,B06009_001E,B06009_002E,B06009_003E,B06009_004E,B06009_005E,B06009_006E,B14005_001E,B14005_002E,B14005_003E,B14005_004E,B14005_005E,B14005_006E,B14005_007E,B14005_008E,B14005_009E,B14005_010E,B14005_011E,B14005_012E,B14005_013E,B14005_014E,B14005_015E,B14005_016E,B14005_017E,B14005_018E,B14005_019E,B14005_020E,B14005_021E,B14005_022E,B14005_023E,B14005_024E,B14005_025E,B14005_026E,B14005_027E,B14005_028E,B14005_029E,zip code tabulation area
0,,,,,,,1141,625,449,0,53,396,176,96,0,46,50,80,0,0,80,516,480,0,22,458,36,18,0,0,18,18,0,0,18,00601
1,,,,,,,2568,1344,1035,50,200,785,309,118,0,62,56,191,15,58,118,1224,1117,35,275,807,107,72,0,0,72,35,0,15,20,00602
2,,,,,,,3159,1571,1371,58,115,1198,200,106,24,44,38,94,10,0,84,1588,1332,92,96,1144,256,176,9,9,158,80,0,7,73,00603
3,,,,,,,363,196,160,11,0,149,36,26,0,0,26,10,0,0,10,167,153,0,0,153,14,0,0,0,0,14,0,0,14,00606
4,,,,,,,1812,891,628,20,28,580,263,142,0,0,142,121,23,33,65,921,758,35,0,723,163,148,11,0,137,15,0,0,15,00610
5,,,,,,,4179,2162,1705,33,64,1608,457,242,42,83,117,215,0,52,163,2017,1777,25,116,1636,240,136,16,14,106,104,0,0,104,00612
6,,,,,,,659,349,272,0,16,256,77,63,34,10,19,14,0,0,14,310,279,38,0,241,31,31,0,0,31,0,0,0,0,00616
7,,,,,,,1387,681,450,22,0,428,231,105,24,16,65,126,0,27,99,706,593,0,0,593,113,91,16,16,59,22,0,0,22,00617
8,,,,,,,469,235,179,0,0,179,56,40,0,0,40,16,0,0,16,234,186,0,12,174,48,20,20,0,0,28,0,0,28,00622
9,,,,,,,2402,1229,1018,11,80,927,211,120,63,0,57,91,16,13,62,1173,923,0,63,860,250,112,0,22,90,138,0,14,124,00623
10,,,,,,,1581,792,587,9,13,565,205,144,12,39,93,61,28,0,33,789,639,49,5,585,150,105,0,32,73,45,0,17,28,00624
11,,,,,,,2206,1141,907,36,71,800,234,226,71,59,96,8,8,0,0,1065,987,39,75,873,78,68,0,0,68,10,0,0,10,00627
12,,,,,,,87,55,40,0,0,40,15,0,0,0,0,15,0,15,0,32,23,0,0,23,9,9,0,0,9,0,0,0,0,00631
13,,,,,,,1636,838,690,6,26,658,148,61,0,0,61,87,0,16,71,798,682,0,17,665,116,58,35,17,6,58,0,0,58,00637
14,,,,,,,1247,615,438,0,0,438,177,57,7,0,50,120,11,0,109,632,530,21,11,498,102,58,0,0,58,44,0,0,44,00638
15,,,,,,,2008,1097,887,17,89,781,210,138,20,46,72,72,0,49,23,911,762,14,73,675,149,93,16,32,45,56,0,0,56,00641
16,,,,,,,2287,1094,950,30,14,906,144,144,29,35,80,0,0,0,0,1193,1067,24,35,1008,126,98,13,36,49,28,0,0,28,00646
17,,,,,,,366,220,179,22,0,157,41,8,8,0,0,33,0,0,33,146,115,0,0,115,31,23,0,0,23,8,0,0,8,00647
18,,,,,,,974,458,366,0,24,342,92,26,13,0,13,66,0,16,50,516,424,0,39,385,92,33,0,20,13,59,0,0,59,00650
19,,,,,,,215,101,44,0,6,38,57,39,0,0,39,18,0,0,18,114,99,0,0,99,15,15,0,0,15,0,0,0,0,00652
20,,,,,,,718,327,243,0,9,234,84,46,0,0,46,38,0,10,28,391,341,10,17,314,50,24,0,0,24,26,0,0,26,00653
21,,,,,,,1235,609,495,15,0,480,114,50,0,8,42,64,0,7,57,626,440,35,21,384,186,169,22,0,147,17,0,0,17,00656
22,,,,,,,2423,1310,1015,12,29,974,295,182,36,109,37,113,27,0,86,1113,917,85,0,832,196,135,0,18,117,61,0,13,48,00659
23,,,,,,,882,434,360,0,94,266,74,42,34,0,8,32,0,0,32,448,364,42,43,279,84,72,0,27,45,12,0,7,5,00660
24,,,,,,,2480,1266,1035,14,47,974,231,128,0,16,112,103,0,0,103,1214,1117,28,0,1089,97,67,8,0,59,30,0,10,20,00662
25,,,,,,,1108,645,375,0,36,339,270,77,0,75,2,193,0,28,165,463,351,0,49,302,112,93,28,20,45,19,0,0,19,00664
26,,,,,,,1480,914,813,0,0,813,101,48,0,0,48,53,0,10,43,566,433,18,0,415,133,83,0,7,76,50,0,13,37,00667
27,,,,,,,1806,963,737,31,75,631,226,121,0,35,86,105,13,22,70,843,674,15,58,601,169,109,0,21,88,60,0,11,49,00669
28,,,,,,,602,319,239,6,0,233,80,50,21,0,29,30,0,0,30,283,235,0,0,235,48,48,0,0,48,0,0,0,0,00670
29,,,,,,,2612,1333,1104,36,0,1068,229,172,0,76,96,57,0,0,57,1279,1083,0,21,1062,196,106,0,61,45,90,0,0,90,00674
30,,,,,,,2366,1152,988,45,82,861,164,52,0,52,0,112,0,23,89,1214,1083,30,27,1026,131,59,0,0,59,72,0,0,72,00676
31,,,,,,,824,425,305,10,55,240,120,45,15,30,0,75,0,14,61,399,371,0,83,288,28,12,0,0,12,16,0,0,16,00677
32,,,,,,,1530,824,755,0,0,755,69,31,17,14,0,38,0,0,38,706,664,28,37,599,42,32,9,0,23,10,0,0,10,00678
33,,,,,,,3610,1939,1409,93,66,1250,530,253,58,57,138,277,41,20,216,1671,1447,117,118,1212,224,129,0,13,116,95,0,34,61,00680
34,,,,,,,2741,1404,1251,58,64,1129,153,53,0,13,40,100,0,10,90,1337,1191,0,52,1139,146,29,0,0,29,117,0,0,117,00682
35,,,,,,,2045,1028,869,38,9,822,159,110,10,0,100,49,13,0,36,1017,874,69,14,791,143,116,0,9,107,27,0,0,27,00683
36,,,,,,,2298,1217,912,69,61,782,305,157,21,0,136,148,65,0,83,1081,899,14,100,785,182,104,0,0,104,78,0,0,78,00685
37,,,,,,,2173,1061,896,12,63,821,165,57,24,0,33,108,0,24,84,1112,970,0,35,935,142,51,0,0,51,91,0,0,91,00687
38,,,,,,,752,419,329,0,0,329,90,90,8,35,47,0,0,0,0,333,297,0,0,297,36,36,14,0,22,0,0,0,0,00688
39,,,,,,,356,192,115,0,0,115,77,0,0,0,0,77,0,0,77,164,141,0,0,141,23,7,0,7,0,16,0,0,16,00690
40,,,,,,,2373,1256,898,13,31,854,358,218,0,101,117,140,0,29,111,1117,798,0,49,749,319,224,13,65,146,95,0,28,67,00692
41,,,,,,,3549,1798,1463,50,61,1352,335,142,25,17,100,193,29,0,164,1751,1488,23,31,1434,263,108,0,43,65,155,0,0,155,00693
42,,,,,,,0,0,0,0,0,0,0,0,0,0,0,0,0,0,0,0,0,0,0,0,0,0,0,0,0,0,0,0,0,00694
43,,,,,,,2469,1376,1165,62,50,1053,211,111,15,38,58,100,0,42,58,1093,886,0,29,857,207,176,48,0,128,31,0,0,31,00698
44,,,,,,,1713,864,715,7,32,676,149,113,25,15,73,36,0,13,23,849,737,0,23,714,112,82,0,0,82,30,7,0,23,00703
45,,,,,,,464,301,178,0,0,178,123,58,0,0,58,65,0,0,65,163,163,7,14,142,0,0,0,0,0,0,0,0,0,00704
46,,,,,,,1555,794,615,20,28,567,179,97,19,0,78,82,0,0,82,761,660,0,42,618,101,76,0,27,49,25,0,0,25,00705
47,,,,,,,775,412,348,16,23,309,64,40,0,15,25,24,0,0,24,363,303,32,38,233,60,60,0,0,60,0,0,0,0,00707
48,,,,,,,1286,678,491,52,54,385,187,125,0,38,87,62,0,40,22,608,554,0,51,503,54,40,0,32,8,14,0,0,14,00714
49,,,,,,,267,130,77,10,26,41,53,53,0,34,19,0,0,0,0,137,71,0,17,54,66,54,0,0,54,12,0,0,12,00715
50,,,,,,,1690,834,649,25,48,576,185,91,24,38,29,94,0,30,64,856,676,60,45,571,180,101,0,0,101,79,0,35,44,00716
51,,,,,,,1143,509,429,53,11,365,80,39,0,0,39,41,0,0,41,634,544,60,23,461,90,57,30,0,27,33,18,0,15,00717
52,,,,,,,1520,698,645,0,0,645,53,0,0,0,0,53,0,17,36,822,756,0,0,756,66,58,0,0,58,8,0,0,8,00718
53,,,,,,,2065,1054,900,0,42,858,154,88,17,19,52,66,15,0,51,1011,893,23,32,838,118,57,12,0,45,61,0,0,61,00719
54,,,,,,,1688,923,591,0,58,533,332,229,34,25,170,103,0,0,103,765,596,0,0,596,169,82,0,0,82,87,0,16,71,00720
55,,,,,,,1153,651,561,38,41,482,90,64,0,24,40,26,0,0,26,502,502,35,24,443,0,0,0,0,0,0,0,0,0,00723
56,,,,,,,5057,2480,1921,142,69,1710,559,371,41,144,186,188,15,50,123,2577,2066,181,139,1746,511,335,85,80,170,176,0,37,139,00725
57,,,,,,,3551,1872,1623,124,105,1394,249,147,42,36,69,102,25,26,51,1679,1553,153,89,1311,126,115,0,24,91,11,0,0,11,00727
58,,,,,,,2969,1487,1193,29,72,1092,294,178,28,62,88,116,0,0,116,1482,1235,23,135,1077,247,221,17,60,144,26,0,18,8,00728
59,,,,,,,3685,1974,1573,21,95,1457,401,266,85,100,81,135,8,0,127,1711,1368,124,133,1111,343,198,42,41,115,145,0,0,145,00729
60,,,,,,,2469,1216,937,67,89,781,279,142,51,46,45,137,11,7,119,1253,1066,103,92,871,187,118,8,74,36,69,0,0,69,00730
61,,,,,,,853,415,386,20,38,328,29,17,0,5,12,12,0,12,0,438,363,29,71,263,75,66,0,30,36,9,0,0,9,00731
62,,,,,,,844,444,432,27,0,405,12,12,0,0,12,0,0,0,0,400,257,0,26,231,143,89,0,0,89,54,0,0,54,00735
63,,,,,,,2935,1417,997,27,52,918,420,325,35,94,196,95,8,18,69,1518,1297,62,49,1186,221,149,0,69,80,72,0,0,72,00736
64,,,,,,,2079,1006,665,6,190,469,341,326,85,99,142,15,15,0,0,1073,852,37,156,659,221,127,37,28,62,94,0,54,40,00738
65,,,,,,,2264,1247,941,114,37,790,306,273,82,0,191,33,0,9,24,1017,853,55,21,777,164,145,38,21,86,19,0,0,19,00739
66,,,,,,,130,25,25,0,0,25,0,0,0,0,0,0,0,0,0,105,76,0,0,76,29,17,0,17,0,12,0,0,12,00740
67,,,,,,,311,154,154,17,0,137,0,0,0,0,0,0,0,0,0,157,125,0,0,125,32,19,0,0,19,13,0,0,13,00741
68,,,,,,,3459,1895,1230,90,187,953,665,436,77,185,174,229,20,37,172,1564,1091,105,138,848,473,268,53,93,122,205,32,21,152,00745
69,,,,,,,1740,888,720,0,8,712,168,119,12,22,85,49,0,8,41,852,752,14,7,731,100,59,0,29,30,41,0,7,34,00751
70,,,,,,,2448,1198,1029,12,32,985,169,135,0,28,107,34,7,0,27,1250,981,36,102,843,269,202,33,5,164,67,0,10,57,00754
71,,,,,,,1593,794,627,20,8,599,167,115,17,9,89,52,0,0,52,799,676,38,0,638,123,72,35,0,37,51,9,0,42,00757
72,,,,,,,515,347,176,14,14,148,171,122,109,0,13,49,26,0,23,168,121,0,0,121,47,47,38,0,9,0,0,0,0,00765
73,,,,,,,1801,1044,791,29,120,642,253,100,0,64,36,153,14,0,139,757,556,18,70,468,201,187,0,47,140,14,0,0,14,00766
74,,,,,,,2271,1076,795,48,39,708,281,134,26,27,81,147,49,17,81,1195,955,0,6,949,240,209,0,35,174,31,0,0,31,00767
75,,,,,,,2598,1337,1065,0,0,1065,272,116,0,51,65,156,35,25,96,1261,1085,22,11,1052,176,117,25,0,92,59,0,0,59,00769
76,,,,,,,2393,1277,1069,16,0,1053,208,173,30,38,105,35,2,22,11,1116,825,107,38,680,291,141,26,22,93,150,0,0,150,00771
77,,,,,,,1466,667,421,8,23,390,246,198,35,41,122,48,0,0,48,799,459,0,23,436,340,267,46,102,119,73,0,0,73,00772
78,,,,,,,1288,703,552,51,63,438,151,123,39,66,18,28,0,0,28,585,459,29,101,329,126,117,0,69,48,9,0,9,0,00773
79,,,,,,,104,41,25,7,0,18,16,0,0,0,0,16,0,0,16,63,33,0,0,33,30,27,0,0,27,3,0,0,3,00775
80,,,,,,,2370,1174,1018,19,81,918,156,23,0,0,23,133,0,29,104,1196,1095,29,43,1023,101,49,0,15,34,52,20,0,32,00777
81,,,,,,,2700,1360,1135,101,48,986,225,136,40,0,96,89,23,0,66,1340,1168,99,33,1036,172,154,76,39,39,18,0,0,18,00778
82,,,,,,,724,497,442,0,42,400,55,37,37,0,0,18,0,18,0,227,185,0,19,166,42,20,0,0,20,22,0,22,0,00780
83,,,,,,,1144,588,482,0,11,471,106,85,23,0,62,21,0,0,21,556,448,0,12,436,108,74,0,11,63,34,0,0,34,00782
84,,,,,,,2281,1104,908,33,86,789,196,88,0,0,88,108,0,17,91,1177,928,23,0,905,249,80,0,24,56,169,0,9,160,00783
85,,,,,,,2858,1521,1242,78,66,1098,279,94,38,30,26,185,16,20,149,1337,1157,7,72,1078,180,54,16,9,29,126,0,0,126,00784
86,,,,,,,27,27,27,0,0,27,0,0,0,0,0,0,0,0,0,0,0,0,0,0,0,0,0,0,0,0,0,0,0,00786
87,,,,,,,3092,1475,1139,41,15,1083,336,222,40,25,157,114,0,18,96,1617,1549,85,15,1449,68,22,0,0,22,46,0,0,46,00791
88,,,,,,,2098,1123,914,21,68,825,209,126,0,0,126,83,11,0,72,975,872,22,4,846,103,77,13,0,64,26,0,0,26,00794
89,,,,,,,3416,1620,1279,54,84,1141,341,228,31,58,139,113,0,15,98,1796,1504,0,209,1295,292,154,0,52,102,138,0,12,126,00795
90,,,,,,,229,104,57,13,0,44,47,24,3,20,1,23,0,0,23,125,108,10,28,70,17,17,0,0,17,0,0,0,0,00901
91,,,,,,,0,0,0,0,0,0,0,0,0,0,0,0,0,0,0,0,0,0,0,0,0,0,0,0,0,0,0,0,0,00906
92,,,,,,,602,352,343,19,33,291,9,9,0,0,9,0,0,0,0,250,219,19,10,190,31,25,0,25,0,6,6,0,0,00907
93,,,,,,,449,269,249,0,24,225,20,20,0,0,20,0,0,0,0,180,160,23,17,120,20,1,0,0,1,19,0,0,19,00909
94,,,,,,,280,203,203,25,38,140,0,0,0,0,0,0,0,0,0,77,65,12,0,53,12,12,0,12,0,0,0,0,0,00911
95,,,,,,,487,175,151,0,9,142,24,24,13,0,11,0,0,0,0,312,268,55,37,176,44,21,12,0,9,23,0,0,23,00912
96,,,,,,,441,298,150,0,0,150,148,27,0,27,0,121,16,39,66,143,102,0,0,102,41,26,9,10,7,15,0,0,15,00913
97,,,,,,,2283,1151,857,65,117,675,294,138,72,30,36,156,40,45,71,1132,902,41,153,708,230,176,48,68,60,54,0,37,17,00915
98,,,,,,,913,540,387,36,16,335,153,129,9,81,39,24,0,0,24,373,281,15,0,266,92,70,11,47,12,22,0,14,8,00917
99,,,,,,,628,274,262,11,0,251,12,12,0,12,0,0,0,0,0,354,217,10,0,207,137,54,0,29,25,83,0,0,83,00918
100,,,,,,,786,451,332,29,52,251,119,38,20,0,18,81,10,31,40,335,278,18,18,242,57,48,17,9,22,9,0,0,9,00920
101,,,,,,,2251,1010,814,71,45,698,196,123,11,24,88,73,14,0,59,1241,1121,114,58,949,120,79,22,43,14,41,9,0,32,00921
102,,,,,,,1913,999,679,45,65,569,320,215,59,99,57,105,0,49,56,914,698,89,33,576,216,55,38,0,17,161,19,20,122,00923
103,,,,,,,3354,1718,1432,101,279,1052,286,199,45,57,97,87,0,59,28,1636,1161,84,177,900,475,246,91,41,114,229,0,71,158,00924
104,,,,,,,656,351,283,26,31,226,68,20,0,0,20,48,32,0,16,305,286,60,31,195,19,0,0,0,0,19,0,0,19,00925
105,,,,,,,5937,2858,2325,171,83,2071,533,467,64,43,360,66,3,25,38,3079,2676,151,130,2395,403,239,82,16,141,164,17,0,147,00926
106,,,,,,,662,270,256,10,9,237,14,14,14,0,0,0,0,0,0,392,360,0,8,352,32,20,9,0,11,12,0,0,12,00927
107,,,,,,,10,0,0,0,0,0,0,0,0,0,0,0,0,0,0,10,10,10,0,0,0,0,0,0,0,0,0,0,0,00934
108,,,,,,,29,1,0,0,0,0,1,0,0,0,0,1,0,0,1,28,0,0,0,0,28,28,0,0,28,0,0,0,0,00936
109,,,,,,,4500,2315,1758,128,124,1506,557,452,139,149,164,105,23,14,68,2185,1803,141,76,1586,382,273,37,75,161,109,0,0,109,00949
110,,,,,,,0,0,0,0,0,0,0,0,0,0,0,0,0,0,0,0,0,0,0,0,0,0,0,0,0,0,0,0,0,00950
111,,,,,,,0,0,0,0,0,0,0,0,0,0,0,0,0,0,0,0,0,0,0,0,0,0,0,0,0,0,0,0,0,00951
112,,,,,,,677,302,243,37,25,181,59,44,12,0,32,15,0,0,15,375,309,34,21,254,66,51,0,19,32,15,0,15,0,00952
113,,,,,,,4983,2530,2065,162,372,1531,465,346,111,66,169,119,8,20,91,2453,2076,118,320,1638,377,197,87,0,110,180,0,13,167,00953
114,,,,,,,4207,2310,1868,87,523,1258,442,297,84,90,123,145,0,77,68,1897,1745,245,412,1088,152,94,0,36,58,58,0,12,46,00956
115,,,,,,,2747,1486,1175,67,306,802,311,136,9,22,105,175,21,22,132,1261,1067,58,117,892,194,85,26,8,51,109,12,0,97,00957
116,,,,,,,2815,1371,1186,46,68,1072,185,146,78,18,50,39,14,0,25,1444,1293,139,173,981,151,136,36,20,80,15,0,0,15,00959
117,,,,,,,149,149,89,0,0,89,60,22,0,0,22,38,0,0,38,0,0,0,0,0,0,0,0,0,0,0,0,0,0,00960
118,,,,,,,1773,806,633,79,62,492,173,110,70,21,19,63,31,10,22,967,882,30,47,805,85,64,0,64,0,21,12,0,9,00961
119,,,,,,,1328,710,545,14,59,472,165,121,13,49,59,44,7,37,0,618,412,13,7,392,206,107,0,47,60,99,0,31,68,00962
120,,,,,,,611,267,229,28,20,181,38,28,0,21,7,10,1,0,9,344,251,20,18,213,93,81,13,15,53,12,0,12,0,00965
121,,,,,,,803,452,377,28,34,315,75,48,12,21,15,27,0,0,27,351,308,15,0,293,43,11,0,0,11,32,0,0,32,00966
122,,,,,,,100,17,17,0,0,17,0,0,0,0,0,0,0,0,0,83,72,0,13,59,11,11,0,0,11,0,0,0,0,00968
123,,,,,,,2141,1095,965,47,21,897,130,124,0,53,71,6,0,0,6,1046,981,16,9,956,65,65,0,22,43,0,0,0,0,00969
124,,,,,,,1890,998,663,12,77,574,335,217,67,132,18,118,31,0,87,892,714,79,32,603,178,107,25,28,54,71,0,55,16,00971
125,,,,,,,3684,1821,1417,112,82,1223,404,298,11,72,215,106,0,29,77,1863,1497,154,9,1334,366,242,83,14,145,124,0,0,124,00976
126,,,,,,,510,259,227,11,0,216,32,32,32,0,0,0,0,0,0,251,235,11,7,217,16,16,0,0,16,0,0,0,0,00979
127,,,,,,,716,329,295,108,13,174,34,34,0,0,34,0,0,0,0,387,314,31,20,263,73,54,16,0,38,19,19,0,0,00982
128,,,,,,,2409,1238,983,70,148,765,255,178,44,45,89,77,39,13,25,1171,1024,94,42,888,147,60,0,17,43,87,0,25,62,00983
129,,,,,,,2377,1175,854,63,114,677,321,210,69,41,100,111,16,21,74,1202,1037,135,121,781,165,95,0,35,60,70,0,12,58,00985
130,,,,,,,4008,2040,1617,151,133,1333,423,237,69,70,98,186,0,45,141,1968,1678,214,158,1306,290,269,64,9,196,21,21,0,0,00987
131,12417,1059,4316,3895,1953,1194,803,374,374,202,1,171,0,0,0,0,0,0,0,0,0,429,409,208,12,189,20,20,20,0,0,0,0,0,0,01001
132,12846,560,1576,2083,3098,5529,4013,1798,1774,517,104,1153,24,24,0,24,0,0,0,0,0,2215,2191,690,178,1323,24,23,0,21,2,1,0,0,1,01002
133,233,0,0,153,49,31,5739,2604,2604,383,247,1974,0,0,0,0,0,0,0,0,0,3135,3135,1114,283,1738,0,0,0,0,0,0,0,0,0,01003
134,3527,296,1257,1145,544,285,425,330,271,18,35,218,59,59,31,0,28,0,0,0,0,95,89,0,0,89,6,0,0,0,0,6,0,0,6,01005
135,10126,665,2569,2978,2372,1542,759,486,479,219,31,229,7,7,0,7,0,0,0,0,0,273,268,72,51,145,5,0,0,0,0,5,0,0,5,01007
136,836,41,287,271,151,86,57,25,25,13,0,12,0,0,0,0,0,0,0,0,0,32,32,5,9,18,0,0,0,0,0,0,0,0,0,01008
137,553,128,165,183,30,47,53,19,19,10,0,9,0,0,0,0,0,0,0,0,0,34,34,9,25,0,0,0,0,0,0,0,0,0,0,01009
138,2697,225,645,680,870,277,103,55,55,21,15,19,0,0,0,0,0,0,0,0,0,48,48,48,0,0,0,0,0,0,0,0,0,0,0,01010
139,1020,95,436,344,94,51,60,45,34,15,2,17,11,11,9,0,2,0,0,0,0,15,15,9,0,6,0,0,0,0,0,0,0,0,0,01011
140,417,8,161,93,87,68,21,15,11,3,0,8,4,3,3,0,0,1,0,1,0,6,6,1,1,4,0,0,0,0,0,0,0,0,0,01012
141,14367,3044,5782,3441,1436,664,1444,684,607,176,46,385,77,69,8,23,38,8,0,4,4,760,588,191,60,337,172,68,36,24,8,104,10,24,70,01013
142,22539,3364,8213,6787,2888,1287,1566,921,802,199,237,366,119,59,0,51,8,60,0,20,40,645,618,256,150,212,27,27,16,11,0,0,0,0,0,01020
143,1887,178,635,526,275,273,428,213,182,0,94,88,31,24,0,0,24,7,0,7,0,215,147,12,7,128,68,55,55,0,0,13,0,0,13,01022
144,796,30,240,219,166,141,77,50,50,9,2,39,0,0,0,0,0,0,0,0,0,27,25,10,0,15,2,2,0,0,2,0,0,0,0,01026
145,13407,1039,4352,4069,2372,1575,491,325,288,92,26,170,37,34,27,0,7,3,3,0,0,166,162,23,13,126,4,3,3,0,0,1,1,0,0,01027
146,11208,598,3161,3186,2404,1859,697,357,323,116,56,151,34,34,23,11,0,0,0,0,0,340,321,153,24,144,19,8,0,8,0,11,0,0,11,01028
147,495,33,213,134,64,51,31,10,10,0,0,10,0,0,0,0,0,0,0,0,0,21,21,0,0,21,0,0,0,0,0,0,0,0,0,01029
148,8024,584,2361,2779,1343,957,481,233,222,49,14,159,11,11,0,11,0,0,0,0,0,248,234,89,34,111,14,14,0,14,0,0,0,0,0,01030
149,1049,141,436,225,110,137,124,73,73,8,0,65,0,0,0,0,0,0,0,0,0,51,51,0,0,51,0,0,0,0,0,0,0,0,0,01031
150,470,18,129,157,82,84,28,6,4,0,0,4,2,2,2,0,0,0,0,0,0,22,22,3,11,8,0,0,0,0,0,0,0,0,0,01032
151,4565,362,1731,1188,694,590,229,114,114,14,0,100,0,0,0,0,0,0,0,0,0,115,101,27,0,74,14,14,14,0,0,0,0,0,0,01033
152,1525,86,492,427,352,168,149,67,63,32,10,21,4,4,0,0,4,0,0,0,0,82,74,24,0,50,8,8,4,4,0,0,0,0,0,01034
153,3911,208,899,947,1048,809,183,127,107,38,0,69,20,20,0,20,0,0,0,0,0,56,56,15,0,41,0,0,0,0,0,0,0,0,0,01035
154,3707,224,1071,1131,672,609,316,161,161,105,0,56,0,0,0,0,0,0,0,0,0,155,135,55,7,73,20,20,20,0,0,0,0,0,0,01036
155,460,21,127,98,75,139,55,35,35,0,0,35,0,0,0,0,0,0,0,0,0,20,8,0,0,8,12,0,0,0,0,12,0,0,12,01037
156,2122,75,656,533,481,377,64,32,22,0,6,16,10,10,9,1,0,0,0,0,0,32,32,10,0,22,0,0,0,0,0,0,0,0,0,01038
157,1246,78,249,345,330,244,42,33,15,8,0,7,18,11,0,0,11,7,7,0,0,9,6,5,0,1,3,3,0,0,3,0,0,0,0,01039
158,26030,6719,7359,6697,3438,1817,2412,1216,900,136,206,558,316,86,68,9,9,230,8,102,120,1196,976,235,135,606,220,64,52,0,12,156,31,0,125,01040
159,1715,98,656,584,203,174,92,49,36,26,0,10,13,1,1,0,0,12,10,2,0,43,41,9,0,32,2,2,2,0,0,0,0,0,0,01050
160,1510,232,408,325,236,309,65,37,37,0,0,37,0,0,0,0,0,0,0,0,0,28,5,5,0,0,23,23,23,0,0,0,0,0,0,01053
161,1333,80,136,258,313,546,70,34,34,3,0,31,0,0,0,0,0,0,0,0,0,36,34,4,3,27,2,2,2,0,0,0,0,0,0,01054
162,15815,2570,5528,4426,2008,1283,736,432,358,89,13,256,74,30,10,0,20,44,0,9,35,304,299,63,26,210,5,0,0,0,0,5,5,0,0,01056
163,6200,531,2121,1735,1125,688,328,129,106,18,13,75,23,16,0,16,0,7,0,0,7,199,196,151,12,33,3,3,3,0,0,0,0,0,0,01057
164,9887,550,1557,1874,2338,3568,1338,238,238,105,12,121,0,0,0,0,0,0,0,0,0,1100,1091,461,90,540,9,0,0,0,0,9,0,0,9,01060
165,7809,649,1561,1339,1713,2547,534,236,164,65,0,99,72,33,0,33,0,39,31,0,8,298,281,144,11,126,17,5,5,0,0,12,0,0,12,01062
166,9,0,0,9,0,0,287,5,5,0,5,0,0,0,0,0,0,0,0,0,0,282,282,112,5,165,0,0,0,0,0,0,0,0,0,01063
167,0,0,0,0,0,0,0,0,0,0,0,0,0,0,0,0,0,0,0,0,0,0,0,0,0,0,0,0,0,0,0,0,0,0,0,01066
168,1278,80,320,409,269,200,71,33,26,3,8,15,7,3,3,0,0,4,0,4,0,38,38,7,3,28,0,0,0,0,0,0,0,0,0,01068
169,6337,707,2532,1872,781,445,454,292,270,41,66,163,22,22,8,14,0,0,0,0,0,162,149,73,0,76,13,0,0,0,0,13,13,0,0,01069
170,462,36,110,131,86,99,37,26,21,4,1,16,5,4,3,1,0,1,0,1,0,11,11,0,3,8,0,0,0,0,0,0,0,0,0,01070
171,1039,51,429,301,179,79,51,32,32,13,0,19,0,0,0,0,0,0,0,0,0,19,17,4,7,6,2,2,2,0,0,0,0,0,0,01071
172,1078,39,155,217,315,352,60,36,32,6,0,26,4,4,4,0,0,0,0,0,0,24,24,10,0,14,0,0,0,0,0,0,0,0,0,01072
173,4181,222,1265,1339,686,669,255,171,171,97,0,74,0,0,0,0,0,0,0,0,0,84,84,37,7,40,0,0,0,0,0,0,0,0,0,01073
174,56,0,0,22,26,8,0,0,0,0,0,0,0,0,0,0,0,0,0,0,0,0,0,0,0,0,0,0,0,0,0,0,0,0,0,01074
175,11795,886,2890,3529,2418,2072,1638,373,321,43,77,201,52,30,25,0,5,22,0,22,0,1265,1257,439,64,754,8,6,6,0,0,2,2,0,0,01075
176,6632,580,2232,1723,1155,942,429,253,185,83,26,76,68,46,46,0,0,22,9,0,13,176,176,27,39,110,0,0,0,0,0,0,0,0,0,01077
177,412,30,148,150,43,41,37,22,22,0,6,16,0,0,0,0,0,0,0,0,0,15,15,6,9,0,0,0,0,0,0,0,0,0,0,01079
178,1452,247,616,317,213,59,123,55,47,7,0,40,8,0,0,0,0,8,0,0,8,68,50,23,0,27,18,18,11,0,7,0,0,0,0,01080
179,1259,85,552,341,197,84,72,54,35,6,14,15,19,5,0,5,0,14,0,3,11,18,13,6,0,7,5,5,0,5,0,0,0,0,0,01081
180,7413,644,3031,2179,1013,546,337,209,164,26,28,110,45,41,9,22,10,4,0,4,0,128,103,53,11,39,25,20,0,20,0,5,0,0,5,01082
181,2145,377,611,857,279,21,101,74,34,0,0,34,40,40,10,0,30,0,0,0,0,27,27,17,0,10,0,0,0,0,0,0,0,0,0,01083
182,180,7,42,30,46,55,8,0,0,0,0,0,0,0,0,0,0,0,0,0,0,8,8,0,6,2,0,0,0,0,0,0,0,0,0,01084
183,26610,2655,8089,7932,5306,2628,2619,1212,1023,320,99,604,189,148,12,66,70,41,0,0,41,1407,1285,319,83,883,122,51,51,0,0,71,44,27,0,01085
184,9,0,0,5,4,0,754,406,406,0,0,406,0,0,0,0,0,0,0,0,0,348,348,0,0,348,0,0,0,0,0,0,0,0,0,01086
185,451,79,233,41,39,59,0,0,0,0,0,0,0,0,0,0,0,0,0,0,0,0,0,0,0,0,0,0,0,0,0,0,0,0,0,01088
186,19625,2449,6275,5659,3504,1738,1429,731,619,130,60,429,112,72,69,3,0,40,15,0,25,698,552,159,136,257,146,55,42,13,0,91,18,26,47,01089
187,838,122,185,387,143,1,40,18,18,18,0,0,0,0,0,0,0,0,0,0,0,22,22,0,0,22,0,0,0,0,0,0,0,0,0,01092
188,214,13,35,32,81,53,5,5,5,5,0,0,0,0,0,0,0,0,0,0,0,0,0,0,0,0,0,0,0,0,0,0,0,0,0,01093
189,281,24,123,67,50,17,14,6,6,0,0,6,0,0,0,0,0,0,0,0,0,8,8,8,0,0,0,0,0,0,0,0,0,0,0,01094
190,10127,663,2185,2742,2645,1892,975,532,521,170,81,270,11,11,11,0,0,0,0,0,0,443,432,316,30,86,11,11,0,11,0,0,0,0,0,01095
191,1689,54,533,466,385,251,63,33,26,7,0,19,7,7,7,0,0,0,0,0,0,30,30,16,3,11,0,0,0,0,0,0,0,0,0,01096
192,38,0,11,27,0,0,8,8,8,8,0,0,0,0,0,0,0,0,0,0,0,0,0,0,0,0,0,0,0,0,0,0,0,0,0,01097
193,870,83,250,205,152,180,19,10,10,6,0,4,0,0,0,0,0,0,0,0,0,9,8,2,0,6,1,0,0,0,0,1,1,0,0,01098
194,1695,651,305,361,187,191,110,60,34,10,9,15,26,8,8,0,0,18,0,18,0,50,50,14,0,36,0,0,0,0,0,0,0,0,0,01103
195,14488,3716,5461,3449,1409,453,1511,870,784,184,97,503,86,58,26,32,0,28,27,0,1,641,621,160,65,396,20,20,17,0,3,0,0,0,0,01104
196,6738,2763,2126,1277,395,177,764,314,239,55,55,129,75,8,0,0,8,67,21,13,33,450,231,54,8,169,219,133,50,13,70,86,61,25,0,01105
197,10884,640,1205,2372,2974,3693,1082,446,446,140,46,260,0,0,0,0,0,0,0,0,0,636,626,197,42,387,10,10,10,0,0,0,0,0,0,01106
198,6369,3042,1449,1318,344,216,785,352,239,44,25,170,113,7,7,0,0,106,33,19,54,433,356,22,65,269,77,10,9,0,1,67,41,14,12,01107
199,15357,3760,3966,4349,1906,1376,2052,1026,859,258,87,514,167,12,0,12,0,155,30,36,89,1026,758,319,97,342,268,197,90,0,107,71,0,0,71,01108
200,16243,3771,6208,4131,1474,659,3367,1843,1525,155,139,1231,318,88,45,23,20,230,16,10,204,1524,1280,232,121,927,244,171,91,52,28,73,10,15,48,01109
201,9730,1017,2626,3181,1713,1193,656,305,267,67,44,156,38,27,0,27,0,11,0,0,11,351,318,54,47,217,33,33,0,0,33,0,0,0,0,01118
202,8765,1755,2606,2891,978,535,1383,681,646,64,15,567,35,17,0,0,17,18,0,6,12,702,640,68,58,514,62,62,0,18,44,0,0,0,0,01119
203,1866,111,553,623,405,174,123,82,82,36,0,46,0,0,0,0,0,0,0,0,0,41,41,22,19,0,0,0,0,0,0,0,0,0,0,01128
204,5068,604,1552,1640,655,617,453,225,205,57,61,87,20,20,0,0,20,0,0,0,0,228,222,35,20,167,6,6,0,6,0,0,0,0,0,01129
205,5165,1095,1771,1673,285,341,695,352,222,69,44,109,130,63,63,0,0,67,51,0,16,343,312,47,0,265,31,0,0,0,0,31,0,0,31,01151
206,0,0,0,0,0,0,0,0,0,0,0,0,0,0,0,0,0,0,0,0,0,0,0,0,0,0,0,0,0,0,0,0,0,0,0,01199
207,33119,3316,11477,9887,4856,3583,1794,919,576,110,60,406,343,139,59,57,23,204,37,39,128,875,806,262,76,468,69,69,38,31,0,0,0,0,0,01201
208,6066,872,2438,1582,829,345,476,241,182,52,58,72,59,59,2,57,0,0,0,0,0,235,222,105,29,88,13,13,13,0,0,0,0,0,0,01220
209,627,58,165,138,172,94,49,21,13,13,0,0,8,8,8,0,0,0,0,0,0,28,28,0,0,28,0,0,0,0,0,0,0,0,0,01222
210,1858,136,590,471,339,322,101,57,38,24,5,9,19,19,19,0,0,0,0,0,0,44,44,5,4,35,0,0,0,0,0,0,0,0,0,01223
211,147,28,19,50,28,22,30,23,23,23,0,0,0,0,0,0,0,0,0,0,0,7,7,0,0,7,0,0,0,0,0,0,0,0,0,01224
212,2188,146,840,729,285,188,182,62,62,41,0,21,0,0,0,0,0,0,0,0,0,120,94,48,21,25,26,13,13,0,0,13,13,0,0,01225
213,5025,310,1781,1345,933,656,367,326,227,80,38,109,99,99,34,65,0,0,0,0,0,41,40,39,0,1,1,1,1,0,0,0,0,0,0,01226
214,78,0,18,26,34,0,0,0,0,0,0,0,0,0,0,0,0,0,0,0,0,0,0,0,0,0,0,0,0,0,0,0,0,0,0,01229
215,5937,653,1724,1200,1303,1057,613,316,286,49,17,220,30,0,0,0,0,30,4,10,16,297,266,88,11,167,31,16,16,0,0,15,0,15,0,01230
216,2179,169,818,661,373,158,143,89,45,5,4,36,44,44,36,8,0,0,0,0,0,54,47,32,4,11,7,5,5,0,0,2,0,2,0,01235
217,1153,17,291,243,324,278,85,49,38,15,0,23,11,11,11,0,0,0,0,0,0,36,29,11,0,18,7,0,0,0,0,7,0,0,7,01236
218,1786,117,702,423,288,256,149,70,69,4,20,45,1,0,0,0,0,1,0,0,1,79,69,43,0,26,10,10,10,0,0,0,0,0,0,01237
219,4550,272,1206,1353,1122,597,483,184,168,43,20,105,16,16,15,0,1,0,0,0,0,299,279,154,18,107,20,2,2,0,0,18,18,0,0,01238
220,3511,158,896,771,776,910,183,103,93,14,0,79,10,0,0,0,0,10,0,0,10,80,80,64,0,16,0,0,0,0,0,0,0,0,0,01240
221,137,13,38,42,26,18,2,0,0,0,0,0,0,0,0,0,0,0,0,0,0,2,2,0,0,2,0,0,0,0,0,0,0,0,0,01242
222,298,15,116,107,30,30,7,7,7,0,0,7,0,0,0,0,0,0,0,0,0,0,0,0,0,0,0,0,0,0,0,0,0,0,0,01243
223,133,18,16,19,40,40,0,0,0,0,0,0,0,0,0,0,0,0,0,0,0,0,0,0,0,0,0,0,0,0,0,0,0,0,0,01244
224,579,17,181,166,94,121,24,8,8,0,0,8,0,0,0,0,0,0,0,0,0,16,16,9,3,4,0,0,0,0,0,0,0,0,0,01245
225,10926,1633,4172,3031,1386,704,1172,528,418,143,22,253,110,95,23,25,47,15,0,0,15,644,607,119,73,415,37,23,11,12,0,14,0,0,14,01247
226,562,27,167,193,101,74,26,16,16,0,0,16,0,0,0,0,0,0,0,0,0,10,6,6,0,0,4,4,4,0,0,0,0,0,0,01253
227,773,16,160,215,192,190,42,23,20,4,0,16,3,0,0,0,0,3,0,3,0,19,19,11,0,8,0,0,0,0,0,0,0,0,0,01254
228,693,110,230,142,133,78,32,14,14,0,0,14,0,0,0,0,0,0,0,0,0,18,14,2,0,12,4,4,0,0,4,0,0,0,0,01255
229,517,69,222,131,44,51,18,16,16,0,0,16,0,0,0,0,0,0,0,0,0,2,2,2,0,0,0,0,0,0,0,0,0,0,0,01256
230,1691,161,510,535,277,208,119,41,41,29,0,12,0,0,0,0,0,0,0,0,0,78,53,18,0,35,25,25,0,0,25,0,0,0,0,01257
231,270,2,52,86,88,42,11,2,2,0,0,2,0,0,0,0,0,0,0,0,0,9,9,1,0,8,0,0,0,0,0,0,0,0,0,01258
232,478,26,102,131,105,114,24,13,0,0,0,0,13,13,13,0,0,0,0,0,0,11,11,11,0,0,0,0,0,0,0,0,0,0,0,01259
233,153,0,82,39,12,20,22,22,22,0,0,22,0,0,0,0,0,0,0,0,0,0,0,0,0,0,0,0,0,0,0,0,0,0,0,01260
234,928,64,274,227,113,250,45,26,26,0,0,26,0,0,0,0,0,0,0,0,0,19,19,7,8,4,0,0,0,0,0,0,0,0,0,01262
235,150,3,33,15,21,78,3,3,3,0,0,3,0,0,0,0,0,0,0,0,0,0,0,0,0,0,0,0,0,0,0,0,0,0,0,01264
236,1089,21,263,299,250,256,40,8,8,5,0,3,0,0,0,0,0,0,0,0,0,32,32,26,0,6,0,0,0,0,0,0,0,0,0,01266
237,4690,261,878,878,1066,1607,1130,460,442,110,12,320,18,0,0,0,0,18,0,0,18,670,670,204,18,448,0,0,0,0,0,0,0,0,0,01267
238,574,35,117,222,123,77,44,16,14,7,0,7,2,0,0,0,0,2,0,0,2,28,28,15,0,13,0,0,0,0,0,0,0,0,0,01270
239,13083,1155,4207,4149,2066,1506,822,406,320,42,46,232,86,59,29,20,10,27,0,26,1,416,345,107,43,195,71,64,40,0,24,7,7,0,0,01301
240,1176,52,235,311,321,257,76,39,30,19,4,7,9,9,9,0,0,0,0,0,0,37,34,0,11,23,3,3,0,0,3,0,0,0,0,01330
241,9203,1381,3608,2894,940,380,702,398,351,109,93,149,47,44,0,22,22,3,0,3,0,304,292,102,19,171,12,0,0,0,0,12,0,4,8,01331
242,1987,132,670,581,360,244,120,75,75,41,4,30,0,0,0,0,0,0,0,0,0,45,45,0,7,38,0,0,0,0,0,0,0,0,0,01337
243,148,5,37,54,27,25,4,4,4,0,4,0,0,0,0,0,0,0,0,0,0,0,0,0,0,0,0,0,0,0,0,0,0,0,0,01338
244,1176,121,362,327,183,183,96,60,54,4,9,41,6,2,0,0,2,4,0,4,0,36,27,20,0,7,9,0,0,0,0,9,9,0,0,01339
245,1372,157,398,452,197,168,60,22,15,9,0,6,7,5,2,0,3,2,2,0,0,38,35,12,2,21,3,3,3,0,0,0,0,0,0,01340
246,1192,32,233,314,277,336,51,20,10,2,3,5,10,10,10,0,0,0,0,0,0,31,22,14,0,8,9,9,9,0,0,0,0,0,0,01341
247,1030,14,115,257,274,370,89,42,42,0,0,42,0,0,0,0,0,0,0,0,0,47,35,7,0,28,12,12,12,0,0,0,0,0,0,01342
248,59,4,32,11,2,10,0,0,0,0,0,0,0,0,0,0,0,0,0,0,0,0,0,0,0,0,0,0,0,0,0,0,0,0,0,01343
249,1049,103,395,339,155,57,100,59,46,4,17,25,13,9,9,0,0,4,0,4,0,41,37,12,10,15,4,4,0,4,0,0,0,0,0,01344
250,367,19,143,85,56,64,9,7,7,2,0,5,0,0,0,0,0,0,0,0,0,2,0,0,0,0,2,2,2,0,0,0,0,0,0,01346
251,69,2,18,22,0,27,0,0,0,0,0,0,0,0,0,0,0,0,0,0,0,0,0,0,0,0,0,0,0,0,0,0,0,0,0,01347
252,621,74,190,162,128,67,33,30,30,0,0,30,0,0,0,0,0,0,0,0,0,3,3,3,0,0,0,0,0,0,0,0,0,0,0,01349
253,90,3,49,20,16,2,2,2,2,2,0,0,0,0,0,0,0,0,0,0,0,0,0,0,0,0,0,0,0,0,0,0,0,0,0,01350
254,1649,81,496,427,357,288,198,106,106,19,0,87,0,0,0,0,0,0,0,0,0,92,79,28,7,44,13,0,0,0,0,13,13,0,0,01351
255,1153,46,346,317,219,225,99,25,25,9,0,16,0,0,0,0,0,0,0,0,0,74,15,5,0,10,59,59,7,0,52,0,0,0,0,01354
256,695,15,145,248,146,141,58,44,30,2,14,14,14,3,3,0,0,11,0,11,0,14,14,3,0,11,0,0,0,0,0,0,0,0,0,01355
257,2247,134,557,681,523,352,142,104,97,29,5,63,7,7,7,0,0,0,0,0,0,38,38,17,0,21,0,0,0,0,0,0,0,0,0,01360
258,5478,657,2012,2030,548,231,404,232,228,27,127,74,4,4,0,0,4,0,0,0,0,172,164,29,12,123,8,8,0,0,8,0,0,0,0,01364
259,931,37,245,265,164,220,91,76,66,13,0,53,10,3,3,0,0,7,0,3,4,15,12,0,0,12,3,0,0,0,0,3,0,0,3,01366
260,410,48,133,141,63,25,12,8,6,4,0,2,2,2,0,2,0,0,0,0,0,4,4,0,0,4,0,0,0,0,0,0,0,0,0,01367
261,855,86,336,270,100,63,52,14,11,3,0,8,3,0,0,0,0,3,3,0,0,38,34,7,6,21,4,4,0,0,4,0,0,0,0,01368
262,3152,249,778,897,721,507,199,98,70,36,0,34,28,24,17,7,0,4,0,0,4,101,96,35,15,46,5,5,0,3,2,0,0,0,0,01370
263,3160,135,812,978,730,505,196,111,100,9,0,91,11,11,0,11,0,0,0,0,0,85,85,32,12,41,0,0,0,0,0,0,0,0,0,01373
264,2113,125,308,419,668,593,129,17,17,0,0,17,0,0,0,0,0,0,0,0,0,112,94,20,0,74,18,18,18,0,0,0,0,0,0,01375
265,3955,502,1176,1405,546,326,342,138,103,27,0,76,35,35,16,19,0,0,0,0,0,204,148,84,15,49,56,5,5,0,0,51,25,26,0,01376
266,544,42,176,151,112,63,22,5,5,3,0,2,0,0,0,0,0,0,0,0,0,17,17,10,0,7,0,0,0,0,0,0,0,0,0,01378
267,797,93,193,160,225,126,36,30,13,0,0,13,17,5,2,3,0,12,0,12,0,6,6,0,0,6,0,0,0,0,0,0,0,0,0,01379
268,25725,4344,8588,7619,3509,1665,2804,1427,1257,439,158,660,170,56,3,25,28,114,34,23,57,1377,1257,472,106,679,120,91,63,9,19,29,0,28,1,01420
269,4239,144,1307,1332,873,583,321,209,209,28,27,154,0,0,0,0,0,0,0,0,0,112,112,50,23,39,0,0,0,0,0,0,0,0,0,01430
270,2193,114,762,677,371,269,212,95,88,50,0,38,7,7,7,0,0,0,0,0,0,117,98,53,0,45,19,19,19,0,0,0,0,0,0,01431
271,5352,328,1595,1488,1226,715,279,156,156,50,48,58,0,0,0,0,0,0,0,0,0,123,113,72,32,9,10,10,0,0,10,0,0,0,0,01432
272,1275,171,515,363,141,85,229,179,98,0,0,98,81,43,0,36,7,38,0,12,26,50,33,6,0,27,17,4,3,0,1,13,0,13,0,01434
273,2656,448,922,710,277,299,223,61,61,0,8,53,0,0,0,0,0,0,0,0,0,162,162,60,20,82,0,0,0,0,0,0,0,0,0,01436
274,247,0,125,64,9,49,0,0,0,0,0,0,0,0,0,0,0,0,0,0,0,0,0,0,0,0,0,0,0,0,0,0,0,0,0,01438
275,14433,2379,4771,4820,1598,865,1019,567,516,203,77,236,51,27,27,0,0,24,0,0,24,452,308,110,8,190,144,112,96,0,16,32,0,9,23,01440
276,7106,182,917,1148,2884,1975,693,501,472,130,27,315,29,18,14,0,4,11,0,0,11,192,191,100,0,91,1,1,1,0,0,0,0,0,0,01450
277,3319,27,255,491,1125,1421,295,150,139,21,0,118,11,0,0,0,0,11,0,0,11,145,134,28,9,97,11,11,0,0,11,0,0,0,0,01451
278,3064,148,1078,1018,497,323,308,161,119,19,0,100,42,36,24,12,0,6,0,0,6,147,147,31,10,106,0,0,0,0,0,0,0,0,0,01452
279,28949,3715,9226,8542,5204,2262,1918,816,641,243,6,392,175,163,75,26,62,12,0,12,0,1102,995,533,143,319,107,87,87,0,0,20,20,0,0,01453
280,6253,190,971,1307,2099,1686,492,347,329,186,36,107,18,0,0,0,0,18,7,0,11,145,145,51,12,82,0,0,0,0,0,0,0,0,0,01460
281,7474,575,1870,2294,1860,875,418,148,122,2,24,96,26,26,8,10,8,0,0,0,0,270,260,73,0,187,10,9,8,0,1,1,0,0,1,01462
282,7781,483,2436,2090,1834,938,700,375,319,129,20,170,56,43,43,0,0,13,0,0,13,325,299,161,28,110,26,26,0,9,17,0,0,0,0,01463
283,5536,878,1873,1551,807,427,379,167,118,31,0,87,49,36,12,14,10,13,13,0,0,212,198,93,14,91,14,14,14,0,0,0,0,0,0,01464
284,264,1,18,25,84,136,25,0,0,0,0,0,0,0,0,0,0,0,0,0,0,25,25,0,0,25,0,0,0,0,0,0,0,0,0,01467
285,2750,124,1145,1093,246,142,221,100,90,15,57,18,10,10,10,0,0,0,0,0,0,121,121,68,14,39,0,0,0,0,0,0,0,0,0,01468
286,4855,207,1747,1472,970,459,270,114,70,25,8,37,44,24,0,16,8,20,20,0,0,156,125,19,6,100,31,0,0,0,0,31,31,0,0,01469
287,5133,279,1241,1538,1375,700,375,264,220,31,0,189,44,29,29,0,0,15,15,0,0,111,111,64,0,47,0,0,0,0,0,0,0,0,0,01473
288,1348,169,371,275,341,192,148,108,99,0,0,99,9,9,9,0,0,0,0,0,0,40,40,12,0,28,0,0,0,0,0,0,0,0,0,01474
289,7364,924,2627,2404,943,466,534,254,242,84,3,155,12,1,0,0,1,11,11,0,0,280,236,102,0,134,44,44,32,0,12,0,0,0,0,01475
290,11286,1010,3300,3022,2479,1475,1016,405,291,111,24,156,114,114,75,39,0,0,0,0,0,611,582,362,13,207,29,29,0,0,29,0,0,0,0,01501
291,2137,142,521,498,594,382,141,38,36,4,0,32,2,2,0,0,2,0,0,0,0,103,67,29,0,38,36,16,11,5,0,20,20,0,0,01503
292,6099,519,1969,1924,1129,558,770,450,439,105,37,297,11,11,0,0,11,0,0,0,0,320,320,95,29,196,0,0,0,0,0,0,0,0,0,01504
293,3059,118,505,725,991,720,307,200,183,51,9,123,17,17,7,1,9,0,0,0,0,107,78,0,0,78,29,29,29,0,0,0,0,0,0,01505
294,2548,202,1026,655,497,168,154,42,36,6,0,30,6,6,6,0,0,0,0,0,0,112,112,56,13,43,0,0,0,0,0,0,0,0,0,01506
295,8959,709,2610,2667,1926,1047,666,411,357,75,74,208,54,54,54,0,0,0,0,0,0,255,175,84,25,66,80,48,10,23,15,32,0,0,32,01507
296,9613,1188,2800,2442,1968,1215,815,433,292,63,22,207,141,139,66,0,73,2,0,0,2,382,323,175,11,137,59,5,0,5,0,54,11,0,43,01510
297,1566,96,636,425,327,82,178,60,60,18,5,37,0,0,0,0,0,0,0,0,0,118,84,16,5,63,34,34,34,0,0,0,0,0,0,01515
298,5716,260,1680,1650,1478,648,358,277,258,132,12,114,19,19,19,0,0,0,0,0,0,81,81,39,0,42,0,0,0,0,0,0,0,0,0,01516
299,1920,126,574,562,402,256,80,45,45,4,0,41,0,0,0,0,0,0,0,0,0,35,35,0,14,21,0,0,0,0,0,0,0,0,0,01518
300,4349,173,709,901,1611,955,195,110,110,18,0,92,0,0,0,0,0,0,0,0,0,85,68,15,0,53,17,17,17,0,0,0,0,0,0,01519
301,9921,493,1773,2539,2900,2216,706,387,351,186,20,145,36,36,36,0,0,0,0,0,0,319,284,116,20,148,35,35,25,10,0,0,0,0,0,01520
302,1769,151,543,539,377,159,156,108,77,25,4,48,31,31,16,0,15,0,0,0,0,48,31,21,4,6,17,17,15,2,0,0,0,0,0,01521
303,2115,51,479,510,488,587,201,68,60,13,0,47,8,8,0,8,0,0,0,0,0,133,133,15,14,104,0,0,0,0,0,0,0,0,0,01522
304,5345,577,1519,1573,1036,640,489,311,220,105,15,100,91,36,9,0,27,55,0,0,55,178,176,16,21,139,2,0,0,0,0,2,0,0,2,01523
305,4731,491,1478,1481,867,414,470,189,165,92,7,66,24,15,15,0,0,9,9,0,0,281,271,162,52,57,10,10,0,0,10,0,0,0,0,01524
306,119,0,51,35,14,19,0,0,0,0,0,0,0,0,0,0,0,0,0,0,0,0,0,0,0,0,0,0,0,0,0,0,0,0,0,01525
307,9494,793,3517,2491,1773,920,849,418,382,150,48,184,36,36,35,1,0,0,0,0,0,431,343,166,18,159,88,88,88,0,0,0,0,0,0,01527
308,2039,256,676,585,344,178,140,72,63,33,8,22,9,9,5,0,4,0,0,0,0,68,64,21,10,33,4,4,0,4,0,0,0,0,0,01529
309,705,33,256,194,132,90,29,16,15,0,0,15,1,1,0,1,0,0,0,0,0,13,13,4,0,9,0,0,0,0,0,0,0,0,0,01531
310,9589,306,1654,2271,3014,2344,678,428,422,123,30,269,6,6,6,0,0,0,0,0,0,250,243,60,66,117,7,0,0,0,0,7,7,0,0,01532
311,3393,304,1079,846,650,514,397,176,165,54,30,81,11,11,11,0,0,0,0,0,0,221,221,51,59,111,0,0,0,0,0,0,0,0,0,01534
312,3146,330,1278,825,432,281,337,235,174,95,0,79,61,1,0,0,1,60,22,0,38,102,102,48,0,54,0,0,0,0,0,0,0,0,0,01535
313,4833,268,1177,1098,1318,972,441,264,210,64,17,129,54,44,25,9,10,10,0,0,10,177,159,39,0,120,18,8,0,0,8,10,10,0,0,01536
314,1663,159,532,481,351,140,85,28,28,13,0,15,0,0,0,0,0,0,0,0,0,57,57,35,0,22,0,0,0,0,0,0,0,0,0,01537
315,7593,510,2572,2441,1536,534,719,257,175,105,0,70,82,82,59,8,15,0,0,0,0,462,384,202,0,182,78,78,62,16,0,0,0,0,0,01540
316,2368,50,381,437,907,593,144,88,82,25,0,57,6,6,0,0,6,0,0,0,0,56,56,8,7,41,0,0,0,0,0,0,0,0,0,01541
317,1293,170,365,390,242,126,67,7,7,0,0,7,0,0,0,0,0,0,0,0,0,60,51,11,0,40,9,9,0,9,0,0,0,0,0,01542
318,5302,186,1410,1598,1264,844,411,284,284,80,7,197,0,0,0,0,0,0,0,0,0,127,100,60,16,24,27,27,27,0,0,0,0,0,0,01543
319,23622,1266,4295,5067,6618,6376,2072,1152,1109,392,63,654,43,43,29,14,0,0,0,0,0,920,887,312,29,546,33,33,33,0,0,0,0,0,0,01545
320,11034,2186,4062,2838,1224,724,985,485,402,150,32,220,83,78,35,43,0,5,5,0,0,500,355,129,62,164,145,60,60,0,0,85,0,11,74,01550
321,2772,142,759,610,808,453,214,45,45,0,8,37,0,0,0,0,0,0,0,0,0,169,80,14,0,66,89,84,0,0,84,5,0,0,5,01560
322,80,0,24,36,20,0,41,21,21,0,15,6,0,0,0,0,0,0,0,0,0,20,20,5,0,15,0,0,0,0,0,0,0,0,0,01561
323,8143,958,2680,2591,1199,715,297,116,97,58,17,22,19,19,19,0,0,0,0,0,0,181,150,24,20,106,31,31,31,0,0,0,0,0,0,01562
324,5529,219,1238,1212,1637,1223,347,173,161,33,0,128,12,12,0,12,0,0,0,0,0,174,155,50,0,105,19,19,0,0,19,0,0,0,0,01564
325,4666,259,797,1509,1221,880,303,115,98,80,0,18,17,0,0,0,0,17,17,0,0,188,188,96,23,69,0,0,0,0,0,0,0,0,0,01566
326,4913,169,1046,1348,1399,951,375,201,169,44,0,125,32,0,0,0,0,32,0,15,17,174,122,87,0,35,52,0,0,0,0,52,0,0,52,01568
327,9316,538,3152,2526,2119,981,817,414,382,155,0,227,32,32,32,0,0,0,0,0,0,403,341,71,86,184,62,62,40,0,22,0,0,0,0,01569
328,12077,2234,4112,3245,1605,881,665,301,230,77,20,133,71,54,54,0,0,17,8,0,9,364,296,125,32,139,68,68,47,21,0,0,0,0,0,01570
329,6949,625,1986,2287,1385,666,1255,734,612,138,23,451,122,102,64,38,0,20,0,5,15,521,503,154,29,320,18,0,0,0,0,18,8,10,0,01571
330,12787,716,1729,2445,4230,3667,797,422,391,128,9,254,31,8,8,0,0,23,0,0,23,375,375,229,23,123,0,0,0,0,0,0,0,0,0,01581
331,5579,576,1576,1595,1155,677,467,358,264,83,25,156,94,26,0,0,26,68,0,0,68,109,109,33,0,76,0,0,0,0,0,0,0,0,0,01583
332,3268,339,1431,705,488,305,194,104,94,9,33,52,10,10,10,0,0,0,0,0,0,90,86,57,0,29,4,0,0,0,0,4,0,4,0,01585
333,6971,659,2266,2215,1176,655,517,296,245,71,75,99,51,11,11,0,0,40,0,40,0,221,206,59,87,60,15,15,15,0,0,0,0,0,0,01588
334,5885,288,1581,1535,1522,959,613,235,206,68,0,138,29,29,21,8,0,0,0,0,0,378,368,215,24,129,10,10,10,0,0,0,0,0,0,01590
335,16137,1602,3866,3817,3835,3017,1394,617,557,126,68,363,60,51,40,0,11,9,6,2,1,777,752,300,82,370,25,25,20,5,0,0,0,0,0,01602
336,12993,2754,4259,3323,1644,1013,1062,648,446,146,20,280,202,149,50,32,67,53,0,0,53,414,338,93,39,206,76,56,42,0,14,20,0,0,20,01603
337,24263,2932,7589,7059,4544,2139,1425,814,648,93,90,465,166,95,69,26,0,71,0,0,71,611,473,135,11,327,138,128,89,0,39,10,0,0,10,01604
338,17242,3052,5391,4188,2847,1764,1627,628,511,99,72,340,117,103,28,50,25,14,13,0,1,999,821,171,90,560,178,111,23,13,75,67,0,0,67,01605
339,13714,976,3436,4000,3394,1908,884,496,457,130,48,279,39,39,32,0,7,0,0,0,0,388,335,137,19,179,53,52,22,29,1,1,0,0,1,01606
340,5989,968,1818,1651,1189,363,600,393,303,88,33,182,90,87,43,5,39,3,3,0,0,207,156,5,0,151,51,51,35,16,0,0,0,0,0,01607
341,1972,700,426,426,277,143,318,152,152,0,0,152,0,0,0,0,0,0,0,0,0,166,139,58,37,44,27,27,0,0,27,0,0,0,0,01608
342,11305,2045,2205,2603,2353,2099,3154,1613,1613,451,65,1097,0,0,0,0,0,0,0,0,0,1541,1530,449,135,946,11,10,0,0,10,1,0,0,1,01609
343,12271,3090,4660,2585,1311,625,3320,1485,1393,434,138,821,92,45,0,20,25,47,20,19,8,1835,1724,275,162,1287,111,90,33,26,31,21,21,0,0,01610
344,1857,150,637,701,258,111,95,36,27,9,0,18,9,9,9,0,0,0,0,0,0,59,30,13,0,17,29,7,0,7,0,22,0,0,22,01611
345,3053,133,464,957,770,729,412,276,265,81,0,184,11,11,11,0,0,0,0,0,0,136,136,92,7,37,0,0,0,0,0,0,0,0,0,01612
346,23286,1252,4956,4683,7200,5195,942,509,483,195,27,261,26,20,19,0,1,6,0,0,6,433,394,167,37,190,39,24,24,0,0,15,0,15,0,01701
347,24868,3822,6561,4807,5706,3972,2280,866,789,211,73,505,77,28,6,3,19,49,30,9,10,1414,1279,551,176,552,135,104,58,35,11,31,0,9,22,01702
348,246,0,11,28,68,139,13,0,0,0,0,0,0,0,0,0,0,0,0,0,0,13,13,13,0,0,0,0,0,0,0,0,0,0,0,01718
349,3512,42,167,545,1211,1547,368,125,125,0,0,125,0,0,0,0,0,0,0,0,0,243,243,66,0,177,0,0,0,0,0,0,0,0,0,01719
350,14766,455,1172,2384,4533,6222,1284,803,788,239,43,506,15,15,14,1,0,0,0,0,0,481,456,147,0,309,25,25,25,0,0,0,0,0,0,01720
351,11986,507,2476,2318,3838,2847,999,533,474,233,0,241,59,48,48,0,0,11,0,0,11,466,437,216,9,212,29,29,18,11,0,0,0,0,0,01721
352,9457,245,1088,2011,2850,3263,657,350,302,66,0,236,48,48,0,23,25,0,0,0,0,307,296,113,31,152,11,0,0,0,0,11,11,0,0,01730
353,690,0,37,277,204,172,80,37,28,7,0,21,9,9,9,0,0,0,0,0,0,43,39,14,0,25,4,4,4,0,0,0,0,0,0,01731
354,3316,107,511,527,1135,1036,269,131,120,25,2,93,11,8,8,0,0,3,0,0,3,138,112,60,16,36,26,26,26,0,0,0,0,0,0,01740
355,3411,18,251,401,1205,1536,247,99,99,23,33,43,0,0,0,0,0,0,0,0,0,148,148,38,0,110,0,0,0,0,0,0,0,0,0,01741
356,13260,817,1787,1830,4056,4770,871,458,400,120,0,280,58,40,20,2,18,18,0,0,18,413,384,77,23,284,29,29,15,0,14,0,0,0,0,01742
357,252,0,74,38,76,64,0,0,0,0,0,0,0,0,0,0,0,0,0,0,0,0,0,0,0,0,0,0,0,0,0,0,0,0,0,01745
358,9326,265,1399,2073,3498,2091,714,313,313,70,37,206,0,0,0,0,0,0,0,0,0,401,382,147,15,220,19,19,12,7,0,0,0,0,0,01746
359,3993,261,1086,964,1270,412,410,260,231,46,38,147,29,13,12,0,1,16,14,0,2,150,148,77,0,71,2,0,0,0,0,2,0,0,2,01747
360,9564,238,1225,1554,3728,2819,953,512,437,119,16,302,75,1,0,0,1,74,0,28,46,441,438,174,10,254,3,1,1,0,0,2,0,2,0,01748
361,14027,1582,3536,3805,3258,1846,969,600,564,130,51,383,36,28,28,0,0,8,0,0,8,369,363,147,60,156,6,6,0,6,0,0,0,0,0,01749
362,27291,2712,8260,5914,6069,4336,1765,942,799,186,25,588,143,64,57,7,0,79,63,0,16,823,687,270,0,417,136,95,19,11,65,41,0,0,41,01752
363,7395,370,1841,1582,2029,1573,325,226,196,90,15,91,30,0,0,0,0,30,30,0,0,99,99,9,18,72,0,0,0,0,0,0,0,0,0,01754
364,3949,111,808,1161,1236,633,293,110,104,45,0,59,6,6,6,0,0,0,0,0,0,183,171,74,29,68,12,12,0,12,0,0,0,0,0,01756
365,19177,1783,5712,4938,4443,2301,1270,687,624,169,50,405,63,25,14,5,6,38,17,21,0,583,431,228,30,173,152,106,106,0,0,46,0,0,46,01757
366,23587,781,3672,3882,8008,7244,1465,919,875,292,58,525,44,44,37,7,0,0,0,0,0,546,520,120,25,375,26,26,0,11,15,0,0,0,0,01760
367,2753,25,213,277,1059,1179,255,160,160,18,0,142,0,0,0,0,0,0,0,0,0,95,87,14,0,73,8,8,8,0,0,0,0,0,0,01770
368,6331,187,828,939,2225,2152,515,235,206,40,21,145,29,15,13,2,0,14,0,0,14,280,261,70,36,155,19,0,0,0,0,19,0,0,19,01772
369,3422,36,180,370,1138,1698,193,107,67,12,1,54,40,40,27,0,13,0,0,0,0,86,85,27,0,58,1,1,1,0,0,0,0,0,0,01773
370,4508,45,585,940,1418,1520,165,106,86,0,45,41,20,20,20,0,0,0,0,0,0,59,59,24,0,35,0,0,0,0,0,0,0,0,0,01775
371,11595,282,823,1455,4185,4850,1158,602,602,138,68,396,0,0,0,0,0,0,0,0,0,556,556,239,10,307,0,0,0,0,0,0,0,0,0,01776
372,9118,189,788,1189,2918,4034,691,332,291,62,0,229,41,41,29,12,0,0,0,0,0,359,342,98,0,244,17,11,10,0,1,6,0,0,6,01778
373,28733,1892,9948,7145,6041,3707,1541,682,627,128,63,436,55,31,31,0,0,24,24,0,0,859,805,361,25,419,54,29,29,0,0,25,0,16,9,01801
374,17971,1218,4063,4111,5018,3561,1012,548,445,88,67,290,103,102,53,47,2,1,0,0,1,464,439,212,55,172,25,25,25,0,0,0,0,0,0,01803
375,22194,754,2649,3444,7452,7895,2121,1169,1143,208,55,880,26,26,0,17,9,0,0,0,0,952,915,239,6,670,37,25,25,0,0,12,0,0,12,01810
376,21468,1294,7202,6357,4449,2166,1557,893,746,457,40,249,147,103,102,1,0,44,7,37,0,664,655,334,100,221,9,9,0,9,0,0,0,0,0,01821
377,17771,653,3559,4306,4962,4291,897,438,438,101,19,318,0,0,0,0,0,0,0,0,0,459,425,199,13,213,34,34,13,21,0,0,0,0,0,01824
378,20777,1962,6979,6502,3644,1690,1667,932,750,299,63,388,182,127,110,17,0,55,22,0,33,735,622,408,14,200,113,62,27,0,35,51,0,10,41,01826
379,2222,74,493,517,635,503,158,87,79,35,5,39,8,8,8,0,0,0,0,0,0,71,71,11,17,43,0,0,0,0,0,0,0,0,0,01827
380,18055,2965,5450,4886,3151,1603,1194,707,536,101,96,339,171,163,71,62,30,8,0,8,0,487,353,166,59,128,134,134,107,0,27,0,0,0,0,01830
381,15102,1801,4459,4794,2782,1266,1018,527,509,105,99,305,18,9,9,0,0,9,9,0,0,491,416,71,44,301,75,48,0,48,0,27,17,0,10,01832
382,5664,109,1307,1513,1440,1295,417,215,197,30,0,167,18,18,18,0,0,0,0,0,0,202,197,77,14,106,5,5,5,0,0,0,0,0,0,01833
383,4668,154,1357,1400,1174,583,358,253,212,39,23,150,41,0,0,0,0,41,0,0,41,105,91,63,0,28,14,0,0,0,0,14,0,0,14,01834
384,9047,406,2152,3267,2079,1143,826,320,303,80,51,172,17,17,17,0,0,0,0,0,0,506,484,240,42,202,22,22,22,0,0,0,0,0,0,01835
385,3010,1239,757,617,209,188,190,102,102,36,16,50,0,0,0,0,0,0,0,0,0,88,68,14,3,51,20,0,0,0,0,20,0,0,20,01840
386,27732,10327,8426,6493,1528,958,3821,1846,1424,266,166,992,422,122,68,0,54,300,44,73,183,1975,1551,510,130,911,424,174,78,46,50,250,0,75,175,01841
387,14955,3704,5148,3915,1506,682,1387,712,604,144,161,299,108,85,19,0,66,23,13,0,10,675,627,85,64,478,48,33,33,0,0,15,0,0,15,01843
388,32404,3633,10085,9215,6169,3302,2477,1359,1252,651,94,507,107,107,52,26,29,0,0,0,0,1118,1044,455,62,527,74,73,37,0,36,1,0,0,1,01844
389,18928,767,3739,3985,5595,4842,1767,887,811,279,46,486,76,62,62,0,0,14,0,14,0,880,810,254,69,487,70,24,24,0,0,46,0,46,0,01845
390,9702,1846,3586,2632,1149,489,797,338,249,61,27,161,89,85,57,19,9,4,0,0,4,459,413,159,57,197,46,0,0,0,0,46,35,0,11,01850
391,19493,4825,5986,4296,2685,1701,1700,1056,740,173,85,482,316,191,131,48,12,125,18,56,51,644,500,146,99,255,144,101,64,0,37,43,13,0,30,01851
392,22743,4147,6581,5973,3885,2157,1874,901,755,237,20,498,146,48,18,10,20,98,7,0,91,973,841,241,116,484,132,47,47,0,0,85,41,0,44,01852
393,17348,3869,5822,4184,2257,1216,2971,1442,1327,439,55,833,115,73,73,0,0,42,0,0,42,1529,1368,521,41,806,161,81,31,11,39,80,0,74,6,01854
394,4443,228,1025,1278,1021,891,344,139,139,12,12,115,0,0,0,0,0,0,0,0,0,205,188,70,0,118,17,0,0,0,0,17,17,0,0,01860
395,7448,793,2501,2024,1299,831,381,148,125,48,26,51,23,0,0,0,0,23,0,0,23,233,233,202,0,31,0,0,0,0,0,0,0,0,0,01862
396,6651,424,1711,1620,1755,1141,391,256,207,42,27,138,49,0,0,0,0,49,0,0,49,135,125,46,4,75,10,10,0,10,0,0,0,0,0,01863
397,10533,327,2668,2393,3450,1695,707,383,369,63,33,273,14,14,14,0,0,0,0,0,0,324,312,89,11,212,12,12,12,0,0,0,0,0,0,01864
398,16746,381,3061,3847,5352,4105,1137,614,573,221,11,341,41,29,29,0,0,12,12,0,0,523,523,233,68,222,0,0,0,0,0,0,0,0,0,01867
399,20733,1101,6912,5751,4799,2170,1312,696,626,130,44,452,70,57,34,6,17,13,0,6,7,616,500,209,21,270,116,65,26,0,39,51,19,18,14,01876
400,7944,422,2360,1958,1985,1219,793,448,393,151,74,168,55,37,30,7,0,18,18,0,0,345,320,94,34,192,25,6,0,6,0,19,0,0,19,01879
401,18113,931,4647,4342,5317,2876,903,502,495,161,23,311,7,0,0,0,0,7,0,0,7,401,376,181,27,168,25,25,11,0,14,0,0,0,0,01880
402,14469,294,1813,2687,4829,4846,1462,825,807,177,125,505,18,8,0,0,8,10,0,0,10,637,637,130,37,470,0,0,0,0,0,0,0,0,0,01886
403,15175,787,4500,4187,3091,2610,1292,772,623,196,80,347,149,134,96,25,13,15,0,0,15,520,469,252,19,198,51,51,17,34,0,0,0,0,0,01887
404,14391,412,1754,2129,4616,5480,892,471,461,133,12,316,10,10,10,0,0,0,0,0,0,421,406,78,8,320,15,15,0,14,1,0,0,0,0,01890
405,1545,376,424,323,244,178,37,24,24,0,23,1,0,0,0,0,0,0,0,0,0,13,0,0,0,0,13,13,13,0,0,0,0,0,0,01901
406,27850,6579,9326,7169,2914,1862,2989,1617,1159,220,139,800,458,237,196,0,41,221,54,21,146,1372,1192,226,148,818,180,179,109,30,40,1,0,0,1,01902
407,13096,1146,4735,3575,2485,1155,926,594,543,165,83,295,51,51,29,22,0,0,0,0,0,332,297,137,0,160,35,24,0,0,24,11,11,0,0,01904
408,15681,3345,5798,4443,1554,541,1319,657,516,123,67,326,141,94,58,14,22,47,0,15,32,662,496,137,43,316,166,81,72,9,0,85,60,9,16,01905
409,20343,1830,7656,5609,3549,1699,1223,595,533,202,50,281,62,36,36,0,0,26,17,0,9,628,615,279,81,255,13,13,13,0,0,0,0,0,0,01906
410,10042,383,1560,2320,3175,2604,777,365,344,114,0,230,21,21,17,0,4,0,0,0,0,412,412,174,42,196,0,0,0,0,0,0,0,0,0,01907
411,2657,83,651,621,695,607,131,59,59,11,0,48,0,0,0,0,0,0,0,0,0,72,72,17,0,55,0,0,0,0,0,0,0,0,0,01908
412,11698,775,3027,3070,2907,1919,858,583,505,124,45,336,78,49,35,14,0,29,0,0,29,275,257,82,37,138,18,8,0,0,8,10,0,0,10,01913
413,27217,1451,6609,7343,6904,4910,2603,1117,971,271,64,636,146,137,85,0,52,9,8,0,1,1486,1390,487,89,814,96,85,70,0,15,11,11,0,0,01915
414,5675,111,863,1248,2031,1422,339,142,114,27,0,87,28,28,15,13,0,0,0,0,0,197,197,75,0,122,0,0,0,0,0,0,0,0,0,01921
415,1997,74,330,460,693,440,101,49,49,49,0,0,0,0,0,0,0,0,0,0,0,52,52,15,0,37,0,0,0,0,0,0,0,0,0,01922
416,19019,1108,4522,5759,5218,2412,1271,641,576,347,0,229,65,53,13,30,10,12,12,0,0,630,615,215,76,324,15,15,15,0,0,0,0,0,0,01923
417,2588,187,614,707,610,470,282,83,83,73,0,10,0,0,0,0,0,0,0,0,0,199,199,32,0,167,0,0,0,0,0,0,0,0,0,01929
418,21757,2187,6546,5779,4374,2871,1402,752,652,272,53,327,100,79,66,13,0,21,9,12,0,650,461,170,41,250,189,166,118,0,48,23,14,9,0,01930
419,89,24,23,21,8,13,0,0,0,0,0,0,0,0,0,0,0,0,0,0,0,0,0,0,0,0,0,0,0,0,0,0,0,0,0,01937
420,9934,364,1953,2910,2647,2060,769,481,428,157,43,228,53,53,44,0,9,0,0,0,0,288,270,128,10,132,18,18,18,0,0,0,0,0,0,01938
421,8646,268,2097,2506,2328,1447,669,331,331,138,0,193,0,0,0,0,0,0,0,0,0,338,338,143,0,195,0,0,0,0,0,0,0,0,0,01940
422,3747,46,553,735,1364,1049,127,54,41,0,14,27,13,13,0,13,0,0,0,0,0,73,58,17,0,41,15,15,0,0,15,0,0,0,0,01944
423,13894,231,1457,2631,5105,4470,911,444,398,67,30,301,46,39,7,0,32,7,0,0,7,467,451,211,9,231,16,16,16,0,0,0,0,0,0,01945
424,6612,576,1981,1590,1621,844,345,235,218,20,13,185,17,12,0,0,12,5,0,0,5,110,97,48,4,45,13,13,0,0,13,0,0,0,0,01949
425,13165,480,2249,3041,4307,3088,529,236,202,56,24,122,34,34,4,0,30,0,0,0,0,293,291,115,50,126,2,2,0,0,2,0,0,0,0,01950
426,2769,78,446,803,809,633,170,102,102,38,0,64,0,0,0,0,0,0,0,0,0,68,68,10,0,58,0,0,0,0,0,0,0,0,0,01951
427,6056,480,2070,1878,1022,606,460,199,188,60,17,111,11,11,11,0,0,0,0,0,0,261,205,110,44,51,56,56,18,14,24,0,0,0,0,01952
428,37430,3804,12511,10223,6656,4236,2411,1337,998,398,25,575,339,277,146,58,73,62,62,0,0,1074,881,354,104,423,193,99,88,0,11,94,0,8,86,01960
429,5548,235,1196,1471,1574,1072,262,117,92,28,0,64,25,25,25,0,0,0,0,0,0,145,132,60,0,72,13,13,13,0,0,0,0,0,0,01966
430,4097,227,1132,1228,992,518,214,150,150,37,0,113,0,0,0,0,0,0,0,0,0,64,64,13,0,51,0,0,0,0,0,0,0,0,0,01969
431,28196,3203,6797,7715,6492,3989,2694,1200,957,237,143,577,243,207,132,62,13,36,0,25,11,1494,1345,328,193,824,149,87,71,16,0,62,0,62,0,01970
432,5274,90,530,869,2200,1585,446,269,261,68,13,180,8,8,0,0,8,0,0,0,0,177,177,110,1,66,0,0,0,0,0,0,0,0,0,01982
433,4279,167,642,831,1260,1379,279,130,130,54,16,60,0,0,0,0,0,0,0,0,0,149,132,44,16,72,17,17,17,0,0,0,0,0,0,01983
434,2475,47,389,477,961,601,1011,390,378,180,23,175,12,12,0,12,0,0,0,0,0,621,621,231,71,319,0,0,0,0,0,0,0,0,0,01984
435,2797,96,493,671,904,633,233,158,158,26,22,110,0,0,0,0,0,0,0,0,0,75,75,0,10,65,0,0,0,0,0,0,0,0,0,01985
436,11415,946,3628,3349,2431,1061,790,468,397,66,49,282,71,35,18,0,17,36,36,0,0,322,284,136,42,106,38,38,0,13,25,0,0,0,0,02019
437,15465,553,3039,4249,4632,2992,1046,502,467,75,57,335,35,24,24,0,0,11,0,0,11,544,494,194,57,243,50,41,41,0,0,9,0,9,0,02021
438,5255,165,608,786,2188,1508,467,245,245,59,16,170,0,0,0,0,0,0,0,0,0,222,222,127,0,95,0,0,0,0,0,0,0,0,0,02025
439,17929,1040,4242,4415,4953,3279,1173,569,471,99,83,289,98,47,3,10,34,51,0,0,51,604,565,126,22,417,39,16,16,0,0,23,0,0,23,02026
440,3624,31,148,418,1359,1668,475,277,277,11,0,266,0,0,0,0,0,0,0,0,0,198,198,10,11,177,0,0,0,0,0,0,0,0,0,02030
441,2872,159,729,820,682,482,212,112,112,64,0,48,0,0,0,0,0,0,0,0,0,100,100,18,0,82,0,0,0,0,0,0,0,0,0,02032
442,11614,407,2451,3599,3406,1751,801,371,303,75,0,228,68,47,23,0,24,21,21,0,0,430,359,105,0,254,71,52,52,0,0,19,0,0,19,02035
443,20276,715,4390,4932,6405,3834,2327,1330,1194,446,88,660,136,136,136,0,0,0,0,0,0,997,982,309,87,586,15,0,0,0,0,15,0,14,1,02038
444,15413,411,2488,2780,5482,4252,995,479,463,53,39,371,16,16,0,0,16,0,0,0,0,516,478,160,23,295,38,38,0,0,38,0,0,0,0,02043
445,7999,409,2105,2328,1954,1203,403,259,219,46,29,144,40,28,28,0,0,12,0,12,0,144,144,51,0,93,0,0,0,0,0,0,0,0,0,02045
446,111,0,111,0,0,0,0,0,0,0,0,0,0,0,0,0,0,0,0,0,0,0,0,0,0,0,0,0,0,0,0,0,0,0,0,02047
447,14958,576,3149,3605,4857,2771,1458,815,774,208,11,555,41,41,10,0,31,0,0,0,0,643,596,240,14,342,47,45,0,45,0,2,0,0,2,02048
448,18072,395,3677,4910,6061,3029,1206,600,600,258,40,302,0,0,0,0,0,0,0,0,0,606,578,238,32,308,28,28,28,0,0,0,0,0,0,02050
449,8025,180,1188,1383,2765,2509,721,408,408,64,42,302,0,0,0,0,0,0,0,0,0,313,313,88,27,198,0,0,0,0,0,0,0,0,0,02052
450,8540,317,1729,2222,2722,1550,690,402,376,138,14,224,26,26,0,26,0,0,0,0,0,288,271,106,49,116,17,17,17,0,0,0,0,0,0,02053
451,5527,243,1243,1516,1569,956,469,322,322,54,0,268,0,0,0,0,0,0,0,0,0,147,147,72,17,58,0,0,0,0,0,0,0,0,0,02054
452,8018,774,1631,1523,2544,1546,554,303,251,82,25,144,52,25,9,16,0,27,0,0,27,251,210,81,0,129,41,21,21,0,0,20,10,0,10,02056
453,7032,190,1364,1727,2468,1283,532,383,377,117,38,222,6,0,0,0,0,6,6,0,0,149,149,28,0,121,0,0,0,0,0,0,0,0,0,02061
454,20556,1293,5292,5317,5390,3264,1360,638,589,221,14,354,49,49,40,0,9,0,0,0,0,722,642,282,29,331,80,52,43,9,0,28,0,0,28,02062
455,12295,382,2431,2889,4194,2399,642,285,263,136,8,119,22,22,0,0,22,0,0,0,0,357,333,126,44,163,24,11,11,0,0,13,0,0,13,02066
456,11883,333,1139,1870,3918,4623,964,421,421,118,21,282,0,0,0,0,0,0,0,0,0,543,518,149,21,348,25,15,15,0,0,10,0,0,10,02067
457,1218,251,303,319,254,91,170,131,122,51,17,54,9,3,0,0,3,6,0,0,6,39,39,26,13,0,0,0,0,0,0,0,0,0,0,02071
458,19958,1891,6737,5317,3984,2029,1440,964,894,102,83,709,70,11,0,0,11,59,29,0,30,476,428,169,49,210,48,9,9,0,0,39,0,30,9,02072
459,13228,645,2691,3285,4063,2544,762,315,299,50,30,219,16,16,16,0,0,0,0,0,0,447,447,79,9,359,0,0,0,0,0,0,0,0,0,02081
460,9989,202,1313,1460,3773,3241,705,420,420,147,15,258,0,0,0,0,0,0,0,0,0,285,267,97,0,170,18,18,0,0,18,0,0,0,0,02090
461,7496,307,1722,1800,2316,1351,723,444,395,110,36,249,49,25,12,0,13,24,13,0,11,279,241,96,38,107,38,14,0,0,14,24,24,0,0,02093
462,3194,89,87,311,1537,1170,258,92,92,10,19,63,0,0,0,0,0,0,0,0,0,166,166,57,0,109,0,0,0,0,0,0,0,0,0,02108
463,3527,466,271,356,1157,1277,25,24,24,0,0,24,0,0,0,0,0,0,0,0,0,1,0,0,0,0,1,1,1,0,0,0,0,0,0,02109
464,1496,56,80,113,569,678,20,20,20,12,8,0,0,0,0,0,0,0,0,0,0,0,0,0,0,0,0,0,0,0,0,0,0,0,0,02110
465,5430,1087,866,575,1213,1689,871,399,393,179,25,189,6,1,0,0,1,5,0,0,5,472,472,124,44,304,0,0,0,0,0,0,0,0,0,02111
466,5160,308,332,452,2758,1310,5,0,0,0,0,0,0,0,0,0,0,0,0,0,0,5,5,0,0,5,0,0,0,0,0,0,0,0,0,02113
467,9247,356,471,977,3183,4260,270,98,44,0,0,44,54,17,0,0,17,37,0,0,37,172,151,65,22,64,21,21,0,0,21,0,0,0,0,02114
468,10363,1047,1370,1667,3121,3158,7538,3731,3719,1103,306,2310,12,12,0,0,12,0,0,0,0,3807,3807,1397,271,2139,0,0,0,0,0,0,0,0,0,02115
469,15850,1261,920,1302,5495,6872,2109,806,751,206,62,483,55,1,0,0,1,54,54,0,0,1303,1274,421,175,678,29,29,11,0,18,0,0,0,0,02116
470,19999,3342,2790,2474,5583,5810,1058,646,501,76,54,371,145,46,8,0,38,99,0,0,99,412,384,174,5,205,28,0,0,0,0,28,0,0,28,02118
471,15303,3640,4307,3864,2149,1343,1565,794,735,99,77,559,59,26,20,0,6,33,0,8,25,771,713,163,116,434,58,45,45,0,0,13,13,0,0,02119
472,5867,1185,1512,1101,1155,914,1571,648,596,150,48,398,52,31,26,5,0,21,21,0,0,923,888,353,85,450,35,24,24,0,0,11,0,0,11,02120
473,16223,3929,5556,4445,1474,819,1873,942,834,136,212,486,108,63,16,47,0,45,19,0,26,931,777,260,112,405,154,61,9,32,20,93,40,14,39,02121
474,16129,3695,5310,3694,2438,992,1385,640,577,101,174,302,63,57,26,31,0,6,0,0,6,745,665,262,92,311,80,70,39,31,0,10,0,0,10,02122
475,32588,6167,10700,9043,4220,2458,3043,1514,1273,95,323,855,241,116,102,0,14,125,44,53,28,1529,1352,436,318,598,177,105,41,26,38,72,36,21,15,02124
476,21491,4499,5720,4591,4175,2506,2090,1011,873,153,80,640,138,71,54,13,4,67,26,9,32,1079,985,313,77,595,94,75,19,0,56,19,0,0,19,02125
477,18682,4202,6647,5057,1860,916,1806,827,663,51,126,486,164,103,78,14,11,61,0,40,21,979,811,276,111,424,168,3,0,0,3,165,149,0,16,02126
478,25398,2471,5450,3705,9783,3989,1079,566,496,12,22,462,70,20,10,10,0,50,0,0,50,513,446,125,94,227,67,34,17,17,0,33,0,9,24,02127
479,30679,9835,9748,5331,3916,1849,1561,831,677,127,77,473,154,106,3,65,38,48,38,0,10,730,570,120,58,392,160,94,74,20,0,66,38,0,28,02128
480,13358,1392,2190,1762,4536,3478,510,232,164,4,39,121,68,44,10,33,1,24,0,0,24,278,248,38,70,140,30,5,0,0,5,25,0,17,8,02129
481,27865,2194,3768,4174,7832,9897,898,459,399,47,78,274,60,16,15,0,1,44,0,0,44,439,345,143,31,171,94,32,28,0,4,62,21,0,41,02130
482,22125,2869,5655,4556,4941,4104,1286,566,448,71,43,334,118,86,37,6,43,32,6,0,26,720,643,257,110,276,77,48,31,17,0,29,9,7,13,02131
483,20692,1066,4483,4543,5614,4986,820,401,359,109,0,250,42,42,34,8,0,0,0,0,0,419,384,208,5,171,35,16,0,0,16,19,0,0,19,02132
484,11556,1628,2254,1524,4094,2056,578,276,235,71,36,128,41,18,18,0,0,23,22,0,1,302,285,104,34,147,17,17,0,17,0,0,0,0,0,02134
485,25054,2242,4054,3860,8527,6371,889,422,371,93,41,237,51,11,11,0,0,40,18,22,0,467,453,85,57,311,14,4,4,0,0,10,0,0,10,02135
486,19390,2323,6485,5687,3077,1818,1574,971,910,164,147,599,61,61,10,32,19,0,0,0,0,603,553,173,109,271,50,0,0,0,0,50,41,0,9,02136
487,22183,450,1297,1573,6968,11895,3979,1733,1731,299,43,1389,2,0,0,0,0,2,0,0,2,2246,2236,820,57,1359,10,10,10,0,0,0,0,0,0,02138
488,25027,2000,2531,2761,7334,10401,2163,977,943,173,103,667,34,27,0,0,27,7,0,7,0,1186,1162,371,58,733,24,12,6,0,6,12,12,0,0,02139
489,13720,907,1982,1702,3659,5470,556,229,205,47,0,158,24,24,23,0,1,0,0,0,0,327,312,131,8,173,15,0,0,0,0,15,0,0,15,02140
490,9544,1172,1448,1226,2637,3061,508,183,104,6,8,90,79,1,0,1,0,78,0,0,78,325,300,129,5,166,25,25,0,25,0,0,0,0,0,02141
491,1981,18,10,114,669,1170,158,53,53,5,5,43,0,0,0,0,0,0,0,0,0,105,105,0,5,100,0,0,0,0,0,0,0,0,0,02142
492,19630,2080,3423,2672,5712,5743,591,341,262,14,25,223,79,79,32,0,47,0,0,0,0,250,228,102,13,113,22,0,0,0,0,22,22,0,0,02143
493,17578,1210,2806,1872,5640,6050,635,297,243,54,33,156,54,14,12,0,2,40,0,13,27,338,302,97,12,193,36,33,0,0,33,3,0,3,0,02144
494,17609,3059,5198,3452,3508,2392,922,488,477,59,93,325,11,11,11,0,0,0,0,0,0,434,413,71,122,220,21,20,0,11,9,1,0,0,1,02145
495,41746,6144,12441,9860,7877,5424,2824,1342,1098,232,185,681,244,232,165,0,67,12,0,0,12,1482,1273,328,337,608,209,96,81,5,10,113,34,79,0,02148
496,29065,5990,11270,7271,3371,1163,2301,1205,979,447,127,405,226,118,33,19,66,108,28,0,80,1096,968,229,298,441,128,57,22,16,19,71,71,0,0,02149
497,22989,8354,7161,3899,2071,1504,1879,971,823,49,86,688,148,32,3,13,16,116,78,38,0,908,823,188,21,614,85,35,11,24,0,50,29,0,21,02150
498,37753,7138,14623,8933,5109,1950,1948,1114,851,330,117,404,263,113,74,28,11,150,93,0,57,834,796,251,135,410,38,24,24,0,0,14,0,10,4,02151
499,13503,749,3844,4075,3303,1532,477,211,191,22,10,159,20,20,10,10,0,0,0,0,0,266,227,66,10,151,39,39,39,0,0,0,0,0,0,02152
500,40652,3802,10279,9051,10193,7327,4193,1935,1798,328,284,1186,137,123,89,34,0,14,0,14,0,2258,2070,705,111,1254,188,138,61,16,61,50,0,40,10,02155
501,1121,0,14,19,675,413,575,229,229,87,18,124,0,0,0,0,0,0,0,0,0,346,346,60,7,279,0,0,0,0,0,0,0,0,0,02163
502,41094,4591,10966,10165,10073,5299,1864,1070,884,263,80,541,186,186,49,95,42,0,0,0,0,794,653,245,182,226,141,141,84,57,0,0,0,0,0,02169
503,14227,1745,3815,3175,3661,1831,1113,508,362,61,50,251,146,146,11,0,135,0,0,0,0,605,557,275,27,255,48,48,0,48,0,0,0,0,0,02170
504,13440,1710,2948,3100,3266,2416,813,440,371,133,40,198,69,69,28,0,41,0,0,0,0,373,346,47,14,285,27,27,9,10,8,0,0,0,0,02171
505,20025,1042,3578,5066,6035,4304,1055,707,684,203,19,462,23,23,23,0,0,0,0,0,0,348,348,133,8,207,0,0,0,0,0,0,0,0,0,02176
506,16005,1043,4537,4268,3899,2258,906,488,448,245,36,167,40,40,35,0,5,0,0,0,0,418,327,153,0,174,91,91,37,54,0,0,0,0,0,02180
507,25214,1601,7113,7332,6050,3118,1949,1122,1014,461,151,402,108,102,60,10,32,6,0,0,6,827,770,346,30,394,57,57,42,8,7,0,0,0,0,02184
508,16906,540,2713,3255,5247,5151,2118,1072,1022,262,14,746,50,34,0,34,0,16,0,0,16,1046,1017,350,20,647,29,17,17,0,0,12,0,0,12,02186
509,10820,638,3351,3398,2488,945,591,256,234,92,45,97,22,0,0,0,0,22,22,0,0,335,309,94,21,194,26,26,17,0,9,0,0,0,0,02188
510,10384,687,3339,3134,2261,963,831,474,395,185,13,197,79,79,64,0,15,0,0,0,0,357,357,168,70,119,0,0,0,0,0,0,0,0,0,02189
511,11970,797,3781,3464,2645,1283,797,553,475,198,103,174,78,78,78,0,0,0,0,0,0,244,244,120,50,74,0,0,0,0,0,0,0,0,0,02190
512,6253,472,1953,1838,1455,535,303,183,143,23,34,86,40,30,10,20,0,10,0,10,0,120,101,52,23,26,19,19,8,9,2,0,0,0,0,02191
513,1188,0,106,84,562,436,12,7,7,0,0,7,0,0,0,0,0,0,0,0,0,5,5,0,0,5,0,0,0,0,0,0,0,0,0,02199
514,0,0,0,0,0,0,0,0,0,0,0,0,0,0,0,0,0,0,0,0,0,0,0,0,0,0,0,0,0,0,0,0,0,0,0,02203
515,1596,14,75,182,652,673,6,6,0,0,0,0,6,6,6,0,0,0,0,0,0,0,0,0,0,0,0,0,0,0,0,0,0,0,0,02210
516,8173,167,545,926,3105,3430,6919,2792,2783,711,190,1882,9,9,0,0,9,0,0,0,0,4127,4096,1330,183,2583,31,31,25,0,6,0,0,0,0,02215
517,37521,7933,12723,10171,4797,1897,4036,2098,1480,373,226,881,618,314,120,101,93,304,45,107,152,1938,1640,568,198,874,298,215,119,87,9,83,0,12,71,02301
518,22302,3727,7931,6562,2810,1272,2188,1119,940,209,249,482,179,154,53,48,53,25,0,23,2,1069,911,335,160,416,158,125,55,32,38,33,12,18,3,02302
519,3184,296,1093,1051,505,239,299,134,122,47,41,34,12,12,0,0,12,0,0,0,0,165,128,56,18,54,37,37,10,27,0,0,0,0,0,02322
520,16825,1342,5132,4481,3873,1997,2359,942,924,409,69,446,18,17,17,0,0,1,0,0,1,1417,1372,636,132,604,45,45,0,45,0,0,0,0,0,02324
521,8063,706,3177,2444,1152,584,672,330,258,123,39,96,72,60,48,12,0,12,12,0,0,342,278,158,11,109,64,64,64,0,0,0,0,0,0,02330
522,10101,223,1309,2099,4092,2378,688,367,337,59,34,244,30,30,0,0,30,0,0,0,0,321,321,114,0,207,0,0,0,0,0,0,0,0,0,02332
523,9589,504,3441,3303,1534,807,876,397,372,86,107,179,25,11,11,0,0,14,0,14,0,479,442,252,5,185,37,37,22,0,15,0,0,0,0,02333
524,5246,247,2052,1739,702,506,523,256,168,15,18,135,88,88,52,36,0,0,0,0,0,267,234,35,0,199,33,33,13,20,0,0,0,0,0,02338
525,9281,429,2149,2475,3057,1171,799,418,327,101,72,154,91,57,57,0,0,34,0,0,34,381,347,189,27,131,34,0,0,0,0,34,0,0,34,02339
526,6747,312,2278,2382,1208,567,738,461,406,121,127,158,55,34,25,0,9,21,0,21,0,277,243,71,52,120,34,34,34,0,0,0,0,0,0,02341
527,8228,536,2868,2771,1574,479,277,159,135,32,70,33,24,24,19,5,0,0,0,0,0,118,107,50,16,41,11,11,11,0,0,0,0,0,0,02343
528,16151,1388,5321,5210,2864,1368,1062,656,507,176,34,297,149,136,57,37,42,13,0,0,13,406,376,138,158,80,30,0,0,0,0,30,14,16,0,02346
529,7358,532,2356,2041,1513,916,639,281,220,42,22,156,61,53,31,22,0,8,0,0,8,358,358,137,0,221,0,0,0,0,0,0,0,0,0,02347
530,11023,387,3687,3813,2288,848,793,340,266,110,58,98,74,74,60,14,0,0,0,0,0,453,331,182,0,149,122,71,30,7,34,51,0,51,0,02351
531,7800,240,1382,2071,2602,1505,1368,642,576,204,17,355,66,44,0,44,0,22,7,0,15,726,726,224,71,431,0,0,0,0,0,0,0,0,0,02356
532,41,0,0,28,6,7,501,230,230,58,16,156,0,0,0,0,0,0,0,0,0,271,271,52,9,210,0,0,0,0,0,0,0,0,0,02357
533,11971,393,3771,3715,2924,1168,1080,551,439,131,32,276,112,112,112,0,0,0,0,0,0,529,431,212,17,202,98,30,30,0,0,68,0,0,68,02359
534,40520,2184,11732,12805,8663,5136,2825,1479,1324,597,225,502,155,96,28,59,9,59,18,0,41,1346,1145,577,18,550,201,151,142,9,0,50,47,0,3,02360
535,8717,569,2377,2383,2135,1253,671,385,335,67,86,182,50,33,16,17,0,17,17,0,0,286,270,153,23,94,16,16,0,0,16,0,0,0,0,02364
536,146,38,78,22,8,0,0,0,0,0,0,0,0,0,0,0,0,0,0,0,0,0,0,0,0,0,0,0,0,0,0,0,0,0,0,02366
537,2015,101,577,592,436,309,130,56,51,16,0,35,5,5,5,0,0,0,0,0,0,74,74,48,0,26,0,0,0,0,0,0,0,0,0,02367
538,22947,3167,6356,6487,4698,2239,1773,807,721,183,112,426,86,29,0,13,16,57,24,10,23,966,953,317,179,457,13,13,13,0,0,0,0,0,0,02368
539,12516,790,4652,4078,1989,1007,948,584,373,129,0,244,211,127,36,65,26,84,0,84,0,364,281,77,52,152,83,67,0,0,67,16,0,0,16,02370
540,6977,409,1782,1837,2016,933,404,112,91,41,6,44,21,21,21,0,0,0,0,0,0,292,284,42,44,198,8,0,0,0,0,8,0,8,0,02375
541,4793,343,1683,1403,835,529,428,194,194,61,10,123,0,0,0,0,0,0,0,0,0,234,206,45,41,120,28,28,28,0,0,0,0,0,0,02379
542,9865,744,3662,2952,1735,772,813,463,362,140,44,178,101,36,36,0,0,65,0,52,13,350,344,235,42,67,6,0,0,0,0,6,0,6,0,02382
543,9784,213,902,1227,2536,4906,944,470,451,140,10,301,19,19,0,10,9,0,0,0,0,474,449,103,15,331,25,16,16,0,0,9,9,0,0,02420
544,12224,389,1064,1284,3123,6364,1159,613,612,106,0,506,1,1,1,0,0,0,0,0,0,546,526,118,69,339,20,20,20,0,0,0,0,0,0,02421
545,14303,265,1376,1205,3576,7881,883,326,313,47,0,266,13,13,13,0,0,0,0,0,0,557,548,97,35,416,9,9,9,0,0,0,0,0,0,02445
546,20605,620,1361,1697,6382,10545,832,351,330,78,0,252,21,18,0,0,18,3,0,0,3,481,464,30,7,427,17,17,14,0,3,0,0,0,0,02446
547,13211,1049,3294,2354,3837,2677,459,208,166,36,18,112,42,42,42,0,0,0,0,0,0,251,214,69,22,123,37,37,37,0,0,0,0,0,0,02451
548,8688,869,1836,1612,2429,1942,2309,1183,1152,226,136,790,31,9,0,0,9,22,0,0,22,1126,1099,467,37,595,27,26,19,0,7,1,0,0,1,02452
549,19588,2447,5073,3204,5039,3825,2541,1131,1059,296,74,689,72,72,72,0,0,0,0,0,0,1410,1361,418,53,890,49,44,20,0,24,5,0,0,5,02453
550,37,0,0,9,3,25,576,235,235,77,9,149,0,0,0,0,0,0,0,0,0,341,341,134,9,198,0,0,0,0,0,0,0,0,0,02457
551,8290,445,942,1065,2306,3532,455,282,269,79,21,169,13,13,13,0,0,0,0,0,0,173,173,7,55,111,0,0,0,0,0,0,0,0,0,02458
552,12254,160,644,1442,3401,6607,1557,704,704,147,38,519,0,0,0,0,0,0,0,0,0,853,828,195,4,629,25,1,0,0,1,24,0,0,24,02459
553,6430,271,839,919,1481,2920,325,211,211,58,0,153,0,0,0,0,0,0,0,0,0,114,114,15,9,90,0,0,0,0,0,0,0,0,0,02460
554,4657,69,342,369,1280,2597,246,109,99,18,11,70,10,10,10,0,0,0,0,0,0,137,117,0,21,96,20,20,0,0,20,0,0,0,0,02461
555,1122,60,128,184,234,516,38,21,21,0,0,21,0,0,0,0,0,0,0,0,0,17,17,7,0,10,0,0,0,0,0,0,0,0,0,02462
556,2299,69,273,351,772,834,37,19,19,0,0,19,0,0,0,0,0,0,0,0,0,18,18,9,0,9,0,0,0,0,0,0,0,0,0,02464
557,8296,331,985,888,2420,3672,407,146,146,100,0,46,0,0,0,0,0,0,0,0,0,261,248,45,0,203,13,13,0,0,13,0,0,0,0,02465
558,5519,198,727,483,1575,2536,1165,571,571,172,0,399,0,0,0,0,0,0,0,0,0,594,593,252,16,325,1,1,1,0,0,0,0,0,0,02466
559,11312,279,683,1355,3229,5766,3724,1536,1536,407,66,1063,0,0,0,0,0,0,0,0,0,2188,2158,557,104,1497,30,30,17,0,13,0,0,0,0,02467
560,3744,27,240,315,857,2305,311,177,177,85,0,92,0,0,0,0,0,0,0,0,0,134,134,22,35,77,0,0,0,0,0,0,0,0,0,02468
561,25176,1694,4890,4321,7668,6603,1247,658,618,103,57,458,40,21,0,21,0,19,6,11,2,589,529,164,83,282,60,38,10,0,28,22,0,0,22,02472
562,19835,1046,3081,2932,5984,6792,955,566,546,150,27,369,20,20,20,0,0,0,0,0,0,389,362,174,9,179,27,13,13,0,0,14,14,0,0,02474
563,12292,325,1684,1793,3627,4863,580,309,272,56,0,216,37,37,37,0,0,0,0,0,0,271,270,29,13,228,1,0,0,0,0,1,0,0,1,02476
564,17219,535,1610,2739,4773,7562,1208,617,586,112,15,459,31,28,12,0,16,3,0,0,3,591,573,123,0,450,18,11,0,0,11,7,7,0,0,02478
565,9026,126,480,803,2927,4690,1620,307,307,50,11,246,0,0,0,0,0,0,0,0,0,1313,1313,539,98,676,0,0,0,0,0,0,0,0,0,02481
566,6831,212,592,741,2199,3087,869,276,276,74,5,197,0,0,0,0,0,0,0,0,0,593,593,237,44,312,0,0,0,0,0,0,0,0,0,02482
567,13190,211,844,1982,4353,5800,1227,651,626,185,16,425,25,25,0,12,13,0,0,0,0,576,576,252,34,290,0,0,0,0,0,0,0,0,0,02492
568,7340,170,633,536,2080,3921,894,414,414,101,0,313,0,0,0,0,0,0,0,0,0,480,480,160,21,299,0,0,0,0,0,0,0,0,0,02493
569,6370,170,952,839,1957,2452,401,185,170,18,16,136,15,15,0,15,0,0,0,0,0,216,195,122,30,43,21,0,0,0,0,21,2,0,19,02494
570,8024,379,2641,2467,1473,1064,747,437,357,108,2,247,80,80,66,14,0,0,0,0,0,310,286,130,0,156,24,24,7,17,0,0,0,0,0,02532
571,1017,116,222,337,206,136,104,93,0,0,0,0,93,93,93,0,0,0,0,0,0,11,11,0,0,11,0,0,0,0,0,0,0,0,0,02534
572,931,20,168,250,333,160,68,44,24,0,0,24,20,0,0,0,0,20,0,0,20,24,24,0,0,24,0,0,0,0,0,0,0,0,0,02535
573,14471,1104,4179,4193,3030,1965,776,464,365,68,0,297,99,99,14,10,75,0,0,0,0,312,239,61,34,144,73,73,73,0,0,0,0,0,0,02536
574,4203,106,897,1095,1387,718,266,84,84,13,0,71,0,0,0,0,0,0,0,0,0,182,182,35,0,147,0,0,0,0,0,0,0,0,0,02537
575,2098,248,982,585,196,87,197,77,77,0,0,77,0,0,0,0,0,0,0,0,0,120,52,11,0,41,68,68,68,0,0,0,0,0,0,02538
576,3401,562,798,1092,547,402,240,150,50,41,0,9,100,90,90,0,0,10,0,0,10,90,78,21,0,57,12,12,12,0,0,0,0,0,0,02539
577,6820,455,1350,1512,1647,1856,371,298,259,0,36,223,39,39,23,16,0,0,0,0,0,73,60,0,0,60,13,13,0,13,0,0,0,0,0,02540
578,441,44,107,165,105,20,53,26,16,5,0,11,10,0,0,0,0,10,0,0,10,27,27,10,0,17,0,0,0,0,0,0,0,0,0,02542
579,516,0,36,72,103,305,54,18,18,0,0,18,0,0,0,0,0,0,0,0,0,36,36,13,0,23,0,0,0,0,0,0,0,0,0,02543
580,165,0,24,77,64,0,0,0,0,0,0,0,0,0,0,0,0,0,0,0,0,0,0,0,0,0,0,0,0,0,0,0,0,0,0,02553
581,7153,433,1704,1852,2035,1129,326,158,157,47,0,110,1,1,1,0,0,0,0,0,0,168,150,18,0,132,18,4,4,0,0,14,14,0,0,02554
582,2364,170,290,699,695,510,43,43,43,9,0,34,0,0,0,0,0,0,0,0,0,0,0,0,0,0,0,0,0,0,0,0,0,0,0,02556
583,3281,125,816,1086,687,567,196,80,80,23,0,57,0,0,0,0,0,0,0,0,0,116,116,74,0,42,0,0,0,0,0,0,0,0,0,02557
584,1099,54,576,344,99,26,106,0,0,0,0,0,0,0,0,0,0,0,0,0,0,106,106,28,0,78,0,0,0,0,0,0,0,0,0,02558
585,3164,40,833,951,685,655,134,14,14,0,0,14,0,0,0,0,0,0,0,0,0,120,112,20,0,92,8,8,8,0,0,0,0,0,0,02559
586,327,0,64,131,45,87,70,70,43,0,0,43,27,0,0,0,0,27,0,0,27,0,0,0,0,0,0,0,0,0,0,0,0,0,0,02561
587,2427,75,837,853,303,359,188,92,92,55,0,37,0,0,0,0,0,0,0,0,0,96,96,61,0,35,0,0,0,0,0,0,0,0,0,02562
588,6992,347,1619,2007,1890,1129,590,259,225,88,0,137,34,27,17,10,0,7,0,0,7,331,283,103,0,180,48,48,28,20,0,0,0,0,0,02563
589,289,15,33,131,51,59,43,43,0,0,0,0,43,0,0,0,0,43,41,2,0,0,0,0,0,0,0,0,0,0,0,0,0,0,0,02564
590,2926,89,525,795,1065,452,162,107,90,16,0,74,17,17,0,17,0,0,0,0,0,55,39,7,0,32,16,15,0,0,15,1,0,0,1,02568
591,7634,737,2485,2461,1240,711,589,389,310,153,44,113,79,79,0,79,0,0,0,0,0,200,200,135,11,54,0,0,0,0,0,0,0,0,0,02571
592,1876,3,445,561,487,380,157,72,54,30,0,24,18,18,0,18,0,0,0,0,0,85,85,16,0,69,0,0,0,0,0,0,0,0,0,02575
593,3421,269,1363,1303,336,150,138,92,78,30,9,39,14,14,14,0,0,0,0,0,0,46,18,18,0,0,28,28,16,12,0,0,0,0,0,02576
594,0,0,0,0,0,0,0,0,0,0,0,0,0,0,0,0,0,0,0,0,0,0,0,0,0,0,0,0,0,0,0,0,0,0,0,02584
595,10229,1389,3336,3088,1563,853,495,281,240,69,0,171,41,3,0,0,3,38,0,0,38,214,112,38,0,74,102,55,10,45,0,47,0,34,13,02601
596,1667,43,252,528,451,393,80,57,50,42,0,8,7,0,0,0,0,7,0,0,7,23,23,12,0,11,0,0,0,0,0,0,0,0,0,02630
597,7179,156,1533,2172,2032,1286,406,232,232,47,16,169,0,0,0,0,0,0,0,0,0,174,128,43,0,85,46,46,17,0,29,0,0,0,0,02631
598,8635,405,2118,2902,2145,1065,643,291,187,29,12,146,104,104,104,0,0,0,0,0,0,352,307,140,0,167,45,45,21,0,24,0,0,0,0,02632
599,3070,98,612,877,911,572,93,51,38,16,8,14,13,12,12,0,0,1,0,0,1,42,42,8,11,23,0,0,0,0,0,0,0,0,0,02633
600,2606,82,479,679,592,774,237,119,119,99,0,20,0,0,0,0,0,0,0,0,0,118,102,0,29,73,16,16,16,0,0,0,0,0,0,02635
601,53,20,0,0,17,16,16,0,0,0,0,0,0,0,0,0,0,0,0,0,0,16,16,0,0,16,0,0,0,0,0,0,0,0,0,02637
602,2735,72,623,741,779,520,32,18,18,18,0,0,0,0,0,0,0,0,0,0,0,14,14,5,0,9,0,0,0,0,0,0,0,0,0,02638
603,2350,206,702,728,425,289,88,12,12,0,0,12,0,0,0,0,0,0,0,0,0,76,76,0,0,76,0,0,0,0,0,0,0,0,0,02639
604,330,0,39,72,113,106,0,0,0,0,0,0,0,0,0,0,0,0,0,0,0,0,0,0,0,0,0,0,0,0,0,0,0,0,0,02641
605,4101,100,957,1225,953,866,179,133,133,103,0,30,0,0,0,0,0,0,0,0,0,46,46,31,0,15,0,0,0,0,0,0,0,0,0,02642
606,17,0,0,9,8,0,0,0,0,0,0,0,0,0,0,0,0,0,0,0,0,0,0,0,0,0,0,0,0,0,0,0,0,0,0,02643
607,2633,81,611,957,676,308,435,227,227,150,0,77,0,0,0,0,0,0,0,0,0,208,79,16,15,48,129,116,116,0,0,13,0,0,13,02644
608,7131,612,1966,2080,1564,909,467,190,190,87,0,103,0,0,0,0,0,0,0,0,0,277,275,153,31,91,2,0,0,0,0,2,0,0,2,02645
609,1604,24,292,441,417,430,47,20,20,19,0,1,0,0,0,0,0,0,0,0,0,27,27,27,0,0,0,0,0,0,0,0,0,0,0,02646
610,117,0,10,14,35,58,0,0,0,0,0,0,0,0,0,0,0,0,0,0,0,0,0,0,0,0,0,0,0,0,0,0,0,0,0,02647
611,5171,141,1320,1763,1207,740,446,199,199,100,0,99,0,0,0,0,0,0,0,0,0,247,219,128,14,77,28,28,28,0,0,0,0,0,0,02648
612,10427,500,3078,3580,2117,1152,693,428,373,275,0,98,55,52,52,0,0,3,0,0,3,265,228,93,6,129,37,29,13,16,0,8,8,0,0,02649
613,1046,25,214,271,300,236,134,38,26,0,0,26,12,12,12,0,0,0,0,0,0,96,96,25,0,71,0,0,0,0,0,0,0,0,0,02650
614,26,0,0,0,26,0,0,0,0,0,0,0,0,0,0,0,0,0,0,0,0,0,0,0,0,0,0,0,0,0,0,0,0,0,0,02651
615,901,36,217,181,187,280,72,60,27,0,0,27,33,33,33,0,0,0,0,0,0,12,0,0,0,0,12,0,0,0,0,12,12,0,0,02652
616,5139,171,1006,1322,1499,1141,213,51,42,23,13,6,9,0,0,0,0,9,0,0,9,162,94,74,7,13,68,61,61,0,0,7,0,0,7,02653
617,3036,61,677,960,709,629,91,44,44,3,0,41,0,0,0,0,0,0,0,0,0,47,47,9,0,38,0,0,0,0,0,0,0,0,0,02655
618,2616,101,442,631,890,552,120,76,47,0,0,47,29,0,0,0,0,29,0,29,0,44,25,0,0,25,19,19,19,0,0,0,0,0,0,02657
619,665,17,126,224,189,109,12,12,12,12,0,0,0,0,0,0,0,0,0,0,0,0,0,0,0,0,0,0,0,0,0,0,0,0,0,02659
620,4680,320,1088,1607,1099,566,219,110,100,16,32,52,10,10,0,10,0,0,0,0,0,109,93,92,0,1,16,16,16,0,0,0,0,0,0,02660
621,106,16,12,27,51,0,0,0,0,0,0,0,0,0,0,0,0,0,0,0,0,0,0,0,0,0,0,0,0,0,0,0,0,0,0,02663
622,7743,670,2232,2602,1451,788,322,252,215,42,15,158,37,19,19,0,0,18,0,0,18,70,70,10,0,60,0,0,0,0,0,0,0,0,0,02664
623,544,51,128,143,112,110,16,10,10,0,0,10,0,0,0,0,0,0,0,0,0,6,6,6,0,0,0,0,0,0,0,0,0,0,0,02666
624,2591,58,452,580,660,841,76,46,46,15,1,30,0,0,0,0,0,0,0,0,0,30,30,0,4,26,0,0,0,0,0,0,0,0,0,02667
625,2133,51,479,632,536,435,85,58,49,34,15,0,9,0,0,0,0,9,9,0,0,27,27,27,0,0,0,0,0,0,0,0,0,0,0,02668
626,183,4,8,90,39,42,0,0,0,0,0,0,0,0,0,0,0,0,0,0,0,0,0,0,0,0,0,0,0,0,0,0,0,0,0,02669
627,993,48,254,250,265,176,114,65,39,0,0,39,26,26,0,6,20,0,0,0,0,49,49,30,0,19,0,0,0,0,0,0,0,0,0,02670
628,686,70,126,205,150,135,27,15,0,0,0,0,15,15,0,0,15,0,0,0,0,12,12,0,12,0,0,0,0,0,0,0,0,0,0,02671
629,84,0,0,20,0,64,66,66,66,66,0,0,0,0,0,0,0,0,0,0,0,0,0,0,0,0,0,0,0,0,0,0,0,0,0,02672
630,6423,525,1700,2590,1080,528,232,95,25,22,0,3,70,44,44,0,0,26,0,0,26,137,112,21,0,91,25,0,0,0,0,25,0,0,25,02673
631,5269,170,1445,1554,1165,935,230,188,188,53,21,114,0,0,0,0,0,0,0,0,0,42,42,25,9,8,0,0,0,0,0,0,0,0,0,02675
632,3159,491,961,740,734,233,180,130,130,81,14,35,0,0,0,0,0,0,0,0,0,50,50,26,0,24,0,0,0,0,0,0,0,0,0,02702
633,30192,3620,8878,8604,6505,2585,1792,988,906,188,83,635,82,82,81,0,1,0,0,0,0,804,743,361,120,262,61,44,35,0,9,17,17,0,0,02703
634,109,26,21,41,6,15,5,5,5,0,0,5,0,0,0,0,0,0,0,0,0,0,0,0,0,0,0,0,0,0,0,0,0,0,0,02713
635,2028,160,648,458,537,225,245,134,134,32,17,85,0,0,0,0,0,0,0,0,0,111,38,21,17,0,73,39,39,0,0,34,0,34,0,02715
636,3048,366,1093,982,418,189,328,230,176,78,22,76,54,54,54,0,0,0,0,0,0,98,76,45,0,31,22,22,22,0,0,0,0,0,0,02717
637,4627,654,1551,1325,708,389,567,388,302,72,62,168,86,86,55,0,31,0,0,0,0,179,154,12,0,142,25,25,25,0,0,0,0,0,0,02718
638,11882,1911,3572,3405,1899,1095,771,352,289,107,23,159,63,63,63,0,0,0,0,0,0,419,356,186,38,132,63,63,0,0,63,0,0,0,0,02719
639,22035,5062,6855,5737,2917,1464,1376,878,736,172,141,423,142,65,29,26,10,77,47,0,30,498,445,98,48,299,53,50,39,11,0,3,0,0,3,02720
640,17479,5620,5665,4416,1205,573,1090,500,363,36,26,301,137,75,34,41,0,62,9,12,41,590,539,222,33,284,51,21,21,0,0,30,15,0,15,02721
641,9747,3250,2986,2544,709,258,563,291,242,13,92,137,49,15,0,15,0,34,0,34,0,272,219,60,9,150,53,33,26,0,7,20,0,0,20,02723
642,11673,4225,3632,2573,926,317,943,578,466,142,131,193,112,46,33,0,13,66,0,59,7,365,297,156,0,141,68,11,0,0,11,57,0,57,0,02724
643,2253,584,604,695,194,176,36,0,0,0,0,0,0,0,0,0,0,0,0,0,0,36,36,36,0,0,0,0,0,0,0,0,0,0,0,02725
644,11189,1422,3125,3372,2041,1229,985,486,447,104,39,304,39,39,39,0,0,0,0,0,0,499,484,111,84,289,15,15,15,0,0,0,0,0,0,02726
645,3667,213,772,1075,835,772,199,110,110,45,0,65,0,0,0,0,0,0,0,0,0,89,82,39,0,43,7,0,0,0,0,7,0,0,7,02738
646,4119,278,1032,923,1062,824,346,232,222,42,7,173,10,10,0,0,10,0,0,0,0,114,102,75,17,10,12,0,0,0,0,12,12,0,0,02739
647,28930,7767,9172,7196,3186,1609,2044,1013,809,240,158,411,204,79,45,10,24,125,48,22,55,1031,732,160,84,488,299,183,138,18,27,116,0,38,78,02740
648,7455,1396,2784,1747,1108,420,509,299,251,71,31,149,48,26,26,0,0,22,11,0,11,210,199,79,0,120,11,0,0,0,0,11,11,0,0,02743
649,7690,2858,2398,1427,730,277,504,238,143,11,19,113,95,83,9,22,52,12,0,12,0,266,242,28,7,207,24,24,0,11,13,0,0,0,0,02744
650,17376,4321,5772,4290,2125,868,1574,796,592,168,113,311,204,192,178,14,0,12,0,12,0,778,571,267,44,260,207,160,109,0,51,47,40,7,0,02745
651,9561,3868,3191,1809,497,196,632,324,251,27,60,164,73,26,10,10,6,47,0,0,47,308,253,70,18,165,55,11,11,0,0,44,0,44,0,02746
652,14069,2900,4183,3596,2238,1152,2515,1324,1257,387,137,733,67,30,14,0,16,37,19,0,18,1191,1140,505,60,575,51,44,44,0,0,7,0,0,7,02747
653,9440,1612,2614,2104,1593,1517,533,249,220,52,27,141,29,29,0,0,29,0,0,0,0,284,238,71,14,153,46,46,46,0,0,0,0,0,0,02748
654,17305,947,4228,4796,4433,2901,1445,959,781,360,101,320,178,157,27,130,0,21,0,21,0,486,417,210,0,207,69,69,48,21,0,0,0,0,0,02760
655,5948,454,1384,1610,1736,764,229,114,91,51,0,40,23,23,0,23,0,0,0,0,0,115,115,53,0,62,0,0,0,0,0,0,0,0,0,02762
656,1069,38,152,355,283,241,164,85,53,27,0,26,32,32,32,0,0,0,0,0,0,79,79,24,0,55,0,0,0,0,0,0,0,0,0,02763
657,2731,272,883,677,596,303,203,85,85,60,0,25,0,0,0,0,0,0,0,0,0,118,88,51,0,37,30,30,30,0,0,0,0,0,0,02764
658,11931,594,3422,3723,2698,1494,1874,726,693,203,42,448,33,33,15,0,18,0,0,0,0,1148,1111,327,103,681,37,13,13,0,0,24,24,0,0,02766
659,9171,677,2817,2604,2103,970,829,384,306,104,21,181,78,78,0,15,63,0,0,0,0,445,370,265,38,67,75,75,28,23,24,0,0,0,0,02767
660,8123,559,2056,2542,1701,1265,690,285,226,44,48,134,59,59,42,17,0,0,0,0,0,405,344,121,20,203,61,61,61,0,0,0,0,0,0,02769
661,3579,315,938,905,924,497,205,129,117,29,6,82,12,12,12,0,0,0,0,0,0,76,76,44,0,32,0,0,0,0,0,0,0,0,0,02770
662,9719,916,3102,2787,1897,1017,826,392,336,94,44,198,56,56,0,0,56,0,0,0,0,434,434,124,38,272,0,0,0,0,0,0,0,0,0,02771
663,11818,1361,3791,3864,1788,1014,710,284,268,52,94,122,16,16,16,0,0,0,0,0,0,426,417,180,80,157,9,0,0,0,0,9,0,0,9,02777
664,4178,539,1378,1162,754,345,368,194,183,54,37,92,11,11,0,0,11,0,0,0,0,174,112,47,30,35,62,30,22,0,8,32,0,0,32,02779
665,34593,6963,12091,9584,4132,1823,2291,1272,950,248,173,529,322,265,188,45,32,57,20,25,12,1019,832,403,187,242,187,120,108,0,12,67,28,7,32,02780
666,11895,1782,3704,2968,1853,1588,629,257,219,87,37,95,38,26,26,0,0,12,0,12,0,372,361,105,55,201,11,11,11,0,0,0,0,0,0,02790
667,80,8,0,11,31,30,0,0,0,0,0,0,0,0,0,0,0,0,0,0,0,0,0,0,0,0,0,0,0,0,0,0,0,0,0,02791
668,592,0,160,252,152,28,82,0,0,0,0,0,0,0,0,0,0,0,0,0,0,82,82,52,0,30,0,0,0,0,0,0,0,0,0,02802
669,2035,177,784,684,301,89,52,30,30,19,11,0,0,0,0,0,0,0,0,0,0,22,0,0,0,0,22,22,22,0,0,0,0,0,0,02804
670,10765,345,1253,1944,3238,3985,1121,547,496,124,6,366,51,43,32,11,0,8,8,0,0,574,531,138,63,330,43,33,3,28,2,10,0,0,10,02806
671,703,9,129,186,259,120,26,12,12,4,0,8,0,0,0,0,0,0,0,0,0,14,14,0,4,10,0,0,0,0,0,0,0,0,0,02807
672,1477,192,663,350,238,34,106,81,33,19,0,14,48,48,38,10,0,0,0,0,0,25,20,20,0,0,5,5,5,0,0,0,0,0,0,02808
673,15333,2081,3829,4038,3500,1885,1894,999,914,317,37,560,85,63,41,22,0,22,22,0,0,895,879,222,55,602,16,9,9,0,0,7,0,0,7,02809
674,1122,44,178,328,328,244,167,125,125,18,0,107,0,0,0,0,0,0,0,0,0,42,42,21,21,0,0,0,0,0,0,0,0,0,0,02812
675,5573,289,1669,1489,1222,904,276,88,66,0,0,66,22,22,0,22,0,0,0,0,0,188,158,25,10,123,30,17,0,0,17,13,0,0,13,02813
676,5326,494,1530,1758,995,549,262,183,123,24,30,69,60,52,52,0,0,8,0,0,8,79,79,20,8,51,0,0,0,0,0,0,0,0,0,02814
677,171,0,17,40,114,0,0,0,0,0,0,0,0,0,0,0,0,0,0,0,0,0,0,0,0,0,0,0,0,0,0,0,0,0,0,02815
678,22885,2172,7533,7276,3677,2227,1749,899,726,199,78,449,173,102,96,6,0,71,60,11,0,850,729,236,170,323,121,121,112,0,9,0,0,0,0,02816
679,4073,187,1297,1264,852,473,243,138,104,11,13,80,34,34,0,34,0,0,0,0,0,105,105,43,0,62,0,0,0,0,0,0,0,0,0,02817
680,12992,424,2284,2999,3940,3345,838,380,356,84,26,246,24,24,24,0,0,0,0,0,0,458,451,109,28,314,7,7,7,0,0,0,0,0,0,02818
681,4348,390,1269,1195,841,653,396,242,229,35,44,150,13,0,0,0,0,13,0,0,13,154,122,15,6,101,32,32,27,0,5,0,0,0,0,02822
682,3740,360,1112,1089,695,484,346,178,150,59,19,72,28,28,19,9,0,0,0,0,0,168,168,117,8,43,0,0,0,0,0,0,0,0,0,02825
683,438,0,229,109,100,0,0,0,0,0,0,0,0,0,0,0,0,0,0,0,0,0,0,0,0,0,0,0,0,0,0,0,0,0,0,02826
684,1579,104,455,555,306,159,120,79,53,23,0,30,26,26,15,0,11,0,0,0,0,41,41,15,0,26,0,0,0,0,0,0,0,0,0,02827
685,5555,458,1453,1554,1196,894,427,187,175,64,8,103,12,12,0,12,0,0,0,0,0,240,240,105,30,105,0,0,0,0,0,0,0,0,0,02828
686,4884,712,1641,1341,835,355,126,58,58,36,0,22,0,0,0,0,0,0,0,0,0,68,57,14,0,43,11,11,11,0,0,0,0,0,0,02830
687,2204,250,661,628,436,229,178,58,58,32,0,26,0,0,0,0,0,0,0,0,0,120,88,9,0,79,32,32,0,32,0,0,0,0,0,02831
688,3643,361,1124,1169,725,264,370,173,138,84,0,54,35,35,35,0,0,0,0,0,0,197,197,41,0,156,0,0,0,0,0,0,0,0,0,02832
689,449,9,134,219,30,57,0,0,0,0,0,0,0,0,0,0,0,0,0,0,0,0,0,0,0,0,0,0,0,0,0,0,0,0,0,02833
690,4040,68,567,898,1131,1376,392,220,194,129,12,53,26,26,26,0,0,0,0,0,0,172,172,17,12,143,0,0,0,0,0,0,0,0,0,02835
691,76,0,15,14,30,17,0,0,0,0,0,0,0,0,0,0,0,0,0,0,0,0,0,0,0,0,0,0,0,0,0,0,0,0,0,02836
692,2607,110,593,736,648,520,152,51,51,18,9,24,0,0,0,0,0,0,0,0,0,101,101,38,9,54,0,0,0,0,0,0,0,0,0,02837
693,2337,418,708,629,389,193,135,91,72,16,0,56,19,0,0,0,0,19,0,0,19,44,34,0,0,34,10,10,0,0,10,0,0,0,0,02838
694,1049,234,335,238,167,75,150,21,12,0,0,12,9,0,0,0,0,9,0,0,9,129,78,25,0,53,51,0,0,0,0,51,18,33,0,02839
695,16313,1546,3343,3775,4487,3162,1865,576,465,105,36,324,111,14,14,0,0,97,97,0,0,1289,1196,603,86,507,93,43,34,0,9,50,34,0,16,02840
696,668,0,7,99,314,248,117,99,87,80,0,7,12,12,12,0,0,0,0,0,0,18,10,10,0,0,8,8,8,0,0,0,0,0,0,02841
697,11123,708,2689,3366,2488,1872,564,292,292,99,10,183,0,0,0,0,0,0,0,0,0,272,222,66,39,117,50,38,14,12,12,12,6,6,0,02842
698,15581,933,3091,4048,4514,2995,1262,637,609,166,74,369,28,25,17,0,8,3,0,0,3,625,604,156,57,391,21,15,4,0,11,6,0,0,6,02852
699,6553,461,2006,1910,1267,909,335,184,172,78,0,94,12,12,12,0,0,0,0,0,0,151,135,51,14,70,16,16,16,0,0,0,0,0,0,02857
700,445,27,126,202,90,0,0,0,0,0,0,0,0,0,0,0,0,0,0,0,0,0,0,0,0,0,0,0,0,0,0,0,0,0,0,02858
701,4991,765,1785,1554,580,307,434,252,200,28,51,121,52,42,35,7,0,10,10,0,0,182,182,119,0,63,0,0,0,0,0,0,0,0,0,02859
702,29046,7927,8760,7255,3162,1942,2016,1033,746,95,154,497,287,147,67,32,48,140,76,29,35,983,797,303,84,410,186,133,102,0,31,53,16,12,25,02860
703,19551,3392,6458,6122,2767,812,1087,593,441,153,47,241,152,104,22,76,6,48,7,25,16,494,422,179,58,185,72,21,21,0,0,51,20,6,25,02861
704,11113,5308,2904,2062,569,270,1169,529,366,127,49,190,163,97,19,53,25,66,10,6,50,640,479,134,29,316,161,100,54,24,22,61,20,0,41,02863
705,23824,2620,5814,6700,5371,3319,1732,801,724,155,23,546,77,45,14,0,31,32,30,0,2,931,866,388,61,417,65,32,9,22,1,33,0,0,33,02864
706,12203,992,2833,3323,2966,2089,594,322,311,86,30,195,11,11,11,0,0,0,0,0,0,272,227,109,49,69,45,38,21,17,0,7,0,7,0,02865
707,12291,653,2879,2662,3479,2618,814,550,497,112,43,342,53,53,24,9,20,0,0,0,0,264,243,91,39,113,21,19,11,0,8,2,0,0,2,02871
708,130,0,45,0,42,43,0,0,0,0,0,0,0,0,0,0,0,0,0,0,0,0,0,0,0,0,0,0,0,0,0,0,0,0,0,02872
709,181,0,100,61,20,0,0,0,0,0,0,0,0,0,0,0,0,0,0,0,0,0,0,0,0,0,0,0,0,0,0,0,0,0,0,02873
710,3787,147,541,718,1365,1016,241,153,132,30,17,85,21,21,21,0,0,0,0,0,0,88,88,19,11,58,0,0,0,0,0,0,0,0,0,02874
711,336,70,112,108,0,46,0,0,0,0,0,0,0,0,0,0,0,0,0,0,0,0,0,0,0,0,0,0,0,0,0,0,0,0,0,02875
712,193,0,73,86,20,14,0,0,0,0,0,0,0,0,0,0,0,0,0,0,0,0,0,0,0,0,0,0,0,0,0,0,0,0,0,02876
713,11617,1217,3330,3236,2417,1417,732,445,395,216,55,124,50,40,23,17,0,10,0,10,0,287,287,77,63,147,0,0,0,0,0,0,0,0,0,02878
714,14503,724,2693,3633,4294,3159,940,540,516,203,51,262,24,24,24,0,0,0,0,0,0,400,350,135,0,215,50,50,33,0,17,0,0,0,0,02879
715,1812,49,143,229,680,711,3945,1614,1591,504,32,1055,23,23,19,0,4,0,0,0,0,2331,2331,752,157,1422,0,0,0,0,0,0,0,0,0,02881
716,8745,367,1521,1933,2684,2240,1027,563,553,299,50,204,10,0,0,0,0,10,0,0,10,464,426,201,14,211,38,38,38,0,0,0,0,0,0,02882
717,7594,1004,2547,1928,1343,772,445,238,205,68,52,85,33,33,21,12,0,0,0,0,0,207,161,28,11,122,46,23,23,0,0,23,0,0,23,02885
718,21910,2413,5827,6942,4244,2484,1040,555,423,148,61,214,132,110,93,0,17,22,0,22,0,485,464,114,48,302,21,21,20,0,1,0,0,0,0,02886
719,14148,1093,4524,4559,2362,1610,928,485,407,127,66,214,78,5,5,0,0,73,0,35,38,443,367,139,81,147,76,73,49,24,0,3,0,0,3,02888
720,20664,2028,6603,6521,3832,1680,1418,693,586,156,145,285,107,75,61,6,8,32,0,12,20,725,661,269,107,285,64,49,29,14,6,15,0,15,0,02889
721,15416,1914,4123,4508,3120,1751,751,292,282,140,14,128,10,10,10,0,0,0,0,0,0,459,365,97,59,209,94,41,31,10,0,53,0,0,53,02891
722,3283,356,895,687,782,563,140,76,76,16,9,51,0,0,0,0,0,0,0,0,0,64,64,17,0,47,0,0,0,0,0,0,0,0,0,02892
723,21221,3087,6984,6488,3232,1430,1282,624,548,115,129,304,76,65,51,10,4,11,0,9,2,658,477,120,57,300,181,149,81,68,0,32,0,0,32,02893
724,344,43,90,107,63,41,19,0,0,0,0,0,0,0,0,0,0,0,0,0,0,19,0,0,0,0,19,19,19,0,0,0,0,0,0,02894
725,27298,6570,9412,7604,2678,1034,2045,1050,766,138,52,576,284,193,67,17,109,91,0,0,91,995,710,193,81,436,285,205,118,23,64,80,9,0,71,02895
726,8577,987,2522,2560,1590,918,554,306,279,74,30,175,27,13,0,13,0,14,0,0,14,248,236,70,24,142,12,0,0,0,0,12,12,0,0,02896
727,897,110,343,190,181,73,86,59,53,0,0,53,6,0,0,0,0,6,0,0,6,27,27,12,0,15,0,0,0,0,0,0,0,0,0,02898
728,5944,1395,1116,954,1270,1209,1576,602,602,280,33,289,0,0,0,0,0,0,0,0,0,974,920,517,143,260,54,46,0,0,46,8,0,0,8,02903
729,20514,3307,5567,6785,3067,1788,1058,621,565,192,148,225,56,12,12,0,0,44,0,0,44,437,293,159,20,114,144,71,29,0,42,73,30,41,2,02904
730,14229,3271,3518,3507,2103,1830,2427,1119,948,212,155,581,171,80,16,47,17,91,60,7,24,1308,1166,478,86,602,142,64,8,22,34,78,0,41,37,02905
731,17864,923,1546,2314,5687,7394,2706,1245,1166,356,84,726,79,68,6,62,0,11,0,0,11,1461,1424,425,138,861,37,37,29,8,0,0,0,0,0,02906
732,15961,5462,4220,4170,1352,757,1995,831,667,93,111,463,164,106,5,20,81,58,42,0,16,1164,979,153,128,698,185,113,57,0,56,72,18,23,31,02907
733,20344,5002,4885,5247,2915,2295,4031,1883,1666,318,213,1135,217,123,27,63,33,94,38,39,17,2148,1949,530,98,1321,199,98,70,20,8,101,25,19,57,02908
734,25405,10362,7184,4585,2336,938,2885,1718,1163,108,115,940,555,182,100,13,69,373,127,81,165,1167,917,167,113,637,250,119,88,30,1,131,8,66,57,02909
735,14065,2012,4158,3673,2870,1352,1111,606,483,106,48,329,123,83,42,18,23,40,29,0,11,505,448,99,102,247,57,52,23,0,29,5,5,0,0,02910
736,11283,1228,3349,3317,2239,1150,1037,402,373,115,23,235,29,29,0,0,29,0,0,0,0,635,635,325,24,286,0,0,0,0,0,0,0,0,0,02911
737,29,0,0,5,15,9,965,449,449,112,0,337,0,0,0,0,0,0,0,0,0,516,516,179,24,313,0,0,0,0,0,0,0,0,0,02912
738,15383,4115,5145,3649,1640,834,994,491,398,84,98,216,93,50,0,50,0,43,33,0,10,503,422,218,71,133,81,0,0,0,0,81,15,66,0,02914
739,12404,1561,3617,3472,2511,1243,358,180,167,26,8,133,13,13,8,0,5,0,0,0,0,178,140,56,0,84,38,12,12,0,0,26,16,0,10,02915
740,6493,649,1666,1637,1497,1044,332,248,219,87,0,132,29,12,12,0,0,17,0,14,3,84,73,21,17,35,11,0,0,0,0,11,0,0,11,02916
741,8197,611,2036,2862,1609,1079,2228,1191,1123,277,34,812,68,23,23,0,0,45,45,0,0,1037,1012,399,91,522,25,25,24,0,1,0,0,0,0,02917
742,21345,3298,7353,5675,3462,1557,1338,635,488,203,31,254,147,37,21,0,16,110,13,18,79,703,683,368,12,303,20,20,20,0,0,0,0,0,0,02919
743,28386,4305,9327,8046,4201,2507,1748,957,793,189,73,531,164,119,13,44,62,45,0,7,38,791,675,274,50,351,116,64,19,6,39,52,0,0,52,02920
744,8041,596,2170,1897,2191,1187,792,400,388,92,24,272,12,12,0,0,12,0,0,0,0,392,382,60,79,243,10,0,0,0,0,10,0,0,10,02921
745,7545,260,977,1655,2823,1830,579,306,299,71,38,190,7,7,0,0,7,0,0,0,0,273,273,74,34,165,0,0,0,0,0,0,0,0,0,03031
746,3417,155,1041,1071,762,388,198,122,113,58,26,29,9,0,0,0,0,9,0,0,9,76,76,10,9,57,0,0,0,0,0,0,0,0,0,03032
747,3258,76,858,866,887,571,397,269,269,104,8,157,0,0,0,0,0,0,0,0,0,128,117,35,0,82,11,11,11,0,0,0,0,0,0,03033
748,2965,147,1005,869,688,256,225,110,110,35,0,75,0,0,0,0,0,0,0,0,0,115,115,42,8,65,0,0,0,0,0,0,0,0,0,03034
749,3269,185,864,1141,700,379,279,172,136,36,0,100,36,19,19,0,0,17,0,0,17,107,107,36,34,37,0,0,0,0,0,0,0,0,0,03036
750,2997,138,905,944,646,364,246,119,119,53,0,66,0,0,0,0,0,0,0,0,0,127,97,45,0,52,30,30,30,0,0,0,0,0,0,03037
751,22968,1300,8274,7240,4161,1993,2093,968,794,266,83,445,174,155,45,52,58,19,17,2,0,1125,1018,357,54,607,107,98,98,0,0,9,0,0,9,03038
752,4595,363,1335,1625,843,429,319,135,116,25,0,91,19,19,19,0,0,0,0,0,0,184,184,119,0,65,0,0,0,0,0,0,0,0,0,03042
753,1150,51,214,375,282,228,69,39,32,6,0,26,7,7,0,0,7,0,0,0,0,30,17,4,4,9,13,13,13,0,0,0,0,0,0,03043
754,3075,271,919,1055,614,216,211,82,65,11,21,33,17,17,11,6,0,0,0,0,0,129,129,36,40,53,0,0,0,0,0,0,0,0,0,03044
755,9473,826,2760,2842,2038,1007,905,477,444,111,26,307,33,33,33,0,0,0,0,0,0,428,411,210,30,171,17,12,0,0,12,5,0,0,5,03045
756,1965,39,585,545,463,333,154,71,71,7,13,51,0,0,0,0,0,0,0,0,0,83,83,13,0,70,0,0,0,0,0,0,0,0,0,03046
757,1070,81,236,370,284,99,79,34,26,8,0,18,8,4,0,0,4,4,0,0,4,45,39,22,7,10,6,6,6,0,0,0,0,0,0,03047
758,2373,324,901,613,383,152,233,108,47,27,8,12,61,41,18,19,4,20,20,0,0,125,110,28,23,59,15,12,12,0,0,3,0,0,3,03048
759,5354,137,905,1034,1732,1546,450,198,198,16,12,170,0,0,0,0,0,0,0,0,0,252,252,72,17,163,0,0,0,0,0,0,0,0,0,03049
760,16841,1243,4699,5346,3812,1741,1229,733,616,355,43,218,117,66,66,0,0,51,0,38,13,496,430,199,25,206,66,66,36,0,30,0,0,0,0,03051
761,5509,432,1241,1920,1406,510,546,321,310,79,60,171,11,11,11,0,0,0,0,0,0,225,198,48,0,150,27,27,12,0,15,0,0,0,0,03052
762,15696,733,3831,4452,4227,2453,1622,805,735,318,105,312,70,53,13,18,22,17,0,17,0,817,797,398,73,326,20,20,20,0,0,0,0,0,0,03053
763,18333,721,5053,4941,5188,2430,1422,896,854,320,88,446,42,42,42,0,0,0,0,0,0,526,502,267,43,192,24,24,9,15,0,0,0,0,0,03054
764,10485,416,2990,3203,2668,1208,784,484,409,145,51,213,75,32,16,0,16,43,10,33,0,300,284,141,51,92,16,16,16,0,0,0,0,0,0,03055
765,1694,54,436,404,465,335,199,100,97,20,7,70,3,3,0,3,0,0,0,0,0,99,90,54,14,22,9,9,6,3,0,0,0,0,0,03057
766,19419,3139,6031,5871,2840,1538,1355,570,477,122,79,276,93,70,25,45,0,23,0,9,14,785,738,437,52,249,47,47,0,0,47,0,0,0,0,03060
767,19267,1686,4257,5460,4817,3047,1309,673,467,196,0,271,206,206,103,103,0,0,0,0,0,636,502,218,91,193,134,97,97,0,0,37,0,0,37,03062
768,11046,736,2487,2750,3193,1880,876,414,391,143,29,219,23,23,0,23,0,0,0,0,0,462,450,166,7,277,12,12,12,0,0,0,0,0,0,03063
769,9954,1317,2451,2912,2039,1235,661,357,296,97,37,162,61,47,31,16,0,14,0,14,0,304,251,96,24,131,53,14,0,0,14,39,0,25,14,03064
770,3635,169,871,1207,1017,371,191,86,73,42,0,31,13,13,0,13,0,0,0,0,0,105,105,20,0,85,0,0,0,0,0,0,0,0,0,03070
771,3375,354,985,938,594,504,297,227,170,59,17,94,57,57,57,0,0,0,0,0,0,70,45,0,0,45,25,0,0,0,0,25,25,0,0,03071
772,8590,634,2918,2511,1728,799,683,347,296,96,17,183,51,51,31,10,10,0,0,0,0,336,314,154,11,149,22,22,14,0,8,0,0,0,0,03076
773,7143,794,2654,2087,1222,386,556,313,271,128,87,56,42,42,25,17,0,0,0,0,0,243,209,67,33,109,34,34,20,14,0,0,0,0,0,03077
774,20356,1423,6856,5814,4430,1833,1572,718,568,95,127,346,150,133,78,55,0,17,17,0,0,854,732,464,12,256,122,106,77,23,6,16,0,0,16,03079
775,1128,78,349,299,298,104,67,19,15,4,0,11,4,4,0,0,4,0,0,0,0,48,48,20,9,19,0,0,0,0,0,0,0,0,0,03082
776,1105,79,401,294,198,133,91,32,27,7,0,20,5,5,0,0,5,0,0,0,0,59,54,8,5,41,5,5,0,5,0,0,0,0,0,03084
777,2625,154,789,949,453,280,124,62,44,9,7,28,18,9,9,0,0,9,0,9,0,62,49,21,8,20,13,13,13,0,0,0,0,0,0,03086
778,9240,334,1842,2080,3013,1971,637,363,336,74,11,251,27,27,0,27,0,0,0,0,0,274,274,112,25,137,0,0,0,0,0,0,0,0,0,03087
779,2086,210,629,511,442,294,82,71,71,25,0,46,0,0,0,0,0,0,0,0,0,11,11,0,0,11,0,0,0,0,0,0,0,0,0,03101
780,21265,3046,7251,6170,3554,1244,2132,1023,862,235,118,509,161,133,9,96,28,28,0,0,28,1109,992,447,88,457,117,53,53,0,0,64,16,48,0,03102
781,23774,4329,8634,6356,3311,1144,2162,1299,985,204,131,650,314,260,164,86,10,54,18,5,31,863,718,224,36,458,145,64,22,19,23,81,23,53,5,03103
782,23182,2413,6581,6182,5012,2994,1678,831,753,268,28,457,78,43,16,27,0,35,17,3,15,847,790,393,57,340,57,22,13,9,0,35,4,0,31,03104
783,9181,665,2485,2839,2299,893,1023,523,465,214,67,184,58,41,24,17,0,17,17,0,0,500,435,154,27,254,65,46,46,0,0,19,19,0,0,03106
784,6955,334,2300,2287,1303,731,430,326,326,97,38,191,0,0,0,0,0,0,0,0,0,104,89,51,0,38,15,15,0,15,0,0,0,0,0,03109
785,14166,658,2522,3068,4571,3347,1236,716,705,183,51,471,11,0,0,0,0,11,0,0,11,520,505,198,0,307,15,15,15,0,0,0,0,0,0,03110
786,201,1,35,34,64,67,0,0,0,0,0,0,0,0,0,0,0,0,0,0,0,0,0,0,0,0,0,0,0,0,0,0,0,0,0,03215
787,1552,114,564,416,317,141,91,34,34,3,0,31,0,0,0,0,0,0,0,0,0,57,53,36,0,17,4,4,4,0,0,0,0,0,0,03216
788,1253,110,420,379,272,72,73,13,13,13,0,0,0,0,0,0,0,0,0,0,0,60,36,9,0,27,24,24,0,0,24,0,0,0,0,03217
789,633,30,309,115,148,31,49,49,49,11,0,38,0,0,0,0,0,0,0,0,0,0,0,0,0,0,0,0,0,0,0,0,0,0,0,03218
790,4815,646,1814,1462,623,270,554,209,198,79,0,119,11,0,0,0,0,11,0,0,11,345,303,55,17,231,42,42,42,0,0,0,0,0,0,03220
791,1500,125,405,451,330,189,102,48,38,25,0,13,10,10,0,10,0,0,0,0,0,54,54,18,2,34,0,0,0,0,0,0,0,0,0,03221
792,4186,349,1543,1292,728,274,179,47,33,27,0,6,14,14,0,14,0,0,0,0,0,132,94,14,0,80,38,12,12,0,0,26,0,26,0,03222
793,2516,224,674,825,439,354,115,29,14,0,0,14,15,15,15,0,0,0,0,0,0,86,14,1,0,13,72,72,0,0,72,0,0,0,0,03223
794,1658,63,343,412,479,361,70,39,29,20,0,9,10,10,4,6,0,0,0,0,0,31,31,10,0,21,0,0,0,0,0,0,0,0,0,03224
795,2787,168,872,1041,512,194,198,123,109,26,0,83,14,14,14,0,0,0,0,0,0,75,46,9,17,20,29,20,20,0,0,9,9,0,0,03225
796,785,25,184,223,226,127,35,17,3,0,0,3,14,14,9,5,0,0,0,0,0,18,18,9,0,9,0,0,0,0,0,0,0,0,0,03226
797,789,17,149,219,195,209,23,8,8,3,0,5,0,0,0,0,0,0,0,0,0,15,15,0,0,15,0,0,0,0,0,0,0,0,0,03227
798,3883,118,781,769,1464,751,330,245,214,87,10,117,31,31,31,0,0,0,0,0,0,85,69,28,0,41,16,16,16,0,0,0,0,0,0,03229
799,1012,164,356,340,80,72,52,28,17,5,0,12,11,11,0,11,0,0,0,0,0,24,19,0,0,19,5,5,5,0,0,0,0,0,0,03230
800,293,18,123,48,20,84,0,0,0,0,0,0,0,0,0,0,0,0,0,0,0,0,0,0,0,0,0,0,0,0,0,0,0,0,0,03231
801,64,0,7,0,57,0,20,9,0,0,0,0,9,9,0,0,9,0,0,0,0,11,11,11,0,0,0,0,0,0,0,0,0,0,0,03233
802,3522,391,1193,985,653,300,165,102,64,43,0,21,38,37,32,0,5,1,0,1,0,63,27,20,0,7,36,36,36,0,0,0,0,0,0,03234
803,6094,880,2182,1937,743,352,388,211,184,16,11,157,27,14,8,0,6,13,0,13,0,177,138,65,0,73,39,24,17,0,7,15,0,0,15,03235
804,1599,126,414,634,231,194,67,44,44,11,26,7,0,0,0,0,0,0,0,0,0,23,23,7,9,7,0,0,0,0,0,0,0,0,0,03237
805,53,3,15,27,8,0,0,0,0,0,0,0,0,0,0,0,0,0,0,0,0,0,0,0,0,0,0,0,0,0,0,0,0,0,0,03238
806,967,81,375,275,165,71,87,50,38,11,0,27,12,0,0,0,0,12,0,0,12,37,37,0,0,37,0,0,0,0,0,0,0,0,0,03240
807,621,58,198,177,118,70,55,23,23,20,0,3,0,0,0,0,0,0,0,0,0,32,32,10,0,22,0,0,0,0,0,0,0,0,0,03241
808,2580,187,553,671,616,553,659,268,268,54,11,203,0,0,0,0,0,0,0,0,0,391,391,109,0,282,0,0,0,0,0,0,0,0,0,03242
809,824,71,385,248,68,52,96,51,42,0,8,34,9,9,9,0,0,0,0,0,0,45,41,21,3,17,4,0,0,0,0,4,0,4,0,03243
810,5436,596,1617,1926,780,517,372,211,189,106,10,73,22,18,4,14,0,4,4,0,0,161,151,102,4,45,10,0,0,0,0,10,0,0,10,03244
811,1266,61,285,238,388,294,77,42,23,23,0,0,19,19,9,10,0,0,0,0,0,35,35,16,0,19,0,0,0,0,0,0,0,0,0,03245
812,11635,1445,4103,3501,1823,763,569,258,200,40,10,150,58,52,38,0,14,6,0,0,6,311,295,98,28,169,16,0,0,0,0,16,0,0,16,03246
813,5267,321,1316,1486,1271,873,529,272,243,78,35,130,29,13,0,0,13,16,16,0,0,257,257,114,9,134,0,0,0,0,0,0,0,0,0,03249
814,870,140,393,197,101,39,80,54,45,6,21,18,9,0,0,0,0,9,0,9,0,26,26,0,0,26,0,0,0,0,0,0,0,0,0,03251
815,4668,402,1158,1617,886,605,351,182,175,39,0,136,7,0,0,0,0,7,7,0,0,169,169,5,15,149,0,0,0,0,0,0,0,0,0,03253
816,3341,95,914,962,847,523,123,65,65,9,7,49,0,0,0,0,0,0,0,0,0,58,16,16,0,0,42,42,42,0,0,0,0,0,0,03254
817,1472,57,363,475,321,256,102,51,51,26,0,25,0,0,0,0,0,0,0,0,0,51,51,25,0,26,0,0,0,0,0,0,0,0,0,03255
818,1545,124,427,438,307,249,173,81,65,23,0,42,16,16,10,6,0,0,0,0,0,92,85,60,8,17,7,7,0,0,7,0,0,0,0,03256
819,2964,68,281,656,1160,799,614,249,249,80,0,169,0,0,0,0,0,0,0,0,0,365,365,68,0,297,0,0,0,0,0,0,0,0,0,03257
820,1868,149,507,612,449,151,135,107,101,13,65,23,6,6,6,0,0,0,0,0,0,28,28,7,7,14,0,0,0,0,0,0,0,0,0,03258
821,235,12,50,40,61,72,8,5,5,0,0,5,0,0,0,0,0,0,0,0,0,3,3,0,0,3,0,0,0,0,0,0,0,0,0,03259
822,588,6,99,112,197,174,63,36,25,16,0,9,11,11,11,0,0,0,0,0,0,27,27,12,0,15,0,0,0,0,0,0,0,0,0,03260
823,3051,192,1061,878,546,374,200,100,87,41,0,46,13,0,0,0,0,13,0,13,0,100,59,0,19,40,41,31,0,0,31,10,0,0,10,03261
824,844,64,246,241,206,87,40,13,13,0,0,13,0,0,0,0,0,0,0,0,0,27,27,17,0,10,0,0,0,0,0,0,0,0,0,03262
825,2760,377,1048,728,452,155,245,124,117,8,0,109,7,7,7,0,0,0,0,0,0,121,82,11,42,29,39,39,39,0,0,0,0,0,0,03263
826,3490,320,767,834,839,730,1187,595,586,203,40,343,9,9,9,0,0,0,0,0,0,592,591,237,16,338,1,0,0,0,0,1,0,0,1,03264
827,1655,157,620,419,305,154,115,48,26,4,0,22,22,21,18,3,0,1,0,0,1,67,57,12,0,45,10,10,10,0,0,0,0,0,0,03266
828,924,30,370,319,133,72,50,22,22,3,0,19,0,0,0,0,0,0,0,0,0,28,28,3,0,25,0,0,0,0,0,0,0,0,0,03268
829,2249,154,619,749,457,270,108,54,43,17,0,26,11,11,11,0,0,0,0,0,0,54,54,15,7,32,0,0,0,0,0,0,0,0,0,03269
830,203,0,31,61,46,65,6,6,6,3,0,3,0,0,0,0,0,0,0,0,0,0,0,0,0,0,0,0,0,0,0,0,0,0,0,03273
831,7659,644,3001,2485,974,555,439,299,228,71,39,118,71,30,13,17,0,41,13,22,6,140,130,32,22,76,10,10,10,0,0,0,0,0,0,03275
832,5928,707,1995,1829,978,419,440,245,203,51,19,133,42,18,0,0,18,24,24,0,0,195,179,54,0,125,16,16,16,0,0,0,0,0,0,03276
833,2141,104,492,751,503,291,157,85,78,48,3,27,7,0,0,0,0,7,7,0,0,72,53,16,0,37,19,19,19,0,0,0,0,0,0,03278
834,512,68,217,148,63,16,27,0,0,0,0,0,0,0,0,0,0,0,0,0,0,27,15,6,0,9,12,12,7,5,0,0,0,0,0,03279
835,842,74,276,244,129,119,58,33,24,10,3,11,9,9,6,0,3,0,0,0,0,25,13,0,5,8,12,12,0,12,0,0,0,0,0,03280
836,5815,316,1553,2001,1491,454,367,179,179,41,35,103,0,0,0,0,0,0,0,0,0,188,162,64,14,84,26,26,26,0,0,0,0,0,0,03281
837,658,52,269,214,95,28,55,32,17,10,0,7,15,15,10,3,2,0,0,0,0,23,16,12,0,4,7,7,0,0,7,0,0,0,0,03282
838,765,32,247,245,155,86,70,58,39,16,4,19,19,19,6,0,13,0,0,0,0,12,12,2,7,3,0,0,0,0,0,0,0,0,0,03284
839,1919,175,471,469,493,311,95,57,42,26,16,0,15,7,0,7,0,8,0,8,0,38,38,16,0,22,0,0,0,0,0,0,0,0,0,03285
840,926,45,179,280,189,233,69,35,19,3,0,16,16,6,6,0,0,10,0,0,10,34,34,27,0,7,0,0,0,0,0,0,0,0,0,03287
841,3438,183,825,1213,688,529,155,95,62,16,0,46,33,33,33,0,0,0,0,0,0,60,60,39,0,21,0,0,0,0,0,0,0,0,0,03290
842,16,8,8,0,0,0,9,9,9,0,0,9,0,0,0,0,0,0,0,0,0,0,0,0,0,0,0,0,0,0,0,0,0,0,0,03291
843,70,0,25,38,3,4,0,0,0,0,0,0,0,0,0,0,0,0,0,0,0,0,0,0,0,0,0,0,0,0,0,0,0,0,0,03293
844,23006,1713,6217,6799,4694,3583,1648,763,636,267,68,301,127,105,93,0,12,22,14,4,4,885,779,241,99,439,106,106,63,0,43,0,0,0,0,03301
845,11416,1043,3511,3948,2053,861,627,288,256,65,76,115,32,32,17,0,15,0,0,0,0,339,279,137,22,120,60,33,22,11,0,27,27,0,0,03303
846,5139,259,958,1510,1421,991,594,335,309,74,29,206,26,26,26,0,0,0,0,0,0,259,232,76,14,142,27,16,0,11,5,11,11,0,0,03304
847,3603,283,1482,984,620,234,327,187,164,59,0,105,23,14,14,0,0,9,0,9,0,140,125,24,31,70,15,15,0,15,0,0,0,0,0,03307
848,16108,1321,4606,4374,3543,2264,2992,1135,1079,209,193,677,56,41,28,0,13,15,0,11,4,1857,1822,735,236,851,35,35,35,0,0,0,0,0,0,03431
849,1879,128,687,659,286,119,189,69,47,13,6,28,22,14,7,0,7,8,8,0,0,120,96,43,0,53,24,24,0,24,0,0,0,0,0,03440
850,327,43,127,119,9,29,65,46,26,0,0,26,20,0,0,0,0,20,0,20,0,19,11,0,0,11,8,8,8,0,0,0,0,0,0,03441
851,963,50,326,322,172,93,74,34,34,3,0,31,0,0,0,0,0,0,0,0,0,40,30,4,11,15,10,10,10,0,0,0,0,0,0,03442
852,654,35,265,144,114,96,23,0,0,0,0,0,0,0,0,0,0,0,0,0,0,23,23,11,0,12,0,0,0,0,0,0,0,0,0,03443
853,1209,107,433,242,238,189,104,51,48,13,4,31,3,3,3,0,0,0,0,0,0,53,44,22,0,22,9,9,9,0,0,0,0,0,0,03444
854,475,59,179,107,80,50,30,9,9,1,0,8,0,0,0,0,0,0,0,0,0,21,7,3,2,2,14,14,14,0,0,0,0,0,0,03445
855,4323,517,1605,1018,769,414,308,165,136,40,35,61,29,0,0,0,0,29,13,0,16,143,143,75,58,10,0,0,0,0,0,0,0,0,0,03446
856,1905,113,774,582,250,186,87,41,25,0,3,22,16,10,0,0,10,6,0,0,6,46,36,31,0,5,10,10,10,0,0,0,0,0,0,03447
857,542,60,216,131,81,54,27,18,9,3,0,6,9,9,9,0,0,0,0,0,0,9,7,3,2,2,2,2,0,2,0,0,0,0,0,03448
858,1325,40,238,251,443,353,68,28,28,10,0,18,0,0,0,0,0,0,0,0,0,40,40,6,3,31,0,0,0,0,0,0,0,0,0,03449
859,686,5,128,184,218,151,4,4,4,0,0,4,0,0,0,0,0,0,0,0,0,0,0,0,0,0,0,0,0,0,0,0,0,0,0,03450
860,2985,377,1405,891,202,110,145,88,71,10,8,53,17,7,7,0,0,10,0,0,10,57,57,22,0,35,0,0,0,0,0,0,0,0,0,03451
861,3801,374,1158,1265,678,326,393,222,148,66,0,82,74,74,74,0,0,0,0,0,0,171,88,59,20,9,83,83,83,0,0,0,0,0,0,03452
862,1446,95,431,436,299,185,91,12,12,12,0,0,0,0,0,0,0,0,0,0,0,79,74,12,0,62,5,5,5,0,0,0,0,0,0,03455
863,581,41,227,183,80,50,27,17,9,2,0,7,8,8,0,8,0,0,0,0,0,10,10,5,0,5,0,0,0,0,0,0,0,0,0,03456
864,539,5,107,141,147,139,47,18,18,15,0,3,0,0,0,0,0,0,0,0,0,29,15,5,2,8,14,11,3,0,8,3,0,0,3,03457
865,4934,119,889,979,1630,1317,208,116,96,19,0,77,20,20,20,0,0,0,0,0,0,92,92,63,2,27,0,0,0,0,0,0,0,0,0,03458
866,3148,246,1143,917,581,261,841,383,378,90,58,230,5,5,4,0,1,0,0,0,0,458,440,198,17,225,18,9,0,0,9,9,9,0,0,03461
867,1312,110,268,231,477,226,86,60,60,0,20,40,0,0,0,0,0,0,0,0,0,26,26,26,0,0,0,0,0,0,0,0,0,0,0,03462
868,767,25,269,211,143,119,41,3,3,3,0,0,0,0,0,0,0,0,0,0,0,38,38,26,0,12,0,0,0,0,0,0,0,0,0,03464
869,1547,159,625,468,230,65,117,89,89,24,8,57,0,0,0,0,0,0,0,0,0,28,28,12,16,0,0,0,0,0,0,0,0,0,0,03465
870,693,18,241,210,149,75,10,10,10,0,0,10,0,0,0,0,0,0,0,0,0,0,0,0,0,0,0,0,0,0,0,0,0,0,0,03466
871,1440,94,486,332,301,227,87,42,42,15,0,27,0,0,0,0,0,0,0,0,0,45,42,29,6,7,3,3,3,0,0,0,0,0,0,03467
872,3355,440,1639,666,382,228,174,108,53,0,0,53,55,46,21,21,4,9,9,0,0,66,40,10,11,19,26,0,0,0,0,26,26,0,0,03470
873,4294,709,1374,1079,697,435,198,92,92,43,15,34,0,0,0,0,0,0,0,0,0,106,106,50,0,56,0,0,0,0,0,0,0,0,0,03561
874,7375,1328,2903,2284,594,266,425,224,183,63,18,102,41,30,0,14,16,11,0,11,0,201,159,54,49,56,42,42,9,12,21,0,0,0,0,03570
875,1818,129,587,540,399,163,92,72,72,0,0,72,0,0,0,0,0,0,0,0,0,20,20,20,0,0,0,0,0,0,0,0,0,0,0,03574
876,62,0,11,35,7,9,0,0,0,0,0,0,0,0,0,0,0,0,0,0,0,0,0,0,0,0,0,0,0,0,0,0,0,0,0,03575
877,2591,459,1023,610,325,174,116,50,42,13,14,15,8,8,6,2,0,0,0,0,0,66,63,31,7,25,3,3,0,3,0,0,0,0,0,03576
878,355,51,157,105,32,10,15,6,6,4,0,2,0,0,0,0,0,0,0,0,0,9,9,3,0,6,0,0,0,0,0,0,0,0,0,03579
879,1156,29,167,280,375,305,100,45,43,28,0,15,2,2,0,2,0,0,0,0,0,55,40,34,0,6,15,15,3,0,12,0,0,0,0,03580
880,2276,204,786,764,323,199,172,103,92,13,0,79,11,11,11,0,0,0,0,0,0,69,69,7,21,41,0,0,0,0,0,0,0,0,0,03581
881,1770,241,805,510,185,29,230,125,100,20,26,54,25,20,17,3,0,5,0,5,0,105,69,6,6,57,36,16,16,0,0,20,0,0,20,03582
882,672,65,227,199,104,77,27,6,2,0,0,2,4,4,4,0,0,0,0,0,0,21,21,16,0,5,0,0,0,0,0,0,0,0,0,03583
883,2639,290,867,898,298,286,209,95,92,40,0,52,3,3,0,0,3,0,0,0,0,114,111,23,5,83,3,3,3,0,0,0,0,0,0,03584
884,1931,268,711,575,260,117,128,80,49,8,7,34,31,19,2,7,10,12,0,12,0,48,41,16,11,14,7,7,7,0,0,0,0,0,0,03585
885,457,5,78,143,140,91,16,7,7,2,0,5,0,0,0,0,0,0,0,0,0,9,9,0,3,6,0,0,0,0,0,0,0,0,0,03586
886,1288,171,486,373,149,109,50,30,24,17,3,4,6,6,5,0,1,0,0,0,0,20,17,12,0,5,3,3,0,3,0,0,0,0,0,03588
887,685,185,260,167,51,22,60,47,33,17,4,12,14,11,6,2,3,3,0,0,3,13,6,0,0,6,7,5,0,5,0,2,0,0,2,03590
888,1110,125,450,332,125,78,42,24,24,20,0,4,0,0,0,0,0,0,0,0,0,18,8,0,3,5,10,10,10,0,0,0,0,0,0,03592
889,379,12,98,99,100,70,20,10,10,0,0,10,0,0,0,0,0,0,0,0,0,10,4,3,0,1,6,6,3,0,3,0,0,0,0,03593
890,591,41,205,203,80,62,65,22,9,9,0,0,13,7,7,0,0,6,6,0,0,43,43,14,0,29,0,0,0,0,0,0,0,0,0,03595
891,273,69,114,83,4,3,21,4,4,0,4,0,0,0,0,0,0,0,0,0,0,17,17,9,4,4,0,0,0,0,0,0,0,0,0,03597
892,2466,326,915,743,338,144,112,75,73,24,0,49,2,2,2,0,0,0,0,0,0,37,37,16,2,19,0,0,0,0,0,0,0,0,0,03598
893,372,53,174,100,42,3,20,14,0,0,0,0,14,14,10,4,0,0,0,0,0,6,6,5,0,1,0,0,0,0,0,0,0,0,0,03601
894,1923,116,655,475,412,265,157,59,58,18,0,40,1,1,0,1,0,0,0,0,0,98,61,21,12,28,37,30,7,12,11,7,0,3,4,03602
895,4082,501,1860,1220,363,138,171,104,102,79,0,23,2,2,0,0,2,0,0,0,0,67,67,34,0,33,0,0,0,0,0,0,0,0,0,03603
896,131,0,71,13,24,23,0,0,0,0,0,0,0,0,0,0,0,0,0,0,0,0,0,0,0,0,0,0,0,0,0,0,0,0,0,03604
897,846,115,382,196,101,52,48,13,10,3,0,7,3,0,0,0,0,3,0,3,0,35,22,7,0,15,13,13,13,0,0,0,0,0,0,03605
898,238,16,111,58,33,20,19,16,14,4,0,10,2,2,0,2,0,0,0,0,0,3,3,3,0,0,0,0,0,0,0,0,0,0,0,03607
899,1683,85,548,396,513,141,67,42,42,0,15,27,0,0,0,0,0,0,0,0,0,25,25,9,7,9,0,0,0,0,0,0,0,0,0,03608
900,738,34,307,290,77,30,56,15,15,0,0,15,0,0,0,0,0,0,0,0,0,41,41,38,0,3,0,0,0,0,0,0,0,0,0,03609
901,542,52,219,123,90,58,34,28,19,4,5,10,9,9,4,5,0,0,0,0,0,6,6,0,0,6,0,0,0,0,0,0,0,0,0,03740
902,3255,288,1230,924,504,309,138,87,87,4,0,83,0,0,0,0,0,0,0,0,0,51,51,7,0,44,0,0,0,0,0,0,0,0,0,03741
903,9648,1270,4327,2610,1109,332,593,329,293,53,63,177,36,22,6,16,0,14,6,8,0,264,154,33,2,119,110,98,12,53,33,12,0,0,12,03743
904,1077,67,305,340,208,157,101,77,70,0,19,51,7,7,0,7,0,0,0,0,0,24,10,5,0,5,14,14,14,0,0,0,0,0,0,03745
905,117,3,43,38,18,15,3,0,0,0,0,0,0,0,0,0,0,0,0,0,0,3,3,0,0,3,0,0,0,0,0,0,0,0,0,03746
906,3554,227,1147,826,805,549,67,67,64,0,0,64,3,3,3,0,0,0,0,0,0,0,0,0,0,0,0,0,0,0,0,0,0,0,0,03748
907,711,43,72,207,159,230,95,87,87,20,11,56,0,0,0,0,0,0,0,0,0,8,8,0,0,8,0,0,0,0,0,0,0,0,0,03750
908,333,0,80,95,59,99,41,11,11,0,0,11,0,0,0,0,0,0,0,0,0,30,30,5,0,25,0,0,0,0,0,0,0,0,0,03751
909,579,100,209,129,103,38,17,1,1,0,0,1,0,0,0,0,0,0,0,0,0,16,16,2,0,14,0,0,0,0,0,0,0,0,0,03752
910,2193,95,526,402,654,516,145,72,57,3,0,54,15,15,0,15,0,0,0,0,0,73,68,26,6,36,5,5,0,5,0,0,0,0,0,03753
911,0,0,0,0,0,0,0,0,0,0,0,0,0,0,0,0,0,0,0,0,0,0,0,0,0,0,0,0,0,0,0,0,0,0,0,03754
912,4604,153,252,433,1677,2089,1889,1050,1032,204,40,788,18,18,0,0,18,0,0,0,0,839,839,275,12,552,0,0,0,0,0,0,0,0,0,03755
913,525,41,174,181,122,7,0,0,0,0,0,0,0,0,0,0,0,0,0,0,0,0,0,0,0,0,0,0,0,0,0,0,0,0,0,03765
914,7018,674,1696,1541,1488,1619,470,148,105,80,0,25,43,43,43,0,0,0,0,0,0,322,236,115,0,121,86,25,0,0,25,61,61,0,0,03766
915,1344,38,194,251,335,526,127,57,52,12,8,32,5,5,0,5,0,0,0,0,0,70,70,17,3,50,0,0,0,0,0,0,0,0,0,03768
916,297,12,63,53,97,72,140,24,24,0,5,19,0,0,0,0,0,0,0,0,0,116,116,0,0,116,0,0,0,0,0,0,0,0,0,03770
917,714,38,262,224,111,79,35,21,14,2,0,12,7,7,0,7,0,0,0,0,0,14,7,4,0,3,7,7,7,0,0,0,0,0,0,03771
918,5768,627,2294,1651,759,437,433,177,134,30,0,104,43,15,0,2,13,28,14,14,0,256,250,129,0,121,6,0,0,0,0,6,4,0,2,03773
919,1316,157,531,413,127,88,35,12,12,0,8,4,0,0,0,0,0,0,0,0,0,23,23,23,0,0,0,0,0,0,0,0,0,0,0,03774
920,1045,48,320,200,252,225,89,39,39,19,0,20,0,0,0,0,0,0,0,0,0,50,40,28,6,6,10,10,7,0,3,0,0,0,0,03777
921,623,36,221,168,109,89,72,51,51,7,0,44,0,0,0,0,0,0,0,0,0,21,19,2,0,17,2,2,2,0,0,0,0,0,0,03779
922,285,6,149,99,26,5,14,3,3,0,0,3,0,0,0,0,0,0,0,0,0,11,11,0,0,11,0,0,0,0,0,0,0,0,0,03780
923,1434,51,306,393,361,323,96,14,14,6,0,8,0,0,0,0,0,0,0,0,0,82,74,23,0,51,8,8,8,0,0,0,0,0,0,03781
924,2318,58,375,601,760,524,117,81,81,10,20,51,0,0,0,0,0,0,0,0,0,36,36,31,0,5,0,0,0,0,0,0,0,0,0,03782
925,2646,41,836,668,696,405,102,61,61,14,0,47,0,0,0,0,0,0,0,0,0,41,15,0,0,15,26,26,0,0,26,0,0,0,0,03784
926,1779,246,789,465,217,62,184,100,29,19,0,10,71,48,4,44,0,23,0,0,23,84,72,43,0,29,12,12,12,0,0,0,0,0,0,03785
927,16671,746,3222,3926,5480,3297,808,366,298,106,0,192,68,65,58,7,0,3,0,3,0,442,437,146,75,216,5,5,0,0,5,0,0,0,0,03801
928,2735,185,609,1160,609,172,216,106,66,57,0,9,40,40,40,0,0,0,0,0,0,110,66,31,0,35,44,44,44,0,0,0,0,0,0,03809
929,1066,80,151,531,181,123,182,48,45,0,0,45,3,3,0,0,3,0,0,0,0,134,134,52,0,82,0,0,0,0,0,0,0,0,0,03810
930,4730,157,1020,1698,1406,449,511,230,230,99,15,116,0,0,0,0,0,0,0,0,0,281,281,139,15,127,0,0,0,0,0,0,0,0,0,03811
931,477,0,110,173,110,84,49,0,0,0,0,0,0,0,0,0,0,0,0,0,0,49,49,19,4,26,0,0,0,0,0,0,0,0,0,03812
932,2651,240,737,971,545,158,185,83,83,6,2,75,0,0,0,0,0,0,0,0,0,102,78,67,0,11,24,24,24,0,0,0,0,0,0,03813
933,1784,290,654,642,154,44,133,98,98,22,0,76,0,0,0,0,0,0,0,0,0,35,35,0,0,35,0,0,0,0,0,0,0,0,0,03814
934,992,39,193,354,252,154,107,70,64,0,0,64,6,6,0,6,0,0,0,0,0,37,37,3,10,24,0,0,0,0,0,0,0,0,0,03816
935,528,59,260,68,67,74,11,0,0,0,0,0,0,0,0,0,0,0,0,0,0,11,11,11,0,0,0,0,0,0,0,0,0,0,0,03817
936,2898,451,1009,935,408,95,191,115,82,29,34,19,33,18,0,0,18,15,0,15,0,76,59,23,27,9,17,17,0,17,0,0,0,0,0,03818
937,2846,120,1073,772,628,253,272,140,140,94,0,46,0,0,0,0,0,0,0,0,0,132,113,37,25,51,19,19,19,0,0,0,0,0,0,03819
938,20078,1830,4226,6431,4725,2866,1375,601,378,115,46,217,223,137,84,42,11,86,47,0,39,774,558,318,54,186,216,198,86,70,42,18,18,0,0,03820
939,1250,45,235,301,310,359,103,45,34,11,3,20,11,11,5,0,6,0,0,0,0,58,55,31,0,24,3,0,0,0,0,3,0,0,3,03823
940,4607,113,337,715,1303,2139,4469,1818,1807,616,154,1037,11,10,0,0,10,1,0,1,0,2651,2638,1212,120,1306,13,0,0,0,0,13,0,0,13,03824
941,5934,283,1425,1967,1605,654,465,288,178,91,10,77,110,110,63,34,13,0,0,0,0,177,158,56,27,75,19,19,19,0,0,0,0,0,0,03825
942,1900,121,438,655,339,347,106,67,67,20,28,19,0,0,0,0,0,0,0,0,0,39,39,0,0,39,0,0,0,0,0,0,0,0,0,03826
943,2285,115,664,631,555,320,168,55,52,11,11,30,3,3,0,3,0,0,0,0,0,113,105,33,14,58,8,8,8,0,0,0,0,0,0,03827
944,1372,206,666,245,120,135,66,27,27,27,0,0,0,0,0,0,0,0,0,0,0,39,39,21,0,18,0,0,0,0,0,0,0,0,0,03830
945,304,8,76,78,90,52,20,9,9,3,6,0,0,0,0,0,0,0,0,0,0,11,11,7,0,4,0,0,0,0,0,0,0,0,0,03832
946,14744,708,3328,4057,3821,2830,1097,628,572,236,36,300,56,48,9,34,5,8,0,0,8,469,436,158,28,250,33,33,33,0,0,0,0,0,0,03833
947,4826,572,1826,1733,478,217,225,68,68,22,0,46,0,0,0,0,0,0,0,0,0,157,141,73,30,38,16,16,0,16,0,0,0,0,0,03835
948,940,61,309,290,186,94,50,25,6,0,3,3,19,19,19,0,0,0,0,0,0,25,22,19,0,3,3,3,3,0,0,0,0,0,0,03836
949,1032,94,314,304,222,98,48,33,33,0,9,24,0,0,0,0,0,0,0,0,0,15,5,0,5,0,10,10,10,0,0,0,0,0,0,03837
950,797,32,161,100,282,222,0,0,0,0,0,0,0,0,0,0,0,0,0,0,0,0,0,0,0,0,0,0,0,0,0,0,0,0,0,03838
951,2582,253,938,884,270,237,261,113,112,40,0,72,1,1,0,1,0,0,0,0,0,148,148,77,14,57,0,0,0,0,0,0,0,0,0,03839
952,2779,78,549,765,722,665,115,51,51,9,0,42,0,0,0,0,0,0,0,0,0,64,64,19,7,38,0,0,0,0,0,0,0,0,0,03840
953,4344,194,1200,1355,922,673,415,249,242,53,23,166,7,7,7,0,0,0,0,0,0,166,166,89,24,53,0,0,0,0,0,0,0,0,0,03841
954,11057,427,2793,3284,2856,1697,852,610,481,192,77,212,129,81,45,0,36,48,0,27,21,242,242,106,17,119,0,0,0,0,0,0,0,0,0,03842
955,1698,27,415,364,568,324,67,39,39,23,0,16,0,0,0,0,0,0,0,0,0,28,28,15,0,13,0,0,0,0,0,0,0,0,0,03844
956,804,96,123,266,216,103,81,75,75,68,0,7,0,0,0,0,0,0,0,0,0,6,6,0,0,6,0,0,0,0,0,0,0,0,0,03845
957,793,2,114,145,346,186,36,14,14,5,0,9,0,0,0,0,0,0,0,0,0,22,22,18,0,4,0,0,0,0,0,0,0,0,0,03846
958,272,0,67,81,65,59,0,0,0,0,0,0,0,0,0,0,0,0,0,0,0,0,0,0,0,0,0,0,0,0,0,0,0,0,0,03847
959,4249,258,1342,1421,797,431,231,87,65,0,0,65,22,22,20,0,2,0,0,0,0,144,144,77,14,53,0,0,0,0,0,0,0,0,0,03848
960,998,43,362,214,286,93,85,11,3,0,1,2,8,8,8,0,0,0,0,0,0,74,68,40,0,28,6,6,6,0,0,0,0,0,0,03849
961,209,30,50,82,12,35,0,0,0,0,0,0,0,0,0,0,0,0,0,0,0,0,0,0,0,0,0,0,0,0,0,0,0,0,0,03850
962,2853,278,1245,909,308,113,219,115,84,17,13,54,31,31,13,18,0,0,0,0,0,104,82,31,0,51,22,22,9,0,13,0,0,0,0,03851
963,378,25,150,115,70,18,44,9,0,0,0,0,9,9,9,0,0,0,0,0,0,35,35,0,0,35,0,0,0,0,0,0,0,0,0,03852
964,550,19,123,168,152,88,0,0,0,0,0,0,0,0,0,0,0,0,0,0,0,0,0,0,0,0,0,0,0,0,0,0,0,0,0,03853
965,773,6,74,172,228,293,41,23,20,16,0,4,3,3,0,0,3,0,0,0,0,18,18,8,0,10,0,0,0,0,0,0,0,0,0,03854
966,1868,141,562,643,369,153,72,53,37,13,11,13,16,16,12,4,0,0,0,0,0,19,19,0,7,12,0,0,0,0,0,0,0,0,0,03855
967,1101,32,174,264,379,252,128,92,89,14,0,75,3,3,3,0,0,0,0,0,0,36,36,9,6,21,0,0,0,0,0,0,0,0,0,03856
968,5825,341,1408,1665,1489,922,625,325,227,84,29,114,98,53,53,0,0,45,0,0,45,300,275,124,36,115,25,25,25,0,0,0,0,0,0,03857
969,3158,150,869,1309,549,281,218,90,90,0,0,90,0,0,0,0,0,0,0,0,0,128,128,82,10,36,0,0,0,0,0,0,0,0,0,03858
970,2579,112,733,862,630,242,224,137,137,68,12,57,0,0,0,0,0,0,0,0,0,87,87,55,0,32,0,0,0,0,0,0,0,0,0,03860
971,3132,118,521,813,1035,645,249,76,66,0,0,66,10,10,0,10,0,0,0,0,0,173,159,66,0,93,14,0,0,0,0,14,14,0,0,03861
972,3242,149,679,834,921,659,181,46,46,25,0,21,0,0,0,0,0,0,0,0,0,135,124,90,0,34,11,11,0,11,0,0,0,0,0,03862
973,1019,130,409,248,139,93,57,11,9,9,0,0,2,2,0,0,2,0,0,0,0,46,9,9,0,0,37,37,37,0,0,0,0,0,0,03864
974,4942,248,2042,1339,811,502,523,276,173,33,15,125,103,103,10,0,93,0,0,0,0,247,234,139,11,84,13,13,13,0,0,0,0,0,0,03865
975,14175,1395,5279,4322,2371,808,860,463,392,157,13,222,71,51,18,33,0,20,20,0,0,397,376,156,58,162,21,21,14,7,0,0,0,0,0,03867
976,4384,512,1899,1354,463,156,216,152,91,47,0,44,61,61,45,0,16,0,0,0,0,64,52,52,0,0,12,0,0,0,0,12,0,0,12,03868
977,1635,142,441,488,388,176,85,38,38,15,0,23,0,0,0,0,0,0,0,0,0,47,35,22,0,13,12,12,12,0,0,0,0,0,0,03869
978,4098,184,850,983,1275,806,172,114,114,65,0,49,0,0,0,0,0,0,0,0,0,58,58,32,0,26,0,0,0,0,0,0,0,0,0,03870
979,17,8,9,0,0,0,0,0,0,0,0,0,0,0,0,0,0,0,0,0,0,0,0,0,0,0,0,0,0,0,0,0,0,0,0,03871
980,2852,317,814,1090,403,228,142,65,31,4,0,27,34,16,4,12,0,18,0,18,0,77,42,4,3,35,35,35,29,0,6,0,0,0,0,03872
981,3884,144,1268,1455,837,180,318,128,114,0,0,114,14,14,0,0,14,0,0,0,0,190,190,99,31,60,0,0,0,0,0,0,0,0,0,03873
982,7117,890,3078,2238,700,211,260,180,118,68,0,50,62,62,62,0,0,0,0,0,0,80,53,28,0,25,27,27,27,0,0,0,0,0,0,03874
983,998,62,471,237,97,131,16,16,16,16,0,0,0,0,0,0,0,0,0,0,0,0,0,0,0,0,0,0,0,0,0,0,0,0,0,03875
984,7820,669,2843,2482,1366,460,395,167,124,18,10,96,43,43,15,17,11,0,0,0,0,228,202,92,0,110,26,26,15,0,11,0,0,0,0,03878
985,1080,119,417,343,156,45,68,33,27,10,10,7,6,6,0,6,0,0,0,0,0,35,12,3,3,6,23,23,17,0,6,0,0,0,0,03882
986,61,0,23,10,12,16,0,0,0,0,0,0,0,0,0,0,0,0,0,0,0,0,0,0,0,0,0,0,0,0,0,0,0,0,0,03883
987,2794,125,565,1035,715,354,232,184,184,70,49,65,0,0,0,0,0,0,0,0,0,48,48,17,0,31,0,0,0,0,0,0,0,0,0,03884
988,4973,85,816,1203,1821,1048,348,252,197,59,0,138,55,55,55,0,0,0,0,0,0,96,96,20,14,62,0,0,0,0,0,0,0,0,0,03885
989,1601,202,724,352,170,153,103,103,103,61,0,42,0,0,0,0,0,0,0,0,0,0,0,0,0,0,0,0,0,0,0,0,0,0,0,03886
990,1380,152,600,479,94,55,99,58,52,22,0,30,6,6,2,2,2,0,0,0,0,41,30,27,0,3,11,0,0,0,0,11,0,0,11,03887
991,273,0,190,73,10,0,27,0,0,0,0,0,0,0,0,0,0,0,0,0,0,27,27,0,0,27,0,0,0,0,0,0,0,0,0,03890
992,4696,276,1029,1532,971,888,237,111,111,86,0,25,0,0,0,0,0,0,0,0,0,126,126,48,12,66,0,0,0,0,0,0,0,0,0,03894
993,4896,339,1596,1453,1083,425,321,121,102,29,0,73,19,19,19,0,0,0,0,0,0,200,200,85,43,72,0,0,0,0,0,0,0,0,0,03901
994,1764,79,461,433,616,175,0,0,0,0,0,0,0,0,0,0,0,0,0,0,0,0,0,0,0,0,0,0,0,0,0,0,0,0,0,03902
995,4551,204,1389,1367,981,610,251,135,107,65,10,32,28,28,28,0,0,0,0,0,0,116,99,65,6,28,17,17,17,0,0,0,0,0,0,03903
996,6207,352,1851,1959,1408,637,340,94,63,6,57,0,31,31,31,0,0,0,0,0,0,246,212,156,10,46,34,34,28,6,0,0,0,0,0,03904
997,987,28,193,299,223,244,59,0,0,0,0,0,0,0,0,0,0,0,0,0,0,59,59,52,0,7,0,0,0,0,0,0,0,0,0,03905
998,3262,285,1122,1060,568,227,143,105,105,61,25,19,0,0,0,0,0,0,0,0,0,38,38,20,9,9,0,0,0,0,0,0,0,0,0,03906
999,961,18,204,253,168,318,48,41,41,30,0,11,0,0,0,0,0,0,0,0,0,7,7,0,0,7,0,0,0,0,0,0,0,0,0,03907
1000,4802,196,1357,1356,1242,651,391,232,197,96,10,91,35,35,17,18,0,0,0,0,0,159,142,16,0,126,17,17,17,0,0,0,0,0,0,03908
1001,7598,225,1539,2116,2322,1396,398,217,217,150,0,67,0,0,0,0,0,0,0,0,0,181,121,63,0,58,60,60,46,0,14,0,0,0,0,03909
1002,202,0,46,72,84,0,17,17,0,0,0,0,17,17,0,17,0,0,0,0,0,0,0,0,0,0,0,0,0,0,0,0,0,0,0,03910
1003,103,12,0,64,27,0,14,14,14,0,0,14,0,0,0,0,0,0,0,0,0,0,0,0,0,0,0,0,0,0,0,0,0,0,0,03911
1004,1787,67,620,698,311,91,167,94,71,11,0,60,23,13,0,13,0,10,0,0,10,73,64,33,0,31,9,9,0,9,0,0,0,0,0,04001
1005,5480,469,2012,1898,678,423,236,155,141,32,0,109,14,14,14,0,0,0,0,0,0,81,81,33,0,48,0,0,0,0,0,0,0,0,0,04002
1006,451,49,121,104,99,78,10,0,0,0,0,0,0,0,0,0,0,0,0,0,0,10,10,0,0,10,0,0,0,0,0,0,0,0,0,04003
1007,15467,1636,5573,4742,2449,1067,1641,781,609,209,28,372,172,135,115,20,0,37,0,0,37,860,803,464,73,266,57,57,29,0,28,0,0,0,0,04005
1008,63,0,8,15,29,11,0,0,0,0,0,0,0,0,0,0,0,0,0,0,0,0,0,0,0,0,0,0,0,0,0,0,0,0,0,04006
1009,1972,63,568,538,524,279,96,43,42,6,0,36,1,0,0,0,0,1,0,0,1,53,8,0,0,8,45,25,14,0,11,20,0,0,20,04008
1010,3960,324,1469,1055,724,388,183,80,65,20,5,40,15,3,0,3,0,12,12,0,0,103,71,0,0,71,32,32,32,0,0,0,0,0,0,04009
1011,982,125,397,247,187,26,63,33,28,0,3,25,5,0,0,0,0,5,0,5,0,30,25,16,0,9,5,3,1,0,2,2,0,0,2,04010
1012,13792,896,3488,3748,3290,2370,1605,755,711,293,77,341,44,44,7,16,21,0,0,0,0,850,803,378,34,391,47,47,47,0,0,0,0,0,0,04011
1013,2794,378,920,887,473,136,175,79,63,7,18,38,16,0,0,0,0,16,0,16,0,96,76,8,0,68,20,13,13,0,0,7,0,0,7,04015
1014,339,13,96,64,93,73,21,11,11,10,0,1,0,0,0,0,0,0,0,0,0,10,10,0,0,10,0,0,0,0,0,0,0,0,0,04017
1015,0,0,0,0,0,0,0,0,0,0,0,0,0,0,0,0,0,0,0,0,0,0,0,0,0,0,0,0,0,0,0,0,0,0,0,04019
1016,991,89,400,296,151,55,136,100,90,18,0,72,10,10,10,0,0,0,0,0,0,36,36,7,9,20,0,0,0,0,0,0,0,0,0,04020
1017,3884,55,499,836,1398,1096,512,142,142,18,0,124,0,0,0,0,0,0,0,0,0,370,289,60,13,216,81,31,16,0,15,50,0,50,0,04021
1018,726,51,237,201,168,69,47,30,20,9,4,7,10,6,6,0,0,4,0,0,4,17,13,13,0,0,4,4,4,0,0,0,0,0,0,04022
1019,429,36,197,131,45,20,35,27,13,9,4,0,14,8,0,8,0,6,0,6,0,8,8,5,0,3,0,0,0,0,0,0,0,0,0,04024
1020,4246,525,1921,1371,333,96,263,157,157,50,17,90,0,0,0,0,0,0,0,0,0,106,94,0,48,46,12,12,12,0,0,0,0,0,0,04027
1021,1222,92,420,366,229,115,47,10,10,7,0,3,0,0,0,0,0,0,0,0,0,37,35,11,0,24,2,0,0,0,0,2,0,2,0,04029
1022,1607,134,745,466,120,142,369,226,206,79,0,127,20,20,0,0,20,0,0,0,0,143,97,20,19,58,46,46,34,0,12,0,0,0,0,04030
1023,5794,330,1260,1564,1389,1251,299,169,136,73,0,63,33,14,14,0,0,19,0,0,19,130,108,36,0,72,22,22,22,0,0,0,0,0,0,04032
1024,2529,303,1121,485,366,254,426,191,152,11,51,90,39,36,13,0,23,3,0,0,3,235,199,102,48,49,36,36,0,18,18,0,0,0,0,04037
1025,10586,437,2636,2940,2942,1631,1760,788,788,322,73,393,0,0,0,0,0,0,0,0,0,972,914,351,98,465,58,58,39,3,16,0,0,0,0,04038
1026,4730,246,1515,1708,1005,256,472,304,232,17,0,215,72,45,45,0,0,27,0,0,27,168,166,154,0,12,2,2,2,0,0,0,0,0,0,04039
1027,2373,166,765,808,381,253,100,36,36,11,0,25,0,0,0,0,0,0,0,0,0,64,55,9,0,46,9,0,0,0,0,9,9,0,0,04040
1028,1121,83,516,358,96,68,115,74,66,8,0,58,8,0,0,0,0,8,0,4,4,41,41,12,0,29,0,0,0,0,0,0,0,0,0,04041
1029,3116,302,1113,1155,415,131,92,43,22,10,0,12,21,21,8,13,0,0,0,0,0,49,42,24,0,18,7,7,0,7,0,0,0,0,0,04042
1030,8173,257,1807,1738,2535,1836,406,199,189,82,36,71,10,10,10,0,0,0,0,0,0,207,207,101,28,78,0,0,0,0,0,0,0,0,0,04043
1031,5411,457,1529,1423,1122,880,283,155,128,41,11,76,27,27,27,0,0,0,0,0,0,128,117,39,47,31,11,11,11,0,0,0,0,0,0,04046
1032,1211,118,569,339,115,70,70,40,33,3,0,30,7,7,7,0,0,0,0,0,0,30,28,7,4,17,2,2,2,0,0,0,0,0,0,04047
1033,1765,145,649,622,245,104,208,129,129,22,24,83,0,0,0,0,0,0,0,0,0,79,56,14,13,29,23,23,5,18,0,0,0,0,0,04048
1034,2514,312,1040,698,333,131,239,178,163,19,61,83,15,15,7,8,0,0,0,0,0,61,59,14,0,45,2,2,0,0,2,0,0,0,0,04049
1035,206,4,61,67,51,23,5,3,3,0,0,3,0,0,0,0,0,0,0,0,0,2,2,0,0,2,0,0,0,0,0,0,0,0,0,04050
1036,808,36,276,226,179,91,45,26,26,4,6,16,0,0,0,0,0,0,0,0,0,19,19,8,0,11,0,0,0,0,0,0,0,0,0,04051
1037,2698,176,1102,936,342,142,233,176,88,31,0,57,88,88,71,17,0,0,0,0,0,57,45,0,9,36,12,12,12,0,0,0,0,0,0,04055
1038,159,7,76,60,14,2,10,0,0,0,0,0,0,0,0,0,0,0,0,0,0,10,10,0,10,0,0,0,0,0,0,0,0,0,0,04056
1039,0,0,0,0,0,0,14,14,14,7,0,7,0,0,0,0,0,0,0,0,0,0,0,0,0,0,0,0,0,0,0,0,0,0,0,04057
1040,2207,103,922,726,309,147,180,92,42,14,0,28,50,50,26,24,0,0,0,0,0,88,75,19,0,56,13,13,13,0,0,0,0,0,0,04061
1041,12075,901,4179,3551,2371,1073,644,379,324,102,28,194,55,55,30,25,0,0,0,0,0,265,255,125,0,130,10,10,10,0,0,0,0,0,0,04062
1042,307,1,54,111,88,53,0,0,0,0,0,0,0,0,0,0,0,0,0,0,0,0,0,0,0,0,0,0,0,0,0,0,0,0,0,04063
1043,6636,586,2404,2016,1182,448,273,90,79,54,11,14,11,11,11,0,0,0,0,0,0,183,143,57,0,86,40,40,40,0,0,0,0,0,0,04064
1044,354,4,55,134,50,111,0,0,0,0,0,0,0,0,0,0,0,0,0,0,0,0,0,0,0,0,0,0,0,0,0,0,0,0,0,04066
1045,1145,118,554,252,146,75,80,42,31,4,0,27,11,0,0,0,0,11,3,0,8,38,31,15,0,16,7,3,0,0,3,4,4,0,0,04068
1046,1053,77,346,262,240,128,74,24,24,8,2,14,0,0,0,0,0,0,0,0,0,50,43,21,0,22,7,7,7,0,0,0,0,0,0,04069
1047,3641,205,1049,1268,694,425,237,146,122,49,0,73,24,24,0,0,24,0,0,0,0,91,78,29,18,31,13,13,12,1,0,0,0,0,0,04071
1048,13393,1126,4098,4107,2718,1344,1020,456,395,169,20,206,61,61,61,0,0,0,0,0,0,564,481,183,7,291,83,83,62,11,10,0,0,0,0,04072
1049,10983,1597,3963,3289,1572,562,755,358,274,105,13,156,84,63,63,0,0,21,0,0,21,397,284,110,7,167,113,63,48,15,0,50,8,0,42,04073
1050,13444,456,2895,3996,4006,2091,844,457,420,218,6,196,37,37,25,0,12,0,0,0,0,387,327,193,6,128,60,60,60,0,0,0,0,0,0,04074
1051,2004,145,897,736,161,65,122,40,35,24,0,11,5,5,5,0,0,0,0,0,0,82,75,51,7,17,7,7,0,7,0,0,0,0,0,04076
1052,2939,49,553,885,709,743,158,48,44,0,0,44,4,4,4,0,0,0,0,0,0,110,110,79,0,31,0,0,0,0,0,0,0,0,0,04079
1053,3191,439,1178,963,447,164,323,183,125,24,0,101,58,58,32,26,0,0,0,0,0,140,124,64,19,41,16,16,16,0,0,0,0,0,0,04083
1054,5469,326,1763,1890,1102,388,539,207,179,26,5,148,28,28,28,0,0,0,0,0,0,332,319,118,16,185,13,13,13,0,0,0,0,0,0,04084
1055,1516,127,689,422,216,62,124,74,35,0,25,10,39,39,39,0,0,0,0,0,0,50,50,0,0,50,0,0,0,0,0,0,0,0,0,04085
1056,6271,352,1776,1628,1625,890,414,257,160,84,4,72,97,88,57,31,0,9,0,0,9,157,147,20,25,102,10,0,0,0,0,10,10,0,0,04086
1057,1173,48,380,473,123,149,121,65,49,0,0,49,16,0,0,0,0,16,0,16,0,56,56,36,0,20,0,0,0,0,0,0,0,0,0,04087
1058,1239,134,597,302,105,101,147,63,49,35,0,14,14,14,7,7,0,0,0,0,0,84,82,59,0,23,2,2,0,2,0,0,0,0,0,04088
1059,7338,584,2153,2403,1438,760,569,281,244,87,0,157,37,37,17,0,20,0,0,0,0,288,278,81,0,197,10,0,0,0,0,10,10,0,0,04090
1060,747,105,273,230,77,62,41,20,20,0,6,14,0,0,0,0,0,0,0,0,0,21,21,19,0,2,0,0,0,0,0,0,0,0,0,04091
1061,12584,1389,4207,3524,2543,921,925,550,385,70,16,299,165,106,33,0,73,59,27,22,10,375,279,78,33,168,96,38,28,0,10,58,0,22,36,04092
1062,5854,459,2086,1739,1159,411,562,343,290,112,29,149,53,43,23,20,0,10,0,0,10,219,188,80,0,108,31,31,0,0,31,0,0,0,0,04093
1063,918,106,382,308,88,34,37,8,4,0,0,4,4,4,0,4,0,0,0,0,0,29,27,0,14,13,2,2,2,0,0,0,0,0,0,04095
1064,6048,186,961,1433,2006,1462,394,188,188,20,39,129,0,0,0,0,0,0,0,0,0,206,206,58,0,148,0,0,0,0,0,0,0,0,0,04096
1065,2409,36,431,662,749,531,187,62,62,37,8,17,0,0,0,0,0,0,0,0,0,125,106,58,0,48,19,11,11,0,0,8,0,0,8,04097
1066,12093,1407,2649,2606,3551,1880,564,226,190,53,7,130,36,21,0,4,17,15,0,3,12,338,256,101,17,138,82,9,0,9,0,73,0,22,51,04101
1067,12529,1012,2550,3240,3297,2430,730,368,326,42,46,238,42,24,14,0,10,18,16,0,2,362,307,158,16,133,55,55,42,13,0,0,0,0,0,04102
1068,21978,1684,4592,6160,5859,3683,1233,627,450,97,45,308,177,159,38,81,40,18,17,0,1,606,582,219,15,348,24,24,19,5,0,0,0,0,0,04103
1069,8198,127,1151,1645,2850,2425,561,379,365,70,41,254,14,0,0,0,0,14,14,0,0,182,170,98,0,72,12,12,12,0,0,0,0,0,0,04105
1070,17655,835,4495,5538,4871,1916,1281,708,673,226,63,384,35,33,31,0,2,2,0,0,2,573,542,297,59,186,31,19,17,2,0,12,12,0,0,04106
1071,6322,104,818,1527,2138,1735,554,247,247,145,0,102,0,0,0,0,0,0,0,0,0,307,298,41,0,257,9,9,0,0,9,0,0,0,0,04107
1072,703,35,59,133,264,212,37,10,10,10,0,0,0,0,0,0,0,0,0,0,0,27,27,19,0,8,0,0,0,0,0,0,0,0,0,04108
1073,62,0,0,4,52,6,0,0,0,0,0,0,0,0,0,0,0,0,0,0,0,0,0,0,0,0,0,0,0,0,0,0,0,0,0,04109
1074,898,12,67,107,385,327,107,65,65,0,14,51,0,0,0,0,0,0,0,0,0,42,29,16,0,13,13,0,0,0,0,13,0,0,13,04110
1075,16021,1540,5506,4985,2707,1283,1180,580,503,152,104,247,77,61,49,5,7,16,0,0,16,600,555,236,32,287,45,29,23,5,1,16,0,16,0,04210
1076,362,25,158,100,58,21,15,8,8,8,0,0,0,0,0,0,0,0,0,0,0,7,0,0,0,0,7,7,7,0,0,0,0,0,0,04216
1077,2059,148,677,495,509,230,114,63,62,11,13,38,1,1,1,0,0,0,0,0,0,51,51,19,0,32,0,0,0,0,0,0,0,0,0,04217
1078,1055,101,442,343,96,73,87,60,52,5,0,47,8,8,5,0,3,0,0,0,0,27,20,12,0,8,7,7,7,0,0,0,0,0,0,04219
1079,2169,221,1030,485,292,141,120,75,60,9,9,42,15,4,4,0,0,11,0,8,3,45,42,20,6,16,3,0,0,0,0,3,0,0,3,04220
1080,770,111,329,193,111,26,25,20,15,0,3,12,5,5,5,0,0,0,0,0,0,5,5,2,0,3,0,0,0,0,0,0,0,0,0,04221
1081,2709,234,761,914,548,252,218,103,94,22,0,72,9,9,0,9,0,0,0,0,0,115,98,40,11,47,17,10,10,0,0,7,7,0,0,04222
1082,2153,219,977,596,256,105,144,45,45,6,0,39,0,0,0,0,0,0,0,0,0,99,96,30,0,66,3,3,3,0,0,0,0,0,0,04224
1083,113,0,59,27,25,2,16,8,8,8,0,0,0,0,0,0,0,0,0,0,0,8,8,0,0,8,0,0,0,0,0,0,0,0,0,04226
1084,30,7,12,11,0,0,0,0,0,0,0,0,0,0,0,0,0,0,0,0,0,0,0,0,0,0,0,0,0,0,0,0,0,0,0,04227
1085,52,52,0,0,0,0,23,23,23,0,0,23,0,0,0,0,0,0,0,0,0,0,0,0,0,0,0,0,0,0,0,0,0,0,0,04228
1086,205,16,86,50,24,29,4,0,0,0,0,0,0,0,0,0,0,0,0,0,0,4,4,2,0,2,0,0,0,0,0,0,0,0,0,04231
1087,74,0,37,30,7,0,0,0,0,0,0,0,0,0,0,0,0,0,0,0,0,0,0,0,0,0,0,0,0,0,0,0,0,0,0,04234
1088,3142,447,1039,941,452,263,148,79,69,10,0,59,10,10,0,10,0,0,0,0,0,69,60,20,10,30,9,9,0,0,9,0,0,0,0,04236
1089,109,8,36,33,28,4,9,6,4,0,0,4,2,2,2,0,0,0,0,0,0,3,3,0,0,3,0,0,0,0,0,0,0,0,0,04237
1090,997,83,374,280,194,66,126,74,70,15,0,55,4,4,4,0,0,0,0,0,0,52,36,15,3,18,16,0,0,0,0,16,0,0,16,04238
1091,3320,228,1465,1183,268,176,246,174,142,75,18,49,32,15,15,0,0,17,0,0,17,72,72,0,0,72,0,0,0,0,0,0,0,0,0,04239
1092,24017,3470,9339,7512,2268,1428,2402,1380,1256,476,179,601,124,57,37,0,20,67,21,35,11,1022,894,357,57,480,128,57,0,0,57,71,41,20,10,04240
1093,2925,353,1267,944,262,99,230,162,147,11,23,113,15,8,8,0,0,7,0,0,7,68,59,49,0,10,9,9,0,0,9,0,0,0,0,04250
1094,3376,201,1357,1248,438,132,230,148,110,47,0,63,38,10,10,0,0,28,28,0,0,82,68,29,11,28,14,14,14,0,0,0,0,0,0,04252
1095,1462,128,615,496,140,83,124,65,57,17,0,40,8,8,0,0,8,0,0,0,0,59,54,25,1,28,5,5,0,0,5,0,0,0,0,04253
1096,2058,341,1013,540,139,25,210,98,80,4,39,37,18,18,18,0,0,0,0,0,0,112,96,37,0,59,16,10,0,10,0,6,6,0,0,04254
1097,625,56,224,198,96,51,25,20,19,0,0,19,1,0,0,0,0,1,1,0,0,5,5,2,0,3,0,0,0,0,0,0,0,0,0,04255
1098,2132,305,1160,484,119,64,24,8,8,0,0,8,0,0,0,0,0,0,0,0,0,16,16,16,0,0,0,0,0,0,0,0,0,0,0,04256
1099,1979,207,1002,583,171,16,60,60,42,24,0,18,18,18,0,18,0,0,0,0,0,0,0,0,0,0,0,0,0,0,0,0,0,0,0,04257
1100,1694,120,666,493,289,126,191,96,89,6,20,63,7,7,0,7,0,0,0,0,0,95,72,18,0,54,23,14,0,14,0,9,9,0,0,04258
1101,2116,52,692,708,342,322,141,86,77,10,0,67,9,9,9,0,0,0,0,0,0,55,24,0,6,18,31,22,22,0,0,9,0,0,9,04259
1102,3780,267,1281,1251,808,173,282,172,117,69,0,48,55,0,0,0,0,55,0,0,55,110,110,11,49,50,0,0,0,0,0,0,0,0,0,04260
1103,332,27,100,110,62,33,18,11,9,1,0,8,2,2,0,0,2,0,0,0,0,7,7,0,0,7,0,0,0,0,0,0,0,0,0,04261
1104,1382,109,573,508,173,19,113,34,20,17,3,0,14,14,0,0,14,0,0,0,0,79,68,29,0,39,11,8,0,0,8,3,0,3,0,04263
1105,698,93,168,275,129,33,73,54,45,19,26,0,9,9,0,9,0,0,0,0,0,19,13,0,0,13,6,6,6,0,0,0,0,0,0,04265
1106,43,10,23,3,7,0,0,0,0,0,0,0,0,0,0,0,0,0,0,0,0,0,0,0,0,0,0,0,0,0,0,0,0,0,0,04267
1107,3898,375,2072,934,308,209,129,39,18,11,0,7,21,15,0,15,0,6,0,0,6,90,68,0,0,68,22,18,18,0,0,4,0,0,4,04268
1108,4559,559,2047,1123,506,324,315,164,131,0,18,113,33,33,20,13,0,0,0,0,0,151,147,49,0,98,4,0,0,0,0,4,0,4,0,04270
1109,0,0,0,0,0,0,0,0,0,0,0,0,0,0,0,0,0,0,0,0,0,0,0,0,0,0,0,0,0,0,0,0,0,0,0,04271
1110,3834,437,1396,1079,576,346,225,127,96,88,0,8,31,24,0,24,0,7,0,0,7,98,98,39,19,40,0,0,0,0,0,0,0,0,0,04274
1111,379,23,175,139,25,17,28,13,11,0,0,11,2,2,0,0,2,0,0,0,0,15,15,1,0,14,0,0,0,0,0,0,0,0,0,04275
1112,4044,574,1984,942,365,179,238,146,118,44,42,32,28,28,15,13,0,0,0,0,0,92,83,18,16,49,9,0,0,0,0,9,0,0,9,04276
1113,4782,776,2204,965,599,238,416,160,96,15,3,78,64,21,11,2,8,43,12,31,0,256,226,114,48,64,30,30,5,18,7,0,0,0,0,04280
1114,3954,449,1793,1054,429,229,260,191,158,19,32,107,33,33,0,0,33,0,0,0,0,69,10,10,0,0,59,25,25,0,0,34,0,34,0,04281
1115,4017,402,1302,1536,471,306,251,106,102,10,9,83,4,0,0,0,0,4,0,4,0,145,122,33,0,89,23,23,23,0,0,0,0,0,0,04282
1116,811,41,206,239,199,126,48,28,28,10,12,6,0,0,0,0,0,0,0,0,0,20,20,9,0,11,0,0,0,0,0,0,0,0,0,04284
1117,390,26,166,95,87,16,16,7,7,0,0,7,0,0,0,0,0,0,0,0,0,9,9,7,0,2,0,0,0,0,0,0,0,0,0,04285
1118,149,0,48,60,0,41,0,0,0,0,0,0,0,0,0,0,0,0,0,0,0,0,0,0,0,0,0,0,0,0,0,0,0,0,0,04286
1119,2130,120,798,758,311,143,180,89,41,4,0,37,48,48,25,18,5,0,0,0,0,91,91,33,19,39,0,0,0,0,0,0,0,0,0,04287
1120,1258,93,579,402,119,65,81,57,52,8,8,36,5,0,0,0,0,5,0,3,2,24,16,3,0,13,8,8,0,3,5,0,0,0,0,04289
1121,997,84,448,313,90,62,52,25,23,2,2,19,2,0,0,0,0,2,2,0,0,27,27,12,0,15,0,0,0,0,0,0,0,0,0,04290
1122,806,45,400,207,98,56,68,40,37,2,0,35,3,3,3,0,0,0,0,0,0,28,23,6,4,13,5,5,0,5,0,0,0,0,0,04292
1123,2929,204,1260,867,299,299,176,92,74,13,5,56,18,18,4,0,14,0,0,0,0,84,84,46,38,0,0,0,0,0,0,0,0,0,0,04294
1124,18610,2105,6777,5410,2862,1456,1236,665,518,143,24,351,147,112,52,44,16,35,22,0,13,571,514,165,53,296,57,48,48,0,0,9,9,0,0,04330
1125,1225,126,431,330,225,113,77,24,16,8,0,8,8,2,2,0,0,6,0,6,0,53,53,0,7,46,0,0,0,0,0,0,0,0,0,04342
1126,61,0,0,0,19,42,18,0,0,0,0,0,0,0,0,0,0,0,0,0,0,18,18,0,0,18,0,0,0,0,0,0,0,0,0,04343
1127,1809,103,567,565,427,147,105,60,60,0,24,36,0,0,0,0,0,0,0,0,0,45,45,19,0,26,0,0,0,0,0,0,0,0,0,04344
1128,8409,526,2960,3084,1238,601,782,352,283,96,57,130,69,69,64,5,0,0,0,0,0,430,334,92,38,204,96,56,5,51,0,40,0,0,40,04345
1129,1298,152,631,365,106,44,128,82,75,37,9,29,7,0,0,0,0,7,0,0,7,46,33,11,6,16,13,13,8,5,0,0,0,0,0,04346
1130,1820,80,476,461,469,334,129,123,123,0,28,95,0,0,0,0,0,0,0,0,0,6,6,0,0,6,0,0,0,0,0,0,0,0,0,04347
1131,2370,244,828,692,395,211,172,66,62,0,0,62,4,4,4,0,0,0,0,0,0,106,65,21,9,35,41,16,0,6,10,25,0,0,25,04348
1132,853,86,307,226,143,91,20,16,13,0,0,13,3,3,3,0,0,0,0,0,0,4,4,0,0,4,0,0,0,0,0,0,0,0,0,04349
1133,2637,263,1124,782,372,96,72,51,43,11,0,32,8,8,0,0,8,0,0,0,0,21,21,0,0,21,0,0,0,0,0,0,0,0,0,04350
1134,1839,123,574,444,459,239,168,87,87,52,0,35,0,0,0,0,0,0,0,0,0,81,72,35,6,31,9,9,8,0,1,0,0,0,0,04351
1135,1152,78,355,411,184,124,80,38,38,8,0,30,0,0,0,0,0,0,0,0,0,42,42,22,0,20,0,0,0,0,0,0,0,0,0,04352
1136,1774,202,712,497,243,120,161,86,51,16,7,28,35,23,4,0,19,12,0,0,12,75,29,11,10,8,46,21,0,0,21,25,0,0,25,04353
1137,1100,60,438,328,172,102,154,80,57,16,3,38,23,23,10,0,13,0,0,0,0,74,59,33,0,26,15,15,15,0,0,0,0,0,0,04354
1138,1870,72,521,538,432,307,106,47,25,15,0,10,22,22,10,0,12,0,0,0,0,59,47,18,8,21,12,8,0,0,8,4,0,0,4,04355
1139,2486,220,784,836,425,221,168,30,26,0,0,26,4,4,4,0,0,0,0,0,0,138,123,64,0,59,15,15,15,0,0,0,0,0,0,04357
1140,2833,208,1201,991,292,141,236,110,103,33,7,63,7,7,7,0,0,0,0,0,0,126,93,28,13,52,33,33,19,0,14,0,0,0,0,04358
1141,324,20,135,124,33,12,0,0,0,0,0,0,0,0,0,0,0,0,0,0,0,0,0,0,0,0,0,0,0,0,0,0,0,0,0,04359
1142,475,18,176,129,63,89,27,16,16,5,0,11,0,0,0,0,0,0,0,0,0,11,11,9,0,2,0,0,0,0,0,0,0,0,0,04360
1143,1791,174,689,548,273,107,101,71,64,37,16,11,7,7,7,0,0,0,0,0,0,30,23,13,0,10,7,7,0,0,7,0,0,0,0,04363
1144,4265,141,1373,1503,749,499,242,60,60,37,0,23,0,0,0,0,0,0,0,0,0,182,182,134,0,48,0,0,0,0,0,0,0,0,0,04364
1145,30331,2577,9563,9896,5002,3293,2610,1162,943,290,108,545,219,177,130,30,17,42,0,40,2,1448,1282,565,84,633,166,92,5,10,77,74,0,0,74,04401
1146,507,62,228,163,38,16,17,11,9,3,0,6,2,2,2,0,0,0,0,0,0,6,6,2,0,4,0,0,0,0,0,0,0,0,0,04406
1147,111,13,39,37,15,7,5,1,1,0,0,1,0,0,0,0,0,0,0,0,0,4,4,4,0,0,0,0,0,0,0,0,0,0,0,04408
1148,791,60,276,303,117,35,39,20,17,6,0,11,3,3,3,0,0,0,0,0,0,19,19,3,0,16,0,0,0,0,0,0,0,0,0,04410
1149,1075,111,516,267,114,67,62,41,35,26,0,9,6,6,0,0,6,0,0,0,0,21,17,8,0,9,4,0,0,0,0,4,4,0,0,04411
1150,6758,437,2048,2195,1428,650,360,188,171,1,41,129,17,17,15,0,2,0,0,0,0,172,151,72,6,73,21,0,0,0,0,21,0,21,0,04412
1151,146,24,72,32,9,9,4,0,0,0,0,0,0,0,0,0,0,0,0,0,0,4,4,0,0,4,0,0,0,0,0,0,0,0,0,04413
1152,1009,128,489,282,60,50,52,29,22,7,0,15,7,7,4,0,3,0,0,0,0,23,23,0,0,23,0,0,0,0,0,0,0,0,0,04414
1153,159,12,81,61,0,5,8,8,0,0,0,0,8,8,0,0,8,0,0,0,0,0,0,0,0,0,0,0,0,0,0,0,0,0,0,04415
1154,3849,286,1488,1217,646,212,222,99,74,0,10,64,25,14,14,0,0,11,0,11,0,123,103,6,16,81,20,20,13,0,7,0,0,0,0,04416
1155,236,29,111,79,15,2,7,0,0,0,0,0,0,0,0,0,0,0,0,0,0,7,4,0,0,4,3,3,0,3,0,0,0,0,0,04417
1156,1201,167,564,353,100,17,63,23,23,4,0,19,0,0,0,0,0,0,0,0,0,40,31,7,8,16,9,0,0,0,0,9,0,0,9,04418
1157,2016,214,880,609,205,108,159,112,112,7,29,76,0,0,0,0,0,0,0,0,0,47,31,13,0,18,16,16,16,0,0,0,0,0,0,04419
1158,558,11,72,115,166,194,398,241,241,75,0,166,0,0,0,0,0,0,0,0,0,157,157,86,0,71,0,0,0,0,0,0,0,0,0,04421
1159,915,101,434,272,80,28,153,111,103,14,0,89,8,8,0,0,8,0,0,0,0,42,41,13,0,28,1,1,0,0,1,0,0,0,0,04422
1160,614,131,303,90,52,38,25,14,14,0,0,14,0,0,0,0,0,0,0,0,0,11,8,6,0,2,3,3,3,0,0,0,0,0,0,04424
1161,3424,366,1213,1094,564,187,253,122,95,23,0,72,27,27,26,0,1,0,0,0,0,131,109,2,26,81,22,22,22,0,0,0,0,0,0,04426
1162,1893,232,831,584,184,62,122,74,74,7,19,48,0,0,0,0,0,0,0,0,0,48,48,8,8,32,0,0,0,0,0,0,0,0,0,04427
1163,2415,218,934,841,252,170,154,79,53,10,0,43,26,13,13,0,0,13,0,13,0,75,73,42,0,31,2,0,0,0,0,2,0,0,2,04428
1164,3576,135,1117,1248,771,305,161,73,73,36,0,37,0,0,0,0,0,0,0,0,0,88,73,22,28,23,15,15,2,0,13,0,0,0,0,04429
1165,1264,174,525,384,148,33,84,35,29,3,3,23,6,0,0,0,0,6,0,0,6,49,42,14,0,28,7,7,0,7,0,0,0,0,0,04430
1166,33,0,10,4,14,5,5,0,0,0,0,0,0,0,0,0,0,0,0,0,0,5,5,0,0,5,0,0,0,0,0,0,0,0,0,04431
1167,913,99,380,262,123,49,45,25,25,6,4,15,0,0,0,0,0,0,0,0,0,20,12,0,4,8,8,0,0,0,0,8,8,0,0,04434
1168,700,128,273,205,68,26,38,24,24,8,0,16,0,0,0,0,0,0,0,0,0,14,14,5,0,9,0,0,0,0,0,0,0,0,0,04435
1169,897,95,392,232,123,55,43,22,19,3,2,14,3,3,3,0,0,0,0,0,0,21,19,0,0,19,2,2,2,0,0,0,0,0,0,04438
1170,1526,182,510,451,267,116,80,50,32,7,0,25,18,18,18,0,0,0,0,0,0,30,30,7,5,18,0,0,0,0,0,0,0,0,0,04441
1171,64,0,5,6,30,23,0,0,0,0,0,0,0,0,0,0,0,0,0,0,0,0,0,0,0,0,0,0,0,0,0,0,0,0,0,04442
1172,1727,232,839,499,114,43,107,45,41,13,3,25,4,0,0,0,0,4,0,0,4,62,51,5,0,46,11,8,0,6,2,3,0,0,3,04443
1173,5950,158,1653,1704,1428,1007,442,253,244,138,26,80,9,4,4,0,0,5,0,0,5,189,172,46,33,93,17,17,17,0,0,0,0,0,0,04444
1174,1080,149,472,311,110,38,76,60,47,2,3,42,13,0,0,0,0,13,0,7,6,16,16,4,0,12,0,0,0,0,0,0,0,0,0,04448
1175,1043,161,377,334,95,76,50,25,16,2,2,12,9,0,0,0,0,9,0,0,9,25,20,5,2,13,5,5,0,5,0,0,0,0,0,04449
1176,891,81,345,335,107,23,10,6,6,0,0,6,0,0,0,0,0,0,0,0,0,4,0,0,0,0,4,4,4,0,0,0,0,0,0,04450
1177,173,47,79,38,4,5,4,4,4,4,0,0,0,0,0,0,0,0,0,0,0,0,0,0,0,0,0,0,0,0,0,0,0,0,0,04451
1178,590,99,251,143,48,49,16,5,5,2,0,3,0,0,0,0,0,0,0,0,0,11,11,9,0,2,0,0,0,0,0,0,0,0,0,04453
1179,46,17,16,13,0,0,0,0,0,0,0,0,0,0,0,0,0,0,0,0,0,0,0,0,0,0,0,0,0,0,0,0,0,0,0,04454
1180,807,86,353,185,133,50,50,10,4,0,0,4,6,6,0,0,6,0,0,0,0,40,22,11,0,11,18,2,2,0,0,16,0,4,12,04455
1181,2001,130,747,756,296,72,99,46,36,8,3,25,10,0,0,0,0,10,0,6,4,53,53,45,0,8,0,0,0,0,0,0,0,0,0,04456
1182,3985,657,1662,1269,269,128,231,149,67,4,3,60,82,82,15,53,14,0,0,0,0,82,42,0,0,42,40,9,5,2,2,31,30,0,1,04457
1183,764,118,367,215,35,29,66,43,22,0,0,22,21,21,9,9,3,0,0,0,0,23,23,0,6,17,0,0,0,0,0,0,0,0,0,04459
1184,992,122,486,283,93,8,77,61,52,7,4,41,9,5,0,5,0,4,4,0,0,16,16,0,0,16,0,0,0,0,0,0,0,0,0,04460
1185,2348,216,910,795,332,95,70,0,0,0,0,0,0,0,0,0,0,0,0,0,0,70,70,18,18,34,0,0,0,0,0,0,0,0,0,04461
1186,3677,367,1564,1268,289,189,185,108,107,16,20,71,1,0,0,0,0,1,1,0,0,77,77,44,0,33,0,0,0,0,0,0,0,0,0,04462
1187,2022,311,889,577,157,88,115,55,41,13,0,28,14,14,5,2,7,0,0,0,0,60,60,4,0,56,0,0,0,0,0,0,0,0,0,04463
1188,528,74,231,118,76,29,25,13,13,0,0,13,0,0,0,0,0,0,0,0,0,12,12,0,3,9,0,0,0,0,0,0,0,0,0,04464
1189,6324,588,2179,1983,970,604,297,181,150,86,27,37,31,20,6,14,0,11,5,2,4,116,113,50,5,58,3,2,1,1,0,1,0,1,0,04468
1190,41,0,0,37,0,4,1860,956,956,229,58,669,0,0,0,0,0,0,0,0,0,904,904,411,51,442,0,0,0,0,0,0,0,0,0,04469
1191,402,35,190,113,44,20,18,8,8,0,0,8,0,0,0,0,0,0,0,0,0,10,8,0,0,8,2,0,0,0,0,2,2,0,0,04471
1192,1660,129,532,483,362,154,58,11,11,11,0,0,0,0,0,0,0,0,0,0,0,47,47,9,0,38,0,0,0,0,0,0,0,0,0,04472
1193,3891,203,824,683,1088,1093,951,509,502,96,20,386,7,0,0,0,0,7,0,0,7,442,435,239,13,183,7,7,7,0,0,0,0,0,0,04473
1194,2821,74,970,800,606,371,200,55,45,23,11,11,10,10,0,10,0,0,0,0,0,145,128,36,0,92,17,8,8,0,0,9,0,0,9,04474
1195,325,50,129,108,34,4,33,19,19,4,3,12,0,0,0,0,0,0,0,0,0,14,14,8,1,5,0,0,0,0,0,0,0,0,0,04475
1196,936,82,283,267,157,147,31,16,16,7,0,9,0,0,0,0,0,0,0,0,0,15,15,7,8,0,0,0,0,0,0,0,0,0,0,04476
1197,277,33,89,135,20,0,13,6,6,0,0,6,0,0,0,0,0,0,0,0,0,7,7,0,0,7,0,0,0,0,0,0,0,0,0,04478
1198,1109,122,606,246,101,34,28,12,12,0,4,8,0,0,0,0,0,0,0,0,0,16,16,2,0,14,0,0,0,0,0,0,0,0,0,04479
1199,482,60,168,168,54,32,38,19,19,0,4,15,0,0,0,0,0,0,0,0,0,19,13,2,0,11,6,6,6,0,0,0,0,0,0,04481
1200,232,18,106,69,30,9,15,15,10,2,1,7,5,5,5,0,0,0,0,0,0,0,0,0,0,0,0,0,0,0,0,0,0,0,0,04485
1201,607,144,288,122,37,16,71,37,34,5,0,29,3,3,0,0,3,0,0,0,0,34,27,6,0,21,7,7,2,5,0,0,0,0,0,04487
1202,936,75,361,355,115,30,46,29,29,6,0,23,0,0,0,0,0,0,0,0,0,17,17,8,3,6,0,0,0,0,0,0,0,0,0,04488
1203,222,0,18,74,74,56,0,0,0,0,0,0,0,0,0,0,0,0,0,0,0,0,0,0,0,0,0,0,0,0,0,0,0,0,0,04489
1204,189,24,77,52,22,14,6,6,6,0,0,6,0,0,0,0,0,0,0,0,0,0,0,0,0,0,0,0,0,0,0,0,0,0,0,04490
1205,77,22,31,20,4,0,2,2,2,0,0,2,0,0,0,0,0,0,0,0,0,0,0,0,0,0,0,0,0,0,0,0,0,0,0,04491
1206,136,33,57,34,12,0,11,0,0,0,0,0,0,0,0,0,0,0,0,0,0,11,8,5,0,3,3,3,0,3,0,0,0,0,0,04492
1207,1464,207,645,457,110,45,51,15,7,0,5,2,8,0,0,0,0,8,0,8,0,36,36,18,0,18,0,0,0,0,0,0,0,0,0,04493
1208,332,55,146,97,29,5,9,5,5,3,0,2,0,0,0,0,0,0,0,0,0,4,3,3,0,0,1,0,0,0,0,1,0,1,0,04495
1209,2648,129,843,805,522,349,249,121,79,25,3,51,42,30,30,0,0,12,0,0,12,128,102,56,0,46,26,26,26,0,0,0,0,0,0,04496
1210,326,80,143,80,15,8,15,2,2,0,0,2,0,0,0,0,0,0,0,0,0,13,13,3,0,10,0,0,0,0,0,0,0,0,0,04497
1211,7959,594,2468,2445,1541,911,416,269,202,67,24,111,67,39,17,18,4,28,0,19,9,147,110,38,0,72,37,35,14,21,0,2,0,0,2,04530
1212,475,30,142,133,97,73,21,16,10,0,0,10,6,0,0,0,0,6,6,0,0,5,5,2,0,3,0,0,0,0,0,0,0,0,0,04535
1213,1503,48,419,649,233,154,65,26,26,9,0,17,0,0,0,0,0,0,0,0,0,39,27,14,0,13,12,12,12,0,0,0,0,0,0,04537
1214,1617,100,449,494,348,226,93,72,67,20,0,47,5,5,5,0,0,0,0,0,0,21,21,5,0,16,0,0,0,0,0,0,0,0,0,04538
1215,1013,48,347,232,186,200,14,14,14,0,0,14,0,0,0,0,0,0,0,0,0,0,0,0,0,0,0,0,0,0,0,0,0,0,0,04539
1216,112,0,15,45,0,52,0,0,0,0,0,0,0,0,0,0,0,0,0,0,0,0,0,0,0,0,0,0,0,0,0,0,0,0,0,04541
1217,1490,92,392,428,299,279,83,56,56,11,21,24,0,0,0,0,0,0,0,0,0,27,18,5,0,13,9,9,0,0,9,0,0,0,0,04543
1218,548,5,63,181,145,154,19,19,19,0,0,19,0,0,0,0,0,0,0,0,0,0,0,0,0,0,0,0,0,0,0,0,0,0,0,04544
1219,908,137,338,245,127,61,47,27,24,4,10,10,3,0,0,0,0,3,0,0,3,20,15,5,0,10,5,5,5,0,0,0,0,0,0,04547
1220,779,82,202,184,154,157,25,18,18,3,0,15,0,0,0,0,0,0,0,0,0,7,7,0,0,7,0,0,0,0,0,0,0,0,0,04548
1221,645,63,144,144,154,140,40,19,13,0,0,13,6,3,0,3,0,3,0,0,3,21,21,17,0,4,0,0,0,0,0,0,0,0,0,04551
1222,1331,80,319,354,332,246,69,36,32,6,0,26,4,4,0,4,0,0,0,0,0,33,30,11,7,12,3,3,0,0,3,0,0,0,0,04553
1223,695,42,227,226,161,39,0,0,0,0,0,0,0,0,0,0,0,0,0,0,0,0,0,0,0,0,0,0,0,0,0,0,0,0,0,04554
1224,1264,67,279,412,309,197,117,71,71,6,4,61,0,0,0,0,0,0,0,0,0,46,46,26,4,16,0,0,0,0,0,0,0,0,0,04555
1225,843,49,204,252,203,135,66,33,19,3,0,16,14,14,9,0,5,0,0,0,0,33,11,6,0,5,22,10,10,0,0,12,0,0,12,04556
1226,298,0,80,96,53,69,0,0,0,0,0,0,0,0,0,0,0,0,0,0,0,0,0,0,0,0,0,0,0,0,0,0,0,0,0,04558
1227,1747,137,618,532,285,175,81,35,30,8,5,17,5,5,5,0,0,0,0,0,0,46,37,25,0,12,9,9,9,0,0,0,0,0,0,04562
1228,953,70,417,253,133,80,85,44,39,32,0,7,5,5,4,1,0,0,0,0,0,41,41,11,2,28,0,0,0,0,0,0,0,0,0,04563
1229,290,3,96,24,147,20,0,0,0,0,0,0,0,0,0,0,0,0,0,0,0,0,0,0,0,0,0,0,0,0,0,0,0,0,0,04564
1230,413,19,96,110,99,89,18,11,11,3,0,8,0,0,0,0,0,0,0,0,0,7,4,4,0,0,3,3,0,0,3,0,0,0,0,04568
1231,0,0,0,0,0,0,0,0,0,0,0,0,0,0,0,0,0,0,0,0,0,0,0,0,0,0,0,0,0,0,0,0,0,0,0,04570
1232,342,0,121,63,69,89,0,0,0,0,0,0,0,0,0,0,0,0,0,0,0,0,0,0,0,0,0,0,0,0,0,0,0,0,0,04571
1233,3378,301,1398,768,561,350,199,100,39,24,0,15,61,61,0,31,30,0,0,0,0,99,66,48,0,18,33,33,33,0,0,0,0,0,0,04572
1234,384,12,106,120,109,37,33,17,17,4,0,13,0,0,0,0,0,0,0,0,0,16,16,5,0,11,0,0,0,0,0,0,0,0,0,04573
1235,1168,113,584,263,134,74,39,22,22,3,0,19,0,0,0,0,0,0,0,0,0,17,17,0,0,17,0,0,0,0,0,0,0,0,0,04574
1236,49,0,0,7,12,30,4,2,1,1,0,0,1,1,1,0,0,0,0,0,0,2,0,0,0,0,2,2,2,0,0,0,0,0,0,04575
1237,561,42,120,148,156,95,4,0,0,0,0,0,0,0,0,0,0,0,0,0,0,4,4,2,0,2,0,0,0,0,0,0,0,0,0,04576
1238,3223,232,1170,926,620,275,330,208,165,63,7,95,43,33,28,0,5,10,0,0,10,122,109,24,0,85,13,13,13,0,0,0,0,0,0,04578
1239,2193,124,890,566,415,198,148,54,54,21,0,33,0,0,0,0,0,0,0,0,0,94,94,16,0,78,0,0,0,0,0,0,0,0,0,04579
1240,9919,767,3315,2967,1976,894,523,283,226,56,5,165,57,18,2,16,0,39,0,0,39,240,216,62,25,129,24,19,17,1,1,5,0,0,5,04605
1241,915,106,362,271,127,49,41,20,14,4,0,10,6,6,0,0,6,0,0,0,0,21,21,5,0,16,0,0,0,0,0,0,0,0,0,04606
1242,833,126,286,286,82,53,58,36,36,6,0,30,0,0,0,0,0,0,0,0,0,22,22,0,3,19,0,0,0,0,0,0,0,0,0,04607
1243,3781,205,843,839,1066,828,453,215,215,105,0,110,0,0,0,0,0,0,0,0,0,238,229,146,18,65,9,9,9,0,0,0,0,0,0,04609
1244,337,55,147,71,58,6,15,13,13,4,0,9,0,0,0,0,0,0,0,0,0,2,0,0,0,0,2,2,2,0,0,0,0,0,0,04611
1245,397,53,101,116,95,32,17,11,11,4,4,3,0,0,0,0,0,0,0,0,0,6,6,6,0,0,0,0,0,0,0,0,0,0,0,04612
1246,128,13,65,26,8,16,0,0,0,0,0,0,0,0,0,0,0,0,0,0,0,0,0,0,0,0,0,0,0,0,0,0,0,0,0,04613
1247,1915,50,589,451,366,459,140,53,53,37,0,16,0,0,0,0,0,0,0,0,0,87,87,36,0,51,0,0,0,0,0,0,0,0,0,04614
1248,713,56,166,179,193,119,43,29,27,22,0,5,2,2,2,0,0,0,0,0,0,14,14,10,0,4,0,0,0,0,0,0,0,0,0,04616
1249,649,39,120,135,214,141,27,13,13,2,0,11,0,0,0,0,0,0,0,0,0,14,13,6,0,7,1,1,1,0,0,0,0,0,0,04617
1250,2292,347,750,748,275,172,126,66,60,23,19,18,6,6,0,0,6,0,0,0,0,60,41,24,0,17,19,19,19,0,0,0,0,0,0,04619
1251,1033,173,455,236,103,66,33,17,17,4,8,5,0,0,0,0,0,0,0,0,0,16,16,0,3,13,0,0,0,0,0,0,0,0,0,04622
1252,862,113,349,249,131,20,125,28,15,8,0,7,13,13,0,13,0,0,0,0,0,97,48,1,0,47,49,49,0,0,49,0,0,0,0,04623
1253,144,0,63,43,23,15,0,0,0,0,0,0,0,0,0,0,0,0,0,0,0,0,0,0,0,0,0,0,0,0,0,0,0,0,0,04624
1254,17,8,2,1,5,1,0,0,0,0,0,0,0,0,0,0,0,0,0,0,0,0,0,0,0,0,0,0,0,0,0,0,0,0,0,04625
1255,336,39,138,86,51,22,14,5,5,0,3,2,0,0,0,0,0,0,0,0,0,9,9,0,2,7,0,0,0,0,0,0,0,0,0,04626
1256,1240,160,457,263,231,129,94,51,38,20,0,18,13,6,6,0,0,7,7,0,0,43,39,9,0,30,4,4,4,0,0,0,0,0,0,04627
1257,495,36,257,112,57,33,47,18,14,0,0,14,4,0,0,0,0,4,3,0,1,29,25,14,0,11,4,2,0,0,2,2,0,2,0,04628
1258,213,0,0,12,152,49,0,0,0,0,0,0,0,0,0,0,0,0,0,0,0,0,0,0,0,0,0,0,0,0,0,0,0,0,0,04629
1259,901,109,297,267,181,47,103,56,56,13,0,43,0,0,0,0,0,0,0,0,0,47,47,17,3,27,0,0,0,0,0,0,0,0,0,04630
1260,1139,85,361,318,230,145,67,56,24,17,7,0,32,20,20,0,0,12,0,0,12,11,3,1,0,2,8,8,8,0,0,0,0,0,0,04631
1261,1448,154,679,371,172,72,85,41,33,9,8,16,8,6,6,0,0,2,0,0,2,44,42,20,0,22,2,2,0,2,0,0,0,0,0,04634
1262,30,0,19,10,1,0,9,9,9,0,0,9,0,0,0,0,0,0,0,0,0,0,0,0,0,0,0,0,0,0,0,0,0,0,0,04635
1263,116,5,42,27,26,16,0,0,0,0,0,0,0,0,0,0,0,0,0,0,0,0,0,0,0,0,0,0,0,0,0,0,0,0,0,04637
1264,1661,120,719,412,250,160,62,12,8,0,0,8,4,4,0,0,4,0,0,0,0,50,26,8,3,15,24,5,5,0,0,19,0,0,19,04640
1265,52,0,30,4,12,6,0,0,0,0,0,0,0,0,0,0,0,0,0,0,0,0,0,0,0,0,0,0,0,0,0,0,0,0,0,04642
1266,729,104,342,172,78,33,48,25,19,0,0,19,6,0,0,0,0,6,0,0,6,23,18,0,0,18,5,0,0,0,0,5,0,0,5,04643
1267,0,0,0,0,0,0,0,0,0,0,0,0,0,0,0,0,0,0,0,0,0,0,0,0,0,0,0,0,0,0,0,0,0,0,0,04644
1268,46,6,14,7,11,8,4,2,0,0,0,0,2,0,0,0,0,2,2,0,0,2,2,0,0,2,0,0,0,0,0,0,0,0,0,04645
1269,62,1,14,15,24,8,0,0,0,0,0,0,0,0,0,0,0,0,0,0,0,0,0,0,0,0,0,0,0,0,0,0,0,0,0,04646
1270,321,21,154,86,39,21,17,6,6,0,0,6,0,0,0,0,0,0,0,0,0,11,11,3,0,8,0,0,0,0,0,0,0,0,0,04648
1271,1032,124,476,222,133,77,59,34,21,10,0,11,13,13,13,0,0,0,0,0,0,25,23,6,0,17,2,2,0,2,0,0,0,0,0,04649
1272,150,27,55,45,4,19,12,12,12,0,0,12,0,0,0,0,0,0,0,0,0,0,0,0,0,0,0,0,0,0,0,0,0,0,0,04650
1273,1527,197,608,413,172,137,94,29,13,10,0,3,16,4,0,4,0,12,0,0,12,65,62,10,3,49,3,3,3,0,0,0,0,0,0,04652
1274,346,3,121,110,69,43,5,0,0,0,0,0,0,0,0,0,0,0,0,0,0,5,5,0,0,5,0,0,0,0,0,0,0,0,0,04653
1275,2152,235,746,628,335,208,286,130,130,85,12,33,0,0,0,0,0,0,0,0,0,156,156,74,17,65,0,0,0,0,0,0,0,0,0,04654
1276,862,115,348,212,117,70,30,14,14,0,0,14,0,0,0,0,0,0,0,0,0,16,13,4,0,9,3,3,0,3,0,0,0,0,0,04655
1277,274,11,104,107,40,12,22,7,4,1,2,1,3,3,0,0,3,0,0,0,0,15,13,5,0,8,2,2,0,0,2,0,0,0,0,04657
1278,1009,126,403,269,161,50,64,34,25,0,0,25,9,0,0,0,0,9,0,9,0,30,26,2,3,21,4,4,0,0,4,0,0,0,0,04658
1279,1155,11,280,204,343,317,19,9,4,4,0,0,5,5,0,0,5,0,0,0,0,10,10,0,0,10,0,0,0,0,0,0,0,0,0,04660
1280,364,0,99,132,84,49,13,13,13,0,0,13,0,0,0,0,0,0,0,0,0,0,0,0,0,0,0,0,0,0,0,0,0,0,0,04662
1281,826,95,325,221,106,79,19,2,0,0,0,0,2,2,2,0,0,0,0,0,0,17,17,0,0,17,0,0,0,0,0,0,0,0,0,04664
1282,949,130,345,290,124,60,41,20,17,1,2,14,3,3,0,2,1,0,0,0,0,21,16,9,0,7,5,0,0,0,0,5,0,0,5,04666
1283,1057,129,349,381,135,63,105,66,45,0,10,35,21,8,0,0,8,13,0,11,2,39,32,3,0,29,7,5,0,5,0,2,0,2,0,04667
1284,1051,145,344,450,97,15,97,67,52,9,6,37,15,5,2,3,0,10,0,7,3,30,19,3,2,14,11,8,6,2,0,3,0,1,2,04668
1285,110,10,34,16,18,32,0,0,0,0,0,0,0,0,0,0,0,0,0,0,0,0,0,0,0,0,0,0,0,0,0,0,0,0,0,04669
1286,410,22,166,161,26,35,17,11,11,2,4,5,0,0,0,0,0,0,0,0,0,6,2,0,0,2,4,4,4,0,0,0,0,0,0,04671
1287,76,13,7,32,14,10,1,1,1,0,0,1,0,0,0,0,0,0,0,0,0,0,0,0,0,0,0,0,0,0,0,0,0,0,0,04673
1288,453,54,198,93,77,31,21,17,14,0,0,14,3,3,3,0,0,0,0,0,0,4,4,4,0,0,0,0,0,0,0,0,0,0,0,04674
1289,302,1,120,48,49,84,4,0,0,0,0,0,0,0,0,0,0,0,0,0,0,4,4,0,0,4,0,0,0,0,0,0,0,0,0,04675
1290,743,66,239,188,166,84,28,19,16,10,0,6,3,3,3,0,0,0,0,0,0,9,7,2,0,5,2,2,2,0,0,0,0,0,0,04676
1291,208,18,53,54,44,39,3,2,2,0,0,2,0,0,0,0,0,0,0,0,0,1,1,0,0,1,0,0,0,0,0,0,0,0,0,04677
1292,1277,94,414,329,300,140,102,55,50,7,0,43,5,5,5,0,0,0,0,0,0,47,43,8,5,30,4,4,0,0,4,0,0,0,0,04679
1293,771,174,283,156,85,73,36,23,16,6,7,3,7,5,5,0,0,2,0,0,2,13,13,5,1,7,0,0,0,0,0,0,0,0,0,04680
1294,958,127,350,234,153,94,24,14,10,0,0,10,4,4,0,4,0,0,0,0,0,10,10,2,0,8,0,0,0,0,0,0,0,0,0,04681
1295,8,0,0,0,0,8,7,0,0,0,0,0,0,0,0,0,0,0,0,0,0,7,7,7,0,0,0,0,0,0,0,0,0,0,0,04683
1296,1266,105,336,385,268,172,75,40,28,6,0,22,12,10,4,6,0,2,0,2,0,35,32,0,4,28,3,3,3,0,0,0,0,0,0,04684
1297,227,27,74,57,35,34,6,4,1,0,0,1,3,3,0,0,3,0,0,0,0,2,2,0,0,2,0,0,0,0,0,0,0,0,0,04685
1298,80,7,29,31,9,4,0,0,0,0,0,0,0,0,0,0,0,0,0,0,0,0,0,0,0,0,0,0,0,0,0,0,0,0,0,04686
1299,370,17,111,111,73,58,25,14,11,2,0,9,3,0,0,0,0,3,0,0,3,11,11,0,0,11,0,0,0,0,0,0,0,0,0,04691
1300,376,29,162,111,52,22,19,5,0,0,0,0,5,5,0,0,5,0,0,0,0,14,14,8,0,6,0,0,0,0,0,0,0,0,0,04693
1301,1744,184,682,586,200,92,135,85,74,15,8,51,11,11,0,11,0,0,0,0,0,50,43,0,11,32,7,0,0,0,0,7,0,3,4,04694
1302,7145,948,2851,2318,824,204,642,379,308,75,50,183,71,54,40,0,14,17,0,17,0,263,229,68,13,148,34,29,27,0,2,5,0,3,2,04730
1303,1206,241,482,361,82,40,67,29,23,6,0,17,6,6,0,6,0,0,0,0,0,38,28,8,4,16,10,0,0,0,0,10,0,0,10,04732
1304,211,9,71,114,9,8,6,6,6,6,0,0,0,0,0,0,0,0,0,0,0,0,0,0,0,0,0,0,0,0,0,0,0,0,0,04733
1305,569,59,250,181,64,15,34,26,26,0,10,16,0,0,0,0,0,0,0,0,0,8,8,1,0,7,0,0,0,0,0,0,0,0,0,04734
1306,447,43,210,156,23,15,38,28,24,5,2,17,4,3,3,0,0,1,1,0,0,10,8,4,0,4,2,1,0,0,1,1,0,0,1,04735
1307,7001,1226,2297,2153,914,411,521,319,316,147,25,144,3,0,0,0,0,3,0,3,0,202,189,60,10,119,13,5,3,0,2,8,5,0,3,04736
1308,740,169,291,190,76,14,20,11,5,2,2,1,6,6,0,0,6,0,0,0,0,9,9,5,0,4,0,0,0,0,0,0,0,0,0,04739
1309,900,94,321,326,108,51,26,20,20,12,0,8,0,0,0,0,0,0,0,0,0,6,3,0,3,0,3,3,0,3,0,0,0,0,0,04740
1310,0,0,0,0,0,0,0,0,0,0,0,0,0,0,0,0,0,0,0,0,0,0,0,0,0,0,0,0,0,0,0,0,0,0,0,04741
1311,2457,451,900,710,263,133,216,71,71,0,13,58,0,0,0,0,0,0,0,0,0,145,117,69,24,24,28,28,0,0,28,0,0,0,0,04742
1312,3263,536,1131,807,537,252,178,58,46,21,1,24,12,12,12,0,0,0,0,0,0,120,110,61,8,41,10,10,1,0,9,0,0,0,0,04743
1313,829,106,361,253,72,37,71,47,47,16,0,31,0,0,0,0,0,0,0,0,0,24,24,11,0,13,0,0,0,0,0,0,0,0,0,04745
1314,374,68,194,77,26,9,39,10,7,0,3,4,3,3,3,0,0,0,0,0,0,29,29,13,0,16,0,0,0,0,0,0,0,0,0,04746
1315,1145,120,465,345,157,58,50,24,9,4,0,5,15,7,0,5,2,8,3,0,5,26,23,5,0,18,3,3,0,3,0,0,0,0,0,04747
1316,1568,177,644,484,209,54,283,100,100,17,9,74,0,0,0,0,0,0,0,0,0,183,163,79,5,79,20,20,0,0,20,0,0,0,0,04750
1317,2709,435,1169,663,381,61,84,50,50,33,0,17,0,0,0,0,0,0,0,0,0,34,30,30,0,0,4,0,0,0,0,4,0,0,4,04756
1318,1986,210,746,659,255,116,115,49,35,15,12,8,14,14,14,0,0,0,0,0,0,66,54,20,6,28,12,12,12,0,0,0,0,0,0,04757
1319,1085,150,416,363,134,22,65,26,19,9,5,5,7,5,5,0,0,2,2,0,0,39,26,14,0,12,13,13,8,5,0,0,0,0,0,04758
1320,518,73,227,149,60,9,23,16,16,5,0,11,0,0,0,0,0,0,0,0,0,7,7,0,0,7,0,0,0,0,0,0,0,0,0,04760
1321,351,52,140,115,33,11,15,4,0,0,0,0,4,4,0,0,4,0,0,0,0,11,8,3,0,5,3,3,3,0,0,0,0,0,0,04761
1322,479,81,144,136,63,55,8,0,0,0,0,0,0,0,0,0,0,0,0,0,0,8,8,3,0,5,0,0,0,0,0,0,0,0,0,04762
1323,478,51,213,146,58,10,44,17,17,3,0,14,0,0,0,0,0,0,0,0,0,27,17,6,2,9,10,10,4,0,6,0,0,0,0,04763
1324,50,4,20,20,6,0,0,0,0,0,0,0,0,0,0,0,0,0,0,0,0,0,0,0,0,0,0,0,0,0,0,0,0,0,0,04764
1325,1109,152,557,268,82,50,59,43,43,13,0,30,0,0,0,0,0,0,0,0,0,16,16,3,0,13,0,0,0,0,0,0,0,0,0,04765
1326,275,29,129,75,29,13,32,15,15,0,2,13,0,0,0,0,0,0,0,0,0,17,12,5,0,7,5,2,0,2,0,3,0,0,3,04766
1327,353,60,123,106,43,21,4,0,0,0,0,0,0,0,0,0,0,0,0,0,0,4,4,0,2,2,0,0,0,0,0,0,0,0,0,04768
1328,6571,738,2313,2180,889,451,682,429,395,269,22,104,34,34,34,0,0,0,0,0,0,253,253,86,46,121,0,0,0,0,0,0,0,0,0,04769
1329,591,112,247,146,56,30,20,14,11,2,0,9,3,3,3,0,0,0,0,0,0,6,6,0,0,6,0,0,0,0,0,0,0,0,0,04772
1330,422,71,211,104,26,10,0,0,0,0,0,0,0,0,0,0,0,0,0,0,0,0,0,0,0,0,0,0,0,0,0,0,0,0,0,04773
1331,612,161,240,120,63,28,12,9,7,2,2,3,2,0,0,0,0,2,0,0,2,3,3,0,0,3,0,0,0,0,0,0,0,0,0,04774
1332,717,56,315,248,70,28,46,7,7,4,0,3,0,0,0,0,0,0,0,0,0,39,28,5,0,23,11,6,0,6,0,5,0,0,5,04776
1333,292,35,124,101,20,12,41,38,20,0,2,18,18,0,0,0,0,18,0,0,18,3,3,3,0,0,0,0,0,0,0,0,0,0,0,04777
1334,232,36,83,55,45,13,0,0,0,0,0,0,0,0,0,0,0,0,0,0,0,0,0,0,0,0,0,0,0,0,0,0,0,0,0,04779
1335,514,100,201,153,41,19,52,24,20,8,0,12,4,0,0,0,0,4,0,2,2,28,18,0,5,13,10,8,5,3,0,2,0,0,2,04780
1336,412,84,159,65,76,28,15,11,6,4,2,0,5,5,3,0,2,0,0,0,0,4,4,4,0,0,0,0,0,0,0,0,0,0,0,04781
1337,284,37,83,85,65,14,15,2,2,0,0,2,0,0,0,0,0,0,0,0,0,13,13,6,0,7,0,0,0,0,0,0,0,0,0,04783
1338,2177,509,824,631,129,84,106,29,29,6,6,17,0,0,0,0,0,0,0,0,0,77,77,18,0,59,0,0,0,0,0,0,0,0,0,04785
1339,1388,193,560,441,182,12,85,29,27,0,12,15,2,2,2,0,0,0,0,0,0,56,53,10,5,38,3,3,3,0,0,0,0,0,0,04786
1340,503,43,284,116,56,4,30,16,16,6,0,10,0,0,0,0,0,0,0,0,0,14,14,0,0,14,0,0,0,0,0,0,0,0,0,04787
1341,5402,511,2077,1288,1066,460,235,96,91,64,0,27,5,1,1,0,0,4,0,0,4,139,135,97,0,38,4,4,0,0,4,0,0,0,0,04841
1342,3934,167,626,1072,1306,763,88,53,39,0,0,39,14,14,0,0,14,0,0,0,0,35,35,13,0,22,0,0,0,0,0,0,0,0,0,04843
1343,1053,41,357,309,217,129,101,41,37,13,0,24,4,4,4,0,0,0,0,0,0,60,53,21,7,25,7,7,7,0,0,0,0,0,0,04847
1344,505,27,121,146,121,90,18,7,7,0,0,7,0,0,0,0,0,0,0,0,0,11,9,3,0,6,2,0,0,0,0,2,0,0,2,04848
1345,2981,126,931,811,626,487,183,82,65,24,21,20,17,17,17,0,0,0,0,0,0,101,93,58,0,35,8,8,0,8,0,0,0,0,0,04849
1346,27,2,3,5,13,4,2,0,0,0,0,0,0,0,0,0,0,0,0,0,0,2,2,2,0,0,0,0,0,0,0,0,0,0,0,04851
1347,39,0,8,14,6,11,0,0,0,0,0,0,0,0,0,0,0,0,0,0,0,0,0,0,0,0,0,0,0,0,0,0,0,0,0,04852
1348,310,5,114,57,85,49,9,6,6,0,0,6,0,0,0,0,0,0,0,0,0,3,3,0,0,3,0,0,0,0,0,0,0,0,0,04853
1349,1286,101,467,352,258,108,64,32,29,7,3,19,3,3,3,0,0,0,0,0,0,32,23,3,0,20,9,9,9,0,0,0,0,0,0,04854
1350,234,25,56,45,43,65,0,0,0,0,0,0,0,0,0,0,0,0,0,0,0,0,0,0,0,0,0,0,0,0,0,0,0,0,0,04855
1351,2337,84,726,604,633,290,263,143,130,24,21,85,13,13,0,0,13,0,0,0,0,120,112,78,0,34,8,8,8,0,0,0,0,0,0,04856
1352,1061,59,472,238,184,108,20,12,9,0,0,9,3,3,0,0,3,0,0,0,0,8,5,0,0,5,3,3,3,0,0,0,0,0,0,04858
1353,315,27,111,96,74,7,0,0,0,0,0,0,0,0,0,0,0,0,0,0,0,0,0,0,0,0,0,0,0,0,0,0,0,0,0,04859
1354,1517,107,457,404,383,166,128,69,40,13,8,19,29,19,10,9,0,10,0,10,0,59,59,42,11,6,0,0,0,0,0,0,0,0,0,04860
1355,2080,118,813,533,402,214,120,60,60,12,0,48,0,0,0,0,0,0,0,0,0,60,60,41,0,19,0,0,0,0,0,0,0,0,0,04861
1356,2751,189,1088,807,452,215,203,119,88,5,8,75,31,31,31,0,0,0,0,0,0,84,82,29,24,29,2,2,2,0,0,0,0,0,0,04862
1357,861,111,370,163,139,78,48,28,8,5,0,3,20,9,9,0,0,11,11,0,0,20,11,11,0,0,9,9,9,0,0,0,0,0,0,04863
1358,3386,274,1621,1024,380,87,194,120,120,18,0,102,0,0,0,0,0,0,0,0,0,74,74,56,0,18,0,0,0,0,0,0,0,0,0,04864
1359,17837,1835,6654,5195,2297,1856,1865,912,817,180,165,472,95,43,33,0,10,52,0,0,52,953,881,271,129,481,72,64,61,0,3,8,0,0,8,04901
1360,1357,115,584,433,173,52,73,20,11,5,0,6,9,4,4,0,0,5,5,0,0,53,53,32,0,21,0,0,0,0,0,0,0,0,0,04910
1361,1491,210,761,400,85,35,112,51,45,5,0,40,6,6,6,0,0,0,0,0,0,61,58,10,3,45,3,3,0,3,0,0,0,0,0,04911
1362,763,89,308,248,99,19,64,8,5,0,0,5,3,3,0,0,3,0,0,0,0,56,46,16,3,27,10,6,0,0,6,4,0,0,4,04912
1363,6113,733,1904,1385,1208,883,261,139,123,35,4,84,16,4,0,0,4,12,0,12,0,122,113,20,3,90,9,4,0,3,1,5,5,0,0,04915
1364,2040,90,501,725,412,312,133,117,95,20,26,49,22,0,0,0,0,22,0,0,22,16,15,6,0,9,1,0,0,0,0,1,0,0,1,04917
1365,280,1,71,125,55,28,0,0,0,0,0,0,0,0,0,0,0,0,0,0,0,0,0,0,0,0,0,0,0,0,0,0,0,0,0,04918
1366,1321,231,533,388,151,18,49,22,15,0,3,12,7,4,0,0,4,3,0,3,0,27,25,21,1,3,2,2,2,0,0,0,0,0,0,04920
1367,1050,103,455,320,125,47,80,28,22,2,2,18,6,2,2,0,0,4,0,4,0,52,49,36,4,9,3,3,3,0,0,0,0,0,0,04921
1368,856,129,425,230,58,14,62,26,26,0,0,26,0,0,0,0,0,0,0,0,0,36,23,0,0,23,13,8,3,5,0,5,0,0,5,04922
1369,411,82,220,80,20,9,10,1,1,0,0,1,0,0,0,0,0,0,0,0,0,9,9,1,0,8,0,0,0,0,0,0,0,0,0,04923
1370,1531,193,529,560,167,82,180,92,74,16,0,58,18,18,7,11,0,0,0,0,0,88,88,46,0,42,0,0,0,0,0,0,0,0,0,04924
1371,76,2,23,21,12,18,0,0,0,0,0,0,0,0,0,0,0,0,0,0,0,0,0,0,0,0,0,0,0,0,0,0,0,0,0,04925
1372,41,24,17,0,0,0,0,0,0,0,0,0,0,0,0,0,0,0,0,0,0,0,0,0,0,0,0,0,0,0,0,0,0,0,0,04926
1373,2423,314,1177,622,175,135,182,87,55,0,0,55,32,18,0,0,18,14,14,0,0,95,95,22,16,57,0,0,0,0,0,0,0,0,0,04927
1374,1511,170,723,386,176,56,67,23,23,5,0,18,0,0,0,0,0,0,0,0,0,44,35,28,0,7,9,6,6,0,0,3,0,0,3,04928
1375,636,75,352,150,51,8,37,26,14,4,0,10,12,12,6,3,3,0,0,0,0,11,6,3,0,3,5,5,3,0,2,0,0,0,0,04929
1376,3252,404,1498,951,320,79,213,118,95,14,2,79,23,23,7,9,7,0,0,0,0,95,95,44,0,51,0,0,0,0,0,0,0,0,0,04930
1377,864,70,329,285,122,58,35,10,10,4,3,3,0,0,0,0,0,0,0,0,0,25,25,2,0,23,0,0,0,0,0,0,0,0,0,04932
1378,33,0,17,16,0,0,0,0,0,0,0,0,0,0,0,0,0,0,0,0,0,0,0,0,0,0,0,0,0,0,0,0,0,0,0,04933
1379,211,46,84,53,15,13,4,4,4,4,0,0,0,0,0,0,0,0,0,0,0,0,0,0,0,0,0,0,0,0,0,0,0,0,0,04936
1380,4630,469,1836,1585,545,195,144,47,47,28,13,6,0,0,0,0,0,0,0,0,0,97,66,43,0,23,31,16,0,0,16,15,0,0,15,04937
1381,6331,621,2092,1571,1220,827,998,343,338,174,0,164,5,5,5,0,0,0,0,0,0,655,631,311,65,255,24,24,21,0,3,0,0,0,0,04938
1382,796,93,356,228,75,44,46,35,35,21,0,14,0,0,0,0,0,0,0,0,0,11,8,3,0,5,3,3,0,3,0,0,0,0,0,04939
1383,28,0,28,0,0,0,0,0,0,0,0,0,0,0,0,0,0,0,0,0,0,0,0,0,0,0,0,0,0,0,0,0,0,0,0,04940
1384,1124,69,396,302,285,72,106,58,38,10,8,20,20,20,14,3,3,0,0,0,0,48,41,20,0,21,7,7,0,0,7,0,0,0,0,04941
1385,904,164,402,205,95,38,48,28,28,8,8,12,0,0,0,0,0,0,0,0,0,20,20,7,0,13,0,0,0,0,0,0,0,0,0,04942
1386,1392,171,608,457,94,62,54,35,32,7,7,18,3,3,3,0,0,0,0,0,0,19,11,0,0,11,8,4,0,0,4,4,0,0,4,04943
1387,56,0,56,0,0,0,0,0,0,0,0,0,0,0,0,0,0,0,0,0,0,0,0,0,0,0,0,0,0,0,0,0,0,0,0,04944
1388,869,95,385,234,126,29,63,32,28,8,0,20,4,4,0,0,4,0,0,0,0,31,31,27,0,4,0,0,0,0,0,0,0,0,0,04945
1389,1285,41,337,401,305,201,133,83,71,23,9,39,12,12,3,9,0,0,0,0,0,50,46,11,4,31,4,4,4,0,0,0,0,0,0,04947
1390,555,33,213,169,94,46,24,17,17,0,2,15,0,0,0,0,0,0,0,0,0,7,2,0,0,2,5,5,5,0,0,0,0,0,0,04949
1391,3535,498,1637,941,349,110,235,93,74,44,13,17,19,15,0,15,0,4,0,0,4,142,79,29,0,50,63,31,18,0,13,32,0,0,32,04950
1392,729,47,322,162,127,71,44,19,12,4,0,8,7,4,4,0,0,3,3,0,0,25,19,12,7,0,6,0,0,0,0,6,0,0,6,04951
1393,1352,132,507,414,188,111,124,64,52,19,13,20,12,12,8,4,0,0,0,0,0,60,44,6,0,38,16,13,0,13,0,3,0,0,3,04952
1394,2324,317,867,755,295,90,228,122,86,18,0,68,36,28,19,0,9,8,8,0,0,106,77,29,0,48,29,29,8,13,8,0,0,0,0,04953
1395,970,76,378,293,142,81,52,26,26,7,3,16,0,0,0,0,0,0,0,0,0,26,8,0,0,8,18,6,6,0,0,12,12,0,0,04955
1396,502,68,209,115,82,28,3,3,3,0,0,3,0,0,0,0,0,0,0,0,0,0,0,0,0,0,0,0,0,0,0,0,0,0,0,04956
1397,3162,430,1228,864,497,143,284,177,163,30,0,133,14,14,4,10,0,0,0,0,0,107,99,17,3,79,8,8,8,0,0,0,0,0,0,04957
1398,1428,173,675,412,135,33,76,32,12,3,0,9,20,20,9,11,0,0,0,0,0,44,20,4,0,16,24,14,11,0,3,10,10,0,0,04958
1399,750,60,343,236,62,49,37,27,27,8,13,6,0,0,0,0,0,0,0,0,0,10,10,7,0,3,0,0,0,0,0,0,0,0,0,04961
1400,72,0,22,30,10,10,0,0,0,0,0,0,0,0,0,0,0,0,0,0,0,0,0,0,0,0,0,0,0,0,0,0,0,0,0,04962
1401,5295,397,1770,1763,720,645,411,217,179,26,32,121,38,38,16,0,22,0,0,0,0,194,111,39,0,72,83,83,62,0,21,0,0,0,0,04963
1402,151,1,35,78,23,14,0,0,0,0,0,0,0,0,0,0,0,0,0,0,0,0,0,0,0,0,0,0,0,0,0,0,0,0,0,04964
1403,1480,197,707,367,149,60,114,51,40,0,5,35,11,0,0,0,0,11,11,0,0,63,58,33,0,25,5,5,5,0,0,0,0,0,0,04965
1404,1398,124,606,451,146,71,90,37,33,11,0,22,4,4,4,0,0,0,0,0,0,53,46,10,7,29,7,3,0,3,0,4,0,4,0,04966
1405,2778,398,956,809,459,156,215,127,99,6,1,92,28,0,0,0,0,28,28,0,0,88,88,15,22,51,0,0,0,0,0,0,0,0,0,04967
1406,813,123,287,317,52,34,66,37,34,24,4,6,3,3,3,0,0,0,0,0,0,29,18,9,0,9,11,2,0,0,2,9,0,0,9,04969
1407,1193,67,405,387,232,102,62,52,4,0,0,4,48,39,39,0,0,9,9,0,0,10,0,0,0,0,10,10,0,0,10,0,0,0,0,04970
1408,1437,188,665,421,128,35,151,121,82,33,0,49,39,18,18,0,0,21,0,0,21,30,30,19,0,11,0,0,0,0,0,0,0,0,0,04971
1409,1144,82,408,348,263,43,74,36,32,4,9,19,4,4,4,0,0,0,0,0,0,38,38,5,4,29,0,0,0,0,0,0,0,0,0,04973
1410,1923,238,779,414,351,141,111,111,77,31,31,15,34,0,0,0,0,34,0,0,34,0,0,0,0,0,0,0,0,0,0,0,0,0,0,04974
1411,121,0,45,36,40,0,0,0,0,0,0,0,0,0,0,0,0,0,0,0,0,0,0,0,0,0,0,0,0,0,0,0,0,0,0,04975
1412,6903,905,2774,2110,735,379,485,243,218,74,12,132,25,6,6,0,0,19,0,5,14,242,207,68,12,127,35,0,0,0,0,35,12,0,23,04976
1413,592,44,245,192,76,35,47,13,9,0,0,9,4,4,0,4,0,0,0,0,0,34,23,0,0,23,11,6,6,0,0,5,5,0,0,04978
1414,815,44,349,327,61,34,29,4,0,0,0,0,4,4,4,0,0,0,0,0,0,25,20,5,4,11,5,0,0,0,0,5,0,0,5,04979
1415,1657,105,550,521,288,193,80,43,39,20,6,13,4,0,0,0,0,4,0,0,4,37,37,13,0,24,0,0,0,0,0,0,0,0,0,04981
1416,348,59,207,58,22,2,26,13,13,3,0,10,0,0,0,0,0,0,0,0,0,13,6,6,0,0,7,0,0,0,0,7,7,0,0,04982
1417,1164,149,447,357,163,48,51,30,30,16,5,9,0,0,0,0,0,0,0,0,0,21,21,8,0,13,0,0,0,0,0,0,0,0,0,04983
1418,415,26,156,125,75,33,27,15,15,0,0,15,0,0,0,0,0,0,0,0,0,12,11,0,0,11,1,1,0,0,1,0,0,0,0,04984
1419,64,2,18,11,24,9,2,2,2,2,0,0,0,0,0,0,0,0,0,0,0,0,0,0,0,0,0,0,0,0,0,0,0,0,0,04985
1420,1198,89,620,295,144,50,78,52,49,8,7,34,3,0,0,0,0,3,0,0,3,26,26,7,0,19,0,0,0,0,0,0,0,0,0,04986
1421,702,89,273,229,70,41,14,4,4,0,0,4,0,0,0,0,0,0,0,0,0,10,10,0,0,10,0,0,0,0,0,0,0,0,0,04987
1422,1324,184,550,307,144,139,244,107,103,0,26,77,4,4,4,0,0,0,0,0,0,137,130,82,11,37,7,0,0,0,0,7,0,0,7,04988
1423,3123,313,1251,867,408,284,133,86,63,10,0,53,23,23,0,23,0,0,0,0,0,47,46,26,0,20,1,1,0,0,1,0,0,0,0,04989
1424,149,0,20,129,0,0,0,0,0,0,0,0,0,0,0,0,0,0,0,0,0,0,0,0,0,0,0,0,0,0,0,0,0,0,0,04992
1425,6836,518,2217,1515,1420,1166,497,274,249,136,10,103,25,25,25,0,0,0,0,0,0,223,191,10,78,103,32,20,20,0,0,12,0,0,12,05001
1426,96,19,0,16,36,25,0,0,0,0,0,0,0,0,0,0,0,0,0,0,0,0,0,0,0,0,0,0,0,0,0,0,0,0,0,05031
1427,2134,152,714,672,295,301,108,47,41,0,0,41,6,6,6,0,0,0,0,0,0,61,53,19,20,14,8,8,0,0,8,0,0,0,0,05032
1428,1832,135,634,538,314,211,116,52,46,5,30,11,6,6,6,0,0,0,0,0,0,64,61,8,0,53,3,3,0,0,3,0,0,0,0,05033
1429,191,15,51,87,27,11,0,0,0,0,0,0,0,0,0,0,0,0,0,0,0,0,0,0,0,0,0,0,0,0,0,0,0,0,0,05034
1430,417,40,160,138,51,28,43,24,6,3,0,3,18,18,18,0,0,0,0,0,0,19,14,3,0,11,5,5,5,0,0,0,0,0,0,05035
1431,705,42,200,219,118,126,53,45,29,14,0,15,16,16,7,0,9,0,0,0,0,8,8,4,4,0,0,0,0,0,0,0,0,0,0,05036
1432,440,28,114,145,53,100,36,4,4,0,0,4,0,0,0,0,0,0,0,0,0,32,32,9,0,23,0,0,0,0,0,0,0,0,0,05037
1433,1040,116,325,267,205,127,74,41,35,0,0,35,6,6,0,6,0,0,0,0,0,33,24,0,0,24,9,9,0,4,5,0,0,0,0,05038
1434,762,67,225,227,164,79,23,5,5,5,0,0,0,0,0,0,0,0,0,0,0,18,18,12,0,6,0,0,0,0,0,0,0,0,0,05039
1435,358,52,103,115,55,33,34,16,16,0,0,16,0,0,0,0,0,0,0,0,0,18,10,0,0,10,8,8,8,0,0,0,0,0,0,05040
1436,238,0,186,37,15,0,0,0,0,0,0,0,0,0,0,0,0,0,0,0,0,0,0,0,0,0,0,0,0,0,0,0,0,0,0,05041
1437,359,41,189,71,41,17,18,14,8,0,0,8,6,0,0,0,0,6,4,0,2,4,4,4,0,0,0,0,0,0,0,0,0,0,0,05042
1438,637,41,150,182,158,106,64,47,22,6,0,16,25,25,25,0,0,0,0,0,0,17,10,5,0,5,7,7,7,0,0,0,0,0,0,05043
1439,1420,94,429,354,279,264,72,21,19,0,0,19,2,2,2,0,0,0,0,0,0,51,38,8,0,30,13,13,10,0,3,0,0,0,0,05045
1440,823,114,286,288,71,64,45,24,6,0,0,6,18,18,18,0,0,0,0,0,0,21,11,4,0,7,10,10,10,0,0,0,0,0,0,05046
1441,1833,88,637,442,283,383,120,45,19,0,0,19,26,26,26,0,0,0,0,0,0,75,39,13,0,26,36,16,16,0,0,20,0,0,20,05048
1442,97,46,32,0,4,15,10,0,0,0,0,0,0,0,0,0,0,0,0,0,0,10,4,4,0,0,6,3,3,0,0,3,3,0,0,05050
1443,1268,100,390,390,252,136,39,18,9,6,0,3,9,8,8,0,0,1,0,0,1,21,21,6,0,15,0,0,0,0,0,0,0,0,0,05051
1444,180,0,88,83,0,9,0,0,0,0,0,0,0,0,0,0,0,0,0,0,0,0,0,0,0,0,0,0,0,0,0,0,0,0,0,05052
1445,280,3,79,63,113,22,0,0,0,0,0,0,0,0,0,0,0,0,0,0,0,0,0,0,0,0,0,0,0,0,0,0,0,0,0,05053
1446,2474,60,178,361,776,1099,85,22,12,0,0,12,10,10,10,0,0,0,0,0,0,63,63,23,0,40,0,0,0,0,0,0,0,0,0,05055
1447,330,11,50,107,122,40,20,10,10,0,0,10,0,0,0,0,0,0,0,0,0,10,5,0,5,0,5,5,5,0,0,0,0,0,0,05056
1448,184,16,64,72,12,20,34,24,24,0,0,24,0,0,0,0,0,0,0,0,0,10,10,5,5,0,0,0,0,0,0,0,0,0,0,05058
1449,396,0,148,132,32,84,42,42,9,0,0,9,33,33,33,0,0,0,0,0,0,0,0,0,0,0,0,0,0,0,0,0,0,0,0,05059
1450,3425,367,1227,786,590,455,249,151,144,38,0,106,7,7,7,0,0,0,0,0,0,98,90,30,0,60,8,8,5,0,3,0,0,0,0,05060
1451,728,11,238,218,126,135,285,198,198,51,21,126,0,0,0,0,0,0,0,0,0,87,87,47,10,30,0,0,0,0,0,0,0,0,0,05061
1452,459,4,186,130,96,43,17,17,9,0,0,9,8,8,0,8,0,0,0,0,0,0,0,0,0,0,0,0,0,0,0,0,0,0,0,05062
1453,844,104,328,154,133,125,31,26,10,0,0,10,16,4,4,0,0,12,4,0,8,5,5,0,0,5,0,0,0,0,0,0,0,0,0,05065
1454,199,4,40,37,67,51,13,0,0,0,0,0,0,0,0,0,0,0,0,0,0,13,13,0,0,13,0,0,0,0,0,0,0,0,0,05067
1455,2201,166,555,587,462,431,191,97,97,38,5,54,0,0,0,0,0,0,0,0,0,94,94,37,9,48,0,0,0,0,0,0,0,0,0,05068
1456,393,29,171,123,47,23,9,0,0,0,0,0,0,0,0,0,0,0,0,0,0,9,9,0,0,9,0,0,0,0,0,0,0,0,0,05069
1457,350,7,62,70,104,107,29,18,18,5,0,13,0,0,0,0,0,0,0,0,0,11,11,7,0,4,0,0,0,0,0,0,0,0,0,05070
1458,219,0,119,70,22,8,32,0,0,0,0,0,0,0,0,0,0,0,0,0,0,32,32,0,0,32,0,0,0,0,0,0,0,0,0,05071
1459,423,18,93,92,127,93,28,10,10,3,3,4,0,0,0,0,0,0,0,0,0,18,18,0,0,18,0,0,0,0,0,0,0,0,0,05072
1460,803,21,143,133,215,291,97,43,34,11,0,23,9,9,9,0,0,0,0,0,0,54,54,25,0,29,0,0,0,0,0,0,0,0,0,05075
1461,274,40,127,72,26,9,25,5,5,5,0,0,0,0,0,0,0,0,0,0,0,20,20,0,0,20,0,0,0,0,0,0,0,0,0,05076
1462,837,37,297,231,132,140,51,35,31,11,0,20,4,0,0,0,0,4,0,0,4,16,11,3,0,8,5,5,0,0,5,0,0,0,0,05077
1463,486,53,128,132,106,67,62,2,2,0,0,2,0,0,0,0,0,0,0,0,0,60,43,3,0,40,17,17,8,3,6,0,0,0,0,05079
1464,376,56,139,92,68,21,15,9,4,0,0,4,5,0,0,0,0,5,5,0,0,6,2,0,0,2,4,0,0,0,0,4,4,0,0,05081
1465,89,21,47,1,11,9,16,16,9,9,0,0,7,0,0,0,0,7,0,7,0,0,0,0,0,0,0,0,0,0,0,0,0,0,0,05083
1466,40,0,3,7,27,3,4,4,0,0,0,0,4,0,0,0,0,4,0,0,4,0,0,0,0,0,0,0,0,0,0,0,0,0,0,05084
1467,582,59,290,152,45,36,38,19,14,6,0,8,5,5,0,5,0,0,0,0,0,19,19,10,0,9,0,0,0,0,0,0,0,0,0,05086
1468,3555,359,1386,947,533,330,323,178,162,76,49,37,16,4,0,3,1,12,0,0,12,145,120,26,10,84,25,0,0,0,0,25,0,0,25,05089
1469,2721,77,564,600,755,725,94,24,24,0,0,24,0,0,0,0,0,0,0,0,0,70,54,17,0,37,16,16,16,0,0,0,0,0,0,05091
1470,3271,433,1308,907,364,259,268,147,134,26,8,100,13,13,7,0,6,0,0,0,0,121,88,0,61,27,33,33,8,13,12,0,0,0,0,05101
1471,83,19,32,29,1,2,0,0,0,0,0,0,0,0,0,0,0,0,0,0,0,0,0,0,0,0,0,0,0,0,0,0,0,0,0,05141
1472,613,37,207,180,88,101,20,18,10,4,0,6,8,8,8,0,0,0,0,0,0,2,2,2,0,0,0,0,0,0,0,0,0,0,0,05142
1473,3179,361,1204,876,382,356,211,91,67,50,0,17,24,24,10,0,14,0,0,0,0,120,92,48,4,40,28,18,0,9,9,10,0,0,10,05143
1474,483,41,131,140,94,77,23,16,9,4,0,5,7,0,0,0,0,7,0,0,7,7,3,3,0,0,4,4,0,4,0,0,0,0,0,05146
1475,866,53,265,221,206,121,55,23,4,4,0,0,19,19,19,0,0,0,0,0,0,32,15,0,0,15,17,17,9,0,8,0,0,0,0,05148
1476,1602,130,472,418,343,239,112,73,56,22,0,34,17,14,14,0,0,3,0,3,0,39,39,2,4,33,0,0,0,0,0,0,0,0,0,05149
1477,765,121,371,144,69,60,27,27,0,0,0,0,27,27,27,0,0,0,0,0,0,0,0,0,0,0,0,0,0,0,0,0,0,0,0,05150
1478,815,51,369,228,137,30,42,26,23,6,5,12,3,0,0,0,0,3,0,0,3,16,16,16,0,0,0,0,0,0,0,0,0,0,0,05151
1479,338,9,102,70,114,43,28,23,17,7,0,10,6,6,6,0,0,0,0,0,0,5,5,3,1,1,0,0,0,0,0,0,0,0,0,05152
1480,626,74,256,150,100,46,23,11,11,4,0,7,0,0,0,0,0,0,0,0,0,12,7,0,0,7,5,5,0,0,5,0,0,0,0,05153
1481,479,78,151,76,105,69,39,30,22,1,0,21,8,8,8,0,0,0,0,0,0,9,9,0,0,9,0,0,0,0,0,0,0,0,0,05154
1482,455,78,97,74,111,95,31,12,12,0,0,12,0,0,0,0,0,0,0,0,0,19,19,14,0,5,0,0,0,0,0,0,0,0,0,05155
1483,6965,583,2870,2153,928,431,354,194,151,58,29,64,43,35,35,0,0,8,0,0,8,160,141,33,0,108,19,0,0,0,0,19,0,19,0,05156
1484,834,66,347,186,94,141,23,0,0,0,0,0,0,0,0,0,0,0,0,0,0,23,22,2,4,16,1,1,1,0,0,0,0,0,0,05158
1485,465,27,112,91,144,91,19,16,13,2,5,6,3,3,3,0,0,0,0,0,0,3,3,0,0,3,0,0,0,0,0,0,0,0,0,05161
1486,9932,1222,3331,2873,1565,941,808,410,279,89,59,131,131,75,63,12,0,56,0,15,41,398,350,74,26,250,48,41,40,1,0,7,0,0,7,05201
1487,2761,179,754,727,614,487,177,106,95,24,0,71,11,11,7,0,4,0,0,0,0,71,54,31,7,16,17,17,17,0,0,0,0,0,0,05250
1488,1087,21,186,338,377,165,62,29,25,16,0,9,4,4,0,4,0,0,0,0,0,33,30,14,0,16,3,3,3,0,0,0,0,0,0,05251
1489,244,12,100,89,21,22,5,3,0,0,0,0,3,3,3,0,0,0,0,0,0,2,2,2,0,0,0,0,0,0,0,0,0,0,0,05252
1490,456,40,98,139,97,82,39,37,26,9,0,17,11,11,11,0,0,0,0,0,0,2,2,0,0,2,0,0,0,0,0,0,0,0,0,05253
1491,204,0,19,36,106,43,33,25,25,0,0,25,0,0,0,0,0,0,0,0,0,8,8,8,0,0,0,0,0,0,0,0,0,0,0,05254
1492,2881,183,830,654,854,360,235,126,126,40,9,77,0,0,0,0,0,0,0,0,0,109,78,4,28,46,31,31,22,0,9,0,0,0,0,05255
1493,1442,182,392,396,273,199,423,164,156,18,5,133,8,2,2,0,0,6,0,3,3,259,259,115,3,141,0,0,0,0,0,0,0,0,0,05257
1494,296,43,128,83,24,18,15,0,0,0,0,0,0,0,0,0,0,0,0,0,0,15,15,15,0,0,0,0,0,0,0,0,0,0,0,05260
1495,2009,274,791,527,254,163,62,38,38,21,16,1,0,0,0,0,0,0,0,0,0,24,14,0,0,14,10,10,10,0,0,0,0,0,0,05261
1496,2063,128,651,493,482,309,138,58,58,27,4,27,0,0,0,0,0,0,0,0,0,80,69,9,0,60,11,3,3,0,0,8,8,0,0,05262
1497,12102,1293,3559,2949,2245,2056,811,400,350,117,26,207,50,34,31,0,3,16,15,1,0,411,362,105,9,248,49,49,36,0,13,0,0,0,0,05301
1498,535,20,110,120,176,109,37,15,15,10,0,5,0,0,0,0,0,0,0,0,0,22,20,11,0,9,2,2,2,0,0,0,0,0,0,05340
1499,381,8,127,119,75,52,7,7,7,0,0,7,0,0,0,0,0,0,0,0,0,0,0,0,0,0,0,0,0,0,0,0,0,0,0,05341
1500,353,14,158,118,18,45,36,26,26,4,0,22,0,0,0,0,0,0,0,0,0,10,6,0,0,6,4,4,0,4,0,0,0,0,0,05342
1501,584,13,267,154,99,51,50,28,19,6,8,5,9,9,6,3,0,0,0,0,0,22,19,8,0,11,3,3,0,3,0,0,0,0,0,05343
1502,1686,100,383,477,477,249,86,34,18,2,0,16,16,16,5,0,11,0,0,0,0,52,38,20,3,15,14,14,14,0,0,0,0,0,0,05345
1503,3347,247,788,808,837,667,390,191,190,37,5,148,1,0,0,0,0,1,1,0,0,199,189,45,12,132,10,10,10,0,0,0,0,0,0,05346
1504,568,109,186,112,98,63,23,17,13,0,0,13,4,4,4,0,0,0,0,0,0,6,6,0,0,6,0,0,0,0,0,0,0,0,0,05350
1505,650,84,236,151,113,66,30,28,26,8,0,18,2,2,2,0,0,0,0,0,0,2,2,0,0,2,0,0,0,0,0,0,0,0,0,05352
1506,756,48,255,200,160,93,45,24,21,0,0,21,3,0,0,0,0,3,0,0,3,21,18,14,0,4,3,3,0,0,3,0,0,0,0,05353
1507,1496,161,549,444,251,91,127,96,86,33,4,49,10,6,6,0,0,4,0,0,4,31,31,15,6,10,0,0,0,0,0,0,0,0,0,05354
1508,484,98,165,139,51,31,9,9,5,5,0,0,4,4,4,0,0,0,0,0,0,0,0,0,0,0,0,0,0,0,0,0,0,0,0,05355
1509,671,27,155,197,214,78,33,26,26,3,0,23,0,0,0,0,0,0,0,0,0,7,7,4,0,3,0,0,0,0,0,0,0,0,0,05356
1510,135,8,55,28,14,30,19,10,10,0,0,10,0,0,0,0,0,0,0,0,0,9,9,9,0,0,0,0,0,0,0,0,0,0,0,05358
1511,446,29,132,96,95,94,15,6,4,3,0,1,2,2,2,0,0,0,0,0,0,9,9,0,0,9,0,0,0,0,0,0,0,0,0,05359
1512,170,10,66,39,35,20,5,0,0,0,0,0,0,0,0,0,0,0,0,0,0,5,5,2,0,3,0,0,0,0,0,0,0,0,0,05360
1513,618,34,255,186,78,65,46,36,30,12,0,18,6,6,6,0,0,0,0,0,0,10,7,2,0,5,3,3,3,0,0,0,0,0,0,05361
1514,94,3,23,39,17,12,17,8,0,0,0,0,8,8,0,8,0,0,0,0,0,9,9,0,0,9,0,0,0,0,0,0,0,0,0,05362
1515,2006,59,529,753,437,228,131,91,78,21,1,56,13,0,0,0,0,13,0,0,13,40,40,17,0,23,0,0,0,0,0,0,0,0,0,05363
1516,15974,1917,2552,3176,5157,3172,1999,946,843,306,88,449,103,91,79,0,12,12,11,1,0,1053,976,386,84,506,77,74,72,0,2,3,3,0,0,05401
1517,13008,570,2319,3070,4189,2860,523,375,302,175,0,127,73,63,14,0,49,10,0,0,10,148,121,42,13,66,27,27,27,0,0,0,0,0,0,05403
1518,4643,601,1294,1054,1208,486,373,181,160,90,9,61,21,14,6,8,0,7,7,0,0,192,169,35,25,109,23,23,23,0,0,0,0,0,0,05404
1519,20,0,0,12,8,0,3046,1176,1176,194,81,901,0,0,0,0,0,0,0,0,0,1870,1870,568,115,1187,0,0,0,0,0,0,0,0,0,05405
1520,7601,633,2019,2104,1751,1094,445,249,240,68,0,172,9,9,9,0,0,0,0,0,0,196,172,63,45,64,24,0,0,0,0,24,0,0,24,05408
1521,28,0,0,3,0,25,745,319,315,80,31,204,4,0,0,0,0,4,4,0,0,426,426,207,12,207,0,0,0,0,0,0,0,0,0,05439
1522,1332,206,579,287,206,54,72,21,15,0,5,10,6,6,6,0,0,0,0,0,0,51,51,16,3,32,0,0,0,0,0,0,0,0,0,05440
1523,708,33,283,253,90,49,55,11,11,11,0,0,0,0,0,0,0,0,0,0,0,44,41,3,0,38,3,3,3,0,0,0,0,0,0,05441
1524,197,23,76,57,24,17,21,12,6,0,0,6,6,6,4,0,2,0,0,0,0,9,7,4,0,3,2,2,0,0,2,0,0,0,0,05442
1525,4615,501,1523,1049,896,646,332,188,132,34,16,82,56,51,14,29,8,5,0,0,5,144,132,58,0,74,12,12,12,0,0,0,0,0,0,05443
1526,1130,50,372,296,290,122,55,17,17,6,0,11,0,0,0,0,0,0,0,0,0,38,30,26,3,1,8,8,0,0,8,0,0,0,0,05444
1527,2680,29,486,404,987,774,179,95,84,22,7,55,11,11,11,0,0,0,0,0,0,84,84,24,0,60,0,0,0,0,0,0,0,0,0,05445
1528,10646,494,2796,3260,2843,1253,811,430,399,87,19,293,31,31,31,0,0,0,0,0,0,381,363,168,21,174,18,18,18,0,0,0,0,0,0,05446
1529,74,11,20,20,13,10,4,4,4,0,0,4,0,0,0,0,0,0,0,0,0,0,0,0,0,0,0,0,0,0,0,0,0,0,0,05447
1530,823,70,359,188,143,63,89,53,31,2,7,22,22,22,12,10,0,0,0,0,0,36,27,0,6,21,9,3,3,0,0,6,0,0,6,05448
1531,3406,508,1462,816,383,237,203,138,114,60,10,44,24,24,24,0,0,0,0,0,0,65,52,16,8,28,13,13,13,0,0,0,0,0,0,05450
1532,13418,442,2526,3940,4047,2463,1158,569,472,207,58,207,97,77,70,7,0,20,0,0,20,589,550,179,30,341,39,10,10,0,0,29,8,0,21,05452
1533,3204,202,1136,842,623,401,225,94,94,39,0,55,0,0,0,0,0,0,0,0,0,131,115,45,0,70,16,16,16,0,0,0,0,0,0,05454
1534,742,62,297,201,119,63,69,41,23,17,4,2,18,18,9,0,9,0,0,0,0,28,22,8,3,11,6,6,0,0,6,0,0,0,0,05455
1535,916,64,376,223,173,80,91,26,16,0,7,9,10,10,10,0,0,0,0,0,0,65,42,26,0,16,23,23,12,0,11,0,0,0,0,05456
1536,985,82,435,282,117,69,48,31,27,13,4,10,4,4,4,0,0,0,0,0,0,17,15,9,0,6,2,2,0,2,0,0,0,0,0,05457
1537,1719,120,492,594,300,213,84,48,48,11,0,37,0,0,0,0,0,0,0,0,0,36,36,14,3,19,0,0,0,0,0,0,0,0,0,05458
1538,1508,194,767,381,88,78,197,86,76,13,0,63,10,10,10,0,0,0,0,0,0,111,75,61,0,14,36,12,0,0,12,24,12,0,12,05459
1539,3222,199,809,879,854,481,319,220,159,95,0,64,61,60,60,0,0,1,0,1,0,99,82,34,48,0,17,0,0,0,0,17,17,0,0,05461
1540,1409,75,411,295,383,245,113,51,43,18,0,25,8,4,0,4,0,4,0,0,4,62,53,12,12,29,9,9,0,9,0,0,0,0,0,05462
1541,345,31,90,143,59,22,45,37,37,0,14,23,0,0,0,0,0,0,0,0,0,8,8,6,0,2,0,0,0,0,0,0,0,0,0,05463
1542,1948,74,456,570,576,272,66,35,27,0,3,24,8,8,6,0,2,0,0,0,0,31,21,12,0,9,10,10,0,0,10,0,0,0,0,05464
1543,3592,122,622,826,1187,835,331,185,159,83,4,72,26,19,10,0,9,7,3,0,4,146,133,33,14,86,13,13,9,4,0,0,0,0,0,05465
1544,8900,558,3327,2720,1736,559,690,341,327,135,40,152,14,14,14,0,0,0,0,0,0,349,349,164,0,185,0,0,0,0,0,0,0,0,0,05468
1545,575,58,145,217,77,78,19,6,6,0,3,3,0,0,0,0,0,0,0,0,0,13,13,4,0,9,0,0,0,0,0,0,0,0,0,05471
1546,1187,105,420,308,221,133,56,33,21,6,9,6,12,12,12,0,0,0,0,0,0,23,20,8,0,12,3,3,3,0,0,0,0,0,0,05472
1547,1115,73,314,242,293,193,37,35,27,4,7,16,8,8,2,6,0,0,0,0,0,2,2,2,0,0,0,0,0,0,0,0,0,0,0,05473
1548,657,25,175,216,159,82,42,35,32,24,0,8,3,3,3,0,0,0,0,0,0,7,7,5,0,2,0,0,0,0,0,0,0,0,0,05474
1549,2299,438,1058,519,189,95,208,87,53,17,14,22,34,32,12,20,0,2,2,0,0,121,97,31,5,61,24,19,19,0,0,5,1,0,4,05476
1550,3183,162,798,695,964,564,179,67,42,14,0,28,25,25,25,0,0,0,0,0,0,112,103,39,36,28,9,9,9,0,0,0,0,0,0,05477
1551,9806,906,3111,2929,1919,941,505,267,217,133,0,84,50,50,20,17,13,0,0,0,0,238,153,88,9,56,85,85,75,0,10,0,0,0,0,05478
1552,0,0,0,0,0,0,0,0,0,0,0,0,0,0,0,0,0,0,0,0,0,0,0,0,0,0,0,0,0,0,0,0,0,0,0,05481
1553,5138,202,637,976,1923,1400,546,336,323,149,0,174,13,13,13,0,0,0,0,0,0,210,127,74,0,53,83,73,30,37,6,10,10,0,0,05482
1554,966,109,522,195,108,32,73,31,17,2,0,15,14,14,14,0,0,0,0,0,0,42,42,10,0,32,0,0,0,0,0,0,0,0,0,05483
1555,16,0,8,5,0,3,0,0,0,0,0,0,0,0,0,0,0,0,0,0,0,0,0,0,0,0,0,0,0,0,0,0,0,0,0,05485
1556,1119,55,300,292,254,218,91,48,27,3,4,20,21,21,15,0,6,0,0,0,0,43,36,14,2,20,7,7,7,0,0,0,0,0,0,05486
1557,1033,76,311,216,290,140,47,15,13,6,0,7,2,2,0,2,0,0,0,0,0,32,20,5,5,10,12,8,0,4,4,4,0,4,0,05487
1558,5362,817,2085,1465,577,418,515,353,228,97,44,87,125,104,22,82,0,21,21,0,0,162,81,48,17,16,81,75,56,0,19,6,0,0,6,05488
1559,2266,28,368,592,860,418,120,49,49,27,0,22,0,0,0,0,0,0,0,0,0,71,66,30,0,36,5,5,5,0,0,0,0,0,0,05489
1560,4110,383,1340,1080,829,478,334,196,185,26,24,135,11,7,4,1,2,4,0,1,3,138,113,47,3,63,25,6,3,0,3,19,17,0,2,05491
1561,504,46,190,125,112,31,17,14,10,7,0,3,4,4,4,0,0,0,0,0,0,3,3,3,0,0,0,0,0,0,0,0,0,0,0,05492
1562,1204,48,255,341,310,250,70,38,38,16,0,22,0,0,0,0,0,0,0,0,0,32,29,10,7,12,3,3,3,0,0,0,0,0,0,05494
1563,6684,273,1280,1575,2116,1440,446,195,195,55,0,140,0,0,0,0,0,0,0,0,0,251,241,136,0,105,10,10,0,9,1,0,0,0,0,05495
1564,8675,491,1902,2085,2051,2146,479,190,173,37,5,131,17,6,3,0,3,11,5,6,0,289,254,149,4,101,35,35,19,6,10,0,0,0,0,05602
1565,184,20,51,23,47,43,4,4,0,0,0,0,4,4,4,0,0,0,0,0,0,0,0,0,0,0,0,0,0,0,0,0,0,0,0,05640
1566,12433,1211,5096,3456,1900,770,814,446,408,157,63,188,38,33,9,0,24,5,0,0,5,368,277,170,10,97,91,35,14,0,21,56,0,0,56,05641
1567,800,99,286,197,125,93,37,17,12,0,0,12,5,3,0,3,0,2,2,0,0,20,16,0,0,16,4,4,4,0,0,0,0,0,0,05647
1568,289,3,30,45,97,114,6,6,6,0,0,6,0,0,0,0,0,0,0,0,0,0,0,0,0,0,0,0,0,0,0,0,0,0,0,05648
1569,645,58,393,159,35,0,73,63,56,0,0,56,7,7,4,3,0,0,0,0,0,10,7,4,0,3,3,3,0,3,0,0,0,0,0,05649
1570,775,90,182,186,163,154,49,29,26,8,8,10,3,3,3,0,0,0,0,0,0,20,20,2,9,9,0,0,0,0,0,0,0,0,0,05650
1571,1112,43,284,345,256,184,79,47,28,4,0,24,19,19,19,0,0,0,0,0,0,32,32,0,0,32,0,0,0,0,0,0,0,0,0,05651
1572,585,99,295,100,61,30,72,48,10,0,0,10,38,34,34,0,0,4,0,0,4,24,4,2,2,0,20,9,0,0,9,11,0,0,11,05652
1573,298,15,120,89,19,55,15,10,7,3,0,4,3,3,0,0,3,0,0,0,0,5,0,0,0,0,5,5,3,0,2,0,0,0,0,05653
1574,481,84,205,151,12,29,17,0,0,0,0,0,0,0,0,0,0,0,0,0,0,17,17,9,0,8,0,0,0,0,0,0,0,0,0,05654
1575,2093,224,891,420,389,169,194,63,49,25,13,11,14,12,0,12,0,2,2,0,0,131,110,36,4,70,21,21,21,0,0,0,0,0,0,05655
1576,1968,246,720,572,343,87,442,186,182,101,3,78,4,4,0,0,4,0,0,0,0,256,243,155,9,79,13,13,13,0,0,0,0,0,0,05656
1577,43,14,26,3,0,0,0,0,0,0,0,0,0,0,0,0,0,0,0,0,0,0,0,0,0,0,0,0,0,0,0,0,0,0,0,05657
1578,1052,92,370,268,222,100,40,18,18,7,0,11,0,0,0,0,0,0,0,0,0,22,9,7,0,2,13,13,4,0,9,0,0,0,0,05658
1579,1221,33,255,248,383,302,89,45,22,3,0,19,23,20,20,0,0,3,0,3,0,44,44,11,3,30,0,0,0,0,0,0,0,0,0,05660
1580,4227,221,1319,1189,913,585,330,214,193,94,12,87,21,21,14,7,0,0,0,0,0,116,79,37,0,42,37,17,17,0,0,20,20,0,0,05661
1581,3747,140,1154,1057,685,711,1095,793,756,87,34,635,37,37,37,0,0,0,0,0,0,302,302,173,32,97,0,0,0,0,0,0,0,0,0,05663
1582,0,0,0,0,0,0,0,0,0,0,0,0,0,0,0,0,0,0,0,0,0,0,0,0,0,0,0,0,0,0,0,0,0,0,0,05664
1583,1565,54,476,390,353,292,159,90,86,12,0,74,4,4,4,0,0,0,0,0,0,69,53,19,21,13,16,16,16,0,0,0,0,0,0,05667
1584,504,86,167,111,79,61,9,6,2,0,0,2,4,4,4,0,0,0,0,0,0,3,0,0,0,0,3,3,0,0,3,0,0,0,0,05669
1585,3031,86,314,692,1211,728,181,67,67,7,0,60,0,0,0,0,0,0,0,0,0,114,114,27,0,87,0,0,0,0,0,0,0,0,0,05672
1586,1771,35,315,360,672,389,61,33,31,21,0,10,2,2,2,0,0,0,0,0,0,28,28,28,0,0,0,0,0,0,0,0,0,0,0,05673
1587,1127,15,202,281,396,233,48,28,25,6,0,19,3,0,0,0,0,3,0,0,3,20,16,10,6,0,4,4,4,0,0,0,0,0,0,05674
1588,794,104,353,168,100,69,43,21,21,7,3,11,0,0,0,0,0,0,0,0,0,22,22,8,0,14,0,0,0,0,0,0,0,0,0,05675
1589,3753,234,900,967,847,805,255,142,114,41,7,66,28,28,22,0,6,0,0,0,0,113,102,43,0,59,11,11,0,0,11,0,0,0,0,05676
1590,1614,16,401,341,684,172,74,61,61,0,0,61,0,0,0,0,0,0,0,0,0,13,13,0,0,13,0,0,0,0,0,0,0,0,0,05677
1591,47,0,0,47,0,0,0,0,0,0,0,0,0,0,0,0,0,0,0,0,0,0,0,0,0,0,0,0,0,0,0,0,0,0,0,05678
1592,2315,247,1090,613,212,153,122,21,21,12,0,9,0,0,0,0,0,0,0,0,0,101,101,29,25,47,0,0,0,0,0,0,0,0,0,05679
1593,1498,190,574,387,246,101,76,37,29,17,0,12,8,8,4,4,0,0,0,0,0,39,39,21,0,18,0,0,0,0,0,0,0,0,0,05680
1594,226,15,72,48,78,13,0,0,0,0,0,0,0,0,0,0,0,0,0,0,0,0,0,0,0,0,0,0,0,0,0,0,0,0,0,05681
1595,856,59,157,254,211,175,73,37,33,11,4,18,4,4,2,0,2,0,0,0,0,36,22,4,0,18,14,14,11,3,0,0,0,0,0,05682
1596,14743,1582,5295,3802,2594,1470,967,410,336,110,43,183,74,74,11,10,53,0,0,0,0,557,349,143,41,165,208,208,57,61,90,0,0,0,0,05701
1597,248,5,54,78,58,53,4,4,4,0,4,0,0,0,0,0,0,0,0,0,0,0,0,0,0,0,0,0,0,0,0,0,0,0,0,05730
1598,545,51,155,212,96,31,0,0,0,0,0,0,0,0,0,0,0,0,0,0,0,0,0,0,0,0,0,0,0,0,0,0,0,0,0,05732
1599,4388,625,1611,956,762,434,245,115,104,11,0,93,11,11,11,0,0,0,0,0,0,130,115,52,3,60,15,5,5,0,0,10,0,0,10,05733
1600,941,82,409,219,143,88,51,31,30,18,0,12,1,1,0,0,1,0,0,0,0,20,20,7,5,8,0,0,0,0,0,0,0,0,0,05734
1601,2341,129,805,672,398,337,631,394,372,90,15,267,22,22,22,0,0,0,0,0,0,237,237,84,25,128,0,0,0,0,0,0,0,0,0,05735
1602,624,66,217,210,88,43,38,6,6,0,0,6,0,0,0,0,0,0,0,0,0,32,32,32,0,0,0,0,0,0,0,0,0,0,0,05736
1603,589,28,117,149,186,109,18,7,7,7,0,0,0,0,0,0,0,0,0,0,0,11,11,0,0,11,0,0,0,0,0,0,0,0,0,05737
1604,877,39,248,259,210,121,60,38,31,14,7,10,7,7,7,0,0,0,0,0,0,22,18,18,0,0,4,4,4,0,0,0,0,0,0,05738
1605,1039,144,377,255,148,115,77,44,40,17,0,23,4,0,0,0,0,4,4,0,0,33,18,4,0,14,15,10,3,7,0,5,0,0,5,05739
1606,0,0,0,0,0,0,0,0,0,0,0,0,0,0,0,0,0,0,0,0,0,0,0,0,0,0,0,0,0,0,0,0,0,0,0,05740
1607,445,46,149,155,78,17,16,4,4,0,0,4,0,0,0,0,0,0,0,0,0,12,12,12,0,0,0,0,0,0,0,0,0,0,0,05742
1608,3038,387,1132,824,428,267,237,162,158,31,26,101,4,4,0,4,0,0,0,0,0,75,72,8,5,59,3,3,0,0,3,0,0,0,0,05743
1609,448,15,228,164,41,0,32,4,4,4,0,0,0,0,0,0,0,0,0,0,0,28,28,28,0,0,0,0,0,0,0,0,0,0,0,05744
1610,233,23,69,69,53,19,23,11,11,9,0,2,0,0,0,0,0,0,0,0,0,12,12,7,3,2,0,0,0,0,0,0,0,0,0,05747
1611,270,27,125,56,36,26,5,3,1,1,0,0,2,2,0,0,2,0,0,0,0,2,2,0,0,2,0,0,0,0,0,0,0,0,0,05748
1612,629,20,117,148,225,119,42,18,12,7,0,5,6,6,6,0,0,0,0,0,0,24,16,3,0,13,8,8,8,0,0,0,0,0,0,05751
1613,5992,490,1418,1203,1218,1663,1367,745,704,218,8,478,41,41,29,0,12,0,0,0,0,622,617,204,13,400,5,0,0,0,0,5,0,5,0,05753
1614,632,45,198,201,113,75,22,14,11,6,0,5,3,3,3,0,0,0,0,0,0,8,5,0,0,5,3,3,3,0,0,0,0,0,0,05757
1615,649,83,233,144,133,56,29,10,3,0,3,0,7,7,7,0,0,0,0,0,0,19,19,5,3,11,0,0,0,0,0,0,0,0,0,05758
1616,1456,177,569,365,284,61,35,35,35,10,0,25,0,0,0,0,0,0,0,0,0,0,0,0,0,0,0,0,0,0,0,0,0,0,0,05759
1617,742,55,300,164,147,76,73,23,23,11,0,12,0,0,0,0,0,0,0,0,0,50,50,19,13,18,0,0,0,0,0,0,0,0,0,05760
1618,725,86,181,183,162,113,54,21,21,10,0,11,0,0,0,0,0,0,0,0,0,33,24,0,0,24,9,5,5,0,0,4,0,0,4,05761
1619,451,30,81,170,100,70,34,16,16,10,0,6,0,0,0,0,0,0,0,0,0,18,18,0,0,18,0,0,0,0,0,0,0,0,0,05762
1620,1954,172,470,674,459,179,61,54,36,0,0,36,18,0,0,0,0,18,18,0,0,7,7,0,0,7,0,0,0,0,0,0,0,0,0,05763
1621,2019,197,765,492,222,343,394,148,137,19,11,107,11,11,0,11,0,0,0,0,0,246,228,88,12,128,18,4,4,0,0,14,14,0,0,05764
1622,1279,137,409,466,142,125,101,48,38,4,5,29,10,5,5,0,0,5,5,0,0,53,53,4,4,45,0,0,0,0,0,0,0,0,0,05765
1623,435,18,94,95,150,78,29,10,10,3,7,0,0,0,0,0,0,0,0,0,0,19,19,11,0,8,0,0,0,0,0,0,0,0,0,05766
1624,765,65,217,223,154,106,40,20,19,0,0,19,1,1,0,0,1,0,0,0,0,20,15,15,0,0,5,5,0,4,1,0,0,0,0,05767
1625,862,130,381,168,111,72,36,7,4,0,2,2,3,0,0,0,0,3,3,0,0,29,25,17,4,4,4,4,4,0,0,0,0,0,0,05769
1626,861,100,338,190,162,71,77,46,35,4,0,31,11,0,0,0,0,11,0,11,0,31,28,10,4,14,3,3,3,0,0,0,0,0,0,05770
1627,465,23,159,129,109,45,35,27,27,11,0,16,0,0,0,0,0,0,0,0,0,8,8,0,0,8,0,0,0,0,0,0,0,0,0,05772
1628,1622,138,565,481,306,132,88,42,40,18,7,15,2,2,2,0,0,0,0,0,0,46,46,14,0,32,0,0,0,0,0,0,0,0,0,05773
1629,911,121,367,208,114,101,40,18,13,0,0,13,5,5,5,0,0,0,0,0,0,22,22,0,3,19,0,0,0,0,0,0,0,0,0,05774
1630,404,76,139,85,55,49,29,9,9,0,0,9,0,0,0,0,0,0,0,0,0,20,13,0,0,13,7,3,0,0,3,4,0,0,4,05775
1631,520,61,160,144,117,38,23,19,16,7,0,9,3,3,3,0,0,0,0,0,0,4,4,0,0,4,0,0,0,0,0,0,0,0,0,05776
1632,2409,317,1013,512,375,192,182,130,85,24,0,61,45,2,2,0,0,43,10,33,0,52,32,7,0,25,20,20,14,4,2,0,0,0,0,05777
1633,528,52,230,122,80,44,38,9,6,3,0,3,3,3,0,3,0,0,0,0,0,29,23,16,0,7,6,2,2,0,0,4,0,4,0,05778
1634,6961,615,2283,2047,1233,783,643,280,256,63,15,178,24,24,11,6,7,0,0,0,0,363,336,76,9,251,27,27,15,0,12,0,0,0,0,05819
1635,455,30,213,94,92,26,31,14,7,3,0,4,7,7,7,0,0,0,0,0,0,17,17,1,7,9,0,0,0,0,0,0,0,0,0,05820
1636,832,38,236,238,179,141,22,10,10,3,0,7,0,0,0,0,0,0,0,0,0,12,12,4,0,8,0,0,0,0,0,0,0,0,0,05821
1637,1254,189,462,344,184,75,79,48,48,16,3,29,0,0,0,0,0,0,0,0,0,31,31,0,5,26,0,0,0,0,0,0,0,0,0,05822
1638,824,108,390,179,106,41,20,10,4,4,0,0,6,6,6,0,0,0,0,0,0,10,10,10,0,0,0,0,0,0,0,0,0,0,0,05824
1639,188,11,90,45,31,11,11,11,11,0,0,11,0,0,0,0,0,0,0,0,0,0,0,0,0,0,0,0,0,0,0,0,0,0,0,05825
1640,658,49,312,134,85,78,41,27,8,5,0,3,19,19,19,0,0,0,0,0,0,14,11,0,0,11,3,3,0,3,0,0,0,0,0,05826
1641,179,4,23,60,51,41,44,14,14,0,4,10,0,0,0,0,0,0,0,0,0,30,30,5,3,22,0,0,0,0,0,0,0,0,0,05827
1642,1557,98,479,405,328,247,44,24,24,12,0,12,0,0,0,0,0,0,0,0,0,20,20,0,10,10,0,0,0,0,0,0,0,0,0,05828
1643,1292,148,548,288,228,80,55,27,16,5,10,1,11,4,4,0,0,7,7,0,0,28,28,13,10,5,0,0,0,0,0,0,0,0,0,05829
1644,1164,107,452,305,208,92,94,68,27,9,0,18,41,14,7,0,7,27,27,0,0,26,24,16,0,8,2,2,2,0,0,0,0,0,0,05830
1645,565,22,158,143,120,122,44,25,21,11,0,10,4,4,0,0,4,0,0,0,0,19,19,19,0,0,0,0,0,0,0,0,0,0,0,05832
1646,124,16,56,34,7,11,6,6,6,0,0,6,0,0,0,0,0,0,0,0,0,0,0,0,0,0,0,0,0,0,0,0,0,0,0,05833
1647,803,84,275,161,155,128,37,33,25,8,0,17,8,6,0,4,2,2,0,2,0,4,2,0,0,2,2,0,0,0,0,2,0,2,0,05836
1648,309,55,134,85,25,10,19,11,11,2,0,9,0,0,0,0,0,0,0,0,0,8,5,0,0,5,3,3,0,3,0,0,0,0,0,05837
1649,554,68,215,138,78,55,39,9,9,0,0,9,0,0,0,0,0,0,0,0,0,30,18,0,3,15,12,3,0,0,3,9,0,0,9,05839
1650,347,27,65,87,84,84,1,1,0,0,0,0,1,1,0,1,0,0,0,0,0,0,0,0,0,0,0,0,0,0,0,0,0,0,0,05841
1651,338,54,133,62,49,40,25,18,7,4,0,3,11,11,11,0,0,0,0,0,0,7,7,3,0,4,0,0,0,0,0,0,0,0,0,05842
1652,1840,319,771,396,217,137,117,96,67,18,0,49,29,19,19,0,0,10,0,0,10,21,21,5,0,16,0,0,0,0,0,0,0,0,0,05843
1653,785,119,350,181,74,61,42,23,21,6,3,12,2,2,0,0,2,0,0,0,0,19,15,3,0,12,4,4,4,0,0,0,0,0,0,05845
1654,760,184,300,183,59,34,35,6,0,0,0,0,6,6,6,0,0,0,0,0,0,29,24,2,3,19,5,5,5,0,0,0,0,0,0,05846
1655,557,75,225,164,68,25,66,35,35,15,0,20,0,0,0,0,0,0,0,0,0,31,31,11,15,5,0,0,0,0,0,0,0,0,0,05847
1656,35,0,17,0,0,18,77,46,46,46,0,0,0,0,0,0,0,0,0,0,0,31,31,31,0,0,0,0,0,0,0,0,0,0,0,05850
1657,4099,453,1613,1160,568,305,653,429,333,65,18,250,96,73,23,0,50,23,0,23,0,224,208,107,16,85,16,11,11,0,0,5,0,5,0,05851
1658,504,40,193,126,92,53,37,20,17,3,0,14,3,0,0,0,0,3,3,0,0,17,13,7,0,6,4,4,2,0,2,0,0,0,0,05853
1659,5051,858,1988,1190,599,416,438,187,131,41,2,88,56,56,42,8,6,0,0,0,0,251,161,58,11,92,90,51,39,0,12,39,8,0,31,05855
1660,1211,181,485,350,140,55,67,21,21,18,0,3,0,0,0,0,0,0,0,0,0,46,44,38,0,6,2,2,0,0,2,0,0,0,0,05857
1661,291,37,129,90,23,12,14,5,5,0,0,5,0,0,0,0,0,0,0,0,0,9,6,6,0,0,3,0,0,0,0,3,0,0,3,05858
1662,1424,245,593,306,189,91,113,59,36,34,0,2,23,13,13,0,0,10,2,0,8,54,47,18,5,24,7,7,2,0,5,0,0,0,0,05859
1663,1845,291,799,489,186,80,100,64,36,14,2,20,28,14,11,3,0,14,14,0,0,36,27,12,0,15,9,9,9,0,0,0,0,0,0,05860
1664,302,16,52,98,70,66,15,9,9,5,0,4,0,0,0,0,0,0,0,0,0,6,6,3,0,3,0,0,0,0,0,0,0,0,0,05862
1665,434,44,177,110,71,32,14,8,2,0,0,2,6,6,0,3,3,0,0,0,0,6,3,0,0,3,3,3,3,0,0,0,0,0,0,05866
1666,614,116,274,133,53,38,44,6,6,3,0,3,0,0,0,0,0,0,0,0,0,38,14,6,0,8,24,24,24,0,0,0,0,0,0,05867
1667,222,26,110,51,12,23,2,0,0,0,0,0,0,0,0,0,0,0,0,0,0,2,0,0,0,0,2,2,2,0,0,0,0,0,0,05868
1668,1012,106,388,283,156,79,94,63,59,12,4,43,4,4,4,0,0,0,0,0,0,31,28,18,0,10,3,3,3,0,0,0,0,0,0,05871
1669,580,78,269,145,62,26,20,5,0,0,0,0,5,5,5,0,0,0,0,0,0,15,15,4,0,11,0,0,0,0,0,0,0,0,0,05872
1670,446,36,150,142,52,66,21,13,12,3,0,9,1,1,1,0,0,0,0,0,0,8,5,2,0,3,3,3,3,0,0,0,0,0,0,05873
1671,402,36,130,130,79,27,32,10,10,2,0,8,0,0,0,0,0,0,0,0,0,22,16,3,0,13,6,6,6,0,0,0,0,0,0,05874
1672,356,39,96,110,32,79,30,12,4,0,0,4,8,8,8,0,0,0,0,0,0,18,18,3,0,15,0,0,0,0,0,0,0,0,0,05875
1673,15,3,6,4,0,2,0,0,0,0,0,0,0,0,0,0,0,0,0,0,0,0,0,0,0,0,0,0,0,0,0,0,0,0,0,05901
1674,135,18,64,28,22,3,12,8,8,0,0,8,0,0,0,0,0,0,0,0,0,4,4,4,0,0,0,0,0,0,0,0,0,0,0,05902
1675,770,120,319,196,109,26,70,36,30,21,1,8,6,6,1,5,0,0,0,0,0,34,16,4,2,10,18,18,5,8,5,0,0,0,0,05903
1676,186,43,75,60,8,0,9,2,0,0,0,0,2,2,0,0,2,0,0,0,0,7,7,0,0,7,0,0,0,0,0,0,0,0,0,05904
1677,589,74,225,191,60,39,33,20,20,6,4,10,0,0,0,0,0,0,0,0,0,13,12,2,1,9,1,1,0,0,1,0,0,0,0,05905
1678,940,132,436,234,96,42,76,47,34,3,6,25,13,13,13,0,0,0,0,0,0,29,27,5,5,17,2,2,0,2,0,0,0,0,0,05906
1679,137,27,52,31,21,6,0,0,0,0,0,0,0,0,0,0,0,0,0,0,0,0,0,0,0,0,0,0,0,0,0,0,0,0,0,05907
1680,13099,383,1595,2394,4587,4140,835,467,444,116,43,285,23,23,23,0,0,0,0,0,0,368,368,73,0,295,0,0,0,0,0,0,0,0,0,06001
1681,15621,1324,4318,4144,3315,2520,822,471,471,123,64,284,0,0,0,0,0,0,0,0,0,351,334,51,33,250,17,17,0,0,17,0,0,0,0,06002
1682,43009,5073,16073,11979,6399,3485,2481,1181,979,259,134,586,202,166,88,72,6,36,14,0,22,1300,1220,417,75,728,80,75,41,34,0,5,5,0,0,06010
1683,6379,252,1304,1833,1823,1167,450,208,190,9,20,161,18,18,18,0,0,0,0,0,0,242,242,82,29,131,0,0,0,0,0,0,0,0,0,06013
1684,4518,184,1712,1321,871,430,153,98,98,20,11,67,0,0,0,0,0,0,0,0,0,55,54,33,0,21,1,0,0,0,0,1,0,0,1,06016
1685,2061,344,737,672,169,139,72,9,0,0,0,0,9,0,0,0,0,9,9,0,0,63,56,0,0,56,7,7,0,7,0,0,0,0,0,06018
1686,7056,310,1444,1877,1975,1450,540,202,168,70,0,98,34,34,21,0,13,0,0,0,0,338,329,129,0,200,9,9,0,0,9,0,0,0,0,06019
1687,0,0,0,0,0,0,0,0,0,0,0,0,0,0,0,0,0,0,0,0,0,0,0,0,0,0,0,0,0,0,0,0,0,0,0,06020
1688,218,11,65,53,50,39,27,8,8,0,0,8,0,0,0,0,0,0,0,0,0,19,14,0,0,14,5,5,5,0,0,0,0,0,0,06021
1689,40,0,0,25,8,7,7,0,0,0,0,0,0,0,0,0,0,0,0,0,0,7,7,7,0,0,0,0,0,0,0,0,0,0,0,06022
1690,796,50,220,260,161,105,45,32,32,32,0,0,0,0,0,0,0,0,0,0,0,13,13,13,0,0,0,0,0,0,0,0,0,0,0,06023
1691,571,27,281,157,76,30,35,25,25,10,15,0,0,0,0,0,0,0,0,0,0,10,10,0,0,10,0,0,0,0,0,0,0,0,0,06024
1692,3555,152,751,1141,844,667,269,169,169,48,21,100,0,0,0,0,0,0,0,0,0,100,56,19,21,16,44,25,0,25,0,19,0,19,0,06026
1693,1073,48,376,255,264,130,74,60,37,0,3,34,23,19,15,0,4,4,0,0,4,14,14,4,3,7,0,0,0,0,0,0,0,0,0,06027
1694,10518,673,2304,3403,2478,1660,804,323,295,83,35,177,28,28,28,0,0,0,0,0,0,481,384,86,134,164,97,97,97,0,0,0,0,0,0,06029
1695,984,38,183,277,312,174,47,20,18,11,0,7,2,2,2,0,0,0,0,0,0,27,24,6,7,11,3,3,3,0,0,0,0,0,0,06031
1696,12604,409,2256,2516,3875,3548,754,362,320,95,17,208,42,26,7,0,19,16,16,0,0,392,354,143,10,201,38,34,34,0,0,4,4,0,0,06032
1697,19689,760,3103,3860,5733,6233,1788,872,863,321,56,486,9,9,9,0,0,0,0,0,0,916,916,211,57,648,0,0,0,0,0,0,0,0,0,06033
1698,5948,187,1214,1370,2063,1114,308,212,200,53,24,123,12,12,0,12,0,0,0,0,0,96,96,53,0,43,0,0,0,0,0,0,0,0,0,06035
1699,13674,893,3806,3918,3130,1927,736,376,376,88,13,275,0,0,0,0,0,0,0,0,0,360,336,196,0,140,24,24,24,0,0,0,0,0,0,06037
1700,1324,71,234,291,361,367,75,34,34,0,0,34,0,0,0,0,0,0,0,0,0,41,41,18,7,16,0,0,0,0,0,0,0,0,0,06039
1701,23944,2355,6666,7117,4866,2940,1758,950,744,287,199,258,206,86,32,12,42,120,85,27,8,808,776,272,152,352,32,17,17,0,0,15,15,0,0,06040
1702,16251,1149,3984,4462,4020,2636,827,419,293,63,16,214,126,111,63,0,48,15,0,0,15,408,349,110,79,160,59,40,0,40,0,19,0,19,0,06042
1703,3639,161,889,914,861,814,286,137,125,55,0,70,12,12,0,12,0,0,0,0,0,149,128,44,10,74,21,10,10,0,0,11,11,0,0,06043
1704,18886,4957,7363,4190,1817,559,1807,784,482,103,57,322,302,223,142,48,33,79,26,27,26,1023,837,228,171,438,186,79,49,18,12,107,45,0,62,06051
1705,5479,688,1701,1543,726,821,370,220,167,12,0,155,53,53,0,0,53,0,0,0,0,150,121,78,0,43,29,0,0,0,0,29,0,29,0,06052
1706,22125,4420,7536,5367,2773,2029,2976,1386,1170,424,20,726,216,113,103,3,7,103,19,70,14,1590,1465,572,70,823,125,70,47,0,23,55,24,22,9,06053
1707,4570,256,1029,1290,1207,788,315,131,131,93,15,23,0,0,0,0,0,0,0,0,0,184,148,58,0,90,36,36,17,0,19,0,0,0,0,06057
1708,1127,69,264,334,230,230,78,37,37,16,0,21,0,0,0,0,0,0,0,0,0,41,38,3,5,30,3,3,3,0,0,0,0,0,0,06058
1709,0,0,0,0,0,0,0,0,0,0,0,0,0,0,0,0,0,0,0,0,0,0,0,0,0,0,0,0,0,0,0,0,0,0,0,06059
1710,1622,31,243,286,433,629,88,52,52,30,0,22,0,0,0,0,0,0,0,0,0,36,36,17,0,19,0,0,0,0,0,0,0,0,0,06060
1711,161,15,99,47,0,0,39,19,19,0,0,19,0,0,0,0,0,0,0,0,0,20,20,20,0,0,0,0,0,0,0,0,0,0,0,06061
1712,12917,1293,4501,4066,2029,1028,840,441,377,240,20,117,64,36,27,9,0,28,0,0,28,399,380,172,29,179,19,19,11,0,8,0,0,0,0,06062
1713,2290,90,661,507,739,293,140,69,69,42,0,27,0,0,0,0,0,0,0,0,0,71,62,43,11,8,9,9,9,0,0,0,0,0,0,06063
1714,632,58,185,168,153,68,9,5,5,0,0,5,0,0,0,0,0,0,0,0,0,4,4,0,0,4,0,0,0,0,0,0,0,0,0,06065
1715,21147,1647,6501,6063,3876,3060,1301,582,451,220,105,126,131,106,61,28,17,25,0,25,0,719,650,315,25,310,69,41,41,0,0,28,0,0,28,06066
1716,14416,988,3771,3281,3933,2443,769,471,398,143,17,238,73,73,60,13,0,0,0,0,0,298,298,123,56,119,0,0,0,0,0,0,0,0,0,06067
1717,1280,100,252,223,373,332,142,17,17,0,0,17,0,0,0,0,0,0,0,0,0,125,125,15,0,110,0,0,0,0,0,0,0,0,0,06068
1718,1999,177,553,449,443,377,145,91,91,33,0,58,0,0,0,0,0,0,0,0,0,54,54,27,0,27,0,0,0,0,0,0,0,0,0,06069
1719,10263,298,946,2095,3937,2987,875,588,570,172,51,347,18,11,11,0,0,7,0,0,7,287,287,65,52,170,0,0,0,0,0,0,0,0,0,06070
1720,8153,915,2537,2482,1230,989,574,278,255,66,49,140,23,10,10,0,0,13,0,0,13,296,234,105,0,129,62,62,0,26,36,0,0,0,0,06071
1721,4037,86,609,824,1087,1431,336,181,181,56,29,96,0,0,0,0,0,0,0,0,0,155,155,30,21,104,0,0,0,0,0,0,0,0,0,06073
1722,17516,1156,3917,4094,4765,3584,1408,996,955,496,141,318,41,14,14,0,0,27,0,0,27,412,379,203,41,135,33,33,33,0,0,0,0,0,0,06074
1723,8538,791,3345,2699,1033,670,794,413,247,91,0,156,166,160,68,35,57,6,0,0,6,381,320,173,5,142,61,61,41,0,20,0,0,0,0,06076
1724,8652,960,1978,2430,1943,1341,832,337,285,114,9,162,52,44,0,10,34,8,0,0,8,495,446,166,20,260,49,49,49,0,0,0,0,0,0,06078
1725,987,32,221,348,227,159,57,26,26,9,17,0,0,0,0,0,0,0,0,0,0,31,21,11,0,10,10,0,0,0,0,10,0,0,10,06081
1726,32653,3821,12465,9138,4779,2450,1835,1045,824,343,140,341,221,150,114,13,23,71,52,18,1,790,741,265,118,358,49,33,19,14,0,16,11,5,0,06082
1727,10068,513,2233,2774,2398,2150,721,442,429,193,45,191,13,13,0,13,0,0,0,0,0,279,239,95,16,128,40,7,7,0,0,33,0,0,33,06084
1728,4871,334,1024,1049,1342,1122,384,192,172,28,33,111,20,10,10,0,0,10,0,0,10,192,192,99,0,93,0,0,0,0,0,0,0,0,0,06085
1729,3773,314,1406,1020,643,390,230,68,68,14,48,6,0,0,0,0,0,0,0,0,0,162,152,64,86,2,10,10,10,0,0,0,0,0,0,06088
1730,2014,42,181,435,623,733,248,148,148,11,0,137,0,0,0,0,0,0,0,0,0,100,100,20,7,73,0,0,0,0,0,0,0,0,0,06089
1731,675,17,188,85,228,157,86,48,48,15,0,33,0,0,0,0,0,0,0,0,0,38,29,29,0,0,9,9,9,0,0,0,0,0,0,06090
1732,132,37,27,19,41,8,12,7,7,0,0,7,0,0,0,0,0,0,0,0,0,5,3,0,0,3,2,2,2,0,0,0,0,0,0,06091
1733,2686,26,259,528,903,970,334,171,171,73,0,98,0,0,0,0,0,0,0,0,0,163,163,37,0,126,0,0,0,0,0,0,0,0,0,06092
1734,2229,47,684,661,552,285,184,68,68,51,0,17,0,0,0,0,0,0,0,0,0,116,116,41,0,75,0,0,0,0,0,0,0,0,0,06093
1735,20215,1610,5342,5987,3961,3315,1348,654,519,101,67,351,135,107,62,6,39,28,28,0,0,694,694,195,71,428,0,0,0,0,0,0,0,0,0,06095
1736,9247,912,3227,2974,1324,810,550,340,232,116,16,100,108,91,65,26,0,17,0,0,17,210,200,71,53,76,10,0,0,0,0,10,10,0,0,06096
1737,8929,961,3160,2926,1074,808,577,334,239,120,5,114,95,76,76,0,0,19,19,0,0,243,193,106,35,52,50,0,0,0,0,50,0,0,50,06098
1738,1092,6,72,171,350,493,19,0,0,0,0,0,0,0,0,0,0,0,0,0,0,19,19,0,0,19,0,0,0,0,0,0,0,0,0,06103
1739,14408,2748,3648,3990,1906,2116,1218,460,457,64,96,297,3,0,0,0,0,3,0,0,3,758,699,203,91,405,59,59,0,0,59,0,0,0,0,06105
1740,22451,7964,6544,4666,2153,1124,3781,1927,1452,211,223,1018,475,183,72,51,60,292,78,58,156,1854,1539,220,136,1183,315,202,75,27,100,113,0,83,30,06106
1741,13383,321,1651,1953,4410,5048,879,477,472,142,29,301,5,5,5,0,0,0,0,0,0,402,379,97,22,260,23,23,15,0,8,0,0,0,0,06107
1742,16305,3276,5503,5197,1575,754,1276,787,567,208,147,212,220,130,28,86,16,90,16,22,52,489,415,113,32,270,74,51,35,10,6,23,12,0,11,06108
1743,19214,1884,4721,4635,4608,3366,1136,508,456,128,71,257,52,8,8,0,0,44,44,0,0,628,585,181,60,344,43,43,43,0,0,0,0,0,0,06109
1744,8577,1199,2292,1978,1711,1397,862,386,347,92,43,212,39,6,6,0,0,33,0,33,0,476,433,121,47,265,43,0,0,0,0,43,34,0,9,06110
1745,22615,2009,6240,6631,4764,2971,1195,652,560,273,19,268,92,78,78,0,0,14,0,13,1,543,526,177,42,307,17,17,8,0,9,0,0,0,0,06111
1746,12621,3507,4691,3469,702,252,2292,1144,1041,214,105,722,103,39,5,20,14,64,0,47,17,1148,999,167,137,695,149,118,45,50,23,31,0,0,31,06112
1747,16196,5577,4714,3969,1183,753,1967,993,772,111,96,565,221,59,58,0,1,162,52,29,81,974,780,230,161,389,194,126,31,22,73,68,16,15,37,06114
1748,10833,505,1392,1813,2873,4250,2502,1046,1030,206,9,815,16,5,0,0,5,11,0,0,11,1456,1456,374,91,991,0,0,0,0,0,0,0,0,0,06117
1749,19313,2582,6784,5571,2834,1542,1389,710,613,51,187,375,97,97,75,0,22,0,0,0,0,679,595,103,251,241,84,68,63,0,5,16,0,16,0,06118
1750,11107,608,2282,2033,2690,3494,376,170,160,59,28,73,10,10,0,0,10,0,0,0,0,206,199,47,14,138,7,7,0,0,7,0,0,0,0,06119
1751,7212,2635,2385,1796,276,120,678,296,234,47,119,68,62,11,3,0,8,51,0,21,30,382,325,46,50,229,57,19,0,6,13,38,0,0,38,06120
1752,0,0,0,0,0,0,0,0,0,0,0,0,0,0,0,0,0,0,0,0,0,0,0,0,0,0,0,0,0,0,0,0,0,0,0,06160
1753,10308,2697,3458,2321,930,902,2562,1082,993,297,39,657,89,83,59,12,12,6,4,0,2,1480,1400,469,190,741,80,67,31,9,27,13,0,13,0,06226
1754,2633,78,503,624,768,660,144,48,44,9,0,35,4,0,0,0,0,4,0,0,4,96,43,0,0,43,53,53,0,0,53,0,0,0,0,06231
1755,2021,102,556,607,472,284,191,107,83,28,17,38,24,24,15,9,0,0,0,0,0,84,84,19,23,42,0,0,0,0,0,0,0,0,0,06232
1756,5899,987,1989,1588,700,635,353,223,222,110,0,112,1,0,0,0,0,1,0,0,1,130,119,23,14,82,11,11,11,0,0,0,0,0,0,06234
1757,1669,161,691,397,264,156,125,51,38,15,6,17,13,13,7,0,6,0,0,0,0,74,48,8,21,19,26,15,15,0,0,11,11,0,0,06235
1758,3986,208,1088,1177,840,673,275,109,102,60,0,42,7,0,0,0,0,7,0,0,7,166,107,53,15,39,59,59,0,9,50,0,0,0,0,06237
1759,8893,584,2672,2732,1623,1282,709,483,360,100,73,187,123,36,36,0,0,87,86,0,1,226,226,107,40,79,0,0,0,0,0,0,0,0,0,06238
1760,7131,1227,2601,2042,903,358,493,277,201,39,0,162,76,47,47,0,0,29,0,29,0,216,151,14,8,129,65,51,9,0,42,14,14,0,0,06239
1761,5059,546,1970,1513,562,468,436,181,150,31,23,96,31,31,31,0,0,0,0,0,0,255,202,25,19,158,53,53,53,0,0,0,0,0,0,06241
1762,1019,62,282,321,181,173,59,26,17,4,0,13,9,9,0,0,9,0,0,0,0,33,31,14,9,8,2,2,2,0,0,0,0,0,0,06242
1763,0,0,0,0,0,0,0,0,0,0,0,0,0,0,0,0,0,0,0,0,0,0,0,0,0,0,0,0,0,0,0,0,0,0,0,06243
1764,2057,119,716,626,335,261,156,87,85,21,13,51,2,0,0,0,0,2,2,0,0,69,69,21,4,44,0,0,0,0,0,0,0,0,0,06247
1765,3783,93,721,1198,1070,701,449,220,220,44,0,176,0,0,0,0,0,0,0,0,0,229,229,105,0,124,0,0,0,0,0,0,0,0,0,06248
1766,5225,344,1270,1574,1139,898,363,167,133,12,13,108,34,34,34,0,0,0,0,0,0,196,196,120,0,76,0,0,0,0,0,0,0,0,0,06249
1767,3287,221,593,866,589,1018,221,130,119,39,0,80,11,0,0,0,0,11,0,0,11,91,80,9,0,71,11,11,0,11,0,0,0,0,0,06250
1768,1400,109,442,466,209,174,94,52,49,18,14,17,3,3,3,0,0,0,0,0,0,42,39,12,0,27,3,3,3,0,0,0,0,0,0,06254
1769,3472,578,1359,819,430,286,356,183,169,7,38,124,14,14,14,0,0,0,0,0,0,173,114,52,0,62,59,59,15,44,0,0,0,0,0,06255
1770,1946,318,829,415,276,108,161,106,105,13,0,92,1,0,0,0,0,1,0,0,1,55,55,21,18,16,0,0,0,0,0,0,0,0,0,06256
1771,2990,236,890,826,482,556,307,146,125,24,20,81,21,6,0,0,6,15,0,15,0,161,142,59,16,67,19,0,0,0,0,19,0,19,0,06259
1772,6473,714,2411,2092,782,474,280,159,140,16,22,102,19,19,0,12,7,0,0,0,0,121,110,12,18,80,11,11,11,0,0,0,0,0,0,06260
1773,461,63,208,145,35,10,0,0,0,0,0,0,0,0,0,0,0,0,0,0,0,0,0,0,0,0,0,0,0,0,0,0,0,0,0,06262
1774,82,0,34,48,0,0,0,0,0,0,0,0,0,0,0,0,0,0,0,0,0,0,0,0,0,0,0,0,0,0,0,0,0,0,0,06263
1775,70,4,45,3,6,12,6,6,6,3,0,3,0,0,0,0,0,0,0,0,0,0,0,0,0,0,0,0,0,0,0,0,0,0,0,06264
1776,354,82,133,91,28,20,20,0,0,0,0,0,0,0,0,0,0,0,0,0,0,20,20,0,0,20,0,0,0,0,0,0,0,0,0,06266
1777,5429,554,1082,1074,740,1979,1629,865,863,208,6,649,2,0,0,0,0,2,0,0,2,764,733,225,16,492,31,0,0,0,0,31,0,0,31,06268
1778,72,0,0,41,27,4,4968,2284,2284,637,138,1509,0,0,0,0,0,0,0,0,0,2684,2684,1186,83,1415,0,0,0,0,0,0,0,0,0,06269
1779,2858,194,1100,899,447,218,150,66,38,0,0,38,28,22,22,0,0,6,0,6,0,84,84,19,8,57,0,0,0,0,0,0,0,0,0,06277
1780,3022,260,828,714,734,486,212,146,141,19,13,109,5,5,5,0,0,0,0,0,0,66,61,33,0,28,5,5,0,0,5,0,0,0,0,06278
1781,3843,138,1175,1103,778,649,345,156,156,43,0,113,0,0,0,0,0,0,0,0,0,189,189,130,20,39,0,0,0,0,0,0,0,0,0,06279
1782,2319,142,808,882,297,190,119,75,35,13,0,22,40,3,3,0,0,37,0,0,37,44,44,26,0,18,0,0,0,0,0,0,0,0,0,06280
1783,4759,276,1317,1231,1035,900,520,298,241,94,0,147,57,57,57,0,0,0,0,0,0,222,211,128,0,83,11,11,11,0,0,0,0,0,0,06281
1784,912,79,308,192,140,193,25,0,0,0,0,0,0,0,0,0,0,0,0,0,0,25,11,0,0,11,14,14,14,0,0,0,0,0,0,06282
1785,16586,3008,5254,4703,2051,1570,2771,1354,1254,466,29,759,100,75,9,66,0,25,0,14,11,1417,1312,410,126,776,105,105,14,34,57,0,0,0,0,06320
1786,2319,257,834,740,327,161,240,104,91,37,7,47,13,13,13,0,0,0,0,0,0,136,136,53,24,59,0,0,0,0,0,0,0,0,0,06330
1787,3614,272,1458,1064,555,265,253,181,121,26,0,95,60,60,11,45,4,0,0,0,0,72,72,30,7,35,0,0,0,0,0,0,0,0,0,06331
1788,286,19,201,66,0,0,7,0,0,0,0,0,0,0,0,0,0,0,0,0,0,7,7,0,7,0,0,0,0,0,0,0,0,0,0,06332
1789,4419,175,927,1166,950,1201,376,173,163,30,26,107,10,10,9,0,1,0,0,0,0,203,203,50,7,146,0,0,0,0,0,0,0,0,0,06333
1790,1797,131,675,589,217,185,235,99,81,27,0,54,18,7,0,7,0,11,0,11,0,136,118,59,8,51,18,18,18,0,0,0,0,0,0,06334
1791,4762,226,995,1438,1062,1041,385,236,204,30,0,174,32,32,32,0,0,0,0,0,0,149,131,14,16,101,18,18,18,0,0,0,0,0,0,06335
1792,39,6,17,5,11,0,0,0,0,0,0,0,0,0,0,0,0,0,0,0,0,0,0,0,0,0,0,0,0,0,0,0,0,0,0,06336
1793,5595,352,1839,1842,915,647,330,138,114,58,0,56,24,2,0,1,1,22,0,0,22,192,178,117,0,61,14,14,3,0,11,0,0,0,0,06339
1794,19019,1728,5916,5735,3330,2310,2366,1652,998,546,106,346,654,645,633,0,12,9,9,0,0,714,514,224,41,249,200,139,115,0,24,61,0,0,61,06340
1795,84,34,10,15,25,0,0,0,0,0,0,0,0,0,0,0,0,0,0,0,0,0,0,0,0,0,0,0,0,0,0,0,0,0,0,06350
1796,11398,1326,4664,3133,1151,1124,785,317,269,68,55,146,48,28,26,0,2,20,0,20,0,468,355,65,25,265,113,65,53,0,12,48,0,0,48,06351
1797,0,0,0,0,0,0,0,0,0,0,0,0,0,0,0,0,0,0,0,0,0,0,0,0,0,0,0,0,0,0,0,0,0,0,0,06353
1798,4376,641,1653,1559,297,226,267,48,41,0,1,40,7,0,0,0,0,7,0,7,0,219,219,22,0,197,0,0,0,0,0,0,0,0,0,06354
1799,9543,262,2073,2395,2580,2233,625,247,247,86,9,152,0,0,0,0,0,0,0,0,0,378,338,138,11,189,40,24,24,0,0,16,0,0,16,06355
1800,9702,1008,2292,2954,1676,1772,432,186,151,92,0,59,35,35,0,18,17,0,0,0,0,246,218,126,21,71,28,13,8,0,5,15,0,0,15,06357
1801,3882,137,1353,834,701,857,192,114,100,0,0,100,14,14,0,14,0,0,0,0,0,78,37,2,19,16,41,41,22,19,0,0,0,0,0,06359
1802,25777,3423,8826,8149,3214,2165,1633,884,730,254,136,340,154,113,62,30,21,41,23,14,4,749,716,120,57,539,33,33,7,0,26,0,0,0,0,06360
1803,3466,278,1275,1164,461,288,211,126,82,14,7,61,44,31,31,0,0,13,13,0,0,85,43,0,0,43,42,0,0,0,0,42,42,0,0,06365
1804,5216,369,1976,1420,1019,432,194,88,75,19,0,56,13,13,13,0,0,0,0,0,0,106,67,0,12,55,39,39,39,0,0,0,0,0,0,06370
1805,7423,232,1379,1785,1915,2112,397,314,299,132,0,167,15,15,7,8,0,0,0,0,0,83,77,22,0,55,6,6,6,0,0,0,0,0,0,06371
1806,282,57,99,92,11,23,15,15,0,0,0,0,15,15,15,0,0,0,0,0,0,0,0,0,0,0,0,0,0,0,0,0,0,0,0,06373
1807,6106,649,2933,1418,716,390,482,287,247,29,0,218,40,40,17,23,0,0,0,0,0,195,182,99,0,83,13,13,13,0,0,0,0,0,0,06374
1808,2864,316,943,635,551,419,201,132,132,13,10,109,0,0,0,0,0,0,0,0,0,69,61,24,0,37,8,8,0,0,8,0,0,0,0,06375
1809,107,0,26,29,0,52,5,5,5,0,0,5,0,0,0,0,0,0,0,0,0,0,0,0,0,0,0,0,0,0,0,0,0,0,0,06376
1810,1880,152,794,687,155,92,151,73,55,29,5,21,18,18,18,0,0,0,0,0,0,78,78,23,0,55,0,0,0,0,0,0,0,0,0,06377
1811,4035,146,851,820,1123,1095,164,101,79,30,6,43,22,22,22,0,0,0,0,0,0,63,57,19,0,38,6,6,6,0,0,0,0,0,0,06378
1812,6359,510,2258,1381,1222,988,356,194,168,22,0,146,26,26,0,0,26,0,0,0,0,162,157,92,12,53,5,0,0,0,0,5,5,0,0,06379
1813,1938,465,738,489,190,56,91,91,91,34,7,50,0,0,0,0,0,0,0,0,0,0,0,0,0,0,0,0,0,0,0,0,0,0,0,06380
1814,8526,1338,3486,2258,843,601,581,271,154,14,0,140,117,64,56,0,8,53,35,0,18,310,283,165,16,102,27,27,27,0,0,0,0,0,0,06382
1815,1923,177,643,664,243,196,144,61,51,18,7,26,10,4,0,4,0,6,6,0,0,83,77,24,18,35,6,6,6,0,0,0,0,0,0,06384
1816,11638,998,3481,3040,2035,2084,593,297,265,87,27,151,32,32,23,9,0,0,0,0,0,296,296,80,26,190,0,0,0,0,0,0,0,0,0,06385
1817,99,0,60,39,0,0,0,0,0,0,0,0,0,0,0,0,0,0,0,0,0,0,0,0,0,0,0,0,0,0,0,0,0,0,0,06387
1818,79,0,0,79,0,0,0,0,0,0,0,0,0,0,0,0,0,0,0,0,0,0,0,0,0,0,0,0,0,0,0,0,0,0,0,06389
1819,217,3,37,70,33,74,15,9,9,9,0,0,0,0,0,0,0,0,0,0,0,6,6,0,0,6,0,0,0,0,0,0,0,0,0,06390
1820,13177,1818,5713,3508,1317,821,870,475,449,44,0,405,26,26,17,0,9,0,0,0,0,395,320,16,10,294,75,75,64,11,0,0,0,0,0,06401
1821,4212,255,1461,1245,816,435,286,153,153,32,0,121,0,0,0,0,0,0,0,0,0,133,118,29,31,58,15,15,15,0,0,0,0,0,0,06403
1822,21045,1591,5249,5640,4684,3881,1142,529,502,88,38,376,27,27,0,0,27,0,0,0,0,613,613,169,55,389,0,0,0,0,0,0,0,0,0,06405
1823,418,74,137,145,37,25,30,0,0,0,0,0,0,0,0,0,0,0,0,0,0,30,30,6,0,24,0,0,0,0,0,0,0,0,0,06409
1824,20129,1272,4330,4312,4914,5301,2065,1353,1161,105,37,1019,192,166,33,0,133,26,0,1,25,712,698,201,109,388,14,14,14,0,0,0,0,0,0,06410
1825,3140,174,891,834,689,552,162,116,116,21,0,95,0,0,0,0,0,0,0,0,0,46,46,10,0,36,0,0,0,0,0,0,0,0,0,06412
1826,9512,616,3008,2620,1884,1384,596,233,175,67,10,98,58,58,8,19,31,0,0,0,0,363,302,112,33,157,61,61,46,15,0,0,0,0,0,06413
1827,181,9,46,116,10,0,46,46,46,0,0,46,0,0,0,0,0,0,0,0,0,0,0,0,0,0,0,0,0,0,0,0,0,0,0,06414
1828,11172,563,3257,3194,2714,1444,852,489,389,72,37,280,100,100,51,0,49,0,0,0,0,363,363,99,26,238,0,0,0,0,0,0,0,0,0,06415
1829,10599,701,3114,2668,2505,1611,578,352,298,50,8,240,54,33,0,9,24,21,0,21,0,226,226,127,0,99,0,0,0,0,0,0,0,0,0,06416
1830,3431,153,1121,974,725,458,182,95,95,23,8,64,0,0,0,0,0,0,0,0,0,87,77,38,0,39,10,10,10,0,0,0,0,0,0,06417
1831,9150,1277,3013,2269,1627,964,387,209,168,39,0,129,41,1,1,0,0,40,31,0,9,178,178,45,32,101,0,0,0,0,0,0,0,0,0,06418
1832,4695,137,876,1343,1162,1177,249,186,171,45,12,114,15,15,15,0,0,0,0,0,0,63,63,23,0,40,0,0,0,0,0,0,0,0,0,06419
1833,2808,76,662,885,624,561,259,123,113,39,0,74,10,10,10,0,0,0,0,0,0,136,88,20,29,39,48,48,14,0,34,0,0,0,0,06420
1834,4974,233,1056,1190,1204,1291,365,157,155,40,17,98,2,0,0,0,0,2,0,0,2,208,208,72,0,136,0,0,0,0,0,0,0,0,0,06422
1835,3612,210,1002,1032,797,571,255,131,115,39,0,76,16,16,16,0,0,0,0,0,0,124,124,30,19,75,0,0,0,0,0,0,0,0,0,06423
1836,8730,356,2344,2474,2022,1534,557,308,253,76,30,147,55,55,55,0,0,0,0,0,0,249,229,91,25,113,20,20,0,20,0,0,0,0,0,06424
1837,2718,57,312,739,1038,572,32,29,29,0,15,14,0,0,0,0,0,0,0,0,0,3,3,0,0,3,0,0,0,0,0,0,0,0,0,06426
1838,16328,551,2927,3671,4500,4679,1127,463,444,113,78,253,19,0,0,0,0,19,0,0,19,664,560,218,66,276,104,104,100,4,0,0,0,0,0,06437
1839,2057,66,620,568,521,282,200,114,114,61,12,41,0,0,0,0,0,0,0,0,0,86,86,58,0,28,0,0,0,0,0,0,0,0,0,06438
1840,3670,138,805,944,984,799,338,139,139,66,23,50,0,0,0,0,0,0,0,0,0,199,199,73,0,126,0,0,0,0,0,0,0,0,0,06441
1841,2022,58,481,475,546,462,115,44,25,0,0,25,19,19,19,0,0,0,0,0,0,71,71,25,0,46,0,0,0,0,0,0,0,0,0,06442
1842,12466,331,1587,2382,4399,3767,1183,562,524,158,41,325,38,36,5,0,31,2,0,0,2,621,606,105,18,483,15,0,0,0,0,15,0,0,15,06443
1843,95,0,38,57,0,0,12,0,0,0,0,0,0,0,0,0,0,0,0,0,0,12,12,12,0,0,0,0,0,0,0,0,0,0,0,06444
1844,4407,177,1031,1062,1112,1025,474,249,249,80,36,133,0,0,0,0,0,0,0,0,0,225,217,18,59,140,8,0,0,0,0,8,0,8,0,06447
1845,26168,4060,9322,7293,3150,2343,1866,780,543,106,76,361,237,150,97,24,29,87,6,79,2,1086,904,164,215,525,182,163,95,35,33,19,0,10,9,06450
1846,15992,2867,6168,4395,1644,918,1271,682,544,72,117,355,138,135,56,20,59,3,0,2,1,589,539,213,101,225,50,34,20,14,0,16,0,16,0,06451
1847,2284,98,750,512,491,433,149,76,75,23,14,38,1,1,0,0,1,0,0,0,0,73,73,16,0,57,0,0,0,0,0,0,0,0,0,06455
1848,191,0,66,16,53,56,0,0,0,0,0,0,0,0,0,0,0,0,0,0,0,0,0,0,0,0,0,0,0,0,0,0,0,0,0,06456
1849,32753,2992,10344,8122,6314,4981,3217,1663,1508,353,73,1082,155,136,80,41,15,19,0,19,0,1554,1472,592,118,762,82,58,22,23,13,24,0,16,8,06457
1850,27829,1834,7578,7023,6197,5197,1483,755,683,284,29,370,72,64,30,31,3,8,0,8,0,728,703,258,90,355,25,14,8,6,0,11,0,0,11,06460
1851,10649,630,3314,2637,2283,1785,676,314,238,77,77,84,76,76,63,0,13,0,0,0,0,362,362,148,0,214,0,0,0,0,0,0,0,0,0,06461
1852,75,14,40,9,12,0,1,1,0,0,0,0,1,0,0,0,0,1,0,0,1,0,0,0,0,0,0,0,0,0,0,0,0,0,0,06467
1853,13335,804,3055,3082,3987,2407,1246,605,563,128,28,407,42,24,24,0,0,18,16,0,2,641,641,289,46,306,0,0,0,0,0,0,0,0,0,06468
1854,2267,77,696,688,556,250,221,114,96,36,16,44,18,18,18,0,0,0,0,0,0,107,107,49,20,38,0,0,0,0,0,0,0,0,0,06469
1855,11199,684,2308,2473,3090,2644,1062,611,576,267,45,264,35,14,0,0,14,21,0,0,21,451,427,199,14,214,24,24,24,0,0,0,0,0,0,06470
1856,5966,461,1781,1535,1160,1029,486,220,206,68,0,138,14,14,14,0,0,0,0,0,0,266,266,90,15,161,0,0,0,0,0,0,0,0,0,06471
1857,4605,266,1560,1091,983,705,243,172,172,49,36,87,0,0,0,0,0,0,0,0,0,71,71,0,0,71,0,0,0,0,0,0,0,0,0,06472
1858,17868,1157,5460,4226,3785,3240,1020,505,334,114,42,178,171,171,79,61,31,0,0,0,0,515,443,198,35,210,72,72,72,0,0,0,0,0,0,06473
1859,7701,437,1814,2072,1707,1671,577,259,249,116,0,133,10,10,0,0,10,0,0,0,0,318,318,106,0,212,0,0,0,0,0,0,0,0,0,06475
1860,9762,512,1751,1981,2730,2788,701,336,304,27,35,242,32,32,22,0,10,0,0,0,0,365,348,113,33,202,17,17,0,17,0,0,0,0,0,06477
1861,8703,527,2421,2304,2159,1292,670,235,207,37,0,170,28,28,28,0,0,0,0,0,0,435,386,147,62,177,49,25,0,0,25,24,0,0,24,06478
1862,7863,560,2387,2349,1725,842,298,192,147,34,17,96,45,45,0,45,0,0,0,0,0,106,106,52,0,54,0,0,0,0,0,0,0,0,0,06479
1863,6801,339,2062,1725,1567,1108,409,230,195,53,36,106,35,35,7,28,0,0,0,0,0,179,118,37,27,54,61,45,45,0,0,16,16,0,0,06480
1864,758,63,184,236,144,131,118,51,51,0,10,41,0,0,0,0,0,0,0,0,0,67,67,11,0,56,0,0,0,0,0,0,0,0,0,06481
1865,7436,319,1248,1947,2383,1539,736,398,386,164,68,154,12,12,12,0,0,0,0,0,0,338,319,82,66,171,19,19,19,0,0,0,0,0,0,06482
1866,11071,651,4106,3174,1917,1223,1132,516,385,178,27,180,131,114,99,0,15,17,0,0,17,616,516,207,49,260,100,96,76,0,20,4,0,4,0,06483
1867,29265,2212,8480,7487,6556,4530,1909,716,627,119,43,465,89,67,47,20,0,22,0,22,0,1193,1122,471,16,635,71,71,31,0,40,0,0,0,0,06484
1868,14721,1061,3386,3791,3676,2807,907,472,443,123,0,320,29,15,15,0,0,14,0,14,0,435,425,194,11,220,10,10,10,0,0,0,0,0,0,06488
1869,23231,1576,7063,6654,4462,3476,1296,693,552,135,60,357,141,80,26,32,22,61,8,51,2,603,593,273,28,292,10,10,10,0,0,0,0,0,0,06489
1870,32168,2542,10092,8408,6766,4360,2582,1359,1215,356,162,697,144,117,61,56,0,27,5,1,21,1223,1138,439,101,598,85,72,46,18,8,13,0,6,7,06492
1871,5144,312,1762,1342,908,820,373,172,128,29,0,99,44,42,41,0,1,2,0,0,2,201,148,67,0,81,53,40,39,0,1,13,13,0,0,06498
1872,1660,130,101,114,415,900,134,70,66,12,19,35,4,4,0,0,4,0,0,0,0,64,64,6,4,54,0,0,0,0,0,0,0,0,0,06510
1873,32112,4651,7241,5643,5959,8618,4183,1916,1725,261,123,1341,191,112,28,36,48,79,46,25,8,2267,2127,649,187,1291,140,108,41,0,67,32,24,0,8,06511
1874,21577,2591,9014,5047,2662,2263,1152,576,525,148,0,377,51,51,51,0,0,0,0,0,0,576,552,180,118,254,24,10,0,10,0,14,0,0,14,06512
1875,26341,6114,10479,5896,2404,1448,2226,1228,898,204,93,601,330,218,35,149,34,112,95,17,0,998,796,130,80,586,202,152,87,48,17,50,11,24,15,06513
1876,18195,1641,5326,4976,3589,2663,1740,888,818,123,134,561,70,70,46,15,9,0,0,0,0,852,752,308,72,372,100,26,26,0,0,74,8,0,66,06514
1877,10394,1329,2068,2221,2097,2679,2226,901,753,118,75,560,148,89,56,0,33,59,0,0,59,1325,1273,310,110,853,52,52,52,0,0,0,0,0,0,06515
1878,36614,4706,13306,10641,4796,3165,3454,1819,1655,379,167,1109,164,140,64,15,61,24,0,24,0,1635,1551,323,235,993,84,77,27,27,23,7,0,0,7,06516
1879,10419,482,2368,2039,2434,3096,755,470,439,100,11,328,31,31,11,10,10,0,0,0,0,285,265,73,0,192,20,20,6,0,14,0,0,0,0,06517
1880,11315,533,2236,2394,3158,2994,3012,1120,1107,399,39,669,13,13,13,0,0,0,0,0,0,1892,1861,850,264,747,31,0,0,0,0,31,31,0,0,06518
1881,9509,2935,3532,2112,574,356,948,537,354,22,16,316,183,101,59,33,9,82,24,21,37,411,243,52,71,120,168,114,31,56,27,54,21,16,17,06519
1882,3807,63,878,912,1017,937,386,329,303,80,72,151,26,26,16,0,10,0,0,0,0,57,57,27,0,30,0,0,0,0,0,0,0,0,0,06524
1883,6336,168,806,1178,1908,2276,635,368,368,29,14,325,0,0,0,0,0,0,0,0,0,267,267,69,0,198,0,0,0,0,0,0,0,0,0,06525
1884,18527,5255,5262,4541,1988,1481,2256,965,812,143,144,525,153,30,23,0,7,123,21,31,71,1291,1192,342,114,736,99,93,53,22,18,6,0,0,6,06604
1885,14916,4365,3959,3246,1924,1422,1123,597,506,135,88,283,91,44,23,8,13,47,0,41,6,526,499,97,96,306,27,19,19,0,0,8,0,0,8,06605
1886,31575,6910,10402,8682,3735,1846,2350,1367,975,97,205,673,392,251,88,93,70,141,82,46,13,983,758,266,172,320,225,160,62,98,0,65,11,0,54,06606
1887,4281,1083,1662,1166,260,110,726,359,171,20,41,110,188,69,0,25,44,119,38,8,73,367,245,18,23,204,122,86,25,61,0,36,8,28,0,06607
1888,7371,2698,2610,1637,307,119,1024,387,285,50,57,178,102,52,9,43,0,50,0,11,39,637,470,87,8,375,167,40,28,12,0,127,26,67,34,06608
1889,14144,3297,5146,3998,1243,460,1251,747,549,49,111,389,198,91,32,23,36,107,27,48,32,504,479,86,24,369,25,7,7,0,0,18,18,0,0,06610
1890,24538,1681,5224,5189,7049,5395,1973,1001,964,161,104,699,37,23,13,0,10,14,0,0,14,972,944,285,41,618,28,28,28,0,0,0,0,0,0,06611
1891,5063,210,639,1010,1502,1702,460,247,247,105,20,122,0,0,0,0,0,0,0,0,0,213,213,52,7,154,0,0,0,0,0,0,0,0,0,06612
1892,24722,2005,7895,6958,4917,2947,1588,933,837,242,95,500,96,75,63,12,0,21,11,0,10,655,575,147,44,384,80,71,71,0,0,9,0,0,9,06614
1893,12572,1819,4330,3047,2040,1336,1014,469,349,54,20,275,120,109,29,40,40,11,0,11,0,545,467,208,38,221,78,66,34,0,32,12,0,12,0,06615
1894,2324,1154,722,301,104,43,147,88,52,19,0,33,36,26,0,3,23,10,0,3,7,59,12,0,0,12,47,0,0,0,0,47,0,0,47,06702
1895,15697,3696,5814,4452,1057,678,1865,796,553,57,79,417,243,99,26,44,29,144,5,57,82,1069,947,140,116,691,122,78,67,0,11,44,22,0,22,06704
1896,18016,3352,6780,5272,1796,816,1382,897,738,160,41,537,159,72,72,0,0,87,41,0,46,485,389,105,27,257,96,32,32,0,0,64,10,0,54,06705
1897,9640,2462,3338,2109,1064,667,648,392,250,69,35,146,142,82,71,11,0,60,4,37,19,256,217,57,32,128,39,18,18,0,0,21,0,0,21,06706
1898,19621,2733,7072,5492,2594,1730,1734,916,782,80,83,619,134,46,35,0,11,88,28,0,60,818,624,165,66,393,194,105,26,29,50,89,16,54,19,06708
1899,5704,1664,1817,1338,513,372,601,305,197,11,0,186,108,55,0,17,38,53,0,15,38,296,213,20,27,166,83,76,32,11,33,7,0,7,0,06710
1900,6761,635,2051,1652,1448,975,524,289,275,162,8,105,14,14,14,0,0,0,0,0,0,235,235,119,43,73,0,0,0,0,0,0,0,0,0,06712
1901,11742,815,4229,3381,1851,1466,989,588,512,209,122,181,76,50,50,0,0,26,16,0,10,401,391,228,43,120,10,0,0,0,0,10,0,0,10,06716
1902,981,94,289,357,101,140,94,29,16,14,0,2,13,13,13,0,0,0,0,0,0,65,57,18,0,39,8,8,5,3,0,0,0,0,0,06750
1903,2528,171,692,754,519,392,234,140,101,8,13,80,39,33,33,0,0,6,0,0,6,94,40,17,14,9,54,54,19,35,0,0,0,0,0,06751
1904,1318,61,295,307,356,299,89,45,45,11,0,34,0,0,0,0,0,0,0,0,0,44,44,13,14,17,0,0,0,0,0,0,0,0,0,06752
1905,1296,65,263,353,357,258,64,33,33,3,3,27,0,0,0,0,0,0,0,0,0,31,25,15,0,10,6,6,0,0,6,0,0,0,0,06754
1906,647,0,137,294,90,126,47,19,19,0,0,19,0,0,0,0,0,0,0,0,0,28,16,16,0,0,12,0,0,0,0,12,0,12,0,06755
1907,2093,140,455,607,416,475,125,88,57,0,0,57,31,0,0,0,0,31,0,0,31,37,8,0,0,8,29,29,20,9,0,0,0,0,0,06756
1908,1635,50,301,379,485,420,88,49,42,0,0,42,7,0,0,0,0,7,0,7,0,39,33,21,0,12,6,0,0,0,0,6,0,0,6,06757
1909,306,4,133,80,71,18,0,0,0,0,0,0,0,0,0,0,0,0,0,0,0,0,0,0,0,0,0,0,0,0,0,0,0,0,0,06758
1910,4149,189,846,1056,1113,945,270,143,122,44,0,78,21,21,0,0,21,0,0,0,0,127,127,51,0,76,0,0,0,0,0,0,0,0,0,06759
1911,5411,350,1050,1482,1204,1325,353,191,185,46,66,73,6,6,0,6,0,0,0,0,0,162,153,70,9,74,9,0,0,0,0,9,0,9,0,06762
1912,1431,81,384,415,328,223,132,77,70,38,0,32,7,7,7,0,0,0,0,0,0,55,51,15,5,31,4,4,4,0,0,0,0,0,0,06763
1913,21835,2893,7419,6499,3062,1962,1502,898,649,188,130,331,249,177,101,0,76,72,0,0,72,604,565,186,66,313,39,39,32,0,7,0,0,0,0,06770
1914,18924,1476,5155,4838,4937,2518,1519,825,711,311,94,306,114,102,85,0,17,12,0,0,12,694,656,193,21,442,38,22,13,9,0,16,0,0,16,06776
1915,1080,63,172,316,302,227,51,34,34,4,0,30,0,0,0,0,0,0,0,0,0,17,17,9,0,8,0,0,0,0,0,0,0,0,0,06777
1916,973,72,355,237,225,84,75,55,30,11,19,0,25,25,14,0,11,0,0,0,0,20,20,10,0,10,0,0,0,0,0,0,0,0,0,06778
1917,6009,524,2264,1826,862,533,475,258,194,16,0,178,64,64,64,0,0,0,0,0,0,217,217,53,52,112,0,0,0,0,0,0,0,0,0,06779
1918,1614,158,540,586,225,105,95,77,77,27,0,50,0,0,0,0,0,0,0,0,0,18,18,18,0,0,0,0,0,0,0,0,0,0,0,06782
1919,1724,68,326,432,533,365,76,48,48,8,13,27,0,0,0,0,0,0,0,0,0,28,28,3,0,25,0,0,0,0,0,0,0,0,0,06783
1920,2659,41,463,632,938,585,223,149,149,8,9,132,0,0,0,0,0,0,0,0,0,74,74,31,0,43,0,0,0,0,0,0,0,0,0,06784
1921,592,55,153,111,118,155,96,24,12,0,0,12,12,12,12,0,0,0,0,0,0,72,72,10,0,62,0,0,0,0,0,0,0,0,0,06785
1922,6813,763,2336,2497,676,541,623,380,346,85,34,227,34,23,14,9,0,11,0,11,0,243,206,87,29,90,37,37,26,0,11,0,0,0,0,06786
1923,5605,513,1845,1776,917,554,489,263,255,101,11,143,8,8,0,0,8,0,0,0,0,226,199,141,0,58,27,27,16,0,11,0,0,0,0,06787
1924,26256,3741,9586,7558,3649,1722,1608,801,606,213,126,267,195,102,46,26,30,93,63,8,22,807,649,302,59,288,158,136,66,11,59,22,0,0,22,06790
1925,4099,329,1177,1175,834,584,400,175,120,32,30,58,55,55,9,31,15,0,0,0,0,225,193,69,16,108,32,32,32,0,0,0,0,0,0,06791
1926,594,4,96,59,228,207,203,102,102,0,0,102,0,0,0,0,0,0,0,0,0,101,101,20,0,81,0,0,0,0,0,0,0,0,0,06793
1927,1154,38,279,269,348,220,37,29,29,20,0,9,0,0,0,0,0,0,0,0,0,8,8,8,0,0,0,0,0,0,0,0,0,0,0,06794
1928,10081,583,2593,3026,2099,1780,756,380,380,197,12,171,0,0,0,0,0,0,0,0,0,376,376,202,0,174,0,0,0,0,0,0,0,0,0,06795
1929,772,22,116,127,273,234,94,52,20,17,0,3,32,32,32,0,0,0,0,0,0,42,42,9,0,33,0,0,0,0,0,0,0,0,0,06796
1930,7330,406,1718,1784,1792,1630,458,241,241,86,10,145,0,0,0,0,0,0,0,0,0,217,217,89,0,128,0,0,0,0,0,0,0,0,0,06798
1931,12964,872,3163,3780,3092,2057,997,546,510,162,71,277,36,22,14,8,0,14,0,14,0,451,432,195,24,213,19,19,19,0,0,0,0,0,0,06801
1932,11153,306,2571,2667,3197,2412,789,372,324,99,72,153,48,30,30,0,0,18,0,0,18,417,359,100,18,241,58,0,0,0,0,58,58,0,0,06804
1933,4603,172,543,796,1749,1343,390,214,202,35,8,159,12,12,12,0,0,0,0,0,0,176,176,10,11,155,0,0,0,0,0,0,0,0,0,06807
1934,33325,7632,10892,7005,4642,3154,3311,1659,1343,493,259,591,316,186,42,104,40,130,98,18,14,1652,1397,621,190,586,255,224,93,27,104,31,29,0,2,06810
1935,23025,1991,6014,5964,5250,3806,1792,938,829,435,93,301,109,85,27,0,58,24,0,21,3,854,848,420,33,395,6,6,6,0,0,0,0,0,0,06811
1936,9236,423,1984,2651,2706,1472,985,505,482,125,26,331,23,13,13,0,0,10,0,0,10,480,413,167,28,218,67,59,59,0,0,8,0,8,0,06812
1937,12523,237,1027,1330,5165,4764,1404,805,776,108,83,585,29,14,0,0,14,15,0,15,0,599,599,74,36,489,0,0,0,0,0,0,0,0,0,06820
1938,20908,658,2823,3768,7552,6107,3263,1519,1392,290,84,1018,127,119,25,0,94,8,0,8,0,1744,1722,426,56,1240,22,0,0,0,0,22,0,22,0,06824
1939,13861,969,2796,2838,4029,3229,1535,641,616,105,48,463,25,20,15,0,5,5,0,0,5,894,846,297,8,541,48,26,26,0,0,22,10,0,12,06825
1940,17277,986,3127,2247,5486,5431,1108,526,415,15,21,379,111,98,47,51,0,13,0,0,13,582,568,143,61,364,14,0,0,0,0,14,7,0,7,06830
1941,10494,540,1885,1683,3284,3102,810,364,342,26,27,289,22,22,22,0,0,0,0,0,0,446,408,46,37,325,38,38,0,0,38,0,0,0,0,06831
1942,12660,365,1029,1789,4771,4706,1449,684,684,100,0,584,0,0,0,0,0,0,0,0,0,765,760,168,11,581,5,0,0,0,0,5,0,0,5,06840
1943,14698,1295,3255,3576,4069,2503,701,329,247,43,37,167,82,46,34,12,0,36,24,0,12,372,313,128,21,164,59,7,0,7,0,52,0,0,52,06850
1944,20987,1984,5031,4803,5303,3866,1066,554,491,99,57,335,63,60,31,20,9,3,3,0,0,512,407,123,113,171,105,89,41,14,34,16,4,0,12,06851
1945,2722,84,280,370,1119,869,84,47,47,9,0,38,0,0,0,0,0,0,0,0,0,37,37,8,0,29,0,0,0,0,0,0,0,0,0,06853
1946,19520,2959,5778,4743,4180,1860,1139,624,470,150,13,307,154,133,87,39,7,21,21,0,0,515,450,190,28,232,65,65,26,0,39,0,0,0,0,06854
1947,5659,536,1394,1263,1631,835,239,139,123,41,0,82,16,16,0,0,16,0,0,0,0,100,74,48,0,26,26,26,0,9,17,0,0,0,0,06855
1948,4,1,3,0,0,0,0,0,0,0,0,0,0,0,0,0,0,0,0,0,0,0,0,0,0,0,0,0,0,0,0,0,0,0,0,06856
1949,4374,29,249,532,1599,1965,384,191,191,34,15,142,0,0,0,0,0,0,0,0,0,193,193,47,0,146,0,0,0,0,0,0,0,0,0,06870
1950,16121,330,1618,2740,6061,5372,1532,730,708,206,50,452,22,0,0,0,0,22,0,0,22,802,802,370,11,421,0,0,0,0,0,0,0,0,0,06877
1951,5316,81,609,860,2056,1710,405,235,217,32,0,185,18,18,0,18,0,0,0,0,0,170,147,13,0,134,23,12,12,0,0,11,0,0,11,06878
1952,18105,322,1831,2237,6733,6982,1468,950,900,199,44,657,50,50,50,0,0,0,0,0,0,518,474,96,0,378,44,12,12,0,0,32,0,0,32,06880
1953,6234,68,339,703,2722,2402,713,329,329,58,26,245,0,0,0,0,0,0,0,0,0,384,384,110,32,242,0,0,0,0,0,0,0,0,0,06883
1954,3009,87,344,427,1182,969,152,77,77,14,14,49,0,0,0,0,0,0,0,0,0,75,71,0,0,71,4,0,0,0,0,4,0,0,4,06890
1955,6167,103,702,930,2357,2075,521,256,232,77,25,130,24,24,24,0,0,0,0,0,0,265,265,94,43,128,0,0,0,0,0,0,0,0,0,06896
1956,11611,277,844,1800,4642,4048,1065,552,537,109,0,428,15,15,15,0,0,0,0,0,0,513,505,162,0,343,8,8,8,0,0,0,0,0,0,06897
1957,5340,723,901,929,1701,1086,286,222,170,0,0,170,52,16,16,0,0,36,0,0,36,64,64,55,9,0,0,0,0,0,0,0,0,0,0,06901
1958,45453,8636,11717,9237,9104,6759,2730,1695,1421,312,191,918,274,123,99,0,24,151,115,36,0,1035,944,253,155,536,91,39,39,0,0,52,20,0,32,06902
1959,10116,395,1405,1590,3486,3240,608,270,232,32,72,128,38,38,38,0,0,0,0,0,0,338,300,33,17,250,38,38,38,0,0,0,0,0,0,06903
1960,13905,1053,2647,3096,3806,3303,798,488,465,128,47,290,23,23,16,0,7,0,0,0,0,310,310,115,31,164,0,0,0,0,0,0,0,0,0,06905
1961,6035,591,1363,1392,1800,889,478,302,281,55,17,209,21,21,21,0,0,0,0,0,0,176,161,28,38,95,15,0,0,0,0,15,15,0,0,06906
1962,5643,417,1332,1418,1485,991,309,148,148,18,57,73,0,0,0,0,0,0,0,0,0,161,161,9,16,136,0,0,0,0,0,0,0,0,0,06907
1963,13150,1416,5678,2690,2321,1045,534,258,204,26,9,169,54,54,11,0,43,0,0,0,0,276,233,77,47,109,43,23,18,5,0,20,0,0,20,07001
1964,44869,5576,16683,9340,9530,3740,3168,1425,1210,29,2,1179,215,141,104,7,30,74,13,0,61,1743,1589,392,27,1170,154,131,74,11,46,23,23,0,0,07002
1965,33647,3299,8516,8675,8625,4532,2664,1318,1206,219,49,938,112,35,8,4,23,77,47,0,30,1346,1304,250,48,1006,42,42,26,0,16,0,0,0,0,07003
1966,5174,365,1583,1252,1345,629,397,171,171,29,7,135,0,0,0,0,0,0,0,0,0,226,226,32,16,178,0,0,0,0,0,0,0,0,0,07004
1967,10635,686,2482,2372,3170,1925,632,316,277,96,0,181,39,39,8,0,31,0,0,0,0,316,306,77,16,213,10,10,0,0,10,0,0,0,0,07005
1968,17611,1017,3545,3685,5546,3818,1196,687,675,137,27,511,12,12,12,0,0,0,0,0,0,509,501,88,29,384,8,8,0,0,8,0,0,0,0,07006
1969,15530,2513,5361,4365,2162,1129,1234,567,454,27,106,321,113,111,0,79,32,2,0,2,0,667,609,155,44,410,58,58,25,33,0,0,0,0,0,07008
1970,9231,661,2691,1668,2828,1383,453,245,208,52,0,156,37,37,0,35,2,0,0,0,0,208,201,75,0,126,7,7,7,0,0,0,0,0,0,07009
1971,18289,2635,4841,3414,4540,2859,859,520,469,49,24,396,51,8,8,0,0,43,0,0,43,339,272,25,38,209,67,25,25,0,0,42,0,0,42,07010
1972,26729,4057,10864,6102,4012,1694,2082,1143,915,198,88,629,228,207,100,0,107,21,5,11,5,939,817,135,87,595,122,112,56,14,42,10,0,0,10,07011
1973,8661,599,2230,2188,2459,1185,306,155,155,10,12,133,0,0,0,0,0,0,0,0,0,151,141,48,14,79,10,0,0,0,0,10,0,0,10,07012
1974,19163,2059,5802,4704,4075,2523,936,491,438,51,0,387,53,25,7,18,0,28,0,16,12,445,445,98,42,305,0,0,0,0,0,0,0,0,0,07013
1975,3621,244,910,955,975,537,149,81,81,43,0,38,0,0,0,0,0,0,0,0,0,68,68,0,0,68,0,0,0,0,0,0,0,0,0,07014
1976,16240,723,3744,3501,4992,3280,1039,474,431,178,0,253,43,42,33,0,9,1,0,0,1,565,520,133,21,366,45,27,11,0,16,18,0,0,18,07016
1977,23187,3261,8524,7840,2540,1022,1952,1004,744,29,73,642,260,210,111,7,92,50,0,41,9,948,858,105,133,620,90,90,26,57,7,0,0,0,0,07017
1978,19273,3338,6883,5815,2167,1070,1748,790,586,149,90,347,204,150,42,59,49,54,23,18,13,958,825,193,131,501,133,118,43,67,8,15,0,15,0,07018
1979,9086,411,874,1050,4134,2617,138,106,95,0,15,80,11,0,0,0,0,11,11,0,0,32,32,0,0,32,0,0,0,0,0,0,0,0,0,07020
1980,1365,9,179,193,468,516,151,82,82,10,13,59,0,0,0,0,0,0,0,0,0,69,63,18,0,45,6,3,3,0,0,3,0,0,3,07021
1981,10146,2613,3565,1764,1648,556,475,243,203,0,0,203,40,40,40,0,0,0,0,0,0,232,207,26,0,181,25,15,0,0,15,10,0,0,10,07022
1982,4999,108,819,1105,1913,1054,231,85,85,35,0,50,0,0,0,0,0,0,0,0,0,146,146,61,0,85,0,0,0,0,0,0,0,0,0,07023
1983,27953,1886,5544,4848,9468,6207,963,550,550,4,0,546,0,0,0,0,0,0,0,0,0,413,385,44,5,336,28,28,13,0,15,0,0,0,0,07024
1984,20593,3751,8383,4605,3110,744,1402,679,551,126,25,400,128,112,83,0,29,16,16,0,0,723,648,200,23,425,75,75,17,0,58,0,0,0,0,07026
1985,3079,237,974,691,790,387,203,123,89,19,0,70,34,34,0,34,0,0,0,0,0,80,80,9,31,40,0,0,0,0,0,0,0,0,0,07027
1986,4737,45,564,544,1720,1864,484,106,106,0,0,106,0,0,0,0,0,0,0,0,0,378,365,60,16,289,13,13,13,0,0,0,0,0,0,07028
1987,11291,2511,3540,2085,1702,1453,855,461,419,21,40,358,42,27,27,0,0,15,0,0,15,394,372,45,2,325,22,17,4,11,2,5,0,0,5,07029
1988,38417,2843,3747,3591,17495,10741,1399,892,804,25,17,762,88,88,0,0,88,0,0,0,0,507,468,26,8,434,39,39,0,11,28,0,0,0,0,07030
1989,11291,1123,3848,2800,2234,1286,639,349,315,34,0,281,34,34,31,0,3,0,0,0,0,290,278,70,0,208,12,12,12,0,0,0,0,0,0,07031
1990,27829,5421,10474,6382,3882,1670,2142,1260,1169,160,108,901,91,74,9,19,46,17,0,0,17,882,812,54,24,734,70,55,32,17,6,15,0,15,0,07032
1991,5340,605,2247,1343,854,291,698,363,363,26,0,337,0,0,0,0,0,0,0,0,0,335,304,156,33,115,31,31,16,0,15,0,0,0,0,07033
1992,6906,390,2359,1421,1718,1018,473,295,267,38,62,167,28,16,0,0,16,12,0,0,12,178,144,33,49,62,34,17,17,0,0,17,0,17,0,07034
1993,8095,606,2740,1829,1841,1079,394,118,118,40,0,78,0,0,0,0,0,0,0,0,0,276,276,99,69,108,0,0,0,0,0,0,0,0,0,07035
1994,29713,4558,12116,7983,3384,1672,2029,1115,926,171,134,621,189,172,59,91,22,17,0,13,4,914,774,195,41,538,140,101,65,10,26,39,35,0,4,07036
1995,20298,732,2836,2909,7397,6424,1184,541,541,75,12,454,0,0,0,0,0,0,0,0,0,643,643,115,46,482,0,0,0,0,0,0,0,0,0,07039
1996,15184,704,2354,2599,5282,4245,1384,556,515,76,58,381,41,41,0,0,41,0,0,0,0,828,810,245,21,544,18,18,18,0,0,0,0,0,0,07040
1997,4653,108,724,539,1750,1532,333,215,214,35,0,179,1,1,0,0,1,0,0,0,0,118,108,0,0,108,10,0,0,0,0,10,0,0,10,07041
1998,17293,960,2706,3215,5479,4933,1436,617,582,29,48,505,35,23,11,10,2,12,0,12,0,819,784,196,30,558,35,35,0,0,35,0,0,0,0,07042
1999,7750,123,376,971,2700,3580,1095,559,541,63,15,463,18,18,10,0,8,0,0,0,0,536,523,211,31,281,13,2,0,0,2,11,0,0,11,07043
2000,10142,429,2071,2244,3408,1990,418,151,139,32,0,107,12,12,11,0,1,0,0,0,0,267,267,77,11,179,0,0,0,0,0,0,0,0,0,07044
2001,6774,286,1139,1249,2220,1880,659,397,374,46,29,299,23,23,0,0,23,0,0,0,0,262,262,129,10,123,0,0,0,0,0,0,0,0,0,07045
2002,2481,48,62,200,1025,1146,592,288,204,30,0,174,84,37,0,0,37,47,39,0,8,304,304,94,12,198,0,0,0,0,0,0,0,0,0,07046
2003,42589,9224,12020,10874,7049,3422,2756,1592,1292,276,270,746,300,181,83,43,55,119,23,83,13,1164,1069,323,66,680,95,38,38,0,0,57,0,0,57,07047
2004,19665,4256,7188,4600,2641,980,1348,822,716,43,157,516,106,73,62,8,3,33,22,0,11,526,472,100,72,300,54,25,0,0,25,29,0,0,29,07050
2005,31925,2901,6904,6878,8815,6427,2243,1135,981,189,64,728,154,104,0,48,56,50,0,24,26,1108,1061,174,32,855,47,37,0,7,30,10,0,0,10,07052
2006,21125,1841,4942,3694,6720,3928,1119,535,491,132,6,353,44,27,0,8,19,17,0,0,17,584,516,177,46,293,68,48,7,0,41,20,0,0,20,07054
2007,39046,13798,13853,6016,3510,1869,5676,3114,2579,185,81,2313,535,330,89,9,232,205,45,23,137,2562,1999,154,46,1799,563,345,105,19,221,218,20,41,157,07055
2008,8525,926,3671,1880,1561,487,522,261,247,44,11,192,14,14,0,0,14,0,0,0,0,261,221,21,20,180,40,40,32,0,8,0,0,0,0,07057
2009,4002,75,971,509,1234,1213,393,245,224,11,23,190,21,21,21,0,0,0,0,0,0,148,148,31,15,102,0,0,0,0,0,0,0,0,0,07058
2010,10340,347,1857,1638,3557,2941,901,408,392,116,10,266,16,16,16,0,0,0,0,0,0,493,478,67,13,398,15,0,0,0,0,15,15,0,0,07059
2011,29404,7609,8915,7030,3548,2302,2229,1065,681,158,67,456,384,138,78,0,60,246,246,0,0,1164,1069,347,156,566,95,58,40,0,18,37,22,4,11,07060
2012,8386,1354,2938,1966,1461,667,658,305,242,0,41,201,63,43,35,0,8,20,20,0,0,353,266,109,62,95,87,75,46,29,0,12,12,0,0,07062
2013,9249,2449,3213,2077,1049,461,766,517,444,189,72,183,73,28,8,20,0,45,45,0,0,249,219,106,51,62,30,9,9,0,0,21,11,0,10,07063
2014,2464,238,1153,544,347,182,210,115,115,30,31,54,0,0,0,0,0,0,0,0,0,95,95,11,0,84,0,0,0,0,0,0,0,0,0,07064
2015,19112,2299,6932,5152,3045,1684,1462,779,704,132,116,456,75,75,66,0,9,0,0,0,0,683,597,155,118,324,86,86,48,0,38,0,0,0,0,07065
2016,10746,772,3355,2524,2823,1272,779,356,318,27,2,289,38,38,0,25,13,0,0,0,0,423,423,55,42,326,0,0,0,0,0,0,0,0,0,07066
2017,12336,983,3875,3257,2730,1491,827,446,409,96,57,256,37,37,7,0,30,0,0,0,0,381,366,89,81,196,15,8,8,0,0,7,0,7,0,07067
2018,4373,148,904,806,1374,1141,228,141,127,31,0,96,14,14,0,0,14,0,0,0,0,87,87,33,0,54,0,0,0,0,0,0,0,0,0,07068
2019,4404,330,583,820,1228,1443,201,83,14,0,0,14,69,0,0,0,0,69,69,0,0,118,118,35,17,66,0,0,0,0,0,0,0,0,0,07069
2020,12406,864,2382,3141,3808,2211,989,506,479,90,37,352,27,22,0,17,5,5,0,0,5,483,457,117,9,331,26,10,0,10,0,16,0,0,16,07070
2021,15017,1589,5152,3574,3021,1681,1113,541,433,54,15,364,108,85,0,0,85,23,0,23,0,572,518,108,22,388,54,0,0,0,0,54,0,0,54,07071
2022,4401,496,1732,880,831,462,495,274,274,65,30,179,0,0,0,0,0,0,0,0,0,221,201,13,0,188,20,20,20,0,0,0,0,0,0,07072
2023,6798,446,1828,1714,1818,992,339,250,216,103,0,113,34,34,12,0,22,0,0,0,0,89,67,55,0,12,22,22,22,0,0,0,0,0,0,07073
2024,2059,367,985,330,288,89,108,56,44,0,0,44,12,12,0,0,12,0,0,0,0,52,52,25,0,27,0,0,0,0,0,0,0,0,0,07074
2025,5987,636,1660,1430,1471,790,439,301,291,90,11,190,10,0,0,0,0,10,0,0,10,138,138,41,16,81,0,0,0,0,0,0,0,0,0,07075
2026,16115,385,2605,4405,4970,3750,1236,574,416,131,0,285,158,137,97,40,0,21,0,21,0,662,622,230,16,376,40,0,0,0,0,40,0,0,40,07076
2027,1886,173,698,499,401,115,47,39,39,0,22,17,0,0,0,0,0,0,0,0,0,8,8,0,0,8,0,0,0,0,0,0,0,0,0,07077
2028,7839,32,395,548,2820,4044,794,401,401,55,0,346,0,0,0,0,0,0,0,0,0,393,393,53,0,340,0,0,0,0,0,0,0,0,0,07078
2029,9861,401,1184,1644,3445,3187,1768,855,835,89,37,709,20,0,0,0,0,20,0,0,20,913,900,72,8,820,13,13,13,0,0,0,0,0,0,07079
2030,16881,1743,5312,3752,4029,2045,1097,564,519,73,105,341,45,22,0,22,0,23,17,6,0,533,486,143,51,292,47,42,42,0,0,5,0,0,5,07080
2031,12176,867,2299,2507,3582,2921,786,451,451,68,26,357,0,0,0,0,0,0,0,0,0,335,335,142,0,193,0,0,0,0,0,0,0,0,0,07081
2032,3577,49,698,477,1442,911,264,140,131,0,0,131,9,9,0,9,0,0,0,0,0,124,110,15,0,95,14,14,0,14,0,0,0,0,0,07082
2033,36959,4373,10645,9772,8218,3951,3304,1721,1518,333,123,1062,203,136,73,55,8,67,30,0,37,1583,1368,303,194,871,215,215,116,70,29,0,0,0,0,07083
2034,9755,1143,1620,1989,3153,1850,554,363,327,49,54,224,36,31,18,13,0,5,5,0,0,191,184,22,0,162,7,0,0,0,0,7,0,0,7,07086
2035,44355,14553,13855,8597,5219,2131,3865,1955,1676,277,177,1222,279,196,62,62,72,83,44,19,20,1910,1662,215,189,1258,248,230,47,33,150,18,0,0,18,07087
2036,2472,345,948,737,332,110,175,105,65,0,39,26,40,29,29,0,0,11,0,0,11,70,70,0,0,70,0,0,0,0,0,0,0,0,0,07088
2037,20044,729,2695,3420,7335,5865,1747,774,708,69,100,539,66,51,48,0,3,15,0,0,15,973,940,230,31,679,33,33,10,23,0,0,0,0,0,07090
2038,4773,274,771,882,1510,1336,359,249,249,130,0,119,0,0,0,0,0,0,0,0,0,110,110,70,32,8,0,0,0,0,0,0,0,0,0,07092
2039,43512,12191,11043,8732,7563,3983,2700,1349,1079,122,137,820,270,154,69,14,71,116,73,29,14,1351,992,167,63,762,359,194,135,17,42,165,32,86,47,07093
2040,12889,1554,3067,2894,3248,2126,756,496,406,73,0,333,90,48,4,44,0,42,0,0,42,260,260,22,0,238,0,0,0,0,0,0,0,0,0,07094
2041,14210,1475,4012,3098,3491,2134,804,454,372,140,11,221,82,82,9,0,73,0,0,0,0,350,348,72,12,264,2,2,2,0,0,0,0,0,0,07095
2042,7576,2455,2166,1260,1107,588,1484,950,906,94,16,796,44,42,0,37,5,2,0,0,2,534,487,34,19,434,47,33,0,14,19,14,0,0,14,07102
2043,17458,4231,5889,4737,1750,851,2575,1438,1111,42,114,955,327,142,24,47,71,185,0,0,185,1137,1015,29,109,877,122,93,13,62,18,29,22,7,0,07103
2044,31713,9868,10518,6763,3203,1361,2744,1424,863,87,122,654,561,324,78,83,163,237,18,0,219,1320,1065,122,65,878,255,188,52,27,109,67,26,0,41,07104
2045,35437,15392,11924,4349,2839,933,2151,1226,783,69,29,685,443,143,37,9,97,300,163,0,137,925,809,253,100,456,116,106,16,38,52,10,0,2,8,07105
2046,19679,3499,7575,5680,2151,774,1604,739,639,85,58,496,100,84,0,47,37,16,0,16,0,865,687,36,70,581,178,70,33,37,0,108,14,0,94,07106
2047,22628,6538,8475,5245,1820,550,2062,1057,849,88,296,465,208,135,39,36,60,73,9,0,64,1005,844,250,168,426,161,97,13,26,58,64,0,0,64,07107
2048,13547,2888,5255,3979,1062,363,1659,649,485,8,177,300,164,152,44,25,83,12,1,0,11,1010,872,83,131,658,138,96,10,31,55,42,0,0,42,07108
2049,24942,3647,8487,6500,4775,1533,1919,1080,810,104,174,532,270,262,85,64,113,8,0,0,8,839,803,153,126,524,36,10,0,0,10,26,0,0,26,07109
2050,20931,1419,6217,3922,5853,3520,1137,630,628,97,35,496,2,1,0,0,1,1,0,0,1,507,486,121,57,308,21,21,11,10,0,0,0,0,0,07110
2051,34699,6538,13234,10570,3360,997,2943,1544,1374,84,351,939,170,122,105,17,0,48,0,26,22,1399,1147,197,204,746,252,252,52,50,150,0,0,0,0,07111
2052,16647,2597,6428,5365,1401,856,1703,931,693,52,177,464,238,222,176,27,19,16,0,6,10,772,728,184,123,421,44,44,13,31,0,0,0,0,0,07112
2053,9556,3475,3903,1590,354,234,760,364,270,17,20,233,94,67,13,0,54,27,0,0,27,396,304,21,130,153,92,73,52,0,21,19,0,8,11,07114
2054,15531,4285,7089,3128,722,307,1103,405,294,49,27,218,111,76,60,0,16,35,6,0,29,698,598,60,35,503,100,57,12,18,27,43,0,15,28,07201
2055,26846,7714,9983,5927,2393,829,1782,815,607,105,107,395,208,111,97,6,8,97,0,27,70,967,872,204,99,569,95,65,32,0,33,30,0,13,17,07202
2056,14770,1497,5400,4807,2143,923,963,496,447,0,80,367,49,49,49,0,0,0,0,0,0,467,424,81,48,295,43,43,21,0,22,0,0,0,0,07203
2057,9287,882,3088,2691,1804,822,970,492,468,75,63,330,24,24,15,0,9,0,0,0,0,478,406,56,72,278,72,72,54,0,18,0,0,0,0,07204
2058,13953,2123,4517,4237,2159,917,1408,848,792,130,67,595,56,33,0,0,33,23,0,23,0,560,453,90,166,197,107,12,0,0,12,95,0,0,95,07205
2059,15311,5175,6703,2690,624,119,1330,665,554,15,44,495,111,82,49,0,33,29,12,0,17,665,501,67,46,388,164,76,47,0,29,88,27,36,25,07206
2060,20771,4428,7349,4699,2664,1631,1373,836,567,116,148,303,269,119,26,60,33,150,101,44,5,537,369,193,37,139,168,150,93,42,15,18,0,0,18,07208
2061,30269,2218,2857,3820,11239,10135,742,469,422,68,19,335,47,47,47,0,0,0,0,0,0,273,234,41,0,193,39,29,0,19,10,10,0,0,10,07302
2062,27487,4937,8518,6525,5639,1868,2231,1295,920,84,115,721,375,293,112,24,157,82,0,57,25,936,859,199,84,576,77,60,42,15,3,17,17,0,0,07304
2063,40153,7362,10951,10681,7713,3446,3714,1810,1596,159,132,1305,214,125,23,65,37,89,0,17,72,1904,1476,147,137,1192,428,319,165,104,50,109,0,10,99,07305
2064,36466,5861,9295,6621,9991,4698,2853,1366,1314,83,103,1128,52,52,30,15,7,0,0,0,0,1487,1399,179,66,1154,88,43,43,0,0,45,0,0,45,07306
2065,29457,5965,7995,6173,6306,3018,2044,1002,870,112,69,689,132,91,29,0,62,41,0,0,41,1042,811,128,61,622,231,198,98,59,41,33,0,0,33,07307
2066,10207,256,657,561,3388,5345,210,99,99,20,0,79,0,0,0,0,0,0,0,0,0,111,66,0,0,66,45,23,0,0,23,22,22,0,0,07310
2067,395,0,0,15,109,271,0,0,0,0,0,0,0,0,0,0,0,0,0,0,0,0,0,0,0,0,0,0,0,0,0,0,0,0,0,07311
2068,4217,175,540,825,1738,939,305,220,220,43,0,177,0,0,0,0,0,0,0,0,0,85,85,27,0,58,0,0,0,0,0,0,0,0,0,07401
2069,5296,485,2009,1368,993,441,376,246,198,94,0,104,48,48,16,32,0,0,0,0,0,130,115,64,0,51,15,15,15,0,0,0,0,0,0,07403
2070,12309,823,2630,2591,3841,2424,830,425,408,113,54,241,17,17,17,0,0,0,0,0,0,405,396,99,7,290,9,9,9,0,0,0,0,0,0,07405
2071,13609,1636,5003,3501,2322,1147,1154,605,553,204,21,328,52,52,15,20,17,0,0,0,0,549,511,210,36,265,38,29,29,0,0,9,9,0,0,07407
2072,23457,1822,4685,5068,6913,4969,1732,797,760,195,128,437,37,37,15,0,22,0,0,0,0,935,872,221,7,644,63,45,0,0,45,18,0,0,18,07410
2073,4220,444,1701,1183,593,299,239,120,120,32,0,88,0,0,0,0,0,0,0,0,0,119,61,46,0,15,58,58,26,32,0,0,0,0,0,07416
2074,7039,230,1132,897,2727,2053,807,431,405,160,23,222,26,26,0,0,26,0,0,0,0,376,376,133,0,243,0,0,0,0,0,0,0,0,0,07417
2075,1456,7,642,470,263,74,64,27,17,0,0,17,10,10,10,0,0,0,0,0,0,37,37,9,0,28,0,0,0,0,0,0,0,0,0,07418
2076,6460,357,2439,1766,1210,688,317,163,137,51,0,86,26,15,15,0,0,11,11,0,0,154,121,44,10,67,33,33,23,10,0,0,0,0,0,07419
2077,3285,512,1278,806,478,211,223,62,49,0,0,49,13,0,0,0,0,13,0,13,0,161,161,68,81,12,0,0,0,0,0,0,0,0,0,07420
2078,5156,429,1959,1542,856,370,485,274,219,72,11,136,55,23,0,23,0,32,0,32,0,211,144,74,10,60,67,24,24,0,0,43,43,0,0,07421
2079,4423,316,1473,1522,813,299,386,240,227,85,25,117,13,13,0,0,13,0,0,0,0,146,63,14,0,49,83,54,54,0,0,29,0,0,29,07422
2080,2837,67,277,469,1198,826,163,122,110,0,0,110,12,12,12,0,0,0,0,0,0,41,41,15,0,26,0,0,0,0,0,0,0,0,0,07423
2081,18438,1905,6896,3509,4075,2053,1372,509,493,74,34,385,16,0,0,0,0,16,16,0,0,863,863,347,68,448,0,0,0,0,0,0,0,0,0,07424
2082,17011,841,3051,3811,5356,3952,1956,923,906,222,107,577,17,14,1,0,13,3,0,0,3,1033,1020,263,103,654,13,0,0,0,0,13,0,0,13,07430
2083,5167,195,1277,1078,1738,879,351,176,122,39,0,83,54,54,54,0,0,0,0,0,0,175,145,0,0,145,30,0,0,0,0,30,14,0,16,07432
2084,1576,21,414,389,473,279,120,40,40,0,0,40,0,0,0,0,0,0,0,0,0,80,68,30,0,38,12,12,12,0,0,0,0,0,0,07435
2085,8591,483,1772,2007,2608,1721,722,385,357,140,70,147,28,28,0,28,0,0,0,0,0,337,337,90,11,236,0,0,0,0,0,0,0,0,0,07436
2086,7932,521,2275,2244,2007,885,379,263,263,23,0,240,0,0,0,0,0,0,0,0,0,116,116,50,0,66,0,0,0,0,0,0,0,0,0,07438
2087,1625,140,526,580,247,132,157,79,61,30,0,31,18,18,18,0,0,0,0,0,0,78,55,23,0,32,23,23,23,0,0,0,0,0,0,07439
2088,3408,174,923,935,898,478,290,164,151,94,0,57,13,13,13,0,0,0,0,0,0,126,126,42,0,84,0,0,0,0,0,0,0,0,0,07440
2089,7894,544,2966,1706,1918,760,462,172,161,15,35,111,11,11,11,0,0,0,0,0,0,290,290,50,70,170,0,0,0,0,0,0,0,0,0,07442
2090,7981,373,2305,1917,2243,1143,544,220,207,98,0,109,13,0,0,0,0,13,13,0,0,324,307,58,50,199,17,17,0,0,17,0,0,0,0,07444
2091,10141,280,1701,2396,3442,2322,928,484,452,122,23,307,32,16,0,0,16,16,16,0,0,444,412,60,25,327,32,0,0,0,0,32,0,0,32,07446
2092,16346,399,1382,2278,6910,5377,1549,718,700,60,43,597,18,18,18,0,0,0,0,0,0,831,806,166,23,617,25,14,0,0,14,11,11,0,0,07450
2093,7486,162,1046,1386,2704,2188,646,330,310,32,34,244,20,20,8,12,0,0,0,0,0,316,243,73,28,142,73,73,16,19,38,0,0,0,0,07452
2094,8235,690,2212,1974,2175,1184,658,356,319,193,39,87,37,0,0,0,0,37,0,20,17,302,262,113,0,149,40,11,11,0,0,29,11,18,0,07456
2095,2893,143,982,580,733,455,182,69,55,29,10,16,14,14,6,8,0,0,0,0,0,113,104,18,9,77,9,9,0,0,9,0,0,0,0,07457
2096,7539,142,1122,1317,2683,2275,667,394,377,67,14,296,17,10,0,0,10,7,0,0,7,273,273,95,0,178,0,0,0,0,0,0,0,0,0,07458
2097,2327,97,587,904,591,148,146,86,86,35,18,33,0,0,0,0,0,0,0,0,0,60,52,0,31,21,8,8,8,0,0,0,0,0,0,07460
2098,13271,964,4710,4236,2328,1033,1098,606,566,205,14,347,40,31,31,0,0,9,0,0,9,492,467,143,14,310,25,25,5,20,0,0,0,0,0,07461
2099,4528,396,1389,1223,1067,453,308,207,135,42,12,81,72,72,46,0,26,0,0,0,0,101,88,40,0,48,13,13,0,13,0,0,0,0,0,07462
2100,6608,234,1463,1795,1946,1170,518,176,164,65,6,93,12,12,12,0,0,0,0,0,0,342,342,155,6,181,0,0,0,0,0,0,0,0,0,07463
2101,4977,241,1794,1307,1058,577,483,294,258,228,0,30,36,36,0,36,0,0,0,0,0,189,183,43,102,38,6,0,0,0,0,6,0,0,6,07465
2102,37553,2660,9151,6963,11808,6971,3611,1729,1640,523,95,1022,89,89,48,26,15,0,0,0,0,1882,1763,473,144,1146,119,117,74,43,0,2,0,0,2,07470
2103,11910,673,3938,3216,2655,1428,1034,558,511,182,66,263,47,47,22,0,25,0,0,0,0,476,397,104,98,195,79,28,0,13,15,51,51,0,0,07480
2104,11343,355,1579,1998,4538,2873,910,540,526,74,15,437,14,14,0,0,14,0,0,0,0,370,370,61,21,288,0,0,0,0,0,0,0,0,0,07481
2105,0,0,0,0,0,0,0,0,0,0,0,0,0,0,0,0,0,0,0,0,0,0,0,0,0,0,0,0,0,0,0,0,0,0,0,07495
2106,18457,7591,6788,2867,1000,211,1961,919,627,11,31,585,292,190,17,22,151,102,0,0,102,1042,827,113,28,686,215,103,18,44,41,112,14,0,98,07501
2107,9315,2287,3503,2176,884,465,821,417,341,49,11,281,76,49,0,0,49,27,0,0,27,404,291,16,8,267,113,62,14,19,29,51,0,0,51,07502
2108,12144,3110,5457,2193,799,585,1327,739,598,46,50,502,141,126,37,61,28,15,0,15,0,588,560,84,17,459,28,28,0,8,20,0,0,0,0,07503
2109,8189,1987,3144,2020,660,378,783,376,282,47,29,206,94,53,0,0,53,41,19,0,22,407,385,64,13,308,22,0,0,0,0,22,0,0,22,07504
2110,1677,607,591,256,213,10,71,25,6,0,0,6,19,0,0,0,0,19,0,0,19,46,37,0,7,30,9,0,0,0,0,9,0,0,9,07505
2111,13213,1114,4281,3560,2667,1591,821,363,306,48,0,258,57,41,41,0,0,16,0,0,16,458,405,185,0,220,53,28,0,0,28,25,0,0,25,07506
2112,15121,2035,5094,3506,3338,1148,1396,725,652,135,177,340,73,57,24,20,13,16,13,0,3,671,621,265,98,258,50,50,28,0,22,0,0,0,0,07508
2113,7821,1569,2462,1475,1632,683,635,333,318,118,2,198,15,13,0,13,0,2,0,0,2,302,272,126,0,146,30,30,30,0,0,0,0,0,0,07512
2114,8006,2076,3331,1877,497,225,688,261,261,29,13,219,0,0,0,0,0,0,0,0,0,427,319,9,21,289,108,88,41,0,47,20,0,0,20,07513
2115,11455,2368,5445,2484,863,295,923,539,409,60,0,349,130,90,29,13,48,40,0,0,40,384,343,39,0,304,41,33,15,18,0,8,0,0,8,07514
2116,12122,3208,4984,2468,1061,401,1479,673,438,25,22,391,235,144,6,0,138,91,20,0,71,806,671,71,46,554,135,120,8,0,112,15,14,0,1,07522
2117,7405,2290,3077,1505,388,145,692,339,330,22,9,299,9,9,0,0,9,0,0,0,0,353,316,59,13,244,37,13,0,0,13,24,0,0,24,07524
2118,31644,4520,9387,7474,6589,3674,1681,847,680,125,62,493,167,149,11,14,124,18,0,0,18,834,736,139,24,573,98,56,56,0,0,42,0,0,42,07601
2119,5541,385,1945,1539,1022,650,533,256,256,26,0,230,0,0,0,0,0,0,0,0,0,277,210,84,0,126,67,67,50,0,17,0,0,0,0,07603
2120,8666,699,2674,1872,2255,1166,514,209,209,54,16,139,0,0,0,0,0,0,0,0,0,305,262,40,0,222,43,43,0,0,43,0,0,0,0,07604
2121,6344,354,1033,1117,2030,1810,335,245,245,24,9,212,0,0,0,0,0,0,0,0,0,90,90,24,17,49,0,0,0,0,0,0,0,0,0,07605
2122,1706,260,730,292,300,124,101,14,11,0,0,11,3,3,3,0,0,0,0,0,0,87,87,0,0,87,0,0,0,0,0,0,0,0,0,07606
2123,6900,469,1873,1743,1779,1036,492,321,314,112,76,126,7,7,7,0,0,0,0,0,0,171,171,22,18,131,0,0,0,0,0,0,0,0,0,07607
2124,57,11,17,12,17,0,6,0,0,0,0,0,0,0,0,0,0,0,0,0,0,6,6,0,0,6,0,0,0,0,0,0,0,0,0,07608
2125,1395,46,173,193,529,454,91,66,65,13,0,52,1,1,0,0,1,0,0,0,0,25,25,2,0,23,0,0,0,0,0,0,0,0,0,07620
2126,18605,1766,5327,4101,5493,1918,1670,834,724,87,42,595,110,94,24,40,30,16,0,0,16,836,779,235,29,515,57,43,29,0,14,14,0,0,14,07621
2127,5626,279,1117,876,2106,1248,513,197,187,0,31,156,10,10,0,10,0,0,0,0,0,316,308,12,0,296,8,0,0,0,0,8,0,0,8,07624
2128,6052,239,1333,933,2241,1306,298,193,180,0,17,163,13,13,13,0,0,0,0,0,0,105,105,0,4,101,0,0,0,0,0,0,0,0,0,07626
2129,3277,76,348,566,1133,1154,352,187,187,7,0,180,0,0,0,0,0,0,0,0,0,165,165,12,16,137,0,0,0,0,0,0,0,0,0,07627
2130,12350,1156,3708,2742,3301,1443,846,413,380,101,21,258,33,20,6,0,14,13,0,13,0,433,410,36,47,327,23,23,23,0,0,0,0,0,0,07628
2131,5301,300,1319,1218,1764,700,373,139,139,35,0,104,0,0,0,0,0,0,0,0,0,234,234,33,37,164,0,0,0,0,0,0,0,0,0,07630
2132,18904,2242,4481,3574,5209,3398,1228,570,477,31,42,404,93,66,1,0,65,27,0,0,27,658,499,25,36,438,159,149,149,0,0,10,0,0,10,07631
2133,3991,372,684,487,1511,937,121,67,67,8,0,59,0,0,0,0,0,0,0,0,0,54,54,11,0,43,0,0,0,0,0,0,0,0,0,07632
2134,3224,116,557,673,1092,786,203,99,89,10,0,79,10,10,0,0,10,0,0,0,0,104,94,19,12,63,10,10,10,0,0,0,0,0,0,07640
2135,2195,35,280,286,967,627,190,124,124,25,7,92,0,0,0,0,0,0,0,0,0,66,66,16,3,47,0,0,0,0,0,0,0,0,0,07641
2136,6883,404,1362,1506,2361,1250,496,276,262,47,10,205,14,14,9,0,5,0,0,0,0,220,220,9,21,190,0,0,0,0,0,0,0,0,0,07642
2137,7729,1016,2394,1908,1769,642,569,357,311,63,0,248,46,46,11,7,28,0,0,0,0,212,189,0,0,189,23,23,23,0,0,0,0,0,0,07643
2138,16469,2648,5580,4439,2924,878,1209,542,471,66,13,392,71,26,0,18,8,45,0,0,45,667,526,44,52,430,141,72,0,0,72,69,0,13,56,07644
2139,5259,134,1209,855,1859,1202,450,222,222,0,0,222,0,0,0,0,0,0,0,0,0,228,228,65,0,163,0,0,0,0,0,0,0,0,0,07645
2140,11457,937,3440,2661,2930,1489,680,335,315,66,0,249,20,7,6,0,1,13,0,13,0,345,320,54,12,254,25,25,0,0,25,0,0,0,0,07646
2141,3604,384,1253,674,917,376,271,178,142,37,12,93,36,36,36,0,0,0,0,0,0,93,93,0,0,93,0,0,0,0,0,0,0,0,0,07647
2142,4009,330,983,715,1392,589,413,290,206,78,0,128,84,84,0,17,67,0,0,0,0,123,123,19,0,104,0,0,0,0,0,0,0,0,0,07648
2143,5439,315,792,1005,2090,1237,447,205,195,66,13,116,10,10,0,10,0,0,0,0,0,242,242,80,11,151,0,0,0,0,0,0,0,0,0,07649
2144,15160,2623,4478,2317,4470,1272,727,348,279,20,10,249,69,0,0,0,0,69,57,12,0,379,357,87,20,250,22,22,22,0,0,0,0,0,0,07650
2145,19415,1572,4495,4018,5813,3517,1315,650,618,223,31,364,32,17,17,0,0,15,0,13,2,665,657,168,0,489,8,0,0,0,0,8,8,0,0,07652
2146,6004,263,1569,1252,1851,1069,342,154,143,35,36,72,11,11,11,0,0,0,0,0,0,188,167,66,6,95,21,0,0,0,0,21,21,0,0,07656
2147,7620,893,2495,1502,1937,793,870,313,255,52,0,203,58,58,58,0,0,0,0,0,0,557,440,42,0,398,117,117,56,0,61,0,0,0,0,07657
2148,8532,914,2596,2328,1921,773,691,412,295,26,11,258,117,70,70,0,0,47,0,0,47,279,236,95,14,127,43,43,10,0,33,0,0,0,0,07660
2149,7779,354,1755,1397,2511,1762,822,384,384,67,21,296,0,0,0,0,0,0,0,0,0,438,438,63,8,367,0,0,0,0,0,0,0,0,0,07661
2150,4218,493,1442,884,885,514,180,117,117,64,0,53,0,0,0,0,0,0,0,0,0,63,63,33,0,30,0,0,0,0,0,0,0,0,0,07662
2151,9883,858,3301,2747,2109,868,489,284,216,16,15,185,68,68,0,0,68,0,0,0,0,205,205,65,18,122,0,0,0,0,0,0,0,0,0,07663
2152,26227,1649,4874,4833,8426,6445,2507,1271,1136,229,9,898,135,66,66,0,0,69,0,0,69,1236,1186,233,84,869,50,50,0,50,0,0,0,0,0,07666
2153,9421,298,996,1318,3297,3512,1040,618,604,74,0,530,14,0,0,0,0,14,0,0,14,422,422,94,0,328,0,0,0,0,0,0,0,0,0,07670
2154,18373,791,4015,3975,6088,3504,1374,654,625,154,8,463,29,29,12,0,17,0,0,0,0,720,708,165,33,510,12,0,0,0,0,12,12,0,0,07675
2155,6564,421,1317,1587,2038,1201,453,272,235,50,0,185,37,37,22,15,0,0,0,0,0,181,150,34,0,116,31,31,31,0,0,0,0,0,0,07676
2156,3918,128,390,683,1451,1266,366,214,202,44,26,132,12,12,12,0,0,0,0,0,0,152,137,42,0,95,15,15,15,0,0,0,0,0,0,07677
2157,16899,1919,4130,3854,3974,3022,1238,669,536,214,38,284,133,47,47,0,0,86,7,72,7,569,479,253,62,164,90,51,29,22,0,39,15,0,24,07701
2158,2585,105,448,502,945,585,244,108,84,37,0,47,24,12,12,0,0,12,12,0,0,136,117,51,0,66,19,19,0,19,0,0,0,0,0,07702
2159,187,0,28,51,14,94,28,26,0,0,0,0,26,26,26,0,0,0,0,0,0,2,0,0,0,0,2,2,2,0,0,0,0,0,0,07703
2160,3928,69,512,479,1552,1316,282,177,177,80,0,97,0,0,0,0,0,0,0,0,0,105,105,25,0,80,0,0,0,0,0,0,0,0,0,07704
2161,1047,35,180,191,406,235,59,23,23,11,0,12,0,0,0,0,0,0,0,0,0,36,35,16,13,6,1,1,0,0,1,0,0,0,0,07711
2162,26908,3663,7632,6445,5710,3458,1757,759,657,147,87,423,102,102,51,6,45,0,0,0,0,998,899,496,54,349,99,17,0,0,17,82,0,0,82,07712
2163,6072,271,1690,1512,1898,701,392,144,127,25,0,102,17,6,0,6,0,11,0,0,11,248,248,118,0,130,0,0,0,0,0,0,0,0,0,07716
2164,1519,53,211,275,611,369,86,13,0,0,0,0,13,13,0,13,0,0,0,0,0,73,73,14,21,38,0,0,0,0,0,0,0,0,0,07717
2165,4240,248,1288,1359,960,385,280,123,109,41,18,50,14,14,14,0,0,0,0,0,0,157,157,83,0,74,0,0,0,0,0,0,0,0,0,07718
2166,15670,1044,4316,3501,4450,2359,874,428,402,157,37,208,26,26,0,0,26,0,0,0,0,446,440,133,35,272,6,6,6,0,0,0,0,0,0,07719
2167,3207,428,652,867,887,373,133,85,40,40,0,0,45,22,22,0,0,23,23,0,0,48,48,12,0,36,0,0,0,0,0,0,0,0,0,07720
2168,1990,102,518,529,514,327,107,72,72,37,15,20,0,0,0,0,0,0,0,0,0,35,21,6,0,15,14,14,0,0,14,0,0,0,0,07721
2169,6430,175,1077,1538,2198,1442,812,493,457,118,0,339,36,36,34,0,2,0,0,0,0,319,282,17,16,249,37,29,1,0,28,8,8,0,0,07722
2170,832,88,280,200,167,97,56,45,42,12,4,26,3,3,0,0,3,0,0,0,0,11,11,0,0,11,0,0,0,0,0,0,0,0,0,07723
2171,15597,1057,3830,4322,3910,2478,1062,549,536,191,73,272,13,13,3,10,0,0,0,0,0,513,495,166,35,294,18,12,7,0,5,6,6,0,0,07724
2172,28552,1877,6522,7520,8110,4523,2626,1290,1205,382,75,748,85,85,38,0,47,0,0,0,0,1336,1223,427,30,766,113,101,32,3,66,12,0,0,12,07726
2173,4568,335,1189,1269,1120,655,334,219,161,45,3,113,58,58,10,3,45,0,0,0,0,115,71,34,2,35,44,16,16,0,0,28,0,0,28,07727
2174,38551,4071,10067,9414,9244,5755,3297,1812,1568,471,53,1044,244,131,91,28,12,113,18,0,95,1485,1365,315,160,890,120,60,39,0,21,60,0,37,23,07728
2175,12274,1035,4167,3743,2386,943,821,440,399,109,43,247,41,41,41,0,0,0,0,0,0,381,360,147,25,188,21,21,13,8,0,0,0,0,0,07730
2176,24380,2026,6698,7354,5892,2410,2638,1341,1192,425,102,665,149,124,68,29,27,25,9,0,16,1297,1197,540,59,598,100,100,72,10,18,0,0,0,0,07731
2177,4019,120,1125,1029,969,776,65,51,41,0,0,41,10,10,10,0,0,0,0,0,0,14,14,0,14,0,0,0,0,0,0,0,0,0,0,07732
2178,11372,663,2011,2059,3411,3228,1074,663,566,82,49,435,97,97,0,0,97,0,0,0,0,411,388,87,0,301,23,23,23,0,0,0,0,0,0,07733
2179,9305,1240,4029,2503,1059,474,600,229,229,71,13,145,0,0,0,0,0,0,0,0,0,371,271,54,19,198,100,33,0,0,33,67,24,0,43,07734
2180,13803,1505,5472,3825,2146,855,1086,539,462,169,95,198,77,77,16,10,51,0,0,0,0,547,475,154,8,313,72,61,28,33,0,11,11,0,0,07735
2181,2710,107,670,1015,614,304,174,65,58,22,0,36,7,7,7,0,0,0,0,0,0,109,109,71,6,32,0,0,0,0,0,0,0,0,0,07737
2182,4217,184,876,891,1394,872,362,250,237,15,15,207,13,0,0,0,0,13,13,0,0,112,101,37,0,64,11,0,0,0,0,11,11,0,0,07738
2183,3846,28,527,878,1460,953,325,181,169,103,0,66,12,12,0,0,12,0,0,0,0,144,144,41,15,88,0,0,0,0,0,0,0,0,0,07739
2184,20934,3878,7223,4433,3513,1887,1418,679,455,134,75,246,224,90,46,14,30,134,42,0,92,739,527,83,40,404,212,183,69,0,114,29,29,0,0,07740
2185,12921,510,2230,2528,4097,3556,1167,520,463,103,27,333,57,57,7,43,7,0,0,0,0,647,634,98,59,477,13,6,0,6,0,7,0,0,7,07746
2186,21360,1160,4971,6314,5735,3180,1503,716,628,82,102,444,88,88,21,34,33,0,0,0,0,787,731,182,36,513,56,26,26,0,0,30,0,0,30,07747
2187,18843,851,4890,4827,5233,3042,1442,693,693,186,13,494,0,0,0,0,0,0,0,0,0,749,722,227,33,462,27,0,0,0,0,27,0,0,27,07748
2188,2497,35,474,536,973,479,120,89,89,26,23,40,0,0,0,0,0,0,0,0,0,31,31,0,0,31,0,0,0,0,0,0,0,0,0,07750
2189,11843,437,2052,2257,4332,2765,1122,588,588,131,0,457,0,0,0,0,0,0,0,0,0,534,525,77,12,436,9,9,9,0,0,0,0,0,0,07751
2190,26910,2213,8908,8243,5122,2424,1749,945,737,368,68,301,208,160,144,16,0,48,0,0,48,804,721,299,25,397,83,74,62,0,12,9,0,0,9,07753
2191,4199,196,1047,1126,1154,676,349,144,131,46,0,85,13,13,13,0,0,0,0,0,0,205,188,55,0,133,17,7,0,0,7,10,0,0,10,07755
2192,2794,78,735,643,817,521,99,25,11,0,0,11,14,14,0,14,0,0,0,0,0,74,74,29,34,11,0,0,0,0,0,0,0,0,0,07756
2193,3880,215,973,967,962,763,212,120,120,25,0,95,0,0,0,0,0,0,0,0,0,92,92,11,20,61,0,0,0,0,0,0,0,0,0,07757
2194,3666,339,1458,1080,570,219,402,225,190,47,0,143,35,35,0,0,35,0,0,0,0,177,166,78,0,88,11,11,0,11,0,0,0,0,0,07758
2195,5982,58,976,1263,2188,1497,576,286,264,24,0,240,22,10,0,10,0,12,0,0,12,290,259,72,0,187,31,21,9,12,0,10,0,0,10,07760
2196,6446,207,1261,1284,2390,1304,414,240,213,64,9,140,27,20,20,0,0,7,7,0,0,174,142,46,0,96,32,32,32,0,0,0,0,0,0,07762
2197,4883,360,1434,1132,1150,807,1618,637,579,105,95,379,58,58,51,0,7,0,0,0,0,981,969,324,28,617,12,12,12,0,0,0,0,0,0,07764
2198,17436,4069,6212,3947,2385,823,1671,1046,825,204,12,609,221,157,138,17,2,64,0,26,38,625,415,185,4,226,210,184,168,13,3,26,0,0,26,07801
2199,2439,196,608,843,525,267,235,85,85,61,0,24,0,0,0,0,0,0,0,0,0,150,111,2,6,103,39,39,0,0,39,0,0,0,0,07803
2200,0,0,0,0,0,0,0,0,0,0,0,0,0,0,0,0,0,0,0,0,0,0,0,0,0,0,0,0,0,0,0,0,0,0,0,07820
2201,6531,238,2043,1946,1606,698,607,341,329,97,33,199,12,12,12,0,0,0,0,0,0,266,266,64,0,202,0,0,0,0,0,0,0,0,0,07821
2202,588,45,214,110,180,39,63,46,46,17,0,29,0,0,0,0,0,0,0,0,0,17,17,10,0,7,0,0,0,0,0,0,0,0,0,07822
2203,5875,515,2486,1611,870,393,296,136,113,21,0,92,23,23,0,0,23,0,0,0,0,160,129,39,23,67,31,6,0,6,0,25,0,6,19,07823
2204,6745,530,2132,1825,1405,853,495,280,271,105,38,128,9,9,9,0,0,0,0,0,0,215,205,60,3,142,10,10,10,0,0,0,0,0,0,07825
2205,4751,281,1699,1413,938,420,274,128,101,23,9,69,27,27,27,0,0,0,0,0,0,146,137,39,2,96,9,6,0,0,6,3,0,0,3,07826
2206,3102,224,1261,1116,320,181,160,104,96,5,32,59,8,0,0,0,0,8,8,0,0,56,34,7,0,27,22,22,22,0,0,0,0,0,0,07827
2207,9703,521,2800,2766,2467,1149,835,367,356,131,15,210,11,11,11,0,0,0,0,0,0,468,379,37,55,287,89,89,56,0,33,0,0,0,0,07828
2208,4407,71,792,1164,1346,1034,304,161,161,40,5,116,0,0,0,0,0,0,0,0,0,143,139,35,0,104,4,0,0,0,0,4,4,0,0,07830
2209,2611,157,1058,747,418,231,133,81,76,10,8,58,5,5,0,0,5,0,0,0,0,52,47,12,0,35,5,5,0,5,0,0,0,0,0,07832
2210,62,0,14,34,14,0,0,0,0,0,0,0,0,0,0,0,0,0,0,0,0,0,0,0,0,0,0,0,0,0,0,0,0,0,0,07833
2211,12768,335,3198,3125,3813,2297,675,484,467,161,12,294,17,17,17,0,0,0,0,0,0,191,148,24,22,102,43,43,22,0,21,0,0,0,0,07834
2212,8661,231,1806,2187,3012,1425,818,534,503,96,16,391,31,31,23,0,8,0,0,0,0,284,241,126,16,99,43,0,0,0,0,43,0,0,43,07836
2213,2439,267,599,652,690,231,197,118,115,32,0,83,3,3,1,0,2,0,0,0,0,79,79,20,0,59,0,0,0,0,0,0,0,0,0,07838
2214,20371,1818,5154,5342,5398,2659,1675,916,869,214,92,563,47,47,40,7,0,0,0,0,0,759,705,199,80,426,54,43,22,0,21,11,11,0,0,07840
2215,86,0,0,0,16,70,0,0,0,0,0,0,0,0,0,0,0,0,0,0,0,0,0,0,0,0,0,0,0,0,0,0,0,0,0,07842
2216,8733,567,2796,2978,1599,793,692,243,224,40,8,176,19,19,9,10,0,0,0,0,0,449,380,139,26,215,69,69,32,0,37,0,0,0,0,07843
2217,58,14,17,8,7,12,3,3,3,0,0,3,0,0,0,0,0,0,0,0,0,0,0,0,0,0,0,0,0,0,0,0,0,0,0,07846
2218,962,121,339,198,209,95,109,37,30,11,0,19,7,7,7,0,0,0,0,0,0,72,59,52,0,7,13,13,0,0,13,0,0,0,0,07847
2219,3392,332,1229,815,608,408,268,129,122,19,12,91,7,5,0,5,0,2,0,0,2,139,128,40,7,81,11,11,4,7,0,0,0,0,0,07848
2220,6039,286,1688,1810,1682,573,622,397,389,64,10,315,8,8,8,0,0,0,0,0,0,225,225,22,0,203,0,0,0,0,0,0,0,0,0,07849
2221,4726,304,1600,1240,1080,502,533,314,299,31,15,253,15,15,15,0,0,0,0,0,0,219,198,73,0,125,21,21,0,21,0,0,0,0,0,07850
2222,45,3,19,14,9,0,9,9,9,0,0,9,0,0,0,0,0,0,0,0,0,0,0,0,0,0,0,0,0,0,0,0,0,0,0,07851
2223,2612,184,782,556,755,335,212,39,39,15,0,24,0,0,0,0,0,0,0,0,0,173,173,0,0,173,0,0,0,0,0,0,0,0,0,07852
2224,8663,350,1392,1967,3082,1872,668,343,301,48,13,240,42,42,14,0,28,0,0,0,0,325,311,101,17,193,14,0,0,0,0,14,0,14,0,07853
2225,3040,174,988,732,706,440,156,48,48,8,14,26,0,0,0,0,0,0,0,0,0,108,108,0,0,108,0,0,0,0,0,0,0,0,0,07856
2226,2441,263,1206,579,244,149,267,127,114,37,27,50,13,13,13,0,0,0,0,0,0,140,140,13,13,114,0,0,0,0,0,0,0,0,0,07857
2227,18382,1600,5637,5260,3850,2035,1553,879,777,183,27,567,102,93,53,34,6,9,0,0,9,674,617,193,41,383,57,31,31,0,0,26,0,0,26,07860
2228,3151,407,1201,874,432,237,212,148,140,24,17,99,8,5,0,0,5,3,0,0,3,64,57,15,11,31,7,7,0,0,7,0,0,0,0,07863
2229,1425,132,490,305,310,188,137,77,77,24,0,53,0,0,0,0,0,0,0,0,0,60,60,17,8,35,0,0,0,0,0,0,0,0,0,07865
2230,14997,974,3998,3630,4235,2160,1008,487,457,125,40,292,30,30,30,0,0,0,0,0,0,521,481,267,32,182,40,40,29,0,11,0,0,0,0,07866
2231,16875,588,2262,2803,6385,4837,1485,664,636,168,27,441,28,28,24,4,0,0,0,0,0,821,798,261,8,529,23,11,11,0,0,12,0,0,12,07869
2232,0,0,0,0,0,0,0,0,0,0,0,0,0,0,0,0,0,0,0,0,0,0,0,0,0,0,0,0,0,0,0,0,0,0,0,07870
2233,13548,328,2253,3335,4969,2663,1513,832,768,148,57,563,64,53,53,0,0,11,11,0,0,681,671,239,29,403,10,0,0,0,0,10,10,0,0,07871
2234,5815,355,1636,1902,1365,557,535,267,230,13,10,207,37,34,23,0,11,3,0,0,3,268,198,150,18,30,70,19,9,0,10,51,0,0,51,07874
2235,6823,294,1636,1718,1956,1219,843,508,472,197,17,258,36,36,12,0,24,0,0,0,0,335,319,74,33,212,16,0,0,0,0,16,0,0,16,07876
2236,687,0,101,115,362,109,47,47,47,47,0,0,0,0,0,0,0,0,0,0,0,0,0,0,0,0,0,0,0,0,0,0,0,0,0,07878
2237,37,0,0,37,0,0,0,0,0,0,0,0,0,0,0,0,0,0,0,0,0,0,0,0,0,0,0,0,0,0,0,0,0,0,0,07880
2238,6,0,4,2,0,0,0,0,0,0,0,0,0,0,0,0,0,0,0,0,0,0,0,0,0,0,0,0,0,0,0,0,0,0,0,07881
2239,9893,691,3603,2260,2333,1006,807,364,353,116,50,187,11,11,11,0,0,0,0,0,0,443,385,92,0,293,58,58,58,0,0,0,0,0,0,07882
2240,7265,874,2707,1672,1413,599,620,234,168,18,0,150,66,66,57,9,0,0,0,0,0,386,357,78,25,254,29,29,0,0,29,0,0,0,0,07885
2241,15223,832,1828,2370,5291,4902,1232,743,682,157,0,525,61,47,27,20,0,14,14,0,0,489,425,107,20,298,64,18,18,0,0,46,0,0,46,07901
2242,17225,442,1804,2721,6299,5959,1778,1009,956,168,7,781,53,41,41,0,0,12,0,12,0,769,761,176,0,585,8,8,8,0,0,0,0,0,0,07920
2243,6284,200,907,1407,2141,1629,134,50,50,0,11,39,0,0,0,0,0,0,0,0,0,84,77,17,19,41,7,0,0,0,0,7,0,0,7,07921
2244,8339,461,1704,1307,2738,2129,556,302,300,58,15,227,2,0,0,0,0,2,0,0,2,254,220,39,0,181,34,22,22,0,0,12,0,0,12,07922
2245,4957,268,894,598,1434,1763,522,401,375,122,0,253,26,26,26,0,0,0,0,0,0,121,121,12,33,76,0,0,0,0,0,0,0,0,0,07924
2246,97,0,63,0,13,21,0,0,0,0,0,0,0,0,0,0,0,0,0,0,0,0,0,0,0,0,0,0,0,0,0,0,0,0,0,07926
2247,2625,192,611,438,829,555,145,69,58,25,0,33,11,11,11,0,0,0,0,0,0,76,49,0,12,37,27,27,27,0,0,0,0,0,0,07927
2248,12379,368,1289,1484,5016,4222,952,498,478,67,31,380,20,20,0,6,14,0,0,0,0,454,438,46,0,392,16,16,16,0,0,0,0,0,0,07928
2249,5311,103,769,868,2080,1491,562,231,214,40,3,171,17,17,17,0,0,0,0,0,0,331,327,34,15,278,4,0,0,0,0,4,0,0,4,07930
2250,2373,106,316,395,844,712,258,178,173,3,0,170,5,0,0,0,0,5,0,5,0,80,80,8,0,72,0,0,0,0,0,0,0,0,0,07931
2251,7481,176,1327,1458,2207,2313,358,147,146,32,0,114,1,0,0,0,0,1,0,0,1,211,200,77,0,123,11,2,0,0,2,9,0,0,9,07932
2252,2253,360,414,197,728,554,157,138,111,32,0,79,27,27,0,0,27,0,0,0,0,19,19,0,0,19,0,0,0,0,0,0,0,0,0,07933
2253,1062,31,130,133,449,319,71,27,27,10,0,17,0,0,0,0,0,0,0,0,0,44,44,0,0,44,0,0,0,0,0,0,0,0,0,07934
2254,345,0,57,89,82,117,0,0,0,0,0,0,0,0,0,0,0,0,0,0,0,0,0,0,0,0,0,0,0,0,0,0,0,0,0,07935
2255,8061,733,2423,1665,2005,1235,641,315,263,83,7,173,52,52,34,0,18,0,0,0,0,326,326,150,0,176,0,0,0,0,0,0,0,0,0,07936
2256,298,51,174,59,12,2,0,0,0,0,0,0,0,0,0,0,0,0,0,0,0,0,0,0,0,0,0,0,0,0,0,0,0,0,0,07939
2257,10098,634,1549,1385,3281,3249,1589,803,787,103,36,648,16,16,0,0,16,0,0,0,0,786,766,298,37,431,20,16,16,0,0,4,0,0,4,07940
2258,6274,202,728,1059,2253,2032,709,313,300,59,0,241,13,0,0,0,0,13,0,0,13,396,393,67,18,308,3,0,0,0,0,3,0,0,3,07945
2259,2032,53,319,263,790,607,245,167,157,41,4,112,10,0,0,0,0,10,0,0,10,78,69,26,14,29,9,9,9,0,0,0,0,0,0,07946
2260,14517,635,2930,2477,4546,3929,760,379,324,118,26,180,55,37,37,0,0,18,0,0,18,381,365,71,0,294,16,16,0,0,16,0,0,0,0,07950
2261,31729,2396,5581,4974,9716,9062,1779,999,785,294,35,456,214,154,84,0,70,60,0,0,60,780,709,246,26,437,71,26,8,0,18,45,22,23,0,07960
2262,0,0,0,0,0,0,0,0,0,0,0,0,0,0,0,0,0,0,0,0,0,0,0,0,0,0,0,0,0,0,0,0,0,0,0,07961
2263,115,0,0,24,79,12,0,0,0,0,0,0,0,0,0,0,0,0,0,0,0,0,0,0,0,0,0,0,0,0,0,0,0,0,0,07970
2264,8167,457,1320,1594,2689,2107,462,214,173,63,0,110,41,41,0,0,41,0,0,0,0,248,245,19,11,215,3,3,3,0,0,0,0,0,0,07974
2265,410,0,30,93,217,70,0,0,0,0,0,0,0,0,0,0,0,0,0,0,0,0,0,0,0,0,0,0,0,0,0,0,0,0,0,07976
2266,520,113,74,95,132,106,0,0,0,0,0,0,0,0,0,0,0,0,0,0,0,0,0,0,0,0,0,0,0,0,0,0,0,0,0,07977
2267,378,20,17,195,56,90,85,42,42,42,0,0,0,0,0,0,0,0,0,0,0,43,43,23,8,12,0,0,0,0,0,0,0,0,0,07979
2268,1667,101,583,340,413,230,138,87,75,13,0,62,12,12,0,12,0,0,0,0,0,51,51,14,0,37,0,0,0,0,0,0,0,0,0,07980
2269,6430,285,1452,1765,1790,1138,395,183,173,0,0,173,10,10,0,10,0,0,0,0,0,212,167,72,0,95,45,45,45,0,0,0,0,0,0,07981
2270,670,45,162,247,193,23,90,35,35,0,0,35,0,0,0,0,0,0,0,0,0,55,55,19,0,36,0,0,0,0,0,0,0,0,0,08001
2271,15782,1346,4058,3691,3837,2850,1136,542,470,91,113,266,72,66,58,0,8,6,0,0,6,594,585,82,169,334,9,9,9,0,0,0,0,0,0,08002
2272,21168,796,3296,3963,7068,6045,1624,1016,921,243,55,623,95,52,10,42,0,43,0,0,43,608,583,205,37,341,25,25,23,0,2,0,0,0,0,08003
2273,8472,929,3321,2488,1316,418,541,292,292,53,73,166,0,0,0,0,0,0,0,0,0,249,215,82,0,133,34,34,0,0,34,0,0,0,0,08004
2274,16165,1595,6654,4180,2375,1361,1261,667,578,233,121,224,89,68,0,68,0,21,21,0,0,594,577,166,71,340,17,0,0,0,0,17,0,0,17,08005
2275,472,2,132,138,114,86,2,0,0,0,0,0,0,0,0,0,0,0,0,0,0,2,2,0,0,2,0,0,0,0,0,0,0,0,0,08006
2276,4040,352,1361,1514,588,225,215,75,75,36,20,19,0,0,0,0,0,0,0,0,0,140,140,58,15,67,0,0,0,0,0,0,0,0,0,08007
2277,5935,182,1494,1310,1620,1329,162,77,70,12,12,46,7,7,0,6,1,0,0,0,0,85,83,6,5,72,2,0,0,0,0,2,0,2,0,08008
2278,8898,795,3210,2444,1823,626,427,244,223,84,44,95,21,15,0,15,0,6,0,0,6,183,107,62,22,23,76,46,46,0,0,30,0,0,30,08009
2279,8043,1198,3068,2359,910,508,518,296,234,15,72,147,62,38,25,5,8,24,24,0,0,222,202,47,30,125,20,20,10,10,0,0,0,0,0,08010
2280,69,0,52,0,9,8,0,0,0,0,0,0,0,0,0,0,0,0,0,0,0,0,0,0,0,0,0,0,0,0,0,0,0,0,0,08011
2281,26963,2364,8520,9500,4316,2263,2256,1178,970,384,134,452,208,168,62,106,0,40,15,25,0,1078,899,355,204,340,179,179,96,26,57,0,0,0,0,08012
2282,286,58,98,74,16,40,0,0,0,0,0,0,0,0,0,0,0,0,0,0,0,0,0,0,0,0,0,0,0,0,0,0,0,0,0,08014
2283,13486,1990,5693,4210,1093,500,1274,581,458,116,59,283,123,89,30,20,39,34,0,29,5,693,586,62,61,463,107,107,72,23,12,0,0,0,0,08015
2284,21781,2105,7498,6180,4404,1594,1899,982,892,246,212,434,90,81,49,26,6,9,0,0,9,917,839,232,58,549,78,48,17,26,5,30,0,0,30,08016
2285,762,128,326,184,88,36,56,35,31,5,0,26,4,4,4,0,0,0,0,0,0,21,14,0,0,14,7,3,3,0,0,4,4,0,0,08019
2286,1788,140,605,371,465,207,95,17,12,0,0,12,5,5,0,0,5,0,0,0,0,78,78,38,15,25,0,0,0,0,0,0,0,0,0,08020
2287,30269,3681,11068,9024,4585,1911,2111,1096,932,151,149,632,164,120,51,48,21,44,0,11,33,1015,845,368,48,429,170,84,28,17,39,86,0,0,86,08021
2288,6348,345,1760,1433,1978,832,340,237,237,31,15,191,0,0,0,0,0,0,0,0,0,103,88,13,17,58,15,15,0,15,0,0,0,0,0,08022
2289,329,69,110,133,17,0,45,0,0,0,0,0,0,0,0,0,0,0,0,0,0,45,45,22,0,23,0,0,0,0,0,0,0,0,0,08023
2290,1590,124,526,437,316,187,161,85,76,17,0,59,9,9,0,9,0,0,0,0,0,76,65,49,0,16,11,11,11,0,0,0,0,0,0,08026
2291,3621,329,1722,921,534,115,188,105,105,14,0,91,0,0,0,0,0,0,0,0,0,83,83,13,0,70,0,0,0,0,0,0,0,0,0,08027
2292,10680,940,3566,3274,1888,1012,2430,1346,1190,322,68,800,156,138,88,11,39,18,0,18,0,1084,1030,241,39,750,54,54,38,0,16,0,0,0,0,08028
2293,3371,475,1297,1005,376,218,321,100,100,84,0,16,0,0,0,0,0,0,0,0,0,221,221,141,40,40,0,0,0,0,0,0,0,0,0,08029
2294,8925,1526,4219,1947,997,236,499,273,260,53,10,197,13,13,3,10,0,0,0,0,0,226,192,46,21,125,34,13,12,0,1,21,16,0,5,08030
2295,8231,1162,3635,2226,757,451,627,264,225,0,28,197,39,8,0,0,8,31,0,0,31,363,298,173,6,119,65,65,65,0,0,0,0,0,0,08031
2296,11088,282,1389,2250,3936,3231,651,369,369,33,0,336,0,0,0,0,0,0,0,0,0,282,273,21,0,252,9,9,8,0,1,0,0,0,0,08033
2297,12813,619,3147,3028,3776,2243,921,514,513,172,99,242,1,0,0,0,0,1,0,0,1,407,403,225,0,178,4,4,4,0,0,0,0,0,0,08034
2298,5225,355,1132,1079,1690,969,367,211,197,55,10,132,14,14,0,14,0,0,0,0,0,156,156,15,0,141,0,0,0,0,0,0,0,0,0,08035
2299,4113,246,1365,1253,865,384,285,184,184,73,9,102,0,0,0,0,0,0,0,0,0,101,101,34,0,67,0,0,0,0,0,0,0,0,0,08036
2300,17268,2814,6825,4244,2386,999,1104,645,453,78,53,322,192,123,56,33,34,69,63,0,6,459,340,120,61,159,119,72,37,35,0,47,39,6,2,08037
2301,63,15,3,18,19,8,2,2,2,2,0,0,0,0,0,0,0,0,0,0,0,0,0,0,0,0,0,0,0,0,0,0,0,0,0,08038
2302,40,5,6,12,9,8,0,0,0,0,0,0,0,0,0,0,0,0,0,0,0,0,0,0,0,0,0,0,0,0,0,0,0,0,0,08039
2303,841,74,256,217,218,76,48,20,14,0,0,14,6,6,6,0,0,0,0,0,0,28,28,12,5,11,0,0,0,0,0,0,0,0,0,08041
2304,75,7,35,22,11,0,3,0,0,0,0,0,0,0,0,0,0,0,0,0,0,3,0,0,0,0,3,0,0,0,0,3,3,0,0,08042
2305,20980,1506,4491,4790,6068,4125,1281,622,548,95,53,400,74,49,12,26,11,25,5,0,20,659,645,108,55,482,14,14,0,0,14,0,0,0,0,08043
2306,1894,259,595,533,340,167,154,72,72,9,13,50,0,0,0,0,0,0,0,0,0,82,62,22,19,21,20,20,0,0,20,0,0,0,0,08045
2307,21410,2300,7002,7064,3569,1475,1683,869,807,228,62,517,62,62,13,25,24,0,0,0,0,814,654,154,87,413,160,144,77,27,40,16,0,16,0,08046
2308,8340,550,2189,2423,2035,1143,756,379,332,144,15,173,47,47,47,0,0,0,0,0,0,377,366,164,49,153,11,11,6,5,0,0,0,0,0,08048
2309,3974,318,1522,1401,615,118,256,174,162,6,16,140,12,12,0,12,0,0,0,0,0,82,65,34,0,31,17,17,17,0,0,0,0,0,0,08049
2310,17348,1502,6315,4451,3548,1532,1271,707,667,245,128,294,40,40,17,0,23,0,0,0,0,564,564,278,47,239,0,0,0,0,0,0,0,0,0,08050
2311,7514,601,2199,2580,1489,645,511,260,245,67,21,157,15,15,0,0,15,0,0,0,0,251,235,42,58,135,16,0,0,0,0,16,0,0,16,08051
2312,13282,1170,5089,3830,2217,976,838,516,496,185,71,240,20,9,9,0,0,11,0,0,11,322,322,89,55,178,0,0,0,0,0,0,0,0,0,08052
2313,31496,1589,7228,8248,9231,5200,2370,1304,1210,292,87,831,94,57,38,18,1,37,27,0,10,1066,1043,393,100,550,23,23,5,0,18,0,0,0,0,08053
2314,29619,1475,6321,7375,9288,5160,2134,1028,990,311,34,645,38,38,38,0,0,0,0,0,0,1106,1035,378,60,597,71,21,0,21,0,50,0,0,50,08054
2315,18692,711,3450,4345,5956,4230,1270,697,679,176,15,488,18,18,18,0,0,0,0,0,0,573,553,138,54,361,20,20,0,0,20,0,0,0,0,08055
2316,2808,27,720,699,869,493,153,63,63,33,0,30,0,0,0,0,0,0,0,0,0,90,90,31,0,59,0,0,0,0,0,0,0,0,0,08056
2317,13982,646,2566,2690,4132,3948,1300,653,644,143,8,493,9,9,9,0,0,0,0,0,0,647,647,129,15,503,0,0,0,0,0,0,0,0,0,08057
2318,3975,486,1578,1241,438,232,200,120,112,22,13,77,8,0,0,0,0,8,0,8,0,80,65,18,21,26,15,15,0,13,2,0,0,0,0,08059
2319,16441,1228,4883,4939,3663,1728,1145,620,428,55,104,269,192,167,102,0,65,25,0,0,25,525,389,42,47,300,136,136,100,0,36,0,0,0,0,08060
2320,1699,164,339,340,608,248,46,0,0,0,0,0,0,0,0,0,0,0,0,0,0,46,46,24,0,22,0,0,0,0,0,0,0,0,0,08061
2321,10110,691,2310,2590,2651,1868,933,420,401,64,56,281,19,11,0,0,11,8,0,6,2,513,440,104,103,233,73,69,69,0,0,4,0,0,4,08062
2322,2125,219,1002,626,215,63,130,43,35,17,0,18,8,8,0,3,5,0,0,0,0,87,82,6,0,76,5,5,5,0,0,0,0,0,0,08063
2323,171,33,93,31,9,5,0,0,0,0,0,0,0,0,0,0,0,0,0,0,0,0,0,0,0,0,0,0,0,0,0,0,0,0,0,08064
2324,5543,501,1741,1837,1009,455,288,112,101,29,18,54,11,0,0,0,0,11,0,0,11,176,165,51,15,99,11,0,0,0,0,11,0,0,11,08065
2325,5667,794,2724,1361,553,235,484,289,262,97,61,104,27,27,27,0,0,0,0,0,0,195,145,0,0,145,50,50,50,0,0,0,0,0,0,08066
2326,1308,130,475,407,165,131,121,33,33,5,0,28,0,0,0,0,0,0,0,0,0,88,88,17,10,61,0,0,0,0,0,0,0,0,0,08067
2327,4842,587,1844,1493,659,259,502,124,102,33,0,69,22,14,0,5,9,8,0,0,8,378,294,36,19,239,84,12,12,0,0,72,0,0,72,08068
2328,8580,1943,3362,2307,694,274,610,327,248,52,40,156,79,75,38,37,0,4,0,4,0,283,199,43,43,113,84,84,8,76,0,0,0,0,0,08069
2329,9245,950,3656,2697,1457,485,601,371,307,79,33,195,64,64,21,28,15,0,0,0,0,230,203,60,4,139,27,27,27,0,0,0,0,0,0,08070
2330,6917,508,2114,1897,1641,757,490,247,225,71,13,141,22,13,0,13,0,9,0,9,0,243,223,73,0,150,20,20,20,0,0,0,0,0,0,08071
2331,140,17,82,29,12,0,4,0,0,0,0,0,0,0,0,0,0,0,0,0,0,4,4,0,4,0,0,0,0,0,0,0,0,0,0,08072
2332,262,0,92,121,49,0,0,0,0,0,0,0,0,0,0,0,0,0,0,0,0,0,0,0,0,0,0,0,0,0,0,0,0,0,0,08073
2333,10,0,0,10,0,0,0,0,0,0,0,0,0,0,0,0,0,0,0,0,0,0,0,0,0,0,0,0,0,0,0,0,0,0,0,08074
2334,20305,2311,7593,4862,3813,1726,1664,829,719,302,8,409,110,73,51,22,0,37,0,0,37,835,729,265,70,394,106,88,47,41,0,18,0,10,8,08075
2335,13405,712,3906,3474,3492,1821,829,414,391,67,43,281,23,17,8,9,0,6,0,0,6,415,394,106,48,240,21,21,15,6,0,0,0,0,0,08077
2336,5592,709,2219,1708,744,212,358,145,138,33,15,90,7,7,0,0,7,0,0,0,0,213,213,16,25,172,0,0,0,0,0,0,0,0,0,08078
2337,7257,1234,3187,1928,616,292,582,258,209,12,54,143,49,15,4,6,5,34,3,18,13,324,256,39,39,178,68,64,0,34,30,4,0,0,4,08079
2338,24629,1385,8013,7156,6015,2060,2201,1376,1293,288,205,800,83,47,47,0,0,36,0,27,9,825,791,364,63,364,34,33,33,0,0,1,0,0,1,08080
2339,32055,2455,9705,10177,6606,3112,3260,1329,1175,428,169,578,154,111,29,55,27,43,27,0,16,1931,1831,467,182,1182,100,57,57,0,0,43,0,0,43,08081
2340,6666,494,2415,2289,1046,422,458,207,199,91,20,88,8,8,8,0,0,0,0,0,0,251,202,99,36,67,49,20,20,0,0,29,3,0,26,08083
2341,4857,485,1627,1486,904,355,397,198,185,17,22,146,13,13,13,0,0,0,0,0,0,199,154,95,12,47,45,29,29,0,0,16,0,0,16,08084
2342,12242,894,3123,3293,3178,1754,879,527,447,108,50,289,80,66,26,40,0,14,5,0,9,352,322,131,9,182,30,19,10,0,9,11,11,0,0,08085
2343,5474,447,2430,1161,1011,425,295,167,129,42,7,80,38,38,38,0,0,0,0,0,0,128,128,50,13,65,0,0,0,0,0,0,0,0,0,08086
2344,17259,1896,6122,5639,2387,1215,1063,585,476,94,34,348,109,84,34,26,24,25,0,11,14,478,314,162,50,102,164,103,65,26,12,61,0,50,11,08087
2345,17901,1565,6734,4471,3290,1841,1349,629,597,226,22,349,32,32,10,0,22,0,0,0,0,720,712,290,50,372,8,8,0,0,8,0,0,0,0,08088
2346,3302,408,1525,803,384,182,159,97,77,10,16,51,20,16,8,8,0,4,0,4,0,62,57,9,42,6,5,3,3,0,0,2,0,2,0,08089
2347,5976,365,2530,1635,955,491,528,298,276,36,30,210,22,13,0,13,0,9,0,9,0,230,213,93,18,102,17,17,10,0,7,0,0,0,0,08090
2348,3773,497,1482,1054,562,178,274,129,112,31,20,61,17,17,7,10,0,0,0,0,0,145,138,66,14,58,7,7,7,0,0,0,0,0,0,08091
2349,2442,177,1029,654,361,221,189,78,66,10,11,45,12,12,12,0,0,0,0,0,0,111,106,18,3,85,5,5,0,5,0,0,0,0,0,08092
2350,6971,1002,2901,1791,940,337,597,312,266,85,41,140,46,46,46,0,0,0,0,0,0,285,263,70,29,164,22,22,11,7,4,0,0,0,0,08093
2351,26386,3342,9697,7259,4528,1560,2265,1061,923,187,66,670,138,73,24,7,42,65,37,0,28,1204,1119,291,132,696,85,85,64,10,11,0,0,0,0,08094
2352,180,23,90,67,0,0,0,0,0,0,0,0,0,0,0,0,0,0,0,0,0,0,0,0,0,0,0,0,0,0,0,0,0,0,0,08095
2353,24774,2495,8546,6764,4793,2176,1333,834,707,209,81,417,127,107,70,37,0,20,0,0,20,499,472,127,17,328,27,13,13,0,0,14,8,4,2,08096
2354,2363,198,879,745,371,170,174,109,109,7,13,89,0,0,0,0,0,0,0,0,0,65,65,7,0,58,0,0,0,0,0,0,0,0,0,08097
2355,6247,516,2160,1419,1588,564,640,260,210,25,24,161,50,20,0,6,14,30,5,9,16,380,332,51,3,278,48,15,0,6,9,33,28,0,5,08098
2356,4029,1597,1261,902,224,45,728,430,320,62,43,215,110,28,0,27,1,82,0,0,82,298,210,5,35,170,88,15,0,15,0,73,0,7,66,08102
2357,8930,2786,3278,2071,514,281,771,459,300,60,24,216,159,46,0,0,46,113,0,9,104,312,236,77,34,125,76,38,31,0,7,38,0,12,26,08103
2358,12627,4022,4930,2795,796,84,1408,781,453,77,41,335,328,231,168,63,0,97,16,36,45,627,536,29,147,360,91,78,0,57,21,13,0,0,13,08104
2359,17041,5970,6344,3450,975,302,2053,950,691,58,41,592,259,194,77,83,34,65,0,10,55,1103,796,75,168,553,307,208,98,74,36,99,0,5,94,08105
2360,7147,689,2392,2119,1379,568,463,258,199,72,11,116,59,47,3,44,0,12,0,0,12,205,197,93,8,96,8,8,8,0,0,0,0,0,0,08106
2361,9585,1204,3161,2654,1682,884,564,336,287,93,33,161,49,43,31,0,12,6,0,6,0,228,219,80,14,125,9,9,0,0,9,0,0,0,0,08107
2362,13038,849,3027,3529,3814,1819,708,385,355,26,54,275,30,30,20,0,10,0,0,0,0,323,306,55,20,231,17,0,0,0,0,17,0,17,0,08108
2363,15681,2037,5310,4449,2622,1263,1230,656,561,64,26,471,95,48,16,8,24,47,0,13,34,574,461,214,32,215,113,106,56,6,44,7,0,7,0,08109
2364,11958,3113,3913,3328,1242,362,963,589,492,121,123,248,97,97,73,5,19,0,0,0,0,374,339,51,122,166,35,0,0,0,0,35,0,0,35,08110
2365,7346,884,2392,2147,1217,706,422,251,195,94,31,70,56,40,25,15,0,16,0,11,5,171,136,15,0,121,35,35,10,25,0,0,0,0,0,08201
2366,1754,21,388,376,623,346,79,26,26,13,0,13,0,0,0,0,0,0,0,0,0,53,53,13,0,40,0,0,0,0,0,0,0,0,0,08202
2367,7345,523,2120,2311,1695,696,346,116,97,23,0,74,19,0,0,0,0,19,0,0,19,230,130,51,0,79,100,69,56,0,13,31,0,0,31,08203
2368,13209,1217,5066,3272,2365,1289,1009,600,377,179,12,186,223,156,127,0,29,67,16,0,51,409,290,121,13,156,119,68,35,0,33,51,36,0,15,08204
2369,18838,2307,6407,5414,3042,1668,1345,716,705,94,187,424,11,2,2,0,0,9,0,0,9,629,620,166,110,344,9,0,0,0,0,9,0,0,9,08205
2370,12802,1780,4826,3142,2022,1032,801,402,311,69,8,234,91,85,71,0,14,6,0,0,6,399,345,111,62,172,54,54,11,13,30,0,0,0,0,08210
2371,170,3,36,21,65,45,0,0,0,0,0,0,0,0,0,0,0,0,0,0,0,0,0,0,0,0,0,0,0,0,0,0,0,0,0,08212
2372,9197,1338,3487,2365,1335,672,1206,700,610,79,109,422,90,59,34,0,25,31,0,13,18,506,506,136,31,339,0,0,0,0,0,0,0,0,0,08215
2373,72,22,24,26,0,0,0,0,0,0,0,0,0,0,0,0,0,0,0,0,0,0,0,0,0,0,0,0,0,0,0,0,0,0,0,08217
2374,4988,348,1029,1343,1355,913,281,118,93,19,17,57,25,25,12,11,2,0,0,0,0,163,163,45,19,99,0,0,0,0,0,0,0,0,0,08221
2375,2864,158,729,889,684,404,162,83,72,0,24,48,11,11,11,0,0,0,0,0,0,79,71,19,0,52,8,8,0,8,0,0,0,0,0,08223
2376,475,49,262,61,85,18,27,16,9,0,0,9,7,7,7,0,0,0,0,0,0,11,11,0,0,11,0,0,0,0,0,0,0,0,0,08224
2377,5919,508,1809,1726,1241,635,495,242,237,61,24,152,5,4,0,0,4,1,0,0,1,253,231,89,68,74,22,22,22,0,0,0,0,0,0,08225
2378,8915,452,2203,1951,2460,1849,582,203,203,102,0,101,0,0,0,0,0,0,0,0,0,379,345,208,40,97,34,29,29,0,0,5,0,0,5,08226
2379,4015,194,1421,988,1026,386,360,220,196,61,0,135,24,24,15,9,0,0,0,0,0,140,140,62,0,78,0,0,0,0,0,0,0,0,0,08230
2380,12298,3723,4358,2917,1008,292,1128,578,384,118,35,231,194,75,47,6,22,119,76,43,0,550,428,128,86,214,122,98,6,18,74,24,0,0,24,08232
2381,27895,3026,8940,7733,5487,2709,2485,1302,993,266,157,570,309,226,119,107,0,83,38,8,37,1183,1076,255,263,558,107,72,59,13,0,35,34,0,1,08234
2382,45,0,12,0,33,0,1308,467,467,93,42,332,0,0,0,0,0,0,0,0,0,841,841,296,70,475,0,0,0,0,0,0,0,0,0,08240
2383,806,82,249,208,175,92,36,26,22,0,4,18,4,4,0,4,0,0,0,0,0,10,10,2,0,8,0,0,0,0,0,0,0,0,0,08241
2384,2219,445,795,618,282,79,209,162,64,30,0,34,98,98,0,49,49,0,0,0,0,47,12,0,12,0,35,35,0,35,0,0,0,0,0,08242
2385,1601,75,567,423,332,204,11,0,0,0,0,0,0,0,0,0,0,0,0,0,0,11,11,0,0,11,0,0,0,0,0,0,0,0,0,08243
2386,7523,765,2667,2465,1093,533,610,361,293,103,34,156,68,40,25,15,0,28,0,28,0,249,193,55,11,127,56,18,2,0,16,38,0,6,32,08244
2387,137,0,16,98,13,10,0,0,0,0,0,0,0,0,0,0,0,0,0,0,0,0,0,0,0,0,0,0,0,0,0,0,0,0,0,08246
2388,695,26,162,131,234,142,8,3,3,1,0,2,0,0,0,0,0,0,0,0,0,5,5,2,0,3,0,0,0,0,0,0,0,0,0,08247
2389,36,0,0,11,0,25,0,0,0,0,0,0,0,0,0,0,0,0,0,0,0,0,0,0,0,0,0,0,0,0,0,0,0,0,0,08248
2390,7045,1232,3287,1585,671,270,455,316,278,69,5,204,38,38,0,0,38,0,0,0,0,139,108,19,23,66,31,31,31,0,0,0,0,0,0,08251
2391,10446,1299,3824,2857,1792,674,576,313,207,86,11,110,106,55,0,55,0,51,47,4,0,263,102,23,0,79,161,69,69,0,0,92,0,16,76,08260
2392,5550,868,2211,1362,722,387,659,377,279,60,15,204,98,68,33,0,35,30,0,0,30,282,242,76,21,145,40,25,5,20,0,15,0,15,0,08270
2393,31125,8322,12155,6618,2747,1283,2524,1413,1117,193,112,812,296,120,58,24,38,176,9,114,53,1111,1008,168,187,653,103,36,30,6,0,67,12,26,29,08302
2394,1560,565,506,271,172,46,73,9,8,8,0,0,1,1,0,0,1,0,0,0,0,64,64,39,0,25,0,0,0,0,0,0,0,0,0,08310
2395,1530,249,594,446,194,47,114,53,53,10,0,43,0,0,0,0,0,0,0,0,0,61,43,15,7,21,18,12,12,0,0,6,0,6,0,08311
2396,5154,654,2407,1192,675,226,290,120,120,68,2,50,0,0,0,0,0,0,0,0,0,170,170,41,56,73,0,0,0,0,0,0,0,0,0,08312
2397,2578,776,1390,314,84,14,14,14,0,0,0,0,14,4,0,0,4,10,0,0,10,0,0,0,0,0,0,0,0,0,0,0,0,0,0,08314
2398,252,88,89,25,50,0,32,0,0,0,0,0,0,0,0,0,0,0,0,0,0,32,5,0,0,5,27,0,0,0,0,27,0,0,27,08316
2399,1047,103,414,320,141,69,110,58,58,7,0,51,0,0,0,0,0,0,0,0,0,52,52,24,0,28,0,0,0,0,0,0,0,0,0,08317
2400,8697,1041,3152,2483,1485,536,667,403,342,89,24,229,61,34,14,18,2,27,27,0,0,264,231,49,0,182,33,23,7,16,0,10,0,3,7,08318
2401,875,51,350,268,153,53,62,33,29,0,13,16,4,4,4,0,0,0,0,0,0,29,26,0,10,16,3,3,0,3,0,0,0,0,0,08319
2402,0,0,0,0,0,0,0,0,0,0,0,0,0,0,0,0,0,0,0,0,0,0,0,0,0,0,0,0,0,0,0,0,0,0,0,08320
2403,95,14,41,24,16,0,4,0,0,0,0,0,0,0,0,0,0,0,0,0,0,4,4,4,0,0,0,0,0,0,0,0,0,0,0,08321
2404,6925,627,2749,1924,1183,442,389,168,153,18,9,126,15,0,0,0,0,15,0,15,0,221,221,91,49,81,0,0,0,0,0,0,0,0,0,08322
2405,749,79,239,215,114,102,48,25,25,0,9,16,0,0,0,0,0,0,0,0,0,23,23,12,3,8,0,0,0,0,0,0,0,0,0,08323
2406,518,82,263,87,57,29,31,0,0,0,0,0,0,0,0,0,0,0,0,0,0,31,31,0,7,24,0,0,0,0,0,0,0,0,0,08324
2407,976,58,292,439,149,38,37,21,21,0,0,21,0,0,0,0,0,0,0,0,0,16,16,16,0,0,0,0,0,0,0,0,0,0,0,08326
2408,2072,713,953,334,64,8,8,0,0,0,0,0,0,0,0,0,0,0,0,0,0,8,0,0,0,0,8,0,0,0,0,8,0,0,8,08327
2409,1172,231,508,346,81,6,47,37,37,0,0,37,0,0,0,0,0,0,0,0,0,10,10,10,0,0,0,0,0,0,0,0,0,0,0,08328
2410,156,0,9,40,88,19,18,0,0,0,0,0,0,0,0,0,0,0,0,0,0,18,18,0,0,18,0,0,0,0,0,0,0,0,0,08329
2411,19193,2400,6353,5758,3208,1474,1698,713,545,96,79,370,168,118,72,15,31,50,25,0,25,985,789,318,66,405,196,196,110,5,81,0,0,0,0,08330
2412,23930,4384,10107,5919,2565,955,1943,1058,902,128,123,651,156,140,69,55,16,16,16,0,0,885,720,187,162,371,165,135,20,24,91,30,30,0,0,08332
2413,557,20,168,134,148,87,42,20,20,0,0,20,0,0,0,0,0,0,0,0,0,22,22,0,0,22,0,0,0,0,0,0,0,0,0,08340
2414,1490,567,351,432,103,37,149,35,35,8,0,27,0,0,0,0,0,0,0,0,0,114,56,23,0,33,58,16,16,0,0,42,35,0,7,08341
2415,3591,402,1322,878,588,401,183,137,119,26,20,73,18,18,18,0,0,0,0,0,0,46,38,7,8,23,8,8,8,0,0,0,0,0,0,08343
2416,3930,650,1706,1021,329,224,563,218,168,16,11,141,50,50,8,37,5,0,0,0,0,345,299,52,13,234,46,20,12,0,8,26,0,0,26,08344
2417,622,182,265,119,44,12,47,34,25,0,0,25,9,9,9,0,0,0,0,0,0,13,13,0,8,5,0,0,0,0,0,0,0,0,0,08345
2418,726,82,402,207,35,0,150,106,87,0,0,87,19,0,0,0,0,19,0,19,0,44,44,0,44,0,0,0,0,0,0,0,0,0,0,08346
2419,433,64,273,96,0,0,0,0,0,0,0,0,0,0,0,0,0,0,0,0,0,0,0,0,0,0,0,0,0,0,0,0,0,0,0,08348
2420,1663,272,750,503,84,54,142,95,34,0,0,34,61,11,0,11,0,50,0,0,50,47,47,0,8,39,0,0,0,0,0,0,0,0,0,08349
2421,538,67,168,212,91,0,66,49,43,0,0,43,6,6,0,6,0,0,0,0,0,17,7,0,0,7,10,0,0,0,0,10,0,0,10,08350
2422,408,82,208,94,24,0,57,22,22,0,0,22,0,0,0,0,0,0,0,0,0,35,18,0,0,18,17,17,17,0,0,0,0,0,0,08352
2423,408,50,175,93,62,28,52,47,39,7,2,30,8,0,0,0,0,8,0,8,0,5,5,0,0,5,0,0,0,0,0,0,0,0,0,08353
2424,28124,6855,11213,6635,2348,1073,2531,1292,1016,155,134,727,276,145,41,51,53,131,82,0,49,1239,1083,244,96,743,156,117,42,53,22,39,21,8,10,08360
2425,12547,2025,3994,3070,2593,865,875,380,341,151,10,180,39,30,21,2,7,9,0,0,9,495,400,116,89,195,95,32,0,0,32,63,0,0,63,08361
2426,25535,7726,8669,5116,2853,1171,1894,1012,677,100,102,475,335,245,78,36,131,90,29,32,29,882,681,61,162,458,201,187,114,38,35,14,0,12,2,08401
2427,5119,214,1314,1242,1392,957,157,90,83,12,0,71,7,7,0,0,7,0,0,0,0,67,67,26,26,15,0,0,0,0,0,0,0,0,0,08402
2428,951,35,285,214,243,174,20,10,10,0,0,10,0,0,0,0,0,0,0,0,0,10,10,0,1,9,0,0,0,0,0,0,0,0,0,08403
2429,8195,1038,2509,2157,1536,955,407,205,204,24,53,127,1,1,0,1,0,0,0,0,0,202,202,11,11,180,0,0,0,0,0,0,0,0,0,08406
2430,4478,129,1370,914,1310,755,325,132,117,6,2,109,15,15,11,0,4,0,0,0,0,193,190,42,38,110,3,0,0,0,0,3,0,3,0,08501
2431,6939,190,540,766,2578,2865,948,489,489,87,0,402,0,0,0,0,0,0,0,0,0,459,446,38,0,408,13,13,0,0,13,0,0,0,0,08502
2432,12048,696,3476,2939,3255,1682,962,625,587,149,6,432,38,34,8,0,26,4,0,0,4,337,312,78,18,216,25,25,19,0,6,0,0,0,0,08505
2433,3420,151,725,655,1212,677,338,87,87,14,0,73,0,0,0,0,0,0,0,0,0,251,243,101,0,142,8,8,8,0,0,0,0,0,0,08510
2434,644,62,235,156,132,59,101,45,42,33,5,4,3,3,0,0,3,0,0,0,0,56,49,10,1,38,7,7,7,0,0,0,0,0,0,08511
2435,7358,518,1479,1401,2139,1821,452,266,266,61,34,171,0,0,0,0,0,0,0,0,0,186,178,42,0,136,8,8,0,8,0,0,0,0,0,08512
2436,2938,173,851,733,715,466,149,70,60,8,0,52,10,0,0,0,0,10,0,0,10,79,79,10,0,69,0,0,0,0,0,0,0,0,0,08514
2437,4035,424,1065,758,1072,716,478,283,197,41,0,156,86,63,0,0,63,23,0,0,23,195,152,51,11,90,43,16,16,0,0,27,0,0,27,08515
2438,3774,420,1437,1015,724,178,213,132,122,9,25,88,10,0,0,0,0,10,10,0,0,81,71,22,10,39,10,10,0,0,10,0,0,0,0,08518
2439,18889,2002,3978,4613,4878,3418,1133,813,720,162,57,501,93,77,77,0,0,16,0,16,0,320,245,32,18,195,75,24,24,0,0,51,51,0,0,08520
2440,3508,69,731,748,1011,949,180,92,92,43,4,45,0,0,0,0,0,0,0,0,0,88,76,32,5,39,12,12,12,0,0,0,0,0,0,08525
2441,38226,2846,12366,11204,7586,4224,2628,1274,1176,294,101,781,98,77,77,0,0,21,9,0,12,1354,1166,456,99,611,188,142,124,0,18,46,17,0,29,08527
2442,189,17,42,34,24,72,0,0,0,0,0,0,0,0,0,0,0,0,0,0,0,0,0,0,0,0,0,0,0,0,0,0,0,0,0,08528
2443,5897,748,1193,1114,1668,1174,222,139,118,27,0,91,21,13,0,0,13,8,0,0,8,83,72,14,0,58,11,11,11,0,0,0,0,0,0,08530
2444,4391,348,1930,1235,609,269,366,209,173,26,0,147,36,36,36,0,0,0,0,0,0,157,157,69,14,74,0,0,0,0,0,0,0,0,0,08533
2445,9243,281,943,1477,2907,3635,632,326,326,90,5,231,0,0,0,0,0,0,0,0,0,306,306,72,15,219,0,0,0,0,0,0,0,0,0,08534
2446,3637,250,576,815,1146,850,637,329,329,70,51,208,0,0,0,0,0,0,0,0,0,308,281,59,9,213,27,27,27,0,0,0,0,0,0,08535
2447,13426,455,1104,2121,4648,5098,871,437,437,78,7,352,0,0,0,0,0,0,0,0,0,434,434,109,0,325,0,0,0,0,0,0,0,0,0,08536
2448,30215,1017,2586,3210,8938,14464,4207,1948,1926,388,63,1475,22,18,14,0,4,4,0,4,0,2259,2239,735,171,1333,20,20,20,0,0,0,0,0,0,08540
2449,2593,256,122,300,640,1275,580,287,287,39,19,229,0,0,0,0,0,0,0,0,0,293,277,132,14,131,16,16,16,0,0,0,0,0,0,08542
2450,13074,264,788,1686,4532,5804,1093,538,523,97,37,389,15,0,0,0,0,15,0,0,15,555,539,49,60,430,16,0,0,0,0,16,0,0,16,08550
2451,3438,78,870,787,887,816,400,226,210,123,13,74,16,16,10,6,0,0,0,0,0,174,153,57,11,85,21,21,21,0,0,0,0,0,0,08551
2452,409,9,44,91,98,167,16,11,11,8,0,3,0,0,0,0,0,0,0,0,0,5,5,2,0,3,0,0,0,0,0,0,0,0,0,08553
2453,2919,186,1353,726,530,124,190,112,37,16,0,21,75,75,75,0,0,0,0,0,0,78,78,0,24,54,0,0,0,0,0,0,0,0,0,08554
2454,570,13,195,124,151,87,43,35,17,5,0,12,18,0,0,0,0,18,8,0,10,8,6,0,0,6,2,2,2,0,0,0,0,0,0,08555
2455,4253,70,331,636,1406,1810,281,163,163,14,13,136,0,0,0,0,0,0,0,0,0,118,118,39,0,79,0,0,0,0,0,0,0,0,0,08558
2456,3845,193,912,1023,1068,649,302,221,221,70,0,151,0,0,0,0,0,0,0,0,0,81,81,35,0,46,0,0,0,0,0,0,0,0,0,08559
2457,2346,204,414,519,449,760,122,74,74,44,0,30,0,0,0,0,0,0,0,0,0,48,48,30,0,18,0,0,0,0,0,0,0,0,0,08560
2458,0,0,0,0,0,0,0,0,0,0,0,0,0,0,0,0,0,0,0,0,0,0,0,0,0,0,0,0,0,0,0,0,0,0,0,08561
2459,3758,561,1505,1056,413,223,285,141,117,16,0,101,24,17,8,0,9,7,0,7,0,144,123,18,16,89,21,21,0,8,13,0,0,0,0,08562
2460,642,136,280,141,60,25,84,1,1,1,0,0,0,0,0,0,0,0,0,0,0,83,73,1,1,71,10,10,10,0,0,0,0,0,0,08608
2461,9232,3159,3131,2098,635,209,1183,729,511,122,51,338,218,117,104,13,0,101,89,0,12,454,415,37,12,366,39,9,0,0,9,30,0,12,18,08609
2462,20204,3594,7453,5696,2482,979,1530,855,733,151,114,468,122,106,59,37,10,16,0,16,0,675,546,213,73,260,129,70,39,0,31,59,12,0,47,08610
2463,17175,6435,6386,2904,1089,361,1370,688,528,171,72,285,160,148,50,57,41,12,0,0,12,682,539,73,157,309,143,82,19,14,49,61,0,21,40,08611
2464,22396,3789,8070,6255,2590,1692,3695,1696,1627,344,123,1160,69,67,0,42,25,2,0,0,2,1999,1918,398,112,1408,81,61,20,27,14,20,0,20,0,08618
2465,16865,1382,5606,4863,3504,1510,1138,469,460,230,18,212,9,9,9,0,0,0,0,0,0,669,617,311,72,234,52,35,35,0,0,17,0,0,17,08619
2466,8676,584,3341,2556,1578,617,998,672,580,65,10,505,92,91,18,13,60,1,0,0,1,326,326,171,9,146,0,0,0,0,0,0,0,0,0,08620
2467,7615,696,2033,1804,1792,1290,288,150,150,49,0,101,0,0,0,0,0,0,0,0,0,138,138,21,0,117,0,0,0,0,0,0,0,0,0,08628
2468,7778,1393,3104,2065,958,258,758,421,421,59,50,312,0,0,0,0,0,0,0,0,0,337,330,100,35,195,7,7,7,0,0,0,0,0,0,08629
2469,15583,2764,5748,3897,1978,1196,1126,464,374,137,7,230,90,72,0,34,38,18,0,8,10,662,510,172,66,272,152,118,71,33,14,34,18,16,0,08638
2470,5768,708,2172,2010,552,326,135,101,52,14,4,34,49,38,31,0,7,11,0,0,11,34,18,0,5,13,16,16,16,0,0,0,0,0,0,08640
2471,1746,91,384,881,245,145,187,87,17,0,5,12,70,70,58,0,12,0,0,0,0,100,55,0,3,52,45,45,45,0,0,0,0,0,0,08641
2472,21135,1630,3607,5025,6269,4604,2125,1068,1014,233,75,706,54,38,14,24,0,16,16,0,0,1057,1008,298,124,586,49,49,49,0,0,0,0,0,0,08648
2473,13554,869,3869,3606,3374,1836,892,390,372,190,31,151,18,12,12,0,0,6,0,0,6,502,488,281,8,199,14,14,14,0,0,0,0,0,0,08690
2474,10932,562,2065,2412,3584,2309,722,310,293,87,32,174,17,17,17,0,0,0,0,0,0,412,412,93,22,297,0,0,0,0,0,0,0,0,0,08691
2475,43508,7745,13835,11111,6645,4172,3951,1973,1563,184,26,1353,410,145,49,64,32,265,96,33,136,1978,1489,291,20,1178,489,444,339,20,85,45,15,0,30,08701
2476,598,29,189,148,146,86,133,10,10,0,0,10,0,0,0,0,0,0,0,0,0,123,53,14,11,28,70,70,55,0,15,0,0,0,0,08720
2477,14788,1089,6390,4222,2224,863,847,438,427,80,14,333,11,11,0,11,0,0,0,0,0,409,385,137,69,179,24,24,13,10,1,0,0,0,0,08721
2478,7138,567,2799,2133,1177,462,496,231,170,95,17,58,61,51,35,16,0,10,0,10,0,265,265,64,35,166,0,0,0,0,0,0,0,0,0,08722
2479,22463,2097,8592,6689,3576,1509,1423,719,615,194,107,314,104,61,61,0,0,43,7,24,12,704,625,198,17,410,79,59,59,0,0,20,11,0,9,08723
2480,30699,1959,11263,9093,6069,2315,2397,1321,1190,276,91,823,131,110,63,25,22,21,12,0,9,1076,973,461,119,393,103,94,60,0,34,9,9,0,0,08724
2481,3380,97,478,703,1377,725,305,227,217,14,41,162,10,0,0,0,0,10,0,0,10,78,78,15,21,42,0,0,0,0,0,0,0,0,0,08730
2482,13885,1080,5268,4100,2336,1101,1179,672,575,149,61,365,97,97,12,18,67,0,0,0,0,507,483,183,169,131,24,24,24,0,0,0,0,0,0,08731
2483,1160,28,285,315,331,201,91,31,31,14,0,17,0,0,0,0,0,0,0,0,0,60,49,15,10,24,11,3,3,0,0,8,0,8,0,08732
2484,1715,185,706,591,193,40,207,114,97,45,0,52,17,17,17,0,0,0,0,0,0,93,75,18,0,57,18,18,18,0,0,0,0,0,0,08733
2485,5580,232,2482,1355,1141,370,461,211,167,88,0,79,44,44,31,0,13,0,0,0,0,250,250,98,52,100,0,0,0,0,0,0,0,0,0,08734
2486,2877,144,923,724,651,435,48,29,29,10,0,19,0,0,0,0,0,0,0,0,0,19,19,7,0,12,0,0,0,0,0,0,0,0,0,08735
2487,9054,328,1988,2120,2870,1748,782,436,408,139,46,223,28,0,0,0,0,28,0,0,28,346,346,110,0,236,0,0,0,0,0,0,0,0,0,08736
2488,859,12,209,177,285,176,9,4,3,0,0,3,1,0,0,0,0,1,0,0,1,5,4,0,0,4,1,0,0,0,0,1,0,0,1,08738
2489,1370,112,474,461,255,68,142,50,44,0,8,36,6,6,6,0,0,0,0,0,0,92,92,24,3,65,0,0,0,0,0,0,0,0,0,08740
2490,1764,66,549,600,371,178,99,55,44,27,6,11,11,5,5,0,0,6,0,0,6,44,44,4,0,40,0,0,0,0,0,0,0,0,0,08741
2491,16926,906,5078,4274,4280,2388,1489,657,629,284,67,278,28,28,15,13,0,0,0,0,0,832,739,301,56,382,93,93,82,0,11,0,0,0,0,08742
2492,2619,40,481,539,977,582,131,100,100,30,24,46,0,0,0,0,0,0,0,0,0,31,31,0,6,25,0,0,0,0,0,0,0,0,0,08750
2493,3397,656,1491,491,512,247,58,31,31,9,0,22,0,0,0,0,0,0,0,0,0,27,27,0,0,27,0,0,0,0,0,0,0,0,0,08751
2494,1730,138,585,404,409,194,38,17,12,4,0,8,5,5,5,0,0,0,0,0,0,21,18,0,0,18,3,3,0,0,3,0,0,0,0,08752
2495,44430,3971,15377,12194,8932,3956,3531,1980,1710,467,259,984,270,121,32,57,32,149,43,0,106,1551,1458,390,215,853,93,73,37,36,0,20,9,0,11,08753
2496,18508,1956,6252,4734,3759,1807,1234,566,557,194,129,234,9,9,9,0,0,0,0,0,0,668,636,155,64,417,32,17,8,9,0,15,0,0,15,08755
2497,27743,5086,13713,5765,2416,763,1021,535,473,90,63,320,62,62,48,0,14,0,0,0,0,486,413,135,93,185,73,6,0,6,0,67,55,0,12,08757
2498,5979,508,2085,1819,1084,483,241,177,159,25,0,134,18,18,18,0,0,0,0,0,0,64,64,0,14,50,0,0,0,0,0,0,0,0,0,08758
2499,29995,3785,14551,7345,3069,1245,511,267,205,43,13,149,62,62,32,22,8,0,0,0,0,244,223,23,40,160,21,10,10,0,0,11,11,0,0,08759
2500,5141,283,839,1168,1674,1177,486,348,241,2,0,239,107,62,0,0,62,45,0,0,45,138,138,17,0,121,0,0,0,0,0,0,0,0,0,08801
2501,2423,123,643,547,636,474,196,52,43,28,0,15,9,9,0,9,0,0,0,0,0,144,144,61,8,75,0,0,0,0,0,0,0,0,0,08802
2502,1844,69,503,619,452,201,217,62,62,7,35,20,0,0,0,0,0,0,0,0,0,155,103,65,0,38,52,52,0,0,52,0,0,0,0,08804
2503,8600,1584,2981,1849,1425,761,640,359,301,75,10,216,58,58,21,13,24,0,0,0,0,281,238,123,0,115,43,43,9,0,34,0,0,0,0,08805
2504,25905,1323,5308,5044,7590,6640,2122,1169,1058,345,64,649,111,83,64,9,10,28,0,0,28,953,905,301,74,530,48,24,0,0,24,24,24,0,0,08807
2505,28,0,10,12,6,0,0,0,0,0,0,0,0,0,0,0,0,0,0,0,0,0,0,0,0,0,0,0,0,0,0,0,0,0,0,08808
2506,4656,870,1009,912,1116,749,466,320,212,30,0,182,108,73,39,0,34,35,0,0,35,146,111,20,3,88,35,18,0,16,2,17,0,0,17,08809
2507,5503,281,661,975,2392,1194,612,190,190,68,19,103,0,0,0,0,0,0,0,0,0,422,422,101,8,313,0,0,0,0,0,0,0,0,0,08810
2508,9786,801,2808,2204,2565,1408,750,383,383,55,0,328,0,0,0,0,0,0,0,0,0,367,349,173,0,176,18,18,0,0,18,0,0,0,0,08812
2509,31986,1990,6385,6512,10019,7080,2889,1521,1441,363,158,920,80,65,21,37,7,15,0,0,15,1368,1329,356,23,950,39,39,0,39,0,0,0,0,0,08816
2510,31088,2551,7258,6442,9119,5718,2298,1266,1067,152,29,886,199,155,34,18,103,44,7,35,2,1032,906,174,30,702,126,108,39,0,69,18,0,8,10,08817
2511,27679,2311,4048,3871,9010,8439,1766,832,738,61,50,627,94,49,49,0,0,45,0,0,45,934,926,202,28,696,8,0,0,0,0,8,8,0,0,08820
2512,196,40,112,11,33,0,4,4,4,0,0,4,0,0,0,0,0,0,0,0,0,0,0,0,0,0,0,0,0,0,0,0,0,0,0,08821
2513,21052,1347,4624,4948,6000,4133,1594,802,698,178,50,470,104,42,9,29,4,62,6,0,56,792,745,361,38,346,47,31,20,0,11,16,10,0,6,08822
2514,6618,202,879,1355,2489,1693,300,183,149,13,11,125,34,0,0,0,0,34,0,0,34,117,61,0,13,48,56,56,56,0,0,0,0,0,0,08823
2515,8022,390,1597,1742,2540,1753,641,388,332,37,45,250,56,56,8,0,48,0,0,0,0,253,234,99,0,135,19,19,14,5,0,0,0,0,0,08824
2516,3169,214,1160,723,676,396,183,113,81,24,0,57,32,32,3,9,20,0,0,0,0,70,70,15,0,55,0,0,0,0,0,0,0,0,0,08825
2517,4148,247,1229,1108,962,602,305,182,174,93,18,63,8,4,0,0,4,4,0,0,4,123,123,51,0,72,0,0,0,0,0,0,0,0,0,08826
2518,3155,152,660,899,901,543,200,127,102,24,3,75,25,25,8,6,11,0,0,0,0,73,60,32,4,24,13,13,0,9,4,0,0,0,0,08827
2519,1681,104,396,592,364,225,174,78,78,18,6,54,0,0,0,0,0,0,0,0,0,96,93,9,0,84,3,3,0,0,3,0,0,0,0,08828
2520,2577,64,650,724,661,478,167,98,77,11,7,59,21,21,0,10,11,0,0,0,0,69,69,35,5,29,0,0,0,0,0,0,0,0,0,08829
2521,13481,1738,3387,2438,3932,1986,700,337,281,57,0,224,56,56,32,14,10,0,0,0,0,363,288,75,0,213,75,38,38,0,0,37,0,0,37,08830
2522,35173,2827,10635,8155,7960,5596,2039,1208,737,133,38,566,471,470,20,12,438,1,0,0,1,831,823,230,29,564,8,8,8,0,0,0,0,0,0,08831
2523,1538,350,612,301,203,72,169,94,88,0,21,67,6,0,0,0,0,6,0,0,6,75,41,0,24,17,34,34,34,0,0,0,0,0,0,08832
2524,6389,174,1132,1282,2065,1736,450,274,264,37,87,140,10,10,0,10,0,0,0,0,0,176,176,85,8,83,0,0,0,0,0,0,0,0,0,08833
2525,7536,1116,3516,1764,947,193,522,272,175,55,9,111,97,58,31,13,14,39,28,0,11,250,237,53,30,154,13,13,13,0,0,0,0,0,0,08835
2526,2662,50,387,313,917,995,222,165,156,31,15,110,9,9,9,0,0,0,0,0,0,57,49,10,0,39,8,0,0,0,0,8,0,0,8,08836
2527,11906,1269,3227,2461,2941,2008,478,234,232,28,9,195,2,2,0,0,2,0,0,0,0,244,244,56,6,182,0,0,0,0,0,0,0,0,0,08837
2528,11784,577,2345,2505,3580,2777,702,407,390,71,30,289,17,10,0,0,10,7,7,0,0,295,248,86,5,157,47,25,0,18,7,22,0,0,22,08840
2529,26066,1225,5177,5966,8311,5387,2507,1132,1098,326,72,700,34,22,10,12,0,12,0,0,12,1375,1254,430,65,759,121,121,121,0,0,0,0,0,0,08844
2530,9118,647,3253,2492,1979,747,832,488,427,84,21,322,61,51,38,0,13,10,0,10,0,344,292,128,7,157,52,22,12,0,10,30,6,0,24,08846
2531,5805,216,1754,1481,1424,930,515,196,135,38,6,91,61,61,28,19,14,0,0,0,0,319,295,110,4,181,24,24,24,0,0,0,0,0,0,08848
2532,6235,310,1778,1584,1665,898,307,124,100,20,0,80,24,24,24,0,0,0,0,0,0,183,169,89,14,66,14,14,14,0,0,0,0,0,0,08850
2533,11811,873,1928,2285,4066,2659,1007,641,562,116,58,388,79,62,62,0,0,17,0,0,17,366,326,114,17,195,40,40,40,0,0,0,0,0,0,08852
2534,3742,99,832,884,1200,727,390,130,130,74,12,44,0,0,0,0,0,0,0,0,0,260,260,62,0,198,0,0,0,0,0,0,0,0,0,08853
2535,34950,2383,8603,7833,9509,6622,5624,2825,2784,462,59,2263,41,31,0,20,11,10,0,4,6,2799,2696,526,84,2086,103,97,56,0,41,6,6,0,0,08854
2536,28231,2224,7893,8084,6649,3381,1958,922,846,177,55,614,76,71,18,11,42,5,0,0,5,1036,953,257,135,561,83,83,33,32,18,0,0,0,0,08857
2537,170,19,21,46,18,66,0,0,0,0,0,0,0,0,0,0,0,0,0,0,0,0,0,0,0,0,0,0,0,0,0,0,0,0,0,08858
2538,15474,1151,4746,3720,3905,1952,1068,657,620,157,14,449,37,11,0,11,0,26,26,0,0,411,404,143,46,215,7,0,0,0,0,7,0,0,7,08859
2539,33608,10482,11689,6315,3990,1132,3022,1509,1063,138,79,846,446,326,123,9,194,120,17,34,69,1513,1045,238,50,757,468,284,166,0,118,184,15,13,156,08861
2540,8559,1019,2925,2003,1551,1061,484,247,220,75,0,145,27,27,18,9,0,0,0,0,0,237,189,60,17,112,48,48,31,11,6,0,0,0,0,08863
2541,20013,3190,8316,4523,2754,1230,1822,884,798,317,27,454,86,86,58,8,20,0,0,0,0,938,575,225,49,301,363,201,91,110,0,162,10,27,125,08865
2542,3695,183,820,823,1191,678,310,147,147,33,16,98,0,0,0,0,0,0,0,0,0,163,156,67,22,67,7,7,0,7,0,0,0,0,0,08867
2543,4791,407,1604,1255,972,553,318,81,81,15,0,66,0,0,0,0,0,0,0,0,0,237,212,49,0,163,25,25,0,0,25,0,0,0,0,08869
2544,13522,1233,4251,3934,2591,1513,972,607,558,166,0,392,49,22,16,0,6,27,6,0,21,365,278,60,10,208,87,32,25,7,0,55,0,0,55,08872
2545,36740,2860,9304,7747,9755,7074,1816,1090,957,198,83,676,133,110,6,61,43,23,10,13,0,726,659,97,22,540,67,67,12,0,55,0,0,0,0,08873
2546,15802,916,4126,3551,4157,3052,1032,500,468,132,22,314,32,26,12,14,0,6,0,0,6,532,470,133,11,326,62,62,59,0,3,0,0,0,0,08876
2547,16591,1570,5745,4849,3130,1297,1098,709,670,69,21,580,39,18,18,0,0,21,0,12,9,389,350,113,0,237,39,30,12,0,18,9,0,9,0,08879
2548,3262,243,1101,1042,624,252,345,120,120,0,0,120,0,0,0,0,0,0,0,0,0,225,189,60,0,129,36,30,17,0,13,6,0,0,6,08880
2549,10802,1990,3648,2820,1565,779,942,600,517,138,140,239,83,37,37,0,0,46,0,0,46,342,312,115,20,177,30,30,23,7,0,0,0,0,0,08882
2550,5938,531,2566,1480,873,488,303,172,123,9,0,114,49,30,7,14,9,19,0,19,0,131,120,17,9,94,11,11,11,0,0,0,0,0,0,08884
2551,4436,169,1072,1014,1367,814,515,276,251,102,8,141,25,21,21,0,0,4,0,4,0,239,205,108,7,90,34,34,34,0,0,0,0,0,0,08886
2552,762,57,120,263,219,103,71,9,9,0,0,9,0,0,0,0,0,0,0,0,0,62,62,50,0,12,0,0,0,0,0,0,0,0,0,08887
2553,7032,292,1340,1607,2231,1562,519,241,241,55,0,186,0,0,0,0,0,0,0,0,0,278,278,152,22,104,0,0,0,0,0,0,0,0,0,08889
2554,0,0,0,0,0,0,0,0,0,0,0,0,0,0,0,0,0,0,0,0,0,0,0,0,0,0,0,0,0,0,0,0,0,0,0,08890
2555,25037,8901,7524,3710,2953,1949,6556,3141,2677,424,59,2194,464,283,170,50,63,181,82,41,58,3415,3112,533,78,2501,303,186,71,24,91,117,0,20,97,08901
2556,28942,2972,6984,5940,8082,4964,2180,1176,995,261,115,619,181,139,4,45,90,42,0,0,42,1004,923,325,83,515,81,81,0,0,81,0,0,0,0,08902
2557,9454,536,1555,1288,2400,3675,612,312,274,9,0,265,38,11,0,0,11,27,0,27,0,300,292,68,8,216,8,0,0,0,0,8,8,0,0,08904
2558,15876,1291,1331,2251,5960,5043,1240,193,183,25,14,144,10,10,10,0,0,0,0,0,0,1047,969,156,36,777,78,20,20,0,0,58,0,0,58,10001
2559,62471,22528,12540,9125,12969,5309,3223,1464,1342,125,223,994,122,52,35,0,17,70,32,13,25,1759,1501,140,0,1361,258,138,50,0,88,120,12,0,108,10002
2560,41525,1668,2890,4726,17797,14444,6319,2419,2369,126,76,2167,50,17,0,13,4,33,0,12,21,3900,3900,234,10,3656,0,0,0,0,0,0,0,0,0,10003
2561,2087,39,130,281,869,768,38,0,0,0,0,0,0,0,0,0,0,0,0,0,0,38,38,0,0,38,0,0,0,0,0,0,0,0,0,10004
2562,5403,123,52,434,2585,2209,34,25,25,0,0,25,0,0,0,0,0,0,0,0,0,9,8,7,0,1,1,1,0,0,1,0,0,0,0,10005
2563,2002,22,108,241,814,817,0,0,0,0,0,0,0,0,0,0,0,0,0,0,0,0,0,0,0,0,0,0,0,0,0,0,0,0,0,10006
2564,5006,324,332,508,1767,2075,194,101,101,0,0,101,0,0,0,0,0,0,0,0,0,93,93,12,0,81,0,0,0,0,0,0,0,0,0,10007
2565,47733,7791,6451,5998,17247,10246,1833,921,781,11,0,770,140,89,33,37,19,51,11,0,40,912,741,59,12,670,171,130,85,0,45,41,17,0,24,10009
2566,23431,811,2003,3354,9334,7929,1196,461,461,20,0,441,0,0,0,0,0,0,0,0,0,735,735,25,8,702,0,0,0,0,0,0,0,0,0,10010
2567,43189,1979,3003,4923,17389,15895,1405,504,490,29,5,456,14,8,8,0,0,6,0,0,6,901,851,83,17,751,50,50,43,0,7,0,0,0,0,10011
2568,20579,1399,1826,1807,8643,6904,739,293,293,51,15,227,0,0,0,0,0,0,0,0,0,446,386,92,12,282,60,60,3,0,57,0,0,0,0,10012
2569,18751,3592,1994,1602,6284,5279,869,529,503,15,54,434,26,0,0,0,0,26,0,0,26,340,340,40,28,272,0,0,0,0,0,0,0,0,0,10013
2570,26135,435,1639,2654,12361,9046,495,261,221,12,0,209,40,29,0,29,0,11,0,1,10,234,219,40,0,179,15,2,2,0,0,13,0,0,13,10014
2571,39874,1316,2519,4364,17495,14180,1054,387,192,0,0,192,195,176,0,0,176,19,0,0,19,667,667,178,0,489,0,0,0,0,0,0,0,0,0,10016
2572,13376,320,759,1506,5801,4990,72,0,0,0,0,0,0,0,0,0,0,0,0,0,0,72,72,0,0,72,0,0,0,0,0,0,0,0,0,10017
2573,5462,428,476,782,2127,1649,124,35,35,18,0,17,0,0,0,0,0,0,0,0,0,89,61,9,4,48,28,28,0,0,28,0,0,0,0,10018
2574,32937,2562,3072,4199,12128,10976,391,174,105,15,0,90,69,47,47,0,0,22,22,0,0,217,169,25,6,138,48,48,28,0,20,0,0,0,0,10019
2575,0,0,0,0,0,0,0,0,0,0,0,0,0,0,0,0,0,0,0,0,0,0,0,0,0,0,0,0,0,0,0,0,0,0,0,10020
2576,33940,914,2130,3740,12921,14235,469,163,163,21,0,142,0,0,0,0,0,0,0,0,0,306,296,46,0,250,10,10,0,0,10,0,0,0,0,10021
2577,25005,402,1430,2982,10835,9356,495,243,243,0,8,235,0,0,0,0,0,0,0,0,0,252,252,26,0,226,0,0,0,0,0,0,0,0,0,10022
2578,49140,1620,3212,5264,16474,22570,1559,839,763,113,40,610,76,14,14,0,0,62,0,1,61,720,636,38,0,598,84,84,0,6,78,0,0,0,0,10023
2579,46852,2263,3171,5036,15984,20398,1141,621,575,15,0,560,46,14,0,0,14,32,0,0,32,520,452,8,0,444,68,68,68,0,0,0,0,0,0,10024
2580,73169,7218,6565,9625,21443,28318,3778,1583,1439,203,107,1129,144,97,22,0,75,47,32,12,3,2195,2019,282,61,1676,176,118,16,88,14,58,0,0,58,10025
2581,25287,4403,5820,5131,5404,4529,1622,816,551,55,24,472,265,191,55,17,119,74,0,5,69,806,641,46,13,582,165,154,35,0,119,11,0,11,0,10026
2582,39760,7209,8290,6665,7917,9679,5908,2566,2374,212,68,2094,192,93,59,3,31,99,9,8,82,3342,3066,326,47,2693,276,209,28,0,181,67,0,20,47,10027
2583,35363,862,2120,3604,14022,14755,675,361,296,48,37,211,65,45,16,16,13,20,0,20,0,314,306,32,0,274,8,0,0,0,0,8,0,0,8,10028
2584,51167,13479,13618,8701,9045,6324,4814,2442,1856,185,73,1598,586,285,65,64,156,301,83,27,191,2372,2062,295,215,1552,310,98,41,0,57,212,0,27,185,10029
2585,19379,4452,4747,4585,3537,2058,1358,629,523,27,0,496,106,52,36,16,0,54,12,22,20,729,618,72,37,509,111,42,0,13,29,69,0,0,69,10030
2586,40296,11054,8253,8703,7171,5115,2889,1576,1342,332,108,902,234,153,14,25,114,81,17,0,64,1313,1080,280,66,734,233,104,66,8,30,129,48,15,66,10031
2587,41220,14781,7728,7787,7222,3702,3010,1618,1308,319,153,836,310,108,24,32,52,202,26,98,78,1392,1189,134,117,938,203,173,72,77,24,30,0,22,8,10032
2588,40807,12256,7682,7917,7413,5539,3103,1753,1565,164,228,1173,188,84,65,19,0,104,39,21,44,1350,1019,195,104,720,331,121,22,33,66,210,22,0,188,10033
2589,29248,8423,5799,5686,5582,3758,2062,1063,746,49,104,593,317,100,0,61,39,217,111,61,45,999,840,51,59,730,159,123,67,35,21,36,0,24,12,10034
2590,22191,7990,5129,4017,3050,2005,1846,993,802,31,16,755,191,104,38,23,43,87,11,15,61,853,802,62,28,712,51,40,0,0,40,11,0,0,11,10035
2591,19133,1131,2229,3037,7188,5548,394,161,119,7,0,112,42,8,8,0,0,34,14,16,4,233,191,88,0,103,42,25,25,0,0,17,4,0,13,10036
2592,12215,1612,2408,3942,2434,1819,966,471,365,22,0,343,106,54,15,0,39,52,0,0,52,495,437,0,18,419,58,15,0,0,15,43,0,0,43,10037
2593,14254,2470,1549,1745,4873,3617,1174,561,561,121,26,414,0,0,0,0,0,0,0,0,0,613,568,159,67,342,45,35,0,0,35,10,0,0,10,10038
2594,16741,3849,4031,4433,2803,1625,1448,686,493,38,91,364,193,42,0,22,20,151,40,51,60,762,614,90,204,320,148,64,0,13,51,84,16,0,68,10039
2595,31456,9079,5815,5709,6509,4344,2046,1018,867,179,110,578,151,75,36,18,21,76,10,51,15,1028,922,108,99,715,106,76,41,0,35,30,15,0,15,10040
2596,9349,1269,1468,1345,1951,3316,437,150,127,0,0,127,23,0,0,0,0,23,0,0,23,287,225,0,73,152,62,44,44,0,0,18,18,0,0,10044
2597,26998,442,2049,2926,10477,11104,391,182,182,1,0,181,0,0,0,0,0,0,0,0,0,209,209,11,11,187,0,0,0,0,0,0,0,0,0,10065
2598,4309,0,120,433,1896,1860,9,9,9,0,0,9,0,0,0,0,0,0,0,0,0,0,0,0,0,0,0,0,0,0,0,0,0,0,0,10069
2599,20750,469,1227,2336,8893,7825,297,144,116,20,0,96,28,28,14,0,14,0,0,0,0,153,153,18,0,135,0,0,0,0,0,0,0,0,0,10075
2600,0,0,0,0,0,0,0,0,0,0,0,0,0,0,0,0,0,0,0,0,0,0,0,0,0,0,0,0,0,0,0,0,0,0,0,10103
2601,2,0,1,0,0,1,0,0,0,0,0,0,0,0,0,0,0,0,0,0,0,0,0,0,0,0,0,0,0,0,0,0,0,0,0,10110
2602,0,0,0,0,0,0,0,0,0,0,0,0,0,0,0,0,0,0,0,0,0,0,0,0,0,0,0,0,0,0,0,0,0,0,0,10111
2603,0,0,0,0,0,0,0,0,0,0,0,0,0,0,0,0,0,0,0,0,0,0,0,0,0,0,0,0,0,0,0,0,0,0,0,10112
2604,0,0,0,0,0,0,0,0,0,0,0,0,0,0,0,0,0,0,0,0,0,0,0,0,0,0,0,0,0,0,0,0,0,0,0,10115
2605,0,0,0,0,0,0,0,0,0,0,0,0,0,0,0,0,0,0,0,0,0,0,0,0,0,0,0,0,0,0,0,0,0,0,0,10119
2606,47275,2069,3103,5252,18741,18110,1320,555,555,59,0,496,0,0,0,0,0,0,0,0,0,765,762,76,38,648,3,3,3,0,0,0,0,0,0,10128
2607,0,0,0,0,0,0,0,0,0,0,0,0,0,0,0,0,0,0,0,0,0,0,0,0,0,0,0,0,0,0,0,0,0,0,0,10152
2608,0,0,0,0,0,0,0,0,0,0,0,0,0,0,0,0,0,0,0,0,0,0,0,0,0,0,0,0,0,0,0,0,0,0,0,10153
2609,0,0,0,0,0,0,0,0,0,0,0,0,0,0,0,0,0,0,0,0,0,0,0,0,0,0,0,0,0,0,0,0,0,0,0,10154
2610,942,13,16,46,564,303,0,0,0,0,0,0,0,0,0,0,0,0,0,0,0,0,0,0,0,0,0,0,0,0,0,0,0,0,0,10162
2611,0,0,0,0,0,0,0,0,0,0,0,0,0,0,0,0,0,0,0,0,0,0,0,0,0,0,0,0,0,0,0,0,0,0,0,10165
2612,0,0,0,0,0,0,0,0,0,0,0,0,0,0,0,0,0,0,0,0,0,0,0,0,0,0,0,0,0,0,0,0,0,0,0,10167
2613,0,0,0,0,0,0,0,0,0,0,0,0,0,0,0,0,0,0,0,0,0,0,0,0,0,0,0,0,0,0,0,0,0,0,0,10168
2614,0,0,0,0,0,0,0,0,0,0,0,0,0,0,0,0,0,0,0,0,0,0,0,0,0,0,0,0,0,0,0,0,0,0,0,10169
2615,0,0,0,0,0,0,0,0,0,0,0,0,0,0,0,0,0,0,0,0,0,0,0,0,0,0,0,0,0,0,0,0,0,0,0,10170
2616,0,0,0,0,0,0,0,0,0,0,0,0,0,0,0,0,0,0,0,0,0,0,0,0,0,0,0,0,0,0,0,0,0,0,0,10171
2617,0,0,0,0,0,0,0,0,0,0,0,0,0,0,0,0,0,0,0,0,0,0,0,0,0,0,0,0,0,0,0,0,0,0,0,10172
2618,0,0,0,0,0,0,0,0,0,0,0,0,0,0,0,0,0,0,0,0,0,0,0,0,0,0,0,0,0,0,0,0,0,0,0,10173
2619,0,0,0,0,0,0,0,0,0,0,0,0,0,0,0,0,0,0,0,0,0,0,0,0,0,0,0,0,0,0,0,0,0,0,0,10174
2620,0,0,0,0,0,0,0,0,0,0,0,0,0,0,0,0,0,0,0,0,0,0,0,0,0,0,0,0,0,0,0,0,0,0,0,10177
2621,0,0,0,0,0,0,0,0,0,0,0,0,0,0,0,0,0,0,0,0,0,0,0,0,0,0,0,0,0,0,0,0,0,0,0,10199
2622,0,0,0,0,0,0,0,0,0,0,0,0,0,0,0,0,0,0,0,0,0,0,0,0,0,0,0,0,0,0,0,0,0,0,0,10271
2623,0,0,0,0,0,0,0,0,0,0,0,0,0,0,0,0,0,0,0,0,0,0,0,0,0,0,0,0,0,0,0,0,0,0,0,10278
2624,0,0,0,0,0,0,0,0,0,0,0,0,0,0,0,0,0,0,0,0,0,0,0,0,0,0,0,0,0,0,0,0,0,0,0,10279
2625,6690,154,297,926,2818,2495,97,32,32,0,0,32,0,0,0,0,0,0,0,0,0,65,65,0,0,65,0,0,0,0,0,0,0,0,0,10280
2626,4088,74,151,332,1538,1993,61,61,61,0,0,61,0,0,0,0,0,0,0,0,0,0,0,0,0,0,0,0,0,0,0,0,0,0,0,10282
2627,24653,3904,6584,5986,4610,3569,2838,1309,1200,263,27,910,109,53,17,7,29,56,0,0,56,1529,1370,345,96,929,159,103,8,25,70,56,0,0,56,10301
2628,10832,2068,3710,2782,1523,749,852,375,266,40,15,211,109,80,0,37,43,29,23,2,4,477,433,13,9,411,44,44,0,21,23,0,0,0,0,10302
2629,14843,2532,5031,3932,2163,1185,1592,789,724,15,36,673,65,40,7,15,18,25,0,0,25,803,743,48,83,612,60,60,17,0,43,0,0,0,0,10303
2630,27455,5327,8281,6173,4393,3281,2719,1341,1018,84,34,900,323,156,68,0,88,167,0,0,167,1378,1190,195,0,995,188,79,19,20,40,109,52,21,36,10304
2631,29627,4340,8941,6954,5774,3618,1762,798,760,154,41,565,38,24,24,0,0,14,0,0,14,964,812,141,12,659,152,130,16,34,80,22,22,0,0,10305
2632,39339,3798,12671,11228,6965,4677,2931,1461,1383,247,50,1086,78,22,7,9,6,56,0,0,56,1470,1421,233,67,1121,49,49,31,18,0,0,0,0,0,10306
2633,9409,786,2624,2990,1723,1286,872,504,480,65,38,377,24,24,5,19,0,0,0,0,0,368,318,61,9,248,50,6,6,0,0,44,0,0,44,10307
2634,20633,1822,7804,5270,3310,2427,1497,793,652,128,61,463,141,141,82,48,11,0,0,0,0,704,642,124,44,474,62,62,60,0,2,0,0,0,0,10308
2635,22138,1951,7243,6097,4069,2778,1511,794,665,92,32,541,129,60,37,11,12,69,0,0,69,717,674,53,0,621,43,43,35,0,8,0,0,0,0,10309
2636,15478,1828,5073,4312,2295,1970,1977,1058,802,71,26,705,256,162,76,64,22,94,0,24,70,919,777,108,22,647,142,84,57,6,21,58,7,26,25,10310
2637,0,0,0,0,0,0,0,0,0,0,0,0,0,0,0,0,0,0,0,0,0,0,0,0,0,0,0,0,0,0,0,0,0,0,0,10311
2638,42179,3632,14171,11000,8638,4738,2801,1519,1358,239,51,1068,161,123,86,0,37,38,0,0,38,1282,1159,221,74,864,123,123,14,23,86,0,0,0,0,10312
2639,61330,6176,20163,16237,11136,7618,4243,2128,2031,303,87,1641,97,86,41,43,2,11,0,0,11,2115,2016,190,21,1805,99,82,22,29,31,17,6,0,11,10314
2640,28103,10539,7373,6128,2625,1438,3013,1568,1196,123,71,1002,372,235,67,34,134,137,44,0,93,1445,1168,165,36,967,277,116,35,37,44,161,16,19,126,10451
2641,43921,16026,12322,10783,3343,1447,5183,2315,1743,137,114,1492,572,250,114,57,79,322,75,67,180,2868,2283,137,354,1792,585,322,58,121,143,263,39,104,120,10452
2642,46878,16214,13659,11330,3924,1751,5826,3115,2205,138,382,1685,910,320,81,178,61,590,127,196,267,2711,2318,242,456,1620,393,182,53,66,63,211,63,50,98,10453
2643,21352,9534,5826,4028,1456,508,2857,1223,916,43,43,830,307,90,47,27,16,217,126,12,79,1634,1363,183,65,1115,271,162,66,12,84,109,14,19,76,10454
2644,22305,9765,6243,4359,1606,332,2154,1040,813,64,73,676,227,84,39,9,36,143,39,56,48,1114,892,80,25,787,222,81,7,6,68,141,18,4,119,10455
2645,51628,20422,14040,11914,3906,1346,6195,3213,2545,117,116,2312,668,322,33,124,165,346,59,0,287,2982,2480,222,83,2175,502,237,98,26,113,265,36,25,204,10456
2646,39326,15004,10284,9380,3320,1338,5697,2685,2108,201,181,1726,577,308,113,108,87,269,79,14,176,3012,2451,169,142,2140,561,285,20,35,230,276,57,75,144,10457
2647,42967,15664,11985,10255,3304,1759,5696,2736,2156,156,158,1842,580,190,26,40,124,390,151,32,207,2960,2410,326,201,1883,550,108,64,13,31,442,60,68,314,10458
2648,26606,11316,6703,5764,2013,810,3600,1990,1590,86,82,1422,400,125,34,8,83,275,146,55,74,1610,1262,68,24,1170,348,168,46,58,64,180,21,2,157,10459
2649,32311,12984,8857,6885,2784,801,4294,2103,1690,177,237,1276,413,224,72,23,129,189,5,46,138,2191,1745,124,367,1254,446,223,65,69,89,223,19,47,157,10460
2650,36576,7287,10809,9221,5826,3433,2291,1116,1054,163,129,762,62,62,6,17,39,0,0,0,0,1175,1083,229,176,678,92,78,0,0,78,14,7,0,7,10461
2651,51541,12125,13756,13362,8092,4206,3860,2005,1799,294,365,1140,206,107,33,37,37,99,12,61,26,1855,1518,264,224,1030,337,227,39,39,149,110,29,0,81,10462
2652,49236,9713,10008,11605,8772,9138,3008,1578,1300,222,50,1028,278,137,51,62,24,141,33,51,57,1430,1301,245,63,993,129,119,39,6,74,10,10,0,0,10463
2653,3190,230,794,794,576,796,161,65,50,0,0,50,15,15,15,0,0,0,0,0,0,96,96,0,0,96,0,0,0,0,0,0,0,0,0,10464
2654,30403,6012,9415,7710,4603,2663,2780,1479,1310,118,58,1134,169,119,0,19,100,50,11,34,5,1301,1126,218,40,868,175,136,80,54,2,39,0,0,39,10465
2655,44429,9506,13929,11707,6490,2797,4677,2334,1950,186,52,1712,384,168,84,8,76,216,23,24,169,2343,2019,217,49,1753,324,241,86,15,140,83,22,0,61,10466
2656,61430,16703,17462,15922,7825,3518,5961,3480,2655,160,162,2333,825,505,162,201,142,320,135,41,144,2481,2187,378,196,1613,294,247,146,0,101,47,0,19,28,10467
2657,43742,13897,13022,9894,4952,1977,4512,2431,1772,127,437,1208,659,228,125,62,41,431,159,114,158,2081,1548,107,302,1139,533,233,53,0,180,300,34,80,186,10468
2658,46628,9189,12243,13371,7562,4263,4559,2319,1935,241,219,1475,384,192,27,89,76,192,13,158,21,2240,2013,303,369,1341,227,140,90,28,22,87,59,0,28,10469
2659,10379,1683,3215,2619,1656,1206,618,352,312,34,33,245,40,20,16,0,4,20,5,0,15,266,255,45,29,181,11,0,0,0,0,11,11,0,0,10470
2660,15540,1300,2863,2925,4060,4392,1582,815,710,143,14,553,105,98,0,7,91,7,0,1,6,767,732,222,11,499,35,35,35,0,0,0,0,0,0,10471
2661,41331,16175,11756,8651,3630,1119,4057,1879,1631,102,47,1482,248,83,43,10,30,165,33,0,132,2178,1595,64,281,1250,583,301,84,47,170,282,55,28,199,10472
2662,37504,9687,10990,10432,4607,1788,3494,1703,1365,117,47,1201,338,151,31,30,90,187,30,90,67,1791,1598,176,32,1390,193,90,11,0,79,103,6,10,87,10473
2663,7331,2743,1992,1866,574,156,643,346,173,7,27,139,173,43,16,0,27,130,53,10,67,297,219,7,33,179,78,41,7,0,34,37,0,0,37,10474
2664,32076,5191,9243,10045,4834,2763,2110,984,740,125,12,603,244,185,38,19,128,59,0,0,59,1126,893,71,52,770,233,201,118,31,52,32,0,0,32,10475
2665,925,44,220,219,243,199,39,32,32,4,0,28,0,0,0,0,0,0,0,0,0,7,7,0,0,7,0,0,0,0,0,0,0,0,0,10501
2666,3625,260,182,655,1076,1452,405,219,219,50,16,153,0,0,0,0,0,0,0,0,0,186,178,29,0,149,8,8,0,8,0,0,0,0,0,10502
2667,133,0,0,13,26,94,0,0,0,0,0,0,0,0,0,0,0,0,0,0,0,0,0,0,0,0,0,0,0,0,0,0,0,0,0,10503
2668,4842,79,630,673,1756,1704,462,216,175,27,6,142,41,12,0,12,0,29,0,0,29,246,246,31,13,202,0,0,0,0,0,0,0,0,0,10504
2669,367,19,59,66,92,131,9,9,9,0,0,9,0,0,0,0,0,0,0,0,0,0,0,0,0,0,0,0,0,0,0,0,0,0,0,10505
2670,3662,98,369,542,1432,1221,267,145,143,23,11,109,2,0,0,0,0,2,0,0,2,122,122,52,0,70,0,0,0,0,0,0,0,0,0,10506
2671,4887,903,1155,1219,855,755,305,221,182,20,1,161,39,39,0,39,0,0,0,0,0,84,59,12,0,47,25,22,0,11,11,3,0,0,3,10507
2672,13759,1286,3407,3748,3042,2276,1024,635,525,95,48,382,110,67,53,14,0,43,35,0,8,389,321,115,12,194,68,68,42,0,26,0,0,0,0,10509
2673,6551,352,696,739,2017,2747,799,289,282,27,25,230,7,0,0,0,0,7,0,0,7,510,498,214,21,263,12,12,12,0,0,0,0,0,0,10510
2674,1640,103,584,524,289,140,136,53,53,22,3,28,0,0,0,0,0,0,0,0,0,83,70,16,4,50,13,13,0,0,13,0,0,0,0,10511
2675,17223,1285,4870,4975,3343,2750,1518,839,778,207,66,505,61,52,16,0,36,9,0,0,9,679,643,179,84,380,36,27,27,0,0,9,0,9,0,10512
2676,8112,146,304,869,2961,3832,819,547,547,150,0,397,0,0,0,0,0,0,0,0,0,272,254,35,0,219,18,16,16,0,0,2,0,0,2,10514
2677,3751,129,727,984,1147,764,174,132,122,15,2,105,10,10,10,0,0,0,0,0,0,42,42,17,2,23,0,0,0,0,0,0,0,0,0,10516
2678,426,31,126,158,83,28,45,35,26,9,0,17,9,9,0,9,0,0,0,0,0,10,10,10,0,0,0,0,0,0,0,0,0,0,0,10517
2679,875,14,95,119,232,415,127,57,57,57,0,0,0,0,0,0,0,0,0,0,0,70,70,34,0,36,0,0,0,0,0,0,0,0,0,10518
2680,129,0,31,21,32,45,37,0,0,0,0,0,0,0,0,0,0,0,0,0,0,37,37,0,0,37,0,0,0,0,0,0,0,0,0,10519
2681,9748,753,1435,1925,2825,2810,580,295,287,52,30,205,8,8,8,0,0,0,0,0,0,285,251,59,0,192,34,34,34,0,0,0,0,0,0,10520
2682,7032,402,1508,1250,1790,2082,1098,562,465,64,25,376,97,44,0,0,44,53,0,0,53,536,536,166,20,350,0,0,0,0,0,0,0,0,0,10522
2683,5685,813,1405,1388,1333,746,381,260,186,16,18,152,74,50,43,0,7,24,16,0,8,121,121,19,5,97,0,0,0,0,0,0,0,0,0,10523
2684,3325,144,781,713,842,845,134,85,68,30,10,28,17,8,0,0,8,9,0,9,0,49,49,15,0,34,0,0,0,0,0,0,0,0,0,10524
2685,1058,29,45,145,367,472,70,47,47,12,0,35,0,0,0,0,0,0,0,0,0,23,23,0,15,8,0,0,0,0,0,0,0,0,0,10526
2686,718,2,70,129,235,282,116,85,85,32,0,53,0,0,0,0,0,0,0,0,0,31,31,0,0,31,0,0,0,0,0,0,0,0,0,10527
2687,8467,846,1650,1654,2447,1870,709,325,269,15,12,242,56,29,29,0,0,27,0,0,27,384,342,100,0,242,42,42,0,0,42,0,0,0,0,10528
2688,9580,318,1332,1906,2903,3121,320,209,180,59,5,116,29,29,14,0,15,0,0,0,0,111,111,20,10,81,0,0,0,0,0,0,0,0,0,10530
2689,3628,290,968,1030,865,475,213,108,102,20,1,81,6,3,0,0,3,3,0,0,3,105,101,48,23,30,4,4,0,0,4,0,0,0,0,10532
2690,5268,295,680,742,1700,1851,451,213,195,43,47,105,18,0,0,0,0,18,0,0,18,238,238,67,11,160,0,0,0,0,0,0,0,0,0,10533
2691,496,20,84,105,211,76,51,0,0,0,0,0,0,0,0,0,0,0,0,0,0,51,51,0,0,51,0,0,0,0,0,0,0,0,0,10535
2692,7056,392,745,1168,2407,2344,604,399,363,89,29,245,36,13,0,0,13,23,0,0,23,205,193,51,0,142,12,0,0,0,0,12,0,0,12,10536
2693,1404,110,260,421,373,240,76,65,65,0,0,65,0,0,0,0,0,0,0,0,0,11,11,0,0,11,0,0,0,0,0,0,0,0,0,10537
2694,11171,358,871,1191,4240,4511,767,438,438,118,17,303,0,0,0,0,0,0,0,0,0,329,313,31,0,282,16,16,16,0,0,0,0,0,0,10538
2695,18095,1455,4922,4874,3828,3016,1710,767,682,252,136,294,85,77,28,0,49,8,0,8,0,943,894,260,75,559,49,49,16,0,33,0,0,0,0,10541
2696,13896,1631,2779,2175,3317,3994,919,518,467,102,52,313,51,38,24,14,0,13,0,0,13,401,327,25,22,280,74,42,27,0,15,32,32,0,0,10543
2697,107,0,12,18,12,65,8,8,8,8,0,0,0,0,0,0,0,0,0,0,0,0,0,0,0,0,0,0,0,0,0,0,0,0,0,10545
2698,734,84,51,108,204,287,42,8,8,0,0,8,0,0,0,0,0,0,0,0,0,34,8,0,0,8,26,26,17,0,9,0,0,0,0,10546
2699,4886,475,1162,1528,1072,649,418,153,93,64,0,29,60,12,0,0,12,48,0,0,48,265,250,61,58,131,15,15,15,0,0,0,0,0,0,10547
2700,2397,165,527,807,521,377,86,30,30,0,12,18,0,0,0,0,0,0,0,0,0,56,36,18,0,18,20,0,0,0,0,20,0,0,20,10548
2701,10682,1458,1711,2166,2768,2579,805,390,330,80,34,216,60,38,29,0,9,22,0,22,0,415,406,79,39,288,9,9,0,0,9,0,0,0,0,10549
2702,23479,4320,8824,6746,2361,1228,2144,908,709,16,285,408,199,99,64,35,0,100,32,44,24,1236,1070,138,331,601,166,95,54,14,27,71,0,39,32,10550
2703,15266,1725,3434,3524,3602,2981,819,467,390,65,56,269,77,42,10,0,32,35,0,0,35,352,241,74,0,167,111,87,38,0,49,24,24,0,0,10552
2704,6649,795,1840,2250,936,828,865,335,323,0,98,225,12,12,0,12,0,0,0,0,0,530,380,69,151,160,150,150,16,114,20,0,0,0,0,10553
2705,3551,212,689,729,1313,608,225,75,75,0,11,64,0,0,0,0,0,0,0,0,0,150,137,18,0,119,13,13,0,0,13,0,0,0,0,10560
2706,22365,4849,4646,4139,4847,3884,1435,679,571,147,114,310,108,70,0,37,33,38,36,0,2,756,576,180,39,357,180,180,131,14,35,0,0,0,0,10562
2707,16887,3029,4922,4137,2640,2159,936,593,559,166,119,274,34,23,0,23,0,11,11,0,0,343,283,54,103,126,60,60,60,0,0,0,0,0,0,10566
2708,13690,1183,2738,3819,2853,3097,1131,600,592,170,13,409,8,8,0,8,0,0,0,0,0,531,531,192,31,308,0,0,0,0,0,0,0,0,0,10567
2709,7893,305,1020,1491,2743,2334,1133,638,566,91,17,458,72,60,0,0,60,12,0,0,12,495,495,118,20,357,0,0,0,0,0,0,0,0,0,10570
2710,26687,6380,7046,5079,4469,3713,1891,1022,858,209,133,516,164,86,33,13,40,78,51,0,27,869,748,160,102,486,121,42,0,0,42,79,21,17,41,10573
2711,3459,73,345,460,1143,1438,151,35,35,21,0,14,0,0,0,0,0,0,0,0,0,116,109,8,7,94,7,7,7,0,0,0,0,0,0,10576
2712,1829,29,173,292,622,713,2112,746,746,217,32,497,0,0,0,0,0,0,0,0,0,1366,1366,407,157,802,0,0,0,0,0,0,0,0,0,10577
2713,447,66,61,90,154,76,35,18,18,0,0,18,0,0,0,0,0,0,0,0,0,17,17,0,0,17,0,0,0,0,0,0,0,0,0,10578
2714,6343,560,1178,1988,1437,1180,448,255,255,77,0,178,0,0,0,0,0,0,0,0,0,193,165,76,9,80,28,15,15,0,0,13,13,0,0,10579
2715,10941,315,1011,1608,4173,3834,880,476,462,49,23,390,14,0,0,0,0,14,0,0,14,404,392,55,36,301,12,0,0,0,0,12,0,0,12,10580
2716,26031,708,2302,3313,7699,12009,2211,1279,1195,123,17,1055,84,75,41,0,34,9,0,0,9,932,906,113,0,793,26,26,26,0,0,0,0,0,0,10583
2717,1760,14,352,636,464,294,110,49,49,0,0,49,0,0,0,0,0,0,0,0,0,61,61,10,0,51,0,0,0,0,0,0,0,0,0,10588
2718,6954,270,1420,1462,1833,1969,316,185,162,0,14,148,23,0,0,0,0,23,0,0,23,131,131,12,0,119,0,0,0,0,0,0,0,0,0,10589
2719,4555,63,527,885,1713,1367,560,242,188,14,14,160,54,42,0,0,42,12,12,0,0,318,305,85,0,220,13,0,0,0,0,13,13,0,0,10590
2720,16070,2414,3030,2669,3972,3985,1058,459,448,104,0,344,11,2,0,0,2,9,9,0,0,599,555,258,52,245,44,44,9,0,35,0,0,0,0,10591
2721,3183,246,831,807,723,576,366,217,177,66,0,111,40,35,0,9,26,5,0,0,5,149,149,21,41,87,0,0,0,0,0,0,0,0,0,10594
2722,6011,684,1218,1493,1245,1371,414,252,128,49,14,65,124,18,11,0,7,106,0,0,106,162,159,58,0,101,3,0,0,0,0,3,0,0,3,10595
2723,888,194,234,386,65,9,66,29,21,0,21,0,8,8,0,0,8,0,0,0,0,37,37,0,0,37,0,0,0,0,0,0,0,0,0,10596
2724,717,9,6,49,296,357,200,70,70,40,0,30,0,0,0,0,0,0,0,0,0,130,130,58,0,72,0,0,0,0,0,0,0,0,0,10597
2725,19641,1281,4347,4657,5032,4324,1948,769,724,199,43,482,45,45,0,0,45,0,0,0,0,1179,1063,329,19,715,116,116,0,16,100,0,0,0,0,10598
2726,8304,944,1545,1903,1902,2010,253,157,99,28,4,67,58,40,0,0,40,18,0,18,0,96,79,34,13,32,17,17,17,0,0,0,0,0,0,10601
2727,12283,956,2600,2969,2718,3040,1046,422,343,67,10,266,79,79,57,0,22,0,0,0,0,624,540,141,113,286,84,26,26,0,0,58,27,0,31,10603
2728,8447,1206,2355,1861,1800,1225,498,232,225,43,19,163,7,7,0,0,7,0,0,0,0,266,258,84,15,159,8,0,0,0,0,8,0,0,8,10604
2729,12804,944,2147,2275,3334,4104,573,345,330,29,13,288,15,0,0,0,0,15,0,0,15,228,224,34,10,180,4,0,0,0,0,4,0,0,4,10605
2730,11598,2298,3246,1749,2288,2017,660,356,356,37,61,258,0,0,0,0,0,0,0,0,0,304,277,97,14,166,27,0,0,0,0,27,27,0,0,10606
2731,5040,597,880,1110,1226,1227,289,92,84,44,0,40,8,0,0,0,0,8,0,0,8,197,186,44,0,142,11,11,11,0,0,0,0,0,0,10607
2732,39628,9877,11483,9226,5279,3763,3766,2055,1474,214,81,1179,581,408,226,100,82,173,24,46,103,1711,1410,252,82,1076,301,147,46,0,101,154,39,0,115,10701
2733,13415,2828,3915,3202,2087,1383,1278,561,490,49,27,414,71,37,24,13,0,34,15,19,0,717,631,127,61,443,86,47,8,0,39,39,0,12,27,10703
2734,22292,2837,7547,5099,4210,2599,1200,713,545,64,51,430,168,123,45,6,72,45,23,22,0,487,384,91,41,252,103,80,80,0,0,23,22,0,1,10704
2735,25100,5797,7502,6046,3668,2087,2457,1303,1025,116,100,809,278,91,0,62,29,187,35,75,77,1154,1028,69,214,745,126,20,20,0,0,106,44,0,62,10705
2736,6079,167,767,935,1573,2637,320,172,151,26,0,125,21,21,11,10,0,0,0,0,0,148,148,7,0,141,0,0,0,0,0,0,0,0,0,10706
2737,7309,521,1287,1512,2135,1854,587,313,313,54,0,259,0,0,0,0,0,0,0,0,0,274,274,58,47,169,0,0,0,0,0,0,0,0,0,10707
2738,15419,646,2447,2879,4574,4873,1169,552,552,152,12,388,0,0,0,0,0,0,0,0,0,617,617,183,35,399,0,0,0,0,0,0,0,0,0,10708
2739,6404,568,1296,1371,1992,1177,340,191,174,21,0,153,17,17,17,0,0,0,0,0,0,149,149,0,13,136,0,0,0,0,0,0,0,0,0,10709
2740,19601,1845,5308,4885,4008,3555,1021,451,379,80,12,287,72,54,31,5,18,18,0,4,14,570,519,64,29,426,51,50,39,5,6,1,0,0,1,10710
2741,26422,5970,7222,5237,4405,3588,3072,1753,1596,235,88,1273,157,102,54,48,0,55,36,15,4,1319,1214,259,59,896,105,76,47,0,29,29,0,0,29,10801
2742,8052,292,1290,1359,2385,2726,774,350,336,35,45,256,14,14,14,0,0,0,0,0,0,424,420,31,14,375,4,4,0,0,4,0,0,0,0,10803
2743,10043,162,838,1629,2930,4484,882,303,303,28,20,255,0,0,0,0,0,0,0,0,0,579,579,65,34,480,0,0,0,0,0,0,0,0,0,10804
2744,13182,2400,3734,3046,2339,1663,1005,519,447,73,35,339,72,47,23,24,0,25,0,11,14,486,486,97,49,340,0,0,0,0,0,0,0,0,0,10805
2745,16165,1004,3644,3537,4223,3757,1167,707,644,237,53,354,63,56,45,0,11,7,7,0,0,460,454,167,39,248,6,0,0,0,0,6,0,0,6,10901
2746,26,0,0,0,26,0,0,0,0,0,0,0,0,0,0,0,0,0,0,0,0,0,0,0,0,0,0,0,0,0,0,0,0,0,0,10910
2747,0,0,0,0,0,0,0,0,0,0,0,0,0,0,0,0,0,0,0,0,0,0,0,0,0,0,0,0,0,0,0,0,0,0,0,10911
2748,3125,205,526,660,799,935,515,292,259,55,29,175,33,33,14,0,19,0,0,0,0,223,223,61,7,155,0,0,0,0,0,0,0,0,0,10913
2749,109,0,0,53,12,44,0,0,0,0,0,0,0,0,0,0,0,0,0,0,0,0,0,0,0,0,0,0,0,0,0,0,0,0,0,10914
2750,148,36,67,10,35,0,0,0,0,0,0,0,0,0,0,0,0,0,0,0,0,0,0,0,0,0,0,0,0,0,0,0,0,0,0,10915
2751,2846,147,806,897,611,385,308,141,124,29,18,77,17,17,10,7,0,0,0,0,0,167,132,38,17,77,35,27,27,0,0,8,0,0,8,10916
2752,1253,72,378,411,141,251,180,79,30,0,15,15,49,49,0,33,16,0,0,0,0,101,101,0,0,101,0,0,0,0,0,0,0,0,0,10917
2753,8181,366,2090,2956,1553,1216,596,455,400,83,19,298,55,43,35,8,0,12,0,0,12,141,129,40,23,66,12,12,12,0,0,0,0,0,0,10918
2754,908,163,208,315,150,72,125,42,42,0,0,42,0,0,0,0,0,0,0,0,0,83,83,10,0,73,0,0,0,0,0,0,0,0,0,10919
2755,5977,387,1347,1645,1626,972,473,289,260,65,0,195,29,16,16,0,0,13,0,0,13,184,167,100,11,56,17,0,0,0,0,17,0,0,17,10920
2756,2887,242,924,831,555,335,71,50,50,5,17,28,0,0,0,0,0,0,0,0,0,21,21,3,0,18,0,0,0,0,0,0,0,0,0,10921
2757,1014,66,320,292,234,102,41,22,22,22,0,0,0,0,0,0,0,0,0,0,0,19,19,19,0,0,0,0,0,0,0,0,0,0,0,10922
2758,5852,852,1633,1650,1127,590,716,250,203,7,65,131,47,0,0,0,0,47,0,0,47,466,368,107,21,240,98,27,0,0,27,71,44,27,0,10923
2759,9070,807,2334,2853,1832,1244,702,381,310,123,31,156,71,22,16,0,6,49,0,0,49,321,313,131,0,182,8,8,8,0,0,0,0,0,0,10924
2760,3217,159,1090,1239,479,250,149,69,69,37,0,32,0,0,0,0,0,0,0,0,0,80,0,0,0,0,80,47,47,0,0,33,21,0,12,10925
2761,2308,169,509,830,408,392,178,50,37,9,0,28,13,13,0,13,0,0,0,0,0,128,119,82,0,37,9,0,0,0,0,9,9,0,0,10926
2762,7416,2130,2097,1593,961,635,555,262,224,41,12,171,38,8,0,8,0,30,10,0,20,293,282,69,41,172,11,11,11,0,0,0,0,0,0,10927
2763,2952,248,853,971,515,365,191,97,97,20,13,64,0,0,0,0,0,0,0,0,0,94,63,27,6,30,31,31,31,0,0,0,0,0,0,10928
2764,5663,190,1131,1778,1439,1125,774,432,358,191,5,162,74,74,30,12,32,0,0,0,0,342,293,122,5,166,49,49,24,25,0,0,0,0,0,10930
2765,634,61,249,196,97,31,45,26,23,4,9,10,3,3,3,0,0,0,0,0,0,19,19,5,6,8,0,0,0,0,0,0,0,0,0,10931
2766,61,0,0,56,5,0,6,0,0,0,0,0,0,0,0,0,0,0,0,0,0,6,6,0,0,6,0,0,0,0,0,0,0,0,0,10932
2767,488,0,15,325,117,31,40,24,0,0,0,0,24,0,0,0,0,24,0,0,24,16,16,0,0,16,0,0,0,0,0,0,0,0,0,10933
2768,31040,5473,9474,9362,4148,2583,3173,1614,1139,373,138,628,475,319,143,121,55,156,39,53,64,1559,1336,400,118,818,223,99,77,22,0,124,45,41,38,10940
2769,8987,884,2790,2826,1588,899,917,498,369,74,18,277,129,129,122,0,7,0,0,0,0,419,334,54,50,230,85,85,53,9,23,0,0,0,0,10941
2770,23321,3368,6294,6436,4471,2752,2627,1297,1150,276,36,838,147,99,89,10,0,48,38,0,10,1330,1085,159,174,752,245,161,82,9,70,84,19,0,65,10950
2771,18030,2527,6135,3747,2989,2632,2948,1451,1285,90,20,1175,166,96,4,12,80,70,47,7,16,1497,1178,188,61,929,319,274,158,59,57,45,15,0,30,10952
2772,154,0,47,39,22,46,0,0,0,0,0,0,0,0,0,0,0,0,0,0,0,0,0,0,0,0,0,0,0,0,0,0,0,0,0,10953
2773,16905,1860,4071,3711,4200,3063,1286,775,749,174,0,575,26,26,0,0,26,0,0,0,0,511,463,121,81,261,48,37,23,0,14,11,0,0,11,10954
2774,21340,1350,3562,4440,6028,5960,1718,925,834,144,53,637,91,53,0,31,22,38,7,0,31,793,755,201,40,514,38,37,13,0,24,1,0,0,1,10956
2775,2093,228,820,481,377,187,138,101,73,15,0,58,28,21,21,0,0,7,0,0,7,37,37,17,0,20,0,0,0,0,0,0,0,0,0,10958
2776,10743,825,1360,2681,2813,3064,1082,486,483,52,23,408,3,3,3,0,0,0,0,0,0,596,585,159,52,374,11,0,0,0,0,11,0,0,11,10960
2777,4480,573,1031,946,1041,889,301,115,99,23,0,76,16,0,0,0,0,16,0,0,16,186,167,12,3,152,19,0,0,0,0,19,0,0,19,10962
2778,3233,450,1330,900,323,230,189,101,57,19,5,33,44,10,10,0,0,34,0,0,34,88,83,38,0,45,5,0,0,0,0,5,0,2,3,10963
2779,1272,79,354,218,277,344,90,34,34,23,0,11,0,0,0,0,0,0,0,0,0,56,55,34,0,21,1,1,0,0,1,0,0,0,0,10964
2780,9841,609,2147,2679,2393,2013,615,290,246,40,0,206,44,0,0,0,0,44,0,0,44,325,325,34,0,291,0,0,0,0,0,0,0,0,0,10965
2781,1867,94,322,362,633,456,105,16,16,16,0,0,0,0,0,0,0,0,0,0,0,89,82,30,30,22,7,0,0,0,0,7,7,0,0,10968
2782,1153,171,245,405,209,123,80,5,5,0,5,0,0,0,0,0,0,0,0,0,0,75,75,22,16,37,0,0,0,0,0,0,0,0,0,10969
2783,6974,1086,1604,1682,1423,1179,517,330,294,77,43,174,36,0,0,0,0,36,0,0,36,187,150,54,70,26,37,0,0,0,0,37,0,0,37,10970
2784,1772,181,592,570,303,126,273,151,137,29,11,97,14,14,0,14,0,0,0,0,0,122,122,26,27,69,0,0,0,0,0,0,0,0,0,10973
2785,2028,128,432,631,542,295,189,105,105,42,24,39,0,0,0,0,0,0,0,0,0,84,73,26,8,39,11,8,8,0,0,3,3,0,0,10974
2786,210,19,56,101,11,23,0,0,0,0,0,0,0,0,0,0,0,0,0,0,0,0,0,0,0,0,0,0,0,0,0,0,0,0,0,10975
2787,1314,203,303,185,384,239,261,96,86,11,8,67,10,0,0,0,0,10,0,0,10,165,165,20,11,134,0,0,0,0,0,0,0,0,0,10976
2788,32999,7972,8979,8017,5239,2792,4071,2025,1577,255,211,1111,448,221,139,0,82,227,87,16,124,2046,1746,412,304,1030,300,219,141,50,28,81,45,21,15,10977
2789,125,46,0,79,0,0,0,0,0,0,0,0,0,0,0,0,0,0,0,0,0,0,0,0,0,0,0,0,0,0,0,0,0,0,0,10979
2790,9447,1072,2753,2418,2064,1140,696,369,330,56,50,224,39,39,30,0,9,0,0,0,0,327,303,49,51,203,24,24,8,16,0,0,0,0,0,10980
2791,3846,194,789,703,1345,815,214,118,110,28,0,82,8,8,0,0,8,0,0,0,0,96,96,0,0,96,0,0,0,0,0,0,0,0,0,10983
2792,2264,60,587,712,533,372,262,156,147,44,0,103,9,9,0,9,0,0,0,0,0,106,106,12,0,94,0,0,0,0,0,0,0,0,0,10984
2793,13,0,0,6,7,0,0,0,0,0,0,0,0,0,0,0,0,0,0,0,0,0,0,0,0,0,0,0,0,0,0,0,0,0,0,10985
2794,1368,60,279,459,305,265,72,45,31,0,0,31,14,14,0,14,0,0,0,0,0,27,27,0,0,27,0,0,0,0,0,0,0,0,0,10986
2795,2404,78,381,532,814,599,120,48,48,39,0,9,0,0,0,0,0,0,0,0,0,72,69,38,0,31,3,3,3,0,0,0,0,0,0,10987
2796,458,28,235,118,66,11,29,18,18,0,0,18,0,0,0,0,0,0,0,0,0,11,11,11,0,0,0,0,0,0,0,0,0,0,0,10988
2797,7083,580,1458,1488,2025,1532,274,125,122,45,0,77,3,3,0,0,3,0,0,0,0,149,136,25,0,111,13,13,0,0,13,0,0,0,0,10989
2798,13993,890,3241,4359,3358,2145,1314,817,720,265,27,428,97,91,9,16,66,6,0,0,6,497,489,92,25,372,8,0,0,0,0,8,8,0,0,10990
2799,6715,483,2161,2270,1008,793,638,372,264,49,0,215,108,108,85,23,0,0,0,0,0,266,252,54,11,187,14,14,0,14,0,0,0,0,0,10992
2800,2868,677,908,836,267,180,260,135,106,77,29,0,29,29,29,0,0,0,0,0,0,125,51,20,31,0,74,74,0,74,0,0,0,0,0,10993
2801,4760,163,930,886,1285,1496,323,207,179,11,0,168,28,0,0,0,0,28,0,0,28,116,116,24,0,92,0,0,0,0,0,0,0,0,0,10994
2802,1433,35,94,407,422,475,1545,1283,1211,929,11,271,72,72,72,0,0,0,0,0,0,262,257,140,0,117,5,5,0,0,5,0,0,0,0,10996
2803,1879,211,546,433,303,386,204,117,117,18,11,88,0,0,0,0,0,0,0,0,0,87,87,29,0,58,0,0,0,0,0,0,0,0,0,10998
2804,18968,1437,5017,4836,4305,3373,1289,665,642,83,59,500,23,13,0,0,13,10,0,0,10,624,613,212,24,377,11,6,6,0,0,5,0,0,5,11001
2805,29189,3728,7615,9184,5502,3160,2674,1581,1392,301,107,984,189,130,34,85,11,59,15,0,44,1093,1012,263,34,715,81,45,38,7,0,36,0,0,36,11003
2806,10427,1119,2600,2034,2710,1964,649,403,323,29,8,286,80,38,0,38,0,42,0,0,42,246,233,12,18,203,13,13,0,0,13,0,0,0,0,11004
2807,2055,51,258,617,517,612,0,0,0,0,0,0,0,0,0,0,0,0,0,0,0,0,0,0,0,0,0,0,0,0,0,0,0,0,0,11005
2808,16940,2003,5776,4049,3245,1867,1586,809,723,102,84,537,86,86,11,66,9,0,0,0,0,777,768,231,50,487,9,9,9,0,0,0,0,0,0,11010
2809,4358,573,651,505,1212,1417,413,240,227,36,32,159,13,8,0,0,8,5,0,0,5,173,168,22,13,133,5,0,0,0,0,5,5,0,0,11020
2810,13078,770,1798,1960,3905,4645,672,320,306,40,0,266,14,0,0,0,0,14,6,0,8,352,349,39,0,310,3,3,0,0,3,0,0,0,0,11021
2811,6313,521,939,1139,1697,2017,552,298,297,24,0,273,1,1,0,0,1,0,0,0,0,254,186,11,0,175,68,68,68,0,0,0,0,0,0,11023
2812,4679,640,879,792,1306,1062,667,448,434,59,28,347,14,14,0,8,6,0,0,0,0,219,175,27,13,135,44,44,0,7,37,0,0,0,0,11024
2813,11442,474,1287,1505,3809,4367,958,379,370,42,11,317,9,1,0,0,1,8,0,0,8,579,565,96,8,461,14,14,14,0,0,0,0,0,0,11030
2814,28245,2647,6565,6682,7276,5075,2014,1138,1102,150,62,890,36,36,36,0,0,0,0,0,0,876,815,149,61,605,61,42,23,19,0,19,13,0,6,11040
2815,544,100,290,78,62,14,0,0,0,0,0,0,0,0,0,0,0,0,0,0,0,0,0,0,0,0,0,0,0,0,0,0,0,0,0,11042
2816,20801,1646,3039,3659,6329,6128,1469,911,859,41,67,751,52,52,38,0,14,0,0,0,0,558,496,73,22,401,62,62,24,31,7,0,0,0,0,11050
2817,5105,1276,1718,1481,442,188,669,346,252,21,14,217,94,72,11,43,18,22,13,9,0,323,314,57,35,222,9,9,9,0,0,0,0,0,0,11096
2818,17642,3654,3783,3768,4216,2221,1170,687,548,44,113,391,139,53,41,12,0,86,0,0,86,483,395,43,40,312,88,88,56,32,0,0,0,0,0,11101
2819,24941,4591,5564,4479,7048,3259,1443,725,568,86,93,389,157,98,42,21,35,59,0,52,7,718,545,32,38,475,173,123,34,26,63,50,38,0,12,11102
2820,29141,5026,6176,5856,8218,3865,960,484,404,34,5,365,80,58,20,0,38,22,22,0,0,476,441,76,30,335,35,35,0,7,28,0,0,0,0,11103
2821,20038,2487,5048,4281,5455,2767,697,348,324,16,24,284,24,24,13,0,11,0,0,0,0,349,342,49,36,257,7,7,0,0,7,0,0,0,0,11104
2822,27940,4409,5788,5769,7918,4056,1133,710,643,86,37,520,67,43,9,18,16,24,0,0,24,423,358,48,46,264,65,55,21,0,34,10,0,10,0,11105
2823,28222,5386,6169,5607,6588,4472,1432,823,728,46,127,555,95,46,7,0,39,49,10,17,22,609,500,61,26,413,109,84,53,24,7,25,0,0,25,11106
2824,3028,0,138,366,1162,1362,59,59,59,0,0,59,0,0,0,0,0,0,0,0,0,0,0,0,0,0,0,0,0,0,0,0,0,0,0,11109
2825,41579,3223,4481,4998,13641,15236,2047,896,748,142,47,559,148,121,23,70,28,27,0,0,27,1151,1084,163,108,813,67,47,32,15,0,20,0,5,15,11201
2826,53894,8062,19117,15824,7207,3684,4288,2130,1830,197,183,1450,300,238,40,62,136,62,0,10,52,2158,1954,168,111,1675,204,168,31,64,73,36,21,0,15,11203
2827,51894,14365,16112,9232,7703,4482,4369,2392,2050,101,52,1897,342,187,117,18,52,155,106,5,44,1977,1752,220,94,1438,225,193,70,32,91,32,0,0,32,11204
2828,25124,5028,5539,4515,5527,4515,2290,1218,1097,105,16,976,121,33,15,0,18,88,0,25,63,1072,987,133,35,819,85,34,0,6,28,51,0,13,38,11205
2829,47816,16548,12470,9749,6606,2443,4904,2607,2235,240,141,1854,372,149,0,101,48,223,24,45,154,2297,1798,203,55,1540,499,239,101,9,129,260,62,81,117,11206
2830,54070,15998,17905,13095,4889,2183,6470,3462,2925,359,245,2321,537,341,71,105,165,196,100,9,87,3008,2398,214,233,1951,610,331,117,49,165,279,39,36,204,11207
2831,54000,12927,24509,11057,4013,1494,6555,3135,2514,61,34,2419,621,384,139,89,156,237,45,60,132,3420,2793,106,117,2570,627,534,10,36,488,93,19,8,66,11208
2832,52815,7069,12154,10426,13525,9641,2952,1410,1248,180,134,934,162,73,56,0,17,89,28,37,24,1542,1450,225,10,1215,92,59,7,1,51,33,0,0,33,11209
2833,41447,4485,14099,9342,8754,4767,4148,2152,1805,126,59,1620,347,207,26,0,181,140,44,41,55,1996,1721,175,82,1464,275,199,67,34,98,76,43,0,33,11210
2834,59787,12352,12401,10709,16046,8279,4036,2180,1983,74,72,1837,197,50,22,7,21,147,15,0,132,1856,1477,136,69,1272,379,255,145,11,99,124,0,0,124,11211
2835,51370,12849,19662,13603,3862,1394,5940,2606,2177,63,92,2022,429,255,23,42,190,174,27,29,118,3334,2739,120,196,2423,595,375,123,30,222,220,0,77,143,11212
2836,38603,8186,12744,9957,4884,2832,3563,1741,1484,101,72,1311,257,147,43,23,81,110,5,22,83,1822,1586,135,83,1368,236,152,56,8,88,84,10,10,64,11213
2837,60581,17148,19514,10237,9383,4299,3365,1569,1450,94,100,1256,119,89,30,18,41,30,0,18,12,1796,1676,165,35,1476,120,102,17,61,24,18,0,0,18,11214
2838,50747,4216,4791,6541,17589,17610,2004,902,722,94,43,585,180,121,17,54,50,59,33,14,12,1102,1047,179,173,695,55,47,26,0,21,8,0,0,8,11215
2839,38649,6821,9595,8804,8288,5141,2470,1393,1162,121,112,929,231,153,8,42,103,78,0,11,67,1077,853,123,36,694,224,174,48,21,105,50,0,0,50,11216
2840,29767,3925,3457,3997,9616,8772,867,359,257,18,28,211,102,74,12,38,24,28,24,0,4,508,459,82,107,270,49,8,0,8,0,41,0,0,41,11217
2841,47497,9455,10364,8773,10676,8229,3785,2128,1765,142,103,1520,363,154,47,0,107,209,112,19,78,1657,1332,177,61,1094,325,282,90,9,183,43,6,0,37,11218
2842,53758,18537,18030,8277,6076,2838,5364,2853,2663,106,49,2508,190,80,29,9,42,110,14,4,92,2511,2073,172,71,1830,438,286,83,75,128,152,63,8,81,11219
2843,67323,32991,13736,8140,8531,3925,5027,2364,1958,116,82,1760,406,102,21,18,63,304,138,15,151,2663,2329,230,189,1910,334,164,39,26,99,170,64,0,106,11220
2844,51576,15938,14319,11618,6670,3031,4861,2496,1974,127,223,1624,522,298,63,97,138,224,18,85,121,2365,2114,167,171,1776,251,165,26,43,96,86,0,52,34,11221
2845,27500,2672,5076,5914,8604,5234,803,421,375,31,18,326,46,45,36,0,9,1,0,0,1,382,306,40,5,261,76,29,0,29,0,47,16,0,31,11222
2846,52146,12096,17995,9448,8283,4324,3261,1586,1446,116,162,1168,140,127,51,48,28,13,0,0,13,1675,1542,109,77,1356,133,118,81,3,34,15,0,0,15,11223
2847,31114,6883,9112,6048,5979,3092,2264,1280,1141,113,114,914,139,41,0,0,41,98,0,7,91,984,804,43,14,747,180,101,48,14,39,79,31,48,0,11224
2848,38782,6558,11220,9947,7022,4035,2757,1383,1144,57,220,867,239,193,114,0,79,46,0,5,41,1374,1150,180,154,816,224,176,76,40,60,48,7,4,37,11225
2849,65117,13164,21817,15882,9473,4781,5278,2684,2022,168,145,1709,662,355,59,104,192,307,61,24,222,2594,2063,158,121,1784,531,395,56,76,263,136,0,19,117,11226
2850,31512,6802,9816,5959,5229,3706,2147,898,861,118,30,713,37,23,13,0,10,14,5,0,9,1249,1192,195,87,910,57,39,27,0,12,18,0,0,18,11228
2851,56793,8868,16716,11176,12888,7145,3962,2024,1797,115,93,1589,227,194,41,41,112,33,0,7,26,1938,1817,308,79,1430,121,94,26,0,68,27,10,8,9,11229
2852,53674,8382,13365,11911,12040,7976,4490,2253,1828,142,46,1640,425,261,63,8,190,164,9,42,113,2237,2032,204,15,1813,205,168,62,27,79,37,16,0,21,11230
2853,25090,3401,3714,3229,8317,6429,1154,675,636,115,102,419,39,15,0,15,0,24,0,0,24,479,387,58,15,314,92,51,0,51,0,41,41,0,0,11231
2854,19088,6836,4375,3474,2497,1906,1524,729,545,94,26,425,184,87,57,0,30,97,74,0,23,795,671,102,61,508,124,82,0,29,53,42,16,0,26,11232
2855,43322,10109,13964,10897,5752,2600,4003,2097,1699,112,196,1391,398,270,122,12,136,128,26,31,71,1906,1547,150,172,1225,359,242,63,17,162,117,0,14,103,11233
2856,62933,7084,18402,17679,12168,7600,4882,2603,2329,267,43,2019,274,181,120,18,43,93,18,10,65,2279,2011,239,92,1680,268,131,61,27,43,137,12,38,87,11234
2857,56088,5791,14075,12396,15946,7880,2623,1416,1288,43,25,1220,128,64,28,4,32,64,21,0,43,1207,1091,135,0,956,116,90,0,0,90,26,0,0,26,11235
2858,64221,9871,19202,19186,10335,5627,6130,3266,2829,193,202,2434,437,403,132,63,208,34,0,0,34,2864,2456,221,152,2083,408,242,66,25,151,166,17,0,149,11236
2859,33282,16983,6142,4313,4133,1711,3548,1811,1304,38,165,1101,507,181,49,59,73,326,239,19,68,1737,1432,130,42,1260,305,65,30,0,35,240,20,28,192,11237
2860,38537,3888,5581,7497,11922,9649,1366,616,492,15,126,351,124,76,14,24,38,48,0,0,48,750,579,108,109,362,171,41,0,23,18,130,15,39,76,11238
2861,9103,1799,2934,2395,1059,916,598,433,394,17,38,339,39,19,0,0,19,20,0,0,20,165,121,0,0,121,44,19,0,0,19,25,0,0,25,11239
2862,0,0,0,0,0,0,0,0,0,0,0,0,0,0,0,0,0,0,0,0,0,0,0,0,0,0,0,0,0,0,0,0,0,0,0,11351
2863,43785,9116,13148,9460,8562,3499,2001,1148,1060,153,33,874,88,68,20,0,48,20,0,0,20,853,815,61,27,727,38,38,10,8,20,0,0,0,0,11354
2864,61043,16976,15993,11791,10785,5498,3660,1734,1616,81,56,1479,118,52,10,20,22,66,0,0,66,1926,1747,88,61,1598,179,99,64,18,17,80,6,19,55,11355
2865,15829,3206,5140,3639,2851,993,1131,535,411,87,22,302,124,97,78,10,9,27,0,0,27,596,438,122,64,252,158,65,0,30,35,93,52,33,8,11356
2866,29815,4010,8624,7137,6441,3603,1726,932,910,195,77,638,22,9,9,0,0,13,13,0,0,794,764,174,99,491,30,10,0,10,0,20,12,0,8,11357
2867,28423,4623,7059,6290,6640,3811,1579,711,614,75,74,465,97,45,10,14,21,52,25,0,27,868,827,85,34,708,41,30,4,0,26,11,0,0,11,11358
2868,0,0,0,0,0,0,0,0,0,0,0,0,0,0,0,0,0,0,0,0,0,0,0,0,0,0,0,0,0,0,0,0,0,0,0,11359
2869,15394,1027,3487,3534,3837,3509,718,425,425,88,37,300,0,0,0,0,0,0,0,0,0,293,293,76,11,206,0,0,0,0,0,0,0,0,0,11360
2870,22085,2619,5277,4986,5572,3631,1368,607,534,51,72,411,73,72,36,26,10,1,0,0,1,761,729,186,15,528,32,26,20,0,6,6,0,0,6,11361
2871,13656,1252,2497,2706,4245,2956,673,295,209,29,0,180,86,86,25,0,61,0,0,0,0,378,353,25,0,328,25,25,0,25,0,0,0,0,0,11362
2872,5039,318,902,1117,1669,1033,360,145,136,35,19,82,9,9,0,0,9,0,0,0,0,215,204,100,8,96,11,11,0,11,0,0,0,0,0,11363
2873,25598,2694,5761,5783,6760,4600,1420,756,746,111,33,602,10,0,0,0,0,10,10,0,0,664,661,53,0,608,3,2,2,0,0,1,1,0,0,11364
2874,29922,4309,6979,8106,6317,4211,1474,695,689,50,23,616,6,6,0,0,6,0,0,0,0,779,635,53,27,555,144,120,0,0,120,24,0,0,24,11365
2875,9182,1174,1816,2044,2559,1589,681,365,365,29,63,273,0,0,0,0,0,0,0,0,0,316,316,74,79,163,0,0,0,0,0,0,0,0,0,11366
2876,26536,3530,6078,5718,6542,4668,1824,802,748,69,30,649,54,44,0,36,8,10,0,10,0,1022,869,86,107,676,153,146,57,46,43,7,0,0,7,11367
2877,69211,27547,20795,12674,5984,2211,5332,2810,2026,383,94,1549,784,390,90,137,163,394,209,32,153,2522,2033,157,141,1735,489,222,113,5,104,267,70,15,182,11368
2878,26578,6793,9732,5627,2971,1455,2208,1142,978,234,30,714,164,134,46,12,76,30,30,0,0,1066,855,89,49,717,211,175,99,0,76,36,17,0,19,11369
2879,25302,7924,7946,4517,3134,1781,2873,1984,494,78,0,416,1490,303,80,31,192,1187,78,34,1075,889,791,58,56,677,98,50,23,0,27,48,0,24,24,11370
2880,0,0,0,0,0,0,0,0,0,0,0,0,0,0,0,0,0,0,0,0,0,0,0,0,0,0,0,0,0,0,0,0,0,0,0,11371
2881,46342,11466,11554,9792,8866,4664,2427,1130,851,147,65,639,279,91,52,14,25,188,74,25,89,1297,1184,210,15,959,113,0,0,0,0,113,0,0,113,11372
2882,70389,21259,17110,13956,13030,5034,4172,2236,2044,123,83,1838,192,137,56,46,35,55,52,0,3,1936,1709,118,94,1497,227,147,36,14,97,80,0,0,80,11373
2883,32639,3052,6401,7358,9881,5947,1168,615,611,20,35,556,4,4,4,0,0,0,0,0,0,553,493,29,16,448,60,21,0,0,21,39,0,0,39,11374
2884,53956,4023,9282,10408,16115,14128,2127,1012,850,70,50,730,162,74,12,17,45,88,0,27,61,1115,1046,205,49,792,69,69,11,0,58,0,0,0,0,11375
2885,62123,15563,15075,13646,12553,5286,3664,1787,1577,121,89,1367,210,86,39,16,31,124,101,4,19,1877,1724,279,166,1279,153,79,51,0,28,74,15,23,36,11377
2886,23223,4102,8122,5828,3557,1614,1144,606,559,25,56,478,47,25,6,0,19,22,11,0,11,538,503,81,38,384,35,35,5,16,14,0,0,0,0,11378
2887,26971,4271,8463,6055,5138,3044,1508,658,574,103,27,444,84,79,56,23,0,5,4,0,1,850,712,34,10,668,138,125,24,14,87,13,13,0,0,11379
2888,66132,14883,22988,15339,8740,4182,5092,2560,2045,167,73,1805,515,327,68,50,209,188,82,41,65,2532,2008,255,67,1686,524,376,152,11,213,148,43,12,93,11385
2889,13630,1397,4068,3977,2660,1528,1239,617,592,100,42,450,25,14,0,3,11,11,6,0,5,622,550,47,33,470,72,67,33,0,34,5,5,0,0,11411
2890,24936,3295,7503,8775,3745,1618,2338,1009,907,88,173,646,102,102,52,44,6,0,0,0,0,1329,1159,181,168,810,170,129,32,87,10,41,0,7,34,11412
2891,27244,3869,7506,8806,4540,2523,2182,1195,964,82,73,809,231,181,106,52,23,50,33,0,17,987,837,89,97,651,150,97,17,24,56,53,21,0,32,11413
2892,21227,3654,7315,4933,3504,1821,1038,525,379,71,42,266,146,72,44,16,12,74,0,16,58,513,512,134,12,366,1,1,0,0,1,0,0,0,0,11414
2893,14182,1516,2558,3580,3561,2967,685,373,300,0,0,300,73,45,0,0,45,28,28,0,0,312,250,58,30,162,62,34,0,21,13,28,18,0,10,11415
2894,16289,4279,4666,3779,2421,1144,1786,864,740,91,72,577,124,81,47,23,11,43,16,7,20,922,823,159,61,603,99,49,24,11,14,50,0,14,36,11416
2895,20259,4268,6954,4805,2804,1428,1552,818,749,125,46,578,69,55,0,13,42,14,0,14,0,734,707,59,100,548,27,5,0,0,5,22,0,0,22,11417
2896,24122,5770,7012,5116,3895,2329,1877,966,873,13,158,702,93,85,50,7,28,8,0,7,1,911,881,132,26,723,30,21,13,0,8,9,9,0,0,11418
2897,32627,8671,12765,5362,4428,1401,2864,1465,1358,129,86,1143,107,107,73,9,25,0,0,0,0,1399,1224,142,37,1045,175,68,41,9,18,107,4,0,103,11419
2898,31943,7122,11527,7336,4420,1538,2790,1456,1218,197,124,897,238,163,10,54,99,75,29,11,35,1334,1149,183,13,953,185,121,75,7,39,64,13,23,28,11420
2899,27457,6493,8367,6761,4059,1777,2431,1438,1172,156,23,993,266,167,123,23,21,99,52,0,47,993,817,122,79,616,176,135,41,29,65,41,7,11,23,11421
2900,21452,2239,5565,7206,4464,1978,1847,950,912,102,26,784,38,38,9,26,3,0,0,0,0,897,745,128,16,601,152,152,54,4,94,0,0,0,0,11422
2901,21759,4711,5943,5401,3753,1951,1957,910,792,116,142,534,118,108,36,55,17,10,0,10,0,1047,1038,114,60,864,9,0,0,0,0,9,0,0,9,11423
2902,0,0,0,0,0,0,0,0,0,0,0,0,0,0,0,0,0,0,0,0,0,0,0,0,0,0,0,0,0,0,0,0,0,0,0,11424
2903,0,0,0,0,0,0,0,0,0,0,0,0,0,0,0,0,0,0,0,0,0,0,0,0,0,0,0,0,0,0,0,0,0,0,0,11425
2904,13623,1458,3646,3423,3104,1992,1041,549,539,131,36,372,10,0,0,0,0,10,0,0,10,492,455,153,25,277,37,37,0,0,37,0,0,0,0,11426
2905,17447,2479,4582,4345,4196,1845,1143,622,613,146,9,458,9,0,0,0,0,9,0,0,9,521,521,69,44,408,0,0,0,0,0,0,0,0,0,11427
2906,14069,2710,4430,3587,2415,927,1065,510,497,28,57,412,13,13,0,0,13,0,0,0,0,555,496,73,57,366,59,47,0,0,47,12,0,0,12,11428
2907,19359,3121,6210,6157,2584,1287,1849,1031,976,125,115,736,55,34,0,18,16,21,0,20,1,818,731,110,73,548,87,28,27,0,1,59,0,24,35,11429
2908,119,29,66,12,6,6,0,0,0,0,0,0,0,0,0,0,0,0,0,0,0,0,0,0,0,0,0,0,0,0,0,0,0,0,0,11430
2909,40798,9463,9508,7785,8562,5480,4142,2159,2029,413,263,1353,130,64,27,37,0,66,0,22,44,1983,1872,235,374,1263,111,69,12,47,10,42,0,17,25,11432
2910,20032,5020,6196,5568,2148,1100,2209,1153,914,34,185,695,239,134,37,97,0,105,3,20,82,1056,875,133,201,541,181,86,75,3,8,95,25,46,24,11433
2911,41273,6141,12702,13750,5680,3000,3556,1880,1403,131,206,1066,477,324,181,44,99,153,0,91,62,1676,1419,251,92,1076,257,136,57,20,59,121,0,65,56,11434
2912,36610,8268,10110,7833,6754,3645,2671,1517,1335,200,181,954,182,92,0,49,43,90,59,15,16,1154,970,138,132,700,184,163,58,77,28,21,0,9,12,11435
2913,11763,2272,4114,3332,1373,672,963,469,416,49,26,341,53,19,10,2,7,34,23,0,11,494,473,89,38,346,21,5,5,0,0,16,0,0,16,11436
2914,0,0,0,0,0,0,0,0,0,0,0,0,0,0,0,0,0,0,0,0,0,0,0,0,0,0,0,0,0,0,0,0,0,0,0,11451
2915,13842,2145,3351,3326,2673,2347,982,569,535,145,32,358,34,23,13,10,0,11,0,11,0,413,394,167,27,200,19,10,0,10,0,9,9,0,0,11501
2916,4934,317,1138,1010,1276,1193,387,245,202,58,10,134,43,4,4,0,0,39,0,0,39,142,133,53,0,80,9,9,9,0,0,0,0,0,0,11507
2917,1567,65,241,325,422,514,28,5,5,0,0,5,0,0,0,0,0,0,0,0,0,23,23,0,2,21,0,0,0,0,0,0,0,0,0,11509
2918,21764,1785,5442,5682,5063,3792,1588,904,789,159,46,584,115,115,29,10,76,0,0,0,0,684,623,119,21,483,61,61,27,22,12,0,0,0,0,11510
2919,3564,359,1033,852,884,436,280,88,88,16,25,47,0,0,0,0,0,0,0,0,0,192,192,56,25,111,0,0,0,0,0,0,0,0,0,11514
2920,4412,388,747,1061,1140,1076,479,299,222,15,0,207,77,77,0,0,77,0,0,0,0,180,180,0,0,180,0,0,0,0,0,0,0,0,0,11516
2921,7399,411,2002,2097,1676,1213,448,196,158,35,0,123,38,38,0,38,0,0,0,0,0,252,252,18,17,217,0,0,0,0,0,0,0,0,0,11518
2922,29585,6420,8915,7247,3984,3019,1969,980,834,184,47,603,146,86,65,0,21,60,36,24,0,989,815,266,91,458,174,120,82,24,14,54,22,23,9,11520
2923,18075,595,2695,3451,6020,5314,2368,974,919,172,25,722,55,55,35,20,0,0,0,0,0,1394,1394,322,119,953,0,0,0,0,0,0,0,0,0,11530
2924,19442,3561,5264,3909,3729,2979,1211,699,535,127,0,408,164,88,30,0,58,76,0,0,76,512,437,91,12,334,75,74,28,0,46,1,1,0,0,11542
2925,8898,369,1451,1510,2846,2722,685,337,320,93,4,223,17,4,4,0,0,13,0,0,13,348,320,54,0,266,28,16,16,0,0,12,0,0,12,11545
2926,461,42,56,95,182,86,60,36,36,0,21,15,0,0,0,0,0,0,0,0,0,24,24,8,0,16,0,0,0,0,0,0,0,0,0,11547
2927,746,20,137,76,285,228,658,286,286,62,27,197,0,0,0,0,0,0,0,0,0,372,357,99,7,251,15,15,0,15,0,0,0,0,0,11548
2928,96,0,0,20,42,34,962,397,397,95,17,285,0,0,0,0,0,0,0,0,0,565,565,154,70,341,0,0,0,0,0,0,0,0,0,11549
2929,35781,10893,10900,8149,3610,2229,3055,1462,1021,149,132,740,441,160,126,18,16,281,193,56,32,1593,1422,235,159,1028,171,113,65,20,28,58,10,0,48,11550
2930,15306,1687,4005,3943,3097,2574,1474,773,745,164,73,508,28,15,8,0,7,13,0,0,13,701,616,131,49,436,85,85,26,59,0,0,0,0,0,11552
2931,16354,3804,4820,4367,2376,987,2182,1065,990,195,40,755,75,45,6,3,36,30,15,0,15,1117,1009,295,32,682,108,72,12,0,60,36,36,0,0,11553
2932,26984,2712,7751,7308,5138,4075,2043,1235,1063,183,11,869,172,76,45,11,20,96,0,0,96,808,758,104,41,613,50,9,9,0,0,41,12,0,29,11554
2933,0,0,0,0,0,0,0,0,0,0,0,0,0,0,0,0,0,0,0,0,0,0,0,0,0,0,0,0,0,0,0,0,0,0,0,11556
2934,5337,152,1076,977,1427,1705,345,182,182,50,5,127,0,0,0,0,0,0,0,0,0,163,159,1,23,135,4,4,4,0,0,0,0,0,0,11557
2935,6286,697,1815,1950,942,882,532,217,194,0,0,194,23,12,0,10,2,11,0,0,11,315,315,111,81,123,0,0,0,0,0,0,0,0,0,11558
2936,4947,402,624,942,1363,1616,584,256,233,20,20,193,23,23,0,23,0,0,0,0,0,328,290,0,10,280,38,38,0,16,22,0,0,0,0,11559
2937,4685,343,842,1105,1340,1055,250,130,115,28,0,87,15,15,12,3,0,0,0,0,0,120,112,17,5,90,8,8,0,0,8,0,0,0,0,11560
2938,28718,2093,6092,7204,7403,5926,1770,808,677,122,39,516,131,108,6,20,82,23,0,0,23,962,919,157,74,688,43,43,19,24,0,0,0,0,0,11561
2939,16422,1228,4772,4041,3941,2440,1329,672,650,23,21,606,22,13,13,0,0,9,9,0,0,657,636,101,56,479,21,14,0,0,14,7,7,0,0,11563
2940,6481,342,1308,1632,1609,1590,403,185,185,18,9,158,0,0,0,0,0,0,0,0,0,218,218,74,0,144,0,0,0,0,0,0,0,0,0,11565
2941,22926,696,4742,5826,5987,5675,2110,1155,1060,156,38,866,95,95,55,6,34,0,0,0,0,955,871,147,62,662,84,52,45,0,7,32,0,0,32,11566
2942,1910,41,167,301,589,812,729,359,356,77,12,267,3,3,3,0,0,0,0,0,0,370,353,111,14,228,17,0,0,0,0,17,0,0,17,11568
2943,999,8,218,172,325,276,80,38,0,0,0,0,38,34,0,0,34,4,0,0,4,42,42,11,0,31,0,0,0,0,0,0,0,0,0,11569
2944,18347,1026,3519,3205,5471,5126,1627,723,723,175,62,486,0,0,0,0,0,0,0,0,0,904,895,141,18,736,9,0,0,0,0,9,0,0,9,11570
2945,20399,1487,5119,5000,4759,4034,1486,973,916,116,47,753,57,29,6,23,0,28,0,0,28,513,493,163,23,307,20,8,8,0,0,12,0,0,12,11572
2946,10532,2698,3501,2659,1260,414,774,324,282,7,29,246,42,42,0,19,23,0,0,0,0,450,359,47,76,236,91,55,25,0,30,36,0,0,36,11575
2947,8645,291,801,1096,3160,3297,646,372,366,18,23,325,6,6,0,6,0,0,0,0,0,274,274,36,5,233,0,0,0,0,0,0,0,0,0,11576
2948,8576,398,1396,1504,2669,2609,690,366,366,13,38,315,0,0,0,0,0,0,0,0,0,324,303,12,0,291,21,9,9,0,0,12,0,0,12,11577
2949,3572,94,504,748,1185,1041,367,141,130,25,9,96,11,0,0,0,0,11,0,0,11,226,226,50,0,176,0,0,0,0,0,0,0,0,0,11579
2950,28025,3028,7691,7790,6190,3326,2237,1275,1163,167,190,806,112,86,84,0,2,26,0,18,8,962,840,256,55,529,122,122,41,52,29,0,0,0,0,11580
2951,14031,1138,3572,3527,3463,2331,1076,638,594,139,88,367,44,44,0,33,11,0,0,0,0,438,404,72,24,308,34,18,18,0,0,16,0,16,0,11581
2952,31123,5025,8178,7630,5764,4526,2288,1310,1043,136,66,841,267,169,107,0,62,98,29,0,69,978,896,259,45,592,82,82,62,0,20,0,0,0,0,11590
2953,7308,435,1469,1651,1793,1960,584,324,314,57,5,252,10,10,0,0,10,0,0,0,0,260,244,65,7,172,16,16,0,16,0,0,0,0,0,11596
2954,8120,434,952,1452,2024,3258,1023,610,575,91,30,454,35,0,0,0,0,35,35,0,0,413,323,3,0,320,90,72,0,6,66,18,0,0,18,11598
2955,35984,9666,10183,8383,4871,2881,3548,1645,1388,110,35,1243,257,154,0,45,109,103,30,6,67,1903,1641,198,119,1324,262,170,89,11,70,92,0,0,92,11691
2956,11102,2700,3189,3077,1444,692,924,465,439,0,9,430,26,4,0,0,4,22,22,0,0,459,404,39,27,338,55,29,0,10,19,26,0,9,17,11692
2957,7664,1453,2318,2066,1320,507,687,389,358,70,19,269,31,8,0,0,8,23,0,0,23,298,291,44,49,198,7,7,0,0,7,0,0,0,0,11693
2958,15705,1893,3564,4345,3116,2787,1149,620,484,50,70,364,136,134,70,0,64,2,0,0,2,529,472,114,59,299,57,0,0,0,0,57,0,0,57,11694
2959,3085,170,845,708,767,595,141,87,87,8,0,79,0,0,0,0,0,0,0,0,0,54,54,0,0,54,0,0,0,0,0,0,0,0,0,11697
2960,18658,3194,6050,4814,2760,1840,1593,902,803,155,138,510,99,77,60,17,0,22,0,0,22,691,623,214,45,364,68,68,68,0,0,0,0,0,0,11701
2961,10576,484,2973,2982,2070,2067,688,365,328,145,43,140,37,14,14,0,0,23,23,0,0,323,301,48,17,236,22,22,22,0,0,0,0,0,0,11702
2962,11298,704,4015,3565,1799,1215,646,416,345,101,10,234,71,58,19,0,39,13,13,0,0,230,173,58,10,105,57,28,10,0,18,29,0,0,29,11703
2963,27901,3247,10783,7557,4069,2245,2187,1238,1079,242,144,693,159,147,56,0,91,12,10,0,2,949,846,212,58,576,103,88,41,0,47,15,7,0,8,11704
2964,5041,263,987,1767,1090,934,666,330,292,50,32,210,38,22,10,0,12,16,16,0,0,336,304,224,0,80,32,0,0,0,0,32,20,0,12,11705
2965,42666,7243,14229,11722,5833,3639,3980,2128,1731,421,194,1116,397,282,170,72,40,115,46,40,29,1852,1421,246,163,1012,431,316,119,90,107,115,19,13,83,11706
2966,4773,177,1078,1395,1105,1018,357,205,161,22,0,139,44,42,9,0,33,2,0,0,2,152,152,71,0,81,0,0,0,0,0,0,0,0,0,11709
2967,24137,1469,6571,6009,5589,4499,1677,873,817,142,48,627,56,56,41,15,0,0,0,0,0,804,776,253,37,486,28,15,0,15,0,13,0,0,13,11710
2968,6244,756,1489,2114,844,1041,613,272,249,45,11,193,23,23,17,0,6,0,0,0,0,341,305,49,8,248,36,36,36,0,0,0,0,0,0,11713
2969,16867,1420,5584,4523,3712,1628,1308,647,605,144,25,436,42,42,0,42,0,0,0,0,0,661,630,191,43,396,31,31,31,0,0,0,0,0,0,11714
2970,3187,51,1010,816,591,719,197,121,121,46,10,65,0,0,0,0,0,0,0,0,0,76,46,23,0,23,30,30,0,0,30,0,0,0,0,11715
2971,7416,539,2515,2104,1109,1149,808,449,434,85,63,286,15,15,15,0,0,0,0,0,0,359,340,49,50,241,19,19,19,0,0,0,0,0,0,11716
2972,36793,11243,13184,7668,3215,1483,3133,1650,1379,252,110,1017,271,230,105,19,106,41,5,27,9,1483,1278,314,105,859,205,113,49,44,20,92,27,36,29,11717
2973,2197,75,382,553,666,521,135,78,74,28,3,43,4,4,0,4,0,0,0,0,0,57,41,6,4,31,16,0,0,0,0,16,0,0,16,11718
2974,2319,250,617,606,435,411,125,45,45,27,0,18,0,0,0,0,0,0,0,0,0,80,80,9,0,71,0,0,0,0,0,0,0,0,0,11719
2975,20194,1533,6866,6286,2997,2512,1679,917,814,249,72,493,103,85,63,0,22,18,0,0,18,762,693,361,33,299,69,69,69,0,0,0,0,0,0,11720
2976,4182,117,639,842,1292,1292,328,158,158,12,0,146,0,0,0,0,0,0,0,0,0,170,170,60,0,110,0,0,0,0,0,0,0,0,0,11721
2977,23736,6934,7608,5429,2198,1567,2253,1213,1007,138,32,837,206,117,61,50,6,89,19,61,9,1040,809,169,55,585,231,192,84,0,108,39,0,0,39,11722
2978,1913,12,258,270,726,647,145,96,90,3,0,87,6,0,0,0,0,6,6,0,0,49,49,12,0,37,0,0,0,0,0,0,0,0,0,11724
2979,19586,881,4670,4989,4802,4244,1548,822,779,221,43,515,43,43,14,0,29,0,0,0,0,726,703,203,134,366,23,23,14,0,9,0,0,0,0,11725
2980,13099,2980,4933,3161,1250,775,1493,626,463,126,27,310,163,79,20,0,59,84,84,0,0,867,765,228,0,537,102,93,34,59,0,9,9,0,0,11726
2981,20272,1815,5602,6488,3454,2913,1110,666,598,61,68,469,68,68,58,10,0,0,0,0,0,444,385,158,5,222,59,59,18,41,0,0,0,0,0,11727
2982,18774,1867,6244,5622,3234,1807,1346,540,468,96,5,367,72,18,18,0,0,54,0,0,54,806,777,236,55,486,29,29,21,0,8,0,0,0,0,11729
2983,9304,537,2895,2480,1739,1653,969,398,377,98,33,246,21,19,19,0,0,2,0,0,2,571,534,46,30,458,37,37,37,0,0,0,0,0,0,11730
2984,19712,882,4307,4960,5446,4117,1506,790,697,142,56,499,93,64,64,0,0,29,29,0,0,716,690,270,32,388,26,26,0,0,26,0,0,0,0,11731
2985,2616,174,397,683,731,631,99,55,50,4,5,41,5,5,0,0,5,0,0,0,0,44,44,4,0,40,0,0,0,0,0,0,0,0,0,11732
2986,12114,440,2027,2462,2762,4423,974,516,514,101,17,396,2,0,0,0,0,2,0,0,2,458,428,108,47,273,30,30,0,0,30,0,0,0,0,11733
2987,22723,1964,7308,5786,4823,2842,2016,1062,949,214,31,704,113,96,63,0,33,17,0,3,14,954,877,245,20,612,77,44,0,25,19,33,0,0,33,11735
2988,11927,1185,4219,3653,1794,1076,1231,819,680,197,37,446,139,49,22,0,27,90,45,45,0,412,404,121,18,265,8,8,8,0,0,0,0,0,0,11738
2989,952,36,186,310,154,266,67,51,51,0,0,51,0,0,0,0,0,0,0,0,0,16,16,0,0,16,0,0,0,0,0,0,0,0,0,11739
2990,6219,294,1412,1659,1578,1276,504,288,288,27,0,261,0,0,0,0,0,0,0,0,0,216,216,63,10,143,0,0,0,0,0,0,0,0,0,11740
2991,19201,1575,6149,6211,3128,2138,1533,657,632,163,70,399,25,18,11,0,7,7,0,7,0,876,853,288,68,497,23,23,10,0,13,0,0,0,0,11741
2992,8663,615,2653,2993,1416,986,842,500,451,105,40,306,49,39,27,0,12,10,0,10,0,342,322,80,38,204,20,20,20,0,0,0,0,0,0,11742
2993,30182,1739,5394,6400,8624,8025,2080,1012,987,235,144,608,25,25,3,0,22,0,0,0,0,1068,982,204,35,743,86,86,34,0,52,0,0,0,0,11743
2994,44619,5758,10368,10726,9691,8076,4545,2401,2084,339,99,1646,317,163,78,8,77,154,56,0,98,2144,1978,559,95,1324,166,166,106,52,8,0,0,0,0,11746
2995,13960,753,2750,2881,3853,3723,1089,545,505,97,0,408,40,40,22,0,18,0,0,0,0,544,544,168,23,353,0,0,0,0,0,0,0,0,0,11747
2996,2371,236,817,660,410,248,295,157,118,31,7,80,39,39,14,25,0,0,0,0,0,138,138,41,0,97,0,0,0,0,0,0,0,0,0,11749
2997,10183,545,3149,3247,1918,1324,756,423,423,139,18,266,0,0,0,0,0,0,0,0,0,333,333,101,34,198,0,0,0,0,0,0,0,0,0,11751
2998,6482,452,2600,1930,980,520,510,207,207,18,31,158,0,0,0,0,0,0,0,0,0,303,258,143,12,103,45,36,36,0,0,9,0,0,9,11752
2999,8074,180,913,1245,2620,3116,696,394,361,40,0,321,33,0,0,0,0,33,0,0,33,302,302,62,0,240,0,0,0,0,0,0,0,0,0,11753
3000,13319,735,3888,3459,3026,2211,1002,538,505,197,50,258,33,12,12,0,0,21,0,0,21,464,409,140,39,230,55,32,32,0,0,23,20,0,3,11754
3001,8080,547,2330,2516,1677,1010,872,476,476,99,21,356,0,0,0,0,0,0,0,0,0,396,361,160,20,181,35,20,0,0,20,15,0,0,15,11755
3002,29659,2419,8841,9467,5225,3707,2356,1179,1035,237,46,752,144,108,74,16,18,36,20,0,16,1177,1028,438,59,531,149,149,126,0,23,0,0,0,0,11756
3003,31455,3336,12341,8768,4804,2206,2808,1565,1469,478,106,885,96,77,12,54,11,19,10,9,0,1243,1030,220,78,732,213,177,111,0,66,36,14,14,8,11757
3004,38604,2345,11785,10215,8524,5735,2722,1314,1187,330,65,792,127,127,82,25,20,0,0,0,0,1408,1328,420,39,869,80,80,74,0,6,0,0,0,0,11758
3005,15582,583,4468,5053,3235,2243,1162,566,533,148,30,355,33,33,25,8,0,0,0,0,0,596,554,101,43,410,42,33,9,0,24,9,0,0,9,11762
3006,19846,2335,6954,5886,2898,1773,1565,674,614,148,66,400,60,40,15,14,11,20,4,0,16,891,774,331,55,388,117,99,14,8,77,18,0,0,18,11763
3007,8261,238,1884,2243,1846,2050,726,297,257,67,9,181,40,40,10,30,0,0,0,0,0,429,429,155,30,244,0,0,0,0,0,0,0,0,0,11764
3008,492,9,60,107,185,131,31,14,14,0,0,14,0,0,0,0,0,0,0,0,0,17,9,0,0,9,8,8,0,0,8,0,0,0,0,11765
3009,8343,389,2010,2447,1925,1572,451,208,208,40,9,159,0,0,0,0,0,0,0,0,0,243,243,153,16,74,0,0,0,0,0,0,0,0,0,11766
3010,10278,681,2800,2852,2289,1656,916,486,474,61,30,383,12,12,0,12,0,0,0,0,0,430,430,141,24,265,0,0,0,0,0,0,0,0,0,11767
3011,15295,332,2453,3951,4270,4289,1179,746,732,110,73,549,14,14,0,14,0,0,0,0,0,433,409,127,32,250,24,24,0,0,24,0,0,0,0,11768
3012,6218,302,1662,2092,1147,1015,319,162,157,13,24,120,5,0,0,0,0,5,0,0,5,157,157,38,47,72,0,0,0,0,0,0,0,0,0,11769
3013,119,1,11,13,60,34,15,0,0,0,0,0,0,0,0,0,0,0,0,0,0,15,15,15,0,0,0,0,0,0,0,0,0,0,0,11770
3014,6472,411,1408,1156,2058,1439,478,157,101,16,0,85,56,47,0,0,47,9,0,0,9,321,267,103,0,164,54,45,3,0,42,9,0,0,9,11771
3015,30968,3901,12009,8165,4101,2792,2225,1313,981,215,18,748,332,271,156,19,96,61,16,0,45,912,751,283,37,431,161,161,85,14,62,0,0,0,0,11772
3016,16889,1475,5561,4285,3256,2312,1270,618,596,108,44,444,22,17,17,0,0,5,0,0,5,652,620,110,116,394,32,27,13,0,14,5,0,0,5,11776
3017,6747,141,1111,1504,1451,2540,392,165,156,56,0,100,9,0,0,0,0,9,0,0,9,227,195,74,10,111,32,3,0,0,3,29,0,0,29,11777
3018,8025,520,2612,2590,1139,1164,829,432,303,23,13,267,129,85,77,8,0,44,0,44,0,397,368,186,9,173,29,29,0,11,18,0,0,0,0,11778
3019,26472,2268,8824,8379,4022,2979,2110,1214,1101,275,73,753,113,74,36,0,38,39,0,20,19,896,786,319,149,318,110,104,70,17,17,6,0,0,6,11779
3020,10222,593,2295,2592,2400,2342,890,435,421,119,10,292,14,14,0,10,4,0,0,0,0,455,455,113,23,319,0,0,0,0,0,0,0,0,0,11780
3021,10635,430,2795,3009,2054,2347,783,441,417,135,11,271,24,24,16,0,8,0,0,0,0,342,331,150,6,175,11,11,3,0,8,0,0,0,0,11782
3022,14629,707,4201,4404,3317,2000,842,339,321,115,9,197,18,10,0,0,10,8,8,0,0,503,458,195,9,254,45,35,0,0,35,10,0,0,10,11783
3023,17196,1448,5923,5515,2571,1739,1454,754,657,190,92,375,97,30,21,9,0,67,44,13,10,700,547,192,35,320,153,139,117,0,22,14,0,0,14,11784
3024,4217,107,882,1260,822,1146,226,109,109,57,26,26,0,0,0,0,0,0,0,0,0,117,107,19,0,88,10,10,10,0,0,0,0,0,0,11786
3025,24791,1118,6056,7107,5572,4938,2299,1268,1137,322,99,716,131,113,65,6,42,18,7,11,0,1031,1000,252,56,692,31,9,6,3,0,22,8,0,14,11787
3026,11389,501,2933,2978,2797,2180,768,312,281,60,6,215,31,30,16,14,0,1,0,0,1,456,442,80,10,352,14,14,9,0,5,0,0,0,0,11788
3027,5111,223,1473,1451,1224,740,388,218,218,15,0,203,0,0,0,0,0,0,0,0,0,170,170,55,30,85,0,0,0,0,0,0,0,0,0,11789
3028,9619,169,1286,2130,2734,3300,2615,1398,1398,257,61,1080,0,0,0,0,0,0,0,0,0,1217,1216,305,50,861,1,0,0,0,0,1,0,0,1,11790
3029,16990,688,2443,2947,5526,5386,1468,851,811,203,32,576,40,26,8,0,18,14,0,0,14,617,607,44,31,532,10,0,0,0,0,10,0,0,10,11791
3030,6223,201,1386,1927,1366,1343,457,184,142,8,7,127,42,17,12,0,5,25,0,0,25,273,221,70,29,122,52,52,33,19,0,0,0,0,0,11792
3031,22319,1237,6008,6006,5136,3932,1732,767,650,100,12,538,117,103,89,0,14,14,14,0,0,965,902,265,10,627,63,46,37,0,9,17,0,0,17,11793
3032,145,0,0,7,62,76,1321,709,709,112,42,555,0,0,0,0,0,0,0,0,0,612,612,164,28,420,0,0,0,0,0,0,0,0,0,11794
3033,17267,1071,5318,4872,3435,2571,1482,768,698,143,57,498,70,70,10,22,38,0,0,0,0,714,668,269,22,377,46,46,26,13,7,0,0,0,0,11795
3034,2688,192,869,847,424,356,229,150,140,57,0,83,10,10,0,0,10,0,0,0,0,79,69,18,0,51,10,10,10,0,0,0,0,0,0,11796
3035,6619,359,1333,767,2182,1978,446,329,325,22,12,291,4,0,0,0,0,4,0,0,4,117,117,39,0,78,0,0,0,0,0,0,0,0,0,11797
3036,8854,1710,2878,2237,1388,641,1170,449,312,49,0,263,137,137,22,14,101,0,0,0,0,721,541,97,19,425,180,117,29,0,88,63,0,33,30,11798
3037,28642,2288,8730,7751,6342,3531,2042,951,871,292,32,547,80,60,43,6,11,20,8,0,12,1091,1035,374,84,577,56,56,20,0,36,0,0,0,0,11801
3038,20047,781,4007,4185,5440,5634,1416,752,746,197,8,541,6,6,6,0,0,0,0,0,0,664,648,98,26,524,16,9,9,0,0,7,0,0,7,11803
3039,3346,135,615,655,908,1033,334,208,208,9,0,199,0,0,0,0,0,0,0,0,0,126,126,34,0,92,0,0,0,0,0,0,0,0,0,11804
3040,21050,4434,7137,5031,2520,1928,1373,720,491,56,8,427,229,40,0,0,40,189,102,17,70,653,469,45,77,347,184,25,25,0,0,159,38,8,113,11901
3041,1003,35,237,200,353,178,28,6,6,6,0,0,0,0,0,0,0,0,0,0,0,22,22,10,0,12,0,0,0,0,0,0,0,0,0,11930
3042,51,0,0,36,15,0,0,0,0,0,0,0,0,0,0,0,0,0,0,0,0,0,0,0,0,0,0,0,0,0,0,0,0,0,0,11931
3043,761,22,193,138,238,170,14,0,0,0,0,0,0,0,0,0,0,0,0,0,0,14,14,11,0,3,0,0,0,0,0,0,0,0,0,11932
3044,4782,383,1573,1452,611,763,275,144,118,49,9,60,26,26,0,13,13,0,0,0,0,131,111,13,0,98,20,20,20,0,0,0,0,0,0,11933
3045,5085,454,1857,1313,785,676,408,156,115,19,0,96,41,0,0,0,0,41,0,0,41,252,199,38,0,161,53,53,0,0,53,0,0,0,0,11934
3046,2519,247,622,619,609,422,229,122,122,50,0,72,0,0,0,0,0,0,0,0,0,107,107,18,0,89,0,0,0,0,0,0,0,0,0,11935
3047,12052,892,2585,3020,2975,2580,597,323,262,34,36,192,61,57,37,0,20,4,0,0,4,274,274,0,17,257,0,0,0,0,0,0,0,0,0,11937
3048,792,46,252,189,151,154,70,27,14,6,0,8,13,0,0,0,0,13,0,13,0,43,24,11,0,13,19,13,0,0,13,6,6,0,0,11939
3049,3609,200,1126,972,763,548,296,165,158,40,0,118,7,6,6,0,0,1,0,0,1,131,131,27,22,82,0,0,0,0,0,0,0,0,0,11940
3050,1385,90,483,335,321,156,120,59,54,0,0,54,5,0,0,0,0,5,5,0,0,61,61,57,0,4,0,0,0,0,0,0,0,0,0,11941
3051,3121,110,745,930,729,607,188,108,108,34,0,74,0,0,0,0,0,0,0,0,0,80,80,7,0,73,0,0,0,0,0,0,0,0,0,11942
3052,3419,563,940,806,579,531,121,57,57,16,0,41,0,0,0,0,0,0,0,0,0,64,64,10,0,54,0,0,0,0,0,0,0,0,0,11944
3053,9808,966,3286,2633,1909,1014,474,238,222,43,8,171,16,16,16,0,0,0,0,0,0,236,178,36,21,121,58,32,0,0,32,26,26,0,0,11946
3054,94,0,50,7,15,22,7,0,0,0,0,0,0,0,0,0,0,0,0,0,0,7,7,0,0,7,0,0,0,0,0,0,0,0,0,11947
3055,754,19,191,141,177,226,103,51,51,30,0,21,0,0,0,0,0,0,0,0,0,52,52,0,0,52,0,0,0,0,0,0,0,0,0,11948
3056,8953,443,2179,2730,1911,1690,1025,622,601,127,12,462,21,21,21,0,0,0,0,0,0,403,387,135,0,252,16,16,0,16,0,0,0,0,0,11949
3057,11111,1598,4726,3268,1009,510,1012,568,248,103,0,145,320,205,52,0,153,115,81,0,34,444,268,20,13,235,176,122,74,39,9,54,0,0,54,11950
3058,9058,1322,3936,2551,599,650,792,423,356,61,28,267,67,34,0,0,34,33,18,0,15,369,208,24,37,147,161,32,17,15,0,129,0,0,129,11951
3059,3272,199,950,883,718,522,179,71,71,21,0,50,0,0,0,0,0,0,0,0,0,108,84,43,0,41,24,24,0,24,0,0,0,0,0,11952
3060,8981,648,2880,2746,1426,1281,440,155,144,28,25,91,11,0,0,0,0,11,11,0,0,285,208,147,3,58,77,18,7,11,0,59,0,0,59,11953
3061,2854,150,880,764,657,403,56,37,36,17,0,19,1,1,1,0,0,0,0,0,0,19,18,0,18,0,1,1,1,0,0,0,0,0,0,11954
3062,2309,196,740,690,327,356,55,34,34,0,0,34,0,0,0,0,0,0,0,0,0,21,21,21,0,0,0,0,0,0,0,0,0,0,0,11955
3063,304,43,40,72,78,71,0,0,0,0,0,0,0,0,0,0,0,0,0,0,0,0,0,0,0,0,0,0,0,0,0,0,0,0,0,11956
3064,578,25,140,122,169,122,54,38,32,16,0,16,6,6,6,0,0,0,0,0,0,16,16,10,0,6,0,0,0,0,0,0,0,0,0,11957
3065,232,49,9,26,84,64,0,0,0,0,0,0,0,0,0,0,0,0,0,0,0,0,0,0,0,0,0,0,0,0,0,0,0,0,0,11958
3066,676,11,175,112,241,137,9,0,0,0,0,0,0,0,0,0,0,0,0,0,0,9,9,0,0,9,0,0,0,0,0,0,0,0,0,11959
3067,677,9,108,102,238,220,56,34,34,0,3,31,0,0,0,0,0,0,0,0,0,22,20,0,0,20,2,0,0,0,0,2,0,0,2,11960
3068,9037,702,3626,2720,1153,836,434,162,159,26,23,110,3,1,0,0,1,2,0,0,2,272,251,88,25,138,21,21,21,0,0,0,0,0,0,11961
3069,348,0,114,64,114,56,50,50,50,40,0,10,0,0,0,0,0,0,0,0,0,0,0,0,0,0,0,0,0,0,0,0,0,0,0,11962
3070,5182,289,1198,938,1537,1220,200,92,92,13,3,76,0,0,0,0,0,0,0,0,0,108,108,51,0,57,0,0,0,0,0,0,0,0,0,11963
3071,1310,45,221,363,378,303,136,54,54,15,0,39,0,0,0,0,0,0,0,0,0,82,44,16,0,28,38,23,23,0,0,15,0,0,15,11964
3072,513,0,102,136,170,105,12,9,9,0,0,9,0,0,0,0,0,0,0,0,0,3,3,1,0,2,0,0,0,0,0,0,0,0,0,11965
3073,17273,2070,7860,4784,1362,1197,1629,844,638,213,16,409,206,194,56,6,132,12,0,12,0,785,647,136,9,502,138,85,29,6,50,53,0,21,32,11967
3074,8359,807,1996,1792,1925,1839,598,336,303,98,8,197,33,33,13,16,4,0,0,0,0,262,216,80,9,127,46,17,0,0,17,29,18,0,11,11968
3075,505,0,75,141,119,170,0,0,0,0,0,0,0,0,0,0,0,0,0,0,0,0,0,0,0,0,0,0,0,0,0,0,0,0,0,11970
3076,4804,100,1396,1518,911,879,254,138,138,43,0,95,0,0,0,0,0,0,0,0,0,116,116,78,0,38,0,0,0,0,0,0,0,0,0,11971
3077,692,27,191,220,181,73,93,78,69,0,0,69,9,9,0,0,9,0,0,0,0,15,3,0,0,3,12,12,0,0,12,0,0,0,0,11972
3078,0,0,0,0,0,0,8,0,0,0,0,0,0,0,0,0,0,0,0,0,0,8,8,0,8,0,0,0,0,0,0,0,0,0,0,11973
3079,284,18,52,54,88,72,25,17,17,2,0,15,0,0,0,0,0,0,0,0,0,8,8,2,3,3,0,0,0,0,0,0,0,0,0,11975
3080,1543,74,283,232,378,576,104,50,50,0,0,50,0,0,0,0,0,0,0,0,0,54,54,30,0,24,0,0,0,0,0,0,0,0,0,11976
3081,1805,86,520,416,461,322,85,51,34,11,0,23,17,5,5,0,0,12,0,0,12,34,34,25,0,9,0,0,0,0,0,0,0,0,0,11977
3082,2534,149,564,562,653,606,107,54,54,2,0,52,0,0,0,0,0,0,0,0,0,53,43,14,9,20,10,5,5,0,0,5,5,0,0,11978
3083,3462,390,1334,845,513,380,272,155,131,26,0,105,24,15,0,5,10,9,0,0,9,117,81,3,0,78,36,36,0,0,36,0,0,0,0,11980
3084,65,0,23,42,0,0,0,0,0,0,0,0,0,0,0,0,0,0,0,0,0,0,0,0,0,0,0,0,0,0,0,0,0,0,0,12007
3085,328,12,78,131,79,28,12,0,0,0,0,0,0,0,0,0,0,0,0,0,0,12,12,0,0,12,0,0,0,0,0,0,0,0,0,12008
3086,5316,207,1520,1749,980,860,426,226,216,98,12,106,10,7,3,4,0,3,0,0,3,200,168,93,24,51,32,23,8,0,15,9,0,9,0,12009
3087,20395,3269,6876,6713,2332,1205,1455,705,480,92,16,372,225,69,24,0,45,156,82,41,33,750,577,195,79,303,173,98,68,8,22,75,18,34,23,12010
3088,1968,204,609,639,220,296,154,87,64,18,3,43,23,6,0,0,6,17,0,0,17,67,62,27,3,32,5,2,2,0,0,3,0,0,3,12015
3089,201,5,93,45,34,24,23,0,0,0,0,0,0,0,0,0,0,0,0,0,0,23,13,10,0,3,10,10,10,0,0,0,0,0,0,12017
3090,5336,179,1619,1756,904,878,289,152,147,39,0,108,5,5,0,5,0,0,0,0,0,137,129,28,37,64,8,7,7,0,0,1,0,0,1,12018
3091,10382,401,2268,3455,2419,1839,678,380,347,153,28,166,33,23,23,0,0,10,0,10,0,298,250,110,52,88,48,48,34,7,7,0,0,0,0,12019
3092,21503,1442,5907,6655,4690,2809,1651,798,660,157,117,386,138,72,43,0,29,66,0,66,0,853,791,318,101,372,62,52,0,0,52,10,0,0,10,12020
3093,704,78,296,172,58,100,28,24,11,0,0,11,13,3,3,0,0,10,3,7,0,4,4,0,0,4,0,0,0,0,0,0,0,0,0,12022
3094,1580,164,527,445,220,224,96,27,27,6,0,21,0,0,0,0,0,0,0,0,0,69,69,37,0,32,0,0,0,0,0,0,0,0,0,12023
3095,57,0,41,16,0,0,0,0,0,0,0,0,0,0,0,0,0,0,0,0,0,0,0,0,0,0,0,0,0,0,0,0,0,0,0,12024
3096,3762,305,1455,1465,392,145,356,167,143,0,17,126,24,18,18,0,0,6,0,0,6,189,149,71,0,78,40,40,40,0,0,0,0,0,0,12025
3097,2681,72,457,836,719,597,156,98,98,11,0,87,0,0,0,0,0,0,0,0,0,58,58,0,8,50,0,0,0,0,0,0,0,0,0,12027
3098,670,15,267,228,95,65,51,10,10,5,0,5,0,0,0,0,0,0,0,0,0,41,41,21,0,20,0,0,0,0,0,0,0,0,0,12028
3099,686,54,153,228,131,120,155,150,103,17,3,83,47,0,0,0,0,47,4,0,43,5,5,3,0,2,0,0,0,0,0,0,0,0,0,12029
3100,103,12,38,29,13,11,7,3,3,0,0,3,0,0,0,0,0,0,0,0,0,4,4,0,0,4,0,0,0,0,0,0,0,0,0,12031
3101,588,47,233,176,59,73,28,17,12,0,0,12,5,0,0,0,0,5,0,5,0,11,11,0,0,11,0,0,0,0,0,0,0,0,0,12032
3102,5776,496,1568,1772,1236,704,369,169,99,52,0,47,70,62,3,21,38,8,0,0,8,200,190,28,0,162,10,8,0,8,0,2,0,0,2,12033
3103,511,85,171,195,42,18,29,0,0,0,0,0,0,0,0,0,0,0,0,0,0,29,29,8,0,21,0,0,0,0,0,0,0,0,0,12035
3104,156,46,64,36,10,0,9,5,5,0,0,5,0,0,0,0,0,0,0,0,0,4,4,0,0,4,0,0,0,0,0,0,0,0,0,12036
3105,2991,243,888,852,521,487,146,47,47,13,4,30,0,0,0,0,0,0,0,0,0,99,63,28,6,29,36,17,0,17,0,19,0,19,0,12037
3106,76,6,42,17,6,5,0,0,0,0,0,0,0,0,0,0,0,0,0,0,0,0,0,0,0,0,0,0,0,0,0,0,0,0,0,12040
3107,251,9,134,52,39,17,70,45,26,0,0,26,19,19,19,0,0,0,0,0,0,25,25,25,0,0,0,0,0,0,0,0,0,0,0,12041
3108,205,16,82,68,0,39,11,11,11,11,0,0,0,0,0,0,0,0,0,0,0,0,0,0,0,0,0,0,0,0,0,0,0,0,0,12042
3109,5104,609,1631,1481,629,754,1043,419,403,159,3,241,16,13,8,0,5,3,0,0,3,624,611,175,101,335,13,3,3,0,0,10,0,10,0,12043
3110,243,54,113,65,0,11,0,0,0,0,0,0,0,0,0,0,0,0,0,0,0,0,0,0,0,0,0,0,0,0,0,0,0,0,0,12045
3111,686,63,227,234,81,81,49,49,49,0,14,35,0,0,0,0,0,0,0,0,0,0,0,0,0,0,0,0,0,0,0,0,0,0,0,12046
3112,14370,1691,4963,4293,2086,1337,752,386,281,71,0,210,105,105,56,0,49,0,0,0,0,366,322,163,9,150,44,44,44,0,0,0,0,0,0,12047
3113,4532,1175,1528,1014,435,380,722,599,156,48,16,92,443,31,0,0,31,412,28,0,384,123,123,68,11,44,0,0,0,0,0,0,0,0,0,12051
3114,1153,77,364,381,171,160,78,3,3,3,0,0,0,0,0,0,0,0,0,0,0,75,71,36,12,23,4,4,4,0,0,0,0,0,0,12052
3115,3089,265,1106,873,432,413,305,185,145,53,0,92,40,4,4,0,0,36,19,0,17,120,118,97,0,21,2,0,0,0,0,2,0,0,2,12053
3116,11689,348,1336,2487,3130,4388,796,394,394,75,28,291,0,0,0,0,0,0,0,0,0,402,372,97,32,243,30,16,16,0,0,14,0,0,14,12054
3117,1799,154,642,500,215,288,146,77,77,0,0,77,0,0,0,0,0,0,0,0,0,69,69,7,0,62,0,0,0,0,0,0,0,0,0,12056
3118,1387,85,582,457,188,75,62,42,19,12,0,7,23,23,6,0,17,0,0,0,0,20,20,0,0,20,0,0,0,0,0,0,0,0,0,12057
3119,1029,234,364,293,79,59,63,41,0,0,0,0,41,41,0,0,41,0,0,0,0,22,22,13,0,9,0,0,0,0,0,0,0,0,0,12058
3120,1185,10,336,414,287,138,52,0,0,0,0,0,0,0,0,0,0,0,0,0,0,52,46,19,0,27,6,6,0,0,6,0,0,0,0,12059
3121,1018,15,202,253,210,338,94,20,20,9,0,11,0,0,0,0,0,0,0,0,0,74,61,6,0,55,13,13,0,13,0,0,0,0,0,12060
3122,6720,260,1549,1953,1569,1389,310,162,157,54,15,88,5,0,0,0,0,5,0,0,5,148,148,25,34,89,0,0,0,0,0,0,0,0,0,12061
3123,1077,64,481,308,150,74,78,54,42,22,0,20,12,7,0,0,7,5,0,5,0,24,24,12,8,4,0,0,0,0,0,0,0,0,0,12062
3124,318,0,53,126,120,19,33,0,0,0,0,0,0,0,0,0,0,0,0,0,0,33,33,33,0,0,0,0,0,0,0,0,0,0,0,12063
3125,247,38,78,93,4,34,8,8,8,0,0,8,0,0,0,0,0,0,0,0,0,0,0,0,0,0,0,0,0,0,0,0,0,0,0,12064
3126,29371,1399,4692,8147,8718,6415,1966,1006,960,283,83,594,46,46,46,0,0,0,0,0,0,960,906,204,83,619,54,54,22,0,32,0,0,0,0,12065
3127,1472,73,581,558,216,44,97,77,58,6,7,45,19,19,3,0,16,0,0,0,0,20,18,10,1,7,2,2,2,0,0,0,0,0,0,12066
3128,971,35,378,281,155,122,69,36,36,0,9,27,0,0,0,0,0,0,0,0,0,33,33,16,0,17,0,0,0,0,0,0,0,0,0,12067
3129,2010,273,727,676,228,106,172,111,109,29,19,61,2,0,0,0,0,2,2,0,0,61,52,18,20,14,9,6,0,6,0,3,0,0,3,12068
3130,131,27,48,28,0,28,10,10,10,10,0,0,0,0,0,0,0,0,0,0,0,0,0,0,0,0,0,0,0,0,0,0,0,0,0,12069
3131,1067,130,304,328,118,187,85,56,33,0,5,28,23,7,0,0,7,16,0,0,16,29,29,20,2,7,0,0,0,0,0,0,0,0,0,12070
3132,148,18,68,40,14,8,1,0,0,0,0,0,0,0,0,0,0,0,0,0,0,1,1,1,0,0,0,0,0,0,0,0,0,0,0,12071
3133,1932,321,820,502,156,133,121,85,66,17,8,41,19,7,7,0,0,12,0,0,12,36,34,10,0,24,2,2,2,0,0,0,0,0,0,12072
3134,2280,167,764,732,411,206,192,104,104,25,18,61,0,0,0,0,0,0,0,0,0,88,83,4,26,53,5,3,0,0,3,2,2,0,0,12074
3135,2318,175,734,775,331,303,224,157,96,0,49,47,61,61,61,0,0,0,0,0,0,67,67,53,0,14,0,0,0,0,0,0,0,0,0,12075
3136,1167,144,534,366,63,60,61,27,11,0,0,11,16,7,0,0,7,9,0,0,9,34,23,10,4,9,11,11,4,3,4,0,0,0,0,12076
3137,4729,159,1046,1195,868,1461,315,247,245,79,0,166,2,0,0,0,0,2,0,0,2,68,58,9,0,49,10,0,0,0,0,10,0,10,0,12077
3138,16299,2944,6663,4539,1078,1075,1422,804,693,134,59,500,111,75,36,0,39,36,8,2,26,618,505,164,56,285,113,22,0,0,22,91,41,8,42,12078
3139,2933,209,1109,968,310,337,139,66,66,7,9,50,0,0,0,0,0,0,0,0,0,73,73,21,0,52,0,0,0,0,0,0,0,0,0,12083
3140,3234,92,475,557,986,1124,137,62,62,31,0,31,0,0,0,0,0,0,0,0,0,75,51,17,0,34,24,24,24,0,0,0,0,0,0,12084
3141,370,31,155,120,28,36,14,0,0,0,0,0,0,0,0,0,0,0,0,0,0,14,14,0,0,14,0,0,0,0,0,0,0,0,0,12085
3142,1110,67,315,368,237,123,38,21,21,5,9,7,0,0,0,0,0,0,0,0,0,17,14,3,0,11,3,3,3,0,0,0,0,0,0,12086
3143,557,31,281,190,43,12,56,37,37,0,0,37,0,0,0,0,0,0,0,0,0,19,4,4,0,0,15,4,4,0,0,11,0,11,0,12087
3144,80,80,0,0,0,0,0,0,0,0,0,0,0,0,0,0,0,0,0,0,0,0,0,0,0,0,0,0,0,0,0,0,0,0,0,12089
3145,4158,451,1433,1321,628,325,493,202,200,82,0,118,2,0,0,0,0,2,0,0,2,291,274,33,15,226,17,17,9,0,8,0,0,0,0,12090
3146,722,69,403,162,36,52,0,0,0,0,0,0,0,0,0,0,0,0,0,0,0,0,0,0,0,0,0,0,0,0,0,0,0,0,0,12092
3147,1309,216,460,412,162,59,71,47,38,0,8,30,9,9,9,0,0,0,0,0,0,24,21,12,1,8,3,1,1,0,0,2,0,0,2,12093
3148,1523,192,604,554,102,71,27,11,11,11,0,0,0,0,0,0,0,0,0,0,0,16,16,0,0,16,0,0,0,0,0,0,0,0,0,12094
3149,8852,1164,3422,2866,781,619,595,320,274,12,13,249,46,6,0,0,6,40,0,0,40,275,238,80,5,153,37,1,0,0,1,36,0,18,18,12095
3150,1655,86,392,552,274,351,119,61,53,10,0,43,8,8,5,3,0,0,0,0,0,58,58,31,22,5,0,0,0,0,0,0,0,0,0,12106
3151,285,31,122,85,13,34,9,9,9,0,0,9,0,0,0,0,0,0,0,0,0,0,0,0,0,0,0,0,0,0,0,0,0,0,0,12108
3152,13719,709,2962,3680,3596,2772,2008,1034,994,264,15,715,40,35,24,0,11,5,0,0,5,974,960,420,29,511,14,14,14,0,0,0,0,0,0,12110
3153,187,0,27,41,44,75,0,0,0,0,0,0,0,0,0,0,0,0,0,0,0,0,0,0,0,0,0,0,0,0,0,0,0,0,0,12115
3154,1476,172,560,461,173,110,59,17,17,7,0,10,0,0,0,0,0,0,0,0,0,42,42,16,0,26,0,0,0,0,0,0,0,0,0,12116
3155,2729,269,1073,975,221,191,224,107,90,2,0,88,17,17,9,0,8,0,0,0,0,117,59,2,0,57,58,58,58,0,0,0,0,0,0,12117
3156,9466,880,3240,2860,1691,795,664,380,300,87,0,213,80,28,28,0,0,52,52,0,0,284,284,152,23,109,0,0,0,0,0,0,0,0,0,12118
3157,549,105,174,111,104,55,14,14,14,0,0,14,0,0,0,0,0,0,0,0,0,0,0,0,0,0,0,0,0,0,0,0,0,0,0,12120
3158,1412,31,693,465,202,21,140,66,54,30,13,11,12,12,12,0,0,0,0,0,0,74,74,28,0,46,0,0,0,0,0,0,0,0,0,12121
3159,3261,453,1364,979,296,169,262,124,108,16,11,81,16,13,6,7,0,3,0,0,3,138,133,35,0,98,5,5,5,0,0,0,0,0,0,12122
3160,3832,246,1646,1075,459,406,211,120,87,24,22,41,33,15,0,15,0,18,18,0,0,91,70,0,14,56,21,0,0,0,0,21,0,21,0,12123
3161,594,60,156,194,149,35,35,0,0,0,0,0,0,0,0,0,0,0,0,0,0,35,17,11,6,0,18,0,0,0,0,18,0,0,18,12124
3162,1042,84,435,254,128,141,89,61,50,10,0,40,11,8,3,5,0,3,3,0,0,28,28,0,0,28,0,0,0,0,0,0,0,0,0,12125
3163,855,35,268,307,162,83,67,11,11,0,11,0,0,0,0,0,0,0,0,0,0,56,45,20,25,0,11,11,0,11,0,0,0,0,0,12130
3164,93,17,45,23,5,3,3,0,0,0,0,0,0,0,0,0,0,0,0,0,0,3,2,0,0,2,1,1,0,1,0,0,0,0,0,12131
3165,219,0,50,68,32,69,0,0,0,0,0,0,0,0,0,0,0,0,0,0,0,0,0,0,0,0,0,0,0,0,0,0,0,0,0,12132
3166,2703,307,1070,784,373,169,161,77,66,8,7,51,11,8,0,0,8,3,0,3,0,84,83,28,0,55,1,0,0,0,0,1,0,0,1,12134
3167,579,19,66,130,219,145,0,0,0,0,0,0,0,0,0,0,0,0,0,0,0,0,0,0,0,0,0,0,0,0,0,0,0,0,0,12136
3168,1357,129,490,430,202,106,104,15,15,0,0,15,0,0,0,0,0,0,0,0,0,89,53,9,44,0,36,5,0,0,5,31,0,31,0,12137
3169,2411,251,859,880,223,198,115,54,54,15,0,39,0,0,0,0,0,0,0,0,0,61,53,11,0,42,8,8,3,0,5,0,0,0,0,12138
3170,124,7,40,57,15,5,3,0,0,0,0,0,0,0,0,0,0,0,0,0,0,3,2,0,0,2,1,1,1,0,0,0,0,0,0,12139
3171,1096,77,338,363,203,115,112,87,87,9,15,63,0,0,0,0,0,0,0,0,0,25,25,0,0,25,0,0,0,0,0,0,0,0,0,12140
3172,3471,282,1580,969,365,275,187,93,60,12,0,48,33,33,33,0,0,0,0,0,0,94,74,0,0,74,20,9,9,0,0,11,0,0,11,12143
3173,14825,1268,4047,5249,2324,1937,764,459,411,38,81,292,48,45,16,0,29,3,0,0,3,305,248,52,85,111,57,57,48,9,0,0,0,0,0,12144
3174,403,35,144,87,50,87,18,0,0,0,0,0,0,0,0,0,0,0,0,0,0,18,18,7,0,11,0,0,0,0,0,0,0,0,0,12147
3175,3083,65,500,763,885,870,213,121,116,48,11,57,5,5,5,0,0,0,0,0,0,92,92,47,0,45,0,0,0,0,0,0,0,0,0,12148
3176,1599,183,666,449,187,114,145,90,79,53,0,26,11,6,6,0,0,5,0,5,0,55,53,10,5,38,2,2,0,0,2,0,0,0,0,12149
3177,561,43,228,146,87,57,44,7,7,0,0,7,0,0,0,0,0,0,0,0,0,37,37,25,12,0,0,0,0,0,0,0,0,0,0,12150
3178,498,40,77,133,144,104,11,8,8,8,0,0,0,0,0,0,0,0,0,0,0,3,3,0,0,3,0,0,0,0,0,0,0,0,0,12151
3179,710,41,115,311,129,114,28,19,19,0,0,19,0,0,0,0,0,0,0,0,0,9,9,5,4,0,0,0,0,0,0,0,0,0,0,12153
3180,1971,181,737,633,281,139,163,138,81,2,15,64,57,57,0,0,57,0,0,0,0,25,24,8,0,16,1,1,1,0,0,0,0,0,0,12154
3181,1293,118,532,459,107,77,115,51,34,5,14,15,17,17,17,0,0,0,0,0,0,64,49,10,0,39,15,13,13,0,0,2,2,0,0,12155
3182,702,99,201,190,147,65,13,10,10,0,0,10,0,0,0,0,0,0,0,0,0,3,3,3,0,0,0,0,0,0,0,0,0,0,0,12156
3183,3299,393,1099,1156,338,313,304,172,121,5,30,86,51,51,0,25,26,0,0,0,0,132,124,40,29,55,8,5,5,0,0,3,0,3,0,12157
3184,4349,269,1382,1319,682,697,328,147,134,56,6,72,13,13,4,9,0,0,0,0,0,181,181,112,43,26,0,0,0,0,0,0,0,0,0,12158
3185,5662,188,920,1233,1561,1760,456,241,241,86,0,155,0,0,0,0,0,0,0,0,0,215,215,73,28,114,0,0,0,0,0,0,0,0,0,12159
3186,742,90,275,209,123,45,46,20,9,6,0,3,11,0,0,0,0,11,8,3,0,26,26,0,0,26,0,0,0,0,0,0,0,0,0,12160
3187,131,0,46,0,60,25,0,0,0,0,0,0,0,0,0,0,0,0,0,0,0,0,0,0,0,0,0,0,0,0,0,0,0,0,0,12161
3188,279,51,82,83,33,30,16,0,0,0,0,0,0,0,0,0,0,0,0,0,0,16,5,0,0,5,11,11,0,0,11,0,0,0,0,12164
3189,147,0,33,40,37,37,6,3,3,0,0,3,0,0,0,0,0,0,0,0,0,3,3,0,0,3,0,0,0,0,0,0,0,0,0,12165
3190,982,148,374,338,85,37,62,27,17,10,0,7,10,10,0,5,5,0,0,0,0,35,28,0,2,26,7,3,3,0,0,4,0,0,4,12166
3191,1953,240,710,514,296,193,116,66,58,3,20,35,8,8,4,4,0,0,0,0,0,50,44,11,0,33,6,6,4,0,2,0,0,0,0,12167
3192,1220,86,458,414,158,104,92,29,29,14,10,5,0,0,0,0,0,0,0,0,0,63,63,23,15,25,0,0,0,0,0,0,0,0,0,12168
3193,220,18,113,51,18,20,0,0,0,0,0,0,0,0,0,0,0,0,0,0,0,0,0,0,0,0,0,0,0,0,0,0,0,0,0,12169
3194,3401,305,1320,976,581,219,407,207,148,33,33,82,59,46,12,26,8,13,10,0,3,200,189,33,97,59,11,11,11,0,0,0,0,0,0,12170
3195,312,79,187,25,10,11,29,29,0,0,0,0,29,0,0,0,0,29,0,0,29,0,0,0,0,0,0,0,0,0,0,0,0,0,0,12172
3196,1243,87,418,532,127,79,88,57,46,7,0,39,11,11,11,0,0,0,0,0,0,31,31,27,0,4,0,0,0,0,0,0,0,0,0,12173
3197,177,22,68,55,10,22,47,32,32,32,0,0,0,0,0,0,0,0,0,0,0,15,12,5,0,7,3,3,3,0,0,0,0,0,0,12174
3198,604,92,199,230,54,29,37,22,5,0,5,0,17,17,17,0,0,0,0,0,0,15,15,3,0,12,0,0,0,0,0,0,0,0,0,12175
3199,224,19,107,79,13,6,70,70,0,0,0,0,70,25,0,0,25,45,0,0,45,0,0,0,0,0,0,0,0,0,0,0,0,0,0,12176
3200,400,0,134,155,38,73,0,0,0,0,0,0,0,0,0,0,0,0,0,0,0,0,0,0,0,0,0,0,0,0,0,0,0,0,0,12177
3201,33626,4430,9499,10110,5134,4453,4633,2930,2729,711,110,1908,201,150,128,9,13,51,7,0,44,1703,1562,515,70,977,141,100,37,0,63,41,0,29,12,12180
3202,9456,1386,3006,3033,1379,652,996,461,381,38,12,331,80,45,38,7,0,35,35,0,0,535,335,4,107,224,200,138,11,66,61,62,0,52,10,12182
3203,1685,98,695,600,174,118,56,30,30,0,0,30,0,0,0,0,0,0,0,0,0,26,20,11,0,9,6,6,6,0,0,0,0,0,0,12183
3204,4971,525,1413,1331,1011,691,299,166,156,21,19,116,10,10,0,0,10,0,0,0,0,133,129,33,0,96,4,4,4,0,0,0,0,0,0,12184
3205,1579,128,554,535,208,154,137,71,71,15,3,53,0,0,0,0,0,0,0,0,0,66,62,17,3,42,4,4,4,0,0,0,0,0,0,12185
3206,4444,226,746,1326,1097,1049,304,140,139,41,30,68,1,1,0,1,0,0,0,0,0,164,157,29,32,96,7,0,0,0,0,7,0,7,0,12186
3207,303,34,73,84,54,58,22,12,12,0,0,12,0,0,0,0,0,0,0,0,0,10,8,0,0,8,2,0,0,0,0,2,2,0,0,12187
3208,7541,389,2027,3038,1244,843,731,533,254,42,9,203,279,269,91,0,178,10,0,0,10,198,198,136,6,56,0,0,0,0,0,0,0,0,0,12188
3209,12145,1215,3406,4035,2408,1081,707,449,375,80,17,278,74,65,55,10,0,9,0,0,9,258,233,74,8,151,25,25,0,25,0,0,0,0,0,12189
3210,565,66,191,217,46,45,10,10,10,0,7,3,0,0,0,0,0,0,0,0,0,0,0,0,0,0,0,0,0,0,0,0,0,0,0,12190
3211,1467,81,675,371,140,200,138,50,39,18,0,21,11,11,11,0,0,0,0,0,0,88,67,12,6,49,21,21,21,0,0,0,0,0,0,12192
3212,1332,82,490,359,215,186,35,22,22,0,9,13,0,0,0,0,0,0,0,0,0,13,13,0,0,13,0,0,0,0,0,0,0,0,0,12193
3213,133,28,52,43,4,6,0,0,0,0,0,0,0,0,0,0,0,0,0,0,0,0,0,0,0,0,0,0,0,0,0,0,0,0,0,12194
3214,156,0,43,25,46,42,0,0,0,0,0,0,0,0,0,0,0,0,0,0,0,0,0,0,0,0,0,0,0,0,0,0,0,0,0,12195
3215,2436,56,443,765,737,435,64,35,35,0,0,35,0,0,0,0,0,0,0,0,0,29,29,15,0,14,0,0,0,0,0,0,0,0,0,12196
3216,1992,210,611,711,243,217,105,41,23,0,3,20,18,18,0,18,0,0,0,0,0,64,61,5,4,52,3,2,2,0,0,1,0,0,1,12197
3217,5461,355,1289,1806,1172,839,470,225,214,56,0,158,11,0,0,0,0,11,0,11,0,245,245,93,29,123,0,0,0,0,0,0,0,0,0,12198
3218,5697,973,2043,1443,543,695,559,377,337,37,15,285,40,0,0,0,0,40,0,3,37,182,180,83,24,73,2,2,0,0,2,0,0,0,0,12202
3219,19603,1631,3955,4821,4749,4447,2969,1222,1128,135,71,922,94,24,20,0,4,70,0,55,15,1747,1727,415,145,1167,20,19,0,0,19,1,0,1,0,12203
3220,4841,413,950,1501,1139,838,260,75,48,0,20,28,27,27,27,0,0,0,0,0,0,185,185,67,0,118,0,0,0,0,0,0,0,0,0,12204
3221,19701,1405,6375,6912,2901,2108,1077,512,372,118,20,234,140,66,58,0,8,74,17,44,13,565,479,264,35,180,86,39,22,17,0,47,47,0,0,12205
3222,9085,1976,2645,2642,1021,801,1110,518,398,90,143,165,120,86,0,47,39,34,5,22,7,592,505,101,27,377,87,61,0,22,39,26,0,26,0,12206
3223,1287,390,418,289,134,56,72,72,66,17,10,39,6,0,0,0,0,6,0,6,0,0,0,0,0,0,0,0,0,0,0,0,0,0,0,12207
3224,14602,722,2854,3702,3800,3524,737,324,302,58,14,230,22,20,13,0,7,2,0,0,2,413,384,141,29,214,29,29,16,0,13,0,0,0,0,12208
3225,7051,706,2113,1894,1288,1050,491,344,286,68,0,218,58,0,0,0,0,58,0,0,58,147,126,95,15,16,21,21,0,0,21,0,0,0,0,12209
3226,6061,586,1805,1203,1573,894,634,250,250,41,0,209,0,0,0,0,0,0,0,0,0,384,278,92,0,186,106,91,53,21,17,15,0,0,15,12210
3227,8905,527,2190,1824,2107,2257,668,356,306,40,0,266,50,41,31,10,0,9,0,0,9,312,302,99,17,186,10,0,0,0,0,10,0,0,10,12211
3228,99,32,21,40,6,0,4053,2019,2019,275,89,1655,0,0,0,0,0,0,0,0,0,2034,2034,446,81,1507,0,0,0,0,0,0,0,0,0,12222
3229,19599,911,5577,6851,3421,2839,1245,670,521,255,41,225,149,85,26,45,14,64,34,8,22,575,520,258,24,238,55,55,47,8,0,0,0,0,0,12302
3230,20516,1754,6986,6077,3217,2482,1795,946,836,388,93,355,110,62,12,32,18,48,0,37,11,849,792,315,132,345,57,41,17,0,24,16,3,0,13,12303
3231,14698,2332,5428,4118,1682,1138,1045,576,540,92,80,368,36,36,28,8,0,0,0,0,0,469,365,111,7,247,104,58,50,8,0,46,23,0,23,12304
3232,3710,487,1129,1268,451,375,387,124,88,7,7,74,36,10,10,0,0,26,0,8,18,263,235,70,12,153,28,24,0,22,2,4,4,0,0,12305
3233,17966,1415,6344,6192,2557,1458,1390,610,545,263,69,213,65,49,49,0,0,16,6,0,10,780,651,305,4,342,129,90,71,14,5,39,0,10,29,12306
3234,4262,1294,1746,991,111,120,358,265,193,57,0,136,72,29,0,0,29,43,9,34,0,93,78,0,33,45,15,0,0,0,0,15,0,15,0,12307
3235,8547,1076,2294,2554,1486,1137,1351,730,594,117,25,452,136,75,13,31,31,61,0,22,39,621,566,147,37,382,55,24,24,0,0,31,31,0,0,12308
3236,20794,840,3733,4896,5500,5825,1442,800,735,280,128,327,65,54,33,9,12,11,11,0,0,642,583,157,36,390,59,59,34,23,2,0,0,0,0,12309
3237,24595,3819,7575,7642,3146,2413,2013,971,634,99,51,484,337,196,123,36,37,141,53,88,0,1042,660,200,59,401,382,188,126,34,28,194,0,123,71,12401
3238,2333,155,581,820,507,270,188,107,86,0,26,60,21,21,21,0,0,0,0,0,0,81,81,29,19,33,0,0,0,0,0,0,0,0,0,12404
3239,449,12,161,159,87,30,0,0,0,0,0,0,0,0,0,0,0,0,0,0,0,0,0,0,0,0,0,0,0,0,0,0,0,0,0,12405
3240,437,42,165,155,54,21,42,21,21,0,0,21,0,0,0,0,0,0,0,0,0,21,21,0,0,21,0,0,0,0,0,0,0,0,0,12406
3241,152,5,63,24,47,13,0,0,0,0,0,0,0,0,0,0,0,0,0,0,0,0,0,0,0,0,0,0,0,0,0,0,0,0,0,12407
3242,460,0,40,158,183,79,38,27,27,1,0,26,0,0,0,0,0,0,0,0,0,11,11,11,0,0,0,0,0,0,0,0,0,0,0,12409
3243,561,46,244,156,81,34,8,0,0,0,0,0,0,0,0,0,0,0,0,0,0,8,8,8,0,0,0,0,0,0,0,0,0,0,0,12410
3244,294,29,105,95,26,39,42,15,15,0,0,15,0,0,0,0,0,0,0,0,0,27,17,0,0,17,10,10,10,0,0,0,0,0,0,12411
3245,284,0,49,119,19,97,0,0,0,0,0,0,0,0,0,0,0,0,0,0,0,0,0,0,0,0,0,0,0,0,0,0,0,0,0,12412
3246,2069,425,800,502,165,177,106,14,14,14,0,0,0,0,0,0,0,0,0,0,0,92,45,9,20,16,47,17,0,0,17,30,0,0,30,12413
3247,7421,984,2986,2179,824,448,461,216,185,14,0,171,31,8,6,0,2,23,0,0,23,245,174,15,64,95,71,21,18,0,3,50,0,27,23,12414
3248,192,0,85,66,27,14,0,0,0,0,0,0,0,0,0,0,0,0,0,0,0,0,0,0,0,0,0,0,0,0,0,0,0,0,0,12416
3249,585,109,317,95,39,25,35,35,35,21,14,0,0,0,0,0,0,0,0,0,0,0,0,0,0,0,0,0,0,0,0,0,0,0,0,12417
3250,281,81,59,96,13,32,0,0,0,0,0,0,0,0,0,0,0,0,0,0,0,0,0,0,0,0,0,0,0,0,0,0,0,0,0,12418
3251,384,12,151,92,47,82,48,28,28,0,14,14,0,0,0,0,0,0,0,0,0,20,20,8,12,0,0,0,0,0,0,0,0,0,0,12419
3252,367,42,107,70,95,53,0,0,0,0,0,0,0,0,0,0,0,0,0,0,0,0,0,0,0,0,0,0,0,0,0,0,0,0,0,12420
3253,433,30,104,173,96,30,10,5,5,0,0,5,0,0,0,0,0,0,0,0,0,5,5,0,0,5,0,0,0,0,0,0,0,0,0,12421
3254,210,35,85,54,25,11,6,6,6,6,0,0,0,0,0,0,0,0,0,0,0,0,0,0,0,0,0,0,0,0,0,0,0,0,0,12422
3255,725,69,315,210,73,58,59,33,33,7,0,26,0,0,0,0,0,0,0,0,0,26,26,5,0,21,0,0,0,0,0,0,0,0,0,12423
3256,177,7,56,57,38,19,17,11,11,0,0,11,0,0,0,0,0,0,0,0,0,6,6,0,0,6,0,0,0,0,0,0,0,0,0,12424
3257,373,18,131,82,95,47,17,17,11,0,0,11,6,6,6,0,0,0,0,0,0,0,0,0,0,0,0,0,0,0,0,0,0,0,0,12427
3258,4309,876,1376,1168,497,392,402,221,191,15,19,157,30,30,0,11,19,0,0,0,0,181,146,16,44,86,35,23,13,0,10,12,0,11,1,12428
3259,212,0,114,19,0,79,46,46,46,0,46,0,0,0,0,0,0,0,0,0,0,0,0,0,0,0,0,0,0,0,0,0,0,0,0,12429
3260,758,60,368,149,141,40,27,8,8,6,0,2,0,0,0,0,0,0,0,0,0,19,14,4,3,7,5,5,5,0,0,0,0,0,0,12430
3261,1001,56,331,410,90,114,26,0,0,0,0,0,0,0,0,0,0,0,0,0,0,26,26,20,6,0,0,0,0,0,0,0,0,0,0,12431
3262,262,31,124,89,18,0,40,31,23,23,0,0,8,0,0,0,0,8,0,0,8,9,9,0,0,9,0,0,0,0,0,0,0,0,0,12432
3263,259,25,61,42,42,89,0,0,0,0,0,0,0,0,0,0,0,0,0,0,0,0,0,0,0,0,0,0,0,0,0,0,0,0,0,12433
3264,434,108,183,113,8,22,10,10,0,0,0,0,10,10,0,10,0,0,0,0,0,0,0,0,0,0,0,0,0,0,0,0,0,0,0,12434
3265,243,22,126,77,18,0,0,0,0,0,0,0,0,0,0,0,0,0,0,0,0,0,0,0,0,0,0,0,0,0,0,0,0,0,0,12435
3266,365,5,183,115,40,22,25,25,25,0,0,25,0,0,0,0,0,0,0,0,0,0,0,0,0,0,0,0,0,0,0,0,0,0,0,12436
3267,51,0,5,13,16,17,0,0,0,0,0,0,0,0,0,0,0,0,0,0,0,0,0,0,0,0,0,0,0,0,0,0,0,0,0,12438
3268,201,29,116,52,4,0,6,0,0,0,0,0,0,0,0,0,0,0,0,0,0,6,6,0,0,6,0,0,0,0,0,0,0,0,0,12439
3269,1502,82,337,383,383,317,140,54,29,0,12,17,25,25,0,0,25,0,0,0,0,86,86,13,0,73,0,0,0,0,0,0,0,0,0,12440
3270,23,0,0,0,0,23,0,0,0,0,0,0,0,0,0,0,0,0,0,0,0,0,0,0,0,0,0,0,0,0,0,0,0,0,0,12441
3271,729,99,212,81,177,160,63,32,32,8,0,24,0,0,0,0,0,0,0,0,0,31,27,16,5,6,4,4,4,0,0,0,0,0,0,12442
3272,2785,166,734,697,539,649,151,79,79,47,31,1,0,0,0,0,0,0,0,0,0,72,72,72,0,0,0,0,0,0,0,0,0,0,0,12443
3273,373,79,138,110,33,13,0,0,0,0,0,0,0,0,0,0,0,0,0,0,0,0,0,0,0,0,0,0,0,0,0,0,0,0,0,12444
3274,3486,626,911,987,679,283,280,183,164,27,0,137,19,19,0,19,0,0,0,0,0,97,97,84,7,6,0,0,0,0,0,0,0,0,0,12446
3275,313,0,22,76,79,136,0,0,0,0,0,0,0,0,0,0,0,0,0,0,0,0,0,0,0,0,0,0,0,0,0,0,0,0,0,12448
3276,2542,434,838,784,226,260,190,112,112,20,0,92,0,0,0,0,0,0,0,0,0,78,78,25,0,53,0,0,0,0,0,0,0,0,0,12449
3277,159,11,62,54,32,0,0,0,0,0,0,0,0,0,0,0,0,0,0,0,0,0,0,0,0,0,0,0,0,0,0,0,0,0,0,12450
3278,1269,152,494,402,187,34,127,60,28,0,0,28,32,0,0,0,0,32,10,0,22,67,51,0,0,51,16,16,16,0,0,0,0,0,0,12451
3279,244,56,68,58,34,28,19,8,8,0,4,4,0,0,0,0,0,0,0,0,0,11,6,6,0,0,5,0,0,0,0,5,5,0,0,12452
3280,243,0,173,27,27,16,20,20,20,20,0,0,0,0,0,0,0,0,0,0,0,0,0,0,0,0,0,0,0,0,0,0,0,0,0,12453
3281,156,9,23,50,53,21,19,6,6,0,0,6,0,0,0,0,0,0,0,0,0,13,13,10,0,3,0,0,0,0,0,0,0,0,0,12454
3282,1679,258,471,567,274,109,73,14,14,0,3,11,0,0,0,0,0,0,0,0,0,59,19,8,0,11,40,26,8,18,0,14,0,0,14,12455
3283,446,80,270,69,14,13,9,9,0,0,0,0,9,0,0,0,0,9,0,0,9,0,0,0,0,0,0,0,0,0,0,0,0,0,0,12456
3284,757,16,119,205,209,208,23,11,10,0,0,10,1,1,0,0,1,0,0,0,0,12,12,0,0,12,0,0,0,0,0,0,0,0,0,12457
3285,2911,634,928,963,246,140,102,50,31,0,3,28,19,14,7,0,7,5,0,0,5,52,52,34,0,18,0,0,0,0,0,0,0,0,0,12458
3286,180,0,0,102,57,21,0,0,0,0,0,0,0,0,0,0,0,0,0,0,0,0,0,0,0,0,0,0,0,0,0,0,0,0,0,12459
3287,199,11,86,51,0,51,16,16,0,0,0,0,16,16,0,0,16,0,0,0,0,0,0,0,0,0,0,0,0,0,0,0,0,0,0,12460
3288,1571,105,385,466,244,371,55,33,32,0,0,32,1,1,1,0,0,0,0,0,0,22,22,22,0,0,0,0,0,0,0,0,0,0,0,12461
3289,822,46,295,350,23,108,105,91,55,0,0,55,36,36,36,0,0,0,0,0,0,14,14,0,14,0,0,0,0,0,0,0,0,0,0,12463
3290,778,25,252,219,153,129,63,63,54,0,0,54,9,9,9,0,0,0,0,0,0,0,0,0,0,0,0,0,0,0,0,0,0,0,0,12464
3291,135,7,48,61,5,14,0,0,0,0,0,0,0,0,0,0,0,0,0,0,0,0,0,0,0,0,0,0,0,0,0,0,0,0,0,12465
3292,1709,134,456,519,320,280,84,45,21,10,0,11,24,0,0,0,0,24,0,24,0,39,39,0,23,16,0,0,0,0,0,0,0,0,0,12466
3293,818,132,400,162,75,49,36,15,15,0,0,15,0,0,0,0,0,0,0,0,0,21,15,2,0,13,6,0,0,0,0,6,0,0,6,12468
3294,575,73,269,115,63,55,15,5,5,0,0,5,0,0,0,0,0,0,0,0,0,10,6,0,0,6,4,4,0,0,4,0,0,0,0,12469
3295,546,93,216,166,18,53,16,9,9,0,0,9,0,0,0,0,0,0,0,0,0,7,7,7,0,0,0,0,0,0,0,0,0,0,0,12470
3296,424,30,62,151,74,107,0,0,0,0,0,0,0,0,0,0,0,0,0,0,0,0,0,0,0,0,0,0,0,0,0,0,0,0,0,12471
3297,1091,136,264,363,233,95,30,30,30,0,0,30,0,0,0,0,0,0,0,0,0,0,0,0,0,0,0,0,0,0,0,0,0,0,0,12472
3298,780,10,139,318,183,130,116,28,16,0,0,16,12,12,12,0,0,0,0,0,0,88,88,0,0,88,0,0,0,0,0,0,0,0,0,12473
3299,1086,146,301,372,160,107,80,46,25,8,0,17,21,0,0,0,0,21,0,0,21,34,34,17,0,17,0,0,0,0,0,0,0,0,0,12474
3300,271,31,140,66,0,34,0,0,0,0,0,0,0,0,0,0,0,0,0,0,0,0,0,0,0,0,0,0,0,0,0,0,0,0,0,12475
3301,13718,1247,4072,4743,1920,1736,951,578,493,162,109,222,85,59,59,0,0,26,18,0,8,373,333,152,45,136,40,40,12,0,28,0,0,0,0,12477
3302,388,71,183,61,35,38,7,3,3,0,0,3,0,0,0,0,0,0,0,0,0,4,4,0,0,4,0,0,0,0,0,0,0,0,0,12480
3303,903,47,239,245,101,271,93,38,38,20,0,18,0,0,0,0,0,0,0,0,0,55,55,12,0,43,0,0,0,0,0,0,0,0,0,12481
3304,554,109,228,123,84,10,35,35,0,0,0,0,35,35,35,0,0,0,0,0,0,0,0,0,0,0,0,0,0,0,0,0,0,0,0,12482
3305,316,43,68,177,28,0,11,11,11,0,11,0,0,0,0,0,0,0,0,0,0,0,0,0,0,0,0,0,0,0,0,0,0,0,0,12483
3306,2053,40,352,584,523,554,299,72,72,19,0,53,0,0,0,0,0,0,0,0,0,227,163,34,20,109,64,64,64,0,0,0,0,0,0,12484
3307,496,81,130,195,61,29,37,15,5,0,0,5,10,10,0,0,10,0,0,0,0,22,11,5,0,6,11,0,0,0,0,11,0,0,11,12485
3308,977,81,242,325,251,78,81,50,50,9,0,41,0,0,0,0,0,0,0,0,0,31,31,0,10,21,0,0,0,0,0,0,0,0,0,12486
3309,2332,202,830,628,427,245,172,106,38,0,38,0,68,68,6,62,0,0,0,0,0,66,66,60,0,6,0,0,0,0,0,0,0,0,0,12487
3310,749,249,282,161,37,20,6,6,6,0,0,6,0,0,0,0,0,0,0,0,0,0,0,0,0,0,0,0,0,0,0,0,0,0,0,12489
3311,67,0,0,47,20,0,0,0,0,0,0,0,0,0,0,0,0,0,0,0,0,0,0,0,0,0,0,0,0,0,0,0,0,0,0,12490
3312,1446,101,432,358,252,303,55,5,0,0,0,0,5,5,5,0,0,0,0,0,0,50,50,27,0,23,0,0,0,0,0,0,0,0,0,12491
3313,282,23,71,130,44,14,29,17,6,0,0,6,11,11,0,0,11,0,0,0,0,12,12,12,0,0,0,0,0,0,0,0,0,0,0,12492
3314,144,25,35,42,0,42,9,0,0,0,0,0,0,0,0,0,0,0,0,0,0,9,7,0,0,7,2,0,0,0,0,2,0,0,2,12493
3315,709,66,277,178,58,130,129,46,46,0,0,46,0,0,0,0,0,0,0,0,0,83,83,69,0,14,0,0,0,0,0,0,0,0,0,12494
3316,216,70,0,65,46,35,0,0,0,0,0,0,0,0,0,0,0,0,0,0,0,0,0,0,0,0,0,0,0,0,0,0,0,0,0,12495
3317,1380,133,569,356,108,214,25,20,20,0,0,20,0,0,0,0,0,0,0,0,0,5,5,5,0,0,0,0,0,0,0,0,0,0,0,12496
3318,4089,190,598,1074,1115,1112,268,120,120,43,0,77,0,0,0,0,0,0,0,0,0,148,148,41,0,107,0,0,0,0,0,0,0,0,0,12498
3319,1561,267,442,552,210,90,116,52,52,14,34,4,0,0,0,0,0,0,0,0,0,64,63,13,0,50,1,0,0,0,0,1,0,0,1,12501
3320,868,119,289,223,131,106,34,29,29,22,3,4,0,0,0,0,0,0,0,0,0,5,0,0,0,0,5,5,5,0,0,0,0,0,0,12502
3321,591,89,232,84,77,109,41,28,28,17,3,8,0,0,0,0,0,0,0,0,0,13,13,0,2,11,0,0,0,0,0,0,0,0,0,12503
3322,98,4,32,6,43,13,634,238,238,91,0,147,0,0,0,0,0,0,0,0,0,396,396,146,1,249,0,0,0,0,0,0,0,0,0,12504
3323,82,7,27,0,21,27,77,42,42,9,0,33,0,0,0,0,0,0,0,0,0,35,35,4,0,31,0,0,0,0,0,0,0,0,0,12507
3324,14379,1685,4775,3969,2182,1768,1138,508,446,99,0,347,62,50,33,17,0,12,0,0,12,630,487,197,108,182,143,130,89,32,9,13,0,0,13,12508
3325,115,0,14,55,5,41,0,0,0,0,0,0,0,0,0,0,0,0,0,0,0,0,0,0,0,0,0,0,0,0,0,0,0,0,0,12512
3326,437,119,80,92,63,83,0,0,0,0,0,0,0,0,0,0,0,0,0,0,0,0,0,0,0,0,0,0,0,0,0,0,0,0,0,12513
3327,1991,52,632,539,455,313,195,116,116,12,36,68,0,0,0,0,0,0,0,0,0,79,56,38,0,18,23,23,23,0,0,0,0,0,0,12514
3328,1011,170,187,265,226,163,84,38,38,11,0,27,0,0,0,0,0,0,0,0,0,46,46,0,0,46,0,0,0,0,0,0,0,0,0,12515
3329,1625,188,544,418,210,265,154,37,21,0,0,21,16,0,0,0,0,16,0,0,16,117,117,32,0,85,0,0,0,0,0,0,0,0,0,12516
3330,462,55,135,146,121,5,19,9,9,0,0,9,0,0,0,0,0,0,0,0,0,10,10,10,0,0,0,0,0,0,0,0,0,0,0,12517
3331,4051,311,1061,1044,735,900,303,191,174,31,0,143,17,0,0,0,0,17,0,9,8,112,110,38,0,72,2,2,0,0,2,0,0,0,0,12518
3332,2101,65,312,500,407,817,145,84,84,32,7,45,0,0,0,0,0,0,0,0,0,61,61,10,3,48,0,0,0,0,0,0,0,0,0,12520
3333,1036,91,394,325,102,124,97,54,54,4,0,50,0,0,0,0,0,0,0,0,0,43,37,0,17,20,6,6,6,0,0,0,0,0,0,12521
3334,3763,729,1470,1043,252,269,289,189,167,62,17,88,22,22,0,16,6,0,0,0,0,100,100,31,0,69,0,0,0,0,0,0,0,0,0,12522
3335,1255,184,423,323,156,169,92,49,34,14,0,20,15,0,0,0,0,15,0,10,5,43,35,11,15,9,8,8,4,4,0,0,0,0,0,12523
3336,11296,1045,3635,2948,2289,1379,752,325,268,163,5,100,57,36,21,0,15,21,0,0,21,427,387,89,7,291,40,40,13,27,0,0,0,0,0,12524
3337,2004,184,453,528,456,383,208,110,110,17,44,49,0,0,0,0,0,0,0,0,0,98,69,18,0,51,29,17,3,14,0,12,0,0,12,12525
3338,2667,261,905,720,370,411,194,75,62,20,4,38,13,2,2,0,0,11,6,0,5,119,113,32,19,62,6,3,0,0,3,3,0,3,0,12526
3339,78,0,0,10,36,32,9,0,0,0,0,0,0,0,0,0,0,0,0,0,0,9,9,9,0,0,0,0,0,0,0,0,0,0,0,12527
3340,9087,1150,2526,2548,1517,1346,498,236,223,47,66,110,13,13,13,0,0,0,0,0,0,262,262,132,31,99,0,0,0,0,0,0,0,0,0,12528
3341,1964,262,369,603,241,489,114,52,52,25,0,27,0,0,0,0,0,0,0,0,0,62,51,1,0,50,11,11,0,0,11,0,0,0,0,12529
3342,8,8,0,0,0,0,0,0,0,0,0,0,0,0,0,0,0,0,0,0,0,0,0,0,0,0,0,0,0,0,0,0,0,0,0,12530
3343,2375,138,785,684,357,411,159,106,106,71,0,35,0,0,0,0,0,0,0,0,0,53,53,0,14,39,0,0,0,0,0,0,0,0,0,12531
3344,17086,1318,4360,4241,3803,3364,1384,744,692,109,31,552,52,40,7,15,18,12,0,12,0,640,627,132,94,401,13,0,0,0,0,13,13,0,0,12533
3345,12836,2614,3900,3751,1435,1136,866,533,381,61,14,306,152,42,34,0,8,110,0,0,110,333,258,111,0,147,75,50,26,0,24,25,15,0,10,12534
3346,9126,735,2481,2833,1528,1549,1121,575,554,106,66,382,21,20,0,20,0,1,0,0,1,546,531,189,30,312,15,15,0,0,15,0,0,0,0,12538
3347,4985,224,1347,1511,1082,821,462,282,260,100,12,148,22,0,0,0,0,22,0,21,1,180,180,69,11,100,0,0,0,0,0,0,0,0,0,12540
3348,4102,450,1450,1155,582,465,495,201,137,0,22,115,64,44,44,0,0,20,20,0,0,294,243,66,0,177,51,37,37,0,0,14,0,0,14,12542
3349,1923,243,657,602,297,124,201,104,104,43,5,56,0,0,0,0,0,0,0,0,0,97,81,44,9,28,16,16,11,0,5,0,0,0,0,12543
3350,3386,424,769,1056,571,566,217,129,103,19,7,77,26,0,0,0,0,26,0,0,26,88,88,2,8,78,0,0,0,0,0,0,0,0,0,12545
3351,2239,270,695,635,382,257,143,83,83,36,4,43,0,0,0,0,0,0,0,0,0,60,60,3,3,54,0,0,0,0,0,0,0,0,0,12546
3352,1907,160,616,555,319,257,129,71,64,0,28,36,7,7,7,0,0,0,0,0,0,58,58,25,11,22,0,0,0,0,0,0,0,0,0,12547
3353,964,119,526,157,80,82,164,123,123,40,38,45,0,0,0,0,0,0,0,0,0,41,41,27,0,14,0,0,0,0,0,0,0,0,0,12548
3354,6783,417,2043,2305,1244,774,554,248,236,70,24,142,12,12,12,0,0,0,0,0,0,306,250,86,34,130,56,16,16,0,0,40,40,0,0,12549
3355,33995,6819,11188,8647,4176,3165,3733,1721,1506,176,132,1198,215,137,99,24,14,78,27,30,21,2012,1664,415,41,1208,348,197,118,28,51,151,66,6,79,12550
3356,17093,2081,4627,5199,3143,2043,1495,920,805,236,35,534,115,86,20,52,14,29,0,13,16,575,491,195,42,254,84,69,36,7,26,15,15,0,0,12553
3357,10158,745,1943,2481,2217,2772,2107,879,831,210,42,579,48,48,32,0,16,0,0,0,0,1228,1201,223,171,807,27,11,11,0,0,16,9,0,7,12561
3358,5387,429,1959,1423,999,577,499,215,215,42,14,159,0,0,0,0,0,0,0,0,0,284,249,73,0,176,35,35,0,0,35,0,0,0,0,12563
3359,5093,447,1373,1372,1081,820,451,245,229,39,35,155,16,16,16,0,0,0,0,0,0,206,189,101,0,88,17,17,17,0,0,0,0,0,0,12564
3360,1037,187,367,333,78,72,120,62,42,0,0,42,20,3,3,0,0,17,0,15,2,58,34,12,13,9,24,20,0,0,20,4,4,0,0,12565
3361,7564,896,1994,2613,1140,921,566,413,313,75,75,163,100,86,86,0,0,14,0,14,0,153,139,53,0,86,14,14,0,14,0,0,0,0,0,12566
3362,2068,214,629,761,260,204,140,75,48,0,0,48,27,0,0,0,0,27,11,0,16,65,54,17,9,28,11,0,0,0,0,11,0,0,11,12567
3363,6572,618,1834,2102,961,1057,489,272,252,67,38,147,20,20,20,0,0,0,0,0,0,217,192,36,58,98,25,12,0,0,12,13,0,0,13,12569
3364,4998,211,1222,1400,1191,974,626,397,330,117,0,213,67,67,0,0,67,0,0,0,0,229,194,101,10,83,35,9,9,0,0,26,0,0,26,12570
3365,6959,343,1500,2039,1314,1763,724,388,356,80,60,216,32,26,5,0,21,6,5,0,1,336,331,119,45,167,5,5,0,5,0,0,0,0,0,12571
3366,7002,620,1386,1729,1572,1695,212,104,102,11,0,91,2,0,0,0,0,2,0,0,2,108,108,5,6,97,0,0,0,0,0,0,0,0,0,12572
3367,394,8,135,59,81,111,5,0,0,0,0,0,0,0,0,0,0,0,0,0,0,5,5,5,0,0,0,0,0,0,0,0,0,0,0,12574
3368,1201,34,147,475,303,242,111,75,75,36,13,26,0,0,0,0,0,0,0,0,0,36,27,27,0,0,9,9,0,0,9,0,0,0,0,12575
3369,834,10,250,229,179,166,136,76,76,0,22,54,0,0,0,0,0,0,0,0,0,60,60,22,0,38,0,0,0,0,0,0,0,0,0,12577
3370,1944,100,642,578,354,270,144,82,82,0,0,82,0,0,0,0,0,0,0,0,0,62,41,22,0,19,21,21,21,0,0,0,0,0,0,12578
3371,3032,433,749,803,518,529,269,164,151,75,38,38,13,13,0,0,13,0,0,0,0,105,93,54,0,39,12,0,0,0,0,12,12,0,0,12580
3372,1584,93,430,616,242,203,105,67,67,9,0,58,0,0,0,0,0,0,0,0,0,38,38,0,5,33,0,0,0,0,0,0,0,0,0,12581
3373,4598,695,1476,1423,559,445,396,253,244,66,28,150,9,9,0,0,9,0,0,0,0,143,120,18,0,102,23,23,0,23,0,0,0,0,0,12582
3374,1448,210,401,335,304,198,277,172,151,19,0,132,21,21,21,0,0,0,0,0,0,105,92,21,0,71,13,13,13,0,0,0,0,0,0,12583
3375,597,19,191,200,77,110,75,22,22,0,10,12,0,0,0,0,0,0,0,0,0,53,53,10,0,43,0,0,0,0,0,0,0,0,0,12585
3376,8259,857,2691,2570,1096,1045,858,394,394,116,0,278,0,0,0,0,0,0,0,0,0,464,431,151,79,201,33,33,33,0,0,0,0,0,0,12586
3377,12746,1159,4959,3945,1594,1089,964,517,427,147,33,247,90,79,28,0,51,11,11,0,0,447,429,188,33,208,18,18,0,18,0,0,0,0,0,12589
3378,24198,2275,6671,6961,4948,3343,2149,1206,1103,394,246,463,103,89,12,77,0,14,14,0,0,943,931,251,82,598,12,7,0,0,7,5,5,0,0,12590
3379,996,142,292,285,139,138,88,76,45,0,0,45,31,31,31,0,0,0,0,0,0,12,12,0,0,12,0,0,0,0,0,0,0,0,0,12592
3380,2881,344,1195,852,307,183,440,245,216,7,34,175,29,29,29,0,0,0,0,0,0,195,186,27,13,146,9,9,0,9,0,0,0,0,0,12594
3381,26241,5210,7764,7958,2925,2384,3845,1823,1544,373,195,976,279,185,118,39,28,94,11,22,61,2022,1886,578,226,1082,136,70,21,49,0,66,12,0,54,12601
3382,29160,2249,6838,8923,6291,4859,2752,1340,1299,343,122,834,41,33,24,9,0,8,8,0,0,1412,1349,495,103,751,63,63,34,29,0,0,0,0,0,12603
3383,18,0,0,0,9,9,366,78,78,35,0,43,0,0,0,0,0,0,0,0,0,288,288,67,0,221,0,0,0,0,0,0,0,0,0,12604
3384,7349,1586,2434,2188,658,483,564,291,224,47,24,153,67,17,0,17,0,50,22,12,16,273,154,65,0,89,119,90,45,0,45,29,0,0,29,12701
3385,936,103,273,332,136,92,59,39,39,0,0,39,0,0,0,0,0,0,0,0,0,20,20,12,0,8,0,0,0,0,0,0,0,0,0,12719
3386,169,0,56,56,57,0,0,0,0,0,0,0,0,0,0,0,0,0,0,0,0,0,0,0,0,0,0,0,0,0,0,0,0,0,0,12720
3387,4009,332,1732,1019,516,410,403,217,168,36,0,132,49,49,0,4,45,0,0,0,0,186,157,28,56,73,29,2,0,2,0,27,0,0,27,12721
3388,103,9,38,56,0,0,26,0,0,0,0,0,0,0,0,0,0,0,0,0,0,26,26,0,0,26,0,0,0,0,0,0,0,0,0,12722
3389,1571,154,519,578,172,148,170,70,70,12,0,58,0,0,0,0,0,0,0,0,0,100,51,7,8,36,49,13,0,0,13,36,0,0,36,12723
3390,247,18,146,10,32,41,25,0,0,0,0,0,0,0,0,0,0,0,0,0,0,25,25,0,25,0,0,0,0,0,0,0,0,0,0,12724
3391,150,29,22,33,34,32,11,7,7,0,7,0,0,0,0,0,0,0,0,0,0,4,4,4,0,0,0,0,0,0,0,0,0,0,0,12725
3392,875,78,340,283,105,69,29,23,23,10,1,12,0,0,0,0,0,0,0,0,0,6,6,6,0,0,0,0,0,0,0,0,0,0,0,12726
3393,1384,212,638,327,152,55,118,31,31,6,0,25,0,0,0,0,0,0,0,0,0,87,13,0,0,13,74,12,0,12,0,62,0,0,62,12729
3394,506,90,177,109,83,47,35,7,7,7,0,0,0,0,0,0,0,0,0,0,0,28,24,0,0,24,4,4,0,0,4,0,0,0,0,12732
3395,884,238,332,227,50,37,31,14,11,9,0,2,3,3,0,0,3,0,0,0,0,17,11,0,0,11,6,6,0,0,6,0,0,0,0,12733
3396,638,98,139,206,134,61,39,15,15,15,0,0,0,0,0,0,0,0,0,0,0,24,24,0,13,11,0,0,0,0,0,0,0,0,0,12734
3397,135,6,74,43,2,10,10,10,10,10,0,0,0,0,0,0,0,0,0,0,0,0,0,0,0,0,0,0,0,0,0,0,0,0,0,12736
3398,1420,128,527,418,204,143,134,81,81,24,14,43,0,0,0,0,0,0,0,0,0,53,38,0,5,33,15,4,0,0,4,11,0,0,11,12737
3399,505,13,92,98,216,86,0,0,0,0,0,0,0,0,0,0,0,0,0,0,0,0,0,0,0,0,0,0,0,0,0,0,0,0,0,12738
3400,1131,101,316,446,136,132,74,49,17,0,0,17,32,10,0,10,0,22,0,0,22,25,25,7,0,18,0,0,0,0,0,0,0,0,0,12740
3401,248,26,63,57,51,51,25,14,14,4,0,10,0,0,0,0,0,0,0,0,0,11,3,0,0,3,8,8,0,0,8,0,0,0,0,12741
3402,183,35,81,44,2,21,0,0,0,0,0,0,0,0,0,0,0,0,0,0,0,0,0,0,0,0,0,0,0,0,0,0,0,0,0,12742
3403,261,39,89,62,23,48,8,0,0,0,0,0,0,0,0,0,0,0,0,0,0,8,8,0,0,8,0,0,0,0,0,0,0,0,0,12743
3404,86,0,74,8,4,0,0,0,0,0,0,0,0,0,0,0,0,0,0,0,0,0,0,0,0,0,0,0,0,0,0,0,0,0,0,12745
3405,780,170,259,237,65,49,104,71,27,0,0,27,44,44,0,0,44,0,0,0,0,33,20,0,0,20,13,13,0,13,0,0,0,0,0,12746
3406,937,153,320,218,133,113,139,39,39,0,0,39,0,0,0,0,0,0,0,0,0,100,58,0,0,58,42,15,0,0,15,27,0,0,27,12747
3407,1344,244,471,313,202,114,128,83,72,35,0,37,11,0,0,0,0,11,0,0,11,45,45,5,4,36,0,0,0,0,0,0,0,0,0,12748
3408,156,0,90,13,46,7,0,0,0,0,0,0,0,0,0,0,0,0,0,0,0,0,0,0,0,0,0,0,0,0,0,0,0,0,0,12749
3409,57,5,26,18,8,0,7,7,7,0,0,7,0,0,0,0,0,0,0,0,0,0,0,0,0,0,0,0,0,0,0,0,0,0,0,12750
3410,504,57,198,204,12,33,0,0,0,0,0,0,0,0,0,0,0,0,0,0,0,0,0,0,0,0,0,0,0,0,0,0,0,0,0,12751
3411,120,4,53,41,22,0,16,8,8,0,0,8,0,0,0,0,0,0,0,0,0,8,8,0,0,8,0,0,0,0,0,0,0,0,0,12752
3412,5223,1045,1777,1560,507,334,352,268,260,32,28,200,8,8,8,0,0,0,0,0,0,84,73,34,19,20,11,11,11,0,0,0,0,0,0,12754
3413,2941,383,992,859,378,329,137,81,81,13,3,65,0,0,0,0,0,0,0,0,0,56,55,14,0,41,1,1,1,0,0,0,0,0,0,12758
3414,1157,259,306,422,100,70,351,188,155,0,24,131,33,33,0,0,33,0,0,0,0,163,163,28,8,127,0,0,0,0,0,0,0,0,0,12759
3415,459,104,161,130,13,51,40,13,13,4,0,9,0,0,0,0,0,0,0,0,0,27,27,0,27,0,0,0,0,0,0,0,0,0,0,12760
3416,244,60,90,28,21,45,0,0,0,0,0,0,0,0,0,0,0,0,0,0,0,0,0,0,0,0,0,0,0,0,0,0,0,0,0,12762
3417,529,74,164,215,36,40,82,9,9,9,0,0,0,0,0,0,0,0,0,0,0,73,48,0,0,48,25,25,25,0,0,0,0,0,0,12763
3418,1262,168,417,330,201,146,97,63,57,4,2,51,6,0,0,0,0,6,0,6,0,34,28,1,0,27,6,0,0,0,0,6,0,0,6,12764
3419,524,55,171,182,55,61,75,0,0,0,0,0,0,0,0,0,0,0,0,0,0,75,40,0,13,27,35,26,26,0,0,9,0,0,9,12765
3420,372,34,178,109,0,51,0,0,0,0,0,0,0,0,0,0,0,0,0,0,0,0,0,0,0,0,0,0,0,0,0,0,0,0,0,12766
3421,69,10,41,18,0,0,7,0,0,0,0,0,0,0,0,0,0,0,0,0,0,7,7,0,0,7,0,0,0,0,0,0,0,0,0,12767
3422,540,96,156,205,51,32,36,10,0,0,0,0,10,0,0,0,0,10,0,0,10,26,18,0,0,18,8,8,8,0,0,0,0,0,0,12768
3423,133,0,76,22,26,9,0,0,0,0,0,0,0,0,0,0,0,0,0,0,0,0,0,0,0,0,0,0,0,0,0,0,0,0,0,12769
3424,196,4,50,122,16,4,0,0,0,0,0,0,0,0,0,0,0,0,0,0,0,0,0,0,0,0,0,0,0,0,0,0,0,0,0,12770
3425,9327,1494,3612,2530,1098,593,801,393,334,25,0,309,59,53,50,0,3,6,0,0,6,408,388,162,30,196,20,10,10,0,0,10,0,10,0,12771
3426,1516,78,407,477,278,276,114,74,69,6,0,63,5,5,5,0,0,0,0,0,0,40,40,0,0,40,0,0,0,0,0,0,0,0,0,12775
3427,1592,185,512,455,318,122,57,34,29,3,0,26,5,5,5,0,0,0,0,0,0,23,13,7,0,6,10,0,0,0,0,10,0,0,10,12776
3428,679,89,157,210,88,135,21,5,5,0,0,5,0,0,0,0,0,0,0,0,0,16,14,8,0,6,2,0,0,0,0,2,2,0,0,12777
3429,174,0,53,81,18,22,0,0,0,0,0,0,0,0,0,0,0,0,0,0,0,0,0,0,0,0,0,0,0,0,0,0,0,0,0,12778
3430,1150,418,313,185,68,166,90,68,57,23,0,34,11,0,0,0,0,11,0,11,0,22,10,0,0,10,12,0,0,0,0,12,0,0,12,12779
3431,1495,167,657,382,140,149,128,7,0,0,0,0,7,7,0,0,7,0,0,0,0,121,114,8,0,106,7,7,6,0,1,0,0,0,0,12780
3432,248,23,133,81,11,0,25,0,0,0,0,0,0,0,0,0,0,0,0,0,0,25,25,0,25,0,0,0,0,0,0,0,0,0,0,12781
3433,1515,303,506,411,170,125,53,53,53,8,39,6,0,0,0,0,0,0,0,0,0,0,0,0,0,0,0,0,0,0,0,0,0,0,0,12783
3434,90,13,35,22,20,0,0,0,0,0,0,0,0,0,0,0,0,0,0,0,0,0,0,0,0,0,0,0,0,0,0,0,0,0,0,12784
3435,811,135,388,123,135,30,0,0,0,0,0,0,0,0,0,0,0,0,0,0,0,0,0,0,0,0,0,0,0,0,0,0,0,0,0,12785
3436,503,96,16,240,100,51,70,26,26,0,26,0,0,0,0,0,0,0,0,0,0,44,44,0,0,44,0,0,0,0,0,0,0,0,0,12786
3437,334,67,92,46,45,84,0,0,0,0,0,0,0,0,0,0,0,0,0,0,0,0,0,0,0,0,0,0,0,0,0,0,0,0,0,12787
3438,2407,484,914,720,158,131,298,172,172,31,22,119,0,0,0,0,0,0,0,0,0,126,126,69,0,57,0,0,0,0,0,0,0,0,0,12788
3439,1244,188,403,372,110,171,141,67,65,3,0,62,2,0,0,0,0,2,0,0,2,74,74,22,0,52,0,0,0,0,0,0,0,0,0,12789
3440,3416,544,1096,1212,317,247,185,124,120,0,8,112,4,4,0,4,0,0,0,0,0,61,61,29,3,29,0,0,0,0,0,0,0,0,0,12790
3441,451,44,119,160,85,43,0,0,0,0,0,0,0,0,0,0,0,0,0,0,0,0,0,0,0,0,0,0,0,0,0,0,0,0,0,12791
3442,272,29,76,74,77,16,0,0,0,0,0,0,0,0,0,0,0,0,0,0,0,0,0,0,0,0,0,0,0,0,0,0,0,0,0,12792
3443,10505,1096,3711,3032,1618,1048,808,414,319,72,43,204,95,50,43,0,7,45,0,0,45,394,330,134,65,131,64,58,32,0,26,6,0,6,0,12801
3444,5722,455,2298,2004,559,406,495,222,215,41,26,148,7,7,7,0,0,0,0,0,0,273,252,123,7,122,21,21,21,0,0,0,0,0,0,12803
3445,18537,1342,5693,5678,3232,2592,1412,701,550,163,64,323,151,106,86,20,0,45,0,0,45,711,637,254,53,330,74,67,50,0,17,7,0,0,7,12804
3446,360,28,117,90,41,84,4,4,4,0,0,4,0,0,0,0,0,0,0,0,0,0,0,0,0,0,0,0,0,0,0,0,0,0,0,12808
3447,2675,282,1409,514,245,225,138,70,63,9,7,47,7,7,7,0,0,0,0,0,0,68,49,0,0,49,19,19,6,13,0,0,0,0,0,12809
3448,392,86,168,94,16,28,27,15,15,0,0,15,0,0,0,0,0,0,0,0,0,12,12,2,0,10,0,0,0,0,0,0,0,0,0,12810
3449,170,48,116,6,0,0,12,0,0,0,0,0,0,0,0,0,0,0,0,0,0,12,12,0,12,0,0,0,0,0,0,0,0,0,0,12811
3450,119,6,34,37,32,10,21,11,11,7,0,4,0,0,0,0,0,0,0,0,0,10,10,10,0,0,0,0,0,0,0,0,0,0,0,12812
3451,1233,51,437,323,323,99,58,15,15,0,9,6,0,0,0,0,0,0,0,0,0,43,40,3,7,30,3,3,3,0,0,0,0,0,0,12814
3452,725,82,277,171,103,92,51,12,4,0,0,4,8,0,0,0,0,8,0,0,8,39,33,1,0,32,6,6,6,0,0,0,0,0,0,12815
3453,3293,464,1060,857,473,439,204,100,81,0,13,68,19,19,11,4,4,0,0,0,0,104,101,45,2,54,3,3,0,3,0,0,0,0,0,12816
3454,1470,113,483,436,205,233,93,55,37,0,0,37,18,0,0,0,0,18,0,0,18,38,38,14,0,24,0,0,0,0,0,0,0,0,0,12817
3455,276,27,87,114,9,39,13,2,2,2,0,0,0,0,0,0,0,0,0,0,0,11,11,5,0,6,0,0,0,0,0,0,0,0,0,12819
3456,1516,434,712,316,49,5,159,159,95,0,0,95,64,45,0,0,45,19,0,0,19,0,0,0,0,0,0,0,0,0,0,0,0,0,0,12821
3457,4289,479,1960,1129,551,170,381,132,110,30,0,80,22,13,7,0,6,9,9,0,0,249,233,64,0,169,16,16,5,0,11,0,0,0,0,12822
3458,135,17,64,21,33,0,25,25,25,0,0,25,0,0,0,0,0,0,0,0,0,0,0,0,0,0,0,0,0,0,0,0,0,0,0,12823
3459,735,42,193,195,157,148,35,26,26,0,0,26,0,0,0,0,0,0,0,0,0,9,9,0,0,9,0,0,0,0,0,0,0,0,0,12824
3460,2714,303,1165,750,260,236,189,103,99,31,4,64,4,4,4,0,0,0,0,0,0,86,63,36,0,27,23,14,14,0,0,9,0,9,0,12827
3461,7085,655,3377,1944,715,394,378,251,215,91,16,108,36,19,8,11,0,17,0,0,17,127,125,27,16,82,2,0,0,0,0,2,0,0,2,12828
3462,12278,843,3864,3818,1907,1846,761,269,233,100,12,121,36,31,31,0,0,5,0,0,5,492,438,105,9,324,54,54,54,0,0,0,0,0,0,12831
3463,4503,593,2050,1263,359,238,336,174,148,28,0,120,26,26,17,5,4,0,0,0,0,162,96,35,0,61,66,65,24,32,9,1,0,0,1,12832
3464,3087,400,822,1005,547,313,124,40,40,30,0,10,0,0,0,0,0,0,0,0,0,84,84,8,28,48,0,0,0,0,0,0,0,0,0,12833
3465,4735,454,1627,1362,724,568,374,170,152,45,34,73,18,0,0,0,0,18,0,16,2,204,185,53,6,126,19,19,19,0,0,0,0,0,0,12834
3466,1812,239,805,502,169,97,127,72,51,17,4,30,21,21,0,0,21,0,0,0,0,55,53,18,0,35,2,2,0,2,0,0,0,0,0,12835
3467,537,72,177,123,99,66,14,6,6,6,0,0,0,0,0,0,0,0,0,0,0,8,8,2,0,6,0,0,0,0,0,0,0,0,0,12836
3468,713,88,363,197,58,7,17,6,2,0,0,2,4,4,4,0,0,0,0,0,0,11,11,0,2,9,0,0,0,0,0,0,0,0,0,12837
3469,426,52,129,166,61,18,11,8,8,8,0,0,0,0,0,0,0,0,0,0,0,3,3,0,3,0,0,0,0,0,0,0,0,0,0,12838
3470,9035,1213,4080,2360,904,478,689,372,305,63,85,157,67,54,16,34,4,13,0,5,8,317,217,131,0,86,100,36,12,11,13,64,0,55,9,12839
3471,118,10,13,27,31,37,0,0,0,0,0,0,0,0,0,0,0,0,0,0,0,0,0,0,0,0,0,0,0,0,0,0,0,0,0,12841
3472,822,76,378,135,123,110,39,34,34,17,0,17,0,0,0,0,0,0,0,0,0,5,5,5,0,0,0,0,0,0,0,0,0,0,0,12842
3473,329,36,151,68,36,38,10,5,5,5,0,0,0,0,0,0,0,0,0,0,0,5,5,0,0,5,0,0,0,0,0,0,0,0,0,12843
3474,171,2,37,55,55,22,43,19,18,7,0,11,1,0,0,0,0,1,0,0,1,24,24,7,7,10,0,0,0,0,0,0,0,0,0,12844
3475,3852,261,985,1133,698,775,237,108,82,9,0,73,26,26,18,8,0,0,0,0,0,129,116,32,0,84,13,7,7,0,0,6,6,0,0,12845
3476,2420,226,1014,765,247,168,245,69,54,12,13,29,15,15,0,0,15,0,0,0,0,176,162,16,0,146,14,14,8,0,6,0,0,0,0,12846
3477,422,59,87,147,49,80,45,34,34,16,0,18,0,0,0,0,0,0,0,0,0,11,11,0,0,11,0,0,0,0,0,0,0,0,0,12847
3478,331,59,232,26,14,0,105,0,0,0,0,0,0,0,0,0,0,0,0,0,0,105,90,55,35,0,15,15,15,0,0,0,0,0,0,12849
3479,1989,128,523,678,361,299,226,144,80,14,19,47,64,64,64,0,0,0,0,0,0,82,77,43,0,34,5,5,5,0,0,0,0,0,0,12850
3480,166,26,58,50,12,20,10,6,6,3,0,3,0,0,0,0,0,0,0,0,0,4,4,0,0,4,0,0,0,0,0,0,0,0,0,12851
3481,349,52,135,87,18,57,23,15,15,10,0,5,0,0,0,0,0,0,0,0,0,8,8,3,0,5,0,0,0,0,0,0,0,0,0,12852
3482,1062,193,429,270,113,57,49,43,37,16,0,21,6,6,0,6,0,0,0,0,0,6,0,0,0,0,6,0,0,0,0,6,0,6,0,12853
3483,105,10,47,30,14,4,6,2,2,2,0,0,0,0,0,0,0,0,0,0,0,4,4,0,0,4,0,0,0,0,0,0,0,0,0,12855
3484,67,16,32,0,0,19,6,6,6,0,0,6,0,0,0,0,0,0,0,0,0,0,0,0,0,0,0,0,0,0,0,0,0,0,0,12856
3485,383,55,125,132,43,28,19,2,2,0,0,2,0,0,0,0,0,0,0,0,0,17,14,0,0,14,3,0,0,0,0,3,0,0,3,12857
3486,51,4,4,8,10,25,0,0,0,0,0,0,0,0,0,0,0,0,0,0,0,0,0,0,0,0,0,0,0,0,0,0,0,0,0,12858
3487,1592,173,493,432,304,190,117,52,42,16,0,26,10,0,0,0,0,10,0,10,0,65,65,28,0,37,0,0,0,0,0,0,0,0,0,12859
3488,435,72,194,109,43,17,224,150,115,35,8,72,35,35,35,0,0,0,0,0,0,74,74,11,8,55,0,0,0,0,0,0,0,0,0,12860
3489,485,54,183,129,65,54,43,16,10,0,0,10,6,6,1,5,0,0,0,0,0,27,26,0,0,26,1,0,0,0,0,1,1,0,0,12861
3490,0,0,0,0,0,0,0,0,0,0,0,0,0,0,0,0,0,0,0,0,0,0,0,0,0,0,0,0,0,0,0,0,0,0,0,12862
3491,511,29,220,179,52,31,13,13,0,0,0,0,13,13,13,0,0,0,0,0,0,0,0,0,0,0,0,0,0,0,0,0,0,0,0,12863
3492,71,0,13,37,21,0,0,0,0,0,0,0,0,0,0,0,0,0,0,0,0,0,0,0,0,0,0,0,0,0,0,0,0,0,0,12864
3493,2527,212,928,748,366,273,182,111,103,47,3,53,8,8,2,0,6,0,0,0,0,71,56,12,0,44,15,10,0,10,0,5,5,0,0,12865
3494,26012,1562,5562,7073,6511,5304,1968,1138,987,395,102,490,151,124,60,0,64,27,8,0,19,830,756,312,19,425,74,36,36,0,0,38,15,0,23,12866
3495,1107,61,401,391,170,84,42,18,18,6,0,12,0,0,0,0,0,0,0,0,0,24,24,12,0,12,0,0,0,0,0,0,0,0,0,12870
3496,2905,297,957,810,503,338,228,90,90,22,3,65,0,0,0,0,0,0,0,0,0,138,81,28,0,53,57,57,2,50,5,0,0,0,0,12871
3497,45,0,22,22,1,0,0,0,0,0,0,0,0,0,0,0,0,0,0,0,0,0,0,0,0,0,0,0,0,0,0,0,0,0,0,12872
3498,554,58,166,150,126,54,38,12,8,8,0,0,4,4,0,0,4,0,0,0,0,26,23,6,13,4,3,0,0,0,0,3,0,3,0,12873
3499,162,0,42,41,38,41,0,0,0,0,0,0,0,0,0,0,0,0,0,0,0,0,0,0,0,0,0,0,0,0,0,0,0,0,0,12874
3500,697,85,275,219,67,51,11,6,3,0,0,3,3,0,0,0,0,3,0,0,3,5,5,3,0,2,0,0,0,0,0,0,0,0,0,12878
3501,3751,629,1321,1235,263,303,180,76,65,28,3,34,11,6,0,0,6,5,0,5,0,104,84,54,0,30,20,0,0,0,0,20,11,9,0,12883
3502,233,35,84,87,18,9,7,2,2,0,2,0,0,0,0,0,0,0,0,0,0,5,5,5,0,0,0,0,0,0,0,0,0,0,0,12884
3503,3475,507,1468,891,298,311,159,117,85,21,26,38,32,32,0,0,32,0,0,0,0,42,34,7,7,20,8,8,0,8,0,0,0,0,0,12885
3504,168,24,50,38,36,20,13,13,13,13,0,0,0,0,0,0,0,0,0,0,0,0,0,0,0,0,0,0,0,0,0,0,0,0,0,12886
3505,4056,654,2073,819,352,158,369,225,180,31,11,138,45,38,21,8,9,7,0,2,5,144,136,58,3,75,8,8,7,1,0,0,0,0,0,12887
3506,20763,2991,6482,5636,3123,2531,2946,1335,1315,202,65,1048,20,12,12,0,0,8,3,0,5,1611,1563,492,33,1038,48,40,29,0,11,8,0,0,8,12901
3507,849,16,147,312,218,156,72,72,72,17,11,44,0,0,0,0,0,0,0,0,0,0,0,0,0,0,0,0,0,0,0,0,0,0,0,12903
3508,1697,475,696,382,85,59,127,32,24,8,6,10,8,0,0,0,0,8,0,0,8,95,91,33,0,58,4,4,4,0,0,0,0,0,0,12910
3509,23,0,8,15,0,0,0,0,0,0,0,0,0,0,0,0,0,0,0,0,0,0,0,0,0,0,0,0,0,0,0,0,0,0,0,12911
3510,1480,223,592,369,133,163,99,55,55,20,0,35,0,0,0,0,0,0,0,0,0,44,21,0,9,12,23,20,20,0,0,3,0,0,3,12912
3511,927,99,281,268,149,130,55,11,0,0,0,0,11,0,0,0,0,11,11,0,0,44,44,13,0,31,0,0,0,0,0,0,0,0,0,12913
3512,542,50,271,145,34,42,70,42,28,4,13,11,14,3,0,0,3,11,0,0,11,28,23,0,0,23,5,0,0,0,0,5,0,0,5,12914
3513,1456,167,652,439,108,90,132,56,53,18,0,35,3,0,0,0,0,3,0,3,0,76,68,20,8,40,8,8,8,0,0,0,0,0,0,12916
3514,863,118,394,260,55,36,34,13,5,0,2,3,8,4,4,0,0,4,4,0,0,21,16,4,5,7,5,0,0,0,0,5,0,2,3,12917
3515,1418,140,448,493,202,135,109,45,37,10,0,27,8,8,0,0,8,0,0,0,0,64,52,4,0,48,12,12,12,0,0,0,0,0,0,12918
3516,1977,373,875,453,150,126,110,86,86,38,6,42,0,0,0,0,0,0,0,0,0,24,24,18,0,6,0,0,0,0,0,0,0,0,0,12919
3517,2021,326,968,486,114,127,118,64,49,17,5,27,15,11,11,0,0,4,0,0,4,54,49,16,0,33,5,5,5,0,0,0,0,0,0,12920
3518,1654,213,506,487,117,331,273,117,90,0,0,90,27,27,27,0,0,0,0,0,0,156,138,34,6,98,18,18,18,0,0,0,0,0,0,12921
3519,36,1,15,14,4,2,1,1,1,0,0,1,0,0,0,0,0,0,0,0,0,0,0,0,0,0,0,0,0,0,0,0,0,0,0,12922
3520,416,85,210,88,17,16,36,18,18,2,5,11,0,0,0,0,0,0,0,0,0,18,13,3,0,10,5,5,0,0,5,0,0,0,0,12923
3521,71,0,44,27,0,0,14,14,14,0,0,14,0,0,0,0,0,0,0,0,0,0,0,0,0,0,0,0,0,0,0,0,0,0,0,12924
3522,1233,196,544,343,61,89,138,79,69,6,0,63,10,7,4,3,0,3,0,0,3,59,46,14,3,29,13,3,3,0,0,10,6,0,4,12926
3523,197,2,66,72,51,6,0,0,0,0,0,0,0,0,0,0,0,0,0,0,0,0,0,0,0,0,0,0,0,0,0,0,0,0,0,12927
3524,1400,154,589,414,160,83,113,28,28,0,0,28,0,0,0,0,0,0,0,0,0,85,85,0,6,79,0,0,0,0,0,0,0,0,0,12928
3525,3335,1059,1682,447,108,39,37,26,9,0,0,9,17,0,0,0,0,17,0,0,17,11,11,0,0,11,0,0,0,0,0,0,0,0,0,12929
3526,493,76,232,132,17,36,65,37,26,0,0,26,11,0,0,0,0,11,0,11,0,28,28,17,0,11,0,0,0,0,0,0,0,0,0,12930
3527,1003,101,262,367,155,118,51,30,12,0,0,12,18,13,0,13,0,5,0,5,0,21,19,0,0,19,2,2,0,0,2,0,0,0,0,12932
3528,6,3,3,0,0,0,0,0,0,0,0,0,0,0,0,0,0,0,0,0,0,0,0,0,0,0,0,0,0,0,0,0,0,0,0,12933
3529,707,181,325,95,68,38,112,68,56,9,6,41,12,0,0,0,0,12,0,0,12,44,44,12,0,32,0,0,0,0,0,0,0,0,0,12934
3530,1107,325,414,191,102,75,46,3,3,1,0,2,0,0,0,0,0,0,0,0,0,43,40,13,0,27,3,3,3,0,0,0,0,0,0,12935
3531,468,57,82,112,97,120,39,13,13,8,0,5,0,0,0,0,0,0,0,0,0,26,26,9,0,17,0,0,0,0,0,0,0,0,0,12936
3532,1098,161,370,416,84,67,79,33,22,12,0,10,11,8,0,8,0,3,0,3,0,46,46,3,0,43,0,0,0,0,0,0,0,0,0,12937
3533,139,0,33,71,35,0,20,15,15,0,0,15,0,0,0,0,0,0,0,0,0,5,5,5,0,0,0,0,0,0,0,0,0,0,0,12939
3534,918,66,298,262,156,136,150,81,74,6,0,68,7,7,7,0,0,0,0,0,0,69,69,16,32,21,0,0,0,0,0,0,0,0,0,12941
3535,532,37,135,135,112,113,42,25,25,16,0,9,0,0,0,0,0,0,0,0,0,17,17,6,0,11,0,0,0,0,0,0,0,0,0,12942
3536,188,7,29,54,44,54,6,6,6,0,0,6,0,0,0,0,0,0,0,0,0,0,0,0,0,0,0,0,0,0,0,0,0,0,0,12943
3537,2894,407,1043,873,315,256,189,66,57,17,17,23,9,6,6,0,0,3,0,3,0,123,104,40,7,57,19,16,8,0,8,3,3,0,0,12944
3538,367,74,85,73,62,73,14,0,0,0,0,0,0,0,0,0,0,0,0,0,0,14,14,14,0,0,0,0,0,0,0,0,0,0,0,12945
3539,4018,365,1067,1225,805,556,230,141,110,11,16,83,31,22,22,0,0,9,0,0,9,89,89,41,25,23,0,0,0,0,0,0,0,0,0,12946
3540,654,150,289,161,31,23,34,21,21,6,0,15,0,0,0,0,0,0,0,0,0,13,9,4,0,5,4,0,0,0,0,4,0,0,4,12950
3541,382,63,169,115,9,26,0,0,0,0,0,0,0,0,0,0,0,0,0,0,0,0,0,0,0,0,0,0,0,0,0,0,0,0,0,12952
3542,11762,2332,4924,2987,832,687,612,291,256,47,9,200,35,13,0,0,13,22,0,0,22,321,253,160,0,93,68,48,35,0,13,20,0,0,20,12953
3543,295,34,142,63,23,33,23,0,0,0,0,0,0,0,0,0,0,0,0,0,0,23,22,0,0,22,1,0,0,0,0,1,0,1,0,12955
3544,814,129,439,136,62,48,54,47,24,0,0,24,23,23,19,0,4,0,0,0,0,7,0,0,0,0,7,7,0,0,7,0,0,0,0,12956
3545,1267,234,570,300,82,81,43,22,22,0,3,19,0,0,0,0,0,0,0,0,0,21,16,0,3,13,5,5,0,0,5,0,0,0,0,12957
3546,1063,103,557,195,137,71,68,53,53,0,11,42,0,0,0,0,0,0,0,0,0,15,15,0,0,15,0,0,0,0,0,0,0,0,0,12958
3547,1218,182,664,239,103,30,53,53,53,13,0,40,0,0,0,0,0,0,0,0,0,0,0,0,0,0,0,0,0,0,0,0,0,0,0,12959
3548,915,90,386,311,67,61,129,121,121,0,0,121,0,0,0,0,0,0,0,0,0,8,8,8,0,0,0,0,0,0,0,0,0,0,0,12960
3549,165,0,150,0,8,7,34,34,17,0,0,17,17,17,0,0,17,0,0,0,0,0,0,0,0,0,0,0,0,0,0,0,0,0,0,12961
3550,3954,406,1197,1323,553,475,277,125,125,10,27,88,0,0,0,0,0,0,0,0,0,152,142,35,0,107,10,10,10,0,0,0,0,0,0,12962
3551,121,5,19,38,30,29,11,11,11,11,0,0,0,0,0,0,0,0,0,0,0,0,0,0,0,0,0,0,0,0,0,0,0,0,0,12964
3552,299,22,143,77,31,26,14,6,6,3,0,3,0,0,0,0,0,0,0,0,0,8,8,0,0,8,0,0,0,0,0,0,0,0,0,12965
3553,2385,396,998,685,179,127,186,97,92,28,7,57,5,5,5,0,0,0,0,0,0,89,63,20,0,43,26,26,20,4,2,0,0,0,0,12966
3554,767,86,402,192,47,40,59,32,28,0,0,28,4,3,3,0,0,1,0,0,1,27,15,0,0,15,12,0,0,0,0,12,2,0,10,12967
3555,365,41,153,122,29,20,42,34,34,0,0,34,0,0,0,0,0,0,0,0,0,8,8,0,0,8,0,0,0,0,0,0,0,0,0,12969
3556,268,15,99,63,55,36,254,190,190,64,4,122,0,0,0,0,0,0,0,0,0,64,63,26,0,37,1,0,0,0,0,1,0,1,0,12970
3557,4667,443,1606,1205,732,681,322,186,175,0,0,175,11,0,0,0,0,11,11,0,0,136,129,29,0,100,7,7,7,0,0,0,0,0,0,12972
3558,185,27,59,56,24,19,6,0,0,0,0,0,0,0,0,0,0,0,0,0,0,6,6,0,0,6,0,0,0,0,0,0,0,0,0,12973
3559,992,101,330,336,144,81,64,19,19,7,12,0,0,0,0,0,0,0,0,0,0,45,45,0,2,43,0,0,0,0,0,0,0,0,0,12974
3560,306,4,103,102,51,46,10,10,0,0,0,0,10,10,10,0,0,0,0,0,0,0,0,0,0,0,0,0,0,0,0,0,0,0,0,12975
3561,108,0,31,44,23,10,0,0,0,0,0,0,0,0,0,0,0,0,0,0,0,0,0,0,0,0,0,0,0,0,0,0,0,0,0,12976
3562,1558,469,653,434,2,0,9,0,0,0,0,0,0,0,0,0,0,0,0,0,0,9,0,0,0,0,9,9,0,0,9,0,0,0,0,12977
3563,249,41,182,0,14,12,56,56,45,0,0,45,11,11,11,0,0,0,0,0,0,0,0,0,0,0,0,0,0,0,0,0,0,0,0,12978
3564,1792,165,610,660,247,110,144,61,61,15,0,46,0,0,0,0,0,0,0,0,0,83,74,29,3,42,9,0,0,0,0,9,0,0,9,12979
3565,882,133,424,214,40,71,51,31,23,10,11,2,8,8,8,0,0,0,0,0,0,20,14,3,0,11,6,6,6,0,0,0,0,0,0,12980
3566,1892,215,749,529,205,194,88,54,51,0,0,51,3,3,3,0,0,0,0,0,0,34,29,11,0,18,5,5,0,5,0,0,0,0,0,12981
3567,5637,462,1203,1976,1023,973,500,301,255,88,0,167,46,19,9,0,10,27,0,0,27,199,156,96,0,60,43,18,7,0,11,25,0,0,25,12983
3568,665,60,282,202,62,59,56,46,7,0,0,7,39,34,34,0,0,5,0,0,5,10,2,2,0,0,8,8,8,0,0,0,0,0,0,12985
3569,4206,549,1493,1474,393,297,313,192,164,20,0,144,28,16,6,0,10,12,5,0,7,121,94,11,0,83,27,27,0,27,0,0,0,0,0,12986
3570,253,49,35,93,42,34,0,0,0,0,0,0,0,0,0,0,0,0,0,0,0,0,0,0,0,0,0,0,0,0,0,0,0,0,0,12987
3571,786,83,270,224,109,100,36,27,27,0,0,27,0,0,0,0,0,0,0,0,0,9,9,0,4,5,0,0,0,0,0,0,0,0,0,12989
3572,3233,635,1238,898,302,160,363,206,129,34,0,95,77,66,66,0,0,11,0,0,11,157,144,31,8,105,13,13,7,6,0,0,0,0,0,12992
3573,1264,221,417,376,151,99,87,53,53,11,0,42,0,0,0,0,0,0,0,0,0,34,26,11,0,15,8,8,4,0,4,0,0,0,0,12993
3574,1380,205,628,342,121,84,54,28,23,0,3,20,5,5,5,0,0,0,0,0,0,26,26,22,0,4,0,0,0,0,0,0,0,0,0,12996
3575,863,79,207,277,203,97,92,71,59,21,0,38,12,6,6,0,0,6,0,6,0,21,21,21,0,0,0,0,0,0,0,0,0,0,0,12997
3576,360,27,289,44,0,0,44,21,21,0,0,21,0,0,0,0,0,0,0,0,0,23,23,0,0,23,0,0,0,0,0,0,0,0,0,12998
3577,99,11,17,50,7,14,11,7,7,2,0,5,0,0,0,0,0,0,0,0,0,4,4,4,0,0,0,0,0,0,0,0,0,0,0,13020
3578,27148,3333,8701,9001,3773,2340,2095,1173,953,463,18,472,220,72,16,42,14,148,31,35,82,922,739,357,110,272,183,130,81,9,40,53,14,0,39,13021
3579,1495,803,330,331,31,0,3,3,0,0,0,0,3,0,0,0,0,3,0,0,3,0,0,0,0,0,0,0,0,0,0,0,0,0,0,13024
3580,991,65,239,309,180,198,271,118,106,52,5,49,12,10,7,0,3,2,2,0,0,153,144,52,17,75,9,7,7,0,0,2,2,0,0,13026
3581,22312,1182,5728,6627,4898,3877,1458,674,636,177,29,430,38,38,32,6,0,0,0,0,0,784,721,202,41,478,63,15,15,0,0,48,48,0,0,13027
3582,948,100,480,198,86,84,66,47,42,16,12,14,5,3,0,3,0,2,0,2,0,19,19,19,0,0,0,0,0,0,0,0,0,0,0,13028
3583,4598,303,1423,1699,641,532,618,280,234,58,52,124,46,20,20,0,0,26,0,0,26,338,293,64,69,160,45,8,8,0,0,37,9,28,0,13029
3584,2409,192,900,823,290,204,160,104,104,13,12,79,0,0,0,0,0,0,0,0,0,56,46,21,8,17,10,0,0,0,0,10,0,10,0,13030
3585,10799,687,2341,3548,2636,1587,821,495,410,131,60,219,85,85,51,34,0,0,0,0,0,326,326,145,13,168,0,0,0,0,0,0,0,0,0,13031
3586,9600,1144,3635,2878,1230,713,620,320,264,35,52,177,56,23,23,0,0,33,3,0,30,300,270,71,0,199,30,30,27,0,3,0,0,0,0,13032
3587,2895,329,1179,822,337,228,192,72,46,8,8,30,26,18,18,0,0,8,5,3,0,120,72,17,7,48,48,38,5,0,33,10,8,0,2,13033
3588,1388,138,469,509,178,94,111,46,36,14,2,20,10,6,0,6,0,4,4,0,0,65,45,11,3,31,20,15,9,6,0,5,0,0,5,13034
3589,5408,271,1186,1509,1384,1058,845,449,439,68,0,371,10,0,0,0,0,10,8,0,2,396,392,72,0,320,4,4,0,4,0,0,0,0,0,13035
3590,5946,732,2486,1966,497,265,395,228,202,14,30,158,26,26,21,0,5,0,0,0,0,167,154,49,0,105,13,13,7,0,6,0,0,0,0,13036
3591,5917,609,1880,1787,1054,587,374,157,118,22,8,88,39,15,15,0,0,24,0,0,24,217,209,39,8,162,8,0,0,0,0,8,0,8,0,13037
3592,11948,568,3249,3981,2514,1636,812,474,456,161,44,251,18,14,6,0,8,4,0,0,4,338,332,130,5,197,6,6,0,0,6,0,0,0,0,13039
3593,1725,162,929,364,143,127,88,45,39,7,0,32,6,6,5,1,0,0,0,0,0,43,41,8,3,30,2,2,0,2,0,0,0,0,0,13040
3594,7319,274,2066,2735,1321,923,502,257,254,65,0,189,3,3,0,0,3,0,0,0,0,245,211,92,19,100,34,34,34,0,0,0,0,0,0,13041
3595,1635,211,794,411,126,93,31,19,18,0,0,18,1,0,0,0,0,1,1,0,0,12,12,5,0,7,0,0,0,0,0,0,0,0,0,13042
3596,1681,174,772,486,153,96,171,56,56,9,14,33,0,0,0,0,0,0,0,0,0,115,115,61,0,54,0,0,0,0,0,0,0,0,0,13044
3597,17257,1651,5724,5305,2618,1959,3343,1530,1405,425,22,958,125,76,11,45,20,49,3,40,6,1813,1672,389,20,1263,141,112,29,4,79,29,0,8,21,13045
3598,13,0,0,0,0,13,0,0,0,0,0,0,0,0,0,0,0,0,0,0,0,0,0,0,0,0,0,0,0,0,0,0,0,0,0,13051
3599,1136,84,436,399,131,86,85,53,50,12,0,38,3,3,3,0,0,0,0,0,0,32,26,2,0,24,6,0,0,0,0,6,0,0,6,13052
3600,2860,169,585,1027,516,563,186,109,109,18,0,91,0,0,0,0,0,0,0,0,0,77,77,27,0,50,0,0,0,0,0,0,0,0,0,13053
3601,914,116,325,367,57,49,85,33,33,0,11,22,0,0,0,0,0,0,0,0,0,52,34,0,0,34,18,18,18,0,0,0,0,0,0,13054
3602,10866,861,3795,3094,1885,1231,548,223,181,45,0,136,42,30,20,10,0,12,0,5,7,325,295,95,39,161,30,13,6,0,7,17,8,9,0,13057
3603,1761,261,633,462,286,119,111,45,45,17,14,14,0,0,0,0,0,0,0,0,0,66,63,19,0,44,3,3,3,0,0,0,0,0,0,13060
3604,887,53,236,262,170,166,56,47,39,0,3,36,8,3,0,3,0,5,0,0,5,9,5,0,0,5,4,4,4,0,0,0,0,0,0,13061
3605,161,0,42,14,105,0,42,0,0,0,0,0,0,0,0,0,0,0,0,0,0,42,42,0,0,42,0,0,0,0,0,0,0,0,0,13062
3606,1363,118,406,367,263,209,61,18,18,16,0,2,0,0,0,0,0,0,0,0,0,43,43,4,7,32,0,0,0,0,0,0,0,0,0,13063
3607,11,0,6,0,3,2,0,0,0,0,0,0,0,0,0,0,0,0,0,0,0,0,0,0,0,0,0,0,0,0,0,0,0,0,0,13064
3608,8434,154,900,1946,2426,3008,455,216,190,79,0,111,26,6,6,0,0,20,0,0,20,239,233,113,0,120,6,6,6,0,0,0,0,0,0,13066
3609,4059,190,1031,1393,647,798,318,196,192,28,0,164,4,4,0,0,4,0,0,0,0,122,100,34,0,66,22,22,0,0,22,0,0,0,0,13068
3610,16634,2547,6904,4591,1677,915,1474,814,670,129,40,501,144,81,44,12,25,63,16,0,47,660,556,92,41,423,104,66,57,0,9,38,6,0,32,13069
3611,676,68,331,147,88,42,14,6,6,1,0,5,0,0,0,0,0,0,0,0,0,8,3,0,0,3,5,3,3,0,0,2,0,2,0,13071
3612,709,120,287,223,45,34,79,58,56,5,3,48,2,2,2,0,0,0,0,0,0,21,20,0,0,20,1,1,1,0,0,0,0,0,0,13072
3613,4360,405,1883,1329,431,312,556,246,230,61,13,156,16,16,0,0,16,0,0,0,0,310,220,54,4,162,90,90,44,14,32,0,0,0,0,13073
3614,3077,391,1521,809,249,107,249,136,123,51,0,72,13,10,0,10,0,3,3,0,0,113,80,26,0,54,33,2,0,2,0,31,6,25,0,13074
3615,1646,138,859,454,100,95,253,156,123,37,7,79,33,33,25,0,8,0,0,0,0,97,73,42,7,24,24,24,0,24,0,0,0,0,0,13076
3616,4603,446,1439,1604,655,459,205,119,75,16,13,46,44,37,37,0,0,7,7,0,0,86,58,9,0,49,28,26,17,9,0,2,0,2,0,13077
3617,7337,530,1490,1903,1711,1703,599,342,278,50,0,228,64,13,0,0,13,51,0,0,51,257,257,83,25,149,0,0,0,0,0,0,0,0,0,13078
3618,2675,239,1050,918,314,154,188,131,68,10,17,41,63,46,16,30,0,17,2,0,15,57,57,5,0,52,0,0,0,0,0,0,0,0,0,13080
3619,885,76,290,235,174,110,57,33,28,10,3,15,5,3,0,3,0,2,0,2,0,24,24,5,0,19,0,0,0,0,0,0,0,0,0,13081
3620,3442,362,1186,1275,373,246,116,60,48,10,0,38,12,12,12,0,0,0,0,0,0,56,56,8,0,48,0,0,0,0,0,0,0,0,0,13082
3621,1145,99,456,359,153,78,59,37,21,0,5,16,16,11,9,2,0,5,0,5,0,22,20,5,0,15,2,2,2,0,0,0,0,0,0,13083
3622,3083,221,904,1095,482,381,303,186,186,3,23,160,0,0,0,0,0,0,0,0,0,117,103,0,0,103,14,0,0,0,0,14,14,0,0,13084
3623,159,0,14,20,66,59,0,0,0,0,0,0,0,0,0,0,0,0,0,0,0,0,0,0,0,0,0,0,0,0,0,0,0,0,0,13087
3624,16826,1753,4913,5618,2824,1718,796,461,385,124,32,229,76,76,59,0,17,0,0,0,0,335,328,127,0,201,7,0,0,0,0,7,0,0,7,13088
3625,20328,924,5015,6682,4795,2912,1348,843,784,224,77,483,59,16,11,0,5,43,24,0,19,505,430,151,21,258,75,75,50,0,25,0,0,0,0,13090
3626,1941,254,646,725,245,71,130,69,69,17,12,40,0,0,0,0,0,0,0,0,0,61,47,6,5,36,14,6,2,0,4,8,0,0,8,13092
3627,1828,218,722,638,149,101,157,90,85,28,0,57,5,3,3,0,0,2,0,0,2,67,57,1,21,35,10,6,6,0,0,4,0,4,0,13101
3628,117,45,55,0,0,17,99,42,42,0,0,42,0,0,0,0,0,0,0,0,0,57,0,0,0,0,57,57,57,0,0,0,0,0,0,13102
3629,225,95,104,26,0,0,54,19,19,0,19,0,0,0,0,0,0,0,0,0,0,35,0,0,0,0,35,35,0,18,17,0,0,0,0,13103
3630,10774,350,1550,2396,3317,3161,836,399,377,107,26,244,22,7,0,7,0,15,0,15,0,437,437,105,17,315,0,0,0,0,0,0,0,0,0,13104
3631,4347,84,1062,1345,972,884,371,206,180,48,22,110,26,26,26,0,0,0,0,0,0,165,141,27,5,109,24,8,8,0,0,16,0,0,16,13108
3632,1775,134,539,603,308,191,96,50,50,15,0,35,0,0,0,0,0,0,0,0,0,46,30,0,0,30,16,12,0,12,0,4,4,0,0,13110
3633,1294,167,743,274,58,52,33,19,16,4,0,12,3,0,0,0,0,3,0,0,3,14,14,3,0,11,0,0,0,0,0,0,0,0,0,13111
3634,1320,67,426,564,149,114,110,42,32,7,0,25,10,10,10,0,0,0,0,0,0,68,68,13,0,55,0,0,0,0,0,0,0,0,0,13112
3635,202,9,104,66,10,13,17,11,11,3,0,8,0,0,0,0,0,0,0,0,0,6,6,2,0,4,0,0,0,0,0,0,0,0,0,13113
3636,4401,587,1823,1286,424,281,231,116,105,6,0,99,11,11,6,0,5,0,0,0,0,115,82,19,8,55,33,30,22,3,5,3,3,0,0,13114
3637,63,16,27,7,10,3,0,0,0,0,0,0,0,0,0,0,0,0,0,0,0,0,0,0,0,0,0,0,0,0,0,0,0,0,0,13115
3638,2612,149,607,894,513,449,136,95,82,39,0,43,13,13,0,13,0,0,0,0,0,41,41,12,11,18,0,0,0,0,0,0,0,0,0,13116
3639,138,34,63,23,12,6,7,5,5,0,0,5,0,0,0,0,0,0,0,0,0,2,0,0,0,0,2,2,2,0,0,0,0,0,0,13117
3640,4482,809,1764,1271,314,324,292,144,126,21,12,93,18,0,0,0,0,18,13,0,5,148,142,58,22,62,6,0,0,0,0,6,6,0,0,13118
3641,1377,82,523,499,198,75,133,63,42,13,7,22,21,12,12,0,0,9,0,0,9,70,45,19,0,26,25,11,11,0,0,14,14,0,0,13120
3642,632,37,225,218,117,35,40,6,2,0,0,2,4,0,0,0,0,4,4,0,0,34,28,0,0,28,6,0,0,0,0,6,6,0,0,13122
3643,94,14,65,15,0,0,0,0,0,0,0,0,0,0,0,0,0,0,0,0,0,0,0,0,0,0,0,0,0,0,0,0,0,0,0,13123
3644,83,0,60,16,4,3,2,0,0,0,0,0,0,0,0,0,0,0,0,0,0,2,2,2,0,0,0,0,0,0,0,0,0,0,0,13124
3645,22464,2846,8170,6086,2813,2549,4110,2025,1814,466,161,1187,211,123,45,46,32,88,18,24,46,2085,1962,660,96,1206,123,82,38,0,44,41,0,32,9,13126
3646,2593,446,1120,763,154,110,238,67,48,0,0,48,19,19,12,0,7,0,0,0,0,171,144,35,18,91,27,10,8,2,0,17,3,4,10,13131
3647,2429,253,1128,642,215,191,315,183,153,48,12,93,30,0,0,0,0,30,0,0,30,132,119,96,23,0,13,13,13,0,0,0,0,0,0,13132
3648,33,0,16,14,3,0,0,0,0,0,0,0,0,0,0,0,0,0,0,0,0,0,0,0,0,0,0,0,0,0,0,0,0,0,0,13134
3649,4649,457,1544,1657,451,540,451,228,192,19,5,168,36,31,23,0,8,5,5,0,0,223,198,69,47,82,25,20,20,0,0,5,0,0,5,13135
3650,331,20,168,118,11,14,19,13,13,2,6,5,0,0,0,0,0,0,0,0,0,6,2,0,0,2,4,4,4,0,0,0,0,0,0,13136
3651,30,15,15,0,0,0,0,0,0,0,0,0,0,0,0,0,0,0,0,0,0,0,0,0,0,0,0,0,0,0,0,0,0,0,0,13138
3652,2902,475,1143,971,198,115,192,87,53,15,5,33,34,26,26,0,0,8,0,5,3,105,86,24,15,47,19,4,0,0,4,15,2,0,13,13140
3653,317,51,111,98,46,11,8,4,4,2,0,2,0,0,0,0,0,0,0,0,0,4,4,4,0,0,0,0,0,0,0,0,0,0,0,13141
3654,4183,543,1703,1253,413,271,280,178,165,29,60,76,13,13,0,13,0,0,0,0,0,102,81,15,6,60,21,9,9,0,0,12,3,0,9,13142
3655,2223,436,971,605,124,87,112,40,40,0,0,40,0,0,0,0,0,0,0,0,0,72,35,16,0,19,37,8,8,0,0,29,0,0,29,13143
3656,1068,231,373,316,82,66,100,79,79,4,18,57,0,0,0,0,0,0,0,0,0,21,17,14,0,3,4,4,2,0,2,0,0,0,0,13144
3657,1369,270,535,359,120,85,102,53,53,18,13,22,0,0,0,0,0,0,0,0,0,49,49,23,7,19,0,0,0,0,0,0,0,0,0,13145
3658,1411,279,648,384,72,28,94,47,31,0,0,31,16,6,0,6,0,10,8,0,2,47,34,18,0,16,13,4,0,0,4,9,3,0,6,13146
3659,1079,128,468,312,102,69,71,37,35,7,4,24,2,2,0,2,0,0,0,0,0,34,34,5,0,29,0,0,0,0,0,0,0,0,0,13147
3660,7444,761,2404,2399,1147,733,468,206,174,17,7,150,32,16,13,3,0,16,9,0,7,262,212,87,8,117,50,4,3,1,0,46,28,0,18,13148
3661,5988,189,1030,1533,1772,1464,427,230,200,26,1,173,30,15,15,0,0,15,15,0,0,197,194,26,23,145,3,0,0,0,0,3,0,0,3,13152
3662,161,18,73,22,32,16,12,12,12,12,0,0,0,0,0,0,0,0,0,0,0,0,0,0,0,0,0,0,0,0,0,0,0,0,0,13153
3663,401,44,171,122,38,26,51,36,27,0,0,27,9,2,2,0,0,7,7,0,0,15,9,0,0,9,6,6,6,0,0,0,0,0,0,13155
3664,1593,161,647,444,213,128,82,75,62,8,2,52,13,13,11,0,2,0,0,0,0,7,7,0,0,7,0,0,0,0,0,0,0,0,0,13156
3665,611,136,254,134,53,34,29,19,19,3,0,16,0,0,0,0,0,0,0,0,0,10,10,0,0,10,0,0,0,0,0,0,0,0,0,13157
3666,1147,168,463,361,100,55,96,51,41,6,6,29,10,10,6,2,2,0,0,0,0,45,37,3,0,34,8,3,0,0,3,5,0,3,2,13158
3667,3638,207,882,1145,852,552,261,149,142,43,0,99,7,0,0,0,0,7,0,0,7,112,101,24,0,77,11,11,2,4,5,0,0,0,0,13159
3668,1254,101,452,454,156,91,161,103,88,7,11,70,15,15,15,0,0,0,0,0,0,58,55,27,0,28,3,3,0,3,0,0,0,0,0,13160
3669,363,26,123,141,41,32,16,16,16,0,0,16,0,0,0,0,0,0,0,0,0,0,0,0,0,0,0,0,0,0,0,0,0,0,0,13162
3670,250,17,70,125,19,19,8,8,8,0,0,8,0,0,0,0,0,0,0,0,0,0,0,0,0,0,0,0,0,0,0,0,0,0,0,13163
3671,1736,105,472,600,330,229,59,47,31,11,0,20,16,7,7,0,0,9,9,0,0,12,9,0,0,9,3,3,3,0,0,0,0,0,0,13164
3672,7561,1096,2835,2520,624,486,552,280,231,73,15,143,49,38,35,0,3,11,4,7,0,272,225,54,11,160,47,12,12,0,0,35,2,0,33,13165
3673,4017,447,1400,1404,437,329,345,204,173,53,3,117,31,23,3,14,6,8,6,0,2,141,96,35,4,57,45,45,36,0,9,0,0,0,0,13166
3674,2115,265,786,684,258,122,204,94,94,8,0,86,0,0,0,0,0,0,0,0,0,110,98,4,22,72,12,5,5,0,0,7,0,0,7,13167
3675,3184,952,829,442,348,613,228,115,37,0,0,37,78,24,0,14,10,54,0,0,54,113,95,0,28,67,18,5,5,0,0,13,0,8,5,13202
3676,10459,2638,2784,2633,1243,1161,1141,574,537,128,36,373,37,8,0,0,8,29,0,23,6,567,499,69,62,368,68,32,32,0,0,36,32,4,0,13203
3677,12266,3225,3801,3254,1405,581,978,450,344,56,52,236,106,85,47,20,18,21,0,13,8,528,380,36,74,270,148,47,15,9,23,101,14,41,46,13204
3678,11770,2360,3842,3475,1164,929,1078,528,451,50,46,355,77,38,14,0,24,39,0,11,28,550,472,98,58,316,78,49,21,11,17,29,10,0,19,13205
3679,11550,1407,3625,3761,1772,985,696,428,366,112,40,214,62,54,25,20,9,8,0,0,8,268,206,144,7,55,62,44,24,0,20,18,0,0,18,13206
3680,8508,1134,2166,2672,1430,1106,704,302,197,54,32,111,105,26,0,26,0,79,6,11,62,402,318,24,25,269,84,46,30,0,16,38,0,0,38,13207
3681,13794,3379,4303,3800,1515,797,1211,542,465,59,43,363,77,43,25,7,11,34,14,0,20,669,446,208,19,219,223,52,29,8,15,171,21,41,109,13208
3682,9639,1036,3590,2951,1413,649,553,239,191,80,9,102,48,48,15,0,33,0,0,0,0,314,257,111,16,130,57,57,7,10,40,0,0,0,0,13209
3683,9692,1191,1747,2016,2262,2476,7764,3469,3447,753,144,2550,22,9,8,0,1,13,0,0,13,4295,4268,979,380,2909,27,27,27,0,0,0,0,0,0,13210
3684,4618,608,2197,1311,377,125,339,207,167,35,29,103,40,11,7,4,0,29,0,10,19,132,99,9,0,90,33,33,33,0,0,0,0,0,0,13211
3685,15301,1406,5071,5525,2077,1222,705,288,241,65,37,139,47,39,21,0,18,8,0,8,0,417,378,111,40,227,39,22,22,0,0,17,0,0,17,13212
3686,5189,234,891,1431,1121,1512,1310,438,384,77,21,286,54,54,14,40,0,0,0,0,0,872,872,295,33,544,0,0,0,0,0,0,0,0,0,13214
3687,10576,555,2364,3115,2463,2079,997,383,373,91,27,255,10,6,0,6,0,4,0,0,4,614,597,285,45,267,17,17,17,0,0,0,0,0,0,13215
3688,11145,910,2681,3607,2175,1772,516,208,208,133,13,62,0,0,0,0,0,0,0,0,0,308,294,115,38,141,14,14,0,0,14,0,0,0,0,13219
3689,5936,538,1397,1455,1090,1456,557,338,202,64,0,138,136,51,44,7,0,85,35,0,50,219,165,18,0,147,54,54,27,0,27,0,0,0,0,13224
3690,0,0,0,0,0,0,0,0,0,0,0,0,0,0,0,0,0,0,0,0,0,0,0,0,0,0,0,0,0,0,0,0,0,0,0,13290
3691,137,0,33,68,0,36,11,0,0,0,0,0,0,0,0,0,0,0,0,0,0,11,11,0,0,11,0,0,0,0,0,0,0,0,0,13301
3692,1135,199,496,318,60,62,88,27,26,10,4,12,1,1,1,0,0,0,0,0,0,61,46,12,2,32,15,9,2,0,7,6,0,4,2,13302
3693,845,68,332,231,125,89,39,19,13,0,0,13,6,6,6,0,0,0,0,0,0,20,13,0,0,13,7,0,0,0,0,7,7,0,0,13303
3694,1098,85,171,356,269,217,67,43,41,23,0,18,2,2,2,0,0,0,0,0,0,24,24,0,0,24,0,0,0,0,0,0,0,0,0,13304
3695,205,0,52,115,16,22,57,38,38,21,0,17,0,0,0,0,0,0,0,0,0,19,19,8,0,11,0,0,0,0,0,0,0,0,0,13305
3696,2357,457,1002,681,169,48,151,134,124,0,21,103,10,0,0,0,0,10,0,10,0,17,17,5,0,12,0,0,0,0,0,0,0,0,0,13308
3697,4218,543,1863,1182,320,310,319,185,132,69,0,63,53,50,50,0,0,3,0,0,3,134,117,27,19,71,17,17,3,14,0,0,0,0,0,13309
3698,378,43,104,139,68,24,32,9,9,0,0,9,0,0,0,0,0,0,0,0,0,23,23,23,0,0,0,0,0,0,0,0,0,0,0,13310
3699,248,18,72,72,50,36,17,10,0,0,0,0,10,10,0,10,0,0,0,0,0,7,3,3,0,0,4,4,0,4,0,0,0,0,0,13312
3700,308,67,160,61,7,13,37,4,4,0,0,4,0,0,0,0,0,0,0,0,0,33,23,0,0,23,10,0,0,0,0,10,0,6,4,13313
3701,346,42,185,91,22,6,23,7,7,0,3,4,0,0,0,0,0,0,0,0,0,16,16,0,0,16,0,0,0,0,0,0,0,0,0,13314
3702,1034,93,498,313,79,51,73,47,47,3,8,36,0,0,0,0,0,0,0,0,0,26,23,5,0,18,3,3,3,0,0,0,0,0,0,13315
3703,4656,560,2100,1217,383,396,408,289,267,74,2,191,22,22,20,0,2,0,0,0,0,119,83,8,18,57,36,36,36,0,0,0,0,0,0,13316
3704,2589,356,1011,694,260,268,172,89,76,22,0,54,13,13,4,0,9,0,0,0,0,83,79,14,5,60,4,4,0,4,0,0,0,0,0,13317
3705,809,54,392,253,54,56,102,47,42,4,4,34,5,0,0,0,0,5,5,0,0,55,41,23,0,18,14,8,3,0,5,6,6,0,0,13318
3706,657,178,189,187,66,37,174,41,22,0,0,22,19,19,0,19,0,0,0,0,0,133,77,48,0,29,56,56,0,0,56,0,0,0,0,13319
3707,1514,192,567,399,188,168,81,52,50,16,10,24,2,0,0,0,0,2,0,0,2,29,22,3,0,19,7,5,5,0,0,2,0,0,2,13320
3708,715,86,206,302,59,62,29,0,0,0,0,0,0,0,0,0,0,0,0,0,0,29,29,0,0,29,0,0,0,0,0,0,0,0,0,13321
3709,783,100,265,234,133,51,17,2,2,2,0,0,0,0,0,0,0,0,0,0,0,15,6,6,0,0,9,9,9,0,0,0,0,0,0,13322
3710,7064,493,1584,2188,1481,1318,1358,686,660,166,26,468,26,26,0,26,0,0,0,0,0,672,672,250,13,409,0,0,0,0,0,0,0,0,0,13323
3711,1643,182,711,508,172,70,168,101,79,7,10,62,22,7,7,0,0,15,0,0,15,67,58,9,11,38,9,6,0,0,6,3,0,0,3,13324
3712,654,99,313,144,50,48,62,24,21,0,0,21,3,2,2,0,0,1,0,0,1,38,34,4,0,30,4,4,0,0,4,0,0,0,0,13325
3713,4065,309,996,1091,798,871,261,138,92,29,0,63,46,35,29,0,6,11,6,0,5,123,96,13,14,69,27,27,20,7,0,0,0,0,0,13326
3714,1313,180,605,392,98,38,94,49,44,0,0,44,5,4,4,0,0,1,1,0,0,45,41,9,0,32,4,4,0,4,0,0,0,0,0,13327
3715,982,103,342,269,215,53,70,17,9,2,0,7,8,8,8,0,0,0,0,0,0,53,32,7,7,18,21,21,15,0,6,0,0,0,0,13328
3716,2661,345,1215,825,152,124,187,134,113,4,4,105,21,19,0,15,4,2,0,0,2,53,53,13,5,35,0,0,0,0,0,0,0,0,0,13329
3717,164,0,58,51,30,25,0,0,0,0,0,0,0,0,0,0,0,0,0,0,0,0,0,0,0,0,0,0,0,0,0,0,0,0,0,13331
3718,1587,151,649,328,237,222,118,34,26,6,0,20,8,0,0,0,0,8,0,0,8,84,84,2,0,82,0,0,0,0,0,0,0,0,0,13332
3719,55,0,31,10,7,7,0,0,0,0,0,0,0,0,0,0,0,0,0,0,0,0,0,0,0,0,0,0,0,0,0,0,0,0,0,13333
3720,898,145,338,310,75,30,134,16,16,1,1,14,0,0,0,0,0,0,0,0,0,118,87,8,6,73,31,31,0,0,31,0,0,0,0,13334
3721,1103,101,488,364,97,53,162,89,69,12,9,48,20,17,17,0,0,3,0,0,3,73,62,18,0,44,11,3,0,3,0,8,0,0,8,13335
3722,604,43,224,78,118,141,21,9,9,0,9,0,0,0,0,0,0,0,0,0,0,12,12,0,0,12,0,0,0,0,0,0,0,0,0,13337
3723,854,61,397,298,58,40,45,21,21,0,0,21,0,0,0,0,0,0,0,0,0,24,24,0,0,24,0,0,0,0,0,0,0,0,0,13338
3724,4351,935,1594,1242,402,178,407,187,115,34,3,78,72,4,4,0,0,68,6,24,38,220,166,33,0,133,54,10,0,0,10,44,0,0,44,13339
3725,5586,737,1911,1894,611,433,455,212,167,69,7,91,45,19,19,0,0,26,26,0,0,243,237,76,8,153,6,6,6,0,0,0,0,0,0,13340
3726,111,6,18,44,30,13,0,0,0,0,0,0,0,0,0,0,0,0,0,0,0,0,0,0,0,0,0,0,0,0,0,0,0,0,0,13341
3727,151,13,49,45,22,22,9,9,9,3,0,6,0,0,0,0,0,0,0,0,0,0,0,0,0,0,0,0,0,0,0,0,0,0,0,13342
3728,1119,117,486,292,138,86,114,73,53,25,0,28,20,10,0,0,10,10,10,0,0,41,24,3,4,17,17,17,4,0,13,0,0,0,0,13343
3729,135,21,78,23,5,8,20,0,0,0,0,0,0,0,0,0,0,0,0,0,0,20,20,0,0,20,0,0,0,0,0,0,0,0,0,13345
3730,3053,228,678,713,613,821,1460,725,708,117,0,591,17,17,4,13,0,0,0,0,0,735,732,141,0,591,3,3,0,0,3,0,0,0,0,13346
3731,893,87,308,203,178,117,74,23,13,5,2,6,10,10,6,4,0,0,0,0,0,51,47,10,11,26,4,4,4,0,0,0,0,0,0,13348
3732,6986,828,2526,2183,783,666,641,271,238,85,28,125,33,33,6,22,5,0,0,0,0,370,340,92,10,238,30,0,0,0,0,30,16,0,14,13350
3733,121,41,54,26,0,0,27,0,0,0,0,0,0,0,0,0,0,0,0,0,0,27,27,27,0,0,0,0,0,0,0,0,0,0,0,13352
3734,35,1,25,9,0,0,0,0,0,0,0,0,0,0,0,0,0,0,0,0,0,0,0,0,0,0,0,0,0,0,0,0,0,0,0,13353
3735,2099,91,657,730,299,322,249,61,58,18,0,40,3,3,3,0,0,0,0,0,0,188,129,41,4,84,59,59,0,59,0,0,0,0,0,13354
3736,448,47,200,142,56,3,95,12,11,5,0,6,1,0,0,0,0,1,1,0,0,83,83,0,0,83,0,0,0,0,0,0,0,0,0,13355
3737,7551,788,2597,2508,1006,652,565,276,232,40,23,169,44,41,24,0,17,3,0,0,3,289,249,100,29,120,40,40,29,0,11,0,0,0,0,13357
3738,416,23,95,159,81,58,36,3,3,0,0,3,0,0,0,0,0,0,0,0,0,33,22,22,0,0,11,7,0,7,0,4,4,0,0,13360
3739,636,64,212,230,81,49,48,27,25,0,0,25,2,0,0,0,0,2,0,0,2,21,15,3,0,12,6,3,3,0,0,3,0,0,3,13361
3740,96,0,32,58,0,6,0,0,0,0,0,0,0,0,0,0,0,0,0,0,0,0,0,0,0,0,0,0,0,0,0,0,0,0,0,13362
3741,1660,228,466,648,239,79,212,106,88,56,15,17,18,0,0,0,0,18,0,18,0,106,106,27,0,79,0,0,0,0,0,0,0,0,0,13363
3742,133,23,30,30,38,12,0,0,0,0,0,0,0,0,0,0,0,0,0,0,0,0,0,0,0,0,0,0,0,0,0,0,0,0,0,13364
3743,6231,808,2233,1880,817,493,423,242,172,26,38,108,70,62,34,15,13,8,0,0,8,181,162,57,13,92,19,7,7,0,0,12,0,0,12,13365
3744,5960,673,2691,1682,487,427,393,147,126,28,8,90,21,21,21,0,0,0,0,0,0,246,232,13,8,211,14,2,2,0,0,12,12,0,0,13367
3745,952,110,559,199,47,37,57,25,9,2,0,7,16,0,0,0,0,16,0,5,11,32,25,0,0,25,7,7,4,3,0,0,0,0,0,13368
3746,1160,127,619,235,103,76,81,27,8,0,2,6,19,4,0,0,4,15,11,0,4,54,8,3,0,5,46,46,0,0,46,0,0,0,0,13402
3747,5631,1256,1713,1809,577,276,414,238,214,38,22,154,24,18,0,0,18,6,0,0,6,176,171,90,0,81,5,0,0,0,0,5,0,0,5,13403
3748,160,6,84,57,6,7,24,7,4,0,0,4,3,0,0,0,0,3,3,0,0,17,17,0,8,9,0,0,0,0,0,0,0,0,0,13404
3749,545,40,188,206,73,38,20,10,10,4,0,6,0,0,0,0,0,0,0,0,0,10,10,5,0,5,0,0,0,0,0,0,0,0,0,13406
3750,3766,448,1359,1306,411,242,301,145,93,32,0,61,52,29,17,0,12,23,0,0,23,156,153,64,8,81,3,3,0,3,0,0,0,0,0,13407
3751,1579,220,498,514,100,247,1004,479,474,64,4,406,5,2,0,0,2,3,3,0,0,525,522,48,0,474,3,0,0,0,0,3,3,0,0,13408
3752,1826,153,793,622,137,121,185,50,26,13,0,13,24,15,13,0,2,9,0,0,9,135,119,10,5,104,16,7,0,0,7,9,0,0,9,13409
3753,221,38,88,75,7,13,14,0,0,0,0,0,0,0,0,0,0,0,0,0,0,14,5,0,0,5,9,0,0,0,0,9,0,0,9,13410
3754,2727,518,1063,819,208,119,224,113,102,7,4,91,11,11,8,0,3,0,0,0,0,111,93,3,14,76,18,18,2,13,3,0,0,0,0,13411
3755,11680,1029,2544,3080,2812,2215,637,397,324,50,0,274,73,55,55,0,0,18,0,0,18,240,226,123,16,87,14,9,0,9,0,5,0,0,5,13413
3756,46,8,20,6,4,8,0,0,0,0,0,0,0,0,0,0,0,0,0,0,0,0,0,0,0,0,0,0,0,0,0,0,0,0,0,13415
3757,1490,127,615,528,140,80,149,74,74,8,0,66,0,0,0,0,0,0,0,0,0,75,67,3,11,53,8,5,0,5,0,3,3,0,0,13416
3758,2257,226,792,852,230,157,138,30,30,24,0,6,0,0,0,0,0,0,0,0,0,108,108,43,13,52,0,0,0,0,0,0,0,0,0,13417
3759,133,6,66,44,11,6,8,4,4,0,4,0,0,0,0,0,0,0,0,0,0,4,4,0,0,4,0,0,0,0,0,0,0,0,0,13418
3760,1069,71,231,351,217,199,37,26,26,0,0,26,0,0,0,0,0,0,0,0,0,11,11,2,0,9,0,0,0,0,0,0,0,0,0,13420
3761,9782,920,3533,3159,1321,849,642,356,308,147,5,156,48,39,12,19,8,9,0,0,9,286,271,53,0,218,15,15,0,0,15,0,0,0,0,13421
3762,1955,230,656,633,300,136,117,62,40,10,0,30,22,0,0,0,0,22,0,0,22,55,55,18,0,37,0,0,0,0,0,0,0,0,0,13424
3763,1653,141,820,393,215,84,105,28,17,10,4,3,11,7,7,0,0,4,0,0,4,77,64,32,0,32,13,13,0,13,0,0,0,0,0,13425
3764,1173,183,533,270,106,81,103,37,37,5,0,32,0,0,0,0,0,0,0,0,0,66,66,24,12,30,0,0,0,0,0,0,0,0,0,13428
3765,1482,131,408,497,237,209,129,64,59,19,22,18,5,5,0,5,0,0,0,0,0,65,65,13,5,47,0,0,0,0,0,0,0,0,0,13431
3766,1234,225,673,203,94,39,117,81,69,34,0,35,12,12,9,0,3,0,0,0,0,36,22,0,0,22,14,14,6,0,8,0,0,0,0,13433
3767,144,13,37,65,10,19,9,2,2,0,0,2,0,0,0,0,0,0,0,0,0,7,5,0,0,5,2,2,2,0,0,0,0,0,0,13435
3768,59,0,22,19,12,6,0,0,0,0,0,0,0,0,0,0,0,0,0,0,0,0,0,0,0,0,0,0,0,0,0,0,0,0,0,13436
3769,312,35,160,79,21,17,23,6,6,0,0,6,0,0,0,0,0,0,0,0,0,17,17,6,0,11,0,0,0,0,0,0,0,0,0,13437
3770,2758,265,1049,843,357,244,221,107,92,8,12,72,15,5,5,0,0,10,10,0,0,114,114,14,7,93,0,0,0,0,0,0,0,0,0,13438
3771,2672,445,992,684,359,192,159,85,63,17,9,37,22,6,6,0,0,16,6,7,3,74,23,3,4,16,51,35,7,18,10,16,6,10,0,13439
3772,30093,3542,10883,9676,3739,2253,1904,1113,1034,182,14,838,79,71,22,20,29,8,0,8,0,791,747,282,73,392,44,18,18,0,0,26,0,0,26,13440
3773,7,0,7,0,0,0,2,0,0,0,0,0,0,0,0,0,0,0,0,0,0,2,0,0,0,0,2,0,0,0,0,2,0,0,2,13441
3774,136,12,89,30,0,5,0,0,0,0,0,0,0,0,0,0,0,0,0,0,0,0,0,0,0,0,0,0,0,0,0,0,0,0,0,13450
3775,3029,704,1357,695,155,118,249,138,106,16,7,83,32,4,0,0,4,28,0,25,3,111,85,14,0,71,26,26,8,3,15,0,0,0,0,13452
3776,504,111,194,151,35,13,75,26,26,7,0,19,0,0,0,0,0,0,0,0,0,49,42,0,0,42,7,7,0,0,7,0,0,0,0,13454
3777,3106,184,790,1135,564,433,177,142,129,95,3,31,13,13,13,0,0,0,0,0,0,35,32,32,0,0,3,3,3,0,0,0,0,0,0,13456
3778,1499,142,707,412,139,99,48,34,28,5,3,20,6,6,6,0,0,0,0,0,0,14,14,6,0,8,0,0,0,0,0,0,0,0,0,13459
3779,2869,354,1196,934,241,144,208,84,52,0,0,52,32,32,25,0,7,0,0,0,0,124,114,31,4,79,10,7,7,0,0,3,0,0,3,13460
3780,2271,243,496,954,330,248,91,64,64,0,0,64,0,0,0,0,0,0,0,0,0,27,27,9,0,18,0,0,0,0,0,0,0,0,0,13461
3781,803,115,372,202,85,29,65,29,22,11,0,11,7,4,3,1,0,3,0,0,3,36,32,16,1,15,4,4,4,0,0,0,0,0,0,13464
3782,293,42,110,62,47,32,28,11,2,0,0,2,9,0,0,0,0,9,5,0,4,17,5,3,0,2,12,12,9,0,3,0,0,0,0,13468
3783,562,10,101,190,129,132,26,16,16,8,0,8,0,0,0,0,0,0,0,0,0,10,10,0,10,0,0,0,0,0,0,0,0,0,0,13469
3784,556,100,211,187,45,13,25,16,16,7,0,9,0,0,0,0,0,0,0,0,0,9,9,0,0,9,0,0,0,0,0,0,0,0,0,13470
3785,2420,478,1064,543,236,99,279,148,94,13,0,81,54,47,11,11,25,7,0,0,7,131,93,3,56,34,38,11,5,6,0,27,0,3,24,13471
3786,183,0,47,118,18,0,3,0,0,0,0,0,0,0,0,0,0,0,0,0,0,3,3,3,0,0,0,0,0,0,0,0,0,0,0,13472
3787,457,56,229,123,22,27,43,20,20,10,0,10,0,0,0,0,0,0,0,0,0,23,22,4,2,16,1,0,0,0,0,1,0,0,1,13473
3788,27,0,3,20,0,4,0,0,0,0,0,0,0,0,0,0,0,0,0,0,0,0,0,0,0,0,0,0,0,0,0,0,0,0,0,13475
3789,2023,230,671,650,330,142,83,61,59,14,0,45,2,2,2,0,0,0,0,0,0,22,19,11,0,8,3,3,3,0,0,0,0,0,0,13476
3790,1106,35,446,492,80,53,91,22,22,12,0,10,0,0,0,0,0,0,0,0,0,69,69,29,0,40,0,0,0,0,0,0,0,0,0,13477
3791,2068,132,733,739,393,71,90,75,61,0,20,41,14,14,0,14,0,0,0,0,0,15,15,0,0,15,0,0,0,0,0,0,0,0,0,13478
3792,2372,268,935,743,250,176,187,127,95,18,0,77,32,18,6,0,12,14,0,0,14,60,56,24,0,32,4,4,3,1,0,0,0,0,0,13480
3793,134,43,41,30,0,20,4,0,0,0,0,0,0,0,0,0,0,0,0,0,0,4,4,0,0,4,0,0,0,0,0,0,0,0,0,13483
3794,65,0,36,16,13,0,0,0,0,0,0,0,0,0,0,0,0,0,0,0,0,0,0,0,0,0,0,0,0,0,0,0,0,0,0,13484
3795,677,104,319,179,51,24,19,11,9,0,0,9,2,2,0,2,0,0,0,0,0,8,8,4,4,0,0,0,0,0,0,0,0,0,0,13485
3796,446,40,202,95,46,63,13,6,6,6,0,0,0,0,0,0,0,0,0,0,0,7,7,0,7,0,0,0,0,0,0,0,0,0,0,13486
3797,68,4,18,31,13,2,4,1,1,0,0,1,0,0,0,0,0,0,0,0,0,3,3,3,0,0,0,0,0,0,0,0,0,0,0,13488
3798,421,32,185,147,33,24,32,20,18,6,0,12,2,2,0,2,0,0,0,0,0,12,12,4,3,5,0,0,0,0,0,0,0,0,0,13489
3799,941,75,415,288,60,103,77,48,48,16,0,32,0,0,0,0,0,0,0,0,0,29,29,0,0,29,0,0,0,0,0,0,0,0,0,13490
3800,2483,280,916,794,323,170,231,127,71,10,5,56,56,54,54,0,0,2,2,0,0,104,92,32,7,53,12,10,10,0,0,2,0,0,2,13491
3801,8402,410,2520,2840,1583,1049,501,195,180,72,18,90,15,15,0,15,0,0,0,0,0,306,262,114,67,81,44,0,0,0,0,44,44,0,0,13492
3802,1321,291,651,290,64,25,100,54,47,5,6,36,7,7,4,3,0,0,0,0,0,46,46,8,7,31,0,0,0,0,0,0,0,0,0,13493
3803,324,39,149,53,62,21,5,0,0,0,0,0,0,0,0,0,0,0,0,0,0,5,5,5,0,0,0,0,0,0,0,0,0,0,0,13494
3804,1610,236,496,538,246,94,106,52,42,0,0,42,10,0,0,0,0,10,0,0,10,54,54,6,0,48,0,0,0,0,0,0,0,0,0,13495
3805,23737,5518,7295,6774,2522,1628,2352,1297,1123,300,114,709,174,93,6,47,40,81,8,20,53,1055,984,297,103,584,71,43,0,0,43,28,0,9,19,13501
3806,21587,3326,6640,7619,2380,1622,2373,1157,1009,383,60,566,148,102,47,24,31,46,33,0,13,1216,942,245,135,562,274,160,91,62,7,114,4,43,67,13502
3807,24823,3130,7878,8278,3416,2121,1899,928,596,193,39,364,332,230,139,28,63,102,12,35,55,971,831,278,90,463,140,111,94,0,17,29,17,12,0,13601
3808,859,2,299,503,55,0,381,251,45,45,0,0,206,206,206,0,0,0,0,0,0,130,0,0,0,0,130,109,109,0,0,21,21,0,0,13602
3809,4389,361,1294,1919,539,276,532,183,99,26,16,57,84,84,84,0,0,0,0,0,0,349,273,73,4,196,76,76,7,8,61,0,0,0,0,13603
3810,3188,440,1042,1039,314,353,211,125,95,39,28,28,30,9,3,0,6,21,13,0,8,86,58,34,3,21,28,8,6,0,2,20,8,4,8,13605
3811,2298,287,963,796,123,129,152,106,106,40,0,66,0,0,0,0,0,0,0,0,0,46,46,24,7,15,0,0,0,0,0,0,0,0,0,13606
3812,1419,184,536,405,127,167,102,62,36,2,0,34,26,26,11,15,0,0,0,0,0,40,40,5,4,31,0,0,0,0,0,0,0,0,0,13607
3813,952,126,465,235,67,59,136,69,51,7,5,39,18,10,8,0,2,8,0,0,8,67,53,20,0,33,14,6,0,6,0,8,0,0,8,13608
3814,1842,241,620,577,246,158,95,56,49,26,5,18,7,7,0,7,0,0,0,0,0,39,38,5,15,18,1,1,1,0,0,0,0,0,0,13612
3815,1771,260,816,445,156,94,138,46,30,6,0,24,16,16,13,0,3,0,0,0,0,92,92,26,0,66,0,0,0,0,0,0,0,0,0,13613
3816,264,57,134,30,19,24,27,9,3,0,0,3,6,0,0,0,0,6,0,0,6,18,7,0,0,7,11,11,0,0,11,0,0,0,0,13614
3817,618,74,234,201,95,14,94,34,17,7,0,10,17,17,2,15,0,0,0,0,0,60,58,7,0,51,2,2,2,0,0,0,0,0,0,13615
3818,1066,213,392,384,36,41,97,48,0,0,0,0,48,15,0,0,15,33,0,0,33,49,45,7,0,38,4,4,4,0,0,0,0,0,0,13616
3819,6255,854,1614,1766,824,1197,1733,764,764,96,71,597,0,0,0,0,0,0,0,0,0,969,965,219,25,721,4,0,0,0,0,4,0,0,4,13617
3820,1439,141,477,474,173,174,63,38,25,8,0,17,13,7,7,0,0,6,0,6,0,25,25,0,9,16,0,0,0,0,0,0,0,0,0,13618
3821,7045,886,2915,2061,784,399,467,291,214,61,32,121,77,77,70,0,7,0,0,0,0,176,143,71,24,48,33,33,27,6,0,0,0,0,0,13619
3822,1528,218,746,328,128,108,103,64,64,17,0,47,0,0,0,0,0,0,0,0,0,39,35,0,0,35,4,4,4,0,0,0,0,0,0,13620
3823,371,20,188,84,30,49,21,4,4,0,0,4,0,0,0,0,0,0,0,0,0,17,17,0,0,17,0,0,0,0,0,0,0,0,0,13621
3824,1767,199,649,622,159,138,69,41,28,0,0,28,13,13,9,0,4,0,0,0,0,28,20,6,0,14,8,8,0,8,0,0,0,0,0,13622
3825,63,3,28,21,3,8,0,0,0,0,0,0,0,0,0,0,0,0,0,0,0,0,0,0,0,0,0,0,0,0,0,0,0,0,0,13623
3826,3723,504,1386,1090,450,293,195,107,55,4,0,51,52,52,47,0,5,0,0,0,0,88,73,53,0,20,15,15,10,0,5,0,0,0,0,13624
3827,1439,116,454,468,186,215,49,21,15,2,9,4,6,3,3,0,0,3,0,0,3,28,21,3,7,11,7,3,3,0,0,4,0,4,0,13625
3828,1375,174,629,434,73,65,134,85,72,32,0,40,13,13,6,7,0,0,0,0,0,49,49,16,0,33,0,0,0,0,0,0,0,0,0,13626
3829,145,11,50,53,23,8,14,12,3,3,0,0,9,7,3,4,0,2,0,2,0,2,2,1,0,1,0,0,0,0,0,0,0,0,0,13628
3830,904,144,368,268,76,48,72,58,41,6,0,35,17,0,0,0,0,17,0,0,17,14,14,6,8,0,0,0,0,0,0,0,0,0,0,13630
3831,189,36,68,51,23,11,25,1,1,0,0,1,0,0,0,0,0,0,0,0,0,24,6,4,0,2,18,0,0,0,0,18,0,0,18,13633
3832,3192,285,1242,1081,348,236,238,145,118,29,14,75,27,27,6,16,5,0,0,0,0,93,86,60,2,24,7,7,3,0,4,0,0,0,0,13634
3833,595,77,260,162,65,31,67,28,20,7,0,13,8,0,0,0,0,8,0,0,8,39,33,10,0,23,6,3,1,0,2,3,3,0,0,13635
3834,152,13,53,51,22,13,9,6,6,2,0,4,0,0,0,0,0,0,0,0,0,3,3,3,0,0,0,0,0,0,0,0,0,0,0,13636
3835,2437,203,756,818,313,347,342,230,184,39,47,98,46,43,43,0,0,3,0,3,0,112,64,17,0,47,48,48,48,0,0,0,0,0,0,13637
3836,150,4,68,55,23,0,0,0,0,0,0,0,0,0,0,0,0,0,0,0,0,0,0,0,0,0,0,0,0,0,0,0,0,0,0,13638
3837,126,10,67,34,5,10,2,0,0,0,0,0,0,0,0,0,0,0,0,0,0,2,2,2,0,0,0,0,0,0,0,0,0,0,0,13639
3838,241,30,55,53,52,51,0,0,0,0,0,0,0,0,0,0,0,0,0,0,0,0,0,0,0,0,0,0,0,0,0,0,0,0,0,13640
3839,69,5,20,30,14,0,0,0,0,0,0,0,0,0,0,0,0,0,0,0,0,0,0,0,0,0,0,0,0,0,0,0,0,0,0,13641
3840,6840,1162,2691,2088,625,274,490,311,237,41,19,177,74,70,39,31,0,4,0,0,4,179,102,44,7,51,77,44,18,7,19,33,0,0,33,13642
3841,26,0,0,26,0,0,0,0,0,0,0,0,0,0,0,0,0,0,0,0,0,0,0,0,0,0,0,0,0,0,0,0,0,0,0,13643
3842,1876,337,703,493,172,171,112,69,59,8,3,48,10,4,3,0,1,6,0,0,6,43,41,2,1,38,2,2,0,0,2,0,0,0,0,13646
3843,58,0,15,5,20,18,6,6,6,0,0,6,0,0,0,0,0,0,0,0,0,0,0,0,0,0,0,0,0,0,0,0,0,0,0,13647
3844,1525,212,613,541,109,50,109,67,43,0,1,42,24,24,0,24,0,0,0,0,0,42,39,5,0,34,3,3,0,3,0,0,0,0,0,13648
3845,869,75,303,339,102,50,108,43,43,8,0,35,0,0,0,0,0,0,0,0,0,65,56,12,5,39,9,9,9,0,0,0,0,0,0,13650
3846,126,0,18,30,59,19,0,0,0,0,0,0,0,0,0,0,0,0,0,0,0,0,0,0,0,0,0,0,0,0,0,0,0,0,0,13651
3847,1191,249,434,321,141,46,70,31,28,0,0,28,3,3,0,3,0,0,0,0,0,39,25,3,0,22,14,4,0,2,2,10,0,0,10,13652
3848,1405,406,401,359,122,117,199,150,35,6,9,20,115,12,12,0,0,103,0,3,100,49,27,5,0,22,22,0,0,0,0,22,2,2,18,13654
3849,2063,638,295,784,237,109,87,53,48,0,0,48,5,0,0,0,0,5,0,0,5,34,34,0,0,34,0,0,0,0,0,0,0,0,0,13655
3850,1845,140,847,532,153,173,112,64,32,0,10,22,32,32,0,32,0,0,0,0,0,48,48,0,8,40,0,0,0,0,0,0,0,0,0,13656
3851,1494,221,572,382,169,150,71,33,33,0,9,24,0,0,0,0,0,0,0,0,0,38,33,23,0,10,5,5,0,0,5,0,0,0,0,13658
3852,408,84,155,94,65,10,23,14,13,2,0,11,1,1,1,0,0,0,0,0,0,9,9,6,0,3,0,0,0,0,0,0,0,0,0,13659
3853,1555,296,594,357,105,203,199,134,105,2,0,103,29,13,3,10,0,16,0,9,7,65,44,2,0,42,21,7,0,7,0,14,10,0,4,13660
3854,1157,159,485,388,60,65,134,65,59,1,47,11,6,6,6,0,0,0,0,0,0,69,68,38,1,29,1,1,1,0,0,0,0,0,0,13661
3855,12114,1373,4652,4122,1048,919,666,383,333,106,35,192,50,50,44,0,6,0,0,0,0,283,264,85,30,149,19,8,8,0,0,11,0,11,0,13662
3856,358,28,155,110,43,22,36,27,27,11,0,16,0,0,0,0,0,0,0,0,0,9,7,0,0,7,2,2,2,0,0,0,0,0,0,13664
3857,751,240,347,141,23,0,80,54,54,21,0,33,0,0,0,0,0,0,0,0,0,26,26,23,0,3,0,0,0,0,0,0,0,0,0,13665
3858,243,111,78,38,3,13,12,10,10,0,0,10,0,0,0,0,0,0,0,0,0,2,2,0,0,2,0,0,0,0,0,0,0,0,0,13666
3859,1902,161,882,596,127,136,65,12,12,12,0,0,0,0,0,0,0,0,0,0,0,53,45,9,0,36,8,0,0,0,0,8,8,0,0,13667
3860,2260,200,830,798,252,180,132,81,79,16,0,63,2,0,0,0,0,2,0,0,2,51,51,9,17,25,0,0,0,0,0,0,0,0,0,13668
3861,11849,1558,4148,3946,1087,1110,698,392,318,73,21,224,74,54,29,25,0,20,0,0,20,306,258,134,17,107,48,33,33,0,0,15,0,0,15,13669
3862,341,65,191,65,3,17,23,5,2,0,0,2,3,3,0,0,3,0,0,0,0,18,16,0,0,16,2,2,2,0,0,0,0,0,0,13670
3863,539,41,238,179,63,18,0,0,0,0,0,0,0,0,0,0,0,0,0,0,0,0,0,0,0,0,0,0,0,0,0,0,0,0,0,13672
3864,1346,94,490,507,126,129,84,58,55,3,0,52,3,3,3,0,0,0,0,0,0,26,26,14,3,9,0,0,0,0,0,0,0,0,0,13673
3865,123,9,55,0,31,28,0,0,0,0,0,0,0,0,0,0,0,0,0,0,0,0,0,0,0,0,0,0,0,0,0,0,0,0,0,13674
3866,33,0,26,0,0,7,0,0,0,0,0,0,0,0,0,0,0,0,0,0,0,0,0,0,0,0,0,0,0,0,0,0,0,0,0,13675
3867,7243,538,2045,1906,1246,1508,3308,1596,1585,320,56,1209,11,11,6,5,0,0,0,0,0,1712,1673,435,140,1098,39,39,26,0,13,0,0,0,0,13676
3868,76,0,39,37,0,0,0,0,0,0,0,0,0,0,0,0,0,0,0,0,0,0,0,0,0,0,0,0,0,0,0,0,0,0,0,13677
3869,93,0,19,41,0,33,0,0,0,0,0,0,0,0,0,0,0,0,0,0,0,0,0,0,0,0,0,0,0,0,0,0,0,0,0,13678
3870,1180,207,430,326,107,110,71,55,55,8,26,21,0,0,0,0,0,0,0,0,0,16,16,0,0,16,0,0,0,0,0,0,0,0,0,13679
3871,794,141,230,309,72,42,45,26,17,0,0,17,9,0,0,0,0,9,9,0,0,19,14,1,0,13,5,5,0,0,5,0,0,0,0,13680
3872,497,68,230,139,39,21,37,22,17,0,0,17,5,0,0,0,0,5,0,5,0,15,15,2,0,13,0,0,0,0,0,0,0,0,0,13681
3873,546,46,269,142,50,39,36,8,2,0,2,0,6,6,5,1,0,0,0,0,0,28,28,14,0,14,0,0,0,0,0,0,0,0,0,13682
3874,795,78,377,255,61,24,63,38,28,3,0,25,10,8,8,0,0,2,0,0,2,25,20,3,0,17,5,5,2,0,3,0,0,0,0,13684
3875,1514,76,290,438,407,303,82,44,34,8,6,20,10,10,10,0,0,0,0,0,0,38,38,23,0,15,0,0,0,0,0,0,0,0,0,13685
3876,459,25,188,151,65,30,6,2,2,0,0,2,0,0,0,0,0,0,0,0,0,4,4,0,0,4,0,0,0,0,0,0,0,0,0,13687
3877,508,64,218,141,34,51,115,58,56,10,0,46,2,0,0,0,0,2,2,0,0,57,57,10,2,45,0,0,0,0,0,0,0,0,0,13690
3878,2106,289,892,669,148,108,262,127,79,14,0,65,48,25,0,25,0,23,2,9,12,135,126,44,9,73,9,9,9,0,0,0,0,0,0,13691
3879,45,0,0,0,45,0,0,0,0,0,0,0,0,0,0,0,0,0,0,0,0,0,0,0,0,0,0,0,0,0,0,0,0,0,0,13692
3880,415,44,194,103,57,17,0,0,0,0,0,0,0,0,0,0,0,0,0,0,0,0,0,0,0,0,0,0,0,0,0,0,0,0,0,13693
3881,1011,63,433,288,133,94,63,42,35,12,0,23,7,7,0,0,7,0,0,0,0,21,18,0,0,18,3,3,3,0,0,0,0,0,0,13694
3882,38,0,6,3,14,15,5,2,2,0,0,2,0,0,0,0,0,0,0,0,0,3,3,3,0,0,0,0,0,0,0,0,0,0,0,13695
3883,47,0,0,0,0,47,0,0,0,0,0,0,0,0,0,0,0,0,0,0,0,0,0,0,0,0,0,0,0,0,0,0,0,0,0,13696
3884,1424,216,627,410,58,113,79,47,17,0,0,17,30,30,30,0,0,0,0,0,0,32,28,0,0,28,4,1,0,1,0,3,3,0,0,13697
3885,2062,340,992,409,220,101,135,74,73,22,21,30,1,0,0,0,0,1,0,1,0,61,30,4,0,26,31,24,0,24,0,7,0,0,7,13730
3886,808,111,289,226,76,106,59,34,18,12,0,6,16,16,11,5,0,0,0,0,0,25,25,22,0,3,0,0,0,0,0,0,0,0,0,13731
3887,5646,267,1515,1691,1208,965,276,185,176,86,0,90,9,9,0,0,9,0,0,0,0,91,84,26,0,58,7,7,7,0,0,0,0,0,0,13732
3888,3838,567,1659,1048,326,238,290,242,179,22,33,124,63,5,3,0,2,58,0,2,56,48,48,4,3,41,0,0,0,0,0,0,0,0,0,13733
3889,1593,93,679,494,128,199,231,86,86,15,20,51,0,0,0,0,0,0,0,0,0,145,125,22,18,85,20,20,20,0,0,0,0,0,0,13734
3890,1645,205,743,486,112,99,204,87,60,24,5,31,27,19,10,9,0,8,0,0,8,117,117,34,0,83,0,0,0,0,0,0,0,0,0,13736
3891,677,130,215,252,53,27,45,21,12,0,8,4,9,9,0,9,0,0,0,0,0,24,16,0,0,16,8,8,0,0,8,0,0,0,0,13739
3892,347,21,78,95,64,89,15,8,8,2,0,6,0,0,0,0,0,0,0,0,0,7,0,0,0,0,7,7,7,0,0,0,0,0,0,13740
3893,2713,213,1088,982,244,186,188,166,137,71,0,66,29,29,13,16,0,0,0,0,0,22,22,2,0,20,0,0,0,0,0,0,0,0,0,13743
3894,962,63,373,284,119,123,36,25,25,20,0,5,0,0,0,0,0,0,0,0,0,11,11,0,0,11,0,0,0,0,0,0,0,0,0,13744
3895,1597,149,603,553,147,145,192,96,85,46,9,30,11,11,5,0,6,0,0,0,0,96,92,29,0,63,4,4,4,0,0,0,0,0,0,13746
3896,2804,200,1171,952,363,118,155,82,82,28,0,54,0,0,0,0,0,0,0,0,0,73,53,25,14,14,20,20,20,0,0,0,0,0,0,13748
3897,659,145,280,112,76,46,44,15,15,7,8,0,0,0,0,0,0,0,0,0,0,29,24,13,7,4,5,0,0,0,0,5,5,0,0,13750
3898,105,0,60,29,10,6,21,9,9,0,0,9,0,0,0,0,0,0,0,0,0,12,12,0,0,12,0,0,0,0,0,0,0,0,0,13751
3899,609,60,127,275,88,59,38,28,8,8,0,0,20,11,11,0,0,9,0,0,9,10,10,0,0,10,0,0,0,0,0,0,0,0,0,13752
3900,3352,351,890,1096,574,441,1070,643,618,113,74,431,25,25,11,3,11,0,0,0,0,427,421,127,7,287,6,6,0,0,6,0,0,0,0,13753
3901,2625,297,1176,715,191,246,206,114,98,13,3,82,16,16,11,0,5,0,0,0,0,92,74,38,0,36,18,18,18,0,0,0,0,0,0,13754
3902,898,101,326,241,136,94,79,37,31,0,0,31,6,6,6,0,0,0,0,0,0,42,36,13,0,23,6,6,0,6,0,0,0,0,0,13755
3903,358,46,159,113,17,23,23,0,0,0,0,0,0,0,0,0,0,0,0,0,0,23,23,16,0,7,0,0,0,0,0,0,0,0,0,13756
3904,803,64,307,220,124,88,31,13,8,0,0,8,5,0,0,0,0,5,5,0,0,18,9,7,0,2,9,9,9,0,0,0,0,0,0,13757
3905,31749,2293,9760,10089,5519,4088,2220,1025,901,375,89,437,124,112,79,33,0,12,0,12,0,1195,1131,425,98,608,64,44,0,29,15,20,2,0,18,13760
3906,133,23,78,32,0,0,111,70,59,36,0,23,11,11,11,0,0,0,0,0,0,41,0,0,0,0,41,41,41,0,0,0,0,0,0,13774
3907,1233,134,517,311,157,114,148,77,63,34,6,23,14,14,14,0,0,0,0,0,0,71,48,28,10,10,23,23,23,0,0,0,0,0,0,13775
3908,385,42,150,98,44,51,45,21,21,0,2,19,0,0,0,0,0,0,0,0,0,24,19,3,0,16,5,5,0,0,5,0,0,0,0,13776
3909,457,119,198,85,55,0,18,14,4,0,0,4,10,10,10,0,0,0,0,0,0,4,2,2,0,0,2,2,2,0,0,0,0,0,0,13777
3910,4285,415,1487,1574,433,376,422,180,180,28,9,143,0,0,0,0,0,0,0,0,0,242,230,109,0,121,12,12,10,0,2,0,0,0,0,13778
3911,776,193,268,195,51,69,42,16,16,0,0,16,0,0,0,0,0,0,0,0,0,26,26,7,0,19,0,0,0,0,0,0,0,0,0,13780
3912,499,54,234,146,30,35,19,13,8,8,0,0,5,5,5,0,0,0,0,0,0,6,4,4,0,0,2,0,0,0,0,2,0,0,2,13782
3913,1531,228,588,438,124,153,130,36,26,9,2,15,10,10,0,0,10,0,0,0,0,94,94,57,7,30,0,0,0,0,0,0,0,0,0,13783
3914,85,11,32,36,6,0,0,0,0,0,0,0,0,0,0,0,0,0,0,0,0,0,0,0,0,0,0,0,0,0,0,0,0,0,0,13784
3915,412,104,157,118,27,6,41,41,26,3,3,20,15,0,0,0,0,15,15,0,0,0,0,0,0,0,0,0,0,0,0,0,0,0,0,13786
3916,2467,269,1243,467,135,353,210,156,156,54,12,90,0,0,0,0,0,0,0,0,0,54,54,12,18,24,0,0,0,0,0,0,0,0,0,13787
3917,752,53,229,300,94,76,53,31,26,0,0,26,5,5,5,0,0,0,0,0,0,22,14,3,1,10,8,8,0,0,8,0,0,0,0,13788
3918,12995,1460,4637,3980,1662,1256,848,501,490,163,64,263,11,2,0,0,2,9,9,0,0,347,301,60,17,224,46,46,46,0,0,0,0,0,0,13790
3919,109,19,21,69,0,0,11,11,11,11,0,0,0,0,0,0,0,0,0,0,0,0,0,0,0,0,0,0,0,0,0,0,0,0,0,13794
3920,2625,368,1038,832,189,198,228,50,50,50,0,0,0,0,0,0,0,0,0,0,0,178,134,30,40,64,44,44,0,44,0,0,0,0,0,13795
3921,892,54,339,259,176,64,54,30,30,4,9,17,0,0,0,0,0,0,0,0,0,24,23,7,0,16,1,0,0,0,0,1,1,0,0,13796
3922,1331,122,664,363,142,40,129,92,67,16,6,45,25,15,12,0,3,10,7,0,3,37,37,12,3,22,0,0,0,0,0,0,0,0,0,13797
3923,892,183,368,224,68,49,48,31,16,2,5,9,15,15,2,10,3,0,0,0,0,17,8,4,0,4,9,9,5,0,4,0,0,0,0,13801
3924,406,17,137,212,27,13,6,6,3,0,0,3,3,3,0,0,3,0,0,0,0,0,0,0,0,0,0,0,0,0,0,0,0,0,0,13802
3925,2695,235,1178,864,282,136,232,100,89,25,0,64,11,11,8,0,3,0,0,0,0,132,124,16,0,108,8,8,4,1,3,0,0,0,0,13803
3926,356,38,158,101,42,17,29,13,8,0,0,8,5,5,0,5,0,0,0,0,0,16,8,4,4,0,8,8,8,0,0,0,0,0,0,13804
3927,155,12,72,34,22,15,9,0,0,0,0,0,0,0,0,0,0,0,0,0,0,9,9,9,0,0,0,0,0,0,0,0,0,0,0,13806
3928,762,67,259,235,111,90,44,31,31,0,0,31,0,0,0,0,0,0,0,0,0,13,8,0,0,8,5,5,5,0,0,0,0,0,0,13807
3929,1204,127,491,323,162,101,100,73,44,14,2,28,29,22,20,2,0,7,0,0,7,27,24,7,5,12,3,3,0,3,0,0,0,0,0,13808
3930,1080,156,457,331,88,48,159,45,39,21,0,18,6,6,6,0,0,0,0,0,0,114,114,11,27,76,0,0,0,0,0,0,0,0,0,13809
3931,807,87,325,272,81,42,12,10,10,0,0,10,0,0,0,0,0,0,0,0,0,2,2,0,2,0,0,0,0,0,0,0,0,0,0,13810
3932,2907,369,1102,909,298,229,277,115,115,37,3,75,0,0,0,0,0,0,0,0,0,162,110,5,12,93,52,52,52,0,0,0,0,0,0,13811
3933,1633,158,702,530,148,95,133,58,54,16,0,38,4,0,0,0,0,4,0,4,0,75,65,10,22,33,10,10,10,0,0,0,0,0,0,13812
3934,684,147,284,217,27,9,71,37,0,0,0,0,37,0,0,0,0,37,0,0,37,34,0,0,0,0,34,0,0,0,0,34,0,0,34,13813
3935,9794,1073,3634,3048,1074,965,639,384,284,40,0,244,100,59,0,55,4,41,16,9,16,255,228,55,3,170,27,23,13,0,10,4,0,0,4,13815
3936,11975,1055,3547,3155,2366,1852,3394,1492,1426,349,60,1017,66,25,0,0,25,41,14,5,22,1902,1846,416,111,1319,56,26,12,8,6,30,14,0,16,13820
3937,2593,413,756,845,345,234,202,82,34,4,0,30,48,34,0,12,22,14,0,0,14,120,113,19,9,85,7,7,7,0,0,0,0,0,0,13825
3938,0,0,0,0,0,0,0,0,0,0,0,0,0,0,0,0,0,0,0,0,0,0,0,0,0,0,0,0,0,0,0,0,0,0,0,13826
3939,8452,737,3037,2414,1387,877,758,404,358,170,0,188,46,26,26,0,0,20,15,0,5,354,293,79,34,180,61,27,23,0,4,34,34,0,0,13827
3940,3484,400,1282,1195,302,305,304,97,67,0,10,57,30,27,15,12,0,3,3,0,0,207,193,52,10,131,14,3,0,3,0,11,11,0,0,13830
3941,375,85,162,69,45,14,27,19,19,0,0,19,0,0,0,0,0,0,0,0,0,8,5,0,0,5,3,3,3,0,0,0,0,0,0,13832
3942,2630,294,1083,700,303,250,202,102,102,28,0,74,0,0,0,0,0,0,0,0,0,100,100,87,8,5,0,0,0,0,0,0,0,0,0,13833
3943,57,0,0,45,0,12,0,0,0,0,0,0,0,0,0,0,0,0,0,0,0,0,0,0,0,0,0,0,0,0,0,0,0,0,0,13834
3944,914,134,379,232,94,75,62,8,3,0,0,3,5,5,2,0,3,0,0,0,0,54,46,19,5,22,8,0,0,0,0,8,0,0,8,13835
3945,3108,283,1457,894,237,237,212,151,120,42,67,11,31,31,13,0,18,0,0,0,0,61,61,38,0,23,0,0,0,0,0,0,0,0,0,13838
3946,945,111,536,222,53,23,54,42,42,0,0,42,0,0,0,0,0,0,0,0,0,12,12,0,6,6,0,0,0,0,0,0,0,0,0,13839
3947,407,97,173,86,47,4,74,41,38,8,0,30,3,3,0,0,3,0,0,0,0,33,30,5,0,25,3,3,0,0,3,0,0,0,0,13841
3948,399,66,161,111,38,23,32,23,23,3,0,20,0,0,0,0,0,0,0,0,0,9,2,0,0,2,7,0,0,0,0,7,0,0,7,13842
3949,1273,162,527,380,122,82,83,61,61,10,27,24,0,0,0,0,0,0,0,0,0,22,22,2,0,20,0,0,0,0,0,0,0,0,0,13843
3950,585,91,236,136,76,46,43,18,15,0,0,15,3,3,0,0,3,0,0,0,0,25,14,10,0,4,11,0,0,0,0,11,0,0,11,13844
3951,19,0,19,0,0,0,0,0,0,0,0,0,0,0,0,0,0,0,0,0,0,0,0,0,0,0,0,0,0,0,0,0,0,0,0,13845
3952,209,18,62,41,56,32,15,15,15,0,0,15,0,0,0,0,0,0,0,0,0,0,0,0,0,0,0,0,0,0,0,0,0,0,0,13846
3953,42,10,18,14,0,0,10,10,10,0,0,10,0,0,0,0,0,0,0,0,0,0,0,0,0,0,0,0,0,0,0,0,0,0,0,13847
3954,2748,358,1078,867,306,139,147,96,57,22,11,24,39,7,7,0,0,32,0,0,32,51,41,25,4,12,10,6,6,0,0,4,0,0,4,13849
3955,15524,958,3644,4207,3258,3457,941,513,442,118,27,297,71,71,59,9,3,0,0,0,0,428,422,143,37,242,6,6,0,0,6,0,0,0,0,13850
3956,4785,897,2142,1021,390,335,222,121,46,0,5,41,75,23,0,23,0,52,0,0,52,101,66,0,0,66,35,35,0,35,0,0,0,0,0,13856
3957,101,8,41,16,36,0,5,5,5,0,0,5,0,0,0,0,0,0,0,0,0,0,0,0,0,0,0,0,0,0,0,0,0,0,0,13859
3958,34,0,0,8,17,9,26,9,0,0,0,0,9,9,9,0,0,0,0,0,0,17,0,0,0,0,17,17,0,0,17,0,0,0,0,13860
3959,213,4,71,83,55,0,32,6,6,0,0,6,0,0,0,0,0,0,0,0,0,26,17,0,0,17,9,9,0,0,9,0,0,0,0,13861
3960,2881,339,1254,800,281,207,208,97,89,24,11,54,8,8,8,0,0,0,0,0,0,111,105,19,13,73,6,6,0,6,0,0,0,0,0,13862
3961,452,57,257,104,24,10,36,14,7,1,1,5,7,7,4,2,1,0,0,0,0,22,10,0,0,10,12,12,5,2,5,0,0,0,0,13863
3962,860,124,321,274,92,49,101,40,40,40,0,0,0,0,0,0,0,0,0,0,0,61,0,0,0,0,61,61,61,0,0,0,0,0,0,13864
3963,4404,454,2014,1276,445,215,386,257,240,38,5,197,17,17,15,0,2,0,0,0,0,129,129,56,0,73,0,0,0,0,0,0,0,0,0,13865
3964,13154,1419,4238,4471,1936,1090,836,448,350,72,50,228,98,84,65,10,9,14,0,0,14,388,370,161,3,206,18,0,0,0,0,18,3,9,6,13901
3965,24,0,3,12,4,5,3824,1846,1846,302,78,1466,0,0,0,0,0,0,0,0,0,1978,1978,335,102,1541,0,0,0,0,0,0,0,0,0,13902
3966,12979,1539,3924,4131,1782,1603,1068,532,462,94,57,311,70,18,16,0,2,52,0,0,52,536,381,121,17,243,155,57,31,2,24,98,56,0,42,13903
3967,6388,958,2650,1723,644,413,438,282,253,15,16,222,29,19,0,0,19,10,0,9,1,156,121,23,25,73,35,34,29,5,0,1,0,0,1,13904
3968,17450,2530,5168,5067,2489,2196,1548,708,608,198,54,356,100,51,16,0,35,49,11,0,38,840,739,200,100,439,101,43,25,0,18,58,0,11,47,13905
3969,6770,607,2749,1980,824,610,727,439,280,134,6,140,159,142,68,74,0,17,0,0,17,288,247,121,0,126,41,41,31,0,10,0,0,0,0,14001
3970,8750,1036,3374,2694,1151,495,572,266,178,93,30,55,88,57,4,0,53,31,0,17,14,306,224,120,6,98,82,68,48,20,0,14,0,14,0,14004
3971,1374,114,548,489,155,68,108,54,50,7,1,42,4,4,4,0,0,0,0,0,0,54,42,20,4,18,12,12,12,0,0,0,0,0,0,14005
3972,6596,539,2573,2124,616,744,412,268,236,128,12,96,32,26,26,0,0,6,0,0,6,144,144,72,16,56,0,0,0,0,0,0,0,0,0,14006
3973,1038,120,357,418,99,44,171,30,30,0,11,19,0,0,0,0,0,0,0,0,0,141,99,66,0,33,42,42,0,0,42,0,0,0,0,14008
3974,4008,430,1513,1407,366,292,201,81,70,36,13,21,11,11,7,4,0,0,0,0,0,120,108,44,10,54,12,12,6,6,0,0,0,0,0,14009
3975,7682,1413,3121,2194,565,389,416,218,148,47,0,101,70,15,7,0,8,55,0,0,55,198,174,38,26,110,24,24,24,0,0,0,0,0,0,14011
3976,1629,101,811,502,161,54,163,71,71,28,0,43,0,0,0,0,0,0,0,0,0,92,82,5,7,70,10,10,2,0,8,0,0,0,0,14012
3977,1246,202,470,416,108,50,107,47,43,13,3,27,4,3,0,0,3,1,0,1,0,60,57,13,7,37,3,0,0,0,0,3,0,0,3,14013
3978,16274,1675,5710,5549,2075,1265,1067,576,428,77,27,324,148,82,40,29,13,66,0,0,66,491,367,163,29,175,124,55,37,11,7,69,22,24,23,14020
3979,1159,176,457,352,117,57,94,37,29,6,6,17,8,8,5,3,0,0,0,0,0,57,54,22,5,27,3,3,3,0,0,0,0,0,0,14024
3980,2295,97,574,757,472,395,137,101,101,69,18,14,0,0,0,0,0,0,0,0,0,36,36,36,0,0,0,0,0,0,0,0,0,0,0,14025
3981,603,73,100,251,82,97,32,0,0,0,0,0,0,0,0,0,0,0,0,0,0,32,32,32,0,0,0,0,0,0,0,0,0,0,0,14026
3982,986,68,385,361,119,53,44,25,25,0,0,25,0,0,0,0,0,0,0,0,0,19,17,0,0,17,2,0,0,0,0,2,2,0,0,14028
3983,1138,56,504,429,86,63,122,37,37,16,0,21,0,0,0,0,0,0,0,0,0,85,56,38,0,18,29,25,0,16,9,4,4,0,0,14030
3984,7050,323,1592,2210,1655,1270,494,280,235,118,10,107,45,21,21,0,0,24,0,0,24,214,214,130,12,72,0,0,0,0,0,0,0,0,0,14031
3985,4889,125,1114,1409,1060,1181,403,193,174,17,0,157,19,9,9,0,0,10,10,0,0,210,203,91,8,104,7,7,7,0,0,0,0,0,0,14032
3986,1456,25,530,468,268,165,89,81,71,0,18,53,10,10,10,0,0,0,0,0,0,8,8,0,0,8,0,0,0,0,0,0,0,0,0,14033
3987,2361,408,1069,556,248,80,116,98,66,8,20,38,32,32,15,7,10,0,0,0,0,18,18,10,0,8,0,0,0,0,0,0,0,0,0,14034
3988,131,13,90,14,7,7,0,0,0,0,0,0,0,0,0,0,0,0,0,0,0,0,0,0,0,0,0,0,0,0,0,0,0,0,0,14035
3989,3692,317,1586,1064,429,296,383,166,131,12,25,94,35,35,33,2,0,0,0,0,0,217,199,111,3,85,18,8,8,0,0,10,0,0,10,14036
3990,722,64,242,202,144,70,42,36,30,8,0,22,6,6,6,0,0,0,0,0,0,6,6,0,0,6,0,0,0,0,0,0,0,0,0,14037
3991,75,0,47,17,8,3,0,0,0,0,0,0,0,0,0,0,0,0,0,0,0,0,0,0,0,0,0,0,0,0,0,0,0,0,0,14039
3992,1488,116,601,471,203,97,205,102,72,6,0,66,30,16,5,11,0,14,14,0,0,103,89,21,0,68,14,11,0,0,11,3,3,0,0,14040
3993,167,30,95,33,2,7,43,10,10,0,0,10,0,0,0,0,0,0,0,0,0,33,22,0,0,22,11,11,11,0,0,0,0,0,0,14041
3994,2425,403,1066,705,171,80,196,113,95,21,23,51,18,14,3,9,2,4,0,0,4,83,70,4,22,44,13,13,9,4,0,0,0,0,0,14042
3995,17319,1631,6761,5377,2372,1178,987,466,412,104,50,258,54,37,19,17,1,17,7,10,0,521,381,98,35,248,140,111,111,0,0,29,0,0,29,14043
3996,4723,427,1500,1590,762,444,411,300,201,133,5,63,99,82,60,0,22,17,5,12,0,111,111,8,29,74,0,0,0,0,0,0,0,0,0,14047
3997,10337,1816,3594,3161,908,858,832,387,291,41,18,232,96,74,20,37,17,22,4,3,15,445,311,67,73,171,134,86,63,0,23,48,7,23,18,14048
3998,13546,561,1694,3034,3669,4588,1162,646,636,335,43,258,10,10,10,0,0,0,0,0,0,516,484,197,68,219,32,9,9,0,0,23,0,0,23,14051
3999,11851,631,2600,3448,2815,2357,795,343,307,126,6,175,36,36,0,10,26,0,0,0,0,452,429,122,7,300,23,23,8,0,15,0,0,0,0,14052
4000,917,92,303,329,109,84,56,29,21,6,0,15,8,8,4,4,0,0,0,0,0,27,21,3,2,16,6,3,0,0,3,3,0,0,3,14054
4001,1034,96,442,265,137,94,121,40,29,0,25,4,11,11,0,11,0,0,0,0,0,81,59,16,0,43,22,22,3,19,0,0,0,0,0,14055
4002,5879,426,1843,1942,1014,654,359,205,194,117,16,61,11,11,11,0,0,0,0,0,0,154,154,58,9,87,0,0,0,0,0,0,0,0,0,14057
4003,1524,215,469,478,251,111,86,58,56,11,2,43,2,2,2,0,0,0,0,0,0,28,28,13,0,15,0,0,0,0,0,0,0,0,0,14058
4004,7204,313,2449,1953,1438,1051,405,214,185,51,0,134,29,29,0,11,18,0,0,0,0,191,176,74,19,83,15,15,15,0,0,0,0,0,0,14059
4005,445,94,222,74,19,36,35,23,23,12,0,11,0,0,0,0,0,0,0,0,0,12,12,0,0,12,0,0,0,0,0,0,0,0,0,14060
4006,200,16,86,76,16,6,11,4,4,0,1,3,0,0,0,0,0,0,0,0,0,7,7,0,1,6,0,0,0,0,0,0,0,0,0,14061
4007,2261,261,982,772,134,112,143,101,98,36,0,62,3,0,0,0,0,3,0,0,3,42,36,0,8,28,6,6,3,0,3,0,0,0,0,14062
4008,8229,463,2601,2250,1504,1411,2187,977,969,278,19,672,8,4,0,0,4,4,0,0,4,1210,1160,386,113,661,50,7,7,0,0,43,15,28,0,14063
4009,1281,287,598,273,100,23,50,9,8,0,6,2,1,0,0,0,0,1,0,1,0,41,37,16,0,21,4,0,0,0,0,4,0,0,4,14065
4010,827,70,445,233,42,37,102,61,59,8,2,49,2,2,2,0,0,0,0,0,0,41,33,10,4,19,8,8,0,8,0,0,0,0,0,14066
4011,3838,455,1628,1050,477,228,254,119,119,48,0,71,0,0,0,0,0,0,0,0,0,135,99,57,27,15,36,18,0,0,18,18,18,0,0,14067
4012,5242,402,1081,1476,1247,1036,425,207,188,104,0,84,19,0,0,0,0,19,0,0,19,218,218,160,10,48,0,0,0,0,0,0,0,0,0,14068
4013,584,36,214,160,89,85,38,15,15,8,0,7,0,0,0,0,0,0,0,0,0,23,23,0,0,23,0,0,0,0,0,0,0,0,0,14069
4014,4842,929,1876,1410,377,250,205,115,66,24,8,34,49,41,6,26,9,8,0,0,8,90,83,34,4,45,7,7,0,4,3,0,0,0,0,14070
4015,14054,516,3205,4379,3248,2706,1206,558,546,141,32,373,12,12,12,0,0,0,0,0,0,648,564,188,28,348,84,84,15,37,32,0,0,0,0,14072
4016,30358,1971,8316,10435,5419,4217,2354,1142,909,438,125,346,233,173,113,7,53,60,60,0,0,1212,1188,558,139,491,24,24,11,13,0,0,0,0,0,14075
4017,3246,260,1250,1105,361,270,174,73,59,21,0,38,14,14,14,0,0,0,0,0,0,101,101,39,0,62,0,0,0,0,0,0,0,0,0,14080
4018,2293,340,826,632,290,205,179,118,94,5,0,89,24,22,3,19,0,2,2,0,0,61,45,3,0,42,16,6,0,4,2,10,0,0,10,14081
4019,233,14,105,57,28,29,7,0,0,0,0,0,0,0,0,0,0,0,0,0,0,7,7,0,0,7,0,0,0,0,0,0,0,0,0,14082
4020,4723,192,1151,1660,1032,688,345,252,245,58,0,187,7,0,0,0,0,7,0,0,7,93,69,22,0,47,24,24,24,0,0,0,0,0,0,14085
4021,21961,1063,6133,7297,4824,2644,1515,971,882,443,57,382,89,89,34,55,0,0,0,0,0,544,529,249,50,230,15,15,15,0,0,0,0,0,0,14086
4022,805,151,330,201,39,84,21,12,12,12,0,0,0,0,0,0,0,0,0,0,0,9,9,0,0,9,0,0,0,0,0,0,0,0,0,14091
4023,8502,534,2061,2464,1695,1748,420,213,199,66,9,124,14,14,8,6,0,0,0,0,0,207,182,57,0,125,25,0,0,0,0,25,25,0,0,14092
4024,35259,3525,12580,11199,4817,3138,2282,1106,991,289,65,637,115,88,28,26,34,27,0,0,27,1176,1104,346,145,613,72,59,46,13,0,13,0,13,0,14094
4025,2121,336,878,618,142,147,221,118,100,16,0,84,18,11,3,3,5,7,0,7,0,103,79,21,10,48,24,12,12,0,0,12,6,0,6,14098
4026,1461,186,717,341,118,99,118,54,41,29,0,12,13,13,13,0,0,0,0,0,0,64,52,4,0,48,12,12,12,0,0,0,0,0,0,14101
4027,1027,15,359,308,164,181,134,63,63,12,9,42,0,0,0,0,0,0,0,0,0,71,57,41,16,0,14,14,14,0,0,0,0,0,0,14102
4028,7307,927,3054,2023,711,592,538,226,199,19,0,180,27,22,0,22,0,5,0,0,5,312,251,103,16,132,61,38,38,0,0,23,14,0,9,14103
4029,2833,303,958,1010,335,227,141,105,93,19,3,71,12,3,0,0,3,9,0,0,9,36,36,15,4,17,0,0,0,0,0,0,0,0,0,14105
4030,4082,360,1512,1420,499,291,145,31,31,0,8,23,0,0,0,0,0,0,0,0,0,114,114,13,18,83,0,0,0,0,0,0,0,0,0,14108
4031,8,0,0,0,8,0,569,184,184,57,7,120,0,0,0,0,0,0,0,0,0,385,385,142,21,222,0,0,0,0,0,0,0,0,0,14109
4032,2427,172,877,959,271,148,132,80,80,24,0,56,0,0,0,0,0,0,0,0,0,52,52,40,0,12,0,0,0,0,0,0,0,0,0,14111
4033,8,0,0,8,0,0,0,0,0,0,0,0,0,0,0,0,0,0,0,0,0,0,0,0,0,0,0,0,0,0,0,0,0,0,0,14112
4034,436,33,187,142,39,35,48,17,11,0,0,11,6,6,6,0,0,0,0,0,0,31,24,24,0,0,7,7,7,0,0,0,0,0,0,14113
4035,31277,2559,10285,9986,4919,3528,2005,1102,951,343,160,448,151,144,73,0,71,7,0,0,7,903,758,397,70,291,145,105,58,47,0,40,0,22,18,14120
4036,2496,372,904,856,246,118,268,89,74,22,2,50,15,10,5,5,0,5,0,5,0,179,165,11,10,144,14,14,14,0,0,0,0,0,0,14125
4037,531,42,141,184,141,23,51,51,51,0,23,28,0,0,0,0,0,0,0,0,0,0,0,0,0,0,0,0,0,0,0,0,0,0,0,14126
4038,21075,845,4552,5992,5050,4636,1625,858,792,278,0,514,66,66,36,13,17,0,0,0,0,767,698,291,80,327,69,51,41,0,10,18,0,0,18,14127
4039,1050,81,470,372,58,69,68,38,32,0,4,28,6,6,0,6,0,0,0,0,0,30,23,10,3,10,7,2,2,0,0,5,0,5,0,14129
4040,145,14,82,37,7,5,27,14,12,0,0,12,2,2,2,0,0,0,0,0,0,13,9,0,2,7,4,4,4,0,0,0,0,0,0,14130
4041,3425,399,1389,1134,332,171,311,199,174,64,17,93,25,12,0,12,0,13,0,0,13,112,103,66,0,37,9,9,0,9,0,0,0,0,0,14131
4042,4322,246,1776,1293,561,446,655,267,206,33,7,166,61,61,33,28,0,0,0,0,0,388,253,100,6,147,135,73,50,23,0,62,62,0,0,14132
4043,69,25,21,16,7,0,8,8,8,0,0,8,0,0,0,0,0,0,0,0,0,0,0,0,0,0,0,0,0,0,0,0,0,0,0,14134
4044,85,4,25,28,18,10,13,13,13,5,0,8,0,0,0,0,0,0,0,0,0,0,0,0,0,0,0,0,0,0,0,0,0,0,0,14135
4045,3606,396,1415,1228,234,333,210,124,98,30,0,68,26,0,0,0,0,26,13,13,0,86,81,11,0,70,5,5,0,5,0,0,0,0,0,14136
4046,1330,181,609,372,102,66,113,72,61,15,6,40,11,7,7,0,0,4,4,0,0,41,27,3,0,24,14,9,9,0,0,5,0,0,5,14138
4047,1403,97,414,450,299,143,132,50,50,14,0,36,0,0,0,0,0,0,0,0,0,82,82,10,12,60,0,0,0,0,0,0,0,0,0,14139
4048,5426,537,2110,1651,644,484,323,146,129,52,19,58,17,17,17,0,0,0,0,0,0,177,144,119,0,25,33,29,21,0,8,4,0,0,4,14141
4049,834,131,298,271,76,58,80,43,38,3,24,11,5,5,0,5,0,0,0,0,0,37,22,15,0,7,15,15,15,0,0,0,0,0,0,14143
4050,1030,85,530,305,75,35,120,55,41,14,0,27,14,14,14,0,0,0,0,0,0,65,53,15,0,38,12,12,6,0,6,0,0,0,0,14145
4051,30652,2441,10423,10145,4645,2998,1781,993,857,322,85,450,136,79,32,39,8,57,29,0,28,788,705,392,26,287,83,52,29,12,11,31,0,0,31,14150
4052,1231,122,488,443,125,53,79,66,35,14,0,21,31,31,14,17,0,0,0,0,0,13,13,5,0,8,0,0,0,0,0,0,0,0,0,14167
4053,50,0,8,17,17,8,6,6,6,0,0,6,0,0,0,0,0,0,0,0,0,0,0,0,0,0,0,0,0,0,0,0,0,0,0,14168
4054,195,0,30,165,0,0,23,23,23,0,0,23,0,0,0,0,0,0,0,0,0,0,0,0,0,0,0,0,0,0,0,0,0,0,0,14169
4055,1673,111,502,588,211,261,118,61,61,39,13,9,0,0,0,0,0,0,0,0,0,57,46,0,0,46,11,0,0,0,0,11,0,0,11,14170
4056,1442,168,595,438,151,90,147,70,49,8,0,41,21,13,13,0,0,8,8,0,0,77,71,10,6,55,6,6,0,0,6,0,0,0,0,14171
4057,2360,151,749,811,336,313,131,80,63,36,3,24,17,13,0,0,13,4,0,4,0,51,41,15,0,26,10,0,0,0,0,10,0,0,10,14172
4058,176,0,65,36,44,31,0,0,0,0,0,0,0,0,0,0,0,0,0,0,0,0,0,0,0,0,0,0,0,0,0,0,0,0,0,14173
4059,4186,233,1345,1211,751,646,275,161,126,26,18,82,35,35,5,22,8,0,0,0,0,114,103,30,0,73,11,10,0,10,0,1,1,0,0,14174
4060,8253,2141,1905,1939,1137,1131,806,426,378,38,13,327,48,0,0,0,0,48,40,0,8,380,343,86,23,234,37,20,2,0,18,17,2,0,15,14201
4061,2598,361,657,674,382,524,254,157,53,0,2,51,104,31,0,0,31,73,5,0,68,97,63,7,23,33,34,21,15,6,0,13,0,0,13,14202
4062,1042,237,278,140,216,171,74,39,13,1,0,12,26,0,0,0,0,26,0,0,26,35,35,4,0,31,0,0,0,0,0,0,0,0,0,14203
4063,6181,1548,1666,2040,610,317,510,316,258,42,71,145,58,28,0,0,28,30,0,10,20,194,92,47,9,36,102,71,31,40,0,31,0,0,31,14204
4064,15335,2811,5984,4782,1124,634,1062,374,268,50,25,193,106,99,65,6,28,7,7,0,0,688,542,131,96,315,146,58,58,0,0,88,52,23,13,14206
4065,13809,3569,4464,3876,1447,453,1241,649,506,60,47,399,143,81,57,12,12,62,0,36,26,592,500,86,71,343,92,63,0,63,0,29,8,12,9,14207
4066,6361,1328,1947,2201,487,398,1251,658,585,150,65,370,73,17,0,0,17,56,12,44,0,593,552,216,38,298,41,31,31,0,0,10,0,10,0,14208
4067,5859,651,971,1508,1261,1468,506,184,158,28,24,106,26,26,0,0,26,0,0,0,0,322,284,46,42,196,38,38,0,0,38,0,0,0,0,14209
4068,9207,1940,3558,2754,743,212,721,338,214,74,51,89,124,86,49,32,5,38,0,23,15,383,268,60,49,159,115,43,43,0,0,72,20,0,52,14210
4069,12244,2761,3867,4098,1009,509,1464,757,559,56,91,412,198,90,19,17,54,108,16,60,32,707,595,124,91,380,112,48,5,5,38,64,0,0,64,14211
4070,6669,1812,2346,2086,363,62,645,465,427,80,33,314,38,10,10,0,0,28,0,10,18,180,143,19,17,107,37,0,0,0,0,37,0,13,24,14212
4071,14111,4000,3496,3186,1892,1537,1384,682,604,110,73,421,78,64,25,39,0,14,0,0,14,702,653,173,111,369,49,30,14,0,16,19,0,0,19,14213
4072,12202,1364,2484,3585,2073,2696,1807,897,802,166,36,600,95,20,20,0,0,75,0,0,75,910,770,215,45,510,140,88,23,17,48,52,24,0,28,14214
4073,22577,3167,6998,8476,2107,1829,2821,1410,1108,213,78,817,302,215,132,33,50,87,0,23,64,1411,1199,320,77,802,212,168,27,97,44,44,12,21,11,14215
4074,16507,1378,3666,4905,3790,2768,1021,461,365,129,85,151,96,55,14,0,41,41,40,0,1,560,542,192,105,245,18,18,18,0,0,0,0,0,0,14216
4075,16608,1443,4583,5167,2915,2500,1064,468,419,173,29,217,49,28,28,0,0,21,0,21,0,596,545,258,52,235,51,51,23,14,14,0,0,0,0,14217
4076,13413,2412,4619,3865,1618,899,698,378,349,110,22,217,29,0,0,0,0,29,0,6,23,320,211,37,50,124,109,71,30,41,0,38,12,26,0,14218
4077,7838,695,3180,2847,826,290,533,324,301,150,60,91,23,21,8,0,13,2,0,2,0,209,199,90,19,90,10,10,7,3,0,0,0,0,0,14219
4078,17090,1668,6121,6006,2145,1150,1132,579,433,105,33,295,146,145,61,26,58,1,0,0,1,553,459,180,71,208,94,75,35,0,40,19,0,0,19,14220
4079,38964,1986,6843,9658,9771,10706,2193,1138,1076,400,63,613,62,51,0,51,0,11,10,0,1,1055,972,438,39,495,83,70,70,0,0,13,13,0,0,14221
4080,9743,527,944,1907,3061,3304,1592,654,619,145,54,420,35,35,34,0,1,0,0,0,0,938,899,296,103,500,39,39,39,0,0,0,0,0,0,14222
4081,15911,1048,4157,5104,3130,2472,1287,747,634,261,94,279,113,97,35,0,62,16,5,0,11,540,498,217,10,271,42,37,37,0,0,5,0,0,5,14223
4082,28958,2402,9614,9507,4195,3240,1718,863,743,287,77,379,120,120,32,42,46,0,0,0,0,855,807,380,65,362,48,48,26,22,0,0,0,0,0,14224
4083,23332,2073,8445,7829,3375,1610,1568,808,657,260,91,306,151,101,52,39,10,50,10,0,40,760,696,307,84,305,64,46,34,0,12,18,18,0,0,14225
4084,19752,921,3413,4668,5200,5550,1533,685,587,133,23,431,98,90,25,5,60,8,0,0,8,848,767,170,121,476,81,9,9,0,0,72,72,0,0,14226
4085,17848,2183,6448,5475,2522,1220,829,475,418,162,61,195,57,57,57,0,0,0,0,0,0,354,333,187,66,80,21,13,13,0,0,8,0,8,0,14227
4086,13471,686,3031,3684,3086,2984,1129,480,403,147,13,243,77,32,22,10,0,45,0,39,6,649,621,226,36,359,28,0,0,0,0,28,0,28,0,14228
4087,153,0,0,33,47,73,3023,1346,1346,276,53,1017,0,0,0,0,0,0,0,0,0,1677,1677,572,36,1069,0,0,0,0,0,0,0,0,0,14261
4088,8539,1819,3281,2582,570,287,968,552,396,105,27,264,156,106,38,31,37,50,0,8,42,416,317,66,16,235,99,73,45,6,22,26,14,0,12,14301
4089,49,16,33,0,0,0,0,0,0,0,0,0,0,0,0,0,0,0,0,0,0,0,0,0,0,0,0,0,0,0,0,0,0,0,0,14302
4090,3943,568,1592,1167,432,184,197,98,69,31,3,35,29,17,17,0,0,12,12,0,0,99,92,33,0,59,7,7,0,7,0,0,0,0,0,14303
4091,21598,2135,8248,7298,2320,1597,1408,792,654,315,28,311,138,138,62,25,51,0,0,0,0,616,549,276,58,215,67,67,58,0,9,0,0,0,0,14304
4092,11017,1446,4359,3452,1015,745,1323,558,428,116,33,279,130,84,46,38,0,46,0,27,19,765,683,363,16,304,82,69,30,6,33,13,13,0,0,14305
4093,9923,1682,4045,2732,1073,391,732,448,258,70,17,171,190,35,11,15,9,155,0,95,60,284,138,58,4,76,146,108,37,0,71,38,0,0,38,14411
4094,4846,218,1446,1587,978,617,245,183,183,26,45,112,0,0,0,0,0,0,0,0,0,62,62,35,0,27,0,0,0,0,0,0,0,0,0,14414
4095,65,0,51,9,5,0,6,0,0,0,0,0,0,0,0,0,0,0,0,0,0,6,6,6,0,0,0,0,0,0,0,0,0,0,0,14415
4096,2490,144,836,875,375,260,230,122,75,24,15,36,47,31,20,0,11,16,6,0,10,108,97,35,0,62,11,11,11,0,0,0,0,0,0,14416
4097,851,90,311,288,97,65,35,22,14,10,0,4,8,8,8,0,0,0,0,0,0,13,0,0,0,0,13,13,13,0,0,0,0,0,0,14418
4098,11146,910,3418,3202,1898,1718,2397,1129,1005,376,49,580,124,55,28,0,27,69,9,38,22,1268,1153,422,111,620,115,67,32,32,3,48,0,0,48,14420
4099,1757,84,727,624,194,128,156,94,71,4,7,60,23,19,19,0,0,4,4,0,0,62,47,4,0,43,15,15,5,0,10,0,0,0,0,14422
4100,3262,215,982,1182,465,418,328,196,196,48,4,144,0,0,0,0,0,0,0,0,0,132,105,45,3,57,27,21,4,0,17,6,0,6,0,14423
4101,19212,1474,4858,6071,3664,3145,1312,758,650,209,68,373,108,39,31,8,0,69,21,6,42,554,535,297,8,230,19,19,5,9,5,0,0,0,0,14424
4102,7077,473,1776,2655,1643,530,543,242,181,92,11,78,61,27,27,0,0,34,31,3,0,301,291,143,64,84,10,10,8,0,2,0,0,0,0,14425
4103,1475,117,685,423,165,85,90,39,39,5,0,34,0,0,0,0,0,0,0,0,0,51,51,0,0,51,0,0,0,0,0,0,0,0,0,14427
4104,6011,395,1720,2238,891,767,493,303,284,109,24,151,19,19,19,0,0,0,0,0,0,190,169,88,40,41,21,21,21,0,0,0,0,0,0,14428
4105,4060,362,1666,1263,602,167,272,150,121,40,14,67,29,12,5,0,7,17,0,0,17,122,111,37,22,52,11,11,0,11,0,0,0,0,0,14432
4106,2744,540,1170,797,166,71,293,200,85,6,10,69,115,52,25,7,20,63,32,12,19,93,83,17,38,28,10,3,0,3,0,7,0,0,7,14433
4107,2037,171,637,669,352,208,68,40,40,1,0,39,0,0,0,0,0,0,0,0,0,28,28,14,4,10,0,0,0,0,0,0,0,0,0,14435
4108,8311,1351,3262,2421,738,539,555,355,263,67,71,125,92,88,31,37,20,4,2,0,2,200,184,90,36,58,16,10,6,4,0,6,6,0,0,14437
4109,247,81,56,51,37,22,2,0,0,0,0,0,0,0,0,0,0,0,0,0,0,2,2,2,0,0,0,0,0,0,0,0,0,0,0,14441
4110,5611,497,1656,1856,879,723,442,240,174,58,23,93,66,66,66,0,0,0,0,0,0,202,176,103,10,63,26,0,0,0,0,26,0,0,26,14445
4111,29081,1032,4927,7617,8543,6962,2104,1068,927,298,83,546,141,132,87,0,45,9,9,0,0,1036,965,341,73,551,71,39,39,0,0,32,32,0,0,14450
4112,4814,444,1070,1325,927,1048,2404,981,959,250,31,678,22,18,13,0,5,4,0,0,4,1423,1423,413,14,996,0,0,0,0,0,0,0,0,0,14454
4113,12641,1633,3775,3797,1962,1474,1850,903,857,260,44,553,46,5,0,5,0,41,23,11,7,947,898,334,54,510,49,36,36,0,0,13,6,0,7,14456
4114,388,39,123,130,63,33,40,24,17,0,0,17,7,0,0,0,0,7,0,7,0,16,16,9,0,7,0,0,0,0,0,0,0,0,0,14462
4115,4666,271,1801,1602,754,238,332,170,146,63,8,75,24,24,0,0,24,0,0,0,0,162,153,46,32,75,9,9,0,9,0,0,0,0,0,14464
4116,1370,48,354,530,209,229,52,21,14,3,0,11,7,7,4,3,0,0,0,0,0,31,26,0,0,26,5,5,5,0,0,0,0,0,0,14466
4117,6755,530,1873,2361,1343,648,534,283,269,97,59,113,14,0,0,0,0,14,14,0,0,251,235,97,14,124,16,16,16,0,0,0,0,0,0,14467
4118,12961,783,3952,5082,1892,1252,932,439,351,83,31,237,88,67,56,11,0,21,8,13,0,493,459,119,68,272,34,21,0,0,21,13,0,0,13,14468
4119,4347,245,1329,1500,782,491,336,142,120,35,50,35,22,22,22,0,0,0,0,0,0,194,166,112,2,52,28,28,25,0,3,0,0,0,0,14469
4120,5617,672,2348,1792,538,267,479,267,211,53,0,158,56,40,2,23,15,16,0,16,0,212,195,39,58,98,17,14,14,0,0,3,0,3,0,14470
4121,2149,202,826,601,321,199,141,44,38,36,2,0,6,6,0,3,3,0,0,0,0,97,95,50,0,45,2,0,0,0,0,2,0,2,0,14471
4122,5607,152,795,1338,1672,1650,370,272,272,55,20,197,0,0,0,0,0,0,0,0,0,98,85,41,0,44,13,13,0,13,0,0,0,0,0,14472
4123,182,5,53,58,40,26,17,5,5,5,0,0,0,0,0,0,0,0,0,0,0,12,12,12,0,0,0,0,0,0,0,0,0,0,0,14475
4124,1633,92,533,661,215,132,134,36,36,7,0,29,0,0,0,0,0,0,0,0,0,98,98,23,0,75,0,0,0,0,0,0,0,0,0,14476
4125,1380,214,395,354,235,182,206,90,57,0,0,57,33,33,26,7,0,0,0,0,0,116,77,24,11,42,39,18,18,0,0,21,21,0,0,14477
4126,565,51,47,145,146,176,456,124,124,49,0,75,0,0,0,0,0,0,0,0,0,332,332,214,21,97,0,0,0,0,0,0,0,0,0,14478
4127,236,95,91,39,11,0,7,0,0,0,0,0,0,0,0,0,0,0,0,0,0,7,0,0,0,0,7,0,0,0,0,7,7,0,0,14479
4128,433,27,173,186,34,13,38,18,0,0,0,0,18,0,0,0,0,18,0,0,18,20,20,10,0,10,0,0,0,0,0,0,0,0,0,14480
4129,1392,237,587,358,122,88,91,34,26,1,0,25,8,8,6,2,0,0,0,0,0,57,43,8,0,35,14,3,0,3,0,11,0,0,11,14481
4130,5766,466,2177,1551,915,657,419,205,182,84,0,98,23,23,9,0,14,0,0,0,0,214,188,51,32,105,26,26,26,0,0,0,0,0,0,14482
4131,2935,140,1014,937,525,319,386,152,144,47,18,79,8,8,2,0,6,0,0,0,0,234,232,96,0,136,2,2,2,0,0,0,0,0,0,14485
4132,179,10,54,56,50,9,0,0,0,0,0,0,0,0,0,0,0,0,0,0,0,0,0,0,0,0,0,0,0,0,0,0,0,0,0,14486
4133,4000,159,1278,1377,692,494,397,180,126,53,0,73,54,54,16,0,38,0,0,0,0,217,196,49,0,147,21,21,21,0,0,0,0,0,0,14487
4134,5237,761,2205,1503,545,223,426,213,152,50,46,56,61,42,8,0,34,19,0,13,6,213,191,0,25,166,22,11,11,0,0,11,0,0,11,14489
4135,7109,452,1931,2292,1433,1001,584,287,260,58,23,179,27,23,22,0,1,4,0,3,1,297,262,74,18,170,35,32,19,0,13,3,3,0,0,14502
4136,1147,103,450,461,99,34,67,45,43,8,3,32,2,2,2,0,0,0,0,0,0,22,11,6,0,5,11,8,8,0,0,3,3,0,0,14504
4137,3582,348,1329,1075,473,357,363,213,167,33,20,114,46,23,10,0,13,23,0,0,23,150,139,86,11,42,11,11,11,0,0,0,0,0,0,14505
4138,920,5,41,224,412,238,14,14,14,0,0,14,0,0,0,0,0,0,0,0,0,0,0,0,0,0,0,0,0,0,0,0,0,0,0,14506
4139,944,93,337,306,135,73,69,39,21,7,0,14,18,11,2,7,2,7,3,0,4,30,23,5,0,18,7,7,0,3,4,0,0,0,0,14507
4140,3408,837,1301,909,207,154,234,124,106,52,0,54,18,8,8,0,0,10,0,0,10,110,34,2,0,32,76,12,0,0,12,64,0,0,64,14510
4141,328,12,88,76,74,78,0,0,0,0,0,0,0,0,0,0,0,0,0,0,0,0,0,0,0,0,0,0,0,0,0,0,0,0,0,14511
4142,3477,301,1127,1104,516,429,285,120,96,16,0,80,24,12,8,4,0,12,6,6,0,165,165,23,7,135,0,0,0,0,0,0,0,0,0,14512
4143,9507,1333,3722,2841,947,664,831,389,267,66,41,160,122,81,8,0,73,41,0,38,3,442,417,212,64,141,25,25,25,0,0,0,0,0,0,14513
4144,4135,253,1178,1401,749,554,362,256,233,26,77,130,23,23,0,23,0,0,0,0,0,106,94,57,0,37,12,12,12,0,0,0,0,0,0,14514
4145,1451,245,525,439,132,110,130,85,69,45,0,24,16,8,8,0,0,8,0,0,8,45,45,11,0,34,0,0,0,0,0,0,0,0,0,14516
4146,1986,250,953,522,145,116,93,47,36,13,0,23,11,11,11,0,0,0,0,0,0,46,33,19,0,14,13,0,0,0,0,13,0,0,13,14517
4147,8120,450,2640,2844,1381,805,499,246,246,130,21,95,0,0,0,0,0,0,0,0,0,253,228,78,31,119,25,25,11,0,14,0,0,0,0,14519
4148,1859,390,617,522,207,123,157,99,65,17,1,47,34,7,7,0,0,27,17,0,10,58,38,4,0,34,20,6,2,0,4,14,3,0,11,14521
4149,6860,765,2356,2460,925,354,414,197,182,44,0,138,15,15,0,15,0,0,0,0,0,217,199,116,0,83,18,18,0,0,18,0,0,0,0,14522
4150,1867,139,777,587,188,176,154,80,74,29,13,32,6,3,0,0,3,3,0,0,3,74,71,20,15,36,3,3,3,0,0,0,0,0,0,14525
4151,14007,793,2152,3930,3539,3593,1287,596,533,82,36,415,63,63,28,35,0,0,0,0,0,691,691,252,5,434,0,0,0,0,0,0,0,0,0,14526
4152,8638,1338,3135,2153,1060,952,726,440,284,62,41,181,156,53,22,0,31,103,41,15,47,286,216,91,0,125,70,14,14,0,0,56,39,0,17,14527
4153,87,0,79,8,0,0,10,10,10,0,0,10,0,0,0,0,0,0,0,0,0,0,0,0,0,0,0,0,0,0,0,0,0,0,0,14529
4154,3734,511,1297,1370,317,239,199,119,92,37,0,55,27,12,12,0,0,15,0,15,0,80,80,33,12,35,0,0,0,0,0,0,0,0,0,14530
4155,3092,196,1275,1077,361,183,287,212,171,48,21,102,41,29,14,15,0,12,0,0,12,75,57,45,0,12,18,5,5,0,0,13,13,0,0,14532
4156,1307,144,563,402,93,105,57,17,17,0,0,17,0,0,0,0,0,0,0,0,0,40,17,13,0,4,23,23,23,0,0,0,0,0,0,14533
4157,22363,291,2220,4011,7541,8300,2040,1026,978,414,49,515,48,44,32,12,0,4,0,0,4,1014,956,307,56,593,58,43,17,0,26,15,15,0,0,14534
4158,437,67,192,138,25,15,22,7,4,0,0,4,3,2,0,2,0,1,0,0,1,15,15,1,0,14,0,0,0,0,0,0,0,0,0,14536
4159,145,36,58,29,0,22,5,5,5,5,0,0,0,0,0,0,0,0,0,0,0,0,0,0,0,0,0,0,0,0,0,0,0,0,0,14537
4160,102,0,27,19,37,19,6,0,0,0,0,0,0,0,0,0,0,0,0,0,0,6,6,6,0,0,0,0,0,0,0,0,0,0,0,14539
4161,3162,947,1044,785,231,155,214,134,86,8,0,78,48,13,3,0,10,35,0,0,35,80,57,7,4,46,23,7,7,0,0,16,2,3,11,14541
4162,41,0,5,0,31,5,0,0,0,0,0,0,0,0,0,0,0,0,0,0,0,0,0,0,0,0,0,0,0,0,0,0,0,0,0,14542
4163,2291,115,657,644,458,417,139,57,57,12,0,45,0,0,0,0,0,0,0,0,0,82,80,80,0,0,2,0,0,0,0,2,0,0,2,14543
4164,1548,240,461,494,169,184,182,113,94,37,23,34,19,0,0,0,0,19,8,0,11,69,40,5,0,35,29,6,2,4,0,23,9,5,9,14544
4165,129,6,48,48,22,5,10,3,3,0,0,3,0,0,0,0,0,0,0,0,0,7,7,0,0,7,0,0,0,0,0,0,0,0,0,14545
4166,3488,227,1058,1209,625,369,199,88,80,34,0,46,8,5,0,5,0,3,0,0,3,111,90,10,12,68,21,0,0,0,0,21,0,0,21,14546
4167,3081,435,1020,1182,340,104,174,66,48,15,8,25,18,18,16,2,0,0,0,0,0,108,97,10,0,87,11,8,8,0,0,3,0,3,0,14548
4168,30,0,12,14,4,0,0,0,0,0,0,0,0,0,0,0,0,0,0,0,0,0,0,0,0,0,0,0,0,0,0,0,0,0,0,14549
4169,1135,130,467,367,118,53,152,89,84,17,6,61,5,5,5,0,0,0,0,0,0,63,49,15,8,26,14,14,0,0,14,0,0,0,0,14550
4170,3768,535,1700,1022,341,170,243,100,91,0,0,91,9,9,0,9,0,0,0,0,0,143,136,39,16,81,7,7,0,0,7,0,0,0,0,14551
4171,964,80,338,294,164,88,64,43,38,12,2,24,5,3,3,0,0,2,0,0,2,21,21,10,0,11,0,0,0,0,0,0,0,0,0,14555
4172,12328,832,3208,3775,2674,1839,1110,548,502,96,69,337,46,37,28,0,9,9,0,0,9,562,530,219,13,298,32,23,23,0,0,9,9,0,0,14559
4173,1370,163,590,378,156,83,89,50,46,0,2,44,4,0,0,0,0,4,4,0,0,39,34,13,8,13,5,5,5,0,0,0,0,0,0,14560
4174,2171,245,738,682,351,155,151,80,80,17,7,56,0,0,0,0,0,0,0,0,0,71,42,5,22,15,29,15,4,0,11,14,14,0,0,14561
4175,9953,253,1797,2542,2787,2574,704,433,368,111,129,128,65,65,12,0,53,0,0,0,0,271,271,128,7,136,0,0,0,0,0,0,0,0,0,14564
4176,4035,153,961,1665,923,333,354,190,190,74,32,84,0,0,0,0,0,0,0,0,0,164,140,82,0,58,24,24,24,0,0,0,0,0,0,14568
4177,4356,737,1636,1412,367,204,263,124,110,25,0,85,14,14,14,0,0,0,0,0,0,139,139,99,4,36,0,0,0,0,0,0,0,0,0,14569
4178,921,180,393,208,93,47,49,34,34,0,7,27,0,0,0,0,0,0,0,0,0,15,15,0,0,15,0,0,0,0,0,0,0,0,0,14571
4179,3524,597,1409,1055,289,174,205,85,83,17,6,60,2,2,2,0,0,0,0,0,0,120,116,6,13,97,4,4,4,0,0,0,0,0,0,14572
4180,34804,1889,8020,10211,7912,6772,2201,1044,1021,296,95,630,23,20,19,0,1,3,0,2,1,1157,1070,476,51,543,87,67,17,0,50,20,0,18,2,14580
4181,67,21,34,4,8,0,0,0,0,0,0,0,0,0,0,0,0,0,0,0,0,0,0,0,0,0,0,0,0,0,0,0,0,0,0,14585
4182,6487,288,1625,1825,1569,1180,656,378,378,107,24,247,0,0,0,0,0,0,0,0,0,278,278,129,18,131,0,0,0,0,0,0,0,0,0,14586
4183,235,96,96,43,0,0,1,1,0,0,0,0,1,1,0,0,1,0,0,0,0,0,0,0,0,0,0,0,0,0,0,0,0,0,0,14588
4184,5463,637,1791,1852,701,482,362,183,168,58,26,84,15,12,0,0,12,3,0,0,3,179,140,32,25,83,39,24,14,10,0,15,15,0,0,14589
4185,3468,559,1497,964,223,225,261,122,115,54,4,57,7,7,4,0,3,0,0,0,0,139,116,30,0,86,23,23,0,15,8,0,0,0,0,14590
4186,1159,114,432,412,119,82,104,53,51,7,0,44,2,2,0,2,0,0,0,0,0,51,33,7,0,26,18,18,13,0,5,0,0,0,0,14591
4187,132,0,16,57,50,9,9,9,9,0,0,9,0,0,0,0,0,0,0,0,0,0,0,0,0,0,0,0,0,0,0,0,0,0,0,14592
4188,1356,265,357,370,65,299,92,48,48,0,0,48,0,0,0,0,0,0,0,0,0,44,34,34,0,0,10,10,0,5,5,0,0,0,0,14604
4189,6856,2308,2175,1663,367,343,1262,655,561,118,108,335,94,17,13,0,4,77,22,27,28,607,469,92,58,319,138,54,4,21,29,84,34,22,28,14605
4190,19268,3809,6899,5894,1994,672,1326,670,573,154,20,399,97,97,58,30,9,0,0,0,0,656,523,121,15,387,133,99,63,11,25,34,0,0,34,14606
4191,11644,732,1549,2639,4148,2576,257,114,113,38,3,72,1,0,0,0,0,1,0,0,1,143,103,63,0,40,40,40,23,0,17,0,0,0,0,14607
4192,7189,1827,2202,1878,723,559,768,372,286,77,22,187,86,8,8,0,0,78,0,25,53,396,276,89,35,152,120,26,26,0,0,94,0,18,76,14608
4193,27473,4121,8268,8370,4076,2638,2381,1307,1073,226,171,676,234,162,81,24,57,72,0,36,36,1074,865,145,56,664,209,105,46,16,43,104,12,14,78,14609
4194,10737,512,1615,2163,3015,3432,301,246,225,53,10,162,21,9,0,9,0,12,0,0,12,55,36,20,0,16,19,19,0,0,19,0,0,0,0,14610
4195,10152,2859,3386,3013,583,311,1210,560,508,173,2,333,52,14,14,0,0,38,0,1,37,650,475,104,45,326,175,129,50,55,24,46,16,0,30,14611
4196,25238,2075,7130,8372,4895,2766,1642,762,719,169,111,439,43,37,10,27,0,6,6,0,0,880,830,327,14,489,50,50,32,18,0,0,0,0,0,14612
4197,7338,1294,2811,2091,655,487,1142,578,495,70,92,333,83,57,40,17,0,26,0,0,26,564,466,94,24,348,98,28,5,15,8,70,0,37,33,14613
4198,797,291,268,212,17,9,132,114,9,0,0,9,105,0,0,0,0,105,0,0,105,18,9,0,0,9,9,0,0,0,0,9,0,0,9,14614
4199,10459,1522,3537,3271,1455,674,663,292,257,83,21,153,35,21,21,0,0,14,0,0,14,371,250,58,8,184,121,70,0,27,43,51,0,11,40,14615
4200,20196,2461,6586,6489,3104,1556,1640,696,620,120,67,433,76,62,48,0,14,14,14,0,0,944,719,263,138,318,225,76,0,12,64,149,0,0,149,14616
4201,16112,1042,3309,4743,4149,2869,1416,745,653,211,42,400,92,52,41,10,1,40,8,21,11,671,642,190,16,436,29,25,17,0,8,4,4,0,0,14617
4202,14361,602,1451,2498,4285,5525,2167,1099,1053,264,27,762,46,46,34,0,12,0,0,0,0,1068,1065,514,22,529,3,3,3,0,0,0,0,0,0,14618
4203,9022,1233,2575,3304,1202,708,973,547,481,158,18,305,66,47,31,0,16,19,19,0,0,426,336,159,39,138,90,43,10,13,20,47,0,10,37,14619
4204,18152,2124,2698,4436,4738,4156,1297,627,525,221,42,262,102,53,4,49,0,49,19,0,30,670,623,206,35,382,47,18,7,0,11,29,0,14,15,14620
4205,20556,6836,6487,5232,1136,865,2264,1127,939,129,122,688,188,119,26,75,18,69,0,38,31,1137,924,205,230,489,213,131,50,14,67,82,8,18,56,14621
4206,9067,1183,2850,2617,1589,828,392,158,130,24,18,88,28,28,7,21,0,0,0,0,0,234,202,63,46,93,32,11,11,0,0,21,0,0,21,14622
4207,13519,1221,3105,4481,2683,2029,4288,2646,2530,609,272,1649,116,77,25,0,52,39,0,24,15,1642,1581,689,52,840,61,61,61,0,0,0,0,0,0,14623
4208,24611,1652,6903,7482,5448,3126,2407,1370,1304,295,68,941,66,53,53,0,0,13,0,13,0,1037,984,448,61,475,53,39,26,13,0,14,14,0,0,14624
4209,7681,316,1181,2072,2036,2076,583,344,323,92,0,231,21,21,12,0,9,0,0,0,0,239,225,40,35,150,14,14,14,0,0,0,0,0,0,14625
4210,22512,2135,6663,7152,3687,2875,958,389,324,59,27,238,65,21,13,0,8,44,11,0,33,569,510,292,12,206,59,59,29,11,19,0,0,0,0,14626
4211,16,0,0,13,0,3,1752,918,918,261,52,605,0,0,0,0,0,0,0,0,0,834,834,282,25,527,0,0,0,0,0,0,0,0,0,14627
4212,27213,3575,9568,9144,2866,2060,2155,1097,853,296,102,455,244,100,56,22,22,144,84,4,56,1058,872,284,33,555,186,122,58,34,30,64,8,10,46,14701
4213,4363,314,1568,1376,514,591,185,101,99,2,0,97,2,2,2,0,0,0,0,0,0,84,84,27,3,54,0,0,0,0,0,0,0,0,0,14706
4214,157,41,54,56,2,4,26,22,22,0,0,22,0,0,0,0,0,0,0,0,0,4,4,0,0,4,0,0,0,0,0,0,0,0,0,14707
4215,180,28,46,88,14,4,18,3,3,0,0,3,0,0,0,0,0,0,0,0,0,15,12,0,0,12,3,3,3,0,0,0,0,0,0,14708
4216,1063,144,437,299,111,72,52,26,13,4,0,9,13,1,1,0,0,12,5,0,7,26,21,5,0,16,5,3,0,0,3,2,0,0,2,14709
4217,2454,231,859,875,244,245,171,90,64,0,0,64,26,26,26,0,0,0,0,0,0,81,81,22,0,59,0,0,0,0,0,0,0,0,0,14710
4218,1232,176,521,359,93,83,93,47,33,2,0,31,14,5,5,0,0,9,0,0,9,46,41,19,0,22,5,0,0,0,0,5,0,0,5,14711
4219,2519,165,631,877,502,344,204,85,85,29,0,56,0,0,0,0,0,0,0,0,0,119,119,44,2,73,0,0,0,0,0,0,0,0,0,14712
4220,368,88,134,102,24,20,21,5,3,3,0,0,2,2,2,0,0,0,0,0,0,16,15,2,0,13,1,0,0,0,0,1,1,0,0,14714
4221,1918,239,922,514,144,99,112,81,70,10,0,60,11,8,0,3,5,3,3,0,0,31,25,14,0,11,6,6,3,3,0,0,0,0,0,14715
4222,2035,526,700,614,122,73,238,161,82,18,4,60,79,50,0,0,50,29,0,0,29,77,65,29,3,33,12,6,0,0,6,6,0,0,6,14716
4223,472,21,193,174,45,39,11,11,2,0,0,2,9,6,0,6,0,3,0,3,0,0,0,0,0,0,0,0,0,0,0,0,0,0,0,14717
4224,1432,197,548,400,174,113,284,166,132,10,0,122,34,12,3,0,9,22,4,0,18,118,103,5,0,98,15,6,0,0,6,9,0,0,9,14718
4225,2425,425,942,730,186,142,234,140,77,24,0,53,63,20,13,7,0,43,9,11,23,94,47,19,8,20,47,28,9,7,12,19,0,0,19,14719
4226,406,51,145,172,15,23,34,24,12,0,9,3,12,12,12,0,0,0,0,0,0,10,10,10,0,0,0,0,0,0,0,0,0,0,0,14720
4227,56,2,21,29,4,0,6,0,0,0,0,0,0,0,0,0,0,0,0,0,0,6,0,0,0,0,6,6,6,0,0,0,0,0,0,14721
4228,260,0,28,12,51,169,102,41,41,10,0,31,0,0,0,0,0,0,0,0,0,61,61,0,8,53,0,0,0,0,0,0,0,0,0,14722
4229,814,121,318,228,71,76,39,25,18,9,2,7,7,0,0,0,0,7,7,0,0,14,12,1,0,11,2,2,2,0,0,0,0,0,0,14723
4230,1523,285,582,440,133,83,178,105,50,16,2,32,55,0,0,0,0,55,24,0,31,73,42,18,4,20,31,0,0,0,0,31,3,0,28,14724
4231,1095,448,319,249,71,8,217,121,42,4,0,38,79,24,21,3,0,55,18,0,37,96,34,11,0,23,62,9,6,3,0,53,10,3,40,14726
4232,3685,276,1609,1071,356,373,178,113,105,17,6,82,8,8,0,2,6,0,0,0,0,65,63,27,4,32,2,2,2,0,0,0,0,0,0,14727
4233,531,141,127,136,69,58,28,28,9,0,0,9,19,19,10,9,0,0,0,0,0,0,0,0,0,0,0,0,0,0,0,0,0,0,0,14728
4234,631,59,259,238,42,33,43,25,25,10,0,15,0,0,0,0,0,0,0,0,0,18,12,3,0,9,6,6,6,0,0,0,0,0,0,14729
4235,978,68,273,318,171,148,72,46,40,10,0,30,6,6,6,0,0,0,0,0,0,26,26,21,0,5,0,0,0,0,0,0,0,0,0,14731
4236,128,8,55,58,0,7,9,6,6,4,0,2,0,0,0,0,0,0,0,0,0,3,3,3,0,0,0,0,0,0,0,0,0,0,0,14732
4237,2718,282,1120,911,233,172,146,110,99,15,34,50,11,4,4,0,0,7,0,0,7,36,22,4,3,15,14,14,11,0,3,0,0,0,0,14733
4238,1807,273,766,465,129,174,115,42,26,1,0,25,16,9,0,9,0,7,3,0,4,73,56,4,21,31,17,8,2,5,1,9,3,0,6,14735
4239,130,15,58,35,11,11,3,0,0,0,0,0,0,0,0,0,0,0,0,0,0,3,3,0,0,3,0,0,0,0,0,0,0,0,0,14736
4240,2840,387,1324,766,220,143,180,72,56,7,0,49,16,6,6,0,0,10,0,0,10,108,91,14,13,64,17,17,5,3,9,0,0,0,0,14737
4241,2774,233,870,1009,353,309,250,205,198,62,58,78,7,7,7,0,0,0,0,0,0,45,45,15,0,30,0,0,0,0,0,0,0,0,0,14738
4242,1754,305,819,427,115,88,144,91,78,9,6,63,13,4,3,1,0,9,0,8,1,53,49,8,0,41,4,0,0,0,0,4,0,0,4,14739
4243,1174,160,483,350,120,61,109,56,26,9,0,17,30,30,0,12,18,0,0,0,0,53,51,16,0,35,2,2,2,0,0,0,0,0,0,14740
4244,1609,226,628,358,199,198,161,112,98,52,0,46,14,0,0,0,0,14,0,0,14,49,33,8,0,25,16,16,0,0,16,0,0,0,0,14741
4245,215,6,108,60,10,31,0,0,0,0,0,0,0,0,0,0,0,0,0,0,0,0,0,0,0,0,0,0,0,0,0,0,0,0,0,14742
4246,1215,168,547,351,104,45,102,60,54,15,0,39,6,6,0,0,6,0,0,0,0,42,42,8,0,34,0,0,0,0,0,0,0,0,0,14743
4247,827,119,181,88,183,256,645,284,269,64,8,197,15,2,1,0,1,13,9,0,4,361,360,80,36,244,1,0,0,0,0,1,0,0,1,14744
4248,1580,189,669,497,150,75,109,81,76,34,0,42,5,5,0,0,5,0,0,0,0,28,28,5,4,19,0,0,0,0,0,0,0,0,0,14747
4249,520,132,262,89,34,3,31,11,11,2,6,3,0,0,0,0,0,0,0,0,0,20,15,0,0,15,5,5,5,0,0,0,0,0,0,14748
4250,3135,243,704,1104,567,517,106,48,40,8,0,32,8,0,0,0,0,8,0,0,8,58,58,20,0,38,0,0,0,0,0,0,0,0,0,14750
4251,133,9,18,49,28,29,11,11,11,0,0,11,0,0,0,0,0,0,0,0,0,0,0,0,0,0,0,0,0,0,0,0,0,0,0,14752
4252,678,87,358,166,58,9,89,51,26,5,0,21,25,0,0,0,0,25,0,11,14,38,35,11,0,24,3,3,0,0,3,0,0,0,0,14753
4253,505,82,250,126,30,17,34,13,10,4,0,6,3,3,3,0,0,0,0,0,0,21,21,5,0,16,0,0,0,0,0,0,0,0,0,14754
4254,2206,283,905,700,186,132,174,111,76,22,2,52,35,12,0,12,0,23,14,0,9,63,48,16,3,29,15,13,10,0,3,2,2,0,0,14755
4255,62,0,0,0,62,0,43,0,0,0,0,0,0,0,0,0,0,0,0,0,0,43,43,0,0,43,0,0,0,0,0,0,0,0,0,14756
4256,2548,268,896,681,400,303,167,114,97,21,5,71,17,15,1,9,5,2,0,0,2,53,53,4,3,46,0,0,0,0,0,0,0,0,0,14757
4257,12878,1196,5049,3742,1455,1436,868,430,323,118,32,173,107,49,49,0,0,58,0,0,58,438,352,178,35,139,86,56,9,0,47,30,0,0,30,14760
4258,1161,224,401,320,136,80,152,53,18,3,2,13,35,2,0,0,2,33,18,0,15,99,52,0,0,52,47,0,0,0,0,47,31,3,13,14767
4259,814,87,332,326,47,22,19,19,0,0,0,0,19,19,19,0,0,0,0,0,0,0,0,0,0,0,0,0,0,0,0,0,0,0,0,14769
4260,1976,151,898,554,177,196,199,97,86,34,16,36,11,11,11,0,0,0,0,0,0,102,93,34,0,59,9,0,0,0,0,9,0,0,9,14770
4261,2605,316,1070,837,179,203,158,89,70,9,0,61,19,19,3,14,2,0,0,0,0,69,52,11,13,28,17,4,0,4,0,13,0,0,13,14772
4262,120,18,61,28,13,0,9,8,8,0,0,8,0,0,0,0,0,0,0,0,0,1,1,0,1,0,0,0,0,0,0,0,0,0,0,14774
4263,1529,318,578,438,130,65,97,63,52,0,0,52,11,0,0,0,0,11,11,0,0,34,25,8,0,17,9,9,9,0,0,0,0,0,0,14775
4264,506,55,231,118,48,54,26,16,13,4,0,9,3,3,0,0,3,0,0,0,0,10,9,0,0,9,1,1,0,0,1,0,0,0,0,14777
4265,19,9,0,8,0,2,654,272,272,61,0,211,0,0,0,0,0,0,0,0,0,382,382,89,17,276,0,0,0,0,0,0,0,0,0,14778
4266,4424,634,1987,1272,342,189,316,169,113,25,8,80,56,51,22,23,6,5,0,0,5,147,111,49,6,56,36,24,16,0,8,12,0,2,10,14779
4267,1524,250,587,419,141,127,230,137,92,15,3,74,45,14,7,0,7,31,17,8,6,93,62,20,0,42,31,0,0,0,0,31,14,0,17,14781
4268,1615,214,701,478,161,61,194,97,90,26,0,64,7,4,0,0,4,3,0,0,3,97,93,44,4,45,4,4,4,0,0,0,0,0,0,14782
4269,259,22,105,128,0,4,15,0,0,0,0,0,0,0,0,0,0,0,0,0,0,15,15,9,0,6,0,0,0,0,0,0,0,0,0,14783
4270,531,97,208,168,25,33,28,28,21,7,0,14,7,7,5,2,0,0,0,0,0,0,0,0,0,0,0,0,0,0,0,0,0,0,0,14784
4271,3816,345,1251,1219,545,456,211,90,73,29,0,44,17,0,0,0,0,17,0,17,0,121,109,0,0,109,12,0,0,0,0,12,12,0,0,14787
4272,204,52,85,27,9,31,5,5,4,0,0,4,1,1,0,0,1,0,0,0,0,0,0,0,0,0,0,0,0,0,0,0,0,0,0,14788
4273,3737,543,1523,1234,205,232,312,168,141,15,0,126,27,14,2,9,3,13,0,3,10,144,102,18,7,77,42,23,0,9,14,19,0,0,19,14801
4274,402,4,20,24,142,212,2205,1307,1304,370,117,817,3,3,3,0,0,0,0,0,0,898,897,297,72,528,1,1,1,0,0,0,0,0,0,14802
4275,640,16,160,153,119,192,25,20,20,5,0,15,0,0,0,0,0,0,0,0,0,5,5,2,0,3,0,0,0,0,0,0,0,0,0,14803
4276,1135,70,396,352,142,175,57,26,26,4,0,22,0,0,0,0,0,0,0,0,0,31,27,6,0,21,4,4,4,0,0,0,0,0,0,14804
4277,689,35,273,189,68,124,61,37,32,3,19,10,5,0,0,0,0,5,0,0,5,24,19,7,0,12,5,2,2,0,0,3,0,0,3,14805
4278,1448,161,606,429,119,133,81,64,56,1,13,42,8,2,2,0,0,6,2,0,4,17,14,0,0,14,3,3,0,0,3,0,0,0,0,14806
4279,2264,153,1101,705,191,114,124,76,70,25,0,45,6,6,3,3,0,0,0,0,0,48,44,21,0,23,4,4,4,0,0,0,0,0,0,14807
4280,332,59,153,97,6,17,0,0,0,0,0,0,0,0,0,0,0,0,0,0,0,0,0,0,0,0,0,0,0,0,0,0,0,0,0,14808
4281,1647,133,633,598,146,137,156,80,55,0,0,55,25,25,15,1,9,0,0,0,0,76,74,4,4,66,2,2,2,0,0,0,0,0,0,14809
4282,9032,1540,3548,2438,753,753,525,300,228,81,7,140,72,15,0,15,0,57,13,14,30,225,168,48,17,103,57,51,19,9,23,6,2,0,4,14810
4283,2227,322,811,802,147,145,304,207,175,8,7,160,32,24,8,0,16,8,0,0,8,97,87,19,9,59,10,10,2,8,0,0,0,0,0,14812
4284,1938,247,783,561,194,153,113,54,30,2,0,28,24,9,0,0,9,15,0,15,0,59,46,7,4,35,13,13,0,13,0,0,0,0,0,14813
4285,1472,57,348,469,269,329,39,39,22,9,0,13,17,17,17,0,0,0,0,0,0,0,0,0,0,0,0,0,0,0,0,0,0,0,0,14814
4286,705,86,314,218,58,29,99,42,34,2,5,27,8,5,2,3,0,3,3,0,0,57,49,8,0,41,8,4,4,0,0,4,4,0,0,14815
4287,229,24,114,24,57,10,9,9,9,0,0,9,0,0,0,0,0,0,0,0,0,0,0,0,0,0,0,0,0,0,0,0,0,0,0,14816
4288,1787,134,489,429,345,390,132,91,74,23,0,51,17,17,17,0,0,0,0,0,0,41,41,7,18,16,0,0,0,0,0,0,0,0,0,14817
4289,1391,102,633,491,134,31,101,36,36,0,0,36,0,0,0,0,0,0,0,0,0,65,65,3,0,62,0,0,0,0,0,0,0,0,0,14818
4290,571,118,283,139,15,16,48,40,40,0,6,34,0,0,0,0,0,0,0,0,0,8,8,0,0,8,0,0,0,0,0,0,0,0,0,14819
4291,452,83,262,83,20,4,23,12,7,0,0,7,5,5,5,0,0,0,0,0,0,11,11,0,0,11,0,0,0,0,0,0,0,0,0,14820
4292,2067,281,771,704,221,90,273,107,82,13,3,66,25,0,0,0,0,25,25,0,0,166,110,28,17,65,56,14,0,14,0,42,32,0,10,14821
4293,895,121,427,254,50,43,84,29,29,5,0,24,0,0,0,0,0,0,0,0,0,55,55,0,0,55,0,0,0,0,0,0,0,0,0,14822
4294,2326,211,1021,688,192,214,302,193,165,32,46,87,28,0,0,0,0,28,18,0,10,109,82,35,0,47,27,25,10,15,0,2,0,0,2,14823
4295,619,119,224,195,53,28,61,41,41,0,2,39,0,0,0,0,0,0,0,0,0,20,0,0,0,0,20,20,20,0,0,0,0,0,0,14824
4296,742,81,363,204,53,41,39,19,19,7,0,12,0,0,0,0,0,0,0,0,0,20,20,5,0,15,0,0,0,0,0,0,0,0,0,14825
4297,1545,191,617,544,129,64,155,66,41,17,0,24,25,19,0,0,19,6,2,0,4,89,72,10,0,62,17,0,0,0,0,17,0,0,17,14826
4298,71,0,25,17,29,0,0,0,0,0,0,0,0,0,0,0,0,0,0,0,0,0,0,0,0,0,0,0,0,0,0,0,0,0,0,14827
4299,13781,1257,3801,4485,2436,1802,1066,545,466,81,60,325,79,70,51,6,13,9,0,5,4,521,449,186,59,204,72,48,30,5,13,24,0,0,24,14830
4300,847,127,426,164,67,63,71,29,27,0,0,27,2,2,0,0,2,0,0,0,0,42,42,0,0,42,0,0,0,0,0,0,0,0,0,14836
4301,3682,527,1450,934,396,375,296,102,67,9,10,48,35,17,14,0,3,18,8,0,10,194,158,71,2,85,36,5,5,0,0,31,16,0,15,14837
4302,1409,115,551,592,95,56,74,49,49,10,7,32,0,0,0,0,0,0,0,0,0,25,25,0,0,25,0,0,0,0,0,0,0,0,0,14838
4303,488,37,200,200,18,33,24,18,18,0,0,18,0,0,0,0,0,0,0,0,0,6,6,3,0,3,0,0,0,0,0,0,0,0,0,14839
4304,2425,144,674,807,404,396,138,86,86,23,0,63,0,0,0,0,0,0,0,0,0,52,52,17,0,35,0,0,0,0,0,0,0,0,0,14840
4305,712,76,174,258,124,80,83,9,9,9,0,0,0,0,0,0,0,0,0,0,0,74,74,74,0,0,0,0,0,0,0,0,0,0,0,14841
4306,640,50,248,174,37,131,90,67,31,0,0,31,36,36,36,0,0,0,0,0,0,23,23,23,0,0,0,0,0,0,0,0,0,0,0,14842
4307,8731,907,3229,2948,826,821,607,282,232,53,26,153,50,29,12,3,14,21,16,0,5,325,325,41,29,255,0,0,0,0,0,0,0,0,0,14843
4308,15269,959,4800,4754,2531,2225,806,444,408,74,11,323,36,20,20,0,0,16,16,0,0,362,335,160,0,175,27,27,19,0,8,0,0,0,0,14845
4309,583,70,285,179,29,20,41,30,25,0,8,17,5,5,5,0,0,0,0,0,0,11,11,0,4,7,0,0,0,0,0,0,0,0,0,14846
4310,1645,145,528,551,259,162,98,63,63,23,5,35,0,0,0,0,0,0,0,0,0,35,33,11,0,22,2,2,2,0,0,0,0,0,0,14847
4311,34078,2004,4973,6310,7960,12831,8589,3966,3905,1024,388,2493,61,51,47,0,4,10,0,0,10,4623,4566,943,70,3553,57,52,47,0,5,5,0,0,5,14850
4312,25,0,0,18,7,0,1816,854,854,278,69,507,0,0,0,0,0,0,0,0,0,962,962,134,29,799,0,0,0,0,0,0,0,0,0,14853
4313,17,0,0,9,8,0,0,0,0,0,0,0,0,0,0,0,0,0,0,0,0,0,0,0,0,0,0,0,0,0,0,0,0,0,0,14854
4314,508,25,231,199,11,42,70,33,33,0,0,33,0,0,0,0,0,0,0,0,0,37,33,0,0,33,4,0,0,0,0,4,4,0,0,14855
4315,124,29,84,11,0,0,10,10,10,10,0,0,0,0,0,0,0,0,0,0,0,0,0,0,0,0,0,0,0,0,0,0,0,0,0,14856
4316,1103,162,408,371,116,46,155,90,43,11,0,32,47,2,2,0,0,45,0,0,45,65,30,0,0,30,35,35,12,0,23,0,0,0,0,14858
4317,673,71,299,232,9,62,100,43,43,4,12,27,0,0,0,0,0,0,0,0,0,57,57,6,0,51,0,0,0,0,0,0,0,0,0,14859
4318,822,87,351,237,76,71,64,35,24,19,0,5,11,0,0,0,0,11,11,0,0,29,18,0,3,15,11,2,0,0,2,9,2,0,7,14860
4319,922,170,437,206,45,64,60,33,26,4,0,22,7,7,7,0,0,0,0,0,0,27,24,6,4,14,3,3,0,3,0,0,0,0,0,14861
4320,829,104,376,231,88,30,31,20,12,6,1,5,8,8,2,6,0,0,0,0,0,11,9,2,0,7,2,0,0,0,0,2,2,0,0,14864
4321,1927,300,714,688,126,99,106,50,50,12,0,38,0,0,0,0,0,0,0,0,0,56,56,9,0,47,0,0,0,0,0,0,0,0,0,14865
4322,3763,567,1182,1096,542,376,317,206,180,13,62,105,26,26,26,0,0,0,0,0,0,111,111,36,9,66,0,0,0,0,0,0,0,0,0,14867
4323,935,101,347,396,55,36,95,33,31,3,16,12,2,2,0,2,0,0,0,0,0,62,56,6,0,50,6,5,5,0,0,1,1,0,0,14869
4324,7143,632,1920,2298,1038,1255,497,236,172,80,1,91,64,64,61,3,0,0,0,0,0,261,174,101,18,55,87,70,65,5,0,17,0,17,0,14870
4325,4084,460,1612,1252,322,438,286,201,153,68,0,85,48,48,18,0,30,0,0,0,0,85,85,31,15,39,0,0,0,0,0,0,0,0,0,14871
4326,520,87,215,168,41,9,56,39,39,0,15,24,0,0,0,0,0,0,0,0,0,17,17,17,0,0,0,0,0,0,0,0,0,0,0,14872
4327,1841,268,694,621,161,97,193,102,60,13,0,47,42,42,20,17,5,0,0,0,0,91,69,17,4,48,22,5,0,0,5,17,8,0,9,14873
4328,196,14,68,45,38,31,19,9,1,0,1,0,8,0,0,0,0,8,0,0,8,10,0,0,0,0,10,10,10,0,0,0,0,0,0,14874
4329,323,35,135,97,27,29,10,8,8,6,0,2,0,0,0,0,0,0,0,0,0,2,2,0,0,2,0,0,0,0,0,0,0,0,0,14877
4330,505,40,147,161,37,120,20,17,17,0,0,17,0,0,0,0,0,0,0,0,0,3,3,3,0,0,0,0,0,0,0,0,0,0,0,14878
4331,1481,183,683,468,88,59,86,67,61,7,1,53,6,3,3,0,0,3,3,0,0,19,19,5,0,14,0,0,0,0,0,0,0,0,0,14879
4332,1158,110,558,342,81,67,59,32,31,5,0,26,1,0,0,0,0,1,0,0,1,27,27,0,2,25,0,0,0,0,0,0,0,0,0,14880
4333,71,54,17,0,0,0,0,0,0,0,0,0,0,0,0,0,0,0,0,0,0,0,0,0,0,0,0,0,0,0,0,0,0,0,0,14881
4334,2831,236,557,687,690,661,183,112,112,16,0,96,0,0,0,0,0,0,0,0,0,71,71,44,11,16,0,0,0,0,0,0,0,0,0,14882
4335,2921,219,1394,742,338,228,237,116,103,44,9,50,13,13,0,0,13,0,0,0,0,121,97,12,19,66,24,16,0,0,16,8,0,0,8,14883
4336,160,26,66,57,3,8,3,1,0,0,0,0,1,1,0,0,1,0,0,0,0,2,2,0,0,2,0,0,0,0,0,0,0,0,0,14884
4337,608,97,289,152,42,28,93,44,34,0,0,34,10,0,0,0,0,10,0,0,10,49,33,0,6,27,16,0,0,0,0,16,0,0,16,14885
4338,4651,295,1109,1506,739,1002,383,217,139,48,0,91,78,69,30,10,29,9,9,0,0,166,130,45,0,85,36,26,3,23,0,10,0,0,10,14886
4339,1038,186,397,322,74,59,117,45,41,5,3,33,4,4,1,0,3,0,0,0,0,72,46,7,0,39,26,25,4,10,11,1,0,1,0,14889
4340,3254,359,1386,972,286,251,179,105,78,51,0,27,27,25,23,0,2,2,2,0,0,74,52,23,0,29,22,4,4,0,0,18,1,0,17,14891
4341,5654,773,2097,1796,573,415,333,187,165,46,17,102,22,22,10,12,0,0,0,0,0,146,137,45,15,77,9,0,0,0,0,9,0,0,9,14892
4342,11,3,6,2,0,0,0,0,0,0,0,0,0,0,0,0,0,0,0,0,0,0,0,0,0,0,0,0,0,0,0,0,0,0,0,14893
4343,920,100,455,238,66,61,63,30,11,0,4,7,19,11,11,0,0,8,0,8,0,33,22,4,0,18,11,3,3,0,0,8,0,8,0,14894
4344,6773,787,2343,2417,667,559,306,120,117,19,35,63,3,3,3,0,0,0,0,0,0,186,153,42,2,109,33,9,0,9,0,24,0,4,20,14895
4345,648,99,364,128,38,19,38,26,21,8,0,13,5,5,3,2,0,0,0,0,0,12,12,4,0,8,0,0,0,0,0,0,0,0,0,14897
4346,1204,293,507,308,65,31,150,56,22,0,6,16,34,9,0,9,0,25,9,0,16,94,54,0,0,54,40,11,4,4,3,29,0,0,29,14898
4347,10960,2072,4421,3238,773,456,1453,577,482,130,4,348,95,39,12,0,27,56,26,10,20,876,716,110,27,579,160,105,78,0,27,55,33,4,18,14901
4348,4846,351,1779,1711,518,487,283,89,63,33,0,30,26,13,0,4,9,13,0,0,13,194,136,15,10,111,58,58,58,0,0,0,0,0,0,14903
4349,10086,1504,4288,3267,741,286,784,334,288,127,44,117,46,34,27,7,0,12,0,11,1,450,366,137,10,219,84,39,33,6,0,45,39,0,6,14904
4350,6373,330,1349,1904,1368,1422,423,290,225,47,0,178,65,65,46,7,12,0,0,0,0,133,125,29,0,96,8,8,8,0,0,0,0,0,0,14905
4351,23535,2036,8801,7080,3691,1927,1513,804,639,169,47,423,165,92,58,12,22,73,7,0,66,709,601,175,39,387,108,61,53,0,8,47,9,20,18,15001
4352,8322,950,3248,2554,1088,482,456,298,271,50,43,178,27,27,27,0,0,0,0,0,0,158,116,9,0,107,42,0,0,0,0,42,20,7,15,15003
4353,175,0,31,98,34,12,0,0,0,0,0,0,0,0,0,0,0,0,0,0,0,0,0,0,0,0,0,0,0,0,0,0,0,0,0,15004
4354,7199,584,2557,1967,1367,724,313,192,166,117,0,49,26,26,8,18,0,0,0,0,0,121,114,38,15,61,7,7,7,0,0,0,0,0,0,15005
4355,235,52,114,47,22,0,0,0,0,0,0,0,0,0,0,0,0,0,0,0,0,0,0,0,0,0,0,0,0,0,0,0,0,0,0,15006
4356,276,7,147,40,76,6,0,0,0,0,0,0,0,0,0,0,0,0,0,0,0,0,0,0,0,0,0,0,0,0,0,0,0,0,0,15007
4357,11188,806,3427,3189,2464,1302,692,331,274,74,16,184,57,45,16,13,16,12,0,0,12,361,342,126,43,173,19,17,17,0,0,2,0,0,2,15009
4358,19194,1628,7409,5563,2997,1597,1907,825,761,259,65,437,64,58,34,15,9,6,0,3,3,1082,997,309,29,659,85,33,22,7,4,52,8,0,44,15010
4359,11794,1038,5003,3121,1571,1061,823,347,288,68,35,185,59,54,31,17,6,5,0,5,0,476,448,136,37,275,28,28,7,12,9,0,0,0,0,15012
4360,2181,190,876,777,232,106,147,74,39,12,0,27,35,7,7,0,0,28,0,0,28,73,73,33,0,40,0,0,0,0,0,0,0,0,0,15014
4361,928,12,96,196,361,263,25,15,15,8,0,7,0,0,0,0,0,0,0,0,0,10,10,0,0,10,0,0,0,0,0,0,0,0,0,15015
4362,11460,684,3384,2636,3023,1733,408,209,148,88,0,60,61,49,38,0,11,12,3,0,9,199,188,74,27,87,11,0,0,0,0,11,0,0,11,15017
4363,499,7,339,117,25,11,14,9,9,0,0,9,0,0,0,0,0,0,0,0,0,5,5,5,0,0,0,0,0,0,0,0,0,0,0,15018
4364,1297,74,706,321,120,76,120,73,73,0,0,73,0,0,0,0,0,0,0,0,0,47,47,7,0,40,0,0,0,0,0,0,0,0,0,15019
4365,103,0,69,34,0,0,32,32,32,0,8,24,0,0,0,0,0,0,0,0,0,0,0,0,0,0,0,0,0,0,0,0,0,0,0,15020
4366,5537,775,2613,1342,595,212,400,183,159,40,4,115,24,21,13,8,0,3,0,0,3,217,210,82,10,118,7,7,7,0,0,0,0,0,0,15021
4367,7270,551,3409,1973,882,455,379,201,140,18,9,113,61,44,32,6,6,17,0,10,7,178,155,30,26,99,23,23,23,0,0,0,0,0,0,15022
4368,6441,525,2159,1832,1271,654,359,184,169,15,43,111,15,15,9,6,0,0,0,0,0,175,175,34,44,97,0,0,0,0,0,0,0,0,0,15024
4369,11439,864,4214,3006,2070,1285,841,381,340,88,27,225,41,41,29,12,0,0,0,0,0,460,357,165,20,172,103,40,35,5,0,63,0,32,31,15025
4370,2424,128,1152,765,255,124,108,48,42,19,0,23,6,5,0,5,0,1,0,0,1,60,60,26,0,34,0,0,0,0,0,0,0,0,0,15026
4371,1500,138,703,416,149,94,88,59,59,8,0,51,0,0,0,0,0,0,0,0,0,29,26,11,0,15,3,0,0,0,0,3,0,0,3,15027
4372,112,11,67,16,9,9,6,6,6,0,0,6,0,0,0,0,0,0,0,0,0,0,0,0,0,0,0,0,0,0,0,0,0,0,0,15028
4373,783,72,294,268,133,16,31,18,18,3,0,15,0,0,0,0,0,0,0,0,0,13,13,0,0,13,0,0,0,0,0,0,0,0,0,15030
4374,370,41,172,89,34,34,62,62,34,0,17,17,28,28,28,0,0,0,0,0,0,0,0,0,0,0,0,0,0,0,0,0,0,0,0,15031
4375,3437,361,1847,696,325,208,264,107,60,26,0,34,47,30,0,8,22,17,0,0,17,157,157,32,0,125,0,0,0,0,0,0,0,0,0,15033
4376,1456,122,696,397,189,52,60,11,7,3,0,4,4,4,4,0,0,0,0,0,0,49,49,7,0,42,0,0,0,0,0,0,0,0,0,15034
4377,1624,162,714,499,161,88,86,54,46,4,7,35,8,8,8,0,0,0,0,0,0,32,32,0,0,32,0,0,0,0,0,0,0,0,0,15035
4378,8331,462,3615,2259,1268,727,451,280,249,90,68,91,31,31,29,0,2,0,0,0,0,171,169,71,21,77,2,0,0,0,0,2,0,0,2,15037
4379,205,44,110,51,0,0,27,14,0,0,0,0,14,14,0,14,0,0,0,0,0,13,13,13,0,0,0,0,0,0,0,0,0,0,0,15038
4380,5927,309,2496,1979,742,401,526,268,246,41,0,205,22,22,22,0,0,0,0,0,0,258,217,105,18,94,41,6,6,0,0,35,35,0,0,15042
4381,1917,170,785,711,132,119,77,44,38,0,0,38,6,6,6,0,0,0,0,0,0,33,29,0,0,29,4,4,4,0,0,0,0,0,0,15043
4382,18526,618,4239,4500,5537,3632,1405,745,655,254,18,383,90,67,53,14,0,23,0,0,23,660,630,212,39,379,30,30,30,0,0,0,0,0,0,15044
4383,3167,396,1363,917,376,115,306,198,198,49,30,119,0,0,0,0,0,0,0,0,0,108,92,51,15,26,16,16,16,0,0,0,0,0,0,15045
4384,1935,119,749,556,354,157,176,116,99,40,15,44,17,17,17,0,0,0,0,0,0,60,60,22,0,38,0,0,0,0,0,0,0,0,0,15046
4385,0,0,0,0,0,0,0,0,0,0,0,0,0,0,0,0,0,0,0,0,0,0,0,0,0,0,0,0,0,0,0,0,0,0,0,15047
4386,778,135,330,151,113,49,24,19,13,3,0,10,6,6,3,0,3,0,0,0,0,5,5,0,0,5,0,0,0,0,0,0,0,0,0,15049
4387,1549,116,708,570,85,70,156,68,55,13,0,42,13,7,7,0,0,6,6,0,0,88,78,21,15,42,10,10,0,0,10,0,0,0,0,15050
4388,321,93,114,82,21,11,0,0,0,0,0,0,0,0,0,0,0,0,0,0,0,0,0,0,0,0,0,0,0,0,0,0,0,0,0,15051
4389,2450,183,1065,854,268,80,151,78,68,15,0,53,10,0,0,0,0,10,0,0,10,73,69,26,0,43,4,3,3,0,0,1,0,0,1,15052
4390,163,39,46,78,0,0,0,0,0,0,0,0,0,0,0,0,0,0,0,0,0,0,0,0,0,0,0,0,0,0,0,0,0,0,0,15053
4391,345,42,195,88,12,8,10,10,10,10,0,0,0,0,0,0,0,0,0,0,0,0,0,0,0,0,0,0,0,0,0,0,0,0,0,15054
4392,983,73,252,251,314,93,10,0,0,0,0,0,0,0,0,0,0,0,0,0,0,10,10,10,0,0,0,0,0,0,0,0,0,0,0,15055
4393,853,47,283,282,164,77,47,35,35,2,3,30,0,0,0,0,0,0,0,0,0,12,12,4,0,8,0,0,0,0,0,0,0,0,0,15056
4394,10166,673,3709,2569,2162,1053,857,412,402,240,31,131,10,10,0,0,10,0,0,0,0,445,427,199,24,204,18,6,6,0,0,12,12,0,0,15057
4395,2981,485,1273,807,307,109,206,73,43,10,0,33,30,2,0,2,0,28,28,0,0,133,123,32,25,66,10,5,5,0,0,5,5,0,0,15059
4396,515,61,269,128,52,5,44,23,17,9,0,8,6,6,6,0,0,0,0,0,0,21,21,4,12,5,0,0,0,0,0,0,0,0,0,15060
4397,9068,905,3390,2556,1453,764,529,212,190,65,36,89,22,22,0,22,0,0,0,0,0,317,292,113,0,179,25,25,11,14,0,0,0,0,0,15061
4398,5631,820,2337,1504,652,318,271,201,171,43,0,128,30,24,15,9,0,6,6,0,0,70,60,3,6,51,10,0,0,0,0,10,10,0,0,15062
4399,8402,697,3848,2335,1126,396,507,337,264,59,33,172,73,43,14,29,0,30,30,0,0,170,164,39,10,115,6,6,6,0,0,0,0,0,0,15063
4400,322,30,208,22,62,0,94,61,61,0,0,61,0,0,0,0,0,0,0,0,0,33,33,0,33,0,0,0,0,0,0,0,0,0,0,15064
4401,8674,515,3970,2304,1313,572,531,191,169,46,8,115,22,20,13,7,0,2,0,0,2,340,299,70,71,158,41,7,0,7,0,34,0,0,34,15065
4402,9092,827,3978,2694,988,605,639,384,341,94,30,217,43,24,21,3,0,19,0,11,8,255,235,77,20,138,20,14,12,0,2,6,0,6,0,15066
4403,1633,197,802,406,176,52,181,158,127,9,0,118,31,27,15,12,0,4,0,0,4,23,19,0,0,19,4,4,0,4,0,0,0,0,0,15067
4404,28071,2439,11513,8220,4087,1812,1635,942,797,199,51,547,145,90,11,48,31,55,15,8,32,693,600,235,27,338,93,47,17,12,18,46,21,4,21,15068
4405,7140,470,2317,1765,1711,877,433,251,251,38,0,213,0,0,0,0,0,0,0,0,0,182,173,49,0,124,9,9,9,0,0,0,0,0,0,15071
4406,119,25,86,0,8,0,0,0,0,0,0,0,0,0,0,0,0,0,0,0,0,0,0,0,0,0,0,0,0,0,0,0,0,0,0,15072
4407,6611,724,3032,1830,675,350,384,182,182,48,14,120,0,0,0,0,0,0,0,0,0,202,184,55,36,93,18,12,12,0,0,6,6,0,0,15074
4408,40,0,11,29,0,0,0,0,0,0,0,0,0,0,0,0,0,0,0,0,0,0,0,0,0,0,0,0,0,0,0,0,0,0,0,15075
4409,826,144,286,256,101,39,108,28,28,10,0,18,0,0,0,0,0,0,0,0,0,80,80,54,0,26,0,0,0,0,0,0,0,0,0,15076
4410,86,19,37,28,2,0,17,10,8,2,0,6,2,2,0,0,2,0,0,0,0,7,7,1,0,6,0,0,0,0,0,0,0,0,0,15077
4411,245,55,137,7,46,0,7,0,0,0,0,0,0,0,0,0,0,0,0,0,0,7,7,0,0,7,0,0,0,0,0,0,0,0,0,15078
4412,271,43,133,75,14,6,3,3,0,0,0,0,3,3,0,3,0,0,0,0,0,0,0,0,0,0,0,0,0,0,0,0,0,0,0,15081
4413,105,0,77,28,0,0,16,8,8,0,0,8,0,0,0,0,0,0,0,0,0,8,8,0,0,8,0,0,0,0,0,0,0,0,0,15082
4414,618,88,280,160,48,42,44,13,13,3,0,10,0,0,0,0,0,0,0,0,0,31,25,13,4,8,6,6,0,0,6,0,0,0,0,15083
4415,6930,802,2967,2076,720,365,533,139,129,18,15,96,10,10,6,4,0,0,0,0,0,394,372,124,21,227,22,17,17,0,0,5,0,0,5,15084
4416,5611,201,2254,1727,1001,428,370,212,167,85,27,55,45,45,45,0,0,0,0,0,0,158,158,33,7,118,0,0,0,0,0,0,0,0,0,15085
4417,224,0,54,57,73,40,0,0,0,0,0,0,0,0,0,0,0,0,0,0,0,0,0,0,0,0,0,0,0,0,0,0,0,0,0,15086
4418,189,13,162,14,0,0,0,0,0,0,0,0,0,0,0,0,0,0,0,0,0,0,0,0,0,0,0,0,0,0,0,0,0,0,0,15087
4419,494,58,234,150,52,0,32,19,19,9,0,10,0,0,0,0,0,0,0,0,0,13,13,6,0,7,0,0,0,0,0,0,0,0,0,15088
4420,4198,410,1784,1297,461,246,216,130,130,54,35,41,0,0,0,0,0,0,0,0,0,86,86,57,0,29,0,0,0,0,0,0,0,0,0,15089
4421,15163,295,1945,2596,5588,4739,1123,739,711,115,0,596,28,17,16,0,1,11,0,0,11,384,383,117,15,251,1,0,0,0,0,1,0,0,1,15090
4422,17362,686,4149,4177,4806,3544,1151,542,542,174,0,368,0,0,0,0,0,0,0,0,0,609,587,218,23,346,22,21,21,0,0,1,0,0,1,15101
4423,21884,934,5944,5145,6581,3280,1221,613,598,184,41,373,15,0,0,0,0,15,15,0,0,608,595,196,67,332,13,0,0,0,0,13,0,0,13,15102
4424,6164,959,2656,1902,445,202,605,299,237,26,18,193,62,25,0,9,16,37,0,32,5,306,208,62,12,134,98,71,53,0,18,27,27,0,0,15104
4425,13714,1022,5385,3732,2501,1074,808,461,325,89,19,217,136,110,110,0,0,26,3,0,23,347,251,80,0,171,96,96,39,38,19,0,0,0,0,15106
4426,28696,1562,7691,8027,7529,3887,2499,1297,1191,525,97,569,106,83,54,26,3,23,0,23,0,1202,1047,450,72,525,155,155,121,34,0,0,0,0,0,15108
4427,3557,423,1640,1027,255,212,457,249,225,0,45,180,24,20,0,0,20,4,4,0,0,208,84,30,0,54,124,58,0,25,33,66,10,0,56,15110
4428,2356,158,898,781,387,132,130,29,23,4,9,10,6,6,6,0,0,0,0,0,0,101,95,53,0,42,6,6,6,0,0,0,0,0,0,15112
4429,11097,515,3610,2689,2766,1517,549,210,187,116,31,40,23,23,23,0,0,0,0,0,0,339,313,125,0,188,26,18,0,0,18,8,0,0,8,15116
4430,13501,1236,5639,3833,1792,1001,778,429,363,74,48,241,66,53,46,0,7,13,0,5,8,349,342,109,42,191,7,7,7,0,0,0,0,0,0,15120
4431,14240,1189,5938,4525,1873,715,1296,687,555,121,63,371,132,66,5,37,24,66,47,19,0,609,465,145,30,290,144,100,43,43,14,44,10,34,0,15122
4432,4625,319,1265,1539,994,508,373,195,169,63,27,79,26,26,0,26,0,0,0,0,0,178,178,38,0,140,0,0,0,0,0,0,0,0,0,15126
4433,7706,508,2362,2222,1870,744,599,275,233,153,5,75,42,42,31,7,4,0,0,0,0,324,289,65,24,200,35,35,35,0,0,0,0,0,0,15129
4434,6565,349,2616,2132,1011,457,310,154,133,43,5,85,21,21,21,0,0,0,0,0,0,156,147,28,5,114,9,9,0,0,9,0,0,0,0,15131
4435,14682,2127,6879,4125,958,593,961,472,405,22,31,352,67,33,21,12,0,34,9,4,21,489,396,67,83,246,93,55,31,0,24,38,0,6,32,15132
4436,4830,350,2147,1626,532,175,301,181,142,6,25,111,39,32,23,9,0,7,0,7,0,120,81,22,0,59,39,39,22,17,0,0,0,0,0,15133
4437,3815,151,1566,1120,653,325,246,100,100,29,0,71,0,0,0,0,0,0,0,0,0,146,146,10,0,136,0,0,0,0,0,0,0,0,0,15135
4438,15143,1663,6140,3518,2715,1107,1119,649,559,163,54,342,90,90,47,37,6,0,0,0,0,470,433,143,113,177,37,26,18,0,8,11,0,0,11,15136
4439,7608,741,3269,2366,871,361,261,194,133,16,0,117,61,16,0,16,0,45,0,0,45,67,43,23,0,20,24,0,0,0,0,24,0,0,24,15137
4440,4957,280,1437,1252,1122,866,267,131,123,63,15,45,8,8,8,0,0,0,0,0,0,136,134,6,19,109,2,2,2,0,0,0,0,0,0,15139
4441,2296,167,1036,627,308,158,199,106,85,0,6,79,21,21,12,9,0,0,0,0,0,93,35,23,12,0,58,58,14,0,44,0,0,0,0,15140
4442,1008,17,221,178,281,311,0,0,0,0,0,0,0,0,0,0,0,0,0,0,0,0,0,0,0,0,0,0,0,0,0,0,0,0,0,15142
4443,13909,559,2868,2591,4026,3865,928,521,491,199,6,286,30,28,28,0,0,2,2,0,0,407,387,103,2,282,20,20,14,0,6,0,0,0,0,15143
4444,2987,262,1208,895,364,258,147,80,74,27,2,45,6,6,0,0,6,0,0,0,0,67,53,46,0,7,14,0,0,0,0,14,3,0,11,15144
4445,5337,392,2477,1574,631,263,422,201,175,0,20,155,26,26,16,10,0,0,0,0,0,221,148,47,17,84,73,73,54,19,0,0,0,0,0,15145
4446,21602,1286,6085,6111,5072,3048,1028,571,539,202,0,337,32,32,32,0,0,0,0,0,0,457,428,87,52,289,29,18,0,18,0,11,0,0,11,15146
4447,12888,1265,4585,3886,2020,1132,724,411,362,178,0,184,49,49,49,0,0,0,0,0,0,313,189,72,31,86,124,124,62,0,62,0,0,0,0,15147
4448,1870,241,863,554,176,36,137,53,50,16,0,34,3,3,0,0,3,0,0,0,0,84,74,24,9,41,10,4,0,0,4,6,0,0,6,15148
4449,10179,1185,2984,2655,2087,1268,507,269,211,47,4,160,58,31,18,13,0,27,0,15,12,238,190,48,71,71,48,48,33,0,15,0,0,0,0,15201
4450,14315,974,4487,4066,3129,1659,827,525,432,154,24,254,93,86,48,19,19,7,7,0,0,302,273,164,11,98,29,29,29,0,0,0,0,0,0,15202
4451,6366,409,1710,1173,1718,1356,399,235,227,8,0,219,8,8,0,0,8,0,0,0,0,164,155,82,15,58,9,9,0,0,9,0,0,0,0,15203
4452,5326,656,2044,1770,533,323,586,320,218,102,19,97,102,21,4,17,0,81,20,61,0,266,239,37,103,99,27,27,0,27,0,0,0,0,0,15204
4453,16457,907,5731,4447,3758,1614,813,443,387,201,12,174,56,39,39,0,0,17,0,0,17,370,286,138,50,98,84,69,24,0,45,15,15,0,0,15205
4454,20354,1925,5332,4992,3745,4360,1408,653,523,110,60,353,130,93,46,29,18,37,3,17,17,755,706,159,107,440,49,24,8,0,16,25,0,0,25,15206
4455,8190,1151,2865,2443,1112,619,620,278,215,76,7,132,63,59,24,35,0,4,4,0,0,342,317,143,17,157,25,25,0,25,0,0,0,0,0,15207
4456,6692,600,1790,1701,1071,1530,512,293,238,40,52,146,55,48,34,14,0,7,0,7,0,219,161,44,38,79,58,58,28,30,0,0,0,0,0,15208
4457,9265,755,3275,2542,1845,848,584,276,234,37,0,197,42,14,4,0,10,28,0,28,0,308,224,63,16,145,84,55,55,0,0,29,0,0,29,15209
4458,17936,2788,7554,5307,1409,878,1489,694,544,96,19,429,150,48,10,19,19,102,20,0,82,795,646,226,84,336,149,72,21,19,32,77,47,19,11,15210
4459,8486,566,2655,2047,1935,1283,382,247,113,13,0,100,134,134,45,16,73,0,0,0,0,135,125,10,0,115,10,10,0,10,0,0,0,0,0,15211
4460,20263,2363,7733,4997,3241,1929,1144,529,438,60,48,330,91,83,18,5,60,8,0,0,8,615,540,155,48,337,75,68,68,0,0,7,3,0,4,15212
4461,9035,814,1524,1805,2080,2812,7275,3505,3452,527,211,2714,53,53,0,53,0,0,0,0,0,3770,3754,1033,201,2520,16,11,11,0,0,5,0,5,0,15213
4462,10169,1032,3818,2606,1774,939,564,271,232,70,20,142,39,38,20,0,18,1,1,0,0,293,207,76,22,109,86,86,6,73,7,0,0,0,0,15214
4463,8942,628,2074,1599,2379,2262,614,340,284,91,18,175,56,11,11,0,0,45,0,45,0,274,266,50,11,205,8,0,0,0,0,8,0,0,8,15215
4464,17283,963,5085,4897,4015,2323,914,425,349,79,38,232,76,76,17,20,39,0,0,0,0,489,455,174,28,253,34,24,13,11,0,10,0,0,10,15216
4465,18679,499,2435,2778,4765,8202,1357,660,609,159,37,413,51,31,0,0,31,20,0,0,20,697,671,241,13,417,26,12,0,0,12,14,0,0,14,15217
4466,10480,572,2688,2453,2360,2407,628,330,330,54,62,214,0,0,0,0,0,0,0,0,0,298,277,85,16,176,21,21,8,0,13,0,0,0,0,15218
4467,8401,1224,3512,2506,512,647,2717,1185,1040,170,48,822,145,98,27,5,66,47,0,0,47,1532,1458,434,72,952,74,66,22,0,44,8,0,0,8,15219
4468,13152,548,3308,3288,3826,2182,728,337,269,74,53,142,68,64,13,15,36,4,0,0,4,391,366,132,5,229,25,25,8,0,17,0,0,0,0,15220
4469,22420,1694,6438,6741,4038,3509,1433,724,663,128,102,433,61,31,9,22,0,30,15,0,15,709,634,116,132,386,75,34,34,0,0,41,0,16,25,15221
4470,2356,101,449,512,542,752,616,271,271,109,31,131,0,0,0,0,0,0,0,0,0,345,345,95,63,187,0,0,0,0,0,0,0,0,0,15222
4471,5062,566,2026,1372,816,282,208,96,87,23,0,64,9,9,0,0,9,0,0,0,0,112,81,24,12,45,31,0,0,0,0,31,15,0,16,15223
4472,7438,634,2146,1937,1442,1279,366,193,172,28,16,128,21,21,0,4,17,0,0,0,0,173,100,3,0,97,73,73,44,29,0,0,0,0,0,15224
4473,853,117,429,206,71,30,40,20,0,0,0,0,20,20,4,14,2,0,0,0,0,20,17,0,0,17,3,3,3,0,0,0,0,0,0,15225
4474,10177,780,3672,3161,1733,831,457,225,207,24,0,183,18,17,9,8,0,1,0,0,1,232,200,95,23,82,32,32,32,0,0,0,0,0,0,15226
4475,20801,1749,7785,6143,3487,1637,1325,674,569,146,104,319,105,105,71,0,34,0,0,0,0,651,588,180,36,372,63,63,63,0,0,0,0,0,0,15227
4476,12406,338,1870,2400,4153,3645,760,347,323,78,10,235,24,0,0,0,0,24,0,0,24,413,406,174,10,222,7,0,0,0,0,7,0,0,7,15228
4477,10236,610,3071,2791,2640,1124,480,173,131,14,23,94,42,34,31,3,0,8,3,0,5,307,296,162,99,35,11,11,11,0,0,0,0,0,0,15229
4478,8496,242,676,1048,2826,3704,671,226,218,52,43,123,8,8,8,0,0,0,0,0,0,445,444,231,5,208,1,0,0,0,0,1,0,0,1,15232
4479,3539,773,1336,939,331,160,117,88,25,0,0,25,63,63,0,41,22,0,0,0,0,29,19,0,0,19,10,10,10,0,0,0,0,0,0,15233
4480,10781,754,3563,2962,2448,1054,493,201,178,17,23,138,23,23,23,0,0,0,0,0,0,292,223,115,5,103,69,58,29,9,20,11,0,0,11,15234
4481,25011,1567,8053,8261,4170,2960,1520,659,593,155,79,359,66,20,14,6,0,46,14,0,32,861,823,290,0,533,38,26,0,17,9,12,0,0,12,15235
4482,21885,1330,7128,6380,4646,2401,1281,641,609,280,58,271,32,32,8,24,0,0,0,0,0,640,640,263,70,307,0,0,0,0,0,0,0,0,0,15236
4483,30462,1471,7342,6782,8730,6137,1692,851,780,288,48,444,71,32,23,9,0,39,39,0,0,841,795,245,45,505,46,0,0,0,0,46,46,0,0,15237
4484,9264,366,1760,1605,2796,2737,532,293,272,7,0,265,21,21,21,0,0,0,0,0,0,239,215,48,22,145,24,18,18,0,0,6,0,0,6,15238
4485,14737,819,4702,4195,3223,1798,1127,691,617,208,14,395,74,56,52,0,4,18,18,0,0,436,410,118,48,244,26,20,9,11,0,6,0,0,6,15239
4486,13760,204,1712,2568,4918,4358,1185,652,628,106,10,512,24,7,7,0,0,17,0,0,17,533,514,188,0,326,19,19,13,0,6,0,0,0,0,15241
4487,10125,357,2192,2025,3015,2536,626,280,263,53,17,193,17,15,15,0,0,2,2,0,0,346,305,68,16,221,41,0,0,0,0,41,10,0,31,15243
4488,0,0,0,0,0,0,0,0,0,0,0,0,0,0,0,0,0,0,0,0,0,0,0,0,0,0,0,0,0,0,0,0,0,0,0,15260
4489,0,0,0,0,0,0,0,0,0,0,0,0,0,0,0,0,0,0,0,0,0,0,0,0,0,0,0,0,0,0,0,0,0,0,0,15290
4490,35539,4221,14909,8631,5227,2551,2807,1275,1064,313,78,673,211,137,115,4,18,74,41,6,27,1532,1334,572,90,672,198,170,143,8,19,28,8,7,13,15301
4491,230,39,140,27,22,2,7,0,0,0,0,0,0,0,0,0,0,0,0,0,0,7,7,0,0,7,0,0,0,0,0,0,0,0,0,15310
4492,1009,122,399,230,198,60,64,25,25,0,3,22,0,0,0,0,0,0,0,0,0,39,26,10,0,16,13,13,13,0,0,0,0,0,0,15311
4493,2593,303,1242,634,300,114,168,84,65,0,6,59,19,16,14,0,2,3,0,0,3,84,74,14,5,55,10,10,10,0,0,0,0,0,0,15312
4494,254,23,94,92,31,14,4,2,2,0,0,2,0,0,0,0,0,0,0,0,0,2,2,0,0,2,0,0,0,0,0,0,0,0,0,15313
4495,2590,356,1047,678,362,147,236,110,90,42,0,48,20,6,0,0,6,14,14,0,0,126,74,21,42,11,52,52,12,29,11,0,0,0,0,15314
4496,569,65,310,114,59,21,14,8,5,0,0,5,3,3,0,0,3,0,0,0,0,6,6,0,0,6,0,0,0,0,0,0,0,0,0,15315
4497,76,9,40,18,9,0,12,11,11,0,0,11,0,0,0,0,0,0,0,0,0,1,1,0,0,1,0,0,0,0,0,0,0,0,0,15316
4498,26171,1728,7200,6418,6804,4021,1598,791,711,280,46,385,80,66,21,13,32,14,0,0,14,807,748,280,43,425,59,58,55,0,3,1,0,0,1,15317
4499,3599,486,1528,858,511,216,375,209,70,0,0,70,139,59,59,0,0,80,56,0,24,166,153,67,0,86,13,13,0,0,13,0,0,0,0,15320
4500,1101,37,351,331,279,103,24,9,9,0,0,9,0,0,0,0,0,0,0,0,0,15,15,6,0,9,0,0,0,0,0,0,0,0,0,15321
4501,1563,194,900,284,118,67,57,38,28,0,5,23,10,10,0,0,10,0,0,0,0,19,8,0,0,8,11,11,11,0,0,0,0,0,0,15322
4502,3073,267,1618,677,307,204,285,147,111,38,2,71,36,30,30,0,0,6,5,0,1,138,117,68,9,40,21,8,8,0,0,13,0,0,13,15323
4503,452,70,214,121,23,24,3,0,0,0,0,0,0,0,0,0,0,0,0,0,0,3,3,0,0,3,0,0,0,0,0,0,0,0,0,15324
4504,282,75,128,79,0,0,7,7,7,0,0,7,0,0,0,0,0,0,0,0,0,0,0,0,0,0,0,0,0,0,0,0,0,0,0,15325
4505,921,221,435,186,63,16,72,20,16,2,0,14,4,4,4,0,0,0,0,0,0,52,46,0,8,38,6,0,0,0,0,6,0,0,6,15327
4506,1184,144,564,288,119,69,94,38,29,3,4,22,9,0,0,0,0,9,9,0,0,56,52,32,0,20,4,4,4,0,0,0,0,0,0,15329
4507,4210,438,1332,1159,884,397,187,88,78,39,0,39,10,4,4,0,0,6,0,0,6,99,79,39,6,34,20,20,20,0,0,0,0,0,0,15330
4508,702,116,324,101,113,48,15,3,3,0,0,3,0,0,0,0,0,0,0,0,0,12,3,3,0,0,9,0,0,0,0,9,0,9,0,15331
4509,6110,376,2817,1707,842,368,405,258,213,64,0,149,45,45,45,0,0,0,0,0,0,147,147,81,0,66,0,0,0,0,0,0,0,0,0,15332
4510,1570,199,790,314,139,128,189,79,60,17,0,43,19,2,2,0,0,17,0,0,17,110,110,0,32,78,0,0,0,0,0,0,0,0,0,15333
4511,93,12,50,13,16,2,8,8,8,0,0,8,0,0,0,0,0,0,0,0,0,0,0,0,0,0,0,0,0,0,0,0,0,0,0,15334
4512,489,69,275,90,37,18,41,21,18,4,1,13,3,3,3,0,0,0,0,0,0,20,20,3,0,17,0,0,0,0,0,0,0,0,0,15337
4513,1165,192,548,228,134,63,53,24,22,1,0,21,2,2,2,0,0,0,0,0,0,29,28,6,0,22,1,1,1,0,0,0,0,0,0,15338
4514,1045,129,501,198,168,49,90,90,79,35,0,44,11,11,8,3,0,0,0,0,0,0,0,0,0,0,0,0,0,0,0,0,0,0,0,15340
4515,678,137,350,82,88,21,61,24,11,2,2,7,13,11,11,0,0,2,0,0,2,37,32,12,0,20,5,2,2,0,0,3,0,0,3,15341
4516,3567,382,1462,924,561,238,264,188,159,82,14,63,29,18,18,0,0,11,0,11,0,76,63,21,9,33,13,10,0,7,3,3,0,0,3,15342
4517,1120,164,529,252,137,38,148,72,66,0,0,66,6,5,0,5,0,1,0,0,1,76,42,8,0,34,34,34,5,14,15,0,0,0,0,15344
4518,1243,184,670,221,142,26,58,37,37,6,0,31,0,0,0,0,0,0,0,0,0,21,21,2,7,12,0,0,0,0,0,0,0,0,0,15345
4519,388,47,163,108,56,14,20,7,7,0,0,7,0,0,0,0,0,0,0,0,0,13,13,0,0,13,0,0,0,0,0,0,0,0,0,15346
4520,316,0,208,60,20,28,0,0,0,0,0,0,0,0,0,0,0,0,0,0,0,0,0,0,0,0,0,0,0,0,0,0,0,0,0,15347
4521,159,9,50,75,25,0,17,9,0,0,0,0,9,9,0,0,9,0,0,0,0,8,8,0,0,8,0,0,0,0,0,0,0,0,0,15348
4522,1363,179,711,261,110,102,74,43,29,3,0,26,14,10,8,0,2,4,0,4,0,31,21,5,0,16,10,4,0,4,0,6,0,0,6,15349
4523,420,58,238,98,21,5,7,0,0,0,0,0,0,0,0,0,0,0,0,0,0,7,7,7,0,0,0,0,0,0,0,0,0,0,0,15350
4524,522,73,222,125,0,102,0,0,0,0,0,0,0,0,0,0,0,0,0,0,0,0,0,0,0,0,0,0,0,0,0,0,0,0,0,15351
4525,601,159,294,87,52,9,48,24,14,0,1,13,10,9,3,2,4,1,0,0,1,24,23,0,0,23,1,1,1,0,0,0,0,0,0,15352
4526,27,4,9,9,2,3,2,0,0,0,0,0,0,0,0,0,0,0,0,0,0,2,2,0,0,2,0,0,0,0,0,0,0,0,0,15353
4527,1242,206,484,277,197,78,96,87,87,46,0,41,0,0,0,0,0,0,0,0,0,9,6,4,0,2,3,3,3,0,0,0,0,0,0,15357
4528,712,10,363,213,33,93,51,26,0,0,0,0,26,0,0,0,0,26,0,0,26,25,11,0,11,0,14,14,14,0,0,0,0,0,0,15358
4529,126,24,55,30,16,1,14,4,0,0,0,0,4,3,0,3,0,1,0,0,1,10,10,4,0,6,0,0,0,0,0,0,0,0,0,15359
4530,1241,73,565,339,174,90,72,38,32,14,0,18,6,6,4,0,2,0,0,0,0,34,34,11,0,23,0,0,0,0,0,0,0,0,0,15360
4531,43,27,16,0,0,0,0,0,0,0,0,0,0,0,0,0,0,0,0,0,0,0,0,0,0,0,0,0,0,0,0,0,0,0,0,15361
4532,587,133,317,71,26,40,36,15,13,0,6,7,2,2,0,2,0,0,0,0,0,21,15,0,0,15,6,6,6,0,0,0,0,0,0,15362
4533,624,110,348,136,30,0,8,8,0,0,0,0,8,8,8,0,0,0,0,0,0,0,0,0,0,0,0,0,0,0,0,0,0,0,0,15363
4534,568,51,305,116,63,33,37,31,19,2,0,17,12,7,7,0,0,5,5,0,0,6,6,0,0,6,0,0,0,0,0,0,0,0,0,15364
4535,184,10,71,103,0,0,0,0,0,0,0,0,0,0,0,0,0,0,0,0,0,0,0,0,0,0,0,0,0,0,0,0,0,0,0,15366
4536,5577,123,730,1132,2121,1471,527,265,253,87,1,165,12,0,0,0,0,12,0,0,12,262,256,78,0,178,6,6,0,0,6,0,0,0,0,15367
4537,220,17,111,63,19,10,0,0,0,0,0,0,0,0,0,0,0,0,0,0,0,0,0,0,0,0,0,0,0,0,0,0,0,0,0,15368
4538,10604,1431,5288,2272,1009,604,979,448,409,89,61,259,39,39,31,3,5,0,0,0,0,531,515,136,41,338,16,0,0,0,0,16,0,16,0,15370
4539,1190,108,692,234,117,39,100,41,41,9,2,30,0,0,0,0,0,0,0,0,0,59,48,26,0,22,11,0,0,0,0,11,0,11,0,15376
4540,525,116,280,71,38,20,53,32,28,0,10,18,4,4,2,0,2,0,0,0,0,21,16,0,7,9,5,0,0,0,0,5,5,0,0,15377
4541,0,0,0,0,0,0,0,0,0,0,0,0,0,0,0,0,0,0,0,0,0,0,0,0,0,0,0,0,0,0,0,0,0,0,0,15378
4542,66,4,35,9,13,5,5,3,2,0,0,2,1,1,1,0,0,0,0,0,0,2,2,0,2,0,0,0,0,0,0,0,0,0,0,15379
4543,483,80,293,80,19,11,43,14,9,0,0,9,5,5,1,2,2,0,0,0,0,29,27,6,5,16,2,2,2,0,0,0,0,0,0,15380
4544,23041,3197,10593,5024,3021,1206,1283,634,490,86,46,358,144,98,43,55,0,46,11,35,0,649,495,199,72,224,154,75,12,12,51,79,42,16,21,15401
4545,450,6,242,171,0,31,18,0,0,0,0,0,0,0,0,0,0,0,0,0,0,18,18,18,0,0,0,0,0,0,0,0,0,0,0,15410
4546,484,48,202,137,62,35,18,12,10,1,0,9,2,2,1,0,1,0,0,0,0,6,5,3,0,2,1,1,0,0,1,0,0,0,0,15411
4547,230,20,117,30,36,27,4,4,4,0,0,4,0,0,0,0,0,0,0,0,0,0,0,0,0,0,0,0,0,0,0,0,0,0,0,15412
4548,376,16,237,53,70,0,14,8,8,0,0,8,0,0,0,0,0,0,0,0,0,6,6,0,0,6,0,0,0,0,0,0,0,0,0,15413
4549,6117,846,2850,1277,682,462,439,188,149,43,0,106,39,32,21,11,0,7,0,7,0,251,200,119,14,67,51,51,12,0,39,0,0,0,0,15417
4550,2100,263,752,359,323,403,874,405,405,79,97,229,0,0,0,0,0,0,0,0,0,469,469,188,53,228,0,0,0,0,0,0,0,0,0,15419
4551,236,24,148,64,0,0,39,0,0,0,0,0,0,0,0,0,0,0,0,0,0,39,0,0,0,0,39,0,0,0,0,39,0,0,39,15420
4552,153,0,98,29,26,0,0,0,0,0,0,0,0,0,0,0,0,0,0,0,0,0,0,0,0,0,0,0,0,0,0,0,0,0,0,15421
4553,43,20,12,11,0,0,15,15,15,0,0,15,0,0,0,0,0,0,0,0,0,0,0,0,0,0,0,0,0,0,0,0,0,0,0,15422
4554,1630,260,623,400,253,94,176,121,119,13,0,106,2,0,0,0,0,2,0,0,2,55,49,23,0,26,6,6,6,0,0,0,0,0,0,15423
4555,2041,358,1044,419,143,77,162,56,45,6,7,32,11,10,2,0,8,1,1,0,0,106,97,5,5,87,9,9,0,9,0,0,0,0,0,15424
4556,13782,1874,6918,3437,1069,484,911,516,419,108,15,296,97,53,51,0,2,44,19,0,25,395,360,110,20,230,35,30,13,0,17,5,0,0,5,15425
4557,972,82,416,252,150,72,30,19,19,3,5,11,0,0,0,0,0,0,0,0,0,11,11,1,0,10,0,0,0,0,0,0,0,0,0,15427
4558,1325,137,775,293,77,43,80,35,26,10,0,16,9,9,9,0,0,0,0,0,0,45,38,18,3,17,7,4,0,2,2,3,0,0,3,15428
4559,104,18,62,8,16,0,0,0,0,0,0,0,0,0,0,0,0,0,0,0,0,0,0,0,0,0,0,0,0,0,0,0,0,0,0,15429
4560,149,0,103,41,5,0,17,10,10,0,5,5,0,0,0,0,0,0,0,0,0,7,7,0,7,0,0,0,0,0,0,0,0,0,0,15430
4561,3008,422,1853,537,140,56,171,62,57,9,3,45,5,0,0,0,0,5,5,0,0,109,72,15,4,53,37,19,19,0,0,18,18,0,0,15431
4562,325,42,156,75,42,10,9,4,4,0,3,1,0,0,0,0,0,0,0,0,0,5,3,0,0,3,2,2,2,0,0,0,0,0,0,15432
4563,885,203,429,154,48,51,0,0,0,0,0,0,0,0,0,0,0,0,0,0,0,0,0,0,0,0,0,0,0,0,0,0,0,0,0,15433
4564,269,39,171,35,9,15,8,8,8,7,0,1,0,0,0,0,0,0,0,0,0,0,0,0,0,0,0,0,0,0,0,0,0,0,0,15434
4565,410,69,247,85,9,0,36,15,0,0,0,0,15,0,0,0,0,15,15,0,0,21,21,0,0,21,0,0,0,0,0,0,0,0,0,15435
4566,1769,231,811,425,217,85,154,100,74,0,9,65,26,17,0,17,0,9,0,0,9,54,35,25,0,10,19,19,3,3,13,0,0,0,0,15436
4567,1594,239,725,325,182,123,41,28,21,0,0,21,7,7,0,0,7,0,0,0,0,13,6,0,0,6,7,7,7,0,0,0,0,0,0,15437
4568,1513,185,673,333,221,101,97,54,38,2,3,33,16,16,16,0,0,0,0,0,0,43,40,34,0,6,3,3,3,0,0,0,0,0,0,15438
4569,343,178,143,22,0,0,0,0,0,0,0,0,0,0,0,0,0,0,0,0,0,0,0,0,0,0,0,0,0,0,0,0,0,0,0,15440
4570,1653,265,1009,242,82,55,66,59,53,21,32,0,6,6,6,0,0,0,0,0,0,7,7,0,0,7,0,0,0,0,0,0,0,0,0,15442
4571,237,26,181,30,0,0,29,16,16,0,16,0,0,0,0,0,0,0,0,0,0,13,13,0,13,0,0,0,0,0,0,0,0,0,0,15443
4572,226,0,189,19,18,0,57,0,0,0,0,0,0,0,0,0,0,0,0,0,0,57,0,0,0,0,57,0,0,0,0,57,0,0,57,15444
4573,1990,188,922,505,211,164,121,46,36,0,23,13,10,10,10,0,0,0,0,0,0,75,75,0,10,65,0,0,0,0,0,0,0,0,0,15445
4574,181,0,87,44,50,0,0,0,0,0,0,0,0,0,0,0,0,0,0,0,0,0,0,0,0,0,0,0,0,0,0,0,0,0,0,15446
4575,70,64,6,0,0,0,0,0,0,0,0,0,0,0,0,0,0,0,0,0,0,0,0,0,0,0,0,0,0,0,0,0,0,0,0,15447
4576,231,68,104,50,9,0,0,0,0,0,0,0,0,0,0,0,0,0,0,0,0,0,0,0,0,0,0,0,0,0,0,0,0,0,0,15448
4577,173,37,136,0,0,0,0,0,0,0,0,0,0,0,0,0,0,0,0,0,0,0,0,0,0,0,0,0,0,0,0,0,0,0,0,15449
4578,1964,534,1034,336,40,20,21,0,0,0,0,0,0,0,0,0,0,0,0,0,0,21,21,0,0,21,0,0,0,0,0,0,0,0,0,15450
4579,715,76,321,221,70,27,79,68,61,16,0,45,7,7,7,0,0,0,0,0,0,11,11,0,0,11,0,0,0,0,0,0,0,0,0,15451
4580,315,127,65,59,0,64,0,0,0,0,0,0,0,0,0,0,0,0,0,0,0,0,0,0,0,0,0,0,0,0,0,0,0,0,0,15454
4581,262,52,45,105,60,0,68,43,43,9,7,27,0,0,0,0,0,0,0,0,0,25,25,0,25,0,0,0,0,0,0,0,0,0,0,15455
4582,2195,431,1041,470,191,62,149,64,59,7,0,52,5,0,0,0,0,5,0,0,5,85,79,0,34,45,6,6,0,6,0,0,0,0,0,15456
4583,1845,240,825,508,239,33,203,91,75,13,18,44,16,16,16,0,0,0,0,0,0,112,71,13,0,58,41,0,0,0,0,41,0,0,41,15458
4584,981,166,537,230,21,27,41,15,15,0,0,15,0,0,0,0,0,0,0,0,0,26,10,0,6,4,16,16,7,0,9,0,0,0,0,15459
4585,39,3,27,5,2,2,10,10,10,0,0,10,0,0,0,0,0,0,0,0,0,0,0,0,0,0,0,0,0,0,0,0,0,0,0,15460
4586,2833,419,1555,470,269,120,221,118,58,30,0,28,60,50,34,16,0,10,0,0,10,103,94,13,20,61,9,9,9,0,0,0,0,0,0,15461
4587,162,36,71,55,0,0,0,0,0,0,0,0,0,0,0,0,0,0,0,0,0,0,0,0,0,0,0,0,0,0,0,0,0,0,0,15462
4588,0,0,0,0,0,0,0,0,0,0,0,0,0,0,0,0,0,0,0,0,0,0,0,0,0,0,0,0,0,0,0,0,0,0,0,15463
4589,1110,215,677,154,38,26,82,24,24,4,0,20,0,0,0,0,0,0,0,0,0,58,58,0,8,50,0,0,0,0,0,0,0,0,0,15464
4590,300,30,159,76,28,7,40,25,16,2,0,14,9,6,6,0,0,3,0,0,3,15,15,8,0,7,0,0,0,0,0,0,0,0,0,15466
4591,99,20,43,36,0,0,11,4,4,0,0,4,0,0,0,0,0,0,0,0,0,7,4,0,4,0,3,3,0,0,3,0,0,0,0,15467
4592,1863,284,889,426,142,122,132,16,16,0,14,2,0,0,0,0,0,0,0,0,0,116,91,0,12,79,25,25,0,0,25,0,0,0,0,15468
4593,1719,340,843,387,117,32,96,60,50,0,0,50,10,0,0,0,0,10,10,0,0,36,36,0,0,36,0,0,0,0,0,0,0,0,0,15469
4594,749,32,314,211,154,38,76,19,19,9,0,10,0,0,0,0,0,0,0,0,0,57,57,5,0,52,0,0,0,0,0,0,0,0,0,15470
4595,189,23,77,24,65,0,8,0,0,0,0,0,0,0,0,0,0,0,0,0,0,8,0,0,0,0,8,8,0,0,8,0,0,0,0,15472
4596,3140,185,1572,757,465,161,228,139,95,16,11,68,44,44,22,22,0,0,0,0,0,89,47,24,0,23,42,15,15,0,0,27,0,27,0,15473
4597,1356,242,673,254,129,58,143,92,62,40,0,22,30,4,4,0,0,26,16,0,10,51,43,17,3,23,8,8,4,0,4,0,0,0,0,15474
4598,720,114,320,198,62,26,64,37,12,12,0,0,25,0,0,0,0,25,0,0,25,27,27,12,15,0,0,0,0,0,0,0,0,0,0,15475
4599,43,15,28,0,0,0,0,0,0,0,0,0,0,0,0,0,0,0,0,0,0,0,0,0,0,0,0,0,0,0,0,0,0,0,0,15476
4600,526,27,255,121,84,39,50,6,6,0,0,6,0,0,0,0,0,0,0,0,0,44,40,8,0,32,4,4,0,0,4,0,0,0,0,15477
4601,4956,966,2632,864,388,106,311,234,203,80,17,106,31,20,17,0,3,11,11,0,0,77,63,17,3,43,14,6,0,6,0,8,3,0,5,15478
4602,1487,222,657,371,135,102,143,53,20,4,0,16,33,33,5,0,28,0,0,0,0,90,76,4,16,56,14,8,8,0,0,6,6,0,0,15479
4603,1524,286,795,309,98,36,78,31,10,10,0,0,21,4,0,0,4,17,0,0,17,47,33,0,0,33,14,14,14,0,0,0,0,0,0,15480
4604,388,62,237,60,19,10,35,22,22,22,0,0,0,0,0,0,0,0,0,0,0,13,13,0,0,13,0,0,0,0,0,0,0,0,0,15482
4605,354,41,128,130,42,13,26,11,11,5,0,6,0,0,0,0,0,0,0,0,0,15,15,4,0,11,0,0,0,0,0,0,0,0,0,15483
4606,259,34,217,0,0,8,18,18,0,0,0,0,18,0,0,0,0,18,0,18,0,0,0,0,0,0,0,0,0,0,0,0,0,0,0,15484
4607,1476,175,772,274,169,86,82,68,40,0,0,40,28,28,0,28,0,0,0,0,0,14,14,0,0,14,0,0,0,0,0,0,0,0,0,15486
4608,238,57,76,105,0,0,38,33,33,0,33,0,0,0,0,0,0,0,0,0,0,5,0,0,0,0,5,0,0,0,0,5,0,0,5,15489
4609,724,116,490,70,48,0,116,64,64,0,17,47,0,0,0,0,0,0,0,0,0,52,11,0,0,11,41,0,0,0,0,41,41,0,0,15490
4610,118,28,43,41,0,6,0,0,0,0,0,0,0,0,0,0,0,0,0,0,0,0,0,0,0,0,0,0,0,0,0,0,0,0,0,15492
4611,12149,1470,5758,2736,1350,835,572,316,275,99,22,154,41,30,14,16,0,11,3,7,1,256,209,77,8,124,47,47,15,32,0,0,0,0,0,15501
4612,105,0,11,22,33,39,0,0,0,0,0,0,0,0,0,0,0,0,0,0,0,0,0,0,0,0,0,0,0,0,0,0,0,0,0,15502
4613,1913,440,925,481,58,9,16,16,11,0,0,11,5,0,0,0,0,5,0,0,5,0,0,0,0,0,0,0,0,0,0,0,0,0,0,15510
4614,175,60,91,14,10,0,0,0,0,0,0,0,0,0,0,0,0,0,0,0,0,0,0,0,0,0,0,0,0,0,0,0,0,0,0,15520
4615,1350,130,812,287,101,20,141,82,81,25,16,40,1,1,0,0,1,0,0,0,0,59,41,0,0,41,18,18,18,0,0,0,0,0,0,15521
4616,8423,1270,3899,1906,1000,348,603,353,247,78,10,159,106,62,44,11,7,44,38,0,6,250,211,125,32,54,39,13,13,0,0,26,23,0,3,15522
4617,3738,595,1920,744,300,179,254,149,119,50,13,56,30,20,9,2,9,10,6,4,0,105,95,31,0,64,10,2,2,0,0,8,2,0,6,15530
4618,3110,496,1495,679,275,165,140,112,92,55,2,35,20,15,11,0,4,5,0,0,5,28,28,17,0,11,0,0,0,0,0,0,0,0,0,15531
4619,165,61,78,23,3,0,29,25,25,13,0,12,0,0,0,0,0,0,0,0,0,4,4,0,0,4,0,0,0,0,0,0,0,0,0,15532
4620,1054,211,534,219,42,48,56,11,11,0,0,11,0,0,0,0,0,0,0,0,0,45,31,21,0,10,14,14,14,0,0,0,0,0,0,15533
4621,647,77,345,170,53,2,31,14,14,2,0,12,0,0,0,0,0,0,0,0,0,17,15,7,6,2,2,2,0,2,0,0,0,0,0,15534
4622,1579,340,775,297,121,46,87,37,22,15,0,7,15,11,11,0,0,4,4,0,0,50,34,18,7,9,16,8,5,0,3,8,6,2,0,15535
4623,305,27,160,91,18,9,20,12,10,3,3,4,2,2,2,0,0,0,0,0,0,8,8,0,0,8,0,0,0,0,0,0,0,0,0,15536
4624,5871,976,2875,1215,623,182,368,204,150,67,23,60,54,4,4,0,0,50,22,9,19,164,144,66,31,47,20,20,5,3,12,0,0,0,0,15537
4625,534,60,313,82,52,27,50,26,20,10,1,9,6,6,2,4,0,0,0,0,0,24,19,0,2,17,5,5,2,0,3,0,0,0,0,15538
4626,391,13,200,166,12,0,0,0,0,0,0,0,0,0,0,0,0,0,0,0,0,0,0,0,0,0,0,0,0,0,0,0,0,0,0,15539
4627,165,54,71,29,11,0,22,15,6,6,0,0,9,9,9,0,0,0,0,0,0,7,7,4,0,3,0,0,0,0,0,0,0,0,0,15540
4628,2897,330,1555,635,231,146,188,106,82,26,0,56,24,19,19,0,0,5,0,5,0,82,82,30,0,52,0,0,0,0,0,0,0,0,0,15541
4629,737,121,499,86,20,11,43,18,11,5,0,6,7,7,5,2,0,0,0,0,0,25,19,3,0,16,6,6,0,6,0,0,0,0,0,15542
4630,151,0,151,0,0,0,0,0,0,0,0,0,0,0,0,0,0,0,0,0,0,0,0,0,0,0,0,0,0,0,0,0,0,0,0,15544
4631,2165,370,1184,436,124,51,200,101,87,4,7,76,14,14,12,2,0,0,0,0,0,99,80,36,0,44,19,19,17,2,0,0,0,0,0,15545
4632,260,0,184,57,19,0,42,0,0,0,0,0,0,0,0,0,0,0,0,0,0,42,42,0,21,21,0,0,0,0,0,0,0,0,0,15546
4633,336,9,204,59,48,16,17,11,11,1,0,10,0,0,0,0,0,0,0,0,0,6,6,4,2,0,0,0,0,0,0,0,0,0,0,15547
4634,1147,168,532,298,91,58,41,17,17,3,1,13,0,0,0,0,0,0,0,0,0,24,20,5,0,15,4,4,0,4,0,0,0,0,0,15550
4635,704,118,350,162,50,24,24,11,11,0,0,11,0,0,0,0,0,0,0,0,0,13,8,4,0,4,5,5,2,0,3,0,0,0,0,15551
4636,4321,872,2186,791,288,184,330,141,107,30,0,77,34,22,22,0,0,12,0,0,12,189,135,53,0,82,54,13,8,0,5,41,16,0,25,15552
4637,1769,85,987,472,141,84,125,42,26,23,0,3,16,16,0,14,2,0,0,0,0,83,73,20,0,53,10,6,6,0,0,4,4,0,0,15554
4638,46,9,16,9,12,0,0,0,0,0,0,0,0,0,0,0,0,0,0,0,0,0,0,0,0,0,0,0,0,0,0,0,0,0,0,15555
4639,2564,334,1327,565,210,128,191,95,73,22,9,42,22,22,11,11,0,0,0,0,0,96,91,30,2,59,5,4,4,0,0,1,0,0,1,15557
4640,1467,303,690,302,133,39,120,59,42,10,9,23,17,8,3,2,3,9,7,0,2,61,47,21,0,26,14,11,11,0,0,3,0,0,3,15558
4641,1480,184,828,298,104,66,96,43,42,26,6,10,1,1,1,0,0,0,0,0,0,53,44,16,7,21,9,9,3,0,6,0,0,0,0,15559
4642,133,2,102,12,5,12,9,2,1,0,0,1,1,1,1,0,0,0,0,0,0,7,7,0,0,7,0,0,0,0,0,0,0,0,0,15560
4643,111,20,54,28,3,6,4,4,4,0,0,4,0,0,0,0,0,0,0,0,0,0,0,0,0,0,0,0,0,0,0,0,0,0,0,15561
4644,117,17,36,31,12,21,19,9,0,0,0,0,9,4,4,0,0,5,5,0,0,10,4,4,0,0,6,6,0,0,6,0,0,0,0,15562
4645,2266,370,1156,465,208,67,142,42,26,4,5,17,16,12,8,4,0,4,4,0,0,100,78,14,9,55,22,19,12,7,0,3,3,0,0,15563
4646,61,6,29,22,4,0,4,0,0,0,0,0,0,0,0,0,0,0,0,0,0,4,4,0,0,4,0,0,0,0,0,0,0,0,0,15564
4647,43483,2838,15009,11556,9128,4952,2798,1271,1109,324,67,718,162,118,61,48,9,44,26,0,18,1527,1397,690,66,641,130,85,60,22,3,45,5,0,40,15601
4648,2599,283,1101,656,352,207,113,78,53,18,0,35,25,23,23,0,0,2,0,0,2,35,35,17,0,18,0,0,0,0,0,0,0,0,0,15610
4649,456,22,277,141,6,10,10,3,2,2,0,0,1,1,1,0,0,0,0,0,0,7,7,7,0,0,0,0,0,0,0,0,0,0,0,15611
4650,201,20,91,62,0,28,0,0,0,0,0,0,0,0,0,0,0,0,0,0,0,0,0,0,0,0,0,0,0,0,0,0,0,0,0,15612
4651,10506,1025,4699,2724,1426,632,733,384,337,79,34,224,47,46,33,11,2,1,0,0,1,349,283,171,14,98,66,37,6,7,24,29,13,0,16,15613
4652,224,0,135,38,42,9,49,0,0,0,0,0,0,0,0,0,0,0,0,0,0,49,49,16,25,8,0,0,0,0,0,0,0,0,0,15615
4653,72,41,31,0,0,0,0,0,0,0,0,0,0,0,0,0,0,0,0,0,0,0,0,0,0,0,0,0,0,0,0,0,0,0,0,15616
4654,301,40,172,62,16,11,20,0,0,0,0,0,0,0,0,0,0,0,0,0,0,20,16,2,0,14,4,0,0,0,0,4,0,0,4,15617
4655,1934,218,1008,506,126,76,136,53,42,20,3,19,11,11,3,8,0,0,0,0,0,83,83,35,9,39,0,0,0,0,0,0,0,0,0,15618
4656,637,77,322,187,51,0,40,0,0,0,0,0,0,0,0,0,0,0,0,0,0,40,37,0,0,37,3,0,0,0,0,3,0,0,3,15620
4657,12,0,7,5,0,0,0,0,0,0,0,0,0,0,0,0,0,0,0,0,0,0,0,0,0,0,0,0,0,0,0,0,0,0,0,15621
4658,1189,47,687,283,137,35,15,6,6,0,0,6,0,0,0,0,0,0,0,0,0,9,9,9,0,0,0,0,0,0,0,0,0,0,0,15622
4659,654,90,300,146,108,10,0,0,0,0,0,0,0,0,0,0,0,0,0,0,0,0,0,0,0,0,0,0,0,0,0,0,0,0,0,15623
4660,279,11,159,95,7,7,0,0,0,0,0,0,0,0,0,0,0,0,0,0,0,0,0,0,0,0,0,0,0,0,0,0,0,0,0,15624
4661,108,20,0,88,0,0,0,0,0,0,0,0,0,0,0,0,0,0,0,0,0,0,0,0,0,0,0,0,0,0,0,0,0,0,0,15625
4662,4242,392,1454,1145,692,559,196,131,122,80,0,42,9,9,9,0,0,0,0,0,0,65,62,46,5,11,3,3,3,0,0,0,0,0,0,15626
4663,4731,378,2188,1472,476,217,283,131,127,32,10,85,4,0,0,0,0,4,4,0,0,152,134,31,0,103,18,18,9,9,0,0,0,0,0,15627
4664,530,71,209,159,70,21,10,9,0,0,0,0,9,9,9,0,0,0,0,0,0,1,1,0,0,1,0,0,0,0,0,0,0,0,0,15628
4665,496,46,236,123,77,14,49,36,36,0,0,36,0,0,0,0,0,0,0,0,0,13,13,5,0,8,0,0,0,0,0,0,0,0,0,15629
4666,756,128,403,179,31,15,26,23,23,11,2,10,0,0,0,0,0,0,0,0,0,3,3,0,3,0,0,0,0,0,0,0,0,0,0,15631
4667,6652,513,1964,1614,1409,1152,546,336,322,117,44,161,14,14,0,0,14,0,0,0,0,210,200,113,0,87,10,10,10,0,0,0,0,0,0,15632
4668,228,13,117,30,68,0,0,0,0,0,0,0,0,0,0,0,0,0,0,0,0,0,0,0,0,0,0,0,0,0,0,0,0,0,0,15633
4669,449,46,172,183,28,20,8,0,0,0,0,0,0,0,0,0,0,0,0,0,0,8,8,0,0,8,0,0,0,0,0,0,0,0,0,15634
4670,69,0,41,28,0,0,0,0,0,0,0,0,0,0,0,0,0,0,0,0,0,0,0,0,0,0,0,0,0,0,0,0,0,0,0,15635
4671,2576,47,686,749,610,484,320,178,161,53,0,108,17,0,0,0,0,17,0,17,0,142,125,17,0,108,17,0,0,0,0,17,0,0,17,15636
4672,1424,89,712,332,254,37,166,124,117,0,0,117,7,0,0,0,0,7,7,0,0,42,32,16,0,16,10,10,10,0,0,0,0,0,0,15637
4673,297,115,105,77,0,0,53,53,53,0,0,53,0,0,0,0,0,0,0,0,0,0,0,0,0,0,0,0,0,0,0,0,0,0,0,15638
4674,1628,109,744,357,245,173,99,66,62,31,0,31,4,4,4,0,0,0,0,0,0,33,33,23,0,10,0,0,0,0,0,0,0,0,0,15639
4675,372,38,160,118,22,34,88,32,32,0,0,32,0,0,0,0,0,0,0,0,0,56,56,28,0,28,0,0,0,0,0,0,0,0,0,15640
4676,387,39,223,85,30,10,16,8,8,2,0,6,0,0,0,0,0,0,0,0,0,8,8,6,0,2,0,0,0,0,0,0,0,0,0,15641
4677,32378,1428,11325,9075,7143,3407,2060,1098,987,279,56,652,111,93,66,19,8,18,16,0,2,962,873,352,59,462,89,85,72,13,0,4,4,0,0,15642
4678,13894,1182,5593,4034,2194,891,1178,739,654,135,77,442,85,65,32,33,0,20,0,0,20,439,380,110,33,237,59,53,38,0,15,6,0,0,6,15644
4679,159,44,68,36,4,7,0,0,0,0,0,0,0,0,0,0,0,0,0,0,0,0,0,0,0,0,0,0,0,0,0,0,0,0,0,15646
4680,219,0,171,48,0,0,16,0,0,0,0,0,0,0,0,0,0,0,0,0,0,16,16,16,0,0,0,0,0,0,0,0,0,0,0,15647
4681,19960,2022,8337,5465,2782,1354,2011,978,882,224,110,548,96,96,55,21,20,0,0,0,0,1033,953,300,87,566,80,57,48,0,9,23,7,0,16,15650
4682,258,8,1,118,54,77,4,0,0,0,0,0,0,0,0,0,0,0,0,0,0,4,4,0,0,4,0,0,0,0,0,0,0,0,0,15655
4683,7250,692,3173,2030,929,426,714,346,241,66,8,167,105,102,102,0,0,3,0,3,0,368,268,83,24,161,100,23,2,21,0,77,15,0,62,15656
4684,6859,610,2685,1665,1191,708,384,243,204,17,37,150,39,39,0,0,39,0,0,0,0,141,136,10,0,126,5,5,5,0,0,0,0,0,0,15658
4685,256,41,134,46,17,18,24,9,0,0,0,0,9,9,0,9,0,0,0,0,0,15,15,0,0,15,0,0,0,0,0,0,0,0,0,15660
4686,315,8,190,77,30,10,38,11,11,11,0,0,0,0,0,0,0,0,0,0,0,27,27,0,0,27,0,0,0,0,0,0,0,0,0,15661
4687,217,0,50,167,0,0,0,0,0,0,0,0,0,0,0,0,0,0,0,0,0,0,0,0,0,0,0,0,0,0,0,0,0,0,0,15662
4688,460,47,211,125,55,22,13,12,12,0,0,12,0,0,0,0,0,0,0,0,0,1,1,1,0,0,0,0,0,0,0,0,0,0,0,15663
4689,1093,88,451,318,133,103,133,133,118,78,0,40,15,4,0,4,0,11,0,0,11,0,0,0,0,0,0,0,0,0,0,0,0,0,0,15665
4690,12727,1313,5978,3246,1467,723,873,437,374,104,74,196,63,50,50,0,0,13,0,0,13,436,347,88,30,229,89,45,45,0,0,44,0,31,13,15666
4691,10011,292,2108,2280,3170,2161,572,306,283,124,14,145,23,23,0,23,0,0,0,0,0,266,225,85,0,140,41,19,0,0,19,22,0,0,22,15668
4692,2290,166,1041,578,340,165,168,139,129,49,35,45,10,10,10,0,0,0,0,0,0,29,29,8,6,15,0,0,0,0,0,0,0,0,0,15670
4693,521,51,230,186,54,0,11,0,0,0,0,0,0,0,0,0,0,0,0,0,0,11,0,0,0,0,11,11,11,0,0,0,0,0,0,15671
4694,2434,46,1007,707,383,291,118,54,41,11,5,25,13,13,13,0,0,0,0,0,0,64,43,27,0,16,21,21,21,0,0,0,0,0,0,15672
4695,939,91,493,192,132,31,107,79,71,11,0,60,8,0,0,0,0,8,0,0,8,28,14,14,0,0,14,4,0,4,0,10,0,0,10,15673
4696,692,24,356,231,53,28,52,35,34,23,0,11,1,1,1,0,0,0,0,0,0,17,17,3,0,14,0,0,0,0,0,0,0,0,0,15675
4697,153,0,71,39,43,0,0,0,0,0,0,0,0,0,0,0,0,0,0,0,0,0,0,0,0,0,0,0,0,0,0,0,0,0,0,15676
4698,317,14,136,86,48,33,51,46,35,4,0,31,11,0,0,0,0,11,0,0,11,5,5,0,0,5,0,0,0,0,0,0,0,0,0,15677
4699,139,52,36,43,8,0,0,0,0,0,0,0,0,0,0,0,0,0,0,0,0,0,0,0,0,0,0,0,0,0,0,0,0,0,0,15678
4700,2690,314,1412,661,242,61,220,152,90,66,0,24,62,62,62,0,0,0,0,0,0,68,68,46,0,22,0,0,0,0,0,0,0,0,0,15679
4701,102,11,55,36,0,0,0,0,0,0,0,0,0,0,0,0,0,0,0,0,0,0,0,0,0,0,0,0,0,0,0,0,0,0,0,15680
4702,3628,290,1802,920,435,181,298,124,105,21,3,81,19,17,16,1,0,2,2,0,0,174,150,24,10,116,24,24,8,0,16,0,0,0,0,15681
4703,5973,472,2630,1937,683,251,329,98,82,15,20,47,16,7,6,0,1,9,0,0,9,231,162,98,27,37,69,68,46,0,22,1,0,0,1,15683
4704,421,44,220,79,63,15,38,27,27,27,0,0,0,0,0,0,0,0,0,0,0,11,0,0,0,0,11,11,11,0,0,0,0,0,0,15684
4705,753,96,312,242,91,12,13,0,0,0,0,0,0,0,0,0,0,0,0,0,0,13,13,13,0,0,0,0,0,0,0,0,0,0,0,15686
4706,956,139,489,199,99,30,29,24,15,0,0,15,9,9,9,0,0,0,0,0,0,5,5,5,0,0,0,0,0,0,0,0,0,0,0,15687
4707,509,37,337,100,35,0,8,8,8,0,0,8,0,0,0,0,0,0,0,0,0,0,0,0,0,0,0,0,0,0,0,0,0,0,0,15688
4708,158,30,74,54,0,0,33,23,23,23,0,0,0,0,0,0,0,0,0,0,0,10,10,0,10,0,0,0,0,0,0,0,0,0,0,15689
4709,6464,724,3227,1726,567,220,454,260,204,18,8,178,56,30,25,0,5,26,21,0,5,194,157,0,11,146,37,0,0,0,0,37,0,0,37,15690
4710,27,13,14,0,0,0,0,0,0,0,0,0,0,0,0,0,0,0,0,0,0,0,0,0,0,0,0,0,0,0,0,0,0,0,0,15691
4711,638,47,366,82,95,48,21,10,10,0,0,10,0,0,0,0,0,0,0,0,0,11,11,0,0,11,0,0,0,0,0,0,0,0,0,15692
4712,102,0,102,0,0,0,44,0,0,0,0,0,0,0,0,0,0,0,0,0,0,44,44,0,0,44,0,0,0,0,0,0,0,0,0,15693
4713,135,27,81,18,9,0,31,31,21,12,0,9,10,10,0,0,10,0,0,0,0,0,0,0,0,0,0,0,0,0,0,0,0,0,0,15695
4714,258,14,97,117,17,13,11,1,0,0,0,0,1,1,1,0,0,0,0,0,0,10,10,4,1,5,0,0,0,0,0,0,0,0,0,15696
4715,2006,198,976,513,273,46,137,92,92,12,20,60,0,0,0,0,0,0,0,0,0,45,33,25,0,8,12,12,12,0,0,0,0,0,0,15697
4716,590,105,372,65,40,8,52,26,0,0,0,0,26,26,26,0,0,0,0,0,0,26,26,0,0,26,0,0,0,0,0,0,0,0,0,15698
4717,19282,1765,6551,3920,3832,3214,4543,2064,1816,473,202,1141,248,153,36,0,117,95,8,22,65,2479,2454,863,240,1351,25,25,22,0,3,0,0,0,0,15701
4718,252,34,181,33,0,4,5,5,5,0,0,5,0,0,0,0,0,0,0,0,0,0,0,0,0,0,0,0,0,0,0,0,0,0,0,15710
4719,299,45,152,72,23,7,23,3,3,0,0,3,0,0,0,0,0,0,0,0,0,20,8,0,0,8,12,12,2,0,10,0,0,0,0,15711
4720,92,32,57,3,0,0,10,7,7,0,0,7,0,0,0,0,0,0,0,0,0,3,3,3,0,0,0,0,0,0,0,0,0,0,0,15712
4721,221,39,134,48,0,0,0,0,0,0,0,0,0,0,0,0,0,0,0,0,0,0,0,0,0,0,0,0,0,0,0,0,0,0,0,15713
4722,3600,530,1777,758,388,147,258,174,129,11,8,110,45,29,15,9,5,16,0,7,9,84,84,18,0,66,0,0,0,0,0,0,0,0,0,15714
4723,434,61,220,81,58,14,30,20,10,3,0,7,10,7,7,0,0,3,0,3,0,10,6,0,0,6,4,0,0,0,0,4,0,0,4,15715
4724,470,124,212,130,4,0,119,67,5,5,0,0,62,26,0,0,26,36,0,0,36,52,14,0,0,14,38,0,0,0,0,38,0,0,38,15716
4725,7638,853,3674,1834,951,326,600,391,328,116,12,200,63,61,11,25,25,2,2,0,0,209,144,41,13,90,65,54,0,54,0,11,0,0,11,15717
4726,163,26,82,48,4,3,7,3,3,0,0,3,0,0,0,0,0,0,0,0,0,4,4,0,0,4,0,0,0,0,0,0,0,0,0,15721
4727,1599,150,842,410,134,63,132,67,53,7,3,43,14,9,0,9,0,5,0,0,5,65,56,12,2,42,9,9,0,0,9,0,0,0,0,15722
4728,27,0,21,0,6,0,5,5,5,5,0,0,0,0,0,0,0,0,0,0,0,0,0,0,0,0,0,0,0,0,0,0,0,0,0,15723
4729,1758,314,1021,318,48,57,82,17,10,0,0,10,7,7,3,4,0,0,0,0,0,65,57,0,3,54,8,8,0,5,3,0,0,0,0,15724
4730,1067,144,562,217,118,26,45,13,10,0,0,10,3,3,0,0,3,0,0,0,0,32,29,5,0,24,3,0,0,0,0,3,0,3,0,15725
4731,98,13,44,18,13,10,13,0,0,0,0,0,0,0,0,0,0,0,0,0,0,13,13,0,0,13,0,0,0,0,0,0,0,0,0,15727
4732,2254,274,1275,420,184,101,113,62,53,25,1,27,9,0,0,0,0,9,0,2,7,51,39,10,0,29,12,12,11,1,0,0,0,0,0,15728
4733,1146,134,688,212,40,72,112,39,18,0,10,8,21,21,21,0,0,0,0,0,0,73,73,18,0,55,0,0,0,0,0,0,0,0,0,15729
4734,36,5,11,7,6,7,0,0,0,0,0,0,0,0,0,0,0,0,0,0,0,0,0,0,0,0,0,0,0,0,0,0,0,0,0,15730
4735,201,0,33,76,92,0,57,31,0,0,0,0,31,31,0,0,31,0,0,0,0,26,0,0,0,0,26,26,26,0,0,0,0,0,0,15731
4736,1242,184,649,227,93,89,96,58,43,17,0,26,15,15,15,0,0,0,0,0,0,38,38,15,9,14,0,0,0,0,0,0,0,0,0,15732
4737,75,8,44,10,0,13,3,0,0,0,0,0,0,0,0,0,0,0,0,0,0,3,0,0,0,0,3,3,3,0,0,0,0,0,0,15733
4738,176,24,111,17,12,12,0,0,0,0,0,0,0,0,0,0,0,0,0,0,0,0,0,0,0,0,0,0,0,0,0,0,0,0,0,15734
4739,522,21,293,112,33,63,16,2,2,0,1,1,0,0,0,0,0,0,0,0,0,14,14,14,0,0,0,0,0,0,0,0,0,0,0,15736
4740,96,18,50,16,12,0,3,0,0,0,0,0,0,0,0,0,0,0,0,0,0,3,3,0,0,3,0,0,0,0,0,0,0,0,0,15737
4741,163,36,83,38,0,6,9,6,6,0,0,6,0,0,0,0,0,0,0,0,0,3,0,0,0,0,3,3,0,0,3,0,0,0,0,15738
4742,292,31,131,96,26,8,13,5,5,5,0,0,0,0,0,0,0,0,0,0,0,8,8,7,0,1,0,0,0,0,0,0,0,0,0,15739
4743,54,5,41,6,0,2,13,3,3,0,0,3,0,0,0,0,0,0,0,0,0,10,10,0,0,10,0,0,0,0,0,0,0,0,0,15741
4744,670,103,397,117,31,22,47,18,10,0,0,10,8,3,1,2,0,5,0,0,5,29,21,2,0,19,8,8,0,0,8,0,0,0,0,15742
4745,87,16,34,17,20,0,20,0,0,0,0,0,0,0,0,0,0,0,0,0,0,20,12,0,0,12,8,8,8,0,0,0,0,0,0,15744
4746,209,71,85,36,13,4,16,0,0,0,0,0,0,0,0,0,0,0,0,0,0,16,0,0,0,0,16,16,16,0,0,0,0,0,0,15745
4747,92,38,17,37,0,0,9,5,0,0,0,0,5,3,3,0,0,2,2,0,0,4,4,0,0,4,0,0,0,0,0,0,0,0,0,15746
4748,1366,156,767,267,106,70,154,62,39,4,0,35,23,10,10,0,0,13,13,0,0,92,63,19,3,41,29,3,0,3,0,26,0,12,14,15747
4749,4755,553,2196,1215,606,185,188,98,85,27,14,44,13,8,8,0,0,5,2,0,3,90,78,38,5,35,12,9,9,0,0,3,3,0,0,15748
4750,108,0,48,60,0,0,0,0,0,0,0,0,0,0,0,0,0,0,0,0,0,0,0,0,0,0,0,0,0,0,0,0,0,0,0,15750
4751,35,3,12,20,0,0,7,0,0,0,0,0,0,0,0,0,0,0,0,0,0,7,0,0,0,0,7,7,7,0,0,0,0,0,0,15752
4752,392,53,221,93,16,9,42,12,7,0,0,7,5,0,0,0,0,5,5,0,0,30,19,0,5,14,11,11,11,0,0,0,0,0,0,15753
4753,395,56,205,97,37,0,0,0,0,0,0,0,0,0,0,0,0,0,0,0,0,0,0,0,0,0,0,0,0,0,0,0,0,0,0,15754
4754,148,11,65,57,15,0,13,13,10,0,0,10,3,3,3,0,0,0,0,0,0,0,0,0,0,0,0,0,0,0,0,0,0,0,0,15756
4755,1149,164,646,250,59,30,76,41,37,0,3,34,4,4,2,2,0,0,0,0,0,35,35,7,0,28,0,0,0,0,0,0,0,0,0,15757
4756,2162,230,1116,451,242,123,145,82,62,5,3,54,20,13,13,0,0,7,7,0,0,63,49,23,6,20,14,11,4,4,3,3,0,0,3,15759
4757,79,7,55,7,10,0,0,0,0,0,0,0,0,0,0,0,0,0,0,0,0,0,0,0,0,0,0,0,0,0,0,0,0,0,0,15760
4758,41,0,34,7,0,0,3,3,3,0,0,3,0,0,0,0,0,0,0,0,0,0,0,0,0,0,0,0,0,0,0,0,0,0,0,15761
4759,578,45,235,154,89,55,71,52,41,11,8,22,11,11,11,0,0,0,0,0,0,19,19,3,0,16,0,0,0,0,0,0,0,0,0,15762
4760,83,12,50,3,6,12,3,0,0,0,0,0,0,0,0,0,0,0,0,0,0,3,3,0,0,3,0,0,0,0,0,0,0,0,0,15764
4761,1383,216,632,295,156,84,41,26,23,5,0,18,3,3,3,0,0,0,0,0,0,15,15,3,0,12,0,0,0,0,0,0,0,0,0,15765
4762,9938,1477,4903,2201,898,459,913,434,351,97,44,210,83,40,29,2,9,43,24,16,3,479,428,105,22,301,51,26,11,8,7,25,0,0,25,15767
4763,200,21,128,37,4,10,13,10,10,0,0,10,0,0,0,0,0,0,0,0,0,3,3,3,0,0,0,0,0,0,0,0,0,0,0,15770
4764,737,119,357,152,61,48,48,12,5,0,0,5,7,0,0,0,0,7,7,0,0,36,25,2,17,6,11,0,0,0,0,11,0,0,11,15771
4765,1193,284,593,249,44,23,64,34,20,11,0,9,14,5,0,3,2,9,7,0,2,30,30,3,8,19,0,0,0,0,0,0,0,0,0,15772
4766,341,49,155,82,46,9,29,24,24,6,5,13,0,0,0,0,0,0,0,0,0,5,3,0,0,3,2,2,2,0,0,0,0,0,0,15773
4767,2419,246,1002,485,410,276,150,68,53,10,3,40,15,7,6,1,0,8,0,0,8,82,71,6,0,65,11,11,9,0,2,0,0,0,0,15774
4768,637,78,312,116,127,4,13,0,0,0,0,0,0,0,0,0,0,0,0,0,0,13,13,0,0,13,0,0,0,0,0,0,0,0,0,15775
4769,46,13,19,3,9,2,5,3,3,0,0,3,0,0,0,0,0,0,0,0,0,2,2,0,0,2,0,0,0,0,0,0,0,0,0,15776
4770,81,0,41,30,10,0,10,10,0,0,0,0,10,0,0,0,0,10,0,0,10,0,0,0,0,0,0,0,0,0,0,0,0,0,0,15777
4771,82,3,60,9,10,0,12,11,8,2,0,6,3,3,3,0,0,0,0,0,0,1,1,0,0,1,0,0,0,0,0,0,0,0,0,15778
4772,228,46,62,92,6,22,22,22,22,0,0,22,0,0,0,0,0,0,0,0,0,0,0,0,0,0,0,0,0,0,0,0,0,0,0,15779
4773,100,10,72,18,0,0,5,0,0,0,0,0,0,0,0,0,0,0,0,0,0,5,5,2,0,3,0,0,0,0,0,0,0,0,0,15780
4774,46,0,18,12,16,0,0,0,0,0,0,0,0,0,0,0,0,0,0,0,0,0,0,0,0,0,0,0,0,0,0,0,0,0,0,15781
4775,59,12,22,17,4,4,0,0,0,0,0,0,0,0,0,0,0,0,0,0,0,0,0,0,0,0,0,0,0,0,0,0,0,0,0,15783
4776,55,4,33,7,8,3,2,2,0,0,0,0,2,2,0,2,0,0,0,0,0,0,0,0,0,0,0,0,0,0,0,0,0,0,0,15784
4777,13723,1208,5880,3579,1942,1114,1094,691,583,193,104,286,108,55,20,15,20,53,42,0,11,403,358,78,23,257,45,14,13,0,1,31,20,11,0,15801
4778,145,12,69,31,30,3,6,2,2,2,0,0,0,0,0,0,0,0,0,0,0,4,4,0,0,4,0,0,0,0,0,0,0,0,0,15821
4779,1134,100,603,240,151,40,68,32,17,0,0,17,15,15,3,0,12,0,0,0,0,36,36,10,0,26,0,0,0,0,0,0,0,0,0,15823
4780,3589,393,1807,946,332,111,235,150,134,15,10,109,16,8,5,3,0,8,0,4,4,85,75,8,11,56,10,2,2,0,0,8,0,0,8,15824
4781,7065,712,3487,1764,737,365,466,240,177,31,13,133,63,50,16,8,26,13,13,0,0,226,207,46,30,131,19,15,10,0,5,4,0,0,4,15825
4782,196,4,98,75,19,0,18,11,11,0,0,11,0,0,0,0,0,0,0,0,0,7,7,7,0,0,0,0,0,0,0,0,0,0,0,15827
4783,313,20,158,111,17,7,5,5,4,0,0,4,1,0,0,0,0,1,0,0,1,0,0,0,0,0,0,0,0,0,0,0,0,0,0,15828
4784,864,56,424,278,67,39,88,72,68,35,0,33,4,4,3,0,1,0,0,0,0,16,14,3,0,11,2,2,0,0,2,0,0,0,0,15829
4785,299,55,178,48,16,2,13,7,6,0,0,6,1,1,1,0,0,0,0,0,0,6,4,4,0,0,2,0,0,0,0,2,2,0,0,15832
4786,3266,415,1633,726,388,104,276,136,102,12,0,90,34,30,21,1,8,4,0,0,4,140,122,30,10,82,18,13,12,0,1,5,0,0,5,15834
4787,1289,109,720,326,82,52,106,75,51,12,0,39,24,24,18,3,3,0,0,0,0,31,27,13,0,14,4,4,4,0,0,0,0,0,0,15840
4788,280,35,127,82,33,3,7,7,0,0,0,0,7,7,7,0,0,0,0,0,0,0,0,0,0,0,0,0,0,0,0,0,0,0,0,15841
4789,2458,288,1432,535,88,115,164,115,109,26,18,65,6,6,0,6,0,0,0,0,0,49,41,7,0,34,8,8,8,0,0,0,0,0,0,15845
4790,2519,213,1414,493,300,99,255,148,126,24,0,102,22,22,22,0,0,0,0,0,0,107,107,74,0,33,0,0,0,0,0,0,0,0,0,15846
4791,132,39,65,17,6,5,0,0,0,0,0,0,0,0,0,0,0,0,0,0,0,0,0,0,0,0,0,0,0,0,0,0,0,0,0,15847
4792,657,135,329,97,67,29,51,20,7,5,0,2,13,0,0,0,0,13,7,0,6,31,24,3,0,21,7,4,1,0,3,3,0,0,3,15848
4793,827,126,462,183,46,10,84,44,39,4,9,26,5,5,0,0,5,0,0,0,0,40,34,21,7,6,6,6,6,0,0,0,0,0,0,15849
4794,4672,573,2641,1009,299,150,341,159,102,20,5,77,57,11,0,4,7,46,15,12,19,182,142,48,12,82,40,15,3,7,5,25,0,7,18,15851
4795,4602,301,2167,1376,555,203,261,113,113,31,0,82,0,0,0,0,0,0,0,0,0,148,136,45,11,80,12,4,0,4,0,8,0,8,0,15853
4796,637,30,362,183,57,5,58,26,20,8,10,2,6,6,0,0,6,0,0,0,0,32,25,15,0,10,7,7,3,0,4,0,0,0,0,15856
4797,9772,1016,4843,2347,1035,531,669,379,353,118,36,199,26,17,17,0,0,9,0,0,9,290,261,147,0,114,29,29,29,0,0,0,0,0,0,15857
4798,810,119,443,121,80,47,23,15,15,6,0,9,0,0,0,0,0,0,0,0,0,8,8,0,0,8,0,0,0,0,0,0,0,0,0,15860
4799,127,19,79,10,15,4,0,0,0,0,0,0,0,0,0,0,0,0,0,0,0,0,0,0,0,0,0,0,0,0,0,0,0,0,0,15861
4800,150,31,100,10,9,0,0,0,0,0,0,0,0,0,0,0,0,0,0,0,0,0,0,0,0,0,0,0,0,0,0,0,0,0,0,15863
4801,1224,111,680,233,159,41,99,66,51,9,6,36,15,15,11,0,4,0,0,0,0,33,30,13,1,16,3,3,3,0,0,0,0,0,0,15864
4802,999,206,459,242,43,49,36,31,16,3,3,10,15,0,0,0,0,15,0,4,11,5,2,0,0,2,3,0,0,0,0,3,3,0,0,15865
4803,170,20,88,29,26,7,9,4,1,0,0,1,3,3,3,0,0,0,0,0,0,5,0,0,0,0,5,1,1,0,0,4,0,0,4,15866
4804,984,119,469,238,132,26,70,45,31,7,0,24,14,14,14,0,0,0,0,0,0,25,22,11,0,11,3,3,3,0,0,0,0,0,0,15868
4805,994,76,624,171,96,27,79,48,48,15,0,33,0,0,0,0,0,0,0,0,0,31,27,21,0,6,4,4,4,0,0,0,0,0,0,15870
4806,3044,636,1535,629,171,73,72,30,29,9,0,20,1,1,0,0,1,0,0,0,0,42,25,0,9,16,17,0,0,0,0,17,0,17,0,15901
4807,8710,950,4527,2121,782,330,486,284,242,31,11,200,42,42,29,13,0,0,0,0,0,202,134,29,10,95,68,43,0,9,34,25,1,12,12,15902
4808,11112,1134,4562,2393,1850,1173,1459,639,638,104,5,529,1,0,0,0,0,1,0,0,1,820,784,179,126,479,36,28,23,0,5,8,0,8,0,15904
4809,15572,835,5874,4189,3047,1627,877,492,437,93,123,221,55,50,46,0,4,5,0,0,5,385,369,84,89,196,16,16,9,7,0,0,0,0,0,15905
4810,8098,1455,4062,1788,612,181,474,274,181,71,6,104,93,70,9,60,1,23,12,8,3,200,160,53,0,107,40,29,10,1,18,11,0,11,0,15906
4811,4051,426,2117,974,423,111,206,75,71,9,6,56,4,4,3,0,1,0,0,0,0,131,114,24,18,72,17,11,7,4,0,6,0,2,4,15909
4812,631,87,271,196,64,13,73,38,22,14,0,8,16,16,4,12,0,0,0,0,0,35,30,22,0,8,5,5,5,0,0,0,0,0,0,15920
4813,182,26,107,32,4,13,0,0,0,0,0,0,0,0,0,0,0,0,0,0,0,0,0,0,0,0,0,0,0,0,0,0,0,0,0,15921
4814,118,39,48,21,10,0,5,0,0,0,0,0,0,0,0,0,0,0,0,0,0,5,5,5,0,0,0,0,0,0,0,0,0,0,0,15922
4815,1189,172,571,314,85,47,132,107,89,4,0,85,18,18,2,5,11,0,0,0,0,25,25,3,0,22,0,0,0,0,0,0,0,0,0,15923
4816,766,132,427,136,61,10,36,20,20,0,0,20,0,0,0,0,0,0,0,0,0,16,16,0,0,16,0,0,0,0,0,0,0,0,0,15924
4817,130,12,81,32,5,0,5,3,3,0,1,2,0,0,0,0,0,0,0,0,0,2,2,0,0,2,0,0,0,0,0,0,0,0,0,15925
4818,1935,244,979,410,199,103,151,89,79,32,0,47,10,10,7,0,3,0,0,0,0,62,54,18,0,36,8,8,0,0,8,0,0,0,0,15926
4819,532,135,179,160,29,29,23,23,10,0,0,10,13,13,0,13,0,0,0,0,0,0,0,0,0,0,0,0,0,0,0,0,0,0,0,15927
4820,1902,99,824,455,377,147,154,132,120,31,39,50,12,12,0,12,0,0,0,0,0,22,22,22,0,0,0,0,0,0,0,0,0,0,0,15928
4821,68,12,22,20,4,10,0,0,0,0,0,0,0,0,0,0,0,0,0,0,0,0,0,0,0,0,0,0,0,0,0,0,0,0,0,15929
4822,115,31,84,0,0,0,20,20,20,0,0,20,0,0,0,0,0,0,0,0,0,0,0,0,0,0,0,0,0,0,0,0,0,0,0,15930
4823,6539,722,2512,1537,1129,639,552,325,307,50,23,234,18,18,0,0,18,0,0,0,0,227,218,18,21,179,9,6,2,0,4,3,0,0,3,15931
4824,89,13,12,29,11,24,0,0,0,0,0,0,0,0,0,0,0,0,0,0,0,0,0,0,0,0,0,0,0,0,0,0,0,0,0,15934
4825,2000,277,1033,403,145,142,100,48,39,0,1,38,9,9,0,0,9,0,0,0,0,52,32,0,2,30,20,0,0,0,0,20,20,0,0,15935
4826,1170,172,656,219,90,33,118,67,67,4,13,50,0,0,0,0,0,0,0,0,0,51,41,3,5,33,10,10,8,0,2,0,0,0,0,15936
4827,491,120,230,53,72,16,23,23,23,0,0,23,0,0,0,0,0,0,0,0,0,0,0,0,0,0,0,0,0,0,0,0,0,0,0,15937
4828,1842,103,968,507,203,61,115,54,51,11,24,16,3,3,2,1,0,0,0,0,0,61,57,29,0,28,4,4,2,2,0,0,0,0,0,15938
4829,2320,224,880,841,212,163,607,171,158,20,0,138,13,7,5,2,0,6,0,0,6,436,436,82,23,331,0,0,0,0,0,0,0,0,0,15940
4830,1426,130,688,349,91,168,106,91,88,15,0,73,3,3,0,0,3,0,0,0,0,15,10,0,4,6,5,5,5,0,0,0,0,0,0,15942
4831,2902,344,1618,578,180,182,145,88,83,6,0,77,5,0,0,0,0,5,0,0,5,57,52,6,3,43,5,5,0,0,5,0,0,0,0,15943
4832,2724,421,1371,616,217,99,141,85,70,29,2,39,15,15,12,3,0,0,0,0,0,56,56,0,0,56,0,0,0,0,0,0,0,0,0,15944
4833,136,33,79,9,7,8,19,19,11,11,0,0,8,8,2,6,0,0,0,0,0,0,0,0,0,0,0,0,0,0,0,0,0,0,0,15945
4834,4933,454,2413,1196,568,302,294,109,98,17,0,81,11,11,11,0,0,0,0,0,0,185,175,27,18,130,10,10,10,0,0,0,0,0,0,15946
4835,474,112,228,102,32,0,0,0,0,0,0,0,0,0,0,0,0,0,0,0,0,0,0,0,0,0,0,0,0,0,0,0,0,0,0,15948
4836,341,44,195,79,23,0,16,8,4,0,4,0,4,4,4,0,0,0,0,0,0,8,8,0,4,4,0,0,0,0,0,0,0,0,0,15949
4837,451,109,239,57,31,15,0,0,0,0,0,0,0,0,0,0,0,0,0,0,0,0,0,0,0,0,0,0,0,0,0,0,0,0,0,15951
4838,981,42,403,333,154,49,79,62,23,0,10,13,39,39,39,0,0,0,0,0,0,17,9,0,0,9,8,8,8,0,0,0,0,0,0,15952
4839,113,0,93,0,20,0,39,39,39,16,0,23,0,0,0,0,0,0,0,0,0,0,0,0,0,0,0,0,0,0,0,0,0,0,0,15953
4840,1681,225,818,426,159,53,102,41,35,3,0,32,6,0,0,0,0,6,0,0,6,61,52,14,12,26,9,9,2,0,7,0,0,0,0,15954
4841,2084,358,1068,350,220,88,129,70,47,16,0,31,23,18,18,0,0,5,0,5,0,59,40,12,7,21,19,15,15,0,0,4,0,0,4,15955
4842,1618,172,949,355,99,43,143,90,87,17,6,64,3,3,0,3,0,0,0,0,0,53,35,8,4,23,18,18,4,0,14,0,0,0,0,15956
4843,450,74,228,69,75,4,12,3,3,3,0,0,0,0,0,0,0,0,0,0,0,9,9,0,0,9,0,0,0,0,0,0,0,0,0,15957
4844,1475,150,730,308,233,54,97,47,47,14,0,33,0,0,0,0,0,0,0,0,0,50,47,12,0,35,3,3,0,3,0,0,0,0,0,15958
4845,301,43,159,66,27,6,17,5,5,0,0,5,0,0,0,0,0,0,0,0,0,12,0,0,0,0,12,12,0,12,0,0,0,0,0,15960
4846,576,115,239,161,50,11,40,32,32,0,0,32,0,0,0,0,0,0,0,0,0,8,8,2,2,4,0,0,0,0,0,0,0,0,0,15961
4847,78,8,45,15,6,4,6,6,6,0,0,6,0,0,0,0,0,0,0,0,0,0,0,0,0,0,0,0,0,0,0,0,0,0,0,15962
4848,8080,1011,3789,1869,893,518,500,338,300,92,26,182,38,28,16,3,9,10,8,2,0,162,137,28,26,83,25,25,0,25,0,0,0,0,0,15963
4849,28804,2706,11362,8120,4480,2136,1956,1086,896,239,127,530,190,133,79,39,15,57,9,26,22,870,686,357,0,329,184,115,31,44,40,69,33,0,36,16001
4850,10998,1170,4077,3156,1732,863,1045,802,750,73,52,625,52,38,4,8,26,14,14,0,0,243,199,28,10,161,44,20,11,9,0,24,0,0,24,16002
4851,846,120,454,173,87,12,33,12,12,6,0,6,0,0,0,0,0,0,0,0,0,21,18,2,2,14,3,3,3,0,0,0,0,0,0,16020
4852,301,54,166,59,8,14,56,34,24,3,8,13,10,0,0,0,0,10,0,5,5,22,16,5,0,11,6,6,6,0,0,0,0,0,0,16022
4853,3214,295,1629,749,356,185,221,111,93,20,0,73,18,18,10,8,0,0,0,0,0,110,110,35,22,53,0,0,0,0,0,0,0,0,0,16023
4854,142,2,65,67,7,1,14,10,3,2,0,1,7,7,0,7,0,0,0,0,0,4,4,3,0,1,0,0,0,0,0,0,0,0,0,16024
4855,3921,305,1960,1072,428,156,275,140,132,50,24,58,8,8,8,0,0,0,0,0,0,135,107,34,8,65,28,28,15,4,9,0,0,0,0,16025
4856,187,14,81,46,33,13,25,21,15,12,3,0,6,6,6,0,0,0,0,0,0,4,4,0,0,4,0,0,0,0,0,0,0,0,0,16027
4857,1534,181,823,349,118,63,91,34,31,4,8,19,3,3,3,0,0,0,0,0,0,57,52,17,1,34,5,5,2,2,1,0,0,0,0,16028
4858,469,50,214,140,56,9,18,16,16,2,0,14,0,0,0,0,0,0,0,0,0,2,2,2,0,0,0,0,0,0,0,0,0,0,0,16029
4859,201,38,107,37,10,9,22,12,11,0,0,11,1,0,0,0,0,1,0,0,1,10,5,1,0,4,5,5,0,0,5,0,0,0,0,16030
4860,4191,334,1692,1134,678,353,326,162,119,67,7,45,43,43,39,4,0,0,0,0,0,164,160,62,0,98,4,0,0,0,0,4,0,4,0,16033
4861,1370,134,737,390,83,26,140,72,50,17,0,33,22,5,5,0,0,17,0,0,17,68,62,15,13,34,6,6,6,0,0,0,0,0,0,16034
4862,72,3,48,17,4,0,7,4,4,0,0,4,0,0,0,0,0,0,0,0,0,3,3,3,0,0,0,0,0,0,0,0,0,0,0,16035
4863,185,18,97,38,10,22,9,4,0,0,0,0,4,4,0,0,4,0,0,0,0,5,5,1,0,4,0,0,0,0,0,0,0,0,0,16036
4864,3311,274,1265,796,723,253,318,254,246,63,13,170,8,8,8,0,0,0,0,0,0,64,64,13,19,32,0,0,0,0,0,0,0,0,0,16037
4865,2603,288,1293,606,282,134,213,116,94,47,29,18,22,17,7,0,10,5,4,1,0,97,83,24,16,43,14,10,8,2,0,4,0,0,4,16038
4866,692,118,389,143,34,8,58,29,19,3,0,16,10,10,10,0,0,0,0,0,0,29,14,7,0,7,15,12,6,0,6,3,0,0,3,16040
4867,1352,166,745,322,89,30,117,35,35,4,0,31,0,0,0,0,0,0,0,0,0,82,63,14,12,37,19,16,10,6,0,3,0,0,3,16041
4868,803,45,353,294,54,57,61,9,9,0,3,6,0,0,0,0,0,0,0,0,0,52,44,33,0,11,8,0,0,0,0,8,8,0,0,16045
4869,10226,278,1971,2237,3618,2122,584,339,328,54,15,259,11,11,11,0,0,0,0,0,0,245,245,124,0,121,0,0,0,0,0,0,0,0,0,16046
4870,120,9,67,35,7,2,24,20,0,0,0,0,20,0,0,0,0,20,0,11,9,4,4,0,0,4,0,0,0,0,0,0,0,0,0,16048
4871,2411,302,1302,562,188,57,171,94,79,23,3,53,15,5,5,0,0,10,10,0,0,77,68,5,4,59,9,6,3,3,0,3,0,0,3,16049
4872,1150,101,674,276,83,16,97,60,43,15,0,28,17,16,12,2,2,1,0,0,1,37,23,6,0,17,14,9,2,7,0,5,0,3,2,16050
4873,2232,171,989,619,300,153,174,89,88,12,4,72,1,0,0,0,0,1,0,0,1,85,71,7,3,61,14,14,14,0,0,0,0,0,0,16051
4874,1657,154,668,428,305,102,135,57,43,3,0,40,14,14,14,0,0,0,0,0,0,78,73,25,4,44,5,5,0,5,0,0,0,0,0,16052
4875,3094,287,1078,946,611,172,194,85,60,39,0,21,25,0,0,0,0,25,0,0,25,109,104,56,0,48,5,5,0,0,5,0,0,0,0,16053
4876,265,45,108,93,14,5,16,8,8,8,0,0,0,0,0,0,0,0,0,0,0,8,7,0,1,6,1,1,1,0,0,0,0,0,0,16054
4877,6094,407,2452,1821,897,517,321,193,188,103,21,64,5,5,5,0,0,0,0,0,0,128,106,88,0,18,22,22,22,0,0,0,0,0,0,16055
4878,3510,259,1688,963,436,164,317,128,123,29,10,84,5,5,0,0,5,0,0,0,0,189,177,49,3,125,12,12,12,0,0,0,0,0,0,16056
4879,6450,543,2316,1492,1211,888,2311,819,781,223,27,531,38,28,20,5,3,10,0,0,10,1492,1485,541,86,858,7,7,3,0,4,0,0,0,0,16057
4880,5806,280,2038,1499,1247,742,340,258,248,152,26,70,10,5,0,5,0,5,5,0,0,82,77,36,0,41,5,5,0,0,5,0,0,0,0,16059
4881,1879,121,867,593,239,59,214,130,121,57,0,64,9,5,2,0,3,4,0,3,1,84,84,11,13,60,0,0,0,0,0,0,0,0,0,16061
4882,5160,353,1998,1171,1078,560,94,53,53,15,0,38,0,0,0,0,0,0,0,0,0,41,41,19,0,22,0,0,0,0,0,0,0,0,0,16063
4883,18814,516,3904,3879,6863,3652,1345,633,603,255,38,310,30,30,30,0,0,0,0,0,0,712,685,335,9,341,27,7,7,0,0,20,20,0,0,16066
4884,23876,3699,11348,5409,2428,992,1852,1032,814,133,64,617,218,179,86,10,83,39,15,0,24,820,673,173,73,427,147,62,7,0,55,85,9,0,76,16101
4885,4054,444,1947,998,423,242,232,139,126,38,0,88,13,3,3,0,0,10,8,0,2,93,55,6,4,45,38,38,19,13,6,0,0,0,0,16102
4886,11224,694,4042,2764,2583,1141,523,295,241,8,14,219,54,54,29,0,25,0,0,0,0,228,209,48,23,138,19,19,19,0,0,0,0,0,0,16105
4887,256,48,119,68,15,6,6,4,4,0,0,4,0,0,0,0,0,0,0,0,0,2,2,0,0,2,0,0,0,0,0,0,0,0,0,16110
4888,776,268,299,116,77,16,82,33,5,0,0,5,28,0,0,0,0,28,28,0,0,49,28,4,0,24,21,4,4,0,0,17,0,0,17,16111
4889,1201,87,612,314,111,77,84,36,33,4,9,20,3,3,0,3,0,0,0,0,0,48,44,26,5,13,4,0,0,0,0,4,0,4,0,16112
4890,315,3,151,105,34,22,7,4,4,2,0,2,0,0,0,0,0,0,0,0,0,3,3,3,0,0,0,0,0,0,0,0,0,0,0,16113
4891,391,41,251,65,28,6,13,6,4,0,0,4,2,2,2,0,0,0,0,0,0,7,7,1,2,4,0,0,0,0,0,0,0,0,0,16114
4892,2339,206,1185,605,231,112,255,153,112,42,4,66,41,41,26,15,0,0,0,0,0,102,102,33,9,60,0,0,0,0,0,0,0,0,0,16115
4893,2158,280,1029,557,192,100,47,13,13,0,0,13,0,0,0,0,0,0,0,0,0,34,25,0,0,25,9,9,9,0,0,0,0,0,0,16116
4894,12442,1190,5645,3176,1846,585,750,493,409,67,80,262,84,46,21,25,0,38,6,27,5,257,191,86,2,103,66,44,35,7,2,22,0,2,20,16117
4895,1580,162,864,326,180,48,126,53,53,3,0,50,0,0,0,0,0,0,0,0,0,73,55,10,2,43,18,14,2,0,12,4,0,0,4,16120
4896,3213,473,1341,996,293,110,447,288,261,34,6,221,27,17,6,11,0,10,0,10,0,159,142,21,0,121,17,10,0,10,0,7,0,0,7,16121
4897,1653,158,664,386,298,147,92,51,45,25,0,20,6,6,6,0,0,0,0,0,0,41,41,1,0,40,0,0,0,0,0,0,0,0,0,16123
4898,1328,163,665,342,118,40,83,48,39,5,0,34,9,4,4,0,0,5,5,0,0,35,29,14,0,15,6,0,0,0,0,6,0,6,0,16124
4899,12632,1547,5948,2773,1483,881,1225,609,571,120,35,416,38,2,2,0,0,36,33,0,3,616,499,110,51,338,117,54,27,27,0,63,46,3,14,16125
4900,9336,996,3493,2120,1694,1033,2162,1270,1237,248,42,947,33,33,15,0,18,0,0,0,0,892,860,335,24,501,32,22,13,9,0,10,0,10,0,16127
4901,1447,191,798,300,127,31,113,51,49,12,0,37,2,0,0,0,0,2,2,0,0,62,42,9,2,31,20,16,3,10,3,4,0,0,4,16130
4902,512,107,225,93,58,29,67,16,3,0,0,3,13,2,2,0,0,11,11,0,0,51,44,12,5,27,7,2,0,0,2,5,0,0,5,16131
4903,279,72,119,22,66,0,0,0,0,0,0,0,0,0,0,0,0,0,0,0,0,0,0,0,0,0,0,0,0,0,0,0,0,0,0,16132
4904,1182,188,600,243,109,42,93,49,36,9,0,27,13,2,2,0,0,11,11,0,0,44,33,10,4,19,11,0,0,0,0,11,0,0,11,16133
4905,2935,451,1384,701,239,160,202,110,93,18,10,65,17,5,5,0,0,12,9,3,0,92,68,10,0,58,24,13,2,11,0,11,5,0,6,16134
4906,536,70,238,157,58,13,20,5,2,0,2,0,3,3,3,0,0,0,0,0,0,15,15,1,0,14,0,0,0,0,0,0,0,0,0,16136
4907,9429,1219,4371,2171,1147,521,573,359,259,75,18,166,100,51,34,9,8,49,3,7,39,214,153,68,7,78,61,30,13,0,17,31,16,2,13,16137
4908,125,19,69,27,0,10,24,24,24,0,0,24,0,0,0,0,0,0,0,0,0,0,0,0,0,0,0,0,0,0,0,0,0,0,0,16140
4909,1462,240,634,361,158,69,81,47,47,5,8,34,0,0,0,0,0,0,0,0,0,34,34,13,0,21,0,0,0,0,0,0,0,0,0,16141
4910,3954,676,1387,732,632,527,1022,393,320,71,4,245,73,30,18,6,6,43,26,0,17,629,578,236,4,338,51,11,11,0,0,40,10,0,30,16142
4911,2267,227,1074,543,312,111,109,90,80,0,0,80,10,0,0,0,0,10,0,0,10,19,0,0,0,0,19,9,9,0,0,10,0,0,10,16143
4912,1802,192,975,388,173,74,153,73,59,12,24,23,14,3,0,1,2,11,0,9,2,80,71,24,12,35,9,5,5,0,0,4,0,0,4,16145
4913,9371,1197,4039,2452,1158,525,668,393,270,46,53,171,123,70,37,33,0,53,0,0,53,275,206,22,16,168,69,47,38,9,0,22,0,22,0,16146
4914,12661,872,4668,3294,2521,1306,615,271,223,54,30,139,48,25,25,0,0,23,0,0,23,344,270,88,13,169,74,55,26,0,29,19,19,0,0,16148
4915,5068,489,2184,1396,680,319,348,174,161,7,44,110,13,13,0,13,0,0,0,0,0,174,154,35,58,61,20,6,1,0,5,14,3,0,11,16150
4916,52,9,23,15,3,2,3,3,2,0,0,2,1,1,1,0,0,0,0,0,0,0,0,0,0,0,0,0,0,0,0,0,0,0,0,16151
4917,1923,208,929,516,164,106,93,38,21,2,0,19,17,14,8,4,2,3,3,0,0,55,50,28,0,22,5,3,2,0,1,2,2,0,0,16153
4918,2178,248,1242,469,155,64,64,31,16,0,16,0,15,15,15,0,0,0,0,0,0,33,33,14,0,19,0,0,0,0,0,0,0,0,0,16154
4919,78,0,17,8,0,53,0,0,0,0,0,0,0,0,0,0,0,0,0,0,0,0,0,0,0,0,0,0,0,0,0,0,0,0,0,16155
4920,2145,336,889,439,314,167,133,78,73,18,0,55,5,5,5,0,0,0,0,0,0,55,53,16,6,31,2,2,2,0,0,0,0,0,0,16156
4921,2487,206,1358,640,236,47,152,46,39,8,0,31,7,7,7,0,0,0,0,0,0,106,97,4,2,91,9,9,0,6,3,0,0,0,0,16157
4922,3276,278,1601,731,490,176,168,99,91,22,28,41,8,5,0,0,5,3,3,0,0,69,53,0,0,53,16,16,16,0,0,0,0,0,0,16159
4923,657,106,338,162,39,12,34,19,19,0,5,14,0,0,0,0,0,0,0,0,0,15,15,6,0,9,0,0,0,0,0,0,0,0,0,16160
4924,542,61,287,139,42,13,11,8,8,8,0,0,0,0,0,0,0,0,0,0,0,3,3,0,0,3,0,0,0,0,0,0,0,0,0,16161
4925,13464,1537,6365,3141,1714,707,805,477,354,49,28,277,123,99,8,63,28,24,0,0,24,328,287,90,16,181,41,41,8,5,28,0,0,0,0,16201
4926,754,191,343,176,34,10,98,83,23,9,6,8,60,58,0,0,58,2,0,0,2,15,15,6,0,9,0,0,0,0,0,0,0,0,0,16210
4927,72,5,39,28,0,0,0,0,0,0,0,0,0,0,0,0,0,0,0,0,0,0,0,0,0,0,0,0,0,0,0,0,0,0,0,16211
4928,251,39,132,71,9,0,18,12,12,11,0,1,0,0,0,0,0,0,0,0,0,6,4,0,0,4,2,2,0,0,2,0,0,0,0,16212
4929,106,30,65,11,0,0,0,0,0,0,0,0,0,0,0,0,0,0,0,0,0,0,0,0,0,0,0,0,0,0,0,0,0,0,0,16213
4930,4609,446,1566,1156,856,585,1586,515,486,52,9,425,29,0,0,0,0,29,0,12,17,1071,1007,258,70,679,64,8,4,0,4,56,52,1,3,16214
4931,94,13,38,34,9,0,7,7,7,2,0,5,0,0,0,0,0,0,0,0,0,0,0,0,0,0,0,0,0,0,0,0,0,0,0,16217
4932,1116,132,601,261,65,57,59,24,15,5,0,10,9,9,0,9,0,0,0,0,0,35,32,17,3,12,3,3,3,0,0,0,0,0,0,16218
4933,1668,219,994,261,161,33,124,64,33,3,0,30,31,4,0,4,0,27,20,0,7,60,29,0,0,29,31,10,10,0,0,21,4,0,17,16222
4934,77,11,30,23,13,0,4,0,0,0,0,0,0,0,0,0,0,0,0,0,0,4,4,0,4,0,0,0,0,0,0,0,0,0,0,16223
4935,910,186,408,210,38,68,59,42,42,12,0,30,0,0,0,0,0,0,0,0,0,17,17,3,0,14,0,0,0,0,0,0,0,0,0,16224
4936,5793,514,3158,1303,635,183,372,125,97,28,4,65,28,28,0,0,28,0,0,0,0,247,237,49,62,126,10,4,0,0,4,6,0,6,0,16226
4937,316,41,168,81,24,2,8,4,4,3,1,0,0,0,0,0,0,0,0,0,0,4,4,0,0,4,0,0,0,0,0,0,0,0,0,16228
4938,3574,163,1598,1121,490,202,220,115,115,39,34,42,0,0,0,0,0,0,0,0,0,105,91,35,0,56,14,14,9,5,0,0,0,0,0,16229
4939,348,47,204,77,10,10,16,13,12,0,5,7,1,0,0,0,0,1,0,1,0,3,2,0,1,1,1,1,1,0,0,0,0,0,0,16230
4940,2945,353,1569,510,379,134,206,131,107,43,12,52,24,19,8,0,11,5,0,2,3,75,58,8,1,49,17,7,7,0,0,10,0,0,10,16232
4941,845,79,411,222,64,69,94,32,32,0,5,27,0,0,0,0,0,0,0,0,0,62,30,2,28,0,32,32,18,14,0,0,0,0,0,16233
4942,933,102,470,212,98,51,51,26,26,7,2,17,0,0,0,0,0,0,0,0,0,25,25,5,0,20,0,0,0,0,0,0,0,0,0,16235
4943,380,71,284,5,20,0,3,0,0,0,0,0,0,0,0,0,0,0,0,0,0,3,3,0,0,3,0,0,0,0,0,0,0,0,0,16236
4944,323,15,154,82,35,37,16,12,12,5,0,7,0,0,0,0,0,0,0,0,0,4,4,0,0,4,0,0,0,0,0,0,0,0,0,16238
4945,3169,734,1551,711,122,51,192,180,176,10,11,155,4,4,4,0,0,0,0,0,0,12,12,0,8,4,0,0,0,0,0,0,0,0,0,16239
4946,1072,142,622,214,60,34,49,29,26,9,0,17,3,3,3,0,0,0,0,0,0,20,19,0,0,19,1,1,1,0,0,0,0,0,0,16240
4947,3253,492,1838,504,253,166,201,88,71,18,0,53,17,12,9,0,3,5,0,0,5,113,87,27,0,60,26,16,5,0,11,10,4,0,6,16242
4948,150,30,61,33,26,0,0,0,0,0,0,0,0,0,0,0,0,0,0,0,0,0,0,0,0,0,0,0,0,0,0,0,0,0,0,16244
4949,129,12,90,27,0,0,21,16,12,5,4,3,4,4,0,4,0,0,0,0,0,5,5,0,0,5,0,0,0,0,0,0,0,0,0,16245
4950,153,25,74,31,23,0,9,6,6,0,0,6,0,0,0,0,0,0,0,0,0,3,1,0,0,1,2,0,0,0,0,2,0,0,2,16246
4951,2219,374,1135,437,186,87,151,106,80,6,3,71,26,26,17,9,0,0,0,0,0,45,38,4,7,27,7,6,2,0,4,1,0,0,1,16248
4952,1411,161,607,384,200,59,133,86,75,30,0,45,11,11,2,9,0,0,0,0,0,47,32,7,0,25,15,9,0,0,9,6,0,0,6,16249
4953,98,25,73,0,0,0,0,0,0,0,0,0,0,0,0,0,0,0,0,0,0,0,0,0,0,0,0,0,0,0,0,0,0,0,0,16250
4954,54,6,37,9,2,0,0,0,0,0,0,0,0,0,0,0,0,0,0,0,0,0,0,0,0,0,0,0,0,0,0,0,0,0,0,16253
4955,2585,229,1271,515,353,217,145,92,53,14,5,34,39,28,7,0,21,11,0,3,8,53,52,11,2,39,1,0,0,0,0,1,0,1,0,16254
4956,1313,143,676,259,159,76,37,14,14,4,2,8,0,0,0,0,0,0,0,0,0,23,17,6,0,11,6,6,2,0,4,0,0,0,0,16255
4957,911,428,331,80,45,27,132,91,49,17,1,31,42,3,3,0,0,39,31,0,8,41,15,0,0,15,26,3,3,0,0,23,0,0,23,16256
4958,1387,194,593,354,164,82,69,41,24,7,0,17,17,10,4,6,0,7,0,3,4,28,22,0,8,14,6,0,0,0,0,6,1,0,5,16258
4959,1295,156,727,285,79,48,118,64,52,23,2,27,12,10,10,0,0,2,0,2,0,54,49,2,0,47,5,0,0,0,0,5,0,0,5,16259
4960,387,59,182,99,39,8,15,0,0,0,0,0,0,0,0,0,0,0,0,0,0,15,15,15,0,0,0,0,0,0,0,0,0,0,0,16260
4961,2139,207,1107,533,215,77,118,64,58,34,0,24,6,6,0,6,0,0,0,0,0,54,54,33,12,9,0,0,0,0,0,0,0,0,0,16262
4962,265,0,135,79,45,6,8,0,0,0,0,0,0,0,0,0,0,0,0,0,0,8,0,0,0,0,8,0,0,0,0,8,0,0,8,16263
4963,10699,1102,5114,2684,1292,507,792,439,336,74,57,205,103,91,62,7,22,12,0,0,12,353,264,36,12,216,89,76,53,0,23,13,0,13,0,16301
4964,392,32,190,99,53,18,26,13,13,2,1,10,0,0,0,0,0,0,0,0,0,13,13,4,0,9,0,0,0,0,0,0,0,0,0,16311
4965,3,0,0,0,3,0,0,0,0,0,0,0,0,0,0,0,0,0,0,0,0,0,0,0,0,0,0,0,0,0,0,0,0,0,0,16312
4966,1410,194,704,343,94,75,114,51,31,0,0,31,20,19,5,0,14,1,1,0,0,63,58,13,0,45,5,3,3,0,0,2,0,0,2,16313
4967,3724,477,1899,879,290,179,303,165,137,13,2,122,28,16,9,3,4,12,5,3,4,138,114,53,8,53,24,11,7,0,4,13,3,0,10,16314
4968,4144,399,1814,937,564,430,285,138,103,50,12,41,35,35,12,14,9,0,0,0,0,147,110,43,10,57,37,32,23,0,9,5,0,0,5,16316
4969,1182,146,590,316,91,39,88,70,29,4,3,22,41,12,8,0,4,29,7,0,22,18,13,0,6,7,5,5,5,0,0,0,0,0,0,16317
4970,886,75,511,206,72,22,47,13,3,3,0,0,10,0,0,0,0,10,0,0,10,34,31,0,0,31,3,0,0,0,0,3,0,0,3,16319
4971,76,10,34,27,5,0,10,10,10,0,0,10,0,0,0,0,0,0,0,0,0,0,0,0,0,0,0,0,0,0,0,0,0,0,0,16321
4972,139,34,71,24,5,5,0,0,0,0,0,0,0,0,0,0,0,0,0,0,0,0,0,0,0,0,0,0,0,0,0,0,0,0,0,16322
4973,12006,1218,6202,2737,1216,633,690,427,368,101,49,218,59,46,41,0,5,13,8,0,5,263,249,71,47,131,14,14,0,6,8,0,0,0,0,16323
4974,285,19,102,65,56,43,7,0,0,0,0,0,0,0,0,0,0,0,0,0,0,7,3,0,0,3,4,4,4,0,0,0,0,0,0,16326
4975,2112,317,979,505,222,89,179,96,56,15,5,36,40,19,12,0,7,21,10,11,0,83,69,18,5,46,14,6,6,0,0,8,4,0,4,16327
4976,60,16,29,12,3,0,3,0,0,0,0,0,0,0,0,0,0,0,0,0,0,3,0,0,0,0,3,3,3,0,0,0,0,0,0,16328
4977,393,19,215,112,27,20,13,2,2,2,0,0,0,0,0,0,0,0,0,0,0,11,9,0,0,9,2,2,2,0,0,0,0,0,0,16329
4978,47,11,22,14,0,0,6,3,3,0,3,0,0,0,0,0,0,0,0,0,0,3,3,0,0,3,0,0,0,0,0,0,0,0,0,16331
4979,29,7,16,3,3,0,0,0,0,0,0,0,0,0,0,0,0,0,0,0,0,0,0,0,0,0,0,0,0,0,0,0,0,0,0,16332
4980,163,43,80,21,13,6,17,15,12,3,0,9,3,0,0,0,0,3,0,0,3,2,2,0,0,2,0,0,0,0,0,0,0,0,0,16333
4981,225,2,106,65,32,20,4,2,2,2,0,0,0,0,0,0,0,0,0,0,0,2,2,0,0,2,0,0,0,0,0,0,0,0,0,16334
4982,19363,1926,8274,4432,2839,1892,2149,1182,1028,192,95,741,154,84,38,16,30,70,18,43,9,967,894,406,107,381,73,21,19,0,2,52,3,44,5,16335
4983,1356,119,722,366,90,59,57,37,33,10,6,17,4,0,0,0,0,4,0,0,4,20,16,0,0,16,4,4,0,0,4,0,0,0,0,16340
4984,1456,159,764,321,150,62,127,43,39,15,3,21,4,2,2,0,0,2,0,0,2,84,52,16,16,20,32,32,26,0,6,0,0,0,0,16341
4985,1838,507,734,398,127,72,118,104,94,10,31,53,10,5,1,0,4,5,0,5,0,14,14,9,0,5,0,0,0,0,0,0,0,0,0,16342
4986,219,22,110,61,13,13,0,0,0,0,0,0,0,0,0,0,0,0,0,0,0,0,0,0,0,0,0,0,0,0,0,0,0,0,0,16343
4987,405,31,213,137,24,0,36,17,6,0,0,6,11,6,0,2,4,5,0,5,0,19,19,0,5,14,0,0,0,0,0,0,0,0,0,16344
4988,2539,154,1121,686,361,217,71,35,30,20,0,10,5,5,5,0,0,0,0,0,0,36,29,14,0,15,7,7,7,0,0,0,0,0,0,16345
4989,2527,218,1137,615,403,154,178,101,76,20,0,56,25,9,0,0,9,16,16,0,0,77,57,44,0,13,20,20,20,0,0,0,0,0,0,16346
4990,1971,273,999,448,176,75,152,85,57,13,2,42,28,28,28,0,0,0,0,0,0,67,39,7,0,32,28,28,7,0,21,0,0,0,0,16347
4991,1862,272,882,517,131,60,220,101,53,11,0,42,48,27,10,0,17,21,3,0,18,119,87,28,23,36,32,3,3,0,0,29,0,0,29,16350
4992,1171,116,621,300,67,67,71,36,27,0,0,27,9,9,5,4,0,0,0,0,0,35,32,13,0,19,3,3,3,0,0,0,0,0,0,16351
4993,160,27,100,30,0,3,13,3,3,0,0,3,0,0,0,0,0,0,0,0,0,10,10,0,10,0,0,0,0,0,0,0,0,0,0,16352
4994,2330,340,1174,522,199,95,102,64,44,9,5,30,20,20,20,0,0,0,0,0,0,38,36,4,2,30,2,2,2,0,0,0,0,0,0,16353
4995,7571,1067,3573,1738,816,377,724,357,315,43,35,237,42,34,22,10,2,8,8,0,0,367,313,118,10,185,54,54,4,34,16,0,0,0,0,16354
4996,983,118,537,196,96,36,80,42,31,8,3,20,11,11,0,1,10,0,0,0,0,38,38,6,0,32,0,0,0,0,0,0,0,0,0,16360
4997,79,5,36,23,10,5,0,0,0,0,0,0,0,0,0,0,0,0,0,0,0,0,0,0,0,0,0,0,0,0,0,0,0,0,0,16361
4998,933,104,519,207,71,32,53,12,12,0,0,12,0,0,0,0,0,0,0,0,0,41,41,19,0,22,0,0,0,0,0,0,0,0,0,16362
4999,800,93,456,144,42,65,43,25,16,8,3,5,9,5,0,5,0,4,4,0,0,18,18,3,3,12,0,0,0,0,0,0,0,0,0,16364
5000,13541,1216,5986,3252,1965,1122,927,520,447,133,22,292,73,40,30,10,0,33,24,9,0,407,303,123,30,150,104,99,61,0,38,5,0,2,3,16365
5001,217,9,125,60,5,18,66,45,45,45,0,0,0,0,0,0,0,0,0,0,0,21,0,0,0,0,21,12,12,0,0,9,0,0,9,16370
5002,2404,314,1211,545,220,114,184,100,80,14,0,66,20,20,13,7,0,0,0,0,0,84,66,27,12,27,18,15,15,0,0,3,0,3,0,16371
5003,302,52,165,53,20,12,16,10,10,0,0,10,0,0,0,0,0,0,0,0,0,6,6,0,0,6,0,0,0,0,0,0,0,0,0,16372
5004,2237,240,1125,545,246,81,252,128,105,16,0,89,23,23,7,7,9,0,0,0,0,124,103,28,8,67,21,18,14,4,0,3,0,0,3,16373
5005,1537,164,781,357,151,84,59,31,11,4,0,7,20,18,0,0,18,2,0,0,2,28,11,5,5,1,17,17,12,0,5,0,0,0,0,16374
5006,5192,802,2752,1092,347,199,234,102,61,19,0,42,41,17,5,2,10,24,18,0,6,132,121,64,0,57,11,11,4,0,7,0,0,0,0,16401
5007,603,90,287,172,35,19,64,29,29,10,0,19,0,0,0,0,0,0,0,0,0,35,31,0,0,31,4,4,0,0,4,0,0,0,0,16402
5008,4777,605,2047,1196,643,286,390,191,138,44,9,85,53,23,23,0,0,30,26,0,4,199,127,12,13,102,72,43,20,0,23,29,15,3,11,16403
5009,2120,382,1027,466,174,71,171,78,60,12,4,44,18,9,5,0,4,9,3,0,6,93,74,20,19,35,19,0,0,0,0,19,0,0,19,16404
5010,583,60,280,190,44,9,66,40,38,5,5,28,2,0,0,0,0,2,0,0,2,26,26,0,0,26,0,0,0,0,0,0,0,0,0,16405
5011,2568,439,1295,502,208,124,154,75,58,30,7,21,17,6,0,3,3,11,5,0,6,79,69,23,0,46,10,0,0,0,0,10,0,0,10,16406
5012,7517,816,3677,1965,773,286,663,357,290,77,41,172,67,64,22,0,42,3,3,0,0,306,257,92,9,156,49,18,10,3,5,31,22,9,0,16407
5013,1219,94,611,339,118,57,114,54,50,13,5,32,4,4,0,4,0,0,0,0,0,60,46,5,4,37,14,12,12,0,0,2,0,0,2,16410
5014,1135,65,643,282,103,42,46,21,6,0,0,6,15,15,15,0,0,0,0,0,0,25,25,0,0,25,0,0,0,0,0,0,0,0,0,16411
5015,6717,358,2010,1710,1511,1128,398,251,206,99,14,93,45,45,20,0,25,0,0,0,0,147,135,65,13,57,12,12,10,0,2,0,0,0,0,16412
5016,6163,405,2068,1478,1383,829,557,298,278,54,49,175,20,20,20,0,0,0,0,0,0,259,259,80,18,161,0,0,0,0,0,0,0,0,0,16415
5017,171,15,90,52,14,0,35,25,14,0,6,8,11,11,11,0,0,0,0,0,0,10,0,0,0,0,10,10,10,0,0,0,0,0,0,16416
5018,5824,474,2725,1475,697,453,489,230,229,32,1,196,1,1,0,0,1,0,0,0,0,259,193,51,25,117,66,66,48,0,18,0,0,0,0,16417
5019,428,91,213,72,19,33,10,10,10,0,0,10,0,0,0,0,0,0,0,0,0,0,0,0,0,0,0,0,0,0,0,0,0,0,0,16420
5020,1874,157,813,432,313,159,130,105,105,11,7,87,0,0,0,0,0,0,0,0,0,25,25,0,0,25,0,0,0,0,0,0,0,0,0,16421
5021,145,0,93,42,4,6,0,0,0,0,0,0,0,0,0,0,0,0,0,0,0,0,0,0,0,0,0,0,0,0,0,0,0,0,0,16422
5022,2920,336,1315,824,294,151,306,159,138,17,16,105,21,21,21,0,0,0,0,0,0,147,130,46,37,47,17,17,11,0,6,0,0,0,0,16423
5023,3151,385,1643,766,220,137,253,114,90,15,4,71,24,16,11,5,0,8,3,2,3,139,94,11,11,72,45,38,31,7,0,7,0,0,7,16424
5024,2984,208,1560,518,398,300,140,84,76,14,25,37,8,8,7,0,1,0,0,0,0,56,54,22,2,30,2,2,0,0,2,0,0,0,0,16426
5025,172,13,94,60,0,5,30,12,12,1,0,11,0,0,0,0,0,0,0,0,0,18,18,0,0,18,0,0,0,0,0,0,0,0,0,16427
5026,8330,773,3390,2081,1430,656,726,399,361,105,22,234,38,10,10,0,0,28,0,14,14,327,295,72,18,205,32,29,4,22,3,3,0,0,3,16428
5027,3750,426,1882,682,551,209,343,234,190,36,54,100,44,35,10,12,13,9,5,0,4,109,90,52,9,29,19,5,2,0,3,14,0,7,7,16433
5028,1695,513,693,319,120,50,228,102,49,9,6,34,53,12,3,0,9,41,14,3,24,126,75,33,1,41,51,11,8,0,3,40,0,0,40,16434
5029,1418,241,645,321,171,40,120,58,41,16,0,25,17,15,5,6,4,2,2,0,0,62,54,16,6,32,8,8,0,2,6,0,0,0,0,16435
5030,373,63,202,58,25,25,54,37,37,33,0,4,0,0,0,0,0,0,0,0,0,17,10,4,0,6,7,3,0,0,3,4,0,0,4,16436
5031,5309,734,2684,1086,548,257,480,270,200,67,17,116,70,47,36,9,2,23,7,0,16,210,202,45,43,114,8,4,4,0,0,4,4,0,0,16438
5032,662,59,339,126,92,46,32,16,9,2,2,5,7,2,2,0,0,5,0,2,3,16,16,6,0,10,0,0,0,0,0,0,0,0,0,16440
5033,6831,588,3254,1561,798,630,523,205,182,58,0,124,23,19,10,0,9,4,0,0,4,318,301,161,25,115,17,17,17,0,0,0,0,0,0,16441
5034,2066,208,957,540,263,98,168,89,78,28,28,22,11,2,2,0,0,9,5,0,4,79,55,9,9,37,24,19,0,3,16,5,0,0,5,16442
5035,836,143,371,164,84,74,91,72,72,0,0,72,0,0,0,0,0,0,0,0,0,19,19,0,0,19,0,0,0,0,0,0,0,0,0,16443
5036,18,0,0,5,13,0,712,299,299,43,9,247,0,0,0,0,0,0,0,0,0,413,413,116,33,264,0,0,0,0,0,0,0,0,0,16444
5037,1597,523,690,201,158,25,125,67,47,0,0,47,20,0,0,0,0,20,0,20,0,58,58,10,14,34,0,0,0,0,0,0,0,0,0,16501
5038,10205,1370,4383,2555,1391,506,838,526,461,106,70,285,65,43,5,36,2,22,0,0,22,312,242,89,36,117,70,53,19,34,0,17,0,17,0,16502
5039,9043,2610,3750,1731,659,293,846,337,277,50,31,196,60,32,10,16,6,28,11,0,17,509,438,89,69,280,71,16,6,10,0,55,14,30,11,16503
5040,11224,1039,4913,2930,1628,714,1409,689,584,163,49,372,105,103,52,51,0,2,0,0,2,720,585,273,81,231,135,89,81,8,0,46,0,0,46,16504
5041,12020,872,3480,3165,2723,1780,710,348,321,126,62,133,27,27,13,6,8,0,0,0,0,362,332,224,5,103,30,14,14,0,0,16,0,0,16,16505
5042,16507,953,5469,4114,3602,2369,1276,690,601,178,26,397,89,51,17,11,23,38,13,0,25,586,483,222,59,202,103,103,51,52,0,0,0,0,0,16506
5043,6035,1051,2707,1238,654,385,1114,548,526,58,85,383,22,15,15,0,0,7,0,7,0,566,507,152,61,294,59,59,48,0,11,0,0,0,0,16507
5044,11250,1015,4537,2636,2073,989,692,413,372,166,38,168,41,41,18,23,0,0,0,0,0,279,255,76,46,133,24,7,7,0,0,17,17,0,0,16508
5045,19780,1134,7237,5073,3728,2608,1423,648,573,165,79,329,75,75,35,20,20,0,0,0,0,775,627,247,43,337,148,85,85,0,0,63,63,0,0,16509
5046,17204,1553,7245,4516,2726,1164,1396,717,597,228,29,340,120,89,29,49,11,31,9,0,22,679,565,233,37,295,114,70,49,0,21,44,0,30,14,16510
5047,7694,658,3418,1932,1097,589,700,331,305,132,12,161,26,26,26,0,0,0,0,0,0,369,325,90,31,204,44,43,29,0,14,1,0,0,1,16511
5048,8,0,0,8,0,0,777,295,295,84,18,193,0,0,0,0,0,0,0,0,0,482,482,146,47,289,0,0,0,0,0,0,0,0,0,16546
5049,19,0,0,13,5,1,1074,561,561,108,39,414,0,0,0,0,0,0,0,0,0,513,513,120,51,342,0,0,0,0,0,0,0,0,0,16563
5050,21939,2015,11112,5155,2688,969,2889,1513,1317,332,89,896,196,158,45,38,75,38,4,8,26,1376,1274,210,64,1000,102,58,19,0,39,44,30,0,14,16601
5051,21069,1998,10395,5249,2398,1029,1175,698,471,159,108,204,227,219,140,13,66,8,8,0,0,477,440,185,53,202,37,33,33,0,0,4,4,0,0,16602
5052,1823,163,989,386,205,80,67,37,36,22,0,14,1,0,0,0,0,1,1,0,0,30,27,13,1,13,3,2,2,0,0,1,1,0,0,16611
5053,1071,96,590,248,96,41,49,28,23,2,0,21,5,5,3,2,0,0,0,0,0,21,19,4,3,12,2,2,0,2,0,0,0,0,0,16613
5054,94,23,44,14,7,6,7,4,4,4,0,0,0,0,0,0,0,0,0,0,0,3,3,0,0,3,0,0,0,0,0,0,0,0,0,16616
5055,1976,154,936,684,130,72,81,40,31,15,2,14,9,9,9,0,0,0,0,0,0,41,41,5,0,36,0,0,0,0,0,0,0,0,0,16617
5056,214,21,158,35,0,0,26,26,16,4,0,12,10,10,10,0,0,0,0,0,0,0,0,0,0,0,0,0,0,0,0,0,0,0,0,16619
5057,272,68,109,73,22,0,3,1,1,0,0,1,0,0,0,0,0,0,0,0,0,2,2,2,0,0,0,0,0,0,0,0,0,0,0,16620
5058,510,107,254,116,15,18,11,8,3,0,0,3,5,0,0,0,0,5,3,0,2,3,2,0,0,2,1,1,1,0,0,0,0,0,0,16621
5059,145,19,66,57,3,0,0,0,0,0,0,0,0,0,0,0,0,0,0,0,0,0,0,0,0,0,0,0,0,0,0,0,0,0,0,16622
5060,313,36,197,56,15,9,12,7,4,0,0,4,3,0,0,0,0,3,0,0,3,5,5,2,0,3,0,0,0,0,0,0,0,0,0,16623
5061,145,7,74,30,29,5,10,0,0,0,0,0,0,0,0,0,0,0,0,0,0,10,9,2,0,7,1,1,0,0,1,0,0,0,0,16624
5062,2684,459,1408,454,247,116,183,88,52,6,0,46,36,2,0,0,2,34,32,0,2,95,83,24,18,41,12,3,3,0,0,9,0,0,9,16625
5063,1613,200,940,371,80,22,121,75,59,10,5,44,16,3,0,0,3,13,0,0,13,46,41,9,2,30,5,5,0,1,4,0,0,0,0,16627
5064,3920,321,1838,1130,417,214,378,171,149,26,18,105,22,10,8,2,0,12,0,1,11,207,207,70,4,133,0,0,0,0,0,0,0,0,0,16630
5065,38,0,33,5,0,0,0,0,0,0,0,0,0,0,0,0,0,0,0,0,0,0,0,0,0,0,0,0,0,0,0,0,0,0,0,16631
5066,96,0,59,32,0,5,15,0,0,0,0,0,0,0,0,0,0,0,0,0,0,15,10,0,0,10,5,5,0,5,0,0,0,0,0,16633
5067,205,25,105,51,18,6,6,3,3,0,0,3,0,0,0,0,0,0,0,0,0,3,3,0,0,3,0,0,0,0,0,0,0,0,0,16634
5068,8984,849,4507,1860,1187,581,623,239,188,117,5,66,51,51,42,9,0,0,0,0,0,384,353,187,13,153,31,0,0,0,0,31,31,0,0,16635
5069,594,45,366,104,43,36,23,10,9,0,0,9,1,1,1,0,0,0,0,0,0,13,13,7,0,6,0,0,0,0,0,0,0,0,0,16636
5070,1669,158,1039,358,66,48,5,0,0,0,0,0,0,0,0,0,0,0,0,0,0,5,5,0,0,5,0,0,0,0,0,0,0,0,0,16637
5071,49,13,16,2,14,4,0,0,0,0,0,0,0,0,0,0,0,0,0,0,0,0,0,0,0,0,0,0,0,0,0,0,0,0,0,16638
5072,1106,149,652,260,40,5,64,34,34,0,0,34,0,0,0,0,0,0,0,0,0,30,30,0,0,30,0,0,0,0,0,0,0,0,0,16639
5073,650,47,341,162,71,29,34,31,28,3,6,19,3,3,3,0,0,0,0,0,0,3,3,3,0,0,0,0,0,0,0,0,0,0,0,16640
5074,1784,170,1042,383,141,48,108,53,44,9,8,27,9,9,9,0,0,0,0,0,0,55,40,13,0,27,15,15,11,2,2,0,0,0,0,16641
5075,115,22,61,27,4,1,0,0,0,0,0,0,0,0,0,0,0,0,0,0,0,0,0,0,0,0,0,0,0,0,0,0,0,0,0,16645
5076,1826,152,910,459,227,78,129,55,55,15,0,40,0,0,0,0,0,0,0,0,0,74,69,8,0,61,5,5,3,0,2,0,0,0,0,16646
5077,476,26,267,82,69,32,17,16,16,4,0,12,0,0,0,0,0,0,0,0,0,1,1,1,0,0,0,0,0,0,0,0,0,0,0,16647
5078,11349,856,4420,2292,2161,1620,469,296,200,35,15,150,96,15,15,0,0,81,0,63,18,173,146,60,21,65,27,27,27,0,0,0,0,0,0,16648
5079,1435,228,841,219,91,56,130,84,62,0,22,40,22,17,8,9,0,5,5,0,0,46,25,0,8,17,21,16,0,16,0,5,0,2,3,16650
5080,4417,842,2371,876,277,51,199,86,38,4,3,31,48,41,11,6,24,7,0,0,7,113,90,28,0,62,23,15,0,15,0,8,0,0,8,16651
5081,13139,1374,6685,3070,1181,829,1289,604,560,73,62,425,44,27,18,9,0,17,5,0,12,685,647,200,10,437,38,36,21,4,11,2,0,0,2,16652
5082,1117,164,605,211,98,39,67,37,32,5,0,27,5,5,5,0,0,0,0,0,0,30,27,4,0,23,3,3,3,0,0,0,0,0,0,16655
5083,1127,133,706,215,55,18,80,45,35,1,2,32,10,10,0,4,6,0,0,0,0,35,35,0,0,35,0,0,0,0,0,0,0,0,0,16656
5084,935,89,495,218,86,47,107,64,61,11,0,50,3,3,3,0,0,0,0,0,0,43,31,5,2,24,12,0,0,0,0,12,3,9,0,16657
5085,224,24,127,56,11,6,9,6,3,0,0,3,3,0,0,0,0,3,3,0,0,3,3,0,0,3,0,0,0,0,0,0,0,0,0,16659
5086,638,96,318,175,36,13,51,32,24,8,0,16,8,7,0,7,0,1,0,1,0,19,11,0,0,11,8,4,4,0,0,4,0,0,4,16661
5087,4415,512,2263,886,481,273,279,138,103,38,20,45,35,32,27,5,0,3,3,0,0,141,100,40,5,55,41,23,23,0,0,18,2,0,16,16662
5088,1249,184,638,262,114,51,97,54,46,5,6,35,8,5,5,0,0,3,3,0,0,43,31,4,5,22,12,7,5,0,2,5,0,0,5,16664
5089,213,31,89,66,24,3,6,1,1,1,0,0,0,0,0,0,0,0,0,0,0,5,5,1,0,4,0,0,0,0,0,0,0,0,0,16665
5090,2424,337,1337,559,104,87,106,52,39,3,11,25,13,11,11,0,0,2,0,2,0,54,54,27,14,13,0,0,0,0,0,0,0,0,0,16666
5091,1118,139,632,239,80,28,50,14,14,3,1,10,0,0,0,0,0,0,0,0,0,36,29,25,0,4,7,7,4,0,3,0,0,0,0,16667
5092,2595,271,1389,597,245,93,148,79,77,9,1,67,2,1,1,0,0,1,0,0,1,69,69,10,0,59,0,0,0,0,0,0,0,0,0,16668
5093,1606,225,767,355,158,101,85,49,36,4,4,28,13,6,1,2,3,7,1,6,0,36,31,2,8,21,5,4,2,2,0,1,0,1,0,16669
5094,28,4,16,4,4,0,0,0,0,0,0,0,0,0,0,0,0,0,0,0,0,0,0,0,0,0,0,0,0,0,0,0,0,0,0,16670
5095,422,68,201,111,27,15,30,24,23,0,1,22,1,1,0,1,0,0,0,0,0,6,3,0,0,3,3,3,0,0,3,0,0,0,0,16671
5096,194,66,105,14,9,0,19,9,9,0,0,9,0,0,0,0,0,0,0,0,0,10,10,0,0,10,0,0,0,0,0,0,0,0,0,16672
5097,3714,295,2036,872,405,106,213,152,135,54,0,81,17,17,3,7,7,0,0,0,0,61,57,11,5,41,4,4,2,2,0,0,0,0,0,16673
5098,401,87,232,53,13,16,33,13,2,0,0,2,11,11,0,2,9,0,0,0,0,20,20,10,2,8,0,0,0,0,0,0,0,0,0,16674
5099,126,28,88,10,0,0,0,0,0,0,0,0,0,0,0,0,0,0,0,0,0,0,0,0,0,0,0,0,0,0,0,0,0,0,0,16677
5100,1990,316,1007,374,210,83,116,71,67,6,9,52,4,1,1,0,0,3,3,0,0,45,38,0,5,33,7,3,0,0,3,4,0,0,4,16678
5101,657,123,351,155,21,7,13,6,6,0,1,5,0,0,0,0,0,0,0,0,0,7,7,5,0,2,0,0,0,0,0,0,0,0,0,16679
5102,265,27,134,70,20,14,9,6,6,0,0,6,0,0,0,0,0,0,0,0,0,3,3,3,0,0,0,0,0,0,0,0,0,0,0,16680
5103,126,0,115,11,0,0,14,14,14,0,0,14,0,0,0,0,0,0,0,0,0,0,0,0,0,0,0,0,0,0,0,0,0,0,0,16682
5104,327,14,131,95,55,32,20,9,9,4,0,5,0,0,0,0,0,0,0,0,0,11,11,6,0,5,0,0,0,0,0,0,0,0,0,16683
5105,264,37,88,124,5,10,11,4,4,4,0,0,0,0,0,0,0,0,0,0,0,7,7,7,0,0,0,0,0,0,0,0,0,0,0,16685
5106,9171,669,4535,2373,1135,459,641,254,218,12,11,195,36,25,21,0,4,11,0,0,11,387,313,109,16,188,74,19,13,6,0,55,8,28,19,16686
5107,401,67,215,67,29,23,23,6,6,0,0,6,0,0,0,0,0,0,0,0,0,17,15,15,0,0,2,2,2,0,0,0,0,0,0,16689
5108,255,29,153,47,11,15,12,6,6,0,6,0,0,0,0,0,0,0,0,0,0,6,6,2,0,4,0,0,0,0,0,0,0,0,0,16691
5109,523,59,282,135,38,9,41,30,24,0,10,14,6,5,1,1,3,1,0,1,0,11,11,0,0,11,0,0,0,0,0,0,0,0,0,16692
5110,2953,360,1677,581,245,90,253,146,117,53,5,59,29,13,8,2,3,16,6,0,10,107,82,9,2,71,25,12,10,2,0,13,8,5,0,16693
5111,161,29,103,23,2,4,4,3,0,0,0,0,3,3,3,0,0,0,0,0,0,1,0,0,0,0,1,1,0,1,0,0,0,0,0,16694
5112,737,77,374,203,54,29,88,36,28,9,2,17,8,2,0,2,0,6,4,0,2,52,20,1,0,19,32,1,1,0,0,31,15,0,16,16695
5113,697,211,277,136,50,23,0,0,0,0,0,0,0,0,0,0,0,0,0,0,0,0,0,0,0,0,0,0,0,0,0,0,0,0,0,16699
5114,11826,1251,5738,2730,1254,853,1240,681,598,152,48,398,83,62,21,41,0,21,0,21,0,559,471,186,60,225,88,88,47,27,14,0,0,0,0,16701
5115,955,117,580,161,78,19,74,27,20,0,0,20,7,7,2,5,0,0,0,0,0,47,44,6,5,33,3,3,0,3,0,0,0,0,0,16720
5116,88,12,28,41,7,0,0,0,0,0,0,0,0,0,0,0,0,0,0,0,0,0,0,0,0,0,0,0,0,0,0,0,0,0,0,16724
5117,50,17,33,0,0,0,5,5,5,0,0,5,0,0,0,0,0,0,0,0,0,0,0,0,0,0,0,0,0,0,0,0,0,0,0,16725
5118,407,38,226,127,16,0,16,6,6,0,6,0,0,0,0,0,0,0,0,0,0,10,10,0,0,10,0,0,0,0,0,0,0,0,0,16726
5119,167,9,66,42,11,39,3,0,0,0,0,0,0,0,0,0,0,0,0,0,0,3,0,0,0,0,3,3,0,3,0,0,0,0,0,16727
5120,19,4,10,5,0,0,4,0,0,0,0,0,0,0,0,0,0,0,0,0,0,4,4,0,0,4,0,0,0,0,0,0,0,0,0,16728
5121,495,41,246,145,40,23,30,0,0,0,0,0,0,0,0,0,0,0,0,0,0,30,27,15,3,9,3,0,0,0,0,3,0,0,3,16729
5122,47,5,34,8,0,0,0,0,0,0,0,0,0,0,0,0,0,0,0,0,0,0,0,0,0,0,0,0,0,0,0,0,0,0,0,16730
5123,1987,234,1009,504,152,88,149,70,59,9,20,30,11,11,0,6,5,0,0,0,0,79,79,16,20,43,0,0,0,0,0,0,0,0,0,16731
5124,249,45,118,61,10,15,16,16,16,0,0,16,0,0,0,0,0,0,0,0,0,0,0,0,0,0,0,0,0,0,0,0,0,0,0,16732
5125,96,12,41,43,0,0,0,0,0,0,0,0,0,0,0,0,0,0,0,0,0,0,0,0,0,0,0,0,0,0,0,0,0,0,0,16733
5126,190,24,123,36,7,0,27,6,6,0,0,6,0,0,0,0,0,0,0,0,0,21,21,2,0,19,0,0,0,0,0,0,0,0,0,16734
5127,4477,518,2185,1111,453,210,301,196,155,13,10,132,41,41,18,5,18,0,0,0,0,105,77,32,7,38,28,17,11,6,0,11,0,0,11,16735
5128,2288,294,1016,794,136,48,80,50,43,12,0,31,7,7,0,7,0,0,0,0,0,30,29,6,0,23,1,1,0,1,0,0,0,0,0,16738
5129,738,61,367,188,78,44,69,47,36,10,0,26,11,11,11,0,0,0,0,0,0,22,19,16,0,3,3,3,3,0,0,0,0,0,0,16740
5130,2767,241,1372,679,277,198,259,147,130,14,15,101,17,17,9,0,8,0,0,0,0,112,91,0,2,89,21,19,17,0,2,2,0,0,2,16743
5131,339,28,268,22,0,21,44,0,0,0,0,0,0,0,0,0,0,0,0,0,0,44,31,0,0,31,13,13,13,0,0,0,0,0,0,16744
5132,395,67,206,73,38,11,22,8,8,0,0,8,0,0,0,0,0,0,0,0,0,14,14,0,0,14,0,0,0,0,0,0,0,0,0,16745
5133,955,73,548,254,50,30,77,40,35,5,0,30,5,5,5,0,0,0,0,0,0,37,33,7,0,26,4,0,0,0,0,4,0,0,4,16746
5134,1957,214,1085,423,143,92,188,87,71,7,0,64,16,16,9,0,7,0,0,0,0,101,95,16,2,77,6,6,2,1,3,0,0,0,0,16748
5135,3198,276,1557,885,280,200,184,97,90,31,9,50,7,3,0,3,0,4,0,0,4,87,79,13,4,62,8,5,0,0,5,3,3,0,0,16749
5136,234,11,106,66,21,30,14,7,7,0,0,7,0,0,0,0,0,0,0,0,0,7,6,4,0,2,1,1,1,0,0,0,0,0,0,16750
5137,20000,789,3691,3542,5332,6646,3462,1669,1592,250,35,1307,77,60,48,12,0,17,16,0,1,1793,1704,423,24,1257,89,89,43,46,0,0,0,0,0,16801
5138,0,0,0,0,0,0,9928,4640,4640,458,159,4023,0,0,0,0,0,0,0,0,0,5288,5288,778,167,4343,0,0,0,0,0,0,0,0,0,16802
5139,13958,651,1803,2077,4319,5108,1158,629,495,51,0,444,134,57,0,57,0,77,77,0,0,529,529,186,36,307,0,0,0,0,0,0,0,0,0,16803
5140,823,129,394,145,91,64,79,38,15,0,0,15,23,15,15,0,0,8,4,0,4,41,14,3,0,11,27,14,3,11,0,13,5,0,8,16820
5141,198,12,125,26,24,11,9,0,0,0,0,0,0,0,0,0,0,0,0,0,0,9,9,0,0,9,0,0,0,0,0,0,0,0,0,16821
5142,1378,216,741,243,113,65,118,65,54,19,4,31,11,9,0,9,0,2,0,0,2,53,27,8,2,17,26,26,0,0,26,0,0,0,0,16822
5143,19671,1851,8378,4756,3177,1509,1092,708,552,185,53,314,156,136,125,0,11,20,16,0,4,384,288,57,39,192,96,72,45,19,8,24,0,0,24,16823
5144,94,1,73,13,7,0,0,0,0,0,0,0,0,0,0,0,0,0,0,0,0,0,0,0,0,0,0,0,0,0,0,0,0,0,0,16825
5145,404,91,187,86,26,14,15,0,0,0,0,0,0,0,0,0,0,0,0,0,0,15,4,0,4,0,11,11,0,11,0,0,0,0,0,16826
5146,2685,94,497,480,889,725,166,111,100,15,0,85,11,0,0,0,0,11,0,0,11,55,55,22,0,33,0,0,0,0,0,0,0,0,0,16827
5147,3325,381,1306,694,636,308,318,127,103,22,0,81,24,24,24,0,0,0,0,0,0,191,191,96,0,95,0,0,0,0,0,0,0,0,0,16828
5148,467,54,294,100,15,4,44,30,20,0,4,16,10,10,5,0,5,0,0,0,0,14,14,0,3,11,0,0,0,0,0,0,0,0,0,16829
5149,10072,1263,4446,2620,1209,534,483,270,226,82,10,134,44,27,5,22,0,17,10,0,7,213,194,70,41,83,19,9,9,0,0,10,10,0,0,16830
5150,276,56,128,44,39,9,11,9,9,0,0,9,0,0,0,0,0,0,0,0,0,2,2,0,0,2,0,0,0,0,0,0,0,0,0,16832
5151,4015,472,2125,913,376,129,288,128,115,8,2,105,13,9,3,0,6,4,0,0,4,160,149,31,11,107,11,2,2,0,0,9,0,1,8,16833
5152,145,33,69,35,8,0,6,6,6,0,0,6,0,0,0,0,0,0,0,0,0,0,0,0,0,0,0,0,0,0,0,0,0,0,0,16834
5153,159,15,97,26,8,13,2,1,0,0,0,0,1,1,0,1,0,0,0,0,0,1,1,0,0,1,0,0,0,0,0,0,0,0,0,16835
5154,806,100,508,161,28,9,62,40,40,3,6,31,0,0,0,0,0,0,0,0,0,22,20,13,0,7,2,2,0,0,2,0,0,0,0,16836
5155,106,27,71,0,8,0,0,0,0,0,0,0,0,0,0,0,0,0,0,0,0,0,0,0,0,0,0,0,0,0,0,0,0,0,0,16837
5156,1233,137,648,285,111,52,78,36,28,3,1,24,8,8,6,0,2,0,0,0,0,42,36,9,0,27,6,6,3,0,3,0,0,0,0,16838
5157,324,42,185,76,17,4,35,23,23,0,6,17,0,0,0,0,0,0,0,0,0,12,7,7,0,0,5,5,0,5,0,0,0,0,0,16839
5158,349,85,169,77,18,0,95,64,64,28,0,36,0,0,0,0,0,0,0,0,0,31,31,0,0,31,0,0,0,0,0,0,0,0,0,16840
5159,4048,527,2055,830,347,289,271,98,77,0,7,70,21,12,0,12,0,9,9,0,0,173,136,56,0,80,37,10,10,0,0,27,0,3,24,16841
5160,258,58,127,73,0,0,49,49,22,22,0,0,27,27,0,27,0,0,0,0,0,0,0,0,0,0,0,0,0,0,0,0,0,0,0,16843
5161,2137,126,1109,464,267,171,164,139,122,49,0,73,17,17,17,0,0,0,0,0,0,25,19,8,4,7,6,6,6,0,0,0,0,0,0,16844
5162,857,131,454,204,60,8,94,49,30,0,4,26,19,15,5,0,10,4,4,0,0,45,15,3,0,12,30,30,2,1,27,0,0,0,0,16845
5163,293,82,157,37,17,0,4,0,0,0,0,0,0,0,0,0,0,0,0,0,0,4,4,0,0,4,0,0,0,0,0,0,0,0,0,16847
5164,311,51,144,80,27,9,8,8,2,2,0,0,6,0,0,0,0,6,6,0,0,0,0,0,0,0,0,0,0,0,0,0,0,0,0,16848
5165,254,0,130,43,61,20,9,0,0,0,0,0,0,0,0,0,0,0,0,0,0,9,9,0,0,9,0,0,0,0,0,0,0,0,0,16849
5166,511,48,89,155,143,76,241,154,129,79,0,50,25,25,25,0,0,0,0,0,0,87,87,71,0,16,0,0,0,0,0,0,0,0,0,16851
5167,211,48,95,29,36,3,45,18,14,0,11,3,4,0,0,0,0,4,4,0,0,27,18,11,0,7,9,0,0,0,0,9,9,0,0,16852
5168,111,9,76,13,13,0,21,0,0,0,0,0,0,0,0,0,0,0,0,0,0,21,21,11,10,0,0,0,0,0,0,0,0,0,0,16853
5169,600,57,251,161,96,35,68,30,25,14,0,11,5,0,0,0,0,5,5,0,0,38,31,6,0,25,7,7,7,0,0,0,0,0,0,16854
5170,215,29,177,9,0,0,39,0,0,0,0,0,0,0,0,0,0,0,0,0,0,39,39,39,0,0,0,0,0,0,0,0,0,0,0,16855
5171,2895,419,1671,544,210,51,157,78,58,2,2,54,20,20,12,0,8,0,0,0,0,79,48,22,0,26,31,22,3,17,2,9,9,0,0,16858
5172,379,41,209,78,36,15,14,5,5,0,0,5,0,0,0,0,0,0,0,0,0,9,0,0,0,0,9,0,0,0,0,9,9,0,0,16859
5173,239,7,85,51,82,14,28,4,4,2,0,2,0,0,0,0,0,0,0,0,0,24,24,0,0,24,0,0,0,0,0,0,0,0,0,16860
5174,220,52,126,34,5,3,5,0,0,0,0,0,0,0,0,0,0,0,0,0,0,5,5,2,0,3,0,0,0,0,0,0,0,0,0,16861
5175,527,88,302,112,24,1,33,8,8,2,0,6,0,0,0,0,0,0,0,0,0,25,20,20,0,0,5,5,2,3,0,0,0,0,0,16863
5176,1473,56,500,170,382,365,129,60,39,0,13,26,21,21,0,0,21,0,0,0,0,69,48,1,0,47,21,21,21,0,0,0,0,0,0,16865
5177,7529,952,3795,1898,577,307,366,130,112,38,10,64,18,18,0,18,0,0,0,0,0,236,224,97,8,119,12,10,0,0,10,2,0,0,2,16866
5178,357,0,193,164,0,0,0,0,0,0,0,0,0,0,0,0,0,0,0,0,0,0,0,0,0,0,0,0,0,0,0,0,0,0,0,16868
5179,4420,120,1478,792,1066,964,360,219,183,64,5,114,36,36,13,0,23,0,0,0,0,141,131,78,3,50,10,10,7,0,3,0,0,0,0,16870
5180,27,13,14,0,0,0,0,0,0,0,0,0,0,0,0,0,0,0,0,0,0,0,0,0,0,0,0,0,0,0,0,0,0,0,0,16871
5181,841,175,459,127,47,33,83,32,19,4,0,15,13,4,4,0,0,9,0,0,9,51,23,11,0,12,28,10,0,10,0,18,15,0,3,16872
5182,941,114,536,207,64,20,88,62,50,21,0,29,12,12,12,0,0,0,0,0,0,26,22,7,0,15,4,4,4,0,0,0,0,0,0,16874
5183,2840,296,1371,462,438,273,198,115,105,14,0,91,10,10,0,5,5,0,0,0,0,83,66,28,0,38,17,17,6,5,6,0,0,0,0,16875
5184,260,43,172,38,7,0,8,0,0,0,0,0,0,0,0,0,0,0,0,0,0,8,8,0,4,4,0,0,0,0,0,0,0,0,0,16876
5185,1290,65,550,318,223,134,55,39,38,11,15,12,1,1,1,0,0,0,0,0,0,16,14,6,0,8,2,2,2,0,0,0,0,0,0,16877
5186,1231,191,673,259,96,12,86,27,21,10,0,11,6,6,6,0,0,0,0,0,0,59,41,9,0,32,18,18,18,0,0,0,0,0,0,16878
5187,306,21,200,43,30,12,35,16,11,6,0,5,5,5,0,5,0,0,0,0,0,19,14,0,0,14,5,5,0,5,0,0,0,0,0,16879
5188,1364,212,741,335,44,32,148,39,39,3,0,36,0,0,0,0,0,0,0,0,0,109,62,0,0,62,47,47,20,27,0,0,0,0,0,16881
5189,193,40,76,42,32,3,13,7,0,0,0,0,7,4,4,0,0,3,3,0,0,6,0,0,0,0,6,0,0,0,0,6,6,0,0,16882
5190,7793,654,3215,1935,1177,812,388,241,220,52,22,146,21,13,13,0,0,8,2,0,6,147,137,34,30,73,10,9,0,0,9,1,1,0,0,16901
5191,275,43,133,48,37,14,19,10,10,0,5,5,0,0,0,0,0,0,0,0,0,9,9,3,0,6,0,0,0,0,0,0,0,0,0,16911
5192,1208,154,519,306,169,60,145,72,54,5,0,49,18,14,11,0,3,4,0,0,4,73,65,13,4,48,8,8,8,0,0,0,0,0,0,16912
5193,1507,191,743,344,151,78,110,47,40,6,12,22,7,3,0,0,3,4,0,0,4,63,60,3,2,55,3,3,3,0,0,0,0,0,0,16914
5194,4245,377,1871,1005,591,401,260,156,134,24,13,97,22,22,19,0,3,0,0,0,0,104,102,36,10,56,2,2,2,0,0,0,0,0,0,16915
5195,947,134,440,271,75,27,100,54,47,30,0,17,7,3,3,0,0,4,4,0,0,46,42,2,0,40,4,4,2,0,2,0,0,0,0,16917
5196,1482,168,673,481,118,42,148,83,58,2,13,43,25,4,0,0,4,21,9,7,5,65,59,12,0,47,6,6,6,0,0,0,0,0,0,16920
5197,463,76,220,130,24,13,20,16,16,7,4,5,0,0,0,0,0,0,0,0,0,4,4,0,0,4,0,0,0,0,0,0,0,0,0,16921
5198,1463,210,738,353,110,52,103,34,34,11,0,23,0,0,0,0,0,0,0,0,0,69,50,3,3,44,19,15,11,4,0,4,4,0,0,16922
5199,996,159,490,249,60,38,90,40,18,0,0,18,22,22,16,3,3,0,0,0,0,50,33,6,0,27,17,10,4,2,4,7,0,3,4,16923
5200,2290,310,1183,532,152,113,157,82,61,10,11,40,21,9,9,0,0,12,0,0,12,75,59,16,0,43,16,16,4,12,0,0,0,0,0,16925
5201,475,70,222,94,55,34,29,23,19,0,0,19,4,4,0,4,0,0,0,0,0,6,6,1,0,5,0,0,0,0,0,0,0,0,0,16926
5202,476,70,256,120,10,20,73,40,28,0,3,25,12,9,6,3,0,3,0,0,3,33,30,2,0,28,3,3,3,0,0,0,0,0,0,16927
5203,947,100,417,312,68,50,48,27,27,7,0,20,0,0,0,0,0,0,0,0,0,21,21,8,2,11,0,0,0,0,0,0,0,0,0,16928
5204,1560,183,664,443,160,110,106,43,35,4,8,23,8,8,5,3,0,0,0,0,0,63,52,2,2,48,11,4,0,2,2,7,0,0,7,16929
5205,873,59,392,229,104,89,56,27,23,7,0,16,4,4,3,0,1,0,0,0,0,29,27,13,4,10,2,2,0,0,2,0,0,0,0,16930
5206,433,38,236,98,34,27,45,15,9,2,4,3,6,6,3,3,0,0,0,0,0,30,30,7,2,21,0,0,0,0,0,0,0,0,0,16932
5207,4317,380,1648,963,714,612,1154,441,440,56,113,271,1,0,0,0,0,1,0,0,1,713,706,228,63,415,7,7,7,0,0,0,0,0,0,16933
5208,921,114,418,230,108,51,75,34,32,6,0,26,2,2,2,0,0,0,0,0,0,41,34,7,2,25,7,7,0,6,1,0,0,0,0,16935
5209,1515,220,695,439,111,50,98,55,47,11,12,24,8,8,8,0,0,0,0,0,0,43,41,9,10,22,2,2,0,0,2,0,0,0,0,16936
5210,169,12,115,34,6,2,25,20,9,0,0,9,11,11,11,0,0,0,0,0,0,5,5,0,0,5,0,0,0,0,0,0,0,0,0,16937
5211,537,66,211,162,64,34,30,17,12,7,2,3,5,0,0,0,0,5,4,0,1,13,2,0,2,0,11,1,0,0,1,10,4,6,0,16938
5212,248,58,122,50,9,9,9,3,3,1,0,2,0,0,0,0,0,0,0,0,0,6,6,1,0,5,0,0,0,0,0,0,0,0,0,16939
5213,251,30,102,79,32,8,29,12,12,7,0,5,0,0,0,0,0,0,0,0,0,17,14,4,0,10,3,3,0,0,3,0,0,0,0,16940
5214,89,0,40,37,12,0,3,2,2,0,0,2,0,0,0,0,0,0,0,0,0,1,1,0,0,1,0,0,0,0,0,0,0,0,0,16941
5215,480,85,227,126,29,13,28,19,10,2,0,8,9,9,9,0,0,0,0,0,0,9,9,1,0,8,0,0,0,0,0,0,0,0,0,16942
5216,360,80,204,57,11,8,15,8,3,1,0,2,5,5,5,0,0,0,0,0,0,7,7,4,2,1,0,0,0,0,0,0,0,0,0,16943
5217,1589,281,777,339,139,53,111,64,55,10,7,38,9,9,9,0,0,0,0,0,0,47,30,19,3,8,17,17,16,1,0,0,0,0,0,16946
5218,3837,477,1847,869,414,230,266,151,133,39,3,91,18,14,6,0,8,4,0,1,3,115,92,19,6,67,23,4,4,0,0,19,15,0,4,16947
5219,1178,178,618,270,62,50,65,41,32,3,0,29,9,3,3,0,0,6,6,0,0,24,22,5,0,17,2,0,0,0,0,2,0,0,2,16948
5220,2488,457,1242,551,171,67,143,75,59,13,2,44,16,11,7,0,4,5,0,2,3,68,61,0,0,61,7,5,0,4,1,2,0,2,0,16950
5221,373,124,184,40,25,0,22,8,6,2,0,4,2,0,0,0,0,2,2,0,0,14,9,0,3,6,5,0,0,0,0,5,2,0,3,17002
5222,7434,826,3381,1642,1114,471,1098,563,522,99,40,383,41,10,6,4,0,31,15,12,4,535,511,208,0,303,24,8,6,0,2,16,3,9,4,17003
5223,3010,1059,1064,563,212,112,273,161,40,0,8,32,121,19,19,0,0,102,38,3,61,112,28,0,0,28,84,15,15,0,0,69,27,0,42,17004
5224,303,51,178,50,14,10,20,16,11,1,0,10,5,5,5,0,0,0,0,0,0,4,0,0,0,0,4,4,4,0,0,0,0,0,0,17005
5225,607,149,307,126,14,11,59,28,12,2,0,10,16,2,2,0,0,14,5,0,9,31,12,3,3,6,19,5,5,0,0,14,14,0,0,17006
5226,3988,307,1134,980,1124,443,405,153,143,42,43,58,10,0,0,0,0,10,10,0,0,252,252,72,61,119,0,0,0,0,0,0,0,0,0,17007
5227,1472,209,875,220,140,28,52,34,34,0,0,34,0,0,0,0,0,0,0,0,0,18,18,5,0,13,0,0,0,0,0,0,0,0,0,17009
5228,0,0,0,0,0,0,0,0,0,0,0,0,0,0,0,0,0,0,0,0,0,0,0,0,0,0,0,0,0,0,0,0,0,0,0,17010
5229,26325,2011,7641,6468,6067,4138,1372,821,724,289,16,419,97,85,33,6,46,12,3,0,9,551,527,301,53,173,24,18,15,3,0,6,6,0,0,17011
5230,22859,2388,8538,5348,3693,2892,2287,1068,1001,305,81,615,67,34,29,0,5,33,0,0,33,1219,1142,514,65,563,77,76,59,16,1,1,0,0,1,17013
5231,15440,1238,6111,3566,2672,1853,1021,511,447,188,21,238,64,45,27,0,18,19,4,0,15,510,436,176,28,232,74,48,4,25,19,26,17,0,9,17015
5232,522,20,312,43,26,121,22,12,0,0,0,0,12,12,12,0,0,0,0,0,0,10,10,0,0,10,0,0,0,0,0,0,0,0,0,17016
5233,1344,217,746,220,96,65,82,38,38,0,3,35,0,0,0,0,0,0,0,0,0,44,30,9,0,21,14,6,6,0,0,8,0,8,0,17017
5234,3176,307,1378,783,391,317,83,33,30,28,1,1,3,3,3,0,0,0,0,0,0,50,50,32,12,6,0,0,0,0,0,0,0,0,0,17018
5235,12638,920,4584,3247,2573,1314,970,372,332,127,12,193,40,35,35,0,0,5,0,0,5,598,521,248,29,244,77,61,61,0,0,16,0,11,5,17019
5236,6676,748,3097,1865,679,287,461,255,215,74,10,131,40,36,23,0,13,4,0,3,1,206,138,43,19,76,68,62,43,0,19,6,0,0,6,17020
5237,717,160,432,90,21,14,14,4,0,0,0,0,4,0,0,0,0,4,0,0,4,10,7,0,0,7,3,3,3,0,0,0,0,0,0,17021
5238,18862,1878,7061,4332,3789,1802,2356,1023,981,366,115,500,42,31,22,0,9,11,0,0,11,1333,1240,457,37,746,93,85,76,9,0,8,0,0,8,17022
5239,2381,292,1157,565,247,120,159,109,87,12,14,61,22,12,3,9,0,10,10,0,0,50,47,17,7,23,3,3,3,0,0,0,0,0,0,17023
5240,1362,194,645,304,153,66,92,30,27,0,0,27,3,3,3,0,0,0,0,0,0,62,44,18,0,26,18,0,0,0,0,18,18,0,0,17024
5241,11416,922,4046,3228,2052,1168,622,312,226,56,46,124,86,43,43,0,0,43,43,0,0,310,250,82,9,159,60,60,52,8,0,0,0,0,0,17025
5242,2762,336,1464,629,209,124,122,53,53,44,9,0,0,0,0,0,0,0,0,0,0,69,56,32,0,24,13,0,0,0,0,13,0,0,13,17026
5243,351,0,35,55,150,111,894,388,388,148,53,187,0,0,0,0,0,0,0,0,0,506,506,235,46,225,0,0,0,0,0,0,0,0,0,17027
5244,2317,191,1224,610,167,125,170,150,125,23,0,102,25,25,13,0,12,0,0,0,0,20,20,13,0,7,0,0,0,0,0,0,0,0,0,17028
5245,431,10,304,117,0,0,0,0,0,0,0,0,0,0,0,0,0,0,0,0,0,0,0,0,0,0,0,0,0,0,0,0,0,0,0,17029
5246,584,98,330,114,26,16,34,14,10,0,0,10,4,0,0,0,0,4,4,0,0,20,20,0,0,20,0,0,0,0,0,0,0,0,0,17030
5247,5977,849,2972,1335,590,231,478,249,198,91,22,85,51,51,21,22,8,0,0,0,0,229,187,36,33,118,42,21,12,9,0,21,10,0,11,17032
5248,12063,877,3287,2346,2858,2695,728,416,391,70,41,280,25,25,21,0,4,0,0,0,0,312,279,110,34,135,33,32,10,0,22,1,0,0,1,17033
5249,1703,267,650,527,187,72,96,32,26,0,0,26,6,6,6,0,0,0,0,0,0,64,0,0,0,0,64,64,64,0,0,0,0,0,0,17034
5250,515,107,328,66,14,0,42,32,29,0,0,29,3,3,3,0,0,0,0,0,0,10,4,0,0,4,6,0,0,0,0,6,0,6,0,17035
5251,15080,639,3902,3467,3562,3510,1091,464,404,134,17,253,60,48,36,0,12,12,0,0,12,627,585,135,73,377,42,42,42,0,0,0,0,0,0,17036
5252,595,113,300,103,46,33,93,54,19,6,0,13,35,20,13,2,5,15,6,0,9,39,19,4,0,15,20,6,0,6,0,14,12,2,0,17037
5253,5604,754,2656,1625,436,133,564,304,230,90,9,131,74,62,51,8,3,12,12,0,0,260,217,89,25,103,43,30,17,0,13,13,13,0,0,17038
5254,18,0,10,0,8,0,8,0,0,0,0,0,0,0,0,0,0,0,0,0,0,8,8,0,8,0,0,0,0,0,0,0,0,0,0,17039
5255,1695,260,780,387,184,84,112,55,30,4,0,26,25,3,3,0,0,22,22,0,0,57,50,14,3,33,7,7,3,0,4,0,0,0,0,17040
5256,155,52,86,17,0,0,28,0,0,0,0,0,0,0,0,0,0,0,0,0,0,28,28,0,0,28,0,0,0,0,0,0,0,0,0,17041
5257,26236,3116,10858,5951,3860,2451,1805,886,738,179,115,444,148,90,42,18,30,58,28,0,30,919,767,304,31,432,152,47,46,0,1,105,24,16,65,17042
5258,4406,246,1658,1427,670,405,179,140,72,64,0,8,68,56,16,0,40,12,12,0,0,39,23,0,14,9,16,16,16,0,0,0,0,0,0,17043
5259,15095,2185,7645,3455,1212,598,964,489,354,41,42,271,135,60,55,0,5,75,19,47,9,475,431,27,161,243,44,35,25,1,9,9,0,0,9,17044
5260,2307,381,1129,519,177,101,115,55,48,9,6,33,7,0,0,0,0,7,4,0,3,60,57,9,0,48,3,3,3,0,0,0,0,0,0,17045
5261,19987,4307,9549,3760,1573,798,1463,655,547,237,42,268,108,63,18,45,0,45,27,18,0,808,625,242,94,289,183,97,63,15,19,86,37,36,13,17046
5262,1581,315,809,338,89,30,243,153,117,18,0,99,36,7,0,3,4,29,21,0,8,90,58,16,11,31,32,13,13,0,0,19,19,0,0,17047
5263,2621,526,1324,530,172,69,167,69,53,18,6,29,16,9,9,0,0,7,7,0,0,98,76,36,7,33,22,8,0,8,0,14,10,0,4,17048
5264,1939,467,1022,214,161,75,267,172,109,65,3,41,63,0,0,0,0,63,25,0,38,95,43,22,0,21,52,10,5,5,0,42,0,0,42,17049
5265,24353,1175,6600,5482,6788,4308,1775,843,779,177,62,540,64,22,12,10,0,42,32,0,10,932,902,367,59,476,30,29,21,0,8,1,0,0,1,17050
5266,3202,562,1856,492,236,56,291,150,76,15,9,52,74,32,25,7,0,42,37,0,5,141,95,27,4,64,46,9,9,0,0,37,2,0,35,17051
5267,1070,124,698,169,65,14,78,53,41,9,0,32,12,12,3,9,0,0,0,0,0,25,22,8,0,14,3,3,0,0,3,0,0,0,0,17052
5268,3671,317,1676,944,469,265,204,100,86,8,20,58,14,14,7,3,4,0,0,0,0,104,91,41,5,45,13,13,8,5,0,0,0,0,0,17053
5269,24642,1491,8139,6141,5596,3275,1568,828,731,250,54,427,97,87,29,58,0,10,10,0,0,740,723,307,35,381,17,17,7,10,0,0,0,0,0,17055
5270,61,10,35,10,6,0,0,0,0,0,0,0,0,0,0,0,0,0,0,0,0,0,0,0,0,0,0,0,0,0,0,0,0,0,0,17056
5271,14595,1818,6465,3469,2054,789,1719,823,724,333,15,376,99,53,25,19,9,46,0,22,24,896,822,392,11,419,74,68,44,13,11,6,0,0,6,17057
5272,1301,297,585,205,160,54,73,45,22,6,0,16,23,13,9,0,4,10,9,0,1,28,28,16,0,12,0,0,0,0,0,0,0,0,0,17058
5273,5688,800,3050,1161,426,251,313,139,104,36,2,66,35,30,8,13,9,5,5,0,0,174,142,56,29,57,32,19,6,13,0,13,0,6,7,17059
5274,860,185,480,141,42,12,46,16,12,0,0,12,4,2,2,0,0,2,2,0,0,30,26,1,0,25,4,0,0,0,0,4,4,0,0,17060
5275,5137,885,2325,1285,341,301,373,186,153,35,26,92,33,21,21,0,0,12,7,0,5,187,134,59,6,69,53,44,37,7,0,9,9,0,0,17061
5276,2800,290,1370,692,322,126,246,113,84,20,2,62,29,19,16,0,3,10,7,3,0,133,105,30,8,67,28,16,13,3,0,12,7,0,5,17062
5277,2239,447,1068,504,127,93,117,42,42,24,0,18,0,0,0,0,0,0,0,0,0,75,44,0,0,44,31,6,0,0,6,25,25,0,0,17063
5278,320,8,77,60,59,116,23,10,10,0,0,10,0,0,0,0,0,0,0,0,0,13,13,9,0,4,0,0,0,0,0,0,0,0,0,17064
5279,2827,397,1223,689,327,191,162,73,45,26,0,19,28,16,16,0,0,12,12,0,0,89,60,16,17,27,29,12,12,0,0,17,0,0,17,17065
5280,3627,601,1982,660,201,183,270,126,107,28,3,76,19,11,0,8,3,8,2,0,6,144,136,33,14,89,8,4,4,0,0,4,0,0,4,17066
5281,9690,1632,4831,1745,879,603,658,343,238,85,0,153,105,88,77,11,0,17,17,0,0,315,181,88,20,73,134,55,18,37,0,79,58,0,21,17067
5282,3246,475,1545,712,323,191,276,166,121,59,17,45,45,18,14,0,4,27,0,27,0,110,97,0,8,89,13,13,13,0,0,0,0,0,0,17068
5283,79,27,37,12,3,0,6,3,3,3,0,0,0,0,0,0,0,0,0,0,0,3,3,3,0,0,0,0,0,0,0,0,0,0,0,17069
5284,11122,791,3570,2817,2695,1249,426,119,87,41,5,41,32,13,13,0,0,19,0,19,0,307,255,124,0,131,52,52,45,0,7,0,0,0,0,17070
5285,91,38,42,9,0,2,0,0,0,0,0,0,0,0,0,0,0,0,0,0,0,0,0,0,0,0,0,0,0,0,0,0,0,0,0,17071
5286,140,0,77,27,36,0,0,0,0,0,0,0,0,0,0,0,0,0,0,0,0,0,0,0,0,0,0,0,0,0,0,0,0,0,0,17072
5287,3435,700,1779,615,247,94,283,118,71,45,8,18,47,18,10,0,8,29,29,0,0,165,110,48,22,40,55,39,39,0,0,16,16,0,0,17073
5288,4934,657,2465,1025,525,262,343,143,106,27,3,76,37,37,28,9,0,0,0,0,0,200,130,25,2,103,70,59,53,0,6,11,2,0,9,17074
5289,86,14,60,5,2,5,8,8,8,0,0,8,0,0,0,0,0,0,0,0,0,0,0,0,0,0,0,0,0,0,0,0,0,0,0,17075
5290,14,0,14,0,0,0,0,0,0,0,0,0,0,0,0,0,0,0,0,0,0,0,0,0,0,0,0,0,0,0,0,0,0,0,0,17076
5291,10,0,5,5,0,0,0,0,0,0,0,0,0,0,0,0,0,0,0,0,0,0,0,0,0,0,0,0,0,0,0,0,0,0,0,17077
5292,14671,1343,5494,3416,2824,1594,717,326,262,104,13,145,64,7,7,0,0,57,0,0,57,391,340,175,7,158,51,11,11,0,0,40,0,12,28,17078
5293,190,41,99,27,13,10,20,12,8,0,0,8,4,4,4,0,0,0,0,0,0,8,8,0,4,4,0,0,0,0,0,0,0,0,0,17080
5294,48,0,34,14,0,0,0,0,0,0,0,0,0,0,0,0,0,0,0,0,0,0,0,0,0,0,0,0,0,0,0,0,0,0,0,17081
5295,2368,322,1308,449,164,125,135,69,53,6,3,44,16,13,13,0,0,3,3,0,0,66,44,14,6,24,22,18,18,0,0,4,0,0,4,17082
5296,60,8,40,12,0,0,0,0,0,0,0,0,0,0,0,0,0,0,0,0,0,0,0,0,0,0,0,0,0,0,0,0,0,0,0,17083
5297,3177,741,1180,636,394,226,188,83,56,13,0,43,27,0,0,0,0,27,27,0,0,105,65,12,7,46,40,4,4,0,0,36,0,0,36,17084
5298,1567,289,816,255,149,58,107,56,36,12,0,24,20,7,7,0,0,13,10,0,3,51,39,12,0,27,12,10,3,4,3,2,2,0,0,17086
5299,2041,528,917,365,187,44,147,79,31,16,4,11,48,20,4,16,0,28,9,0,19,68,36,8,0,28,32,20,17,0,3,12,0,0,12,17087
5300,413,99,154,93,60,7,8,8,8,8,0,0,0,0,0,0,0,0,0,0,0,0,0,0,0,0,0,0,0,0,0,0,0,0,0,17088
5301,3471,464,1390,971,375,271,266,113,70,24,18,28,43,43,30,13,0,0,0,0,0,153,143,78,38,27,10,10,0,10,0,0,0,0,0,17090
5302,501,11,238,118,115,19,105,49,49,6,0,43,0,0,0,0,0,0,0,0,0,56,56,13,3,40,0,0,0,0,0,0,0,0,0,17093
5303,1857,288,891,437,134,107,178,117,79,15,0,64,38,29,24,0,5,9,6,3,0,61,24,0,7,17,37,20,4,16,0,17,4,5,8,17094
5304,549,84,314,90,49,12,39,20,17,4,0,13,3,3,0,3,0,0,0,0,0,19,16,8,0,8,3,0,0,0,0,3,0,0,3,17097
5305,1719,294,874,399,126,26,141,62,48,8,15,25,14,4,4,0,0,10,4,3,3,79,72,22,9,41,7,5,2,0,3,2,0,2,0,17098
5306,797,118,367,284,28,0,148,108,53,0,0,53,55,42,19,23,0,13,13,0,0,40,40,0,0,40,0,0,0,0,0,0,0,0,0,17099
5307,1603,331,496,340,219,217,43,43,43,0,0,43,0,0,0,0,0,0,0,0,0,0,0,0,0,0,0,0,0,0,0,0,0,0,0,17101
5308,5907,808,1610,1509,1364,616,255,86,69,6,16,47,17,6,0,0,6,11,0,6,5,169,169,0,29,140,0,0,0,0,0,0,0,0,0,17102
5309,7067,1352,3061,1830,656,168,716,404,336,77,27,232,68,24,16,8,0,44,0,0,44,312,268,66,0,202,44,24,0,24,0,20,0,0,20,17103
5310,11923,2986,4575,2522,1228,612,1554,883,495,0,82,413,388,153,63,24,66,235,47,100,88,671,602,169,135,298,69,46,10,15,21,23,0,0,23,17104
5311,16542,1623,5424,5184,2819,1492,923,433,302,151,24,127,131,116,82,22,12,15,12,0,3,490,407,169,17,221,83,64,50,14,0,19,19,0,0,17109
5312,17254,1578,5191,4413,3552,2520,1047,379,316,80,51,185,63,58,11,7,40,5,0,5,0,668,529,170,47,312,139,79,30,35,14,60,29,4,27,17110
5313,22422,2136,7135,6198,4324,2629,1389,866,660,307,15,338,206,138,59,15,64,68,3,0,65,523,436,141,57,238,87,79,10,23,46,8,0,0,8,17111
5314,24077,1397,7267,5974,5939,3500,1837,995,737,293,56,388,258,174,124,22,28,84,40,0,44,842,820,468,71,281,22,22,0,0,22,0,0,0,0,17112
5315,6798,689,3542,1809,541,217,669,314,277,58,25,194,37,30,21,6,3,7,0,0,7,355,341,86,0,255,14,14,0,14,0,0,0,0,0,17113
5316,0,0,0,0,0,0,0,0,0,0,0,0,0,0,0,0,0,0,0,0,0,0,0,0,0,0,0,0,0,0,0,0,0,0,0,17120
5317,16926,3225,6305,3608,2538,1250,1441,616,480,157,1,322,136,75,22,28,25,61,30,0,31,825,655,301,14,340,170,141,67,28,46,29,22,0,7,17201
5318,21418,2331,9755,4924,2717,1691,1419,751,622,253,34,335,129,94,71,23,0,35,0,28,7,668,551,254,60,237,117,97,97,0,0,20,20,0,0,17202
5319,110,15,56,25,14,0,0,0,0,0,0,0,0,0,0,0,0,0,0,0,0,0,0,0,0,0,0,0,0,0,0,0,0,0,0,17210
5320,253,52,128,59,12,2,17,13,11,0,0,11,2,2,0,2,0,0,0,0,0,4,4,4,0,0,0,0,0,0,0,0,0,0,0,17211
5321,509,69,253,131,36,20,38,32,24,0,11,13,8,0,0,0,0,8,0,0,8,6,6,3,0,3,0,0,0,0,0,0,0,0,0,17212
5322,447,72,204,101,40,30,58,40,30,0,0,30,10,10,10,0,0,0,0,0,0,18,18,0,0,18,0,0,0,0,0,0,0,0,0,17213
5323,841,120,383,225,58,55,85,37,31,21,0,10,6,6,0,6,0,0,0,0,0,48,48,48,0,0,0,0,0,0,0,0,0,0,0,17214
5324,154,29,93,23,6,3,3,0,0,0,0,0,0,0,0,0,0,0,0,0,0,3,0,0,0,0,3,3,0,0,3,0,0,0,0,17215
5325,60,11,35,14,0,0,5,0,0,0,0,0,0,0,0,0,0,0,0,0,0,5,0,0,0,0,5,5,5,0,0,0,0,0,0,17217
5326,285,76,161,33,3,12,23,10,10,0,0,10,0,0,0,0,0,0,0,0,0,13,13,0,0,13,0,0,0,0,0,0,0,0,0,17219
5327,199,60,81,21,16,21,21,9,4,4,0,0,5,5,5,0,0,0,0,0,0,12,0,0,0,0,12,0,0,0,0,12,4,0,8,17220
5328,377,86,197,60,27,7,33,10,6,3,0,3,4,0,0,0,0,4,0,0,4,23,23,0,0,23,0,0,0,0,0,0,0,0,0,17221
5329,7668,1201,3249,1442,1164,612,532,357,315,72,0,243,42,10,0,0,10,32,11,0,21,175,102,37,20,45,73,61,57,0,4,12,12,0,0,17222
5330,247,63,127,46,7,4,14,9,9,9,0,0,0,0,0,0,0,0,0,0,0,5,2,2,0,0,3,3,0,0,3,0,0,0,0,17223
5331,1593,278,1026,206,28,55,73,50,47,31,0,16,3,3,3,0,0,0,0,0,0,23,23,6,0,17,0,0,0,0,0,0,0,0,0,17224
5332,13427,1781,5576,3292,1776,1002,948,506,411,129,16,266,95,44,28,16,0,51,22,14,15,442,385,157,0,228,57,33,20,0,13,24,0,0,24,17225
5333,776,145,412,151,27,41,85,70,59,0,11,48,11,11,11,0,0,0,0,0,0,15,15,0,9,6,0,0,0,0,0,0,0,0,0,17228
5334,912,106,518,191,74,23,82,62,62,27,3,32,0,0,0,0,0,0,0,0,0,20,20,11,0,9,0,0,0,0,0,0,0,0,0,17229
5335,3605,547,1865,738,306,149,209,93,64,5,10,49,29,26,14,8,4,3,0,0,3,116,90,35,13,42,26,26,5,11,10,0,0,0,0,17233
5336,473,65,241,75,92,0,0,0,0,0,0,0,0,0,0,0,0,0,0,0,0,0,0,0,0,0,0,0,0,0,0,0,0,0,0,17235
5337,5825,1073,2878,1035,425,414,312,156,102,30,8,64,54,29,13,16,0,25,25,0,0,156,100,23,1,76,56,27,19,8,0,29,11,0,18,17236
5338,1251,172,608,306,105,60,347,153,153,34,8,111,0,0,0,0,0,0,0,0,0,194,171,57,25,89,23,23,18,5,0,0,0,0,0,17237
5339,1028,151,559,201,84,33,83,29,19,10,3,6,10,10,10,0,0,0,0,0,0,54,48,17,8,23,6,6,3,0,3,0,0,0,0,17238
5340,148,28,80,11,8,21,11,5,5,0,0,5,0,0,0,0,0,0,0,0,0,6,4,4,0,0,2,2,0,0,2,0,0,0,0,17239
5341,2063,455,1004,340,167,97,291,183,102,27,6,69,81,36,30,3,3,45,35,0,10,108,85,37,14,34,23,13,11,0,2,10,8,0,2,17240
5342,8154,1393,3968,1734,680,379,633,325,250,95,10,145,75,32,21,11,0,43,33,0,10,308,244,86,40,118,64,15,10,0,5,49,19,0,30,17241
5343,901,148,485,178,47,43,111,59,47,23,6,18,12,4,2,0,2,8,0,0,8,52,48,20,9,19,4,4,4,0,0,0,0,0,0,17243
5344,1651,318,733,398,134,68,94,33,24,4,12,8,9,9,9,0,0,0,0,0,0,61,50,33,2,15,11,4,0,0,4,7,0,0,7,17244
5345,79,4,70,5,0,0,0,0,0,0,0,0,0,0,0,0,0,0,0,0,0,0,0,0,0,0,0,0,0,0,0,0,0,0,0,17246
5346,334,87,93,33,27,94,0,0,0,0,0,0,0,0,0,0,0,0,0,0,0,0,0,0,0,0,0,0,0,0,0,0,0,0,0,17247
5347,197,42,117,25,13,0,3,2,2,0,1,1,0,0,0,0,0,0,0,0,0,1,1,1,0,0,0,0,0,0,0,0,0,0,0,17249
5348,107,0,107,0,0,0,0,0,0,0,0,0,0,0,0,0,0,0,0,0,0,0,0,0,0,0,0,0,0,0,0,0,0,0,0,17250
5349,77,7,34,13,12,11,12,0,0,0,0,0,0,0,0,0,0,0,0,0,0,12,12,0,0,12,0,0,0,0,0,0,0,0,0,17251
5350,2358,466,1023,493,291,85,218,151,151,24,10,117,0,0,0,0,0,0,0,0,0,67,22,12,10,0,45,34,0,34,0,11,0,0,11,17252
5351,197,25,116,39,9,8,17,8,8,0,0,8,0,0,0,0,0,0,0,0,0,9,9,5,1,3,0,0,0,0,0,0,0,0,0,17253
5352,1,0,1,0,0,0,1,1,1,1,0,0,0,0,0,0,0,0,0,0,0,0,0,0,0,0,0,0,0,0,0,0,0,0,0,17254
5353,820,126,421,219,19,35,45,27,27,4,0,23,0,0,0,0,0,0,0,0,0,18,16,5,0,11,2,2,2,0,0,0,0,0,0,17255
5354,14,0,14,0,0,0,0,0,0,0,0,0,0,0,0,0,0,0,0,0,0,0,0,0,0,0,0,0,0,0,0,0,0,0,0,17256
5355,16117,2506,6838,3525,1998,1250,2912,1373,1254,320,130,804,119,48,39,9,0,71,54,0,17,1539,1419,351,140,928,120,55,50,5,0,65,26,0,39,17257
5356,796,150,500,82,61,3,76,25,13,0,0,13,12,6,6,0,0,6,0,0,6,51,33,2,0,31,18,18,0,1,17,0,0,0,0,17260
5357,59,26,23,7,0,3,137,137,102,0,0,102,35,3,0,0,3,32,0,0,32,0,0,0,0,0,0,0,0,0,0,0,0,0,0,17261
5358,966,289,369,215,75,18,127,95,24,0,0,24,71,13,13,0,0,58,0,0,58,32,20,6,0,14,12,0,0,0,0,12,6,0,6,17262
5359,405,90,233,79,3,0,192,143,84,0,0,84,59,39,39,0,0,20,20,0,0,49,24,0,0,24,25,25,25,0,0,0,0,0,0,17263
5360,1640,263,946,320,72,39,91,51,35,14,0,21,16,4,4,0,0,12,5,0,7,40,37,15,0,22,3,3,0,3,0,0,0,0,0,17264
5361,390,63,216,72,34,5,33,16,16,16,0,0,0,0,0,0,0,0,0,0,0,17,10,0,0,10,7,7,7,0,0,0,0,0,0,17265
5362,425,63,213,95,38,16,65,23,9,2,3,4,14,14,12,2,0,0,0,0,0,42,31,19,0,12,11,0,0,0,0,11,0,0,11,17266
5363,1960,288,908,485,175,104,174,90,79,18,8,53,11,11,11,0,0,0,0,0,0,84,72,28,18,26,12,8,6,0,2,4,0,4,0,17267
5364,19445,2624,8265,4903,2379,1274,1389,671,515,165,70,280,156,100,16,58,26,56,30,26,0,718,500,238,27,235,218,81,65,0,16,137,64,17,56,17268
5365,129,0,65,34,0,30,0,0,0,0,0,0,0,0,0,0,0,0,0,0,0,0,0,0,0,0,0,0,0,0,0,0,0,0,0,17270
5366,255,62,107,53,30,3,22,15,15,2,0,13,0,0,0,0,0,0,0,0,0,7,7,7,0,0,0,0,0,0,0,0,0,0,0,17271
5367,160,25,48,59,14,14,0,0,0,0,0,0,0,0,0,0,0,0,0,0,0,0,0,0,0,0,0,0,0,0,0,0,0,0,0,17272
5368,2435,433,1157,598,142,105,189,53,37,19,18,0,16,10,0,0,10,6,0,6,0,136,116,45,16,55,20,18,18,0,0,2,2,0,0,17301
5369,1892,231,946,555,99,61,108,52,21,0,0,21,31,8,0,0,8,23,0,0,23,56,49,7,8,34,7,0,0,0,0,7,7,0,0,17302
5370,2075,340,974,407,176,178,112,69,69,40,0,29,0,0,0,0,0,0,0,0,0,43,40,17,0,23,3,3,0,0,3,0,0,0,0,17304
5371,231,7,147,42,25,10,36,17,17,7,0,10,0,0,0,0,0,0,0,0,0,19,19,8,0,11,0,0,0,0,0,0,0,0,0,17306
5372,3961,612,1820,823,402,304,288,161,143,47,23,73,18,11,11,0,0,7,0,7,0,127,119,17,7,95,8,8,8,0,0,0,0,0,0,17307
5373,1252,117,853,169,50,63,93,55,55,20,12,23,0,0,0,0,0,0,0,0,0,38,31,25,0,6,7,7,7,0,0,0,0,0,0,17309
5374,222,64,76,52,24,6,13,8,8,0,0,8,0,0,0,0,0,0,0,0,0,5,5,0,5,0,0,0,0,0,0,0,0,0,0,17311
5375,7297,839,3271,1785,817,585,506,196,177,52,31,94,19,11,11,0,0,8,8,0,0,310,262,148,57,57,48,45,41,0,4,3,0,3,0,17313
5376,4024,482,1702,1410,330,100,439,248,227,131,0,96,21,12,12,0,0,9,7,2,0,191,130,42,34,54,61,61,35,26,0,0,0,0,0,17314
5377,18681,2306,8942,4516,2043,874,1186,474,384,127,10,247,90,84,57,14,13,6,0,0,6,712,642,212,147,283,70,70,33,37,0,0,0,0,0,17315
5378,5760,600,2539,1490,752,379,512,361,301,72,8,221,60,39,30,5,4,21,0,21,0,151,148,82,0,66,3,3,0,0,3,0,0,0,0,17316
5379,584,36,288,127,77,56,43,21,13,3,0,10,8,8,8,0,0,0,0,0,0,22,19,19,0,0,3,0,0,0,0,3,3,0,0,17317
5380,186,11,128,40,7,0,9,9,9,9,0,0,0,0,0,0,0,0,0,0,0,0,0,0,0,0,0,0,0,0,0,0,0,0,0,17318
5381,6990,527,2562,2007,1423,471,634,265,215,33,6,176,50,47,47,0,0,3,0,0,3,369,329,48,115,166,40,26,26,0,0,14,14,0,0,17319
5382,5606,562,2149,1449,847,599,351,150,112,40,13,59,38,38,38,0,0,0,0,0,0,201,195,82,22,91,6,6,3,0,3,0,0,0,0,17320
5383,1519,197,594,464,144,120,149,54,44,12,6,26,10,10,0,3,7,0,0,0,0,95,76,35,6,35,19,19,1,10,8,0,0,0,0,17321
5384,4191,465,1959,1153,410,204,376,203,172,15,18,139,31,28,20,3,5,3,0,0,3,173,133,37,7,89,40,33,7,26,0,7,0,0,7,17322
5385,3073,604,1433,649,279,108,197,83,60,15,7,38,23,23,12,11,0,0,0,0,0,114,97,37,6,54,17,12,6,0,6,5,0,5,0,17324
5386,18656,2487,6789,3983,2928,2469,2394,1202,1134,217,29,888,68,49,24,17,8,19,3,0,16,1192,1123,261,98,764,69,60,41,9,10,9,0,0,9,17325
5387,5900,667,2324,1622,824,463,346,183,170,48,35,87,13,13,12,0,1,0,0,0,0,163,123,53,21,49,40,40,25,6,9,0,0,0,0,17327
5388,1777,108,681,725,151,112,192,131,131,78,21,32,0,0,0,0,0,0,0,0,0,61,61,52,9,0,0,0,0,0,0,0,0,0,0,17329
5389,35047,4256,15471,8902,4233,2185,2235,1273,1116,355,99,662,157,139,77,55,7,18,0,0,18,962,848,263,124,461,114,49,43,0,6,65,20,0,45,17331
5390,4697,380,1657,1249,999,412,412,237,161,35,16,110,76,55,31,13,11,21,13,8,0,175,161,69,26,66,14,14,0,9,5,0,0,0,0,17339
5391,7423,903,3127,1985,863,545,627,338,308,156,28,124,30,30,5,11,14,0,0,0,0,289,259,139,8,112,30,21,21,0,0,9,0,0,9,17340
5392,21,0,0,0,0,21,0,0,0,0,0,0,0,0,0,0,0,0,0,0,0,0,0,0,0,0,0,0,0,0,0,0,0,0,0,17343
5393,2248,296,1170,550,127,105,153,66,66,25,0,41,0,0,0,0,0,0,0,0,0,87,87,75,0,12,0,0,0,0,0,0,0,0,0,17344
5394,5064,714,2612,956,556,226,442,270,178,24,19,135,92,58,36,7,15,34,20,0,14,172,130,36,6,88,42,36,19,17,0,6,0,0,6,17345
5395,4336,444,1833,1081,579,399,402,312,269,65,39,165,43,43,40,3,0,0,0,0,0,90,74,22,32,20,16,16,16,0,0,0,0,0,0,17347
5396,5149,523,1573,1499,1060,494,419,125,124,26,0,98,1,1,1,0,0,0,0,0,0,294,294,137,15,142,0,0,0,0,0,0,0,0,0,17349
5397,8907,1703,4104,1930,703,467,671,319,298,51,0,247,21,20,0,0,20,1,0,1,0,352,206,85,49,72,146,84,84,0,0,62,26,36,0,17350
5398,864,142,349,228,87,58,88,39,39,4,0,35,0,0,0,0,0,0,0,0,0,49,44,0,0,44,5,5,0,0,5,0,0,0,0,17352
5399,2360,230,943,619,398,170,222,130,130,39,0,91,0,0,0,0,0,0,0,0,0,92,89,15,0,74,3,3,3,0,0,0,0,0,0,17353
5400,116,21,47,29,15,4,24,18,13,2,1,10,5,5,5,0,0,0,0,0,0,6,6,0,2,4,0,0,0,0,0,0,0,0,0,17355
5401,15349,1986,6327,4018,1875,1143,1138,586,537,79,107,351,49,49,22,16,11,0,0,0,0,552,481,166,93,222,71,45,45,0,0,26,15,0,11,17356
5402,3950,506,1456,862,827,299,197,99,72,17,0,55,27,27,24,0,3,0,0,0,0,98,98,10,0,88,0,0,0,0,0,0,0,0,0,17360
5403,3914,311,1575,953,708,367,346,196,182,59,22,101,14,14,14,0,0,0,0,0,0,150,121,11,0,110,29,29,29,0,0,0,0,0,0,17361
5404,9535,1020,4850,2026,977,662,994,470,320,87,13,220,150,125,109,5,11,25,10,7,8,524,463,232,44,187,61,49,24,14,11,12,0,0,12,17362
5405,6769,601,2583,1920,1157,508,412,221,200,61,47,92,21,21,10,11,0,0,0,0,0,191,163,47,12,104,28,28,25,3,0,0,0,0,0,17363
5406,2482,399,1347,383,208,145,269,161,148,30,0,118,13,13,13,0,0,0,0,0,0,108,93,23,0,70,15,15,0,6,9,0,0,0,0,17364
5407,1732,175,886,404,156,111,66,29,29,10,0,19,0,0,0,0,0,0,0,0,0,37,37,32,0,5,0,0,0,0,0,0,0,0,0,17365
5408,3892,534,2077,869,281,131,215,87,84,34,0,50,3,3,3,0,0,0,0,0,0,128,95,57,0,38,33,33,33,0,0,0,0,0,0,17366
5409,5033,780,2412,1124,375,342,268,200,139,62,0,77,61,47,23,24,0,14,14,0,0,68,68,33,0,35,0,0,0,0,0,0,0,0,0,17368
5410,3741,396,1733,986,481,145,208,127,124,53,0,71,3,3,0,0,3,0,0,0,0,81,81,0,0,81,0,0,0,0,0,0,0,0,0,17370
5411,201,55,93,33,4,16,8,8,0,0,0,0,8,7,7,0,0,1,1,0,0,0,0,0,0,0,0,0,0,0,0,0,0,0,0,17371
5412,2898,563,1245,707,231,152,262,136,120,31,21,68,16,4,4,0,0,12,4,0,8,126,88,56,4,28,38,38,25,0,13,0,0,0,0,17372
5413,9940,3053,4434,1518,767,168,1138,478,320,51,43,226,158,41,8,33,0,117,0,106,11,660,366,92,36,238,294,97,54,37,6,197,62,21,114,17401
5414,25789,2676,9338,6325,4646,2804,1624,912,684,130,139,415,228,190,143,16,31,38,0,24,14,712,572,200,63,309,140,134,102,11,21,6,0,0,6,17402
5415,25371,3982,8897,5848,4263,2381,3128,1542,1231,243,120,868,311,217,107,74,36,94,0,32,62,1586,1473,472,95,906,113,76,35,7,34,37,31,3,3,17403
5416,23700,2510,9628,5806,3720,2036,1661,856,756,98,173,485,100,100,65,35,0,0,0,0,0,805,705,299,133,273,100,47,45,0,2,53,33,0,20,17404
5417,15873,1663,6767,3826,2338,1279,1310,840,578,242,35,301,262,247,74,80,93,15,0,15,0,470,461,141,84,236,9,9,9,0,0,0,0,0,0,17406
5418,1475,114,511,434,289,127,83,45,45,22,3,20,0,0,0,0,0,0,0,0,0,38,33,15,0,18,5,5,5,0,0,0,0,0,0,17407
5419,16129,1531,6865,4038,2525,1170,1025,426,374,47,113,214,52,38,38,0,0,14,14,0,0,599,508,212,58,238,91,55,22,0,33,36,0,0,36,17408
5420,3272,508,1308,752,500,204,156,79,54,7,19,28,25,25,14,0,11,0,0,0,0,77,68,36,0,32,9,0,0,0,0,9,9,0,0,17501
5421,2033,267,1028,402,263,73,102,48,48,8,13,27,0,0,0,0,0,0,0,0,0,54,48,0,9,39,6,6,6,0,0,0,0,0,0,17502
5422,1101,517,336,90,78,80,147,92,16,0,0,16,76,20,6,0,14,56,56,0,0,55,26,8,0,18,29,0,0,0,0,29,15,0,14,17505
5423,13,0,0,13,0,0,0,0,0,0,0,0,0,0,0,0,0,0,0,0,0,0,0,0,0,0,0,0,0,0,0,0,0,0,0,17507
5424,224,0,34,151,26,13,20,0,0,0,0,0,0,0,0,0,0,0,0,0,0,20,20,20,0,0,0,0,0,0,0,0,0,0,0,17508
5425,2520,762,844,477,290,147,281,105,65,9,0,56,40,4,2,2,0,36,29,0,7,176,58,28,9,21,118,4,4,0,0,114,100,0,14,17509
5426,11869,1717,5668,2700,1322,462,879,452,392,113,74,205,60,60,46,0,14,0,0,0,0,427,385,159,15,211,42,32,3,0,29,10,0,0,10,17512
5427,3258,425,1546,545,485,257,261,109,100,68,8,24,9,9,9,0,0,0,0,0,0,152,152,93,14,45,0,0,0,0,0,0,0,0,0,17516
5428,10511,2048,4499,2054,1426,484,827,501,358,188,11,159,143,55,55,0,0,88,50,11,27,326,244,115,0,129,82,75,58,6,11,7,7,0,0,17517
5429,769,269,346,78,53,23,80,62,23,13,6,4,39,0,0,0,0,39,11,0,28,18,3,0,0,3,15,0,0,0,0,15,7,0,8,17518
5430,4050,1438,1759,420,343,90,401,211,77,21,0,56,134,42,42,0,0,92,80,0,12,190,85,24,23,38,105,35,21,0,14,70,57,0,13,17519
5431,3073,315,1164,892,476,226,348,199,172,114,0,58,27,27,12,15,0,0,0,0,0,149,104,79,11,14,45,0,0,0,0,45,0,45,0,17520
5432,21907,4612,8478,4472,2994,1351,1423,713,499,138,60,301,214,80,63,8,9,134,90,7,37,710,413,178,50,185,297,78,60,0,18,219,128,36,55,17522
5433,3457,1118,1368,526,305,140,401,246,175,62,0,113,71,33,33,0,0,38,38,0,0,155,137,88,0,49,18,11,11,0,0,7,7,0,0,17527
5434,2391,1151,713,269,194,64,308,131,12,6,0,6,119,14,14,0,0,105,93,0,12,177,31,16,0,15,146,8,8,0,0,138,125,0,13,17529
5435,2402,617,1119,439,118,109,185,72,68,0,19,49,4,0,0,0,0,4,0,0,4,113,95,11,10,74,18,0,0,0,0,18,0,0,18,17532
5436,1178,515,471,105,53,34,185,93,29,15,5,9,64,0,0,0,0,64,22,0,42,92,29,16,13,0,63,7,7,0,0,56,32,0,24,17535
5437,1629,511,594,240,214,70,210,152,33,14,0,19,119,6,0,0,6,113,99,0,14,58,28,16,6,6,30,8,8,0,0,22,22,0,0,17536
5438,4655,163,1362,1107,1238,785,249,112,112,47,13,52,0,0,0,0,0,0,0,0,0,137,137,86,16,35,0,0,0,0,0,0,0,0,0,17538
5439,5780,1463,2158,1140,715,304,431,282,259,39,30,190,23,23,23,0,0,0,0,0,0,149,111,22,10,79,38,10,0,0,10,28,0,0,28,17540
5440,29359,3266,10222,6454,6099,3318,2233,1041,914,312,67,535,127,113,97,16,0,14,7,0,7,1192,1143,375,41,727,49,18,18,0,0,31,29,0,2,17543
5441,14745,2118,6537,2773,2345,972,1014,452,326,121,24,181,126,107,99,8,0,19,10,0,9,562,512,265,47,200,50,36,11,0,25,14,8,0,6,17545
5442,5058,527,2425,1049,712,345,154,79,79,22,3,54,0,0,0,0,0,0,0,0,0,75,75,26,0,49,0,0,0,0,0,0,0,0,0,17547
5443,563,0,443,80,40,0,5,5,5,0,5,0,0,0,0,0,0,0,0,0,0,0,0,0,0,0,0,0,0,0,0,0,0,0,0,17550
5444,5393,408,1829,1260,1186,710,1997,889,881,182,74,625,8,8,0,8,0,0,0,0,0,1108,1101,402,32,667,7,7,7,0,0,0,0,0,0,17551
5445,13214,934,5388,3383,2518,991,979,503,458,195,21,242,45,45,45,0,0,0,0,0,0,476,452,189,13,250,24,11,11,0,0,13,13,0,0,17552
5446,5501,470,2344,1428,854,405,282,188,163,89,10,64,25,25,14,0,11,0,0,0,0,94,94,16,0,78,0,0,0,0,0,0,0,0,0,17554
5447,4546,1481,1785,635,413,232,519,321,175,82,0,93,146,28,14,0,14,118,118,0,0,198,131,17,0,114,67,7,0,0,7,60,38,8,14,17555
5448,9179,2372,3500,1852,1098,357,737,381,197,72,44,81,184,35,17,0,18,149,122,0,27,356,223,159,0,64,133,76,55,0,21,57,44,0,13,17557
5449,3311,697,1731,489,239,155,354,142,107,12,42,53,35,10,10,0,0,25,8,0,17,212,154,69,0,85,58,39,39,0,0,19,19,0,0,17560
5450,2666,1282,861,280,193,50,312,140,50,0,10,40,90,6,5,0,1,84,68,0,16,172,50,18,0,32,122,0,0,0,0,122,114,0,8,17562
5451,2268,661,1079,312,151,65,252,129,64,20,9,35,65,10,10,0,0,55,7,0,48,123,61,10,12,39,62,20,8,4,8,42,24,13,5,17563
5452,1555,240,770,336,104,105,63,40,29,18,10,1,11,11,11,0,0,0,0,0,0,23,23,13,0,10,0,0,0,0,0,0,0,0,0,17565
5453,7655,1497,3584,1514,762,298,553,308,168,49,24,95,140,47,39,0,8,93,41,0,52,245,162,66,30,66,83,40,7,21,12,43,26,0,17,17566
5454,3433,417,1376,762,628,250,280,162,141,60,30,51,21,21,21,0,0,0,0,0,0,118,118,11,16,91,0,0,0,0,0,0,0,0,0,17569
5455,125,27,20,14,64,0,0,0,0,0,0,0,0,0,0,0,0,0,0,0,0,0,0,0,0,0,0,0,0,0,0,0,0,0,0,17570
5456,2009,672,961,227,121,28,245,99,16,16,0,0,83,15,15,0,0,68,53,0,15,146,78,0,0,78,68,31,31,0,0,37,23,0,14,17572
5457,127,28,59,40,0,0,0,0,0,0,0,0,0,0,0,0,0,0,0,0,0,0,0,0,0,0,0,0,0,0,0,0,0,0,0,17576
5458,5014,897,2390,953,620,154,431,234,110,38,0,72,124,118,76,36,6,6,6,0,0,197,140,69,21,50,57,16,16,0,0,41,6,0,35,17578
5459,3625,516,1342,843,600,324,353,157,115,88,0,27,42,16,4,12,0,26,26,0,0,196,181,47,29,105,15,15,15,0,0,0,0,0,0,17579
5460,589,203,223,90,48,25,59,37,27,0,0,27,10,3,0,0,3,7,7,0,0,22,18,7,0,11,4,0,0,0,0,4,4,0,0,17581
5461,1370,138,608,393,196,35,87,51,51,0,0,51,0,0,0,0,0,0,0,0,0,36,29,7,0,22,7,7,7,0,0,0,0,0,0,17582
5462,6780,412,2724,1566,1274,804,355,178,142,32,18,92,36,21,21,0,0,15,14,0,1,177,152,53,0,99,25,25,9,16,0,0,0,0,0,17584
5463,34714,2380,10373,7742,8251,5968,2162,1011,866,221,126,519,145,133,88,45,0,12,12,0,0,1151,1037,315,50,672,114,93,52,0,41,21,21,0,0,17601
5464,34528,6711,12778,7473,5281,2285,3091,1785,1385,374,296,715,400,219,148,18,53,181,76,19,86,1306,1039,267,208,564,267,188,82,84,22,79,22,37,20,17602
5465,40412,6433,14727,9111,6212,3929,4263,2225,2071,567,533,971,154,137,26,38,73,17,7,10,0,2038,1898,593,211,1094,140,117,89,5,23,23,0,23,0,17603
5466,592,109,245,95,108,35,0,0,0,0,0,0,0,0,0,0,0,0,0,0,0,0,0,0,0,0,0,0,0,0,0,0,0,0,0,17606
5467,29207,3725,11984,7768,3494,2236,3200,1753,1582,326,203,1053,171,117,43,36,38,54,31,9,14,1447,1188,340,96,752,259,126,52,51,23,133,57,60,16,17701
5468,7141,766,2988,1969,956,462,588,348,233,83,0,150,115,61,32,14,15,54,18,0,36,240,221,85,43,93,19,16,16,0,0,3,0,0,3,17702
5469,1188,108,627,307,107,39,52,29,14,5,7,2,15,10,10,0,0,5,0,5,0,23,23,7,4,12,0,0,0,0,0,0,0,0,0,17721
5470,50,4,36,7,3,0,0,0,0,0,0,0,0,0,0,0,0,0,0,0,0,0,0,0,0,0,0,0,0,0,0,0,0,0,0,17723
5471,3681,502,1938,865,295,81,247,134,100,18,6,76,34,22,12,0,10,12,0,0,12,113,97,12,4,81,16,11,11,0,0,5,3,0,2,17724
5472,37,4,22,7,4,0,0,0,0,0,0,0,0,0,0,0,0,0,0,0,0,0,0,0,0,0,0,0,0,0,0,0,0,0,0,17727
5473,3712,405,1471,1175,460,201,329,178,155,33,20,102,23,20,9,11,0,3,0,3,0,151,140,101,4,35,11,8,0,2,6,3,0,3,0,17728
5474,59,1,28,28,2,0,0,0,0,0,0,0,0,0,0,0,0,0,0,0,0,0,0,0,0,0,0,0,0,0,0,0,0,0,0,17729
5475,249,115,61,73,0,0,18,18,18,0,0,18,0,0,0,0,0,0,0,0,0,0,0,0,0,0,0,0,0,0,0,0,0,0,0,17730
5476,129,0,36,20,33,40,6,6,6,0,0,6,0,0,0,0,0,0,0,0,0,0,0,0,0,0,0,0,0,0,0,0,0,0,0,17731
5477,4140,432,1852,1000,563,293,263,171,154,34,30,90,17,17,14,3,0,0,0,0,0,92,86,50,0,36,6,6,6,0,0,0,0,0,0,17737
5478,36,3,18,12,0,3,1,1,1,0,0,1,0,0,0,0,0,0,0,0,0,0,0,0,0,0,0,0,0,0,0,0,0,0,0,17739
5479,8561,1265,3923,2197,836,340,692,304,242,22,27,193,62,50,47,2,1,12,12,0,0,388,325,66,19,240,63,27,25,0,2,36,22,0,14,17740
5480,43,0,20,13,10,0,0,0,0,0,0,0,0,0,0,0,0,0,0,0,0,0,0,0,0,0,0,0,0,0,0,0,0,0,0,17742
5481,2294,283,1156,619,145,91,135,96,91,20,9,62,5,5,5,0,0,0,0,0,0,39,34,9,0,25,5,5,5,0,0,0,0,0,0,17744
5482,11195,1473,4838,2646,1417,821,2119,1035,986,118,40,828,49,28,14,4,10,21,0,14,7,1084,1037,228,96,713,47,39,25,14,0,8,3,3,2,17745
5483,1889,395,887,409,154,44,188,75,42,0,5,37,33,11,9,0,2,22,16,0,6,113,68,14,3,51,45,15,5,8,2,30,6,0,24,17747
5484,185,31,91,47,16,0,3,3,0,0,0,0,3,3,0,0,3,0,0,0,0,0,0,0,0,0,0,0,0,0,0,0,0,0,0,17748
5485,174,21,87,48,18,0,19,12,12,1,4,7,0,0,0,0,0,0,0,0,0,7,7,3,0,4,0,0,0,0,0,0,0,0,0,17749
5486,77,5,27,17,28,0,3,3,3,0,0,3,0,0,0,0,0,0,0,0,0,0,0,0,0,0,0,0,0,0,0,0,0,0,0,17750
5487,5113,654,2328,1176,613,342,439,226,193,51,0,142,33,21,7,0,14,12,11,0,1,213,156,33,12,111,57,31,27,4,0,26,13,0,13,17751
5488,3245,497,1449,894,249,156,235,141,130,42,3,85,11,11,11,0,0,0,0,0,0,94,74,46,3,25,20,11,2,9,0,9,8,1,0,17752
5489,9113,783,3209,2688,1624,809,422,262,240,101,2,137,22,16,14,0,2,6,0,0,6,160,153,91,0,62,7,4,4,0,0,3,0,3,0,17754
5490,9096,1349,3981,2160,1065,541,527,220,206,15,9,182,14,11,3,8,0,3,3,0,0,307,245,96,23,126,62,23,23,0,0,39,6,4,29,17756
5491,738,98,378,170,64,28,61,24,14,12,0,2,10,10,10,0,0,0,0,0,0,37,37,7,0,30,0,0,0,0,0,0,0,0,0,17758
5492,437,64,201,112,26,34,19,8,8,6,0,2,0,0,0,0,0,0,0,0,0,11,11,2,0,9,0,0,0,0,0,0,0,0,0,17760
5493,342,14,169,67,64,28,16,2,2,2,0,0,0,0,0,0,0,0,0,0,0,14,14,0,0,14,0,0,0,0,0,0,0,0,0,17762
5494,269,37,131,63,38,0,46,20,18,0,0,18,2,0,0,0,0,2,2,0,0,26,18,0,9,9,8,8,8,0,0,0,0,0,0,17763
5495,1579,262,867,310,88,52,82,34,31,7,0,24,3,2,0,0,2,1,0,0,1,48,43,11,4,28,5,3,0,3,0,2,0,0,2,17764
5496,658,75,347,144,91,1,25,19,16,2,4,10,3,3,0,0,3,0,0,0,0,6,3,0,0,3,3,3,3,0,0,0,0,0,0,17765
5497,70,0,66,0,0,4,0,0,0,0,0,0,0,0,0,0,0,0,0,0,0,0,0,0,0,0,0,0,0,0,0,0,0,0,0,17767
5498,171,35,105,19,11,1,13,9,2,0,0,2,7,7,0,7,0,0,0,0,0,4,3,0,0,3,1,1,0,0,1,0,0,0,0,17768
5499,2469,298,1240,607,222,102,215,142,122,38,5,79,20,6,0,0,6,14,0,12,2,73,55,20,14,21,18,8,7,0,1,10,4,0,6,17771
5500,1659,277,824,349,140,69,147,85,56,14,0,42,29,9,9,0,0,20,20,0,0,62,42,17,4,21,20,0,0,0,0,20,3,0,17,17772
5501,849,108,434,205,79,23,45,21,14,2,0,12,7,0,0,0,0,7,2,3,2,24,24,6,0,18,0,0,0,0,0,0,0,0,0,17774
5502,220,33,127,48,9,3,8,7,5,2,2,1,2,2,2,0,0,0,0,0,0,1,1,0,0,1,0,0,0,0,0,0,0,0,0,17776
5503,5037,550,2731,968,570,218,346,149,132,46,12,74,17,0,0,0,0,17,14,0,3,197,185,80,0,105,12,0,0,0,0,12,0,0,12,17777
5504,71,25,24,18,2,2,4,0,0,0,0,0,0,0,0,0,0,0,0,0,0,4,4,0,4,0,0,0,0,0,0,0,0,0,0,17778
5505,130,2,69,33,26,0,0,0,0,0,0,0,0,0,0,0,0,0,0,0,0,0,0,0,0,0,0,0,0,0,0,0,0,0,0,17779
5506,11428,1928,5434,2651,987,428,697,327,274,33,15,226,53,47,13,3,31,6,1,0,5,370,333,113,16,204,37,30,16,14,0,7,0,0,7,17801
5507,5086,1093,2457,1103,351,82,143,61,50,9,0,41,11,9,3,0,6,2,2,0,0,82,65,33,0,32,17,14,3,0,11,3,0,0,3,17810
5508,976,220,500,189,36,31,92,37,32,21,4,7,5,0,0,0,0,5,5,0,0,55,55,7,7,41,0,0,0,0,0,0,0,0,0,17812
5509,1295,179,724,222,112,58,148,102,88,16,3,69,14,14,11,3,0,0,0,0,0,46,39,10,20,9,7,3,3,0,0,4,4,0,0,17813
5510,3293,468,1563,768,304,190,249,148,115,10,10,95,33,9,0,9,0,24,19,0,5,101,91,22,4,65,10,10,10,0,0,0,0,0,0,17814
5511,17692,1498,7387,3904,2898,2005,3678,1528,1407,280,41,1086,121,66,41,6,19,55,13,16,26,2150,2077,474,133,1470,73,53,15,16,22,20,0,0,20,17815
5512,4059,440,1846,955,554,264,259,141,130,39,12,79,11,8,2,0,6,3,3,0,0,118,94,45,7,42,24,11,6,0,5,13,5,0,8,17820
5513,13490,1264,5348,3020,2100,1758,885,437,375,75,6,294,62,49,32,0,17,13,4,4,5,448,380,149,20,211,68,62,24,4,34,6,6,0,0,17821
5514,0,0,0,0,0,0,0,0,0,0,0,0,0,0,0,0,0,0,0,0,0,0,0,0,0,0,0,0,0,0,0,0,0,0,0,17822
5515,835,115,496,127,65,32,50,35,31,9,0,22,4,1,1,0,0,3,3,0,0,15,5,2,0,3,10,7,5,0,2,3,3,0,0,17823
5516,2973,290,1218,689,470,306,176,67,67,61,0,6,0,0,0,0,0,0,0,0,0,109,70,38,0,32,39,0,0,0,0,39,0,0,39,17824
5517,535,86,245,143,37,24,36,21,16,0,0,16,5,5,5,0,0,0,0,0,0,15,13,13,0,0,2,2,2,0,0,0,0,0,0,17827
5518,148,36,68,27,11,6,16,13,5,0,1,4,8,7,6,0,1,1,1,0,0,3,2,2,0,0,1,0,0,0,0,1,1,0,0,17829
5519,1433,195,830,241,133,34,62,28,28,7,0,21,0,0,0,0,0,0,0,0,0,34,29,12,0,17,5,5,3,2,0,0,0,0,0,17830
5520,469,52,219,139,39,20,23,13,7,0,0,7,6,6,6,0,0,0,0,0,0,10,10,5,0,5,0,0,0,0,0,0,0,0,0,17832
5521,2491,298,1350,445,247,151,84,46,18,0,0,18,28,28,28,0,0,0,0,0,0,38,25,0,9,16,13,0,0,0,0,13,0,0,13,17834
5522,117,19,57,35,6,0,2,0,0,0,0,0,0,0,0,0,0,0,0,0,0,2,2,2,0,0,0,0,0,0,0,0,0,0,0,17835
5523,143,7,77,31,26,2,11,7,7,7,0,0,0,0,0,0,0,0,0,0,0,4,4,4,0,0,0,0,0,0,0,0,0,0,0,17836
5524,12280,1374,4062,2902,2221,1721,2341,1118,1095,173,75,847,23,13,0,0,13,10,10,0,0,1223,1198,272,7,919,25,18,18,0,0,7,7,0,0,17837
5525,355,65,194,96,0,0,0,0,0,0,0,0,0,0,0,0,0,0,0,0,0,0,0,0,0,0,0,0,0,0,0,0,0,0,0,17840
5526,3351,731,1825,556,155,84,196,84,31,0,0,31,53,33,16,0,17,20,9,0,11,112,70,9,0,61,42,9,6,0,3,33,5,0,28,17841
5527,6015,1106,3053,1183,408,265,434,245,178,61,26,91,67,32,25,4,3,35,9,14,12,189,164,71,20,73,25,18,18,0,0,7,7,0,0,17842
5528,6586,1187,2851,1284,829,435,451,250,165,92,12,61,85,28,13,5,10,57,32,0,25,201,147,41,32,74,54,24,24,0,0,30,14,2,14,17844
5529,1539,429,747,253,90,20,118,78,65,9,22,34,13,7,7,0,0,6,6,0,0,40,32,0,0,32,8,5,0,5,0,3,2,1,0,17845
5530,2597,327,1272,471,343,184,134,83,79,32,2,45,4,4,4,0,0,0,0,0,0,51,45,29,4,12,6,6,6,0,0,0,0,0,0,17846
5531,8730,1298,4225,1994,771,442,622,403,378,88,63,227,25,3,0,3,0,22,7,15,0,219,180,69,7,104,39,35,16,19,0,4,3,0,1,17847
5532,398,90,220,64,24,0,17,8,0,0,0,0,8,8,5,3,0,0,0,0,0,9,9,9,0,0,0,0,0,0,0,0,0,0,0,17850
5533,5820,854,3027,1098,553,288,385,213,154,0,27,127,59,0,0,0,0,59,0,32,27,172,172,5,33,134,0,0,0,0,0,0,0,0,0,17851
5534,2261,638,1167,314,94,48,176,82,31,16,5,10,51,28,21,7,0,23,19,0,4,94,70,31,11,28,24,17,12,5,0,7,3,0,4,17853
5535,688,50,315,177,100,46,41,23,21,11,0,10,2,2,2,0,0,0,0,0,0,18,18,9,1,8,0,0,0,0,0,0,0,0,0,17855
5536,2567,282,1420,583,250,32,166,108,100,7,20,73,8,8,6,2,0,0,0,0,0,58,45,22,0,23,13,13,8,5,0,0,0,0,0,17856
5537,5528,627,2659,1123,785,334,320,179,123,33,7,83,56,56,18,4,34,0,0,0,0,141,141,62,26,53,0,0,0,0,0,0,0,0,0,17857
5538,2379,338,1207,445,205,184,118,61,58,4,0,54,3,3,3,0,0,0,0,0,0,57,57,21,0,36,0,0,0,0,0,0,0,0,0,17859
5539,1590,172,793,358,220,47,65,38,26,0,7,19,12,7,7,0,0,5,5,0,0,27,22,11,11,0,5,0,0,0,0,5,5,0,0,17860
5540,71,18,8,20,19,6,0,0,0,0,0,0,0,0,0,0,0,0,0,0,0,0,0,0,0,0,0,0,0,0,0,0,0,0,0,17861
5541,310,20,210,52,13,15,50,20,20,10,0,10,0,0,0,0,0,0,0,0,0,30,30,13,0,17,0,0,0,0,0,0,0,0,0,17862
5542,1466,453,648,200,116,49,201,100,61,19,6,36,39,4,4,0,0,35,32,3,0,101,64,28,12,24,37,12,12,0,0,25,15,0,10,17864
5543,87,0,55,11,21,0,2,0,0,0,0,0,0,0,0,0,0,0,0,0,0,2,2,0,0,2,0,0,0,0,0,0,0,0,0,17865
5544,7948,1693,4199,1283,594,179,523,409,342,40,0,302,67,61,19,0,42,6,6,0,0,114,97,27,0,70,17,1,0,0,1,16,5,6,5,17866
5545,129,4,80,33,6,6,2,0,0,0,0,0,0,0,0,0,0,0,0,0,0,2,2,2,0,0,0,0,0,0,0,0,0,0,0,17867
5546,708,59,282,186,95,86,62,23,23,6,0,17,0,0,0,0,0,0,0,0,0,39,39,29,0,10,0,0,0,0,0,0,0,0,0,17868
5547,9264,1159,3582,2036,1459,1028,1517,746,678,193,34,451,68,37,28,0,9,31,17,10,4,771,762,266,55,441,9,6,6,0,0,3,3,0,0,17870
5548,6994,995,4087,1341,444,127,647,329,141,4,6,131,188,123,88,22,13,65,48,0,17,318,255,70,32,153,63,37,35,0,2,26,0,0,26,17872
5549,1315,156,565,301,199,94,68,52,27,22,0,5,25,19,4,15,0,6,0,6,0,16,16,9,3,4,0,0,0,0,0,0,0,0,0,17876
5550,1023,123,494,246,108,52,91,58,53,7,0,46,5,1,1,0,0,4,0,4,0,33,23,9,0,14,10,10,5,5,0,0,0,0,0,17878
5551,54,14,31,9,0,0,4,4,4,4,0,0,0,0,0,0,0,0,0,0,0,0,0,0,0,0,0,0,0,0,0,0,0,0,0,17880
5552,1100,187,577,217,81,38,77,33,26,6,6,14,7,7,0,0,7,0,0,0,0,44,37,7,0,30,7,7,0,0,7,0,0,0,0,17881
5553,172,40,105,13,11,3,16,7,5,0,0,5,2,2,0,0,2,0,0,0,0,9,9,3,0,6,0,0,0,0,0,0,0,0,0,17884
5554,129,0,92,17,18,2,0,0,0,0,0,0,0,0,0,0,0,0,0,0,0,0,0,0,0,0,0,0,0,0,0,0,0,0,0,17885
5555,655,62,311,184,82,16,0,0,0,0,0,0,0,0,0,0,0,0,0,0,0,0,0,0,0,0,0,0,0,0,0,0,0,0,0,17886
5556,202,30,172,0,0,0,0,0,0,0,0,0,0,0,0,0,0,0,0,0,0,0,0,0,0,0,0,0,0,0,0,0,0,0,0,17887
5557,202,14,100,54,27,7,11,9,9,6,0,3,0,0,0,0,0,0,0,0,0,2,2,0,0,2,0,0,0,0,0,0,0,0,0,17888
5558,1801,274,791,404,190,142,173,67,61,22,0,39,6,0,0,0,0,6,4,0,2,106,72,30,5,37,34,27,0,5,22,7,0,0,7,17889
5559,17059,2145,8047,3960,1774,1133,1119,593,511,66,38,407,82,63,51,12,0,19,11,3,5,526,473,101,64,308,53,31,17,4,10,22,22,0,0,17901
5560,240,34,160,23,16,7,16,4,2,0,0,2,2,2,2,0,0,0,0,0,0,12,12,0,2,10,0,0,0,0,0,0,0,0,0,17920
5561,5950,854,3044,1386,417,249,123,58,48,11,9,28,10,10,0,10,0,0,0,0,0,65,63,27,0,36,2,2,0,0,2,0,0,0,0,17921
5562,3421,360,1350,1026,407,278,326,174,160,35,0,125,14,14,8,6,0,0,0,0,0,152,137,31,3,103,15,0,0,0,0,15,15,0,0,17922
5563,280,49,174,42,8,7,12,2,2,0,0,2,0,0,0,0,0,0,0,0,0,10,2,0,0,2,8,8,0,8,0,0,0,0,0,17923
5564,292,38,146,70,9,29,19,10,10,3,0,7,0,0,0,0,0,0,0,0,0,9,9,9,0,0,0,0,0,0,0,0,0,0,0,17925
5565,1250,103,631,351,98,67,129,59,55,17,10,28,4,4,0,4,0,0,0,0,0,70,55,9,34,12,15,11,11,0,0,4,0,0,4,17929
5566,270,32,143,62,25,8,11,6,4,0,0,4,2,2,0,2,0,0,0,0,0,5,5,0,0,5,0,0,0,0,0,0,0,0,0,17930
5567,6894,1066,3772,1417,478,161,244,169,160,37,18,105,9,0,0,0,0,9,0,0,9,75,65,16,0,49,10,10,0,0,10,0,0,0,0,17931
5568,66,15,18,0,0,33,0,0,0,0,0,0,0,0,0,0,0,0,0,0,0,0,0,0,0,0,0,0,0,0,0,0,0,0,0,17933
5569,373,74,223,41,35,0,7,7,3,0,0,3,4,0,0,0,0,4,0,4,0,0,0,0,0,0,0,0,0,0,0,0,0,0,0,17934
5570,1163,140,730,188,79,26,83,45,39,0,0,39,6,3,3,0,0,3,0,3,0,38,32,0,0,32,6,6,0,6,0,0,0,0,0,17935
5571,563,45,298,133,51,36,16,11,9,5,0,4,2,2,0,0,2,0,0,0,0,5,2,0,0,2,3,0,0,0,0,3,0,0,3,17936
5572,1713,223,869,375,184,62,227,63,59,2,4,53,4,4,4,0,0,0,0,0,0,164,108,54,9,45,56,56,56,0,0,0,0,0,0,17938
5573,572,94,299,149,20,10,45,32,31,3,0,28,1,1,1,0,0,0,0,0,0,13,13,6,0,7,0,0,0,0,0,0,0,0,0,17941
5574,248,23,132,11,82,0,15,0,0,0,0,0,0,0,0,0,0,0,0,0,0,15,15,0,0,15,0,0,0,0,0,0,0,0,0,17943
5575,152,18,80,25,16,13,20,0,0,0,0,0,0,0,0,0,0,0,0,0,0,20,18,8,0,10,2,2,2,0,0,0,0,0,0,17944
5576,156,40,79,29,2,6,2,2,2,0,0,2,0,0,0,0,0,0,0,0,0,0,0,0,0,0,0,0,0,0,0,0,0,0,0,17945
5577,158,14,63,12,47,22,24,0,0,0,0,0,0,0,0,0,0,0,0,0,0,24,24,0,0,24,0,0,0,0,0,0,0,0,0,17946
5578,3370,559,1720,790,217,84,262,157,154,48,0,106,3,3,3,0,0,0,0,0,0,105,87,9,20,58,18,0,0,0,0,18,0,0,18,17948
5579,154,13,88,39,12,2,0,0,0,0,0,0,0,0,0,0,0,0,0,0,0,0,0,0,0,0,0,0,0,0,0,0,0,0,0,17949
5580,194,37,86,56,15,0,0,0,0,0,0,0,0,0,0,0,0,0,0,0,0,0,0,0,0,0,0,0,0,0,0,0,0,0,0,17951
5581,167,63,50,35,16,3,5,0,0,0,0,0,0,0,0,0,0,0,0,0,0,5,5,3,0,2,0,0,0,0,0,0,0,0,0,17952
5582,365,78,188,75,19,5,17,7,7,0,0,7,0,0,0,0,0,0,0,0,0,10,10,10,0,0,0,0,0,0,0,0,0,0,0,17953
5583,3019,364,1626,686,200,143,230,135,68,13,8,47,67,67,59,8,0,0,0,0,0,95,95,15,0,80,0,0,0,0,0,0,0,0,0,17954
5584,226,23,122,43,25,13,9,9,5,0,0,5,4,4,4,0,0,0,0,0,0,0,0,0,0,0,0,0,0,0,0,0,0,0,0,17957
5585,1057,141,590,215,90,21,65,28,28,11,0,17,0,0,0,0,0,0,0,0,0,37,31,10,0,21,6,6,6,0,0,0,0,0,0,17959
5586,2885,242,1455,742,324,122,170,90,84,11,20,53,6,4,4,0,0,2,2,0,0,80,80,47,1,32,0,0,0,0,0,0,0,0,0,17960
5587,5302,546,1779,1375,864,738,303,119,100,38,0,62,19,14,2,12,0,5,5,0,0,184,178,58,5,115,6,6,4,0,2,0,0,0,0,17961
5588,6730,945,3299,1729,575,182,521,264,219,16,12,191,45,41,25,7,9,4,4,0,0,257,256,47,25,184,1,0,0,0,0,1,0,0,1,17963
5589,504,51,278,90,47,38,44,22,20,9,2,9,2,2,2,0,0,0,0,0,0,22,22,13,0,9,0,0,0,0,0,0,0,0,0,17964
5590,1479,191,732,406,109,41,91,77,77,33,0,44,0,0,0,0,0,0,0,0,0,14,14,12,2,0,0,0,0,0,0,0,0,0,0,17965
5591,1801,173,929,432,162,105,107,49,33,15,0,18,16,16,3,13,0,0,0,0,0,58,58,8,14,36,0,0,0,0,0,0,0,0,0,17967
5592,215,45,113,34,23,0,13,10,7,0,0,7,3,3,3,0,0,0,0,0,0,3,3,2,0,1,0,0,0,0,0,0,0,0,0,17968
5593,2442,454,1245,525,184,34,133,71,62,15,20,27,9,0,0,0,0,9,0,0,9,62,62,4,20,38,0,0,0,0,0,0,0,0,0,17970
5594,7716,1038,3745,1741,752,440,505,325,246,89,20,137,79,79,33,46,0,0,0,0,0,180,166,62,0,104,14,14,0,10,4,0,0,0,0,17972
5595,192,33,119,19,0,21,18,0,0,0,0,0,0,0,0,0,0,0,0,0,0,18,18,0,0,18,0,0,0,0,0,0,0,0,0,17974
5596,4714,978,2587,790,218,141,406,301,165,13,0,152,136,136,62,54,20,0,0,0,0,105,74,11,0,63,31,4,0,0,4,27,0,0,27,17976
5597,123,26,48,41,6,2,8,6,3,0,0,3,3,3,3,0,0,0,0,0,0,2,2,0,0,2,0,0,0,0,0,0,0,0,0,17978
5598,88,0,77,0,11,0,0,0,0,0,0,0,0,0,0,0,0,0,0,0,0,0,0,0,0,0,0,0,0,0,0,0,0,0,0,17979
5599,2243,276,1147,548,176,96,109,56,50,3,19,28,6,6,6,0,0,0,0,0,0,53,52,22,0,30,1,1,1,0,0,0,0,0,0,17980
5600,1975,381,1193,304,66,31,108,72,60,14,6,40,12,6,6,0,0,6,0,3,3,36,22,7,0,15,14,11,8,0,3,3,3,0,0,17981
5601,328,44,145,108,28,3,10,7,7,0,0,7,0,0,0,0,0,0,0,0,0,3,3,0,0,3,0,0,0,0,0,0,0,0,0,17982
5602,1128,263,574,181,85,25,42,22,14,6,0,8,8,8,8,0,0,0,0,0,0,20,13,13,0,0,7,7,7,0,0,0,0,0,0,17983
5603,905,108,420,240,86,51,40,19,14,4,0,10,5,0,0,0,0,5,0,0,5,21,16,8,0,8,5,5,0,0,5,0,0,0,0,17985
5604,3864,340,1391,924,762,447,230,101,76,44,11,21,25,23,10,13,0,2,2,0,0,129,115,40,0,75,14,11,3,0,8,3,3,0,0,18011
5605,12796,1563,5733,3380,1437,683,922,524,471,143,115,213,53,53,39,2,12,0,0,0,0,398,329,123,3,203,69,49,46,0,3,20,0,0,20,18013
5606,8341,1154,3592,2116,1016,463,377,220,200,31,41,128,20,20,20,0,0,0,0,0,0,157,149,45,18,86,8,0,0,0,0,8,0,8,0,18014
5607,18716,3440,6206,4419,2418,2233,3658,2111,1968,279,78,1611,143,134,69,10,55,9,0,0,9,1547,1419,123,46,1250,128,97,73,0,24,31,0,0,31,18015
5608,0,0,0,0,0,0,0,0,0,0,0,0,0,0,0,0,0,0,0,0,0,0,0,0,0,0,0,0,0,0,0,0,0,0,0,18016
5609,26984,2894,7796,7047,5588,3659,1636,684,660,150,111,399,24,19,4,15,0,5,0,0,5,952,862,398,94,370,90,90,83,7,0,0,0,0,0,18017
5610,22295,2335,7719,6260,3642,2339,2592,1454,1286,337,122,827,168,121,47,63,11,47,9,0,38,1138,1010,290,66,654,128,121,51,0,70,7,7,0,0,18018
5611,14493,1310,4094,4183,3169,1737,1134,550,461,191,49,221,89,49,40,0,9,40,40,0,0,584,509,180,51,278,75,75,48,0,27,0,0,0,0,18020
5612,483,60,237,104,52,30,8,6,6,6,0,0,0,0,0,0,0,0,0,0,0,2,2,0,0,2,0,0,0,0,0,0,0,0,0,18030
5613,5107,221,1510,1310,1149,917,207,154,154,61,40,53,0,0,0,0,0,0,0,0,0,53,46,10,0,36,7,7,7,0,0,0,0,0,0,18031
5614,6761,793,3123,1469,961,415,362,230,121,44,12,65,109,94,56,38,0,15,15,0,0,132,120,10,22,88,12,0,0,0,0,12,12,0,0,18032
5615,4925,158,1300,1059,1477,931,928,412,397,150,22,225,15,15,0,15,0,0,0,0,0,516,516,242,24,250,0,0,0,0,0,0,0,0,0,18034
5616,127,14,28,32,47,6,0,0,0,0,0,0,0,0,0,0,0,0,0,0,0,0,0,0,0,0,0,0,0,0,0,0,0,0,0,18035
5617,8977,702,3127,1829,1872,1447,722,385,347,137,19,191,38,38,29,0,9,0,0,0,0,337,268,134,20,114,69,36,0,14,22,33,33,0,0,18036
5618,5329,535,2065,1502,857,370,240,117,117,74,16,27,0,0,0,0,0,0,0,0,0,123,110,45,30,35,13,13,13,0,0,0,0,0,0,18037
5619,2006,270,824,492,313,107,173,88,75,45,14,16,13,13,0,0,13,0,0,0,0,85,85,71,14,0,0,0,0,0,0,0,0,0,0,18038
5620,11044,592,3093,3314,2506,1539,512,250,203,81,20,102,47,36,3,2,31,11,0,0,11,262,214,70,0,144,48,48,0,48,0,0,0,0,0,18040
5621,3706,297,1561,1048,533,267,306,150,140,52,12,76,10,10,10,0,0,0,0,0,0,156,93,23,13,57,63,63,8,55,0,0,0,0,0,18041
5622,26952,4234,10537,7169,3110,1902,3282,1647,1393,170,122,1101,254,184,104,0,80,70,10,38,22,1635,1485,275,49,1161,150,106,13,21,72,44,0,0,44,18042
5623,18896,1235,6284,5100,3734,2543,922,520,508,213,41,254,12,6,6,0,0,6,0,0,6,402,365,123,7,235,37,37,18,0,19,0,0,0,0,18045
5624,0,0,0,0,0,0,0,0,0,0,0,0,0,0,0,0,0,0,0,0,0,0,0,0,0,0,0,0,0,0,0,0,0,0,0,18046
5625,12386,1022,3979,3102,2668,1615,748,342,279,44,26,209,63,46,22,9,15,17,0,0,17,406,368,103,58,207,38,38,3,12,23,0,0,0,0,18049
5626,2528,80,498,544,824,582,150,101,86,25,18,43,15,15,7,0,8,0,0,0,0,49,49,23,16,10,0,0,0,0,0,0,0,0,0,18051
5627,19496,2428,6781,5544,3130,1613,1089,662,563,55,78,430,99,86,86,0,0,13,0,0,13,427,363,135,38,190,64,53,13,40,0,11,0,0,11,18052
5628,1806,102,786,523,328,67,157,108,90,23,0,67,18,18,0,18,0,0,0,0,0,49,49,0,0,49,0,0,0,0,0,0,0,0,0,18053
5629,3039,210,1233,884,510,202,209,102,92,47,0,45,10,2,2,0,0,8,0,0,8,107,77,42,7,28,30,30,11,5,14,0,0,0,0,18054
5630,9144,807,3034,2336,1836,1131,390,234,220,85,26,109,14,8,8,0,0,6,0,0,6,156,131,49,18,64,25,25,14,11,0,0,0,0,0,18055
5631,577,88,345,130,14,0,34,26,26,0,0,26,0,0,0,0,0,0,0,0,0,8,8,0,0,8,0,0,0,0,0,0,0,0,0,18056
5632,7066,944,2946,2019,761,396,432,303,207,53,36,118,96,96,73,23,0,0,0,0,0,129,113,47,21,45,16,16,16,0,0,0,0,0,0,18058
5633,705,30,187,184,167,137,172,41,32,0,0,32,9,0,0,0,0,9,0,0,9,131,131,54,41,36,0,0,0,0,0,0,0,0,0,18059
5634,16757,1226,4272,4030,4294,2935,1268,646,578,174,41,363,68,49,15,0,34,19,19,0,0,622,550,168,31,351,72,48,48,0,0,24,0,0,24,18062
5635,516,43,232,216,25,0,53,0,0,0,0,0,0,0,0,0,0,0,0,0,0,53,16,16,0,0,37,37,37,0,0,0,0,0,0,18063
5636,17058,1728,5758,4445,3532,1595,1141,634,590,238,50,302,44,33,33,0,0,11,11,0,0,507,476,192,70,214,31,22,9,13,0,9,0,0,9,18064
5637,4185,264,1543,1196,720,462,303,85,85,29,17,39,0,0,0,0,0,0,0,0,0,218,192,60,6,126,26,21,21,0,0,5,0,0,5,18066
5638,13070,1275,5304,3751,1657,1083,937,458,433,95,63,275,25,25,25,0,0,0,0,0,0,479,431,196,57,178,48,48,48,0,0,0,0,0,0,18067
5639,47,0,47,0,0,0,56,0,0,0,0,0,0,0,0,0,0,0,0,0,0,56,56,0,0,56,0,0,0,0,0,0,0,0,0,18068
5640,5594,442,1503,1374,1289,986,509,295,281,50,48,183,14,14,14,0,0,0,0,0,0,214,174,37,16,121,40,40,0,0,40,0,0,0,0,18069
5641,583,45,308,174,12,44,45,0,0,0,0,0,0,0,0,0,0,0,0,0,0,45,45,28,0,17,0,0,0,0,0,0,0,0,0,18070
5642,7665,1282,3642,1765,637,339,496,296,264,62,79,123,32,17,17,0,0,15,0,15,0,200,183,130,0,53,17,17,0,0,17,0,0,0,0,18071
5643,4477,596,1762,1350,603,166,254,105,96,60,0,36,9,2,2,0,0,7,0,7,0,149,131,36,21,74,18,0,0,0,0,18,18,0,0,18072
5644,6516,554,2261,1722,1207,772,465,248,217,30,26,161,31,20,9,0,11,11,0,0,11,217,188,74,11,103,29,29,29,0,0,0,0,0,0,18073
5645,4240,415,1743,1123,642,317,416,254,237,106,28,103,17,8,8,0,0,9,0,9,0,162,155,90,19,46,7,7,7,0,0,0,0,0,0,18074
5646,1982,284,743,406,392,157,138,66,55,18,23,14,11,5,5,0,0,6,0,0,6,72,56,9,8,39,16,13,0,13,0,3,3,0,0,18076
5647,1710,124,649,381,311,245,103,38,24,7,0,17,14,14,0,0,14,0,0,0,0,65,65,3,4,58,0,0,0,0,0,0,0,0,0,18077
5648,5052,449,1625,1112,1047,819,262,129,129,57,7,65,0,0,0,0,0,0,0,0,0,133,120,14,4,102,13,13,5,0,8,0,0,0,0,18078
5649,196,0,184,12,0,0,39,0,0,0,0,0,0,0,0,0,0,0,0,0,0,39,39,32,0,7,0,0,0,0,0,0,0,0,0,18079
5650,8403,1099,3721,2224,947,412,534,339,275,56,30,189,64,64,64,0,0,0,0,0,0,195,195,80,0,115,0,0,0,0,0,0,0,0,0,18080
5651,233,82,13,100,38,0,0,0,0,0,0,0,0,0,0,0,0,0,0,0,0,0,0,0,0,0,0,0,0,0,0,0,0,0,0,18081
5652,388,56,146,101,64,21,16,12,12,12,0,0,0,0,0,0,0,0,0,0,0,4,4,0,0,4,0,0,0,0,0,0,0,0,0,18083
5653,697,39,279,144,163,72,44,39,35,14,2,19,4,4,0,0,4,0,0,0,0,5,2,0,0,2,3,3,3,0,0,0,0,0,0,18085
5654,393,28,103,36,105,121,48,14,14,0,0,14,0,0,0,0,0,0,0,0,0,34,34,0,0,34,0,0,0,0,0,0,0,0,0,18086
5655,497,109,236,25,38,89,9,0,0,0,0,0,0,0,0,0,0,0,0,0,0,9,9,0,0,9,0,0,0,0,0,0,0,0,0,18087
5656,6159,815,2579,1623,836,306,446,279,278,127,33,118,1,0,0,0,0,1,0,0,1,167,158,24,16,118,9,9,9,0,0,0,0,0,0,18088
5657,4282,622,1836,1197,427,200,321,112,99,12,21,66,13,13,13,0,0,0,0,0,0,209,173,20,0,153,36,26,26,0,0,10,0,0,10,18091
5658,2359,189,809,580,490,291,182,72,58,11,0,47,14,14,0,14,0,0,0,0,0,110,110,15,12,83,0,0,0,0,0,0,0,0,0,18092
5659,3150,1034,1133,715,203,65,321,230,159,46,53,60,71,56,22,0,34,15,0,0,15,91,31,5,0,26,60,35,0,0,35,25,18,0,7,18101
5660,26386,8261,9919,5812,1808,586,3262,1699,1197,224,283,690,502,212,119,10,83,290,73,89,128,1563,1123,265,309,549,440,231,121,97,13,209,72,30,107,18102
5661,32481,5343,10675,8778,4897,2788,2617,1292,1029,317,171,541,263,250,79,171,0,13,0,0,13,1325,1134,361,153,620,191,128,64,17,47,63,20,0,43,18103
5662,30490,2427,9247,7172,6460,5184,3017,1383,1305,383,138,784,78,67,19,15,33,11,0,0,11,1634,1619,672,146,801,15,15,15,0,0,0,0,0,0,18104
5663,67,17,22,16,12,0,0,0,0,0,0,0,0,0,0,0,0,0,0,0,0,0,0,0,0,0,0,0,0,0,0,0,0,0,0,18105
5664,4980,460,1522,1158,966,874,298,117,117,0,7,110,0,0,0,0,0,0,0,0,0,181,170,76,19,75,11,11,0,11,0,0,0,0,0,18106
5665,10780,2087,4259,2893,1072,469,615,405,271,45,41,185,134,29,12,0,17,105,42,63,0,210,183,68,61,54,27,9,0,9,0,18,0,0,18,18109
5666,0,0,0,0,0,0,0,0,0,0,0,0,0,0,0,0,0,0,0,0,0,0,0,0,0,0,0,0,0,0,0,0,0,0,0,18195
5667,17781,3867,7876,4035,1395,608,1777,893,677,128,61,488,216,134,49,0,85,82,40,0,42,884,676,177,42,457,208,118,7,73,38,90,0,19,71,18201
5668,7607,1463,3403,1768,586,387,1065,588,537,67,69,401,51,51,29,9,13,0,0,0,0,477,444,165,13,266,33,11,0,5,6,22,22,0,0,18202
5669,5025,581,1995,1585,518,346,368,146,120,20,19,81,26,26,26,0,0,0,0,0,0,222,151,51,0,100,71,71,0,0,71,0,0,0,0,18210
5670,967,30,550,239,53,95,66,11,11,0,0,11,0,0,0,0,0,0,0,0,0,55,55,0,36,19,0,0,0,0,0,0,0,0,0,18211
5671,101,13,72,8,0,8,20,9,9,0,0,9,0,0,0,0,0,0,0,0,0,11,0,0,0,0,11,11,11,0,0,0,0,0,0,18212
5672,1699,183,641,484,249,142,40,21,21,0,7,14,0,0,0,0,0,0,0,0,0,19,19,2,8,9,0,0,0,0,0,0,0,0,0,18214
5673,786,49,504,152,69,12,26,20,13,0,0,13,7,7,7,0,0,0,0,0,0,6,6,0,3,3,0,0,0,0,0,0,0,0,0,18216
5674,1658,233,770,462,110,83,77,31,25,6,0,19,6,0,0,0,0,6,0,6,0,46,12,0,0,12,34,34,34,0,0,0,0,0,0,18218
5675,1087,14,335,389,164,185,58,50,50,21,0,29,0,0,0,0,0,0,0,0,0,8,8,8,0,0,0,0,0,0,0,0,0,0,0,18219
5676,272,13,146,96,14,3,19,16,16,9,0,7,0,0,0,0,0,0,0,0,0,3,3,0,0,3,0,0,0,0,0,0,0,0,0,18220
5677,377,13,270,64,30,0,34,34,34,0,0,34,0,0,0,0,0,0,0,0,0,0,0,0,0,0,0,0,0,0,0,0,0,0,0,18221
5678,6837,532,2566,1889,1108,742,389,225,148,29,11,108,77,55,17,37,1,22,22,0,0,164,160,58,0,102,4,4,4,0,0,0,0,0,0,18222
5679,122,31,56,35,0,0,0,0,0,0,0,0,0,0,0,0,0,0,0,0,0,0,0,0,0,0,0,0,0,0,0,0,0,0,0,18223
5680,4095,387,2039,1053,483,133,310,185,118,44,0,74,67,58,53,5,0,9,0,0,9,125,120,66,0,54,5,0,0,0,0,5,0,0,5,18224
5681,43,0,43,0,0,0,0,0,0,0,0,0,0,0,0,0,0,0,0,0,0,0,0,0,0,0,0,0,0,0,0,0,0,0,0,18225
5682,6788,585,2918,1860,987,438,463,261,252,48,0,204,9,9,9,0,0,0,0,0,0,202,177,87,19,71,25,11,11,0,0,14,0,0,14,18229
5683,53,12,21,13,4,3,0,0,0,0,0,0,0,0,0,0,0,0,0,0,0,0,0,0,0,0,0,0,0,0,0,0,0,0,0,18230
5684,480,50,223,152,43,12,20,8,8,0,8,0,0,0,0,0,0,0,0,0,0,12,12,0,12,0,0,0,0,0,0,0,0,0,0,18231
5685,2853,399,1542,669,130,113,81,0,0,0,0,0,0,0,0,0,0,0,0,0,0,81,81,0,0,81,0,0,0,0,0,0,0,0,0,18232
5686,304,40,57,108,63,36,0,0,0,0,0,0,0,0,0,0,0,0,0,0,0,0,0,0,0,0,0,0,0,0,0,0,0,0,0,18234
5687,13925,1926,6175,3651,1201,972,906,445,338,67,45,226,107,105,39,1,65,2,2,0,0,461,375,92,31,252,86,53,37,16,0,33,0,33,0,18235
5688,2621,413,1359,588,154,107,226,124,104,31,23,50,20,20,8,12,0,0,0,0,0,102,87,59,0,28,15,0,0,0,0,15,0,0,15,18237
5689,281,50,158,52,21,0,0,0,0,0,0,0,0,0,0,0,0,0,0,0,0,0,0,0,0,0,0,0,0,0,0,0,0,0,0,18239
5690,3020,420,1246,792,349,213,137,81,76,19,0,57,5,5,0,0,5,0,0,0,0,56,56,31,0,25,0,0,0,0,0,0,0,0,0,18240
5691,556,157,290,87,22,0,63,19,19,8,0,11,0,0,0,0,0,0,0,0,0,44,44,35,0,9,0,0,0,0,0,0,0,0,0,18241
5692,150,27,65,41,17,0,7,7,7,4,0,3,0,0,0,0,0,0,0,0,0,0,0,0,0,0,0,0,0,0,0,0,0,0,0,18242
5693,327,39,190,68,16,14,24,13,8,0,0,8,5,5,5,0,0,0,0,0,0,11,9,0,0,9,2,2,0,0,2,0,0,0,0,18244
5694,385,22,250,67,0,46,44,0,0,0,0,0,0,0,0,0,0,0,0,0,0,44,44,20,0,24,0,0,0,0,0,0,0,0,0,18245
5695,117,19,61,29,8,0,4,0,0,0,0,0,0,0,0,0,0,0,0,0,0,4,4,4,0,0,0,0,0,0,0,0,0,0,0,18246
5696,415,34,215,109,39,18,14,14,14,0,0,14,0,0,0,0,0,0,0,0,0,0,0,0,0,0,0,0,0,0,0,0,0,0,0,18248
5697,2674,91,857,721,716,289,111,73,64,7,0,57,9,9,9,0,0,0,0,0,0,38,38,17,0,21,0,0,0,0,0,0,0,0,0,18249
5698,2086,217,972,582,247,68,82,31,17,17,0,0,14,14,0,14,0,0,0,0,0,51,36,0,0,36,15,15,0,0,15,0,0,0,0,18250
5699,108,0,79,26,3,0,0,0,0,0,0,0,0,0,0,0,0,0,0,0,0,0,0,0,0,0,0,0,0,0,0,0,0,0,0,18251
5700,8165,1137,3362,2261,865,540,484,254,224,106,0,118,30,11,11,0,0,19,3,10,6,230,223,95,32,96,7,0,0,0,0,7,4,0,3,18252
5701,602,46,314,180,45,17,36,33,33,4,12,17,0,0,0,0,0,0,0,0,0,3,3,3,0,0,0,0,0,0,0,0,0,0,0,18254
5702,3282,263,1709,918,272,120,203,121,95,8,6,81,26,26,14,8,4,0,0,0,0,82,73,18,0,55,9,9,9,0,0,0,0,0,0,18255
5703,314,22,214,25,53,0,0,0,0,0,0,0,0,0,0,0,0,0,0,0,0,0,0,0,0,0,0,0,0,0,0,0,0,0,0,18256
5704,17088,1908,5953,4323,2830,2074,2768,1371,1307,357,201,749,64,43,36,7,0,21,21,0,0,1397,1352,366,130,856,45,45,28,17,0,0,0,0,0,18301
5705,11493,1057,3934,4025,1598,879,1260,719,668,203,139,326,51,29,15,0,14,22,0,21,1,541,422,47,96,279,119,45,17,28,0,74,0,0,74,18302
5706,1331,72,559,375,143,182,118,80,18,0,0,18,62,62,62,0,0,0,0,0,0,38,38,14,24,0,0,0,0,0,0,0,0,0,0,18321
5707,1944,188,715,726,236,79,121,17,8,8,0,0,9,9,9,0,0,0,0,0,0,104,92,40,23,29,12,12,12,0,0,0,0,0,0,18322
5708,49,0,9,8,17,15,0,0,0,0,0,0,0,0,0,0,0,0,0,0,0,0,0,0,0,0,0,0,0,0,0,0,0,0,0,18323
5709,6681,812,2316,2266,814,473,697,333,333,30,107,196,0,0,0,0,0,0,0,0,0,364,352,98,0,254,12,12,12,0,0,0,0,0,0,18324
5710,1931,113,746,691,257,124,151,22,22,0,0,22,0,0,0,0,0,0,0,0,0,129,61,35,26,0,68,68,68,0,0,0,0,0,0,18325
5711,3288,215,1140,901,770,262,256,209,209,119,0,90,0,0,0,0,0,0,0,0,0,47,47,0,0,47,0,0,0,0,0,0,0,0,0,18326
5712,433,43,121,80,141,48,45,16,16,0,0,16,0,0,0,0,0,0,0,0,0,29,14,14,0,0,15,15,15,0,0,0,0,0,0,18327
5713,5108,725,1982,1683,503,215,422,216,158,63,15,80,58,25,0,25,0,33,0,0,33,206,206,89,19,98,0,0,0,0,0,0,0,0,0,18328
5714,5577,257,2396,1613,825,486,471,104,104,37,0,67,0,0,0,0,0,0,0,0,0,367,355,176,0,179,12,0,0,0,0,12,0,0,12,18330
5715,902,170,366,245,93,28,46,46,46,0,22,24,0,0,0,0,0,0,0,0,0,0,0,0,0,0,0,0,0,0,0,0,0,0,0,18331
5716,2007,144,958,549,281,75,195,96,96,0,24,72,0,0,0,0,0,0,0,0,0,99,99,23,42,34,0,0,0,0,0,0,0,0,0,18332
5717,335,65,127,109,34,0,105,70,70,0,35,35,0,0,0,0,0,0,0,0,0,35,35,0,0,35,0,0,0,0,0,0,0,0,0,18333
5718,2445,203,1047,730,339,126,450,238,238,10,68,160,0,0,0,0,0,0,0,0,0,212,192,53,11,128,20,20,0,0,20,0,0,0,0,18334
5719,420,166,29,201,24,0,0,0,0,0,0,0,0,0,0,0,0,0,0,0,0,0,0,0,0,0,0,0,0,0,0,0,0,0,0,18335
5720,2860,232,1075,829,472,252,286,112,105,30,4,71,7,7,0,7,0,0,0,0,0,174,174,49,18,107,0,0,0,0,0,0,0,0,0,18336
5721,10011,745,3607,3421,1363,875,983,461,450,95,69,286,11,8,8,0,0,3,0,3,0,522,457,106,40,311,65,65,16,0,49,0,0,0,0,18337
5722,97,10,37,13,20,17,22,0,0,0,0,0,0,0,0,0,0,0,0,0,0,22,22,7,0,15,0,0,0,0,0,0,0,0,0,18340
5723,272,74,158,22,18,0,43,0,0,0,0,0,0,0,0,0,0,0,0,0,0,43,43,0,0,43,0,0,0,0,0,0,0,0,0,18342
5724,2901,375,978,910,416,222,127,62,44,13,0,31,18,18,0,18,0,0,0,0,0,65,65,26,0,39,0,0,0,0,0,0,0,0,0,18343
5725,2359,309,755,633,430,232,347,152,138,0,0,138,14,0,0,0,0,14,0,0,14,195,195,129,0,66,0,0,0,0,0,0,0,0,0,18344
5726,1853,117,961,489,218,68,116,33,19,0,19,0,14,14,0,14,0,0,0,0,0,83,83,0,10,73,0,0,0,0,0,0,0,0,0,18346
5727,1762,143,669,494,192,264,113,97,78,49,0,29,19,19,19,0,0,0,0,0,0,16,16,0,16,0,0,0,0,0,0,0,0,0,0,18347
5728,226,32,36,52,80,26,0,0,0,0,0,0,0,0,0,0,0,0,0,0,0,0,0,0,0,0,0,0,0,0,0,0,0,0,0,18349
5729,1365,157,370,560,176,102,201,161,110,0,45,65,51,51,51,0,0,0,0,0,0,40,40,0,40,0,0,0,0,0,0,0,0,0,0,18350
5730,391,19,162,108,53,49,26,6,6,0,0,6,0,0,0,0,0,0,0,0,0,20,20,8,0,12,0,0,0,0,0,0,0,0,0,18351
5731,929,227,296,197,178,31,68,44,0,0,0,0,44,44,0,0,44,0,0,0,0,24,24,0,0,24,0,0,0,0,0,0,0,0,0,18352
5732,8750,1000,3733,2399,963,655,766,378,325,112,39,174,53,45,14,0,31,8,0,0,8,388,356,154,0,202,32,32,0,32,0,0,0,0,0,18353
5733,493,60,136,104,150,43,0,0,0,0,0,0,0,0,0,0,0,0,0,0,0,0,0,0,0,0,0,0,0,0,0,0,0,0,0,18354
5734,945,135,270,303,148,89,24,19,19,0,11,8,0,0,0,0,0,0,0,0,0,5,5,0,0,5,0,0,0,0,0,0,0,0,0,18355
5735,219,0,0,168,51,0,0,0,0,0,0,0,0,0,0,0,0,0,0,0,0,0,0,0,0,0,0,0,0,0,0,0,0,0,0,18356
5736,213,43,29,61,80,0,0,0,0,0,0,0,0,0,0,0,0,0,0,0,0,0,0,0,0,0,0,0,0,0,0,0,0,0,0,18357
5737,20004,1925,6868,5196,3876,2139,1524,717,529,200,118,211,188,123,48,28,47,65,55,9,1,807,754,271,107,376,53,53,17,0,36,0,0,0,0,18360
5738,666,8,262,225,137,34,27,12,12,12,0,0,0,0,0,0,0,0,0,0,0,15,15,0,0,15,0,0,0,0,0,0,0,0,0,18370
5739,410,14,108,176,62,50,77,32,32,0,0,32,0,0,0,0,0,0,0,0,0,45,45,45,0,0,0,0,0,0,0,0,0,0,0,18371
5740,2165,174,594,654,419,324,81,36,36,0,0,36,0,0,0,0,0,0,0,0,0,45,36,13,0,23,9,9,9,0,0,0,0,0,0,18372
5741,5178,526,1983,1189,934,546,310,173,164,80,6,78,9,0,0,0,0,9,0,9,0,137,137,77,28,32,0,0,0,0,0,0,0,0,0,18403
5742,1791,280,647,603,133,128,182,140,130,89,0,41,10,10,10,0,0,0,0,0,0,42,35,24,0,11,7,7,6,0,1,0,0,0,0,18405
5743,9983,1215,4642,2386,1118,622,582,320,289,131,28,130,31,27,14,0,13,4,0,0,4,262,191,74,47,70,71,26,14,12,0,45,0,0,45,18407
5744,15301,624,3455,3885,4134,3203,1214,499,472,127,42,303,27,11,0,7,4,16,7,0,9,715,674,271,16,387,41,29,15,9,5,12,0,0,12,18411
5745,105,7,34,10,37,17,24,24,24,24,0,0,0,0,0,0,0,0,0,0,0,0,0,0,0,0,0,0,0,0,0,0,0,0,0,18413
5746,3955,234,1353,855,920,593,241,161,132,33,4,95,29,16,10,3,3,13,0,0,13,80,73,21,5,47,7,7,7,0,0,0,0,0,0,18414
5747,945,152,342,211,133,107,13,13,13,4,0,9,0,0,0,0,0,0,0,0,0,0,0,0,0,0,0,0,0,0,0,0,0,0,0,18415
5748,937,165,427,177,112,56,30,28,28,17,0,11,0,0,0,0,0,0,0,0,0,2,2,0,0,2,0,0,0,0,0,0,0,0,0,18417
5749,3050,258,1329,663,501,299,423,159,159,89,5,65,0,0,0,0,0,0,0,0,0,264,251,67,12,172,13,2,0,2,0,11,7,0,4,18419
5750,38,3,22,13,0,0,0,0,0,0,0,0,0,0,0,0,0,0,0,0,0,0,0,0,0,0,0,0,0,0,0,0,0,0,0,18420
5751,3342,344,1746,735,339,178,213,140,121,49,9,63,19,16,4,12,0,3,0,0,3,73,73,31,0,42,0,0,0,0,0,0,0,0,0,18421
5752,3720,445,1599,1004,367,305,195,127,105,21,4,80,22,8,4,0,4,14,14,0,0,68,68,27,9,32,0,0,0,0,0,0,0,0,0,18424
5753,944,138,360,274,111,61,88,36,26,0,0,26,10,10,10,0,0,0,0,0,0,52,52,0,0,52,0,0,0,0,0,0,0,0,0,18425
5754,3349,132,1631,826,431,329,143,98,72,0,9,63,26,26,11,15,0,0,0,0,0,45,45,45,0,0,0,0,0,0,0,0,0,0,0,18426
5755,108,13,53,42,0,0,0,0,0,0,0,0,0,0,0,0,0,0,0,0,0,0,0,0,0,0,0,0,0,0,0,0,0,0,0,18427
5756,8878,803,3274,2644,1224,933,545,309,236,57,31,148,73,17,2,9,6,56,0,11,45,236,194,94,8,92,42,14,7,0,7,28,0,0,28,18428
5757,17,11,3,3,0,0,0,0,0,0,0,0,0,0,0,0,0,0,0,0,0,0,0,0,0,0,0,0,0,0,0,0,0,0,0,18430
5758,9268,1235,3880,2202,1193,758,810,423,344,86,8,250,79,66,39,7,20,13,0,0,13,387,313,116,30,167,74,41,32,3,6,33,9,0,24,18431
5759,4990,445,2210,1217,706,412,338,173,153,55,4,94,20,17,14,3,0,3,0,0,3,165,161,16,11,134,4,4,4,0,0,0,0,0,0,18433
5760,2895,293,1223,680,480,219,256,125,89,47,0,42,36,27,27,0,0,9,0,0,9,131,131,99,0,32,0,0,0,0,0,0,0,0,0,18434
5761,465,0,136,170,70,89,136,86,42,42,0,0,44,44,0,44,0,0,0,0,0,50,34,0,0,34,16,16,16,0,0,0,0,0,0,18435
5762,10336,994,3974,2670,1349,1349,699,385,346,73,40,233,39,10,3,0,7,29,20,0,9,314,261,43,28,190,53,9,9,0,0,44,0,0,44,18436
5763,155,13,69,40,10,23,8,8,8,0,0,8,0,0,0,0,0,0,0,0,0,0,0,0,0,0,0,0,0,0,0,0,0,0,0,18437
5764,790,62,303,199,85,141,61,11,11,0,0,11,0,0,0,0,0,0,0,0,0,50,50,0,0,50,0,0,0,0,0,0,0,0,0,18438
5765,330,15,141,110,35,29,12,7,5,0,0,5,2,2,2,0,0,0,0,0,0,5,5,0,0,5,0,0,0,0,0,0,0,0,0,18439
5766,205,21,118,47,15,4,48,23,23,0,0,23,0,0,0,0,0,0,0,0,0,25,25,14,0,11,0,0,0,0,0,0,0,0,0,18441
5767,314,34,144,88,28,20,0,0,0,0,0,0,0,0,0,0,0,0,0,0,0,0,0,0,0,0,0,0,0,0,0,0,0,0,0,18443
5768,9830,783,3669,2809,1418,1151,743,463,368,138,29,201,95,74,40,15,19,21,21,0,0,280,268,154,9,105,12,10,8,0,2,2,0,0,2,18444
5769,1493,109,570,441,251,122,153,94,64,20,0,44,30,30,9,0,21,0,0,0,0,59,51,20,3,28,8,8,3,0,5,0,0,0,0,18445
5770,2738,328,1387,540,331,152,157,45,33,8,0,25,12,12,0,3,9,0,0,0,0,112,98,27,8,63,14,10,10,0,0,4,0,0,4,18446
5771,7659,754,2993,2011,1306,595,495,163,138,31,16,91,25,25,18,7,0,0,0,0,0,332,314,86,14,214,18,0,0,0,0,18,0,0,18,18447
5772,327,0,120,128,56,23,12,0,0,0,0,0,0,0,0,0,0,0,0,0,0,12,12,0,0,12,0,0,0,0,0,0,0,0,0,18451
5773,4017,391,1778,1090,498,260,153,128,117,46,0,71,11,11,11,0,0,0,0,0,0,25,25,0,0,25,0,0,0,0,0,0,0,0,0,18452
5774,855,77,372,233,98,75,37,17,14,0,3,11,3,3,3,0,0,0,0,0,0,20,18,4,0,14,2,2,0,0,2,0,0,0,0,18453
5775,28,0,18,10,0,0,0,0,0,0,0,0,0,0,0,0,0,0,0,0,0,0,0,0,0,0,0,0,0,0,0,0,0,0,0,18454
5776,93,0,28,31,26,8,2,2,2,2,0,0,0,0,0,0,0,0,0,0,0,0,0,0,0,0,0,0,0,0,0,0,0,0,0,18455
5777,316,39,128,88,34,27,19,4,4,0,4,0,0,0,0,0,0,0,0,0,0,15,12,0,0,12,3,3,0,3,0,0,0,0,0,18456
5778,67,21,26,20,0,0,0,0,0,0,0,0,0,0,0,0,0,0,0,0,0,0,0,0,0,0,0,0,0,0,0,0,0,0,0,18457
5779,2173,108,609,804,385,267,196,137,106,68,22,16,31,31,22,3,6,0,0,0,0,59,57,21,0,36,2,2,2,0,0,0,0,0,0,18458
5780,51,8,19,13,8,3,0,0,0,0,0,0,0,0,0,0,0,0,0,0,0,0,0,0,0,0,0,0,0,0,0,0,0,0,0,18459
5781,183,8,43,57,15,60,0,0,0,0,0,0,0,0,0,0,0,0,0,0,0,0,0,0,0,0,0,0,0,0,0,0,0,0,0,18460
5782,276,46,135,74,6,15,12,9,6,0,0,6,3,3,3,0,0,0,0,0,0,3,1,0,0,1,2,2,0,2,0,0,0,0,0,18461
5783,287,58,99,74,33,23,33,11,11,7,0,4,0,0,0,0,0,0,0,0,0,22,19,15,0,4,3,3,0,3,0,0,0,0,0,18462
5784,201,15,141,23,18,4,11,11,0,0,0,0,11,11,6,0,5,0,0,0,0,0,0,0,0,0,0,0,0,0,0,0,0,0,0,18463
5785,837,32,267,247,173,118,84,77,66,12,26,28,11,11,11,0,0,0,0,0,0,7,7,0,0,7,0,0,0,0,0,0,0,0,0,18464
5786,1161,119,532,298,150,62,129,107,101,9,1,91,6,6,6,0,0,0,0,0,0,22,18,12,0,6,4,2,2,0,0,2,0,0,2,18465
5787,10444,1293,3703,3441,1472,535,1624,916,763,66,125,572,153,120,72,35,13,33,0,0,33,708,567,108,131,328,141,130,57,24,49,11,0,0,11,18466
5788,353,16,198,106,18,15,59,24,24,0,0,24,0,0,0,0,0,0,0,0,0,35,26,0,26,0,9,9,9,0,0,0,0,0,0,18469
5789,1633,160,724,387,216,146,82,63,59,24,11,24,4,1,0,1,0,3,3,0,0,19,17,4,0,13,2,2,2,0,0,0,0,0,0,18470
5790,413,0,21,48,194,150,56,29,29,0,0,29,0,0,0,0,0,0,0,0,0,27,27,0,0,27,0,0,0,0,0,0,0,0,0,18471
5791,5956,1067,2794,1576,277,242,308,141,97,29,0,68,44,41,5,11,25,3,0,3,0,167,141,30,4,107,26,9,4,0,5,17,3,0,14,18472
5792,311,56,158,51,26,20,0,0,0,0,0,0,0,0,0,0,0,0,0,0,0,0,0,0,0,0,0,0,0,0,0,0,0,0,0,18473
5793,869,240,326,124,112,67,110,57,50,0,0,50,7,7,0,0,7,0,0,0,0,53,53,0,0,53,0,0,0,0,0,0,0,0,0,18503
5794,14330,1778,6053,3664,1949,886,1129,532,424,170,39,215,108,83,30,46,7,25,9,16,0,597,534,179,56,299,63,54,47,7,0,9,0,0,9,18504
5795,14402,2017,5820,3695,1872,998,870,433,366,141,61,164,67,56,25,11,20,11,0,9,2,437,405,164,5,236,32,7,0,0,7,25,0,25,0,18505
5796,3678,317,1322,911,760,368,95,74,74,24,18,32,0,0,0,0,0,0,0,0,0,21,21,0,0,21,0,0,0,0,0,0,0,0,0,18507
5797,8162,1541,3590,1860,776,395,471,199,164,55,18,91,35,29,29,0,0,6,0,0,6,272,238,122,0,116,34,7,7,0,0,27,0,0,27,18508
5798,8892,1273,2967,2103,1447,1102,892,424,344,99,11,234,80,22,14,0,8,58,0,15,43,468,446,188,0,258,22,8,8,0,0,14,0,0,14,18509
5799,7690,1096,2414,1834,1499,847,1982,925,840,210,13,617,85,12,12,0,0,73,17,13,43,1057,1030,349,13,668,27,14,0,0,14,13,0,0,13,18510
5800,8789,863,3542,2373,1263,748,535,214,214,27,31,156,0,0,0,0,0,0,0,0,0,321,301,134,18,149,20,20,20,0,0,0,0,0,0,18512
5801,3758,556,1621,911,445,225,170,56,44,15,0,29,12,12,12,0,0,0,0,0,0,114,80,19,0,61,34,0,0,0,0,34,0,0,34,18517
5802,6107,547,2417,1769,972,402,404,200,175,92,10,73,25,0,0,0,0,25,0,25,0,204,179,37,11,131,25,25,25,0,0,0,0,0,0,18518
5803,3593,346,1565,1080,426,176,213,71,46,32,0,14,25,15,15,0,0,10,0,0,10,142,124,64,0,60,18,18,18,0,0,0,0,0,0,18519
5804,243,21,41,50,69,62,8,4,4,4,0,0,0,0,0,0,0,0,0,0,0,4,4,0,0,4,0,0,0,0,0,0,0,0,0,18602
5805,14113,2323,6728,3072,1461,529,895,437,361,109,26,226,76,13,1,12,0,63,63,0,0,458,391,156,4,231,67,32,18,10,4,35,35,0,0,18603
5806,3028,431,1518,797,178,104,500,301,221,41,1,179,80,30,0,0,30,50,14,0,36,199,148,53,0,95,51,51,35,0,16,0,0,0,0,18610
5807,12065,926,3873,3396,2297,1573,1408,638,576,189,59,328,62,62,33,23,6,0,0,0,0,770,767,309,51,407,3,1,0,0,1,2,0,0,2,18612
5808,1949,194,1019,513,155,68,187,101,53,11,5,37,48,19,19,0,0,29,0,29,0,86,60,32,0,28,26,24,14,0,10,2,0,0,2,18614
5809,1379,150,689,343,118,79,52,25,21,5,6,10,4,4,4,0,0,0,0,0,0,27,27,5,0,22,0,0,0,0,0,0,0,0,0,18615
5810,460,60,219,120,32,29,4,0,0,0,0,0,0,0,0,0,0,0,0,0,0,4,4,1,0,3,0,0,0,0,0,0,0,0,0,18616
5811,1273,274,692,226,55,26,30,24,24,12,12,0,0,0,0,0,0,0,0,0,0,6,6,6,0,0,0,0,0,0,0,0,0,0,0,18617
5812,2801,302,1045,747,415,292,241,150,145,8,0,137,5,5,5,0,0,0,0,0,0,91,87,61,0,26,4,4,0,0,4,0,0,0,0,18618
5813,140,28,70,27,7,8,4,4,3,0,0,3,1,1,0,0,1,0,0,0,0,0,0,0,0,0,0,0,0,0,0,0,0,0,0,18619
5814,4577,698,2289,1100,298,192,177,123,115,27,14,74,8,8,0,8,0,0,0,0,0,54,49,12,17,20,5,0,0,0,0,5,0,5,0,18621
5815,189,36,118,12,4,19,15,15,0,0,0,0,15,0,0,0,0,15,0,0,15,0,0,0,0,0,0,0,0,0,0,0,0,0,0,18622
5816,1831,299,999,374,127,32,134,65,44,14,0,30,21,13,13,0,0,8,2,0,6,69,52,18,3,31,17,15,10,5,0,2,0,2,0,18623
5817,490,0,173,125,122,70,15,15,15,15,0,0,0,0,0,0,0,0,0,0,0,0,0,0,0,0,0,0,0,0,0,0,0,0,0,18624
5818,337,7,148,98,36,48,23,8,5,5,0,0,3,3,3,0,0,0,0,0,0,15,15,10,0,5,0,0,0,0,0,0,0,0,0,18625
5819,533,80,198,144,44,67,53,33,20,14,3,3,13,13,3,0,10,0,0,0,0,20,20,0,0,20,0,0,0,0,0,0,0,0,0,18626
5820,235,27,123,49,17,19,19,14,7,0,0,7,7,7,7,0,0,0,0,0,0,5,0,0,0,0,5,5,5,0,0,0,0,0,0,18628
5821,1260,168,615,349,89,39,86,72,41,13,0,28,31,24,15,9,0,7,0,7,0,14,12,4,0,8,2,2,2,0,0,0,0,0,0,18629
5822,2244,312,1166,501,155,110,137,39,27,9,0,18,12,12,9,0,3,0,0,0,0,98,86,37,4,45,12,9,9,0,0,3,0,0,3,18630
5823,942,81,530,168,99,64,95,35,35,24,0,11,0,0,0,0,0,0,0,0,0,60,28,0,0,28,32,32,0,0,32,0,0,0,0,18631
5824,342,12,187,127,12,4,0,0,0,0,0,0,0,0,0,0,0,0,0,0,0,0,0,0,0,0,0,0,0,0,0,0,0,0,0,18632
5825,10075,1370,4448,2821,939,497,568,259,209,37,24,148,50,15,14,1,0,35,0,8,27,309,281,82,34,165,28,28,23,5,0,0,0,0,0,18634
5826,2869,392,1478,613,292,94,199,112,93,16,0,77,19,8,5,0,3,11,0,0,11,87,83,34,2,47,4,4,4,0,0,0,0,0,0,18635
5827,1120,104,600,321,60,35,54,40,40,3,0,37,0,0,0,0,0,0,0,0,0,14,9,5,0,4,5,5,1,4,0,0,0,0,0,18636
5828,12567,1561,5022,3572,1521,891,737,321,301,57,12,232,20,11,0,0,11,9,0,0,9,416,293,94,104,95,123,92,42,10,40,31,3,6,22,18640
5829,5393,583,2215,1626,561,408,322,224,208,84,0,124,16,16,0,11,5,0,0,0,0,98,98,74,0,24,0,0,0,0,0,0,0,0,0,18641
5830,2965,186,1228,733,489,329,131,54,45,0,20,25,9,9,0,9,0,0,0,0,0,77,68,11,32,25,9,9,9,0,0,0,0,0,0,18642
5831,9352,792,3237,2843,1591,889,396,181,166,71,0,95,15,15,15,0,0,0,0,0,0,215,170,72,14,84,45,12,0,0,12,33,0,33,0,18643
5832,5371,291,1933,1617,922,608,339,193,183,87,11,85,10,0,0,0,0,10,0,0,10,146,128,57,0,71,18,18,18,0,0,0,0,0,0,18644
5833,6084,914,2758,1628,515,269,350,211,189,48,11,130,22,22,7,0,15,0,0,0,0,139,132,23,29,80,7,7,0,0,7,0,0,0,0,18651
5834,75,12,48,15,0,0,5,5,5,5,0,0,0,0,0,0,0,0,0,0,0,0,0,0,0,0,0,0,0,0,0,0,0,0,0,18653
5835,4593,594,1967,1264,581,187,328,188,161,9,21,131,27,16,7,9,0,11,0,0,11,140,140,71,8,61,0,0,0,0,0,0,0,0,0,18655
5836,1677,147,873,420,120,117,118,49,36,13,5,18,13,8,4,0,4,5,0,0,5,69,57,10,0,47,12,12,3,6,3,0,0,0,0,18656
5837,8654,891,3890,2187,1122,564,697,421,330,86,16,228,91,56,39,5,12,35,13,0,22,276,246,110,14,122,30,18,8,10,0,12,4,0,8,18657
5838,2408,212,1203,634,202,157,133,40,32,19,0,13,8,5,5,0,0,3,0,0,3,93,93,45,17,31,0,0,0,0,0,0,0,0,0,18660
5839,3992,403,1795,1098,491,205,240,163,155,52,18,85,8,0,0,0,0,8,0,0,8,77,70,47,1,22,7,7,7,0,0,0,0,0,0,18661
5840,1081,234,413,176,196,62,1325,614,609,150,12,447,5,0,0,0,0,5,0,5,0,711,711,201,37,473,0,0,0,0,0,0,0,0,0,18701
5841,27160,4017,10341,7663,3341,1798,2367,1218,1077,297,33,747,141,102,37,0,65,39,25,0,14,1149,980,312,37,631,169,105,83,0,22,64,6,8,50,18702
5842,23174,1927,8292,6757,3946,2252,1396,860,809,280,93,436,51,51,13,35,3,0,0,0,0,536,498,108,43,347,38,30,21,0,9,8,0,0,8,18704
5843,10385,1115,4540,2869,1286,575,462,254,187,42,6,139,67,67,30,31,6,0,0,0,0,208,142,65,0,77,66,39,21,0,18,27,27,0,0,18705
5844,11915,1352,5174,3306,1372,711,690,357,305,65,23,217,52,52,39,0,13,0,0,0,0,333,319,122,30,167,14,10,10,0,0,4,0,0,4,18706
5845,11229,465,3371,3422,2220,1751,905,396,379,121,48,210,17,9,7,2,0,8,0,8,0,509,486,263,33,190,23,23,23,0,0,0,0,0,0,18707
5846,7319,579,2350,2027,1285,1078,510,279,258,128,0,130,21,15,15,0,0,6,6,0,0,231,231,90,2,139,0,0,0,0,0,0,0,0,0,18708
5847,2010,302,836,604,179,89,105,67,44,5,4,35,23,0,0,0,0,23,0,0,23,38,30,23,4,3,8,8,8,0,0,0,0,0,0,18709
5848,6268,611,2926,1694,599,438,500,233,186,80,24,82,47,19,19,0,0,28,15,0,13,267,204,79,17,108,63,52,37,2,13,11,3,0,8,18801
5849,4103,368,1923,1125,424,263,272,98,82,15,10,57,16,0,0,0,0,16,0,0,16,174,136,37,14,85,38,38,38,0,0,0,0,0,0,18810
5850,1198,104,349,429,194,122,95,50,40,11,14,15,10,5,5,0,0,5,0,5,0,45,40,13,0,27,5,5,5,0,0,0,0,0,0,18812
5851,88,9,46,21,8,4,0,0,0,0,0,0,0,0,0,0,0,0,0,0,0,0,0,0,0,0,0,0,0,0,0,0,0,0,0,18814
5852,102,9,44,33,6,10,10,0,0,0,0,0,0,0,0,0,0,0,0,0,0,10,10,0,0,10,0,0,0,0,0,0,0,0,0,18816
5853,133,29,37,30,28,9,3,3,3,0,0,3,0,0,0,0,0,0,0,0,0,0,0,0,0,0,0,0,0,0,0,0,0,0,0,18817
5854,989,168,418,237,104,62,58,33,28,11,7,10,5,2,0,2,0,3,3,0,0,25,18,6,0,12,7,4,3,0,1,3,0,0,3,18818
5855,932,121,519,176,61,55,88,72,59,19,0,40,13,6,4,2,0,7,0,7,0,16,12,0,0,12,4,4,4,0,0,0,0,0,0,18821
5856,2435,291,1195,655,195,99,187,91,72,20,0,52,19,0,0,0,0,19,8,11,0,96,69,20,8,41,27,8,8,0,0,19,0,0,19,18822
5857,134,14,90,19,6,5,0,0,0,0,0,0,0,0,0,0,0,0,0,0,0,0,0,0,0,0,0,0,0,0,0,0,0,0,0,18823
5858,925,114,464,207,93,47,84,54,43,18,0,25,11,8,8,0,0,3,3,0,0,30,24,9,4,11,6,6,0,0,6,0,0,0,0,18824
5859,95,15,18,49,9,4,6,3,3,3,0,0,0,0,0,0,0,0,0,0,0,3,0,0,0,0,3,3,0,0,3,0,0,0,0,18825
5860,1255,137,611,287,127,93,42,25,11,11,0,0,14,6,0,3,3,8,2,6,0,17,14,11,0,3,3,3,3,0,0,0,0,0,0,18826
5861,213,43,116,29,14,11,0,0,0,0,0,0,0,0,0,0,0,0,0,0,0,0,0,0,0,0,0,0,0,0,0,0,0,0,0,18828
5862,531,61,232,160,43,35,30,23,23,4,0,19,0,0,0,0,0,0,0,0,0,7,7,0,0,7,0,0,0,0,0,0,0,0,0,18829
5863,666,58,292,196,70,50,26,16,16,0,7,9,0,0,0,0,0,0,0,0,0,10,10,3,0,7,0,0,0,0,0,0,0,0,0,18830
5864,693,114,358,147,51,23,27,18,16,0,0,16,2,0,0,0,0,2,2,0,0,9,9,3,0,6,0,0,0,0,0,0,0,0,0,18831
5865,1258,123,670,290,138,37,94,41,36,14,0,22,5,0,0,0,0,5,0,0,5,53,44,15,0,29,9,4,4,0,0,5,0,0,5,18832
5866,1412,237,810,273,53,39,77,57,42,8,2,32,15,11,0,11,0,4,4,0,0,20,16,2,0,14,4,4,4,0,0,0,0,0,0,18833
5867,2612,173,1312,651,294,182,176,108,92,24,12,56,16,10,10,0,0,6,0,0,6,68,61,8,0,53,7,7,7,0,0,0,0,0,0,18834
5868,2203,336,1089,530,168,80,126,75,56,23,0,33,19,6,1,5,0,13,10,3,0,51,46,12,0,34,5,2,2,0,0,3,0,0,3,18837
5869,8118,817,3278,1931,1272,820,531,234,190,103,0,87,44,0,0,0,0,44,44,0,0,297,262,135,0,127,35,24,0,0,24,11,11,0,0,18840
5870,180,3,89,54,32,2,0,0,0,0,0,0,0,0,0,0,0,0,0,0,0,0,0,0,0,0,0,0,0,0,0,0,0,0,0,18842
5871,120,9,45,12,31,23,0,0,0,0,0,0,0,0,0,0,0,0,0,0,0,0,0,0,0,0,0,0,0,0,0,0,0,0,0,18843
5872,1315,170,585,293,177,90,152,91,86,14,7,65,5,5,5,0,0,0,0,0,0,61,53,15,7,31,8,8,4,4,0,0,0,0,0,18844
5873,254,42,134,39,28,11,7,7,4,0,0,4,3,3,3,0,0,0,0,0,0,0,0,0,0,0,0,0,0,0,0,0,0,0,0,18845
5874,589,42,333,126,77,11,38,14,14,14,0,0,0,0,0,0,0,0,0,0,0,24,24,17,0,7,0,0,0,0,0,0,0,0,0,18846
5875,4157,503,2123,953,349,229,243,126,100,29,6,65,26,22,15,5,2,4,0,4,0,117,103,33,6,64,14,8,0,8,0,6,0,0,6,18847
5876,6385,1021,2835,1216,917,396,544,271,217,81,17,119,54,44,27,11,6,10,0,0,10,273,214,63,28,123,59,54,28,26,0,5,0,0,5,18848
5877,1481,144,764,344,170,59,125,63,44,10,6,28,19,15,10,5,0,4,0,0,4,62,36,9,0,27,26,26,4,0,22,0,0,0,0,18850
5878,627,83,338,132,56,18,17,10,0,0,0,0,10,10,0,10,0,0,0,0,0,7,7,0,0,7,0,0,0,0,0,0,0,0,0,18851
5879,3139,331,1662,607,381,158,191,97,80,26,10,44,17,14,9,0,5,3,0,0,3,94,70,21,5,44,24,13,9,0,4,11,0,0,11,18853
5880,910,189,409,184,78,50,54,39,29,8,0,21,10,7,3,0,4,3,0,0,3,15,15,2,0,13,0,0,0,0,0,0,0,0,0,18854
5881,19763,1134,4568,4591,5749,3721,1680,639,544,242,70,232,95,66,33,18,15,29,3,0,26,1041,1005,513,157,335,36,0,0,0,0,36,0,21,15,18901
5882,13289,358,2566,2290,4599,3476,1399,678,678,244,18,416,0,0,0,0,0,0,0,0,0,721,713,247,29,437,8,0,0,0,0,8,0,0,8,18902
5883,8,0,0,3,5,0,0,0,0,0,0,0,0,0,0,0,0,0,0,0,0,0,0,0,0,0,0,0,0,0,0,0,0,0,0,18912
5884,72,0,5,67,0,0,0,0,0,0,0,0,0,0,0,0,0,0,0,0,0,0,0,0,0,0,0,0,0,0,0,0,0,0,0,18913
5885,14124,487,3236,3561,3939,2901,1240,594,589,210,39,340,5,4,0,4,0,1,0,0,1,646,575,291,31,253,71,71,60,11,0,0,0,0,0,18914
5886,683,42,171,189,123,158,25,25,25,0,0,25,0,0,0,0,0,0,0,0,0,0,0,0,0,0,0,0,0,0,0,0,0,0,0,18915
5887,1528,235,515,319,307,152,119,44,44,7,0,37,0,0,0,0,0,0,0,0,0,75,52,30,0,22,23,23,0,23,0,0,0,0,0,18917
5888,157,11,53,33,18,42,22,22,22,0,0,22,0,0,0,0,0,0,0,0,0,0,0,0,0,0,0,0,0,0,0,0,0,0,0,18920
5889,590,70,117,104,111,188,16,16,16,0,0,16,0,0,0,0,0,0,0,0,0,0,0,0,0,0,0,0,0,0,0,0,0,0,0,18923
5890,4385,164,848,895,1279,1199,228,122,122,69,0,53,0,0,0,0,0,0,0,0,0,106,106,47,27,32,0,0,0,0,0,0,0,0,0,18925
5891,5385,57,1188,1144,1921,1075,502,258,258,94,14,150,0,0,0,0,0,0,0,0,0,244,244,68,18,158,0,0,0,0,0,0,0,0,0,18929
5892,1827,96,592,520,398,221,92,69,35,2,7,26,34,0,0,0,0,34,34,0,0,23,23,8,9,6,0,0,0,0,0,0,0,0,0,18930
5893,326,0,122,84,100,20,6,0,0,0,0,0,0,0,0,0,0,0,0,0,0,6,6,6,0,0,0,0,0,0,0,0,0,0,0,18932
5894,0,0,0,0,0,0,0,0,0,0,0,0,0,0,0,0,0,0,0,0,0,0,0,0,0,0,0,0,0,0,0,0,0,0,0,18935
5895,55,0,41,0,14,0,0,0,0,0,0,0,0,0,0,0,0,0,0,0,0,0,0,0,0,0,0,0,0,0,0,0,0,0,0,18936
5896,10583,349,2020,2667,3119,2428,535,368,368,82,0,286,0,0,0,0,0,0,0,0,0,167,121,51,0,70,46,21,21,0,0,25,0,0,25,18938
5897,20306,544,3844,4333,6694,4891,1702,1046,1041,268,77,696,5,0,0,0,0,5,0,0,5,656,641,201,23,417,15,15,0,15,0,0,0,0,0,18940
5898,2552,237,860,516,678,261,231,76,50,9,0,41,26,26,16,10,0,0,0,0,0,155,146,31,0,115,9,9,9,0,0,0,0,0,0,18942
5899,17006,1116,5385,4925,3684,1896,1564,668,589,241,47,301,79,78,29,49,0,1,0,0,1,896,820,325,55,440,76,76,67,0,9,0,0,0,0,18944
5900,4362,373,1073,1035,1110,771,645,402,357,166,24,167,45,45,27,18,0,0,0,0,0,243,231,123,30,78,12,12,12,0,0,0,0,0,0,18947
5901,138,0,0,49,89,0,33,20,0,0,0,0,20,0,0,0,0,20,0,0,20,13,13,13,0,0,0,0,0,0,0,0,0,0,0,18950
5902,24103,2399,9264,5901,4431,2108,1426,760,607,210,109,288,153,44,20,0,24,109,0,41,68,666,546,265,86,195,120,77,56,0,21,43,43,0,0,18951
5903,6547,258,1501,1534,1899,1355,740,350,330,67,64,199,20,20,20,0,0,0,0,0,0,390,379,87,53,239,11,11,11,0,0,0,0,0,0,18954
5904,1070,77,473,325,144,51,74,37,37,15,3,19,0,0,0,0,0,0,0,0,0,37,30,11,0,19,7,7,7,0,0,0,0,0,0,18955
5905,9028,807,3373,2433,1481,934,734,445,416,253,0,163,29,27,27,0,0,2,0,0,2,289,266,82,33,151,23,20,20,0,0,3,0,0,3,18960
5906,433,7,138,155,40,93,57,15,15,11,0,4,0,0,0,0,0,0,0,0,0,42,36,8,0,28,6,0,0,0,0,6,0,5,1,18962
5907,9899,862,3503,2276,2022,1236,673,429,385,128,111,146,44,44,32,6,6,0,0,0,0,244,220,90,35,95,24,24,24,0,0,0,0,0,0,18964
5908,27182,1259,7293,6994,6936,4700,2193,1243,1138,480,89,569,105,96,84,12,0,9,8,0,1,950,937,347,39,551,13,10,10,0,0,3,0,0,3,18966
5909,10057,902,3464,2616,2132,943,813,435,334,121,59,154,101,76,44,13,19,25,25,0,0,378,336,143,10,183,42,39,36,0,3,3,1,0,2,18969
5910,520,61,282,82,57,38,26,9,9,0,5,4,0,0,0,0,0,0,0,0,0,17,6,6,0,0,11,11,11,0,0,0,0,0,0,18970
5911,2679,302,1020,573,519,265,188,60,49,31,5,13,11,11,11,0,0,0,0,0,0,128,88,23,0,65,40,8,5,3,0,32,0,5,27,18972
5912,29601,2419,10665,7788,5776,2953,1734,786,744,270,61,413,42,38,27,11,0,4,0,0,4,948,903,387,125,391,45,30,19,11,0,15,12,0,3,18974
5913,13159,606,3614,2837,3970,2132,1147,573,486,179,28,279,87,27,17,10,0,60,0,0,60,574,564,205,93,266,10,10,10,0,0,0,0,0,0,18976
5914,2906,40,358,592,971,945,105,30,30,19,0,11,0,0,0,0,0,0,0,0,0,75,75,41,0,34,0,0,0,0,0,0,0,0,0,18977
5915,371,30,103,60,154,24,42,7,7,0,0,7,0,0,0,0,0,0,0,0,0,35,35,18,0,17,0,0,0,0,0,0,0,0,0,18980
5916,11962,981,3536,2831,2791,1823,908,611,530,115,63,352,81,44,31,0,13,37,29,0,8,297,297,116,9,172,0,0,0,0,0,0,0,0,0,19001
5917,23021,914,4218,4115,7536,6238,1853,937,865,191,54,620,72,54,30,24,0,18,2,0,16,916,900,298,31,571,16,12,12,0,0,4,4,0,0,19002
5918,8776,527,1375,1403,2789,2682,494,214,205,82,0,123,9,0,0,0,0,9,9,0,0,280,278,75,18,185,2,0,0,0,0,2,0,0,2,19003
5919,6602,127,759,821,1644,3251,428,195,195,30,12,153,0,0,0,0,0,0,0,0,0,233,176,14,15,147,57,57,0,0,57,0,0,0,0,19004
5920,15294,1026,3374,3202,4451,3241,1131,648,564,138,26,400,84,36,14,0,22,48,17,0,31,483,429,146,6,277,54,24,19,5,0,30,0,0,30,19006
5921,14619,1902,7482,3472,1147,616,950,610,525,189,84,252,85,74,27,20,27,11,11,0,0,340,304,113,7,184,36,29,22,7,0,7,0,0,7,19007
5922,14612,1369,4649,3319,3353,1922,1043,549,532,192,40,300,17,17,10,0,7,0,0,0,0,494,420,109,17,294,74,18,0,0,18,56,0,0,56,19008
5923,563,35,73,165,144,146,138,99,95,24,0,71,4,4,0,0,4,0,0,0,0,39,36,0,13,23,3,3,0,0,3,0,0,0,0,19009
5924,12294,543,1277,1584,3868,5022,2847,770,738,122,42,574,32,11,0,0,11,21,0,12,9,2077,2068,801,27,1240,9,0,0,0,0,9,0,0,9,19010
5925,4506,326,977,1235,972,996,367,191,174,20,0,154,17,9,0,9,0,8,0,8,0,176,176,57,17,102,0,0,0,0,0,0,0,0,0,19012
5926,20775,4040,10000,4741,1356,638,2940,1432,1091,214,106,771,341,186,75,46,65,155,11,55,89,1508,1230,285,88,857,278,209,85,39,85,69,12,4,53,19013
5927,14200,1148,5336,3846,2512,1358,1348,624,586,178,27,381,38,38,0,0,38,0,0,0,0,724,665,279,44,342,59,58,32,16,10,1,0,0,1,19014
5928,11029,1215,4384,2956,1671,803,596,390,321,87,19,215,69,57,42,0,15,12,0,0,12,206,183,50,4,129,23,22,4,0,18,1,0,0,1,19015
5929,269,11,62,30,69,97,0,0,0,0,0,0,0,0,0,0,0,0,0,0,0,0,0,0,0,0,0,0,0,0,0,0,0,0,0,19017
5930,16240,1461,6621,4212,2788,1158,1175,641,590,138,92,360,51,51,42,0,9,0,0,0,0,534,479,109,13,357,55,55,32,15,8,0,0,0,0,19018
5931,39202,3525,13649,11134,6894,4000,2685,1401,1311,431,121,759,90,30,30,0,0,60,0,0,60,1284,1234,366,181,687,50,50,22,0,28,0,0,0,0,19020
5932,7173,819,3839,1834,519,162,492,261,260,53,74,133,1,0,0,0,0,1,0,0,1,231,194,111,0,83,37,37,37,0,0,0,0,0,0,19021
5933,2351,261,1189,676,160,65,175,98,86,7,8,71,12,4,4,0,0,8,0,4,4,77,60,0,9,51,17,13,5,8,0,4,0,0,4,19022
5934,13149,1706,5692,3790,1326,635,1343,603,445,54,21,370,158,97,18,25,54,61,0,42,19,740,633,65,50,518,107,80,26,5,49,27,20,0,7,19023
5935,3757,76,406,706,1343,1226,398,142,142,50,15,77,0,0,0,0,0,0,0,0,0,256,256,23,0,233,0,0,0,0,0,0,0,0,0,19025
5936,20830,1168,6426,5315,4946,2975,1380,775,687,171,67,449,88,88,13,34,41,0,0,0,0,605,587,193,42,352,18,10,10,0,0,8,8,0,0,19026
5937,13652,560,2687,3387,3192,3826,742,406,364,70,40,254,42,42,42,0,0,0,0,0,0,336,265,69,11,185,71,54,54,0,0,17,6,0,11,19027
5938,2772,348,1285,841,212,86,146,73,45,0,10,35,28,28,22,6,0,0,0,0,0,73,68,46,8,14,5,0,0,0,0,5,0,0,5,19029
5939,8754,739,3635,2824,1184,372,539,347,337,138,50,149,10,0,0,0,0,10,0,0,10,192,147,80,17,50,45,37,8,0,29,8,8,0,0,19030
5940,3451,183,617,763,1008,880,216,77,77,10,10,57,0,0,0,0,0,0,0,0,0,139,131,54,22,55,8,8,0,0,8,0,0,0,0,19031
5941,4501,470,1789,1499,592,151,284,124,124,0,6,118,0,0,0,0,0,0,0,0,0,160,154,0,41,113,6,6,0,0,6,0,0,0,0,19032
5942,5937,356,2575,1827,871,308,589,221,201,49,46,106,20,20,0,20,0,0,0,0,0,368,368,180,76,112,0,0,0,0,0,0,0,0,0,19033
5943,3822,186,475,457,1436,1268,332,156,150,53,0,97,6,6,0,0,6,0,0,0,0,176,167,37,0,130,9,9,0,0,9,0,0,0,0,19034
5944,2587,13,328,258,893,1095,133,78,78,12,0,66,0,0,0,0,0,0,0,0,0,55,55,10,0,45,0,0,0,0,0,0,0,0,0,19035
5945,9192,907,4119,2438,1246,482,562,360,325,76,36,213,35,35,15,0,20,0,0,0,0,202,194,75,8,111,8,0,0,0,0,8,0,8,0,19036
5946,21247,1054,4728,4768,5892,4805,1969,743,725,219,95,411,18,18,0,9,9,0,0,0,0,1226,1160,659,61,440,66,55,30,25,0,11,0,0,11,19038
5947,14341,1090,4955,3854,2999,1443,905,389,341,103,18,220,48,40,19,13,8,8,0,0,8,516,497,216,33,248,19,19,8,11,0,0,0,0,0,19040
5948,3946,21,345,497,1367,1716,718,320,317,84,0,233,3,3,3,0,0,0,0,0,0,398,392,75,14,303,6,6,2,0,4,0,0,0,0,19041
5949,1610,90,638,559,205,118,108,39,39,0,0,39,0,0,0,0,0,0,0,0,0,69,47,16,0,31,22,22,22,0,0,0,0,0,0,19043
5950,11365,726,2830,3442,2923,1444,858,516,498,104,36,358,18,18,11,7,0,0,0,0,0,342,342,137,28,177,0,0,0,0,0,0,0,0,0,19044
5951,12955,369,2658,2911,3664,3353,707,327,301,46,55,200,26,26,10,16,0,0,0,0,0,380,380,107,28,245,0,0,0,0,0,0,0,0,0,19046
5952,24670,1368,7311,6565,5952,3474,2155,986,808,274,54,480,178,48,38,0,10,130,0,18,112,1169,1113,516,241,356,56,32,21,11,0,24,3,0,21,19047
5953,19297,1441,5791,5879,3717,2469,1621,806,732,73,109,550,74,55,0,7,48,19,0,0,19,815,763,206,16,541,52,52,8,0,44,0,0,0,0,19050
5954,18416,1333,6748,5570,3023,1742,1108,557,478,83,25,370,79,73,28,24,21,6,0,6,0,551,541,246,49,246,10,9,9,0,0,1,0,0,1,19053
5955,12089,961,5284,3713,1667,464,1102,539,480,150,65,265,59,49,17,21,11,10,0,0,10,563,532,278,45,209,31,31,31,0,0,0,0,0,0,19054
5956,9302,943,4704,2598,805,252,701,408,337,86,55,196,71,67,30,12,25,4,0,0,4,293,257,95,65,97,36,0,0,0,0,36,36,0,0,19055
5957,11061,705,4114,3840,1664,738,883,630,559,183,84,292,71,61,39,0,22,10,10,0,0,253,230,44,31,155,23,23,23,0,0,0,0,0,0,19056
5958,12410,830,6206,3457,1272,645,775,417,377,35,101,241,40,35,0,0,35,5,0,0,5,358,317,83,15,219,41,26,0,0,26,15,0,0,15,19057
5959,7748,210,2196,1751,1963,1628,585,357,340,110,0,230,17,17,0,0,17,0,0,0,0,228,228,84,0,144,0,0,0,0,0,0,0,0,0,19060
5960,13505,1439,6012,3542,1659,853,1169,616,481,103,36,342,135,105,32,73,0,30,0,0,30,553,434,124,26,284,119,61,45,6,10,58,12,0,46,19061
5961,26202,1398,6038,5602,7110,6054,1495,781,754,126,41,587,27,21,0,21,0,6,0,0,6,714,699,185,21,493,15,0,0,0,0,15,0,0,15,19063
5962,17200,811,4617,4976,4476,2320,1090,487,468,118,24,326,19,7,0,7,0,12,7,0,5,603,563,167,53,343,40,22,10,12,0,18,0,0,18,19064
5963,3736,81,300,286,933,2136,762,341,330,24,24,282,11,0,0,0,0,11,0,0,11,421,415,91,9,315,6,0,0,0,0,6,0,0,6,19066
5964,35111,1785,7467,7808,9811,8240,2341,1225,1189,400,91,698,36,36,21,0,15,0,0,0,0,1116,1116,370,89,657,0,0,0,0,0,0,0,0,0,19067
5965,5257,461,2027,1320,818,631,321,166,166,21,24,121,0,0,0,0,0,0,0,0,0,155,154,76,10,68,1,1,0,0,1,0,0,0,0,19070
5966,6799,194,723,928,2190,2764,440,156,156,31,13,112,0,0,0,0,0,0,0,0,0,284,284,117,21,146,0,0,0,0,0,0,0,0,0,19072
5967,13515,304,2907,2676,4007,3621,961,462,432,99,32,301,30,24,24,0,0,6,6,0,0,499,466,157,24,285,33,30,19,0,11,3,0,0,3,19073
5968,4182,344,1999,1165,504,170,245,124,111,13,38,60,13,13,10,3,0,0,0,0,0,121,116,14,27,75,5,0,0,0,0,5,0,0,5,19074
5969,5040,156,1209,1177,1631,867,284,106,106,29,0,77,0,0,0,0,0,0,0,0,0,178,178,55,11,112,0,0,0,0,0,0,0,0,0,19075
5970,4461,405,1784,1377,717,178,309,179,111,54,0,57,68,68,41,0,27,0,0,0,0,130,106,50,20,36,24,24,24,0,0,0,0,0,0,19076
5971,7861,642,2817,2690,1264,448,654,364,308,69,27,212,56,6,6,0,0,50,41,0,9,290,275,42,40,193,15,15,15,0,0,0,0,0,0,19078
5972,5535,552,2581,1325,537,540,496,224,170,0,0,170,54,54,54,0,0,0,0,0,0,272,225,39,13,173,47,0,0,0,0,47,0,13,34,19079
5973,6198,207,1653,914,1385,2039,1062,495,495,217,3,275,0,0,0,0,0,0,0,0,0,567,553,120,0,433,14,14,0,0,14,0,0,0,0,19081
5974,25536,4580,8837,7041,3498,1580,2465,1320,1043,136,82,825,277,70,25,17,28,207,9,66,132,1145,1022,267,57,698,123,49,23,14,12,74,26,0,48,19082
5975,24416,946,5935,5436,6970,5129,1952,1034,974,253,62,659,60,49,40,9,0,11,3,0,8,918,847,167,41,639,71,43,12,0,31,28,18,10,0,19083
5976,3729,13,411,446,1275,1584,2139,1136,1136,393,18,725,0,0,0,0,0,0,0,0,0,1003,1003,295,16,692,0,0,0,0,0,0,0,0,0,19085
5977,7999,280,1704,1401,2199,2415,623,308,308,76,57,175,0,0,0,0,0,0,0,0,0,315,282,62,26,194,33,32,18,0,14,1,0,0,1,19086
5978,20825,376,1965,2960,8098,7426,2706,1363,1318,469,59,790,45,39,19,12,8,6,0,0,6,1343,1294,481,49,764,49,5,0,5,0,44,0,0,44,19087
5979,13252,818,4156,3626,3167,1485,939,489,430,165,42,223,59,11,0,8,3,48,48,0,0,450,421,202,35,184,29,22,9,0,13,7,0,7,0,19090
5980,2989,406,1283,811,292,197,222,127,109,11,31,67,18,18,18,0,0,0,0,0,0,95,94,60,0,34,1,0,0,0,0,1,0,0,1,19094
5981,5419,296,905,1267,1555,1396,343,60,46,10,0,36,14,7,7,0,0,7,0,0,7,283,241,37,33,171,42,11,0,11,0,31,0,0,31,19095
5982,9936,222,787,1327,2849,4751,611,333,270,24,0,246,63,63,12,0,51,0,0,0,0,278,278,43,22,213,0,0,0,0,0,0,0,0,0,19096
5983,3257,12,101,358,1254,1532,173,80,80,18,0,62,0,0,0,0,0,0,0,0,0,93,93,4,16,73,0,0,0,0,0,0,0,0,0,19102
5984,19277,581,1494,1681,6790,8731,391,150,150,9,1,140,0,0,0,0,0,0,0,0,0,241,241,89,2,150,0,0,0,0,0,0,0,0,0,19103
5985,21664,4253,4549,5608,3527,3727,10023,5200,4963,670,188,4105,237,124,13,73,38,113,10,20,83,4823,4738,914,123,3701,85,66,14,9,43,19,0,0,19,19104
5986,9975,466,1178,1061,3150,4120,42,31,18,7,0,11,13,0,0,0,0,13,0,0,13,11,6,0,0,6,5,5,0,0,5,0,0,0,0,19106
5987,8986,1143,1163,997,2624,3059,728,418,401,87,17,297,17,17,17,0,0,0,0,0,0,310,268,57,24,187,42,42,0,42,0,0,0,0,0,19107
5988,0,0,0,0,0,0,0,0,0,0,0,0,0,0,0,0,0,0,0,0,0,0,0,0,0,0,0,0,0,0,0,0,0,0,0,19109
5989,45152,7870,17495,11397,5296,3094,3313,1506,1265,145,185,935,241,203,42,5,156,38,0,25,13,1807,1685,228,175,1282,122,92,55,0,37,30,0,0,30,19111
5990,0,0,0,0,0,0,0,0,0,0,0,0,0,0,0,0,0,0,0,0,0,0,0,0,0,0,0,0,0,0,0,0,0,0,0,19112
5991,101,9,53,33,6,0,11,6,6,6,0,0,0,0,0,0,0,0,0,0,0,5,5,0,0,5,0,0,0,0,0,0,0,0,0,19113
5992,22627,2340,10051,5847,2779,1610,1031,506,449,90,154,205,57,49,21,20,8,8,8,0,0,525,463,102,37,324,62,62,13,17,32,0,0,0,0,19114
5993,24871,3279,8182,6317,4693,2400,1204,537,493,60,140,293,44,13,13,0,0,31,0,0,31,667,608,219,14,375,59,47,34,0,13,12,0,0,12,19115
5994,23646,2634,8743,6195,4147,1927,855,473,386,114,112,160,87,77,64,0,13,10,0,10,0,382,298,108,11,179,84,32,17,0,15,52,0,0,52,19116
5995,7017,266,600,967,2264,2920,566,156,156,47,12,97,0,0,0,0,0,0,0,0,0,410,410,96,48,266,0,0,0,0,0,0,0,0,0,19118
5996,21197,1693,4189,5313,4336,5666,1313,817,739,170,52,517,78,78,78,0,0,0,0,0,0,496,463,55,14,394,33,0,0,0,0,33,0,0,33,19119
5997,42498,11912,15723,10105,3404,1354,5740,2769,2358,288,336,1734,411,275,53,181,41,136,37,52,47,2971,2456,484,416,1556,515,376,195,97,84,139,9,69,61,19120
5998,17230,4564,7159,3755,1187,565,3221,1392,1126,88,87,951,266,229,7,97,125,37,0,21,16,1829,1734,316,338,1080,95,95,47,40,8,0,0,0,0,19121
5999,10144,3098,3662,1926,1033,425,3235,1365,1285,102,74,1109,80,53,0,20,33,27,0,0,27,1870,1756,341,135,1280,114,79,45,12,22,35,0,0,35,19122
6000,9787,1506,2104,1878,2612,1687,509,180,68,12,19,37,112,91,52,3,36,21,0,11,10,329,276,64,55,157,53,42,0,38,4,11,0,1,10,19123
6001,38346,11648,15093,7938,2721,946,4500,2304,1867,229,257,1381,437,250,93,46,111,187,39,90,58,2196,1913,319,242,1352,283,203,100,35,68,80,0,0,80,19124
6002,16493,3814,4539,3090,3296,1754,744,367,312,10,50,252,55,54,8,31,15,1,0,0,1,377,256,33,103,120,121,86,0,38,48,35,0,12,23,19125
6003,10780,1748,3684,3049,1471,828,991,574,490,48,54,388,84,38,0,20,18,46,0,29,17,417,304,8,0,296,113,93,46,47,0,20,0,0,20,19126
6004,3927,375,1109,452,1283,708,102,40,18,6,0,12,22,22,0,22,0,0,0,0,0,62,62,38,0,24,0,0,0,0,0,0,0,0,0,19127
6005,26535,2047,6657,5571,6947,5313,677,356,303,51,34,218,53,51,38,0,13,2,0,0,2,321,242,37,43,162,79,73,7,17,49,6,5,0,1,19128
6006,7713,921,2093,1404,1510,1785,825,359,306,50,8,248,53,13,8,0,5,40,0,0,40,466,387,106,16,265,79,61,61,0,0,18,0,0,18,19129
6007,19135,1373,2867,2870,6137,5888,490,255,178,46,0,132,77,50,25,25,0,27,0,0,27,235,144,15,15,114,91,56,13,43,0,35,0,0,35,19130
6008,28457,4367,8749,8849,3840,2652,3142,1732,1350,173,61,1116,382,236,34,24,178,146,20,30,96,1410,1266,113,31,1122,144,114,44,0,70,30,0,0,30,19131
6009,22589,5327,10822,5418,758,264,2593,1244,844,103,18,723,400,172,19,54,99,228,0,0,228,1349,1163,121,160,882,186,160,56,9,95,26,0,0,26,19132
6010,14038,6031,5421,2016,496,74,1940,1067,734,136,98,500,333,170,30,15,125,163,0,0,163,873,691,108,6,577,182,108,5,27,76,74,0,0,74,19133
6011,34620,12311,14154,5417,1994,744,4755,2325,1693,91,245,1357,632,232,123,53,56,400,26,102,272,2430,1906,171,406,1329,524,313,90,131,92,211,34,83,94,19134
6012,20477,4098,9943,4320,1523,593,2026,1054,657,102,81,474,397,351,171,132,48,46,0,40,6,972,822,264,122,436,150,130,110,18,2,20,0,20,0,19135
6013,25215,4325,11390,5930,2408,1162,1848,1058,622,61,89,472,436,234,25,28,181,202,11,0,191,790,679,148,146,385,111,87,61,8,18,24,0,0,24,19136
6014,6124,1210,2875,1159,536,344,410,147,136,31,8,97,11,11,5,0,6,0,0,0,0,263,232,24,107,101,31,22,0,22,0,9,0,9,0,19137
6015,21354,3585,8238,6975,1565,991,2378,1091,1003,90,107,806,88,27,0,27,0,61,0,37,24,1287,1114,352,45,717,173,157,47,46,64,16,0,0,16,19138
6016,25941,5241,10276,7364,1954,1106,2836,1359,1043,90,141,812,316,203,117,31,55,113,0,53,60,1477,1279,145,175,959,198,123,62,29,32,75,0,71,4,19139
6017,32575,10926,13220,6711,1079,639,4235,2135,1493,123,360,1010,642,576,187,158,231,66,0,0,66,2100,1682,256,146,1280,418,256,97,48,111,162,42,90,30,19140
6018,20643,4251,7942,5965,1830,655,2196,873,720,156,120,444,153,49,18,31,0,104,0,31,73,1323,1250,239,98,913,73,33,8,0,25,40,10,0,30,19141
6019,16487,4360,6196,4353,1205,373,1979,1088,931,11,93,827,157,82,0,0,82,75,0,24,51,891,684,54,88,542,207,165,18,27,120,42,0,10,32,19142
6020,42608,7519,15778,10581,5011,3719,3411,1664,1342,131,256,955,322,218,20,67,131,104,0,33,71,1747,1650,191,195,1264,97,77,22,0,55,20,0,0,20,19143
6021,29055,5179,10206,7174,4086,2410,2360,1113,918,148,110,660,195,115,31,43,41,80,16,48,16,1247,982,183,61,738,265,160,65,44,51,105,0,0,105,19144
6022,31812,6513,11861,7600,3855,1983,2096,1063,879,102,150,627,184,90,29,61,0,94,76,16,2,1033,846,176,39,631,187,32,0,10,22,155,17,35,103,19145
6023,24931,3368,6241,4749,5300,5273,1289,618,520,56,22,442,98,75,48,0,27,23,0,13,10,671,456,143,15,298,215,156,102,42,12,59,0,9,50,19146
6024,26911,3337,5176,4342,7128,6928,840,419,321,7,26,288,98,60,60,0,0,38,0,37,1,421,401,12,78,311,20,19,19,0,0,1,0,0,1,19147
6025,36343,9909,12870,6823,4651,2090,2012,966,864,118,65,681,102,99,0,53,46,3,0,3,0,1046,743,148,58,537,303,128,120,0,8,175,0,0,175,19148
6026,33262,6436,13610,8066,3432,1718,2520,1431,1209,34,163,1012,222,137,51,27,59,85,39,20,26,1089,1037,289,130,618,52,52,0,0,52,0,0,0,0,19149
6027,17232,2122,6289,4979,2263,1579,1051,495,369,75,34,260,126,56,14,22,20,70,0,0,70,556,377,66,23,288,179,110,0,17,93,69,0,0,69,19150
6028,20069,2645,5933,7045,2443,2003,2448,1058,951,81,66,804,107,36,0,36,0,71,11,0,60,1390,1255,162,28,1065,135,117,25,44,48,18,0,0,18,19151
6029,23888,3556,9984,5097,3734,1517,1125,607,580,117,164,299,27,6,0,0,6,21,0,21,0,518,466,98,53,315,52,28,0,28,0,24,0,24,0,19152
6030,8537,1169,3073,2630,1016,649,561,117,95,0,0,95,22,22,0,22,0,0,0,0,0,444,374,36,78,260,70,60,51,0,9,10,0,10,0,19153
6031,23447,2318,11460,5821,2921,927,1323,584,540,110,12,418,44,43,0,7,36,1,0,0,1,739,683,298,78,307,56,46,0,11,35,10,0,0,10,19154
6032,4792,230,895,853,1472,1342,234,125,123,40,6,77,2,0,0,0,0,2,0,0,2,109,108,68,7,33,1,1,0,0,1,0,0,0,0,19301
6033,1744,257,683,431,221,152,206,154,107,35,4,68,47,19,0,19,0,28,22,0,6,52,46,11,4,31,6,0,0,0,0,6,6,0,0,19310
6034,5434,1238,836,956,1458,946,488,302,240,44,27,169,62,21,21,0,0,41,24,0,17,186,177,77,2,98,9,9,0,9,0,0,0,0,0,19311
6035,7585,207,902,755,3187,2534,716,402,342,50,8,284,60,40,13,0,27,20,0,0,20,314,305,84,15,206,9,9,9,0,0,0,0,0,0,19312
6036,65,0,11,37,17,0,11,11,11,11,0,0,0,0,0,0,0,0,0,0,0,0,0,0,0,0,0,0,0,0,0,0,0,0,0,19316
6037,6855,128,1011,1211,2201,2304,527,294,294,75,0,219,0,0,0,0,0,0,0,0,0,233,227,94,0,133,6,6,6,0,0,0,0,0,0,19317
6038,130,14,8,57,6,45,499,189,189,74,18,97,0,0,0,0,0,0,0,0,0,310,310,109,13,188,0,0,0,0,0,0,0,0,0,19319
6039,35382,3613,12106,8806,7126,3731,2434,1272,883,204,143,536,389,281,215,66,0,108,33,23,52,1162,962,433,62,467,200,155,56,91,8,45,25,0,20,19320
6040,3895,365,1627,954,625,324,264,151,114,33,3,78,37,34,19,15,0,3,0,0,3,113,85,32,0,53,28,3,3,0,0,25,12,0,13,19330
6041,5143,65,564,720,1888,1906,222,62,62,14,0,48,0,0,0,0,0,0,0,0,0,160,143,65,0,78,17,17,17,0,0,0,0,0,0,19333
6042,31851,1135,7363,7216,10510,5627,2404,1367,1319,371,164,784,48,43,43,0,0,5,0,0,5,1037,962,400,76,486,75,48,48,0,0,27,0,0,27,19335
6043,11837,516,2147,2199,4277,2698,798,487,452,155,27,270,35,35,35,0,0,0,0,0,0,311,284,77,13,194,27,27,0,27,0,0,0,0,0,19341
6044,13264,407,3021,2708,4146,2982,1421,1134,867,93,0,774,267,140,36,57,47,127,0,0,127,287,260,53,27,180,27,23,0,0,23,4,0,0,4,19342
6045,5623,289,1276,1331,1848,879,395,187,177,38,30,109,10,8,6,0,2,2,0,0,2,208,175,84,0,91,33,24,0,20,4,9,9,0,0,19343
6046,7688,1221,2820,2010,1051,586,702,348,257,149,7,101,91,33,33,0,0,58,33,0,25,354,240,145,25,70,114,64,25,39,0,50,11,0,39,19344
6047,227,23,34,4,63,103,312,80,80,22,17,41,0,0,0,0,0,0,0,0,0,232,232,110,9,113,0,0,0,0,0,0,0,0,0,19345
6048,15140,2108,3022,2638,4112,3260,1289,718,605,104,44,457,113,26,26,0,0,87,44,0,43,571,526,225,15,286,45,17,3,0,14,28,0,0,28,19348
6049,7532,581,1314,1509,2230,1898,766,395,369,140,29,200,26,8,0,0,8,18,8,0,10,371,308,111,0,197,63,31,31,0,0,32,32,0,0,19350
6050,5406,416,1395,1358,1397,840,1622,749,721,176,81,464,28,20,20,0,0,8,0,0,8,873,865,225,38,602,8,8,8,0,0,0,0,0,0,19352
6051,16853,803,2406,2994,6215,4435,1224,703,643,202,15,426,60,46,39,7,0,14,0,0,14,521,505,133,18,354,16,16,16,0,0,0,0,0,0,19355
6052,331,84,160,53,23,11,25,13,7,3,0,4,6,6,0,0,6,0,0,0,0,12,9,4,0,5,3,3,3,0,0,0,0,0,0,19358
6053,3777,634,1611,885,445,202,337,186,166,16,29,121,20,19,9,0,10,1,0,0,1,151,131,11,0,120,20,0,0,0,0,20,0,0,20,19362
6054,10284,1802,3604,2498,1693,687,863,449,330,154,0,176,119,89,11,78,0,30,29,0,1,414,337,57,25,255,77,28,28,0,0,49,36,2,11,19363
6055,4436,605,1851,1017,677,286,389,189,156,59,14,83,33,26,13,13,0,7,3,3,1,200,165,23,47,95,35,14,4,7,3,21,10,0,11,19365
6056,69,8,0,38,0,23,0,0,0,0,0,0,0,0,0,0,0,0,0,0,0,0,0,0,0,0,0,0,0,0,0,0,0,0,0,19367
6057,1155,26,508,225,308,88,84,40,40,12,28,0,0,0,0,0,0,0,0,0,0,44,44,0,0,44,0,0,0,0,0,0,0,0,0,19372
6058,3177,358,820,666,754,579,352,256,166,83,0,83,90,59,7,0,52,31,0,0,31,96,88,30,0,58,8,0,0,0,0,8,0,0,8,19373
6059,956,245,538,150,23,0,24,0,0,0,0,0,0,0,0,0,0,0,0,0,0,24,24,0,0,24,0,0,0,0,0,0,0,0,0,19374
6060,74,0,27,0,47,0,0,0,0,0,0,0,0,0,0,0,0,0,0,0,0,0,0,0,0,0,0,0,0,0,0,0,0,0,0,19375
6061,34693,1524,6748,7329,11842,7250,2395,1369,1220,377,164,679,149,96,65,6,25,53,6,0,47,1026,895,314,33,548,131,80,44,0,36,51,0,22,29,19380
6062,34350,1541,6125,6767,11891,8026,3002,1392,1310,366,91,853,82,44,26,7,11,38,32,0,6,1610,1580,603,82,895,30,26,0,0,26,4,0,0,4,19382
6063,15,0,0,0,0,15,2213,825,825,249,64,512,0,0,0,0,0,0,0,0,0,1388,1388,515,61,812,0,0,0,0,0,0,0,0,0,19383
6064,9130,1095,2770,2112,2011,1142,715,328,271,86,34,151,57,30,0,22,8,27,15,6,6,387,289,93,34,162,98,98,83,15,0,0,0,0,0,19390
6065,28346,4655,11143,6249,4230,2069,1776,1070,717,152,95,470,353,186,125,61,0,167,106,46,15,706,549,180,18,351,157,138,0,32,106,19,19,0,0,19401
6066,32201,2064,8377,7840,7939,5981,2113,1255,1109,352,109,648,146,93,47,0,46,53,0,0,53,858,787,303,44,440,71,71,41,15,15,0,0,0,0,19403
6067,3858,344,1593,893,675,353,122,81,81,22,0,59,0,0,0,0,0,0,0,0,0,41,23,0,0,23,18,18,18,0,0,0,0,0,0,19405
6068,17117,862,3864,3398,5027,3966,723,367,367,124,10,233,0,0,0,0,0,0,0,0,0,356,327,86,80,161,29,29,29,0,0,0,0,0,0,19406
6069,13200,325,2627,2422,3890,3936,1082,596,567,125,0,442,29,29,11,18,0,0,0,0,0,486,476,78,79,319,10,0,0,0,0,10,0,10,0,19422
6070,8986,172,891,1356,3684,2883,702,444,412,94,15,303,32,32,32,0,0,0,0,0,0,258,230,63,7,160,28,18,0,0,18,10,0,0,10,19425
6071,24985,1769,5840,5277,7255,4844,2725,1184,1118,299,120,699,66,33,0,9,24,33,0,0,33,1541,1493,605,52,836,48,36,14,0,22,12,0,0,12,19426
6072,12362,857,3277,2303,3730,2195,655,315,262,53,37,172,53,46,44,2,0,7,4,0,3,340,316,117,19,180,24,24,4,20,0,0,0,0,0,19428
6073,173,29,32,63,36,13,7,0,0,0,0,0,0,0,0,0,0,0,0,0,0,7,7,0,0,7,0,0,0,0,0,0,0,0,0,19435
6074,596,9,133,152,130,172,0,0,0,0,0,0,0,0,0,0,0,0,0,0,0,0,0,0,0,0,0,0,0,0,0,0,0,0,0,19436
6075,501,12,82,29,158,220,39,27,27,14,0,13,0,0,0,0,0,0,0,0,0,12,12,0,0,12,0,0,0,0,0,0,0,0,0,19437
6076,16346,764,4344,3712,4728,2798,1333,859,781,235,57,489,78,65,31,0,34,13,13,0,0,474,464,199,12,253,10,10,10,0,0,0,0,0,0,19438
6077,13116,1199,4487,3046,2908,1476,651,313,270,135,20,115,43,43,10,17,16,0,0,0,0,338,328,108,31,189,10,0,0,0,0,10,0,0,10,19440
6078,0,0,0,0,0,0,0,0,0,0,0,0,0,0,0,0,0,0,0,0,0,0,0,0,0,0,0,0,0,0,0,0,0,0,0,19442
6079,7598,288,1073,1549,2598,2090,554,273,254,44,8,202,19,19,19,0,0,0,0,0,0,281,281,69,5,207,0,0,0,0,0,0,0,0,0,19444
6080,39228,2458,9216,9310,11174,7070,2600,1342,1174,258,64,852,168,153,62,55,36,15,0,0,15,1258,1147,379,160,608,111,63,31,22,10,48,30,0,18,19446
6081,1111,123,397,296,125,170,14,14,14,14,0,0,0,0,0,0,0,0,0,0,0,0,0,0,0,0,0,0,0,0,0,0,0,0,0,19453
6082,19833,935,4134,4573,6254,3937,1140,516,471,115,44,312,45,22,22,0,0,23,0,11,12,624,594,234,33,327,30,12,12,0,0,18,0,0,18,19454
6083,442,0,114,117,123,88,35,0,0,0,0,0,0,0,0,0,0,0,0,0,0,35,35,0,0,35,0,0,0,0,0,0,0,0,0,19456
6084,110,0,76,34,0,0,42,42,42,0,0,42,0,0,0,0,0,0,0,0,0,0,0,0,0,0,0,0,0,0,0,0,0,0,0,19457
6085,27794,1814,6901,5490,8482,5107,2417,1159,1134,448,87,599,25,14,0,13,1,11,0,0,11,1258,1241,450,0,791,17,17,0,0,17,0,0,0,0,19460
6086,10482,678,2509,2437,2735,2123,803,439,427,136,35,256,12,8,0,0,8,4,4,0,0,364,344,166,10,168,20,8,0,0,8,12,12,0,0,19462
6087,30996,3382,12312,8250,4952,2100,2304,1389,1030,304,269,457,359,317,161,103,53,42,0,5,37,915,755,399,56,300,160,131,64,56,11,29,6,23,0,19464
6088,11827,671,3910,2853,2935,1458,936,500,488,157,40,291,12,12,0,8,4,0,0,0,0,436,422,138,8,276,14,14,0,0,14,0,0,0,0,19465
6089,17751,1002,5104,5015,4413,2217,1495,892,785,290,26,469,107,83,35,28,20,24,0,24,0,603,520,119,39,362,83,75,75,0,0,8,0,0,8,19468
6090,17,0,17,0,0,0,0,0,0,0,0,0,0,0,0,0,0,0,0,0,0,0,0,0,0,0,0,0,0,0,0,0,0,0,0,19472
6091,10713,706,2885,2836,2680,1606,709,395,319,99,5,215,76,63,52,11,0,13,0,0,13,314,297,133,12,152,17,5,5,0,0,12,0,0,12,19473
6092,425,10,44,80,263,28,0,0,0,0,0,0,0,0,0,0,0,0,0,0,0,0,0,0,0,0,0,0,0,0,0,0,0,0,0,19474
6093,8006,728,2970,1535,1763,1010,471,309,244,90,51,103,65,46,21,8,17,19,9,9,1,162,134,60,0,74,28,28,8,20,0,0,0,0,0,19475
6094,102,16,27,8,31,20,0,0,0,0,0,0,0,0,0,0,0,0,0,0,0,0,0,0,0,0,0,0,0,0,0,0,0,0,0,19477
6095,333,87,108,29,68,41,8,8,8,0,0,8,0,0,0,0,0,0,0,0,0,0,0,0,0,0,0,0,0,0,0,0,0,0,0,19492
6096,637,82,270,219,43,23,21,6,6,0,0,6,0,0,0,0,0,0,0,0,0,15,13,10,3,0,2,2,2,0,0,0,0,0,0,19501
6097,905,88,512,188,92,25,113,76,64,56,0,8,12,8,6,2,0,4,1,0,3,37,27,8,0,19,10,10,0,10,0,0,0,0,0,19503
6098,3646,245,1550,893,569,389,223,128,128,19,0,109,0,0,0,0,0,0,0,0,0,95,87,22,0,65,8,8,8,0,0,0,0,0,0,19504
6099,2078,327,1013,483,137,118,186,101,101,22,30,49,0,0,0,0,0,0,0,0,0,85,60,27,19,14,25,25,19,6,0,0,0,0,0,19505
6100,5007,700,2184,1178,659,286,411,208,168,64,12,92,40,28,10,18,0,12,12,0,0,203,168,59,0,109,35,16,5,8,3,19,17,0,2,19506
6101,2391,572,1252,351,168,48,164,96,68,9,16,43,28,11,11,0,0,17,3,10,4,68,28,19,0,9,40,31,31,0,0,9,4,0,5,19507
6102,11086,1130,4362,3148,1702,744,891,602,449,216,51,182,153,125,82,0,43,28,8,8,12,289,274,122,32,120,15,5,5,0,0,10,0,10,0,19508
6103,4840,404,1831,1381,812,412,438,141,127,49,25,53,14,0,0,0,0,14,14,0,0,297,297,193,13,91,0,0,0,0,0,0,0,0,0,19510
6104,212,32,112,34,34,0,0,0,0,0,0,0,0,0,0,0,0,0,0,0,0,0,0,0,0,0,0,0,0,0,0,0,0,0,0,19511
6105,12352,1895,5306,2717,1659,775,918,513,456,124,46,286,57,46,20,6,20,11,11,0,0,405,385,147,23,215,20,20,20,0,0,0,0,0,0,19512
6106,9645,567,3662,2463,1908,1045,860,512,439,101,131,207,73,73,60,13,0,0,0,0,0,348,310,53,13,244,38,38,31,7,0,0,0,0,0,19518
6107,57,0,39,18,0,0,0,0,0,0,0,0,0,0,0,0,0,0,0,0,0,0,0,0,0,0,0,0,0,0,0,0,0,0,0,19519
6108,4261,299,1568,1119,859,416,202,119,117,52,11,54,2,2,2,0,0,0,0,0,0,83,77,49,3,25,6,6,2,4,0,0,0,0,0,19520
6109,10830,1234,4734,2314,1787,761,580,283,276,24,30,222,7,7,7,0,0,0,0,0,0,297,246,97,40,109,51,51,10,41,0,0,0,0,0,19522
6110,171,3,75,28,19,46,4,4,0,0,0,0,4,4,0,0,4,0,0,0,0,0,0,0,0,0,0,0,0,0,0,0,0,0,0,19523
6111,9640,596,2692,2615,2712,1025,680,362,335,95,18,222,27,17,17,0,0,10,0,0,10,318,318,109,21,188,0,0,0,0,0,0,0,0,0,19525
6112,8145,1278,3802,1836,835,394,663,407,380,140,30,210,27,20,5,15,0,7,7,0,0,256,222,111,17,94,34,29,11,13,5,5,0,0,5,19526
6113,2370,255,861,634,386,234,110,52,52,12,3,37,0,0,0,0,0,0,0,0,0,58,57,20,8,29,1,1,0,0,1,0,0,0,0,19529
6114,7861,744,3140,1707,1394,876,2652,998,981,174,200,607,17,0,0,0,0,17,0,10,7,1654,1605,420,298,887,49,29,29,0,0,20,0,0,20,19530
6115,5785,1111,2515,1388,536,235,361,265,141,29,18,94,124,51,31,0,20,73,3,0,70,96,78,38,9,31,18,18,15,3,0,0,0,0,0,19533
6116,1527,229,625,315,311,47,56,30,26,2,0,24,4,4,4,0,0,0,0,0,0,26,23,23,0,0,3,3,0,0,3,0,0,0,0,19534
6117,48,0,0,5,6,37,0,0,0,0,0,0,0,0,0,0,0,0,0,0,0,0,0,0,0,0,0,0,0,0,0,0,0,0,0,19535
6118,320,59,176,50,29,6,24,12,12,0,0,12,0,0,0,0,0,0,0,0,0,12,12,4,0,8,0,0,0,0,0,0,0,0,0,19536
6119,46,0,36,10,0,0,0,0,0,0,0,0,0,0,0,0,0,0,0,0,0,0,0,0,0,0,0,0,0,0,0,0,0,0,0,19538
6120,3355,539,1463,674,426,253,273,136,112,0,0,112,24,15,15,0,0,9,9,0,0,137,137,50,17,70,0,0,0,0,0,0,0,0,0,19539
6121,8054,948,3012,1951,1478,665,753,399,319,75,103,141,80,43,43,0,0,37,20,8,9,354,328,187,11,130,26,1,0,0,1,25,0,0,25,19540
6122,2840,237,1235,662,525,181,233,160,110,49,22,39,50,50,50,0,0,0,0,0,0,73,66,33,0,33,7,0,0,0,0,7,7,0,0,19541
6123,0,0,0,0,0,0,0,0,0,0,0,0,0,0,0,0,0,0,0,0,0,0,0,0,0,0,0,0,0,0,0,0,0,0,0,19542
6124,3784,408,1152,966,841,417,400,209,169,68,0,101,40,15,15,0,0,25,25,0,0,191,138,57,26,55,53,31,23,8,0,22,22,0,0,19543
6125,152,0,74,62,16,0,0,0,0,0,0,0,0,0,0,0,0,0,0,0,0,0,0,0,0,0,0,0,0,0,0,0,0,0,0,19544
6126,363,0,233,112,18,0,40,34,34,0,0,34,0,0,0,0,0,0,0,0,0,6,0,0,0,0,6,6,0,6,0,0,0,0,0,19545
6127,2936,290,1130,704,552,260,381,248,231,91,0,140,17,17,15,0,2,0,0,0,0,133,89,13,41,35,44,44,0,0,44,0,0,0,0,19547
6128,175,36,87,38,12,2,8,6,1,1,0,0,5,5,5,0,0,0,0,0,0,2,0,0,0,0,2,2,2,0,0,0,0,0,0,19549
6129,379,100,134,104,5,36,50,26,26,0,0,26,0,0,0,0,0,0,0,0,0,24,24,4,0,20,0,0,0,0,0,0,0,0,0,19550
6130,3619,365,1772,836,475,171,419,284,221,45,51,125,63,31,31,0,0,32,4,0,28,135,124,37,11,76,11,11,0,7,4,0,0,0,0,19551
6131,252,29,119,83,21,0,14,4,0,0,0,0,4,4,0,4,0,0,0,0,0,10,10,10,0,0,0,0,0,0,0,0,0,0,0,19554
6132,2487,362,1126,606,331,62,128,49,39,10,12,17,10,7,7,0,0,3,3,0,0,79,74,9,0,65,5,5,0,0,5,0,0,0,0,19555
6133,190,14,101,48,21,6,15,9,9,6,0,3,0,0,0,0,0,0,0,0,0,6,6,0,0,6,0,0,0,0,0,0,0,0,0,19559
6134,5463,724,2707,1175,655,202,202,140,86,7,23,56,54,7,7,0,0,47,47,0,0,62,27,9,0,18,35,17,17,0,0,18,0,0,18,19560
6135,1950,286,771,512,214,167,117,50,32,12,6,14,18,18,5,6,7,0,0,0,0,67,52,17,0,35,15,15,15,0,0,0,0,0,0,19562
6136,54,11,22,21,0,0,0,0,0,0,0,0,0,0,0,0,0,0,0,0,0,0,0,0,0,0,0,0,0,0,0,0,0,0,0,19564
6137,6277,752,2478,1575,1031,441,396,122,86,23,14,49,36,21,7,0,14,15,11,0,4,274,255,143,17,95,19,14,0,8,6,5,4,0,1,19565
6138,3574,584,1440,837,485,228,317,188,165,27,21,117,23,6,6,0,0,17,14,0,3,129,112,81,0,31,17,3,3,0,0,14,14,0,0,19567
6139,19440,7242,6470,3859,1332,537,2145,1127,933,53,167,713,194,98,37,14,47,96,56,5,35,1018,725,117,130,478,293,206,150,8,48,87,15,0,72,19601
6140,10295,3754,3543,2184,593,221,1331,685,501,79,154,268,184,82,2,42,38,102,39,63,0,646,422,89,39,294,224,97,58,30,9,127,17,29,81,19602
6141,14851,5420,5290,3012,726,403,2533,1214,994,159,193,642,220,107,79,23,5,113,47,33,33,1319,1068,239,199,630,251,186,41,86,59,65,8,18,39,19604
6142,14013,1976,6050,3117,1703,1167,801,544,485,129,57,299,59,48,30,0,18,11,0,0,11,257,230,95,20,115,27,0,0,0,0,27,0,27,0,19605
6143,23602,2335,8632,5563,4616,2456,1804,861,733,237,102,394,128,105,58,14,33,23,0,23,0,943,786,334,82,370,157,128,127,0,1,29,28,0,1,19606
6144,15460,1633,5634,3875,2798,1520,1225,522,424,86,18,320,98,98,98,0,0,0,0,0,0,703,689,220,31,438,14,14,0,14,0,0,0,0,0,19607
6145,15408,1159,5118,4015,3331,1785,1373,715,671,199,106,366,44,34,25,9,0,10,0,0,10,658,618,282,64,272,40,40,0,16,24,0,0,0,0,19608
6146,6790,484,2856,1489,1146,815,442,231,219,88,27,104,12,12,12,0,0,0,0,0,0,211,193,75,12,106,18,6,6,0,0,12,12,0,0,19609
6147,11012,599,2892,2234,2776,2511,1264,652,652,211,50,391,0,0,0,0,0,0,0,0,0,612,577,197,49,331,35,27,27,0,0,8,0,0,8,19610
6148,6613,1342,2610,1423,854,384,447,224,168,65,0,103,56,8,0,8,0,48,0,0,48,223,190,48,19,123,33,33,28,5,0,0,0,0,0,19611
6149,27054,1834,8018,7282,5841,4079,2285,1188,1011,255,63,693,177,103,45,0,58,74,0,0,74,1097,1089,318,46,725,8,8,8,0,0,0,0,0,0,19701
6150,33833,3149,9394,10509,6761,4020,3255,1518,1386,254,87,1045,132,96,75,9,12,36,0,36,0,1737,1541,387,103,1051,196,132,82,0,50,64,13,28,23,19702
6151,9935,1178,3370,2882,1761,744,632,303,244,68,6,170,59,15,0,7,8,44,0,30,14,329,277,75,37,165,52,40,33,7,0,12,0,0,12,19703
6152,1554,274,629,464,126,61,167,120,115,15,14,86,5,5,5,0,0,0,0,0,0,47,38,25,0,13,9,9,0,0,9,0,0,0,0,19706
6153,10888,380,1391,2116,3968,3033,712,346,346,130,0,216,0,0,0,0,0,0,0,0,0,366,366,89,15,262,0,0,0,0,0,0,0,0,0,19707
6154,23037,1575,6613,7141,5238,2470,2444,1276,983,257,62,664,293,101,67,0,34,192,9,171,12,1168,1163,689,64,410,5,0,0,0,0,5,0,0,5,19709
6155,18,0,18,0,0,0,0,0,0,0,0,0,0,0,0,0,0,0,0,0,0,0,0,0,0,0,0,0,0,0,0,0,0,0,0,19710
6156,31908,1842,6046,7658,8820,7542,3265,1432,1416,230,91,1095,16,16,9,7,0,0,0,0,0,1833,1748,506,78,1164,85,62,5,15,42,23,13,0,10,19711
6157,21432,2520,7150,6009,3168,2585,1474,712,614,67,77,470,98,78,31,36,11,20,0,20,0,762,731,308,133,290,31,23,12,11,0,8,0,0,8,19713
6158,0,0,0,0,0,0,700,272,272,22,0,250,0,0,0,0,0,0,0,0,0,428,428,37,4,387,0,0,0,0,0,0,0,0,0,19716
6159,27,0,0,0,27,0,3068,1279,1279,122,14,1143,0,0,0,0,0,0,0,0,0,1789,1789,307,48,1434,0,0,0,0,0,0,0,0,0,19717
6160,39607,6459,14287,11915,4670,2276,3202,1861,1689,416,176,1097,172,43,35,8,0,129,0,75,54,1341,1168,240,181,747,173,117,52,28,37,56,29,18,9,19720
6161,391,20,82,143,107,39,6,6,3,0,0,3,3,3,0,3,0,0,0,0,0,0,0,0,0,0,0,0,0,0,0,0,0,0,0,19730
6162,116,8,29,35,31,13,5,5,5,5,0,0,0,0,0,0,0,0,0,0,0,0,0,0,0,0,0,0,0,0,0,0,0,0,0,19731
6163,49,0,0,0,10,39,0,0,0,0,0,0,0,0,0,0,0,0,0,0,0,0,0,0,0,0,0,0,0,0,0,0,0,0,0,19732
6164,168,31,58,42,19,18,22,9,9,0,0,9,0,0,0,0,0,0,0,0,0,13,13,0,0,13,0,0,0,0,0,0,0,0,0,19733
6165,7113,578,2299,1927,1628,681,732,300,290,93,13,184,10,10,8,2,0,0,0,0,0,432,340,114,25,201,92,29,29,0,0,63,30,0,33,19734
6166,0,0,0,0,0,0,0,0,0,0,0,0,0,0,0,0,0,0,0,0,0,0,0,0,0,0,0,0,0,0,0,0,0,0,0,19735
6167,0,0,0,0,0,0,0,0,0,0,0,0,0,0,0,0,0,0,0,0,0,0,0,0,0,0,0,0,0,0,0,0,0,0,0,19736
6168,10029,2425,3616,2355,906,727,691,370,172,13,13,146,198,78,8,0,70,120,0,0,120,321,291,135,40,116,30,20,6,7,7,10,10,0,0,19801
6169,16506,2792,5718,4455,2195,1346,1251,530,437,80,64,293,93,50,13,12,25,43,0,11,32,721,509,198,34,277,212,117,78,6,33,95,22,24,49,19802
6170,15667,460,2584,3296,4751,4576,929,502,480,179,10,291,22,17,0,17,0,5,0,0,5,427,394,109,26,259,33,11,11,0,0,22,0,22,0,19803
6171,12369,1485,5237,3586,1438,623,805,429,265,78,33,154,164,72,72,0,0,92,11,27,54,376,306,105,53,148,70,38,38,0,0,32,8,0,24,19804
6172,25485,5469,9526,6096,3003,1391,2645,1338,1073,243,83,747,265,68,19,28,21,197,18,85,94,1307,998,267,120,611,309,169,41,11,117,140,16,26,98,19805
6173,8164,782,1372,1577,2442,1991,123,85,76,44,0,32,9,9,9,0,0,0,0,0,0,38,35,12,0,23,3,3,0,3,0,0,0,0,0,19806
6174,5455,79,582,811,1645,2338,216,98,98,31,8,59,0,0,0,0,0,0,0,0,0,118,105,8,0,97,13,0,0,0,0,13,0,0,13,19807
6175,26558,2185,7651,7037,5975,3710,1673,873,689,166,29,494,184,146,98,40,8,38,36,0,2,800,699,287,36,376,101,56,14,27,15,45,0,0,45,19808
6176,10220,687,3437,2572,2099,1425,537,287,266,33,42,191,21,20,20,0,0,1,0,0,1,250,247,54,0,193,3,3,0,3,0,0,0,0,0,19809
6177,18321,880,4108,4480,4810,4043,1238,728,650,163,53,434,78,78,53,19,6,0,0,0,0,510,459,116,0,343,51,13,0,0,13,38,0,0,38,19810
6178,21712,2919,6618,7067,3191,1917,3063,1396,1177,116,42,1019,219,177,123,47,7,42,15,4,23,1667,1497,309,52,1136,170,133,25,82,26,37,0,20,17,19901
6179,13,0,0,11,2,0,36,30,11,11,0,0,19,19,19,0,0,0,0,0,0,6,0,0,0,0,6,6,6,0,0,0,0,0,0,19902
6180,21018,3102,6277,6240,3217,2182,1934,1060,927,196,118,613,133,83,54,10,19,50,12,30,8,874,825,173,30,622,49,13,0,0,13,36,12,12,12,19904
6181,1966,40,473,510,538,405,85,73,70,63,0,7,3,3,3,0,0,0,0,0,0,12,12,3,0,9,0,0,0,0,0,0,0,0,0,19930
6182,172,32,47,45,36,12,10,0,0,0,0,0,0,0,0,0,0,0,0,0,0,10,8,0,2,6,2,2,2,0,0,0,0,0,0,19931
6183,5617,1148,2157,1496,594,222,355,143,82,23,0,59,61,17,17,0,0,44,11,0,33,212,187,25,0,162,25,25,10,3,12,0,0,0,0,19933
6184,8852,1008,2828,2606,1288,1122,505,189,153,30,51,72,36,21,16,5,0,15,15,0,0,316,283,45,7,231,33,27,16,11,0,6,6,0,0,19934
6185,187,91,67,24,5,0,12,12,12,2,0,10,0,0,0,0,0,0,0,0,0,0,0,0,0,0,0,0,0,0,0,0,0,0,0,19936
6186,5764,898,2471,1541,470,384,504,287,235,94,6,135,52,34,34,0,0,18,0,18,0,217,175,39,34,102,42,38,25,13,0,4,4,0,0,19938
6187,4708,445,1586,1418,688,571,236,90,66,23,5,38,24,24,19,5,0,0,0,0,0,146,74,18,18,38,72,0,0,0,0,72,7,0,65,19939
6188,3621,707,1383,988,434,109,183,89,51,12,7,32,38,36,29,7,0,2,0,2,0,94,79,30,30,19,15,15,11,0,4,0,0,0,0,19940
6189,1781,605,632,436,53,55,249,98,63,27,0,36,35,35,11,24,0,0,0,0,0,151,115,20,0,95,36,36,36,0,0,0,0,0,0,19941
6190,8302,1233,3421,2109,933,606,630,432,383,76,22,285,49,34,19,15,0,15,0,0,15,198,198,62,43,93,0,0,0,0,0,0,0,0,0,19943
6191,510,15,162,136,106,91,3,3,3,0,0,3,0,0,0,0,0,0,0,0,0,0,0,0,0,0,0,0,0,0,0,0,0,0,0,19944
6192,6392,1134,2504,1479,796,479,332,105,96,35,6,55,9,6,3,3,0,3,0,0,3,227,227,95,0,132,0,0,0,0,0,0,0,0,0,19945
6193,2988,451,1081,884,365,207,166,73,73,14,5,54,0,0,0,0,0,0,0,0,0,93,56,26,0,30,37,3,3,0,0,34,0,0,34,19946
6194,12955,3443,4871,2880,1084,677,718,405,329,56,0,273,76,18,3,0,15,58,0,0,58,313,292,84,51,157,21,13,0,13,0,8,0,8,0,19947
6195,5178,867,2442,1094,569,206,357,250,188,69,0,119,62,32,22,10,0,30,0,0,30,107,98,40,13,45,9,9,0,9,0,0,0,0,0,19950
6196,1346,109,446,373,296,122,224,178,166,111,0,55,12,0,0,0,0,12,0,9,3,46,44,42,0,2,2,0,0,0,0,2,2,0,0,19951
6197,6577,1067,2821,1757,693,239,412,200,152,47,19,86,48,48,48,0,0,0,0,0,0,212,164,25,21,118,48,12,0,12,0,36,27,0,9,19952
6198,2894,637,974,900,237,146,196,115,83,0,9,74,32,0,0,0,0,32,27,5,0,81,65,28,0,37,16,5,5,0,0,11,11,0,0,19953
6199,941,165,389,247,88,52,89,75,70,10,6,54,5,0,0,0,0,5,0,0,5,14,14,2,0,12,0,0,0,0,0,0,0,0,0,19954
6200,43,7,19,17,0,0,5,0,0,0,0,0,0,0,0,0,0,0,0,0,0,5,5,0,0,5,0,0,0,0,0,0,0,0,0,19955
6201,9826,1657,4097,2934,699,439,765,276,195,57,26,112,81,24,0,15,9,57,18,5,34,489,286,47,8,231,203,71,7,30,34,132,13,53,66,19956
6202,16500,1446,5038,4511,3066,2439,748,345,309,138,0,171,36,36,12,3,21,0,0,0,0,403,376,79,13,284,27,27,17,10,0,0,0,0,0,19958
6203,4650,955,1689,1251,532,223,486,273,260,31,0,229,13,6,0,0,6,7,0,7,0,213,204,14,14,176,9,9,9,0,0,0,0,0,0,19960
6204,6121,650,1805,2109,1038,519,577,342,315,100,14,201,27,15,15,0,0,12,12,0,0,235,176,67,0,109,59,59,35,0,24,0,0,0,0,19962
6205,14052,2169,5251,3693,1745,1194,595,397,310,100,19,191,87,58,58,0,0,29,5,5,19,198,189,49,20,120,9,9,9,0,0,0,0,0,0,19963
6206,903,158,420,166,106,53,38,27,27,0,0,27,0,0,0,0,0,0,0,0,0,11,11,11,0,0,0,0,0,0,0,0,0,0,0,19964
6207,19753,2951,8456,5582,1752,1012,1114,583,502,204,30,268,81,44,31,2,11,37,32,0,5,531,405,134,34,237,126,104,99,0,5,22,0,4,18,19966
6208,388,34,94,91,95,74,11,9,0,0,0,0,9,7,7,0,0,2,2,0,0,2,2,0,0,2,0,0,0,0,0,0,0,0,0,19967
6209,6681,506,2436,1769,1018,952,353,104,91,38,14,39,13,6,0,0,6,7,0,0,7,249,125,35,13,77,124,45,8,30,7,79,0,38,41,19968
6210,5223,256,1693,1680,1038,556,151,70,70,20,0,50,0,0,0,0,0,0,0,0,0,81,81,42,0,39,0,0,0,0,0,0,0,0,0,19970
6211,9659,301,2092,2509,2700,2057,296,114,106,41,37,28,8,0,0,0,0,8,1,7,0,182,171,88,0,83,11,11,11,0,0,0,0,0,0,19971
6212,15021,2552,6230,3902,1237,1100,993,561,451,116,26,309,110,54,46,8,0,56,6,16,34,432,289,109,34,146,143,68,68,0,0,75,0,0,75,19973
6213,6151,1024,2179,1806,756,386,240,120,77,14,28,35,43,16,7,9,0,27,0,0,27,120,98,10,0,88,22,16,0,0,16,6,6,0,0,19975
6214,16967,3073,5309,5597,2146,842,1089,524,330,94,23,213,194,130,101,0,29,64,0,0,64,565,473,98,11,364,92,38,38,0,0,54,31,23,0,19977
6215,392,16,204,105,58,9,63,45,33,13,0,20,12,0,0,0,0,12,0,12,0,18,16,0,6,10,2,2,2,0,0,0,0,0,0,19979
6216,28074,3900,3851,4219,7965,8139,2462,914,834,55,14,765,80,35,27,0,8,45,0,0,45,1548,1491,298,150,1043,57,51,31,20,0,6,0,0,6,20001
6217,41039,5784,7888,7790,9717,9860,2370,1292,1052,164,219,669,240,107,30,27,50,133,0,8,125,1078,953,171,121,661,125,68,6,18,44,57,0,19,38,20002
6218,21298,1841,3194,2346,5737,8180,720,345,99,17,0,82,246,70,32,0,38,176,0,0,176,375,286,30,36,220,89,49,41,8,0,40,0,0,40,20003
6219,1430,0,6,52,433,939,0,0,0,0,0,0,0,0,0,0,0,0,0,0,0,0,0,0,0,0,0,0,0,0,0,0,0,0,0,20004
6220,10568,843,674,1096,2946,5009,129,104,104,0,100,4,0,0,0,0,0,0,0,0,0,25,25,0,0,25,0,0,0,0,0,0,0,0,0,20005
6221,495,0,22,46,179,248,1487,723,723,55,0,668,0,0,0,0,0,0,0,0,0,764,764,127,8,629,0,0,0,0,0,0,0,0,0,20006
6222,18240,275,577,1628,5868,9892,1087,380,320,33,0,287,60,0,0,0,0,60,0,0,60,707,682,65,10,607,25,0,0,0,0,25,0,0,25,20007
6223,22347,396,796,1593,6739,12823,425,148,115,0,0,115,33,0,0,0,0,33,0,0,33,277,275,90,0,185,2,1,0,0,1,1,0,0,1,20008
6224,40696,3042,2850,4093,12861,17850,1052,222,195,35,0,160,27,19,0,0,19,8,0,0,8,830,792,182,66,544,38,14,0,14,0,24,0,0,24,20009
6225,23923,4334,4031,3129,5668,6761,781,346,311,41,16,254,35,8,0,8,0,27,0,18,9,435,411,115,70,226,24,23,23,0,0,1,0,1,0,20010
6226,44372,7011,11691,10321,8137,7212,2781,1563,1348,87,102,1159,215,102,37,0,65,113,68,0,45,1218,1023,43,66,914,195,173,60,55,58,22,0,0,22,20011
6227,11065,1176,1740,2324,2461,3364,384,215,186,11,14,161,29,7,0,0,7,22,22,0,0,169,169,31,39,99,0,0,0,0,0,0,0,0,0,20012
6228,11378,424,360,1007,3533,6054,437,256,230,42,0,188,26,10,0,0,10,16,0,0,16,181,129,39,12,78,52,52,52,0,0,0,0,0,0,20015
6229,22081,801,879,2095,6965,11341,3535,1590,1550,129,0,1421,40,27,27,0,0,13,0,0,13,1945,1856,406,60,1390,89,39,39,0,0,50,0,0,50,20016
6230,13541,1563,3110,3577,2427,2864,1066,454,370,28,21,321,84,39,28,11,0,45,0,0,45,612,481,92,16,373,131,77,30,0,47,54,38,16,0,20017
6231,12852,1920,3730,3611,1920,1671,782,387,323,49,42,232,64,19,12,0,7,45,24,0,21,395,370,65,51,254,25,25,19,0,6,0,0,0,0,20018
6232,32481,6218,13213,8699,2571,1780,3117,1682,1243,74,71,1098,439,295,86,74,135,144,0,31,113,1435,1121,192,95,834,314,213,28,60,125,101,0,49,52,20019
6233,31043,5550,12563,7950,3036,1944,3596,1774,1281,76,80,1125,493,268,67,153,48,225,32,27,166,1822,1436,55,174,1207,386,287,69,23,195,99,0,25,74,20020
6234,9600,633,1226,1446,2764,3531,160,116,90,0,0,90,26,26,24,2,0,0,0,0,0,44,30,0,0,30,14,0,0,0,0,14,0,0,14,20024
6235,20441,3724,7716,6118,1789,1094,2896,1406,848,21,137,690,558,309,166,46,97,249,39,36,174,1490,825,48,52,725,665,384,111,140,133,281,0,86,195,20032
6236,4489,36,260,316,1452,2425,37,37,35,12,0,23,2,0,0,0,0,2,0,0,2,0,0,0,0,0,0,0,0,0,0,0,0,0,0,20036
6237,8227,266,418,638,2381,4524,1715,540,540,59,15,466,0,0,0,0,0,0,0,0,0,1175,1175,158,38,979,0,0,0,0,0,0,0,0,0,20037
6238,0,0,0,0,0,0,0,0,0,0,0,0,0,0,0,0,0,0,0,0,0,0,0,0,0,0,0,0,0,0,0,0,0,0,0,20045
6239,12,0,0,0,0,12,310,153,153,42,0,111,0,0,0,0,0,0,0,0,0,157,157,59,0,98,0,0,0,0,0,0,0,0,0,20052
6240,0,0,0,0,0,0,0,0,0,0,0,0,0,0,0,0,0,0,0,0,0,0,0,0,0,0,0,0,0,0,0,0,0,0,0,20053
6241,52,0,0,29,9,14,2602,1148,1148,117,13,1018,0,0,0,0,0,0,0,0,0,1454,1454,213,21,1220,0,0,0,0,0,0,0,0,0,20057
6242,67,0,0,27,15,25,1024,464,464,58,7,399,0,0,0,0,0,0,0,0,0,560,560,186,7,367,0,0,0,0,0,0,0,0,0,20064
6243,7766,220,905,1805,3039,1797,622,342,342,137,0,205,0,0,0,0,0,0,0,0,0,280,280,91,8,181,0,0,0,0,0,0,0,0,0,20105
6244,3611,297,905,1305,666,438,283,111,99,21,14,64,12,12,0,0,12,0,0,0,0,172,172,32,0,140,0,0,0,0,0,0,0,0,0,20106
6245,23164,3902,5826,7069,4374,1993,1660,759,553,228,30,295,206,201,34,76,91,5,0,0,5,901,735,240,76,419,166,158,73,8,77,8,8,0,0,20109
6246,28663,4847,7545,8012,5408,2851,2446,1285,1082,247,140,695,203,182,152,24,6,21,0,0,21,1161,1041,229,115,697,120,120,41,0,79,0,0,0,0,20110
6247,19913,3143,5413,5718,3679,1960,1907,959,856,244,59,553,103,88,43,0,45,15,7,0,8,948,871,246,0,625,77,77,77,0,0,0,0,0,0,20111
6248,16606,1031,3185,4223,4611,3556,1816,1085,969,206,19,744,116,93,58,14,21,23,0,18,5,731,651,187,15,449,80,52,51,0,1,28,28,0,0,20112
6249,4205,497,1134,1061,863,650,195,80,80,10,62,8,0,0,0,0,0,0,0,0,0,115,115,31,19,65,0,0,0,0,0,0,0,0,0,20115
6250,1851,122,346,378,618,387,23,9,9,0,4,5,0,0,0,0,0,0,0,0,0,14,14,0,0,14,0,0,0,0,0,0,0,0,0,20117
6251,8,0,6,2,0,0,0,0,0,0,0,0,0,0,0,0,0,0,0,0,0,0,0,0,0,0,0,0,0,0,0,0,0,0,0,20118
6252,2823,315,949,683,456,420,398,203,171,20,51,100,32,32,0,0,32,0,0,0,0,195,170,28,23,119,25,25,0,0,25,0,0,0,0,20119
6253,26793,1410,4171,6280,8883,6049,2648,1432,1313,189,156,968,119,107,51,14,42,12,12,0,0,1216,1105,257,124,724,111,97,62,18,17,14,0,0,14,20120
6254,18725,1235,2802,4778,6839,3071,1492,776,598,204,22,372,178,178,129,7,42,0,0,0,0,716,691,251,11,429,25,0,0,0,0,25,25,0,0,20121
6255,10409,306,1017,2126,3953,3007,1192,741,660,197,47,416,81,38,25,13,0,43,0,0,43,451,451,157,34,260,0,0,0,0,0,0,0,0,0,20124
6256,425,18,71,50,159,127,66,53,53,9,10,34,0,0,0,0,0,0,0,0,0,13,13,13,0,0,0,0,0,0,0,0,0,0,0,20129
6257,226,41,67,53,39,26,0,0,0,0,0,0,0,0,0,0,0,0,0,0,0,0,0,0,0,0,0,0,0,0,0,0,0,0,0,20130
6258,10544,599,1950,2596,3274,2125,1040,506,491,229,47,215,15,15,0,13,2,0,0,0,0,534,459,265,21,173,75,34,0,34,0,41,41,0,0,20132
6259,1975,131,595,591,412,246,124,60,60,10,0,50,0,0,0,0,0,0,0,0,0,64,64,15,15,34,0,0,0,0,0,0,0,0,0,20135
6260,17508,781,2307,5180,5400,3840,1598,829,711,138,34,539,118,67,39,13,15,51,51,0,0,769,724,183,137,404,45,6,6,0,0,39,0,0,39,20136
6261,1084,85,189,422,262,126,80,46,18,0,0,18,28,28,10,0,18,0,0,0,0,34,34,21,0,13,0,0,0,0,0,0,0,0,0,20137
6262,147,0,31,52,14,50,0,0,0,0,0,0,0,0,0,0,0,0,0,0,0,0,0,0,0,0,0,0,0,0,0,0,0,0,0,20139
6263,4000,132,678,847,1494,849,432,169,138,66,0,72,31,22,7,15,0,9,0,0,9,263,254,30,23,201,9,9,9,0,0,0,0,0,0,20141
6264,807,50,127,242,244,144,22,0,0,0,0,0,0,0,0,0,0,0,0,0,0,22,22,0,0,22,0,0,0,0,0,0,0,0,0,20143
6265,926,30,206,250,299,141,73,66,60,20,0,40,6,6,6,0,0,0,0,0,0,7,7,0,0,7,0,0,0,0,0,0,0,0,0,20144
6266,36750,1492,4091,8431,13192,9544,2765,1300,1237,360,97,780,63,63,30,0,33,0,0,0,0,1465,1403,525,93,785,62,25,15,0,10,37,37,0,0,20147
6267,18795,432,1046,3008,8426,5883,1134,621,596,131,38,427,25,25,0,0,25,0,0,0,0,513,478,118,39,321,35,35,35,0,0,0,0,0,0,20148
6268,13619,1168,2376,2982,4102,2991,1594,810,789,210,40,539,21,21,0,0,21,0,0,0,0,784,733,244,14,475,51,43,43,0,0,8,0,0,8,20151
6269,15948,578,1394,2685,6844,4447,1171,583,556,251,38,267,27,12,12,0,0,15,0,0,15,588,553,123,34,396,35,35,35,0,0,0,0,0,0,20152
6270,20458,1117,3200,5965,6119,4057,1223,602,529,73,41,415,73,33,20,13,0,40,40,0,0,621,606,264,11,331,15,15,15,0,0,0,0,0,0,20155
6271,2793,175,606,555,863,594,290,108,108,64,0,44,0,0,0,0,0,0,0,0,0,182,182,31,0,151,0,0,0,0,0,0,0,0,0,20158
6272,24241,3744,6215,5432,6016,2834,2383,1394,1144,374,97,673,250,153,79,10,64,97,77,0,20,989,935,330,115,490,54,43,12,8,23,11,11,0,0,20164
6273,22031,497,2641,5318,7942,5633,1681,948,908,309,27,572,40,40,13,0,27,0,0,0,0,733,715,245,18,452,18,0,0,0,0,18,0,0,18,20165
6274,6744,633,844,1263,2629,1375,461,233,204,66,77,61,29,29,29,0,0,0,0,0,0,228,208,98,0,110,20,20,20,0,0,0,0,0,0,20166
6275,13180,494,1781,3452,4440,3013,1268,734,645,233,62,350,89,89,59,30,0,0,0,0,0,534,532,90,42,400,2,2,2,0,0,0,0,0,0,20169
6276,27773,4051,3659,5277,8739,6047,1775,973,897,276,36,585,76,55,9,46,0,21,0,0,21,802,662,130,48,484,140,100,49,12,39,40,0,0,40,20170
6277,31421,1194,2149,4993,11615,11470,2183,996,959,243,23,693,37,37,16,0,21,0,0,0,0,1187,1179,280,18,881,8,0,0,0,0,8,0,0,8,20171
6278,18605,878,2898,4617,6421,3791,1433,755,740,150,50,540,15,8,0,0,8,7,0,0,7,678,567,97,26,444,111,111,88,0,23,0,0,0,0,20175
6279,30083,3117,4430,6621,9610,6305,2076,1171,1158,363,74,721,13,2,0,0,2,11,11,0,0,905,893,319,14,560,12,0,0,0,0,12,0,12,0,20176
6280,4022,136,775,1078,1413,620,407,177,172,23,2,147,5,5,5,0,0,0,0,0,0,230,206,100,0,106,24,24,0,24,0,0,0,0,0,20180
6281,5234,605,1277,1901,818,633,477,283,254,26,0,228,29,29,29,0,0,0,0,0,0,194,194,40,0,154,0,0,0,0,0,0,0,0,0,20181
6282,559,28,70,31,215,215,105,26,26,0,0,26,0,0,0,0,0,0,0,0,0,79,79,0,0,79,0,0,0,0,0,0,0,0,0,20184
6283,10296,763,2838,3109,2253,1333,716,287,235,88,36,111,52,30,15,0,15,22,0,0,22,429,310,91,26,193,119,98,81,17,0,21,0,0,21,20186
6284,10683,458,2195,3447,2865,1718,844,472,408,59,21,328,64,64,29,35,0,0,0,0,0,372,300,49,0,251,72,72,7,65,0,0,0,0,0,20187
6285,13856,472,1493,2830,5158,3903,494,253,240,113,24,103,13,0,0,0,0,13,0,0,13,241,241,92,32,117,0,0,0,0,0,0,0,0,0,20190
6286,20800,1278,2215,4288,7274,5745,1169,502,502,126,130,246,0,0,0,0,0,0,0,0,0,667,638,133,144,361,29,11,11,0,0,18,9,0,9,20191
6287,9700,311,607,1389,3917,3476,539,213,213,77,0,136,0,0,0,0,0,0,0,0,0,326,263,68,19,176,63,55,55,0,0,8,0,0,8,20194
6288,971,9,153,124,393,292,54,0,0,0,0,0,0,0,0,0,0,0,0,0,0,54,31,0,0,31,23,23,23,0,0,0,0,0,0,20197
6289,1662,117,405,581,318,241,33,5,1,0,0,1,4,4,0,4,0,0,0,0,0,28,17,15,0,2,11,11,0,0,11,0,0,0,0,20198
6290,0,0,0,0,0,0,0,0,0,0,0,0,0,0,0,0,0,0,0,0,0,0,0,0,0,0,0,0,0,0,0,0,0,0,0,20202
6291,0,0,0,0,0,0,0,0,0,0,0,0,0,0,0,0,0,0,0,0,0,0,0,0,0,0,0,0,0,0,0,0,0,0,0,20204
6292,0,0,0,0,0,0,0,0,0,0,0,0,0,0,0,0,0,0,0,0,0,0,0,0,0,0,0,0,0,0,0,0,0,0,0,20228
6293,0,0,0,0,0,0,0,0,0,0,0,0,0,0,0,0,0,0,0,0,0,0,0,0,0,0,0,0,0,0,0,0,0,0,0,20230
6294,0,0,0,0,0,0,0,0,0,0,0,0,0,0,0,0,0,0,0,0,0,0,0,0,0,0,0,0,0,0,0,0,0,0,0,20240
6295,0,0,0,0,0,0,0,0,0,0,0,0,0,0,0,0,0,0,0,0,0,0,0,0,0,0,0,0,0,0,0,0,0,0,0,20245
6296,0,0,0,0,0,0,0,0,0,0,0,0,0,0,0,0,0,0,0,0,0,0,0,0,0,0,0,0,0,0,0,0,0,0,0,20260
6297,104,6,52,37,9,0,0,0,0,0,0,0,0,0,0,0,0,0,0,0,0,0,0,0,0,0,0,0,0,0,0,0,0,0,0,20307
6298,355,50,95,70,54,86,0,0,0,0,0,0,0,0,0,0,0,0,0,0,0,0,0,0,0,0,0,0,0,0,0,0,0,0,0,20317
6299,5,0,5,0,0,0,33,33,0,0,0,0,33,33,33,0,0,0,0,0,0,0,0,0,0,0,0,0,0,0,0,0,0,0,0,20319
6300,14,0,9,0,5,0,3,3,0,0,0,0,3,3,3,0,0,0,0,0,0,0,0,0,0,0,0,0,0,0,0,0,0,0,0,20373
6301,18,0,7,11,0,0,73,73,15,15,0,0,58,58,58,0,0,0,0,0,0,0,0,0,0,0,0,0,0,0,0,0,0,0,0,20390
6302,0,0,0,0,0,0,0,0,0,0,0,0,0,0,0,0,0,0,0,0,0,0,0,0,0,0,0,0,0,0,0,0,0,0,0,20405
6303,0,0,0,0,0,0,0,0,0,0,0,0,0,0,0,0,0,0,0,0,0,0,0,0,0,0,0,0,0,0,0,0,0,0,0,20418
6304,0,0,0,0,0,0,0,0,0,0,0,0,0,0,0,0,0,0,0,0,0,0,0,0,0,0,0,0,0,0,0,0,0,0,0,20427
6305,0,0,0,0,0,0,0,0,0,0,0,0,0,0,0,0,0,0,0,0,0,0,0,0,0,0,0,0,0,0,0,0,0,0,0,20506
6306,0,0,0,0,0,0,0,0,0,0,0,0,0,0,0,0,0,0,0,0,0,0,0,0,0,0,0,0,0,0,0,0,0,0,0,20510
6307,0,0,0,0,0,0,0,0,0,0,0,0,0,0,0,0,0,0,0,0,0,0,0,0,0,0,0,0,0,0,0,0,0,0,0,20520
6308,0,0,0,0,0,0,0,0,0,0,0,0,0,0,0,0,0,0,0,0,0,0,0,0,0,0,0,0,0,0,0,0,0,0,0,20535
6309,0,0,0,0,0,0,0,0,0,0,0,0,0,0,0,0,0,0,0,0,0,0,0,0,0,0,0,0,0,0,0,0,0,0,0,20540
6310,0,0,0,0,0,0,0,0,0,0,0,0,0,0,0,0,0,0,0,0,0,0,0,0,0,0,0,0,0,0,0,0,0,0,0,20551
6311,0,0,0,0,0,0,0,0,0,0,0,0,0,0,0,0,0,0,0,0,0,0,0,0,0,0,0,0,0,0,0,0,0,0,0,20553
6312,0,0,0,0,0,0,0,0,0,0,0,0,0,0,0,0,0,0,0,0,0,0,0,0,0,0,0,0,0,0,0,0,0,0,0,20560
6313,0,0,0,0,0,0,0,0,0,0,0,0,0,0,0,0,0,0,0,0,0,0,0,0,0,0,0,0,0,0,0,0,0,0,0,20565
6314,0,0,0,0,0,0,0,0,0,0,0,0,0,0,0,0,0,0,0,0,0,0,0,0,0,0,0,0,0,0,0,0,0,0,0,20566
6315,0,0,0,0,0,0,0,0,0,0,0,0,0,0,0,0,0,0,0,0,0,0,0,0,0,0,0,0,0,0,0,0,0,0,0,20593
6316,16156,1268,4833,5784,2966,1305,1723,1075,808,89,110,609,267,219,38,37,144,48,20,0,28,648,603,75,42,486,45,27,0,12,15,18,18,0,0,20601
6317,16217,1503,5674,5190,2378,1472,1494,416,344,61,40,243,72,55,24,0,31,17,0,17,0,1078,812,210,38,564,266,163,163,0,0,103,0,0,103,20602
6318,18852,1032,4311,6513,4162,2834,1909,853,709,88,103,518,144,40,32,0,8,104,0,48,56,1056,996,271,106,619,60,42,25,17,0,18,0,0,18,20603
6319,280,53,106,96,25,0,34,0,0,0,0,0,0,0,0,0,0,0,0,0,0,34,34,14,0,20,0,0,0,0,0,0,0,0,0,20606
6320,6740,371,1477,2297,1318,1277,343,165,165,46,25,94,0,0,0,0,0,0,0,0,0,178,126,53,0,73,52,22,22,0,0,30,0,0,30,20607
6321,565,120,203,168,54,20,33,15,15,4,0,11,0,0,0,0,0,0,0,0,0,18,10,0,3,7,8,6,0,6,0,2,0,2,0,20608
6322,726,108,272,215,74,57,55,44,12,12,0,0,32,32,32,0,0,0,0,0,0,11,11,0,0,11,0,0,0,0,0,0,0,0,0,20609
6323,769,35,348,258,73,55,70,16,5,0,0,5,11,11,0,4,7,0,0,0,0,54,38,0,0,38,16,16,0,5,11,0,0,0,0,20611
6324,262,106,85,28,0,43,0,0,0,0,0,0,0,0,0,0,0,0,0,0,0,0,0,0,0,0,0,0,0,0,0,0,0,0,0,20612
6325,9394,922,3044,2962,1712,754,891,596,496,121,68,307,100,86,66,20,0,14,0,0,14,295,283,81,0,202,12,0,0,0,0,12,0,12,0,20613
6326,314,21,92,121,44,36,40,7,7,7,0,0,0,0,0,0,0,0,0,0,0,33,33,0,33,0,0,0,0,0,0,0,0,0,0,20615
6327,4212,439,1409,1564,579,221,514,235,77,50,0,27,158,158,113,0,45,0,0,0,0,279,258,51,18,189,21,21,0,0,21,0,0,0,0,20616
6328,610,79,116,219,79,117,124,104,27,0,0,27,77,32,17,0,15,45,0,0,45,20,20,10,0,10,0,0,0,0,0,0,0,0,0,20617
6329,532,57,214,168,63,30,58,30,30,0,0,30,0,0,0,0,0,0,0,0,0,28,28,28,0,0,0,0,0,0,0,0,0,0,0,20618
6330,6828,185,1212,1930,1971,1530,555,295,253,76,34,143,42,42,42,0,0,0,0,0,0,260,241,109,0,132,19,0,0,0,0,19,0,0,19,20619
6331,921,140,210,371,115,85,99,39,39,0,0,39,0,0,0,0,0,0,0,0,0,60,60,47,0,13,0,0,0,0,0,0,0,0,0,20620
6332,949,109,319,317,174,30,26,26,26,0,8,18,0,0,0,0,0,0,0,0,0,0,0,0,0,0,0,0,0,0,0,0,0,0,0,20621
6333,3310,458,1259,873,425,295,262,99,73,44,15,14,26,22,0,22,0,4,0,0,4,163,163,44,12,107,0,0,0,0,0,0,0,0,0,20622
6334,1874,89,535,614,414,222,215,28,28,0,0,28,0,0,0,0,0,0,0,0,0,187,187,84,5,98,0,0,0,0,0,0,0,0,0,20623
6335,850,82,432,238,28,70,57,26,26,0,0,26,0,0,0,0,0,0,0,0,0,31,31,7,0,24,0,0,0,0,0,0,0,0,0,20624
6336,459,39,164,200,36,20,0,0,0,0,0,0,0,0,0,0,0,0,0,0,0,0,0,0,0,0,0,0,0,0,0,0,0,0,0,20625
6337,232,27,80,55,62,8,0,0,0,0,0,0,0,0,0,0,0,0,0,0,0,0,0,0,0,0,0,0,0,0,0,0,0,0,0,20626
6338,206,35,105,21,0,45,0,0,0,0,0,0,0,0,0,0,0,0,0,0,0,0,0,0,0,0,0,0,0,0,0,0,0,0,0,20628
6339,191,0,43,104,30,14,0,0,0,0,0,0,0,0,0,0,0,0,0,0,0,0,0,0,0,0,0,0,0,0,0,0,0,0,0,20629
6340,209,0,78,52,20,59,0,0,0,0,0,0,0,0,0,0,0,0,0,0,0,0,0,0,0,0,0,0,0,0,0,0,0,0,0,20630
6341,193,42,93,30,28,0,19,19,19,0,7,12,0,0,0,0,0,0,0,0,0,0,0,0,0,0,0,0,0,0,0,0,0,0,0,20632
6342,4307,473,1336,1398,712,388,205,80,72,0,0,72,8,5,2,1,2,3,3,0,0,125,125,35,36,54,0,0,0,0,0,0,0,0,0,20634
6343,7236,607,2174,2409,1227,819,604,334,254,28,83,143,80,0,0,0,0,80,66,14,0,270,252,61,17,174,18,0,0,0,0,18,0,0,18,20636
6344,3416,330,1127,913,662,384,200,149,112,23,0,89,37,37,20,0,17,0,0,0,0,51,38,26,0,12,13,0,0,0,0,13,0,0,13,20637
6345,9532,567,2948,2539,1898,1580,1161,609,589,62,99,428,20,20,0,20,0,0,0,0,0,552,507,177,61,269,45,34,22,0,12,11,5,0,6,20639
6346,6764,979,2400,2519,572,294,834,537,374,13,130,231,163,158,85,10,63,5,0,0,5,297,247,113,10,124,50,14,0,14,0,36,30,0,6,20640
6347,647,15,220,193,190,29,45,32,32,21,0,11,0,0,0,0,0,0,0,0,0,13,13,7,0,6,0,0,0,0,0,0,0,0,0,20645
6348,13358,1029,4088,4460,2257,1524,952,405,327,88,30,209,78,56,22,0,34,22,11,0,11,547,503,96,25,382,44,34,34,0,0,10,0,0,10,20646
6349,8914,984,2500,1809,2029,1592,700,430,338,157,56,125,92,92,29,18,45,0,0,0,0,270,224,59,7,158,46,0,0,0,0,46,12,0,34,20650
6350,15264,1646,4223,4468,3087,1840,1803,905,751,213,9,529,154,131,84,12,35,23,0,0,23,898,734,127,15,592,164,47,42,5,0,117,47,36,34,20653
6351,12677,742,4299,4708,1640,1288,1162,529,409,158,12,239,120,120,25,73,22,0,0,0,0,633,560,239,55,266,73,73,65,0,8,0,0,0,0,20657
6352,695,53,324,204,78,36,77,59,31,0,0,31,28,16,0,0,16,12,0,12,0,18,4,0,0,4,14,5,0,0,5,9,0,0,9,20658
6353,14972,1538,6336,4637,1609,852,1386,741,628,142,11,475,113,49,0,25,24,64,0,64,0,645,538,162,33,343,107,85,44,18,23,22,9,0,13,20659
6354,1,0,0,0,1,0,1,1,0,0,0,0,1,0,0,0,0,1,1,0,0,0,0,0,0,0,0,0,0,0,0,0,0,0,0,20660
6355,1730,388,707,350,167,118,236,108,108,21,23,64,0,0,0,0,0,0,0,0,0,128,128,34,11,83,0,0,0,0,0,0,0,0,0,20662
6356,2030,204,1038,458,171,159,96,52,36,0,0,36,16,16,16,0,0,0,0,0,0,44,28,0,0,28,16,16,16,0,0,0,0,0,0,20664
6357,381,40,84,158,50,49,76,9,9,9,0,0,0,0,0,0,0,0,0,0,0,67,67,0,0,67,0,0,0,0,0,0,0,0,0,20667
6358,546,12,174,255,86,19,87,62,32,4,11,17,30,4,4,0,0,26,26,0,0,25,15,0,0,15,10,10,10,0,0,0,0,0,0,20670
6359,715,107,171,200,97,140,23,0,0,0,0,0,0,0,0,0,0,0,0,0,0,23,23,23,0,0,0,0,0,0,0,0,0,0,0,20674
6360,1085,79,284,373,258,91,21,13,0,0,0,0,13,1,0,0,1,12,12,0,0,8,0,0,0,0,8,8,0,8,0,0,0,0,0,20675
6361,2282,201,715,580,494,292,107,84,63,41,0,22,21,0,0,0,0,21,0,0,21,23,23,12,6,5,0,0,0,0,0,0,0,0,0,20676
6362,1612,141,419,437,387,228,219,143,143,47,0,96,0,0,0,0,0,0,0,0,0,76,76,16,33,27,0,0,0,0,0,0,0,0,0,20677
6363,8050,963,3184,2263,974,666,522,244,192,68,24,100,52,47,24,10,13,5,0,0,5,278,201,46,18,137,77,77,39,0,38,0,0,0,0,20678
6364,1021,63,376,457,24,101,32,1,0,0,0,0,1,1,0,0,1,0,0,0,0,31,31,0,0,31,0,0,0,0,0,0,0,0,0,20680
6365,552,26,173,218,96,39,97,10,0,0,0,0,10,0,0,0,0,10,10,0,0,87,0,0,0,0,87,40,26,0,14,47,47,0,0,20684
6366,4494,268,1341,1485,888,512,522,290,239,77,16,146,51,45,45,0,0,6,0,6,0,232,218,79,25,114,14,14,14,0,0,0,0,0,0,20685
6367,64,0,1,1,0,62,456,162,162,62,0,100,0,0,0,0,0,0,0,0,0,294,294,97,0,197,0,0,0,0,0,0,0,0,0,20686
6368,319,11,109,83,52,64,27,0,0,0,0,0,0,0,0,0,0,0,0,0,0,27,27,27,0,0,0,0,0,0,0,0,0,0,0,20687
6369,1478,143,201,304,472,358,20,20,20,0,0,20,0,0,0,0,0,0,0,0,0,0,0,0,0,0,0,0,0,0,0,0,0,0,0,20688
6370,949,100,251,283,211,104,119,71,28,0,0,28,43,43,18,14,11,0,0,0,0,48,38,38,0,0,10,10,10,0,0,0,0,0,0,20689
6371,369,31,28,107,67,136,0,0,0,0,0,0,0,0,0,0,0,0,0,0,0,0,0,0,0,0,0,0,0,0,0,0,0,0,0,20690
6372,1109,121,300,393,178,117,0,0,0,0,0,0,0,0,0,0,0,0,0,0,0,0,0,0,0,0,0,0,0,0,0,0,0,0,0,20692
6373,802,110,256,171,185,80,30,12,12,0,0,12,0,0,0,0,0,0,0,0,0,18,18,0,0,18,0,0,0,0,0,0,0,0,0,20693
6374,3775,175,1030,1432,618,520,251,114,86,0,0,86,28,28,28,0,0,0,0,0,0,137,137,24,57,56,0,0,0,0,0,0,0,0,0,20695
6375,108,48,36,20,0,4,0,0,0,0,0,0,0,0,0,0,0,0,0,0,0,0,0,0,0,0,0,0,0,0,0,0,0,0,0,20701
6376,17443,2939,4304,4391,3670,2139,1105,611,563,69,103,391,48,48,19,29,0,0,0,0,0,494,455,98,41,316,39,39,21,0,18,0,0,0,0,20705
6377,23668,4026,6389,7164,3672,2417,2525,1314,1069,184,62,823,245,245,146,31,68,0,0,0,0,1211,1072,144,58,870,139,117,68,5,44,22,0,22,0,20706
6378,22336,2931,4649,5777,5171,3808,1205,628,524,118,49,357,104,96,87,9,0,8,0,0,8,577,488,94,71,323,89,89,89,0,0,0,0,0,0,20707
6379,16236,1777,4305,4555,3384,2215,1144,504,428,44,58,326,76,28,10,18,0,48,32,7,9,640,582,95,76,411,58,57,30,8,19,1,0,0,1,20708
6380,6018,1302,2100,1766,522,328,359,151,110,4,19,87,41,16,16,0,0,25,25,0,0,208,141,87,0,54,67,40,40,0,0,27,0,0,27,20710
6381,4534,642,2051,988,386,467,447,205,178,54,10,114,27,27,27,0,0,0,0,0,0,242,184,93,49,42,58,0,0,0,0,58,0,49,9,20711
6382,6195,1552,1839,1091,1031,682,358,121,47,0,0,47,74,28,0,19,9,46,46,0,0,237,177,42,0,135,60,24,6,0,18,36,0,0,36,20712
6383,3025,190,1102,857,518,358,218,86,86,36,0,50,0,0,0,0,0,0,0,0,0,132,89,5,0,84,43,10,5,0,5,33,33,0,0,20714
6384,17862,812,3852,5154,4646,3398,1940,967,855,142,51,662,112,53,10,43,0,59,9,44,6,973,936,284,111,541,37,27,15,0,12,10,0,0,10,20715
6385,14191,612,2813,4625,3422,2719,1156,699,604,172,128,304,95,94,42,52,0,1,0,0,1,457,446,122,61,263,11,0,0,0,0,11,0,0,11,20716
6386,14557,861,2497,3941,3940,3318,1086,493,474,187,54,233,19,19,11,0,8,0,0,0,0,593,529,178,52,299,64,64,64,0,0,0,0,0,0,20720
6387,17776,633,2368,5448,4893,4434,1573,714,643,231,92,320,71,41,23,17,1,30,0,0,30,859,808,147,84,577,51,51,28,0,23,0,0,0,0,20721
6388,3454,1138,944,796,353,223,192,93,82,30,11,41,11,9,4,0,5,2,0,0,2,99,52,7,7,38,47,19,10,0,9,28,0,0,28,20722
6389,19073,789,3520,5036,5152,4576,1765,845,784,215,82,487,61,50,50,0,0,11,11,0,0,920,875,304,85,486,45,45,45,0,0,0,0,0,0,20723
6390,11251,1332,2209,3033,2400,2277,676,320,230,50,3,177,90,67,57,9,1,23,20,0,3,356,285,51,0,234,71,68,0,68,0,3,0,3,0,20724
6391,6464,509,1840,2051,1237,827,733,436,397,110,48,239,39,39,12,27,0,0,0,0,0,297,246,56,49,141,51,51,11,0,40,0,0,0,0,20732
6392,1827,72,595,677,305,178,166,81,42,9,0,33,39,39,9,0,30,0,0,0,0,85,85,31,9,45,0,0,0,0,0,0,0,0,0,20733
6393,25374,2075,7774,8789,4262,2474,2000,954,710,96,45,569,244,127,31,61,35,117,38,0,79,1046,965,81,117,767,81,55,55,0,0,26,11,0,15,20735
6394,6391,418,2111,1816,1171,875,582,339,314,119,14,181,25,25,19,6,0,0,0,0,0,243,233,134,41,58,10,10,0,0,10,0,0,0,0,20736
6395,12556,4342,3254,2839,1333,788,915,553,430,42,103,285,123,75,23,52,0,48,42,0,6,362,268,21,0,247,94,47,23,24,0,47,18,21,8,20737
6396,14560,1664,2648,2860,3530,3858,2468,1334,1306,305,55,946,28,18,0,6,12,10,0,10,0,1134,1039,341,69,629,95,95,24,45,26,0,0,0,0,20740
6397,0,0,0,0,0,0,6615,3315,3315,477,146,2692,0,0,0,0,0,0,0,0,0,3300,3300,843,99,2358,0,0,0,0,0,0,0,0,0,20742
6398,24622,3695,9457,7904,2368,1198,2222,1366,975,106,305,564,391,242,70,126,46,149,46,11,92,856,598,170,47,381,258,215,61,87,67,43,20,0,23,20743
6399,35518,2929,8986,12016,6995,4592,2816,1642,1441,184,145,1112,201,161,105,38,18,40,16,0,24,1174,976,240,118,618,198,195,116,49,30,3,1,0,2,20744
6400,19847,3458,7229,5833,2175,1152,1867,956,619,116,74,429,337,208,58,15,135,129,23,13,93,911,764,91,229,444,147,101,39,33,29,46,28,18,0,20745
6401,17969,2018,6487,5778,2478,1208,1804,958,814,77,114,623,144,113,14,47,52,31,12,0,19,846,599,188,88,323,247,202,125,68,9,45,0,0,45,20746
6402,24904,2446,10172,8003,2928,1355,1948,909,767,235,97,435,142,127,75,51,1,15,0,14,1,1039,817,240,136,441,222,118,15,58,45,104,16,16,72,20747
6403,25870,2574,9164,8674,3634,1824,2107,1084,862,97,182,583,222,87,40,40,7,135,0,83,52,1023,785,176,59,550,238,168,101,17,50,70,30,0,40,20748
6404,1705,280,447,465,334,179,46,33,26,0,0,26,7,7,7,0,0,0,0,0,0,13,13,0,0,13,0,0,0,0,0,0,0,0,0,20751
6405,4549,179,1369,1332,1143,526,530,254,208,66,24,118,46,31,22,9,0,15,0,0,15,276,235,78,5,152,41,41,8,5,28,0,0,0,0,20754
6406,4554,98,491,2496,1047,422,566,342,247,191,0,56,95,87,45,3,39,8,8,0,0,224,197,100,0,97,27,27,15,0,12,0,0,0,0,20755
6407,434,57,146,129,39,63,26,0,0,0,0,0,0,0,0,0,0,0,0,0,0,26,26,26,0,0,0,0,0,0,0,0,0,0,0,20758
6408,1981,54,329,369,776,453,146,59,46,0,0,46,13,13,13,0,0,0,0,0,0,87,87,40,0,47,0,0,0,0,0,0,0,0,0,20759
6409,1837,70,316,970,352,129,119,97,90,37,0,53,7,7,0,0,7,0,0,0,0,22,21,6,0,15,1,1,1,0,0,0,0,0,0,20762
6410,1154,106,112,330,336,270,151,96,87,29,13,45,9,9,9,0,0,0,0,0,0,55,55,0,0,55,0,0,0,0,0,0,0,0,0,20763
6411,3071,202,854,1080,558,377,212,31,31,0,0,31,0,0,0,0,0,0,0,0,0,181,181,98,0,83,0,0,0,0,0,0,0,0,0,20764
6412,349,11,89,123,22,104,12,0,0,0,0,0,0,0,0,0,0,0,0,0,0,12,12,0,0,12,0,0,0,0,0,0,0,0,0,20765
6413,4182,211,696,1284,1114,877,371,209,190,51,51,88,19,19,0,19,0,0,0,0,0,162,141,65,0,76,21,21,14,0,7,0,0,0,0,20769
6414,16483,1623,3950,4281,3709,2920,1395,635,515,36,65,414,120,65,18,0,47,55,0,0,55,760,684,232,0,452,76,12,12,0,0,64,57,7,0,20770
6415,29648,1937,7665,9082,5922,5042,2306,1223,1068,149,34,885,155,99,65,4,30,56,0,0,56,1083,943,243,91,609,140,110,89,20,1,30,18,0,12,20772
6416,29830,1559,6440,9800,6897,5134,2192,1131,867,78,31,758,264,224,164,33,27,40,9,31,0,1061,951,165,72,714,110,45,5,0,40,65,0,37,28,20774
6417,2690,268,1141,816,285,180,126,125,102,14,12,76,23,10,10,0,0,13,13,0,0,1,1,0,0,1,0,0,0,0,0,0,0,0,0,20776
6418,2209,54,380,410,692,673,172,22,22,10,0,12,0,0,0,0,0,0,0,0,0,150,150,50,0,100,0,0,0,0,0,0,0,0,0,20777
6419,1416,10,336,587,352,131,119,81,63,0,0,63,18,1,0,0,1,17,0,0,17,38,38,27,0,11,0,0,0,0,0,0,0,0,0,20778
6420,1029,47,371,220,177,214,54,33,24,0,0,24,9,0,0,0,0,9,0,0,9,21,9,0,0,9,12,12,12,0,0,0,0,0,0,20779
6421,7360,1991,1918,1459,855,1137,652,376,283,65,4,214,93,15,7,0,8,78,42,0,36,276,175,45,15,115,101,42,23,0,19,59,0,10,49,20781
6422,21986,5829,5160,5109,3143,2745,1520,764,576,61,77,438,188,106,70,28,8,82,66,0,16,756,604,77,52,475,152,88,60,15,13,64,35,29,0,20782
6423,31914,14557,7057,4826,3347,2127,1650,930,641,65,127,449,289,96,82,14,0,193,82,35,76,720,548,213,134,201,172,94,42,12,40,78,55,0,23,20783
6424,18812,4535,6274,5061,1894,1048,1568,922,712,158,127,427,210,110,56,40,14,100,28,54,18,646,478,173,51,254,168,133,11,86,36,35,22,0,13,20784
6425,23119,3047,7732,7115,3075,2150,2294,1074,901,209,150,542,173,144,59,12,73,29,14,0,15,1220,1097,190,105,802,123,95,51,11,33,28,0,0,28,20785
6426,11151,2837,3276,2870,1581,587,313,192,103,18,10,75,89,15,0,0,15,74,0,0,74,121,70,50,0,20,51,51,38,9,4,0,0,0,0,20794
6427,176,1,5,12,71,87,16,6,5,0,0,5,1,1,1,0,0,0,0,0,0,10,10,0,0,10,0,0,0,0,0,0,0,0,0,20812
6428,20463,601,1217,2308,5895,10442,858,456,389,133,0,256,67,52,46,0,6,15,3,0,12,402,393,109,0,284,9,9,9,0,0,0,0,0,0,20814
6429,22664,441,1083,2111,6156,12873,1173,636,619,144,31,444,17,17,8,0,9,0,0,0,0,537,518,110,21,387,19,15,0,0,15,4,0,0,4,20815
6430,10989,91,595,990,3154,6159,736,412,412,89,10,313,0,0,0,0,0,0,0,0,0,324,324,68,11,245,0,0,0,0,0,0,0,0,0,20816
6431,24997,583,1388,2927,7114,12985,1648,870,823,118,43,662,47,28,28,0,0,19,0,0,19,778,769,120,14,635,9,9,0,9,0,0,0,0,0,20817
6432,1454,29,178,206,390,651,65,34,34,0,0,34,0,0,0,0,0,0,0,0,0,31,31,0,0,31,0,0,0,0,0,0,0,0,0,20818
6433,16275,644,1990,3881,5327,4433,1999,1122,1075,324,72,679,47,39,38,0,1,8,0,0,8,877,866,211,8,647,11,0,0,0,0,11,0,0,11,20832
6434,5135,187,488,934,1750,1776,324,152,152,38,19,95,0,0,0,0,0,0,0,0,0,172,172,97,0,75,0,0,0,0,0,0,0,0,0,20833
6435,3854,152,699,1115,1153,735,517,285,285,73,0,212,0,0,0,0,0,0,0,0,0,232,232,51,0,181,0,0,0,0,0,0,0,0,0,20837
6436,167,2,21,29,71,44,11,2,2,0,0,2,0,0,0,0,0,0,0,0,0,9,9,6,0,3,0,0,0,0,0,0,0,0,0,20838
6437,95,0,24,41,18,12,38,13,13,13,0,0,0,0,0,0,0,0,0,0,0,25,25,0,0,25,0,0,0,0,0,0,0,0,0,20839
6438,6559,584,616,1389,1893,2077,647,324,282,54,0,228,42,0,0,0,0,42,23,0,19,323,323,69,10,244,0,0,0,0,0,0,0,0,0,20841
6439,1153,35,290,345,242,241,72,47,43,0,18,25,4,0,0,0,0,4,4,0,0,25,17,13,0,4,8,5,5,0,0,3,3,0,0,20842
6440,33322,1923,3394,6001,9309,12695,1959,977,900,265,37,598,77,49,21,13,15,28,23,0,5,982,939,196,34,709,43,43,11,0,32,0,0,0,0,20850
6441,9274,1106,2248,1681,2204,2035,764,397,352,55,32,265,45,29,29,0,0,16,0,0,16,367,346,165,0,181,21,21,21,0,0,0,0,0,0,20851
6442,31890,1549,3138,4868,9478,12857,1497,710,693,97,104,492,17,17,17,0,0,0,0,0,0,787,738,362,41,335,49,10,10,0,0,39,23,0,16,20852
6443,20783,2346,3777,4724,5241,4695,1488,748,719,205,42,472,29,29,29,0,0,0,0,0,0,740,718,175,53,490,22,5,0,5,0,17,0,0,17,20853
6444,34360,960,2151,3781,10097,17371,2680,1254,1244,134,93,1017,10,1,0,0,1,9,0,0,9,1426,1393,376,7,1010,33,33,0,0,33,0,0,0,0,20854
6445,9556,446,1290,1903,2931,2986,1120,614,518,94,56,368,96,39,18,10,11,57,47,0,10,506,506,68,0,438,0,0,0,0,0,0,0,0,0,20855
6446,1765,144,238,427,511,445,226,79,67,0,0,67,12,12,12,0,0,0,0,0,0,147,147,51,0,96,0,0,0,0,0,0,0,0,0,20860
6447,1168,13,184,171,407,393,99,41,41,0,16,25,0,0,0,0,0,0,0,0,0,58,58,0,0,58,0,0,0,0,0,0,0,0,0,20861
6448,137,0,23,12,9,93,0,0,0,0,0,0,0,0,0,0,0,0,0,0,0,0,0,0,0,0,0,0,0,0,0,0,0,0,0,20862
6449,8142,588,1412,1994,2212,1936,1006,502,492,77,60,355,10,10,0,9,1,0,0,0,0,504,471,144,24,303,33,33,6,11,16,0,0,0,0,20866
6450,666,5,212,203,128,118,151,139,139,18,0,121,0,0,0,0,0,0,0,0,0,12,12,12,0,0,0,0,0,0,0,0,0,0,0,20868
6451,9477,442,1156,2504,2769,2606,652,353,321,46,63,212,32,32,32,0,0,0,0,0,0,299,290,128,0,162,9,0,0,0,0,9,0,0,9,20871
6452,8489,490,1785,2338,2275,1601,945,549,533,102,62,369,16,16,16,0,0,0,0,0,0,396,319,137,31,151,77,66,46,4,16,11,0,11,0,20872
6453,39024,3193,6297,10788,10616,8130,3124,1610,1276,264,139,873,334,200,105,56,39,134,49,49,36,1514,1323,296,21,1006,191,157,40,58,59,34,34,0,0,20874
6454,16256,1571,2827,4602,4011,3245,1584,782,631,153,127,351,151,59,11,17,31,92,92,0,0,802,735,182,21,532,67,61,12,0,49,6,0,0,6,20876
6455,23409,4487,4886,6016,4805,3215,1428,461,407,56,36,315,54,0,0,0,0,54,54,0,0,967,892,275,189,428,75,75,63,0,12,0,0,0,0,20877
6456,43033,2364,4390,7725,13636,14918,2746,1347,1268,160,33,1075,79,28,18,10,0,51,0,51,0,1399,1317,421,87,809,82,57,13,0,44,25,9,6,10,20878
6457,16239,1559,3083,4471,4206,2920,1578,966,750,234,87,429,216,163,104,59,0,53,36,17,0,612,515,105,94,316,97,88,71,0,17,9,9,0,0,20879
6458,394,8,68,60,92,166,30,10,5,2,3,0,5,5,5,0,0,0,0,0,0,20,18,8,0,10,2,0,0,0,0,2,0,0,2,20880
6459,9538,422,1490,2346,2783,2497,968,618,569,88,61,420,49,11,0,0,11,38,0,0,38,350,346,96,42,208,4,0,0,0,0,4,0,0,4,20882
6460,22497,2195,4606,5403,5696,4597,1994,1179,946,210,28,708,233,203,177,10,16,30,0,0,30,815,706,175,42,489,109,32,23,0,9,77,0,0,77,20886
6461,13167,779,1506,1990,3999,4893,852,311,304,32,46,226,7,7,4,0,3,0,0,0,0,541,529,158,26,345,12,12,0,0,12,0,0,0,0,20895
6462,621,6,23,82,217,293,43,20,9,0,0,9,11,0,0,0,0,11,11,0,0,23,23,5,0,18,0,0,0,0,0,0,0,0,0,20896
6463,115,0,43,72,0,0,0,0,0,0,0,0,0,0,0,0,0,0,0,0,0,0,0,0,0,0,0,0,0,0,0,0,0,0,0,20899
6464,24268,3441,3708,4620,5698,6801,1453,756,578,173,73,332,178,53,0,30,23,125,117,0,8,697,618,141,79,398,79,22,9,13,0,57,46,0,11,20901
6465,33135,6076,6382,6332,7179,7166,2139,1129,1014,169,189,656,115,83,82,0,1,32,32,0,0,1010,841,170,148,523,169,91,63,0,28,78,27,51,0,20902
6466,15393,5980,2874,2819,1979,1741,1312,661,516,81,104,331,145,63,63,0,0,82,23,32,27,651,514,113,64,337,137,39,20,0,19,98,56,0,42,20903
6467,37183,3355,7234,9129,9442,8023,2809,1456,1332,204,81,1047,124,64,48,10,6,60,19,20,21,1353,1189,157,188,844,164,125,31,48,46,39,0,0,39,20904
6468,12878,848,2383,2584,3520,3543,1390,804,757,135,0,622,47,47,36,0,11,0,0,0,0,586,574,153,62,359,12,0,0,0,0,12,0,12,0,20905
6469,47805,8451,10867,10678,9553,8256,2705,1351,1241,168,165,908,110,87,48,39,0,23,0,0,23,1354,1320,349,131,840,34,26,0,0,26,8,0,0,8,20906
6470,29378,1662,2584,4867,8337,11928,1478,718,587,120,35,432,131,61,29,25,7,70,54,16,0,760,693,180,14,499,67,50,35,0,15,17,0,0,17,20910
6471,17074,2132,3344,3681,3574,4343,962,432,397,55,16,326,35,21,12,9,0,14,0,14,0,530,498,94,79,325,32,16,8,0,8,16,16,0,0,20912
6472,14908,1934,5119,4909,1819,1127,997,488,418,98,60,260,70,24,23,0,1,46,7,39,0,509,393,152,62,179,116,98,54,0,44,18,0,0,18,21001
6473,893,0,152,356,203,182,191,136,108,63,16,29,28,28,17,11,0,0,0,0,0,55,55,9,7,39,0,0,0,0,0,0,0,0,0,21005
6474,20069,859,5268,6617,4382,2943,1441,688,572,220,61,291,116,65,53,0,12,51,1,19,31,753,674,168,42,464,79,67,26,14,27,12,0,12,0,21009
6475,85,0,20,18,18,29,0,0,0,0,0,0,0,0,0,0,0,0,0,0,0,0,0,0,0,0,0,0,0,0,0,0,0,0,0,21010
6476,13948,543,2388,3926,4027,3064,1341,573,545,237,25,283,28,28,11,17,0,0,0,0,0,768,755,375,35,345,13,0,0,0,0,13,13,0,0,21012
6477,3355,161,824,866,829,675,379,223,212,104,0,108,11,11,11,0,0,0,0,0,0,156,156,58,0,98,0,0,0,0,0,0,0,0,0,21013
6478,24182,1407,5780,6693,6264,4038,1888,934,778,196,82,500,156,90,27,41,22,66,27,0,39,954,828,342,51,435,126,110,82,21,7,16,0,0,16,21014
6479,18301,1054,4158,5371,4368,3350,2104,1260,1153,316,96,741,107,75,59,0,16,32,0,0,32,844,773,332,40,401,71,58,58,0,0,13,0,0,13,21015
6480,4881,336,1293,1819,1055,378,171,98,40,10,14,16,58,58,0,0,58,0,0,0,0,73,45,25,7,13,28,28,28,0,0,0,0,0,0,21017
6481,2467,119,618,767,619,344,249,150,99,57,0,42,51,51,38,0,13,0,0,0,0,99,99,44,5,50,0,0,0,0,0,0,0,0,0,21028
6482,7516,136,792,960,2464,3164,1052,683,663,227,31,405,20,19,0,0,19,1,1,0,0,369,341,82,0,259,28,0,0,0,0,28,0,0,28,21029
6483,17135,975,2524,4095,5764,3777,1159,596,526,165,0,361,70,46,18,0,28,24,15,0,9,563,421,138,0,283,142,64,36,12,16,78,8,0,70,21030
6484,0,0,0,0,0,0,32,16,0,0,0,0,16,16,0,0,16,0,0,0,0,16,16,0,0,16,0,0,0,0,0,0,0,0,0,21031
6485,6275,277,1435,1597,1776,1190,322,137,135,25,0,110,2,2,0,0,2,0,0,0,0,185,169,62,26,81,16,16,16,0,0,0,0,0,0,21032
6486,2358,345,781,792,275,165,168,102,90,55,21,14,12,0,0,0,0,12,12,0,0,66,59,17,0,42,7,0,0,0,0,7,0,0,7,21034
6487,5259,213,1000,1393,1525,1128,405,219,156,38,11,107,63,58,58,0,0,5,0,0,5,186,186,86,0,100,0,0,0,0,0,0,0,0,0,21035
6488,1499,65,176,320,401,537,204,163,163,62,0,101,0,0,0,0,0,0,0,0,0,41,41,32,0,9,0,0,0,0,0,0,0,0,0,21036
6489,14662,1281,3818,4198,3063,2302,1057,553,454,211,52,191,99,95,76,0,19,4,0,0,4,504,437,170,10,257,67,34,34,0,0,33,9,12,12,21037
6490,15541,1525,5894,5291,1749,1082,1580,633,464,145,142,177,169,119,25,94,0,50,7,43,0,947,775,177,314,284,172,61,43,18,0,111,0,0,111,21040
6491,26764,762,3096,4316,9068,9522,2403,1399,1335,420,10,905,64,52,0,0,52,12,0,0,12,1004,936,220,0,716,68,68,68,0,0,0,0,0,0,21042
6492,27977,1512,3745,5745,9093,7882,2850,1404,1334,277,32,1025,70,65,45,0,20,5,0,0,5,1446,1378,418,115,845,68,59,12,47,0,9,0,0,9,21043
6493,29648,1147,3162,5556,9097,10686,2004,1227,1071,273,150,648,156,116,81,0,35,40,0,0,40,777,685,193,70,422,92,50,14,36,0,42,0,0,42,21044
6494,27345,2439,4139,5390,8610,6767,2037,1047,966,171,170,625,81,81,64,12,5,0,0,0,0,990,912,133,42,737,78,22,18,0,4,56,0,0,56,21045
6495,10956,332,1089,2613,3979,2943,614,340,285,146,9,130,55,55,0,0,55,0,0,0,0,274,257,45,0,212,17,17,17,0,0,0,0,0,0,21046
6496,8337,291,1978,2546,2303,1219,555,299,259,62,7,190,40,40,40,0,0,0,0,0,0,256,248,44,0,204,8,0,0,0,0,8,8,0,0,21047
6497,7580,686,2424,1929,1599,942,693,510,447,139,24,284,63,36,30,6,0,27,27,0,0,183,174,116,14,44,9,9,9,0,0,0,0,0,0,21048
6498,12274,944,3250,3422,2972,1686,1043,484,438,115,26,297,46,46,46,0,0,0,0,0,0,559,530,197,28,305,29,29,20,4,5,0,0,0,0,21050
6499,181,10,54,32,39,46,0,0,0,0,0,0,0,0,0,0,0,0,0,0,0,0,0,0,0,0,0,0,0,0,0,0,0,0,0,21051
6500,165,30,86,35,5,9,20,0,0,0,0,0,0,0,0,0,0,0,0,0,0,20,5,0,0,5,15,15,0,15,0,0,0,0,0,21052
6501,2239,196,532,724,327,460,183,98,70,21,0,49,28,28,0,9,19,0,0,0,0,85,74,10,0,64,11,11,0,0,11,0,0,0,0,21053
6502,6698,275,1891,1361,1797,1374,438,215,204,96,6,102,11,11,0,11,0,0,0,0,0,223,204,112,11,81,19,18,0,0,18,1,0,0,1,21054
6503,183,0,0,32,81,70,0,0,0,0,0,0,0,0,0,0,0,0,0,0,0,0,0,0,0,0,0,0,0,0,0,0,0,0,0,21056
6504,2880,219,491,657,786,727,329,276,276,45,0,231,0,0,0,0,0,0,0,0,0,53,53,11,0,42,0,0,0,0,0,0,0,0,0,21057
6505,21160,3511,7560,6438,2595,1056,1308,507,299,60,25,214,208,191,97,43,51,17,0,11,6,801,563,106,99,358,238,211,100,34,77,27,0,0,27,21060
6506,36455,4975,12522,11945,4668,2345,2480,1265,919,229,94,596,346,210,135,55,20,136,58,61,17,1215,893,440,40,413,322,115,97,0,18,207,17,52,138,21061
6507,301,0,65,109,52,75,22,22,22,0,0,22,0,0,0,0,0,0,0,0,0,0,0,0,0,0,0,0,0,0,0,0,0,0,0,21071
6508,9613,792,3198,2850,1801,972,755,316,281,82,0,199,35,35,20,0,15,0,0,0,0,439,420,139,26,255,19,19,0,0,19,0,0,0,0,21074
6509,17459,1132,3604,3955,4865,3903,1273,650,572,129,117,326,78,68,41,17,10,10,0,0,10,623,568,250,29,289,55,48,48,0,0,7,0,0,7,21075
6510,9612,561,2087,2585,2575,1804,556,199,199,85,0,114,0,0,0,0,0,0,0,0,0,357,343,139,103,101,14,14,14,0,0,0,0,0,0,21076
6511,155,0,84,71,0,0,0,0,0,0,0,0,0,0,0,0,0,0,0,0,0,0,0,0,0,0,0,0,0,0,0,0,0,0,0,21077
6512,13009,1521,4166,3764,2035,1523,859,452,316,79,45,192,136,114,97,0,17,22,0,8,14,407,274,78,42,154,133,120,66,28,26,13,0,0,13,21078
6513,299,10,85,59,82,63,31,20,20,0,0,20,0,0,0,0,0,0,0,0,0,11,11,0,0,11,0,0,0,0,0,0,0,0,0,21082
6514,5328,164,1983,1423,1054,704,451,220,172,122,0,50,48,48,48,0,0,0,0,0,0,231,231,86,0,145,0,0,0,0,0,0,0,0,0,21084
6515,11682,1013,4061,3450,1958,1200,504,306,222,56,16,150,84,72,72,0,0,12,0,12,0,198,178,50,19,109,20,20,13,7,0,0,0,0,0,21085
6516,3912,212,1277,955,855,613,317,126,99,80,8,11,27,15,15,0,0,12,0,0,12,191,177,95,0,82,14,0,0,0,0,14,0,0,14,21087
6517,6734,847,2157,1894,1131,705,563,350,271,98,21,152,79,33,22,0,11,46,0,46,0,213,129,76,0,53,84,84,57,0,27,0,0,0,0,21090
6518,26946,1071,4732,5992,7829,7322,1528,872,796,179,40,577,76,68,12,7,49,8,0,8,0,656,632,200,23,409,24,13,13,0,0,11,0,0,11,21093
6519,7862,736,2803,2081,1404,838,727,347,269,51,17,201,78,68,56,12,0,10,10,0,0,380,315,146,20,149,65,65,65,0,0,0,0,0,0,21102
6520,3069,176,683,637,1018,555,292,120,108,13,27,68,12,12,12,0,0,0,0,0,0,172,159,85,0,74,13,13,13,0,0,0,0,0,0,21104
6521,18,9,9,0,0,0,0,0,0,0,0,0,0,0,0,0,0,0,0,0,0,0,0,0,0,0,0,0,0,0,0,0,0,0,0,21105
6522,12217,935,3033,3060,3081,2108,985,406,379,91,0,288,27,0,0,0,0,27,0,27,0,579,496,241,16,239,83,83,17,0,66,0,0,0,0,21108
6523,3123,129,631,539,851,973,281,162,162,58,9,95,0,0,0,0,0,0,0,0,0,119,119,30,0,89,0,0,0,0,0,0,0,0,0,21111
6524,20862,1047,4115,6014,5840,3846,1688,981,813,331,56,426,168,154,65,89,0,14,14,0,0,707,698,334,110,254,9,9,9,0,0,0,0,0,0,21113
6525,17515,538,2489,4771,6094,3623,979,449,449,94,66,289,0,0,0,0,0,0,0,0,0,530,464,167,49,248,66,66,52,0,14,0,0,0,0,21114
6526,37776,2213,5324,10121,11567,8551,2793,1590,1390,279,90,1021,200,119,37,70,12,81,28,0,53,1203,1114,241,15,858,89,69,54,0,15,20,12,7,1,21117
6527,4843,290,983,1263,1366,941,347,160,153,99,10,44,7,7,0,7,0,0,0,0,0,187,187,58,16,113,0,0,0,0,0,0,0,0,0,21120
6528,41318,4133,13824,12706,6627,4028,3386,2206,1793,601,293,899,413,321,181,130,10,92,38,0,54,1180,916,328,55,533,264,211,105,33,73,53,0,43,10,21122
6529,9329,647,2333,2576,1983,1790,707,339,323,91,21,211,16,0,0,0,0,16,0,16,0,368,368,70,35,263,0,0,0,0,0,0,0,0,0,21128
6530,233,27,129,46,31,0,41,41,41,17,0,24,0,0,0,0,0,0,0,0,0,0,0,0,0,0,0,0,0,0,0,0,0,0,0,21130
6531,4625,168,608,961,1556,1332,344,193,176,13,30,133,17,17,9,8,0,0,0,0,0,151,151,26,0,125,0,0,0,0,0,0,0,0,0,21131
6532,1457,164,470,467,117,239,82,29,29,29,0,0,0,0,0,0,0,0,0,0,0,53,42,17,13,12,11,0,0,0,0,11,0,11,0,21132
6533,21099,1821,5794,6739,4217,2528,1720,1035,882,213,157,512,153,131,91,0,40,22,10,0,12,685,597,147,20,430,88,51,38,13,0,37,10,16,11,21133
6534,22196,1759,4887,5377,5993,4180,1763,738,664,107,45,512,74,47,30,0,17,27,8,0,19,1025,883,224,128,531,142,120,110,10,0,22,0,0,22,21136
6535,2379,106,500,650,632,491,171,95,95,58,10,27,0,0,0,0,0,0,0,0,0,76,66,12,0,54,10,10,0,0,10,0,0,0,0,21140
6536,20800,2163,5508,6221,4116,2792,1859,927,872,281,52,539,55,49,28,21,0,6,0,0,6,932,840,218,83,539,92,42,25,0,17,50,0,50,0,21144
6537,17912,624,2458,4232,6328,4270,1767,880,789,253,109,427,91,81,36,45,0,10,0,0,10,887,887,335,74,478,0,0,0,0,0,0,0,0,0,21146
6538,4059,120,667,867,1496,909,261,137,122,44,0,78,15,15,0,15,0,0,0,0,0,124,92,11,0,81,32,32,32,0,0,0,0,0,0,21152
6539,230,0,22,14,80,114,18,7,7,0,0,7,0,0,0,0,0,0,0,0,0,11,11,0,0,11,0,0,0,0,0,0,0,0,0,21153
6540,5024,640,2011,1401,508,464,451,204,115,46,0,69,89,89,16,63,10,0,0,0,0,247,247,136,22,89,0,0,0,0,0,0,0,0,0,21154
6541,1613,189,481,493,291,159,191,112,94,64,9,21,18,18,10,8,0,0,0,0,0,79,60,22,23,15,19,19,0,19,0,0,0,0,0,21155
6542,326,20,63,106,68,69,0,0,0,0,0,0,0,0,0,0,0,0,0,0,0,0,0,0,0,0,0,0,0,0,0,0,0,0,0,21156
6543,25160,2697,7846,7037,4441,3139,2943,1454,1278,339,103,836,176,140,98,11,31,36,10,9,17,1489,1369,495,87,787,120,56,56,0,0,64,11,0,53,21157
6544,13329,853,4067,4082,2696,1631,1184,537,501,246,19,236,36,36,36,0,0,0,0,0,0,647,580,234,27,319,67,67,32,22,13,0,0,0,0,21158
6545,1593,125,478,335,339,316,107,77,77,59,0,18,0,0,0,0,0,0,0,0,0,30,30,16,0,14,0,0,0,0,0,0,0,0,0,21160
6546,3861,239,1150,1244,699,529,388,111,82,30,0,52,29,21,8,0,13,8,1,0,7,277,206,100,13,93,71,0,0,0,0,71,0,0,71,21161
6547,2610,230,818,743,530,289,142,78,68,44,0,24,10,7,7,0,0,3,0,0,3,64,64,9,0,55,0,0,0,0,0,0,0,0,0,21162
6548,4806,153,677,979,1600,1397,638,378,249,0,0,249,129,74,0,0,74,55,0,0,55,260,188,12,0,176,72,18,0,0,18,54,0,0,54,21163
6549,11021,2050,1782,2187,2363,2639,732,332,248,62,2,184,84,41,22,7,12,43,0,12,31,400,336,56,98,182,64,64,28,10,26,0,0,0,0,21201
6550,15400,3703,4424,2668,2284,2321,1016,653,400,23,0,377,253,129,37,10,82,124,0,0,124,363,318,66,61,191,45,34,1,21,12,11,0,0,11,21202
6551,12579,839,2262,2059,3561,3858,1843,770,656,56,26,574,114,32,0,0,32,82,21,0,61,1073,1003,195,30,778,70,62,36,0,26,8,0,0,8,21204
6552,9103,3708,3222,1598,369,206,1313,625,367,31,6,330,258,76,19,17,40,182,67,75,40,688,546,15,94,437,142,117,62,16,39,25,0,0,25,21205
6553,33637,4886,12757,10231,3517,2246,2657,1151,847,235,30,582,304,218,188,30,0,86,9,39,38,1506,1201,264,110,827,305,247,118,91,38,58,0,4,54,21206
6554,33910,4748,10629,11246,4549,2738,2229,1017,787,101,171,515,230,173,22,55,96,57,0,0,57,1212,1007,221,138,648,205,143,128,8,7,62,0,0,62,21207
6555,24015,1424,5600,6020,5575,5396,1439,710,640,79,129,432,70,54,26,0,28,16,0,16,0,729,627,181,81,365,102,101,45,0,56,1,0,0,1,21208
6556,19537,834,2290,3821,5984,6608,910,445,440,100,0,340,5,5,5,0,0,0,0,0,0,465,405,95,10,300,60,25,0,25,0,35,0,35,0,21209
6557,8338,82,455,1057,2216,4528,2314,980,978,140,52,786,2,1,0,0,1,1,0,0,1,1334,1333,330,15,988,1,0,0,0,0,1,0,0,1,21210
6558,13385,1979,2670,2271,3010,3455,359,226,167,6,49,112,59,35,11,12,12,24,0,20,4,133,94,30,0,64,39,15,0,0,15,24,16,8,0,21211
6559,21582,1865,3691,4552,5673,5801,1827,785,713,154,49,510,72,42,19,23,0,30,0,0,30,1042,904,193,143,568,138,92,48,6,38,46,0,18,28,21212
6560,20512,4436,8730,5113,1368,865,1621,802,605,87,86,432,197,86,6,80,0,111,0,41,70,819,613,135,65,413,206,96,11,29,56,110,49,0,61,21213
6561,14371,1583,3954,4097,2633,2104,1097,642,566,131,145,290,76,49,4,37,8,27,0,19,8,455,412,111,50,251,43,35,35,0,0,8,0,0,8,21214
6562,43520,9618,14831,11627,4257,3187,3118,1564,1219,213,199,807,345,183,78,60,45,162,14,26,122,1554,1384,294,61,1029,170,78,34,19,25,92,19,11,62,21215
6563,17723,4095,6395,5015,1426,792,1647,851,676,142,138,396,175,149,14,73,62,26,4,21,1,796,665,180,158,327,131,103,29,53,21,28,0,0,28,21216
6564,24990,6621,7646,6050,2475,2198,2820,1113,880,80,28,772,233,147,55,15,77,86,0,0,86,1707,1357,167,65,1125,350,148,24,38,86,202,0,43,159,21217
6565,31516,4923,9115,7496,4742,5240,4460,2097,1857,164,96,1597,240,58,11,25,22,182,11,60,111,2363,2237,558,208,1471,126,68,67,0,1,58,0,0,58,21218
6566,6554,1036,2584,2039,642,253,537,265,198,43,13,142,67,42,11,15,16,25,0,0,25,272,217,65,0,152,55,30,20,0,10,25,0,0,25,21219
6567,27433,4296,10923,8146,2580,1488,1896,1149,894,231,10,653,255,151,120,31,0,104,41,30,33,747,599,208,31,360,148,82,71,0,11,66,23,28,15,21220
6568,27164,4334,11396,7997,2447,990,2096,1020,803,188,49,566,217,134,90,20,24,83,40,28,15,1076,789,210,16,563,287,221,158,7,56,66,5,0,61,21221
6569,37952,7604,16472,10316,2307,1253,2230,1112,934,225,57,652,178,129,41,64,24,49,15,15,19,1118,856,209,87,560,262,227,114,63,50,35,16,13,6,21222
6570,15338,4891,4909,3940,1057,541,1551,606,508,43,102,363,98,30,11,19,0,68,1,51,16,945,754,199,113,442,191,101,54,8,39,90,4,80,6,21223
6571,34953,8637,9442,6467,6228,4179,1606,963,689,29,157,503,274,141,27,33,81,133,96,0,37,643,494,198,49,247,149,111,92,0,19,38,22,4,12,21224
6572,21105,5369,8324,5609,1369,434,1620,718,499,36,59,404,219,145,111,5,29,74,24,40,10,902,656,179,128,349,246,137,71,66,0,109,6,100,3,21225
6573,4976,1072,1953,1179,618,154,309,142,123,23,0,100,19,0,0,0,0,19,19,0,0,167,134,12,0,122,33,33,33,0,0,0,0,0,0,21226
6574,23492,4924,8140,5949,3211,1268,1237,656,522,97,17,408,134,90,35,0,55,44,0,0,44,581,438,174,35,229,143,44,18,26,0,99,35,14,50,21227
6575,34252,2515,8070,8721,8414,6532,2296,966,813,195,109,509,153,91,54,36,1,62,19,0,43,1330,956,283,135,538,374,304,105,118,81,70,0,0,70,21228
6576,29257,5276,10103,9060,2964,1854,2565,1406,942,293,60,589,464,275,116,67,92,189,71,37,81,1159,958,206,223,529,201,127,89,0,38,74,60,14,0,21229
6577,24747,4463,5040,4242,6317,4685,751,438,292,29,45,218,146,29,18,0,11,117,19,0,98,313,256,40,31,185,57,25,5,0,20,32,0,13,19,21230
6578,12496,2226,2091,1852,3640,2687,537,286,174,79,0,95,112,75,19,48,8,37,15,10,12,251,163,8,0,155,88,0,0,0,0,88,0,12,76,21231
6579,48863,4947,16140,14432,8467,4877,3022,1509,1250,381,101,768,259,139,112,17,10,120,49,9,62,1513,1328,477,74,777,185,139,90,0,49,46,37,0,9,21234
6580,26118,1982,6926,7870,5794,3546,2050,1033,922,338,86,498,111,88,70,9,9,23,6,0,17,1017,956,538,26,392,61,53,26,0,27,8,8,0,0,21236
6581,21007,2710,7002,6098,3591,1606,1709,811,645,103,12,530,166,128,83,20,25,38,0,18,20,898,802,189,48,565,96,96,96,0,0,0,0,0,0,21237
6582,19212,2689,5778,5638,2683,2424,2019,1202,1076,197,109,770,126,114,58,0,56,12,0,0,12,817,674,201,67,406,143,87,18,38,31,56,9,12,35,21239
6583,0,0,0,0,0,0,0,0,0,0,0,0,0,0,0,0,0,0,0,0,0,0,0,0,0,0,0,0,0,0,0,0,0,0,0,21240
6584,24364,2223,6347,7851,4844,3099,2238,1437,1109,253,144,712,328,280,114,140,26,48,19,14,15,801,689,102,146,441,112,98,63,23,12,14,0,7,7,21244
6585,36,0,0,29,7,0,1903,1061,1061,72,6,983,0,0,0,0,0,0,0,0,0,842,842,146,26,670,0,0,0,0,0,0,0,0,0,21250
6586,0,0,0,0,0,0,496,231,231,18,5,208,0,0,0,0,0,0,0,0,0,265,265,29,5,231,0,0,0,0,0,0,0,0,0,21251
6587,5,0,0,0,5,0,1763,804,798,89,15,694,6,6,0,0,6,0,0,0,0,959,959,157,41,761,0,0,0,0,0,0,0,0,0,21252
6588,13078,712,2136,3085,3404,3741,1773,643,634,117,51,466,9,9,8,0,1,0,0,0,0,1130,1102,360,20,722,28,28,12,16,0,0,0,0,0,21286
6589,26936,2253,4673,6143,7040,6827,1352,838,661,108,38,515,177,160,132,0,28,17,0,0,17,514,513,123,11,379,1,0,0,0,0,1,0,0,1,21401
6590,1008,19,134,398,322,135,1313,983,845,706,8,131,138,138,98,0,40,0,0,0,0,330,243,126,0,117,87,87,67,0,20,0,0,0,0,21402
6591,22188,2156,3990,5337,5574,5131,1080,636,515,78,60,377,121,103,53,37,13,18,17,0,1,444,404,55,87,262,40,40,4,36,0,0,0,0,0,21403
6592,348,0,49,37,158,104,5,5,5,0,5,0,0,0,0,0,0,0,0,0,0,0,0,0,0,0,0,0,0,0,0,0,0,0,0,21405
6593,13543,451,2249,3806,3874,3163,1067,529,455,130,7,318,74,58,14,44,0,16,0,0,16,538,510,186,37,287,28,28,28,0,0,0,0,0,0,21409
6594,31884,4264,13015,9295,3109,2201,2011,855,603,189,51,363,252,147,76,62,9,105,0,0,105,1156,902,173,81,648,254,158,84,9,65,96,7,16,73,21502
6595,1414,147,635,350,150,132,101,25,18,15,0,3,7,7,7,0,0,0,0,0,0,76,35,23,5,7,41,6,6,0,0,35,21,0,14,21520
6596,917,73,449,258,72,65,85,43,35,15,0,20,8,8,8,0,0,0,0,0,0,42,39,19,0,20,3,3,0,3,0,0,0,0,0,21521
6597,94,0,66,14,14,0,0,0,0,0,0,0,0,0,0,0,0,0,0,0,0,0,0,0,0,0,0,0,0,0,0,0,0,0,0,21522
6598,162,17,96,16,8,25,24,17,17,0,0,17,0,0,0,0,0,0,0,0,0,7,7,0,0,7,0,0,0,0,0,0,0,0,0,21523
6599,352,57,198,91,4,2,14,0,0,0,0,0,0,0,0,0,0,0,0,0,0,14,5,0,0,5,9,9,9,0,0,0,0,0,0,21524
6600,380,56,227,70,24,3,20,20,20,0,0,20,0,0,0,0,0,0,0,0,0,0,0,0,0,0,0,0,0,0,0,0,0,0,0,21529
6601,1256,153,649,339,67,48,74,50,20,0,0,20,30,3,0,0,3,27,0,0,27,24,24,0,0,24,0,0,0,0,0,0,0,0,0,21530
6602,1600,206,773,434,96,91,164,54,33,13,0,20,21,18,0,0,18,3,0,0,3,110,97,49,0,48,13,0,0,0,0,13,0,0,13,21531
6603,9262,899,3842,2451,950,1120,1850,989,926,240,78,608,63,63,30,0,33,0,0,0,0,861,767,225,94,448,94,94,60,0,34,0,0,0,0,21532
6604,2974,425,1352,694,362,141,308,168,88,41,0,47,80,32,29,0,3,48,0,0,48,140,58,33,0,25,82,48,32,13,3,34,17,0,17,21536
6605,446,75,238,78,35,20,90,54,44,15,7,22,10,5,2,3,0,5,0,0,5,36,35,21,0,14,1,1,0,1,0,0,0,0,0,21538
6606,1850,320,847,393,162,128,173,126,88,11,0,77,38,18,14,0,4,20,0,0,20,47,33,22,0,11,14,2,2,0,0,12,0,3,9,21539
6607,46,8,22,13,3,0,15,8,2,0,0,2,6,6,0,2,4,0,0,0,0,7,7,1,0,6,0,0,0,0,0,0,0,0,0,21540
6608,916,84,291,228,178,135,51,28,28,8,0,20,0,0,0,0,0,0,0,0,0,23,23,0,0,23,0,0,0,0,0,0,0,0,0,21541
6609,374,28,194,108,24,20,41,21,21,0,7,14,0,0,0,0,0,0,0,0,0,20,14,14,0,0,6,6,0,6,0,0,0,0,0,21542
6610,78,0,26,24,14,14,0,0,0,0,0,0,0,0,0,0,0,0,0,0,0,0,0,0,0,0,0,0,0,0,0,0,0,0,0,21543
6611,1361,126,647,381,78,129,93,45,39,9,0,30,6,6,0,0,6,0,0,0,0,48,48,12,8,28,0,0,0,0,0,0,0,0,0,21545
6612,10202,1589,4098,2712,999,804,734,404,223,28,12,183,181,139,134,0,5,42,15,8,19,330,270,128,23,119,60,48,34,0,14,12,10,0,2,21550
6613,1324,154,534,527,70,39,117,46,33,14,0,19,13,0,0,0,0,13,13,0,0,71,45,0,0,45,26,26,26,0,0,0,0,0,0,21555
6614,1395,152,490,503,154,96,176,137,137,60,37,40,0,0,0,0,0,0,0,0,0,39,39,28,0,11,0,0,0,0,0,0,0,0,0,21557
6615,1873,125,906,425,148,269,140,88,76,29,0,47,12,0,0,0,0,12,0,0,12,52,52,6,0,46,0,0,0,0,0,0,0,0,0,21561
6616,2186,331,1134,530,120,71,97,66,45,0,0,45,21,21,9,12,0,0,0,0,0,31,18,7,0,11,13,13,13,0,0,0,0,0,0,21562
6617,17207,1943,4696,4859,2968,2741,1084,504,448,86,9,353,56,20,20,0,0,36,0,22,14,580,495,252,34,209,85,63,63,0,0,22,0,0,22,21601
6618,401,60,248,56,19,18,25,16,3,0,0,3,13,13,13,0,0,0,0,0,0,9,1,0,0,1,8,8,0,0,8,0,0,0,0,21607
6619,331,12,136,116,32,35,14,10,10,5,0,5,0,0,0,0,0,0,0,0,0,4,4,4,0,0,0,0,0,0,0,0,0,0,0,21610
6620,241,7,81,68,53,32,15,9,9,0,0,9,0,0,0,0,0,0,0,0,0,6,6,0,0,6,0,0,0,0,0,0,0,0,0,21612
6621,12023,1956,4544,2959,1466,1098,732,377,287,43,79,165,90,23,8,0,15,67,0,33,34,355,330,59,70,201,25,25,0,25,0,0,0,0,0,21613
6622,6905,618,1990,1722,1557,1018,506,340,308,90,68,150,32,21,1,0,20,11,0,0,11,166,132,58,0,74,34,34,34,0,0,0,0,0,0,21617
6623,4067,235,1185,1264,857,526,339,90,72,16,0,56,18,18,18,0,0,0,0,0,0,249,227,94,0,133,22,9,0,9,0,13,13,0,0,21619
6624,8425,1105,2726,1897,1330,1367,1079,543,479,123,57,299,64,37,16,17,4,27,12,0,15,536,459,115,15,329,77,50,0,0,50,27,25,0,2,21620
6625,527,129,211,164,23,0,76,72,31,0,0,31,41,41,41,0,0,0,0,0,0,4,4,1,0,3,0,0,0,0,0,0,0,0,0,21622
6626,1380,256,426,430,144,124,104,48,30,19,0,11,18,13,5,0,8,5,0,0,5,56,16,12,4,0,40,14,2,4,8,26,0,0,26,21623
6627,124,0,5,26,39,54,0,0,0,0,0,0,0,0,0,0,0,0,0,0,0,0,0,0,0,0,0,0,0,0,0,0,0,0,0,21624
6628,1883,220,831,485,228,119,160,106,96,16,0,80,10,10,10,0,0,0,0,0,0,54,48,21,0,27,6,6,0,6,0,0,0,0,0,21625
6629,132,58,17,40,17,0,0,0,0,0,0,0,0,0,0,0,0,0,0,0,0,0,0,0,0,0,0,0,0,0,0,0,0,0,0,21626
6630,24,0,6,18,0,0,0,0,0,0,0,0,0,0,0,0,0,0,0,0,0,0,0,0,0,0,0,0,0,0,0,0,0,0,0,21627
6631,384,23,190,98,18,55,0,0,0,0,0,0,0,0,0,0,0,0,0,0,0,0,0,0,0,0,0,0,0,0,0,0,0,0,0,21628
6632,6198,958,2315,1892,690,343,504,238,164,70,20,74,74,44,44,0,0,30,0,9,21,266,173,13,0,160,93,59,16,0,43,34,24,0,10,21629
6633,1863,272,619,513,255,204,132,26,23,6,0,17,3,3,0,0,3,0,0,0,0,106,95,57,0,38,11,11,8,0,3,0,0,0,0,21631
6634,3783,670,1811,838,302,162,364,207,194,35,0,159,13,13,13,0,0,0,0,0,0,157,138,55,22,61,19,19,19,0,0,0,0,0,0,21632
6635,289,145,78,39,0,27,0,0,0,0,0,0,0,0,0,0,0,0,0,0,0,0,0,0,0,0,0,0,0,0,0,0,0,0,0,21634
6636,1570,175,586,435,180,194,26,15,13,8,0,5,2,2,1,0,1,0,0,0,0,11,7,2,0,5,4,4,0,0,4,0,0,0,0,21635
6637,888,190,399,197,74,28,77,35,15,5,0,10,20,20,0,9,11,0,0,0,0,42,40,11,23,6,2,2,0,0,2,0,0,0,0,21636
6638,3522,182,1122,902,871,445,75,17,17,17,0,0,0,0,0,0,0,0,0,0,0,58,48,48,0,0,10,10,10,0,0,0,0,0,0,21638
6639,3060,396,1290,892,352,130,366,170,156,64,17,75,14,7,2,5,0,7,0,0,7,196,177,84,4,89,19,19,0,19,0,0,0,0,0,21639
6640,946,259,440,180,39,28,32,12,0,0,0,0,12,12,0,12,0,0,0,0,0,20,13,9,0,4,7,7,0,0,7,0,0,0,0,21640
6641,30,3,5,12,6,4,0,0,0,0,0,0,0,0,0,0,0,0,0,0,0,0,0,0,0,0,0,0,0,0,0,0,0,0,0,21641
6642,3871,691,1620,1083,352,125,166,66,51,4,0,47,15,5,0,5,0,10,0,0,10,100,83,0,44,39,17,0,0,0,0,17,0,0,17,21643
6643,97,3,31,0,63,0,0,0,0,0,0,0,0,0,0,0,0,0,0,0,0,0,0,0,0,0,0,0,0,0,0,0,0,0,0,21644
6644,694,103,218,186,138,49,67,67,47,41,0,6,20,6,0,0,6,14,8,0,6,0,0,0,0,0,0,0,0,0,0,0,0,0,0,21645
6645,208,13,49,88,24,34,5,0,0,0,0,0,0,0,0,0,0,0,0,0,0,5,5,0,0,5,0,0,0,0,0,0,0,0,0,21647
6646,276,48,93,80,33,22,13,13,13,0,0,13,0,0,0,0,0,0,0,0,0,0,0,0,0,0,0,0,0,0,0,0,0,0,0,21648
6647,1192,550,386,188,49,19,129,103,75,0,29,46,28,9,9,0,0,19,10,0,9,26,26,2,18,6,0,0,0,0,0,0,0,0,0,21649
6648,61,0,38,13,10,0,8,0,0,0,0,0,0,0,0,0,0,0,0,0,0,8,8,8,0,0,0,0,0,0,0,0,0,0,0,21650
6649,2132,496,761,491,249,135,83,5,1,0,0,1,4,0,0,0,0,4,4,0,0,78,67,5,0,62,11,11,11,0,0,0,0,0,0,21651
6650,136,20,10,33,46,27,0,0,0,0,0,0,0,0,0,0,0,0,0,0,0,0,0,0,0,0,0,0,0,0,0,0,0,0,0,21652
6651,50,20,9,13,4,4,0,0,0,0,0,0,0,0,0,0,0,0,0,0,0,0,0,0,0,0,0,0,0,0,0,0,0,0,0,21653
6652,814,22,109,218,215,250,0,0,0,0,0,0,0,0,0,0,0,0,0,0,0,0,0,0,0,0,0,0,0,0,0,0,0,0,0,21654
6653,3579,424,1601,820,471,263,224,127,60,29,3,28,67,67,30,21,16,0,0,0,0,97,87,20,5,62,10,10,10,0,0,0,0,0,0,21655
6654,579,97,244,110,31,97,121,83,48,9,0,39,35,35,0,17,18,0,0,0,0,38,34,0,0,34,4,4,4,0,0,0,0,0,0,21657
6655,2737,205,575,701,817,439,172,95,75,16,15,44,20,7,4,3,0,13,13,0,0,77,58,19,0,39,19,19,19,0,0,0,0,0,0,21658
6656,1248,222,476,363,103,84,68,18,18,0,15,3,0,0,0,0,0,0,0,0,0,50,50,42,0,8,0,0,0,0,0,0,0,0,0,21659
6657,2883,412,1097,950,302,122,217,91,66,0,11,55,25,24,9,0,15,1,0,0,1,126,113,3,20,90,13,13,4,0,9,0,0,0,0,21660
6658,2037,236,693,513,350,245,133,65,32,12,4,16,33,26,26,0,0,7,1,6,0,68,41,8,0,33,27,14,13,0,1,13,0,0,13,21661
6659,606,54,150,163,120,119,62,30,30,18,6,6,0,0,0,0,0,0,0,0,0,32,32,13,0,19,0,0,0,0,0,0,0,0,0,21662
6660,2799,198,678,691,648,584,140,71,44,0,11,33,27,15,15,0,0,12,12,0,0,69,58,46,3,9,11,11,6,5,0,0,0,0,0,21663
6661,550,69,237,187,51,6,30,19,14,1,2,11,5,5,0,2,3,0,0,0,0,11,11,0,5,6,0,0,0,0,0,0,0,0,0,21664
6662,180,19,56,55,35,15,7,7,0,0,0,0,7,7,7,0,0,0,0,0,0,0,0,0,0,0,0,0,0,0,0,0,0,0,0,21665
6663,8580,441,2648,2731,1779,981,763,339,297,147,0,150,42,29,29,0,0,13,0,13,0,424,395,166,20,209,29,29,29,0,0,0,0,0,0,21666
6664,201,0,91,45,33,32,0,0,0,0,0,0,0,0,0,0,0,0,0,0,0,0,0,0,0,0,0,0,0,0,0,0,0,0,0,21667
6665,1164,146,433,263,270,52,227,176,144,35,0,109,32,32,12,20,0,0,0,0,0,51,40,24,0,16,11,11,11,0,0,0,0,0,0,21668
6666,173,24,117,11,16,5,0,0,0,0,0,0,0,0,0,0,0,0,0,0,0,0,0,0,0,0,0,0,0,0,0,0,0,0,0,21669
6667,776,204,217,152,95,108,21,21,0,0,0,0,21,21,0,21,0,0,0,0,0,0,0,0,0,0,0,0,0,0,0,0,0,0,0,21671
6668,203,50,116,20,6,11,0,0,0,0,0,0,0,0,0,0,0,0,0,0,0,0,0,0,0,0,0,0,0,0,0,0,0,0,0,21672
6669,2279,245,774,645,339,276,214,110,104,22,41,41,6,6,0,0,6,0,0,0,0,104,94,35,33,26,10,7,7,0,0,3,0,3,0,21673
6670,76,5,15,40,0,16,0,0,0,0,0,0,0,0,0,0,0,0,0,0,0,0,0,0,0,0,0,0,0,0,0,0,0,0,0,21675
6671,379,58,183,61,6,71,18,0,0,0,0,0,0,0,0,0,0,0,0,0,0,18,8,8,0,0,10,10,10,0,0,0,0,0,0,21676
6672,375,45,141,109,16,64,64,40,8,8,0,0,32,32,32,0,0,0,0,0,0,24,24,19,5,0,0,0,0,0,0,0,0,0,0,21677
6673,1898,201,692,407,445,153,78,38,35,1,0,34,3,3,3,0,0,0,0,0,0,40,12,0,0,12,28,28,28,0,0,0,0,0,0,21678
6674,325,49,115,80,34,47,19,19,19,0,0,19,0,0,0,0,0,0,0,0,0,0,0,0,0,0,0,0,0,0,0,0,0,0,0,21679
6675,25419,2140,6706,6493,5873,4207,1833,974,881,382,90,409,93,66,31,0,35,27,16,0,11,859,760,359,62,339,99,77,12,0,65,22,0,22,0,21701
6676,25473,2623,5323,7401,6029,4097,1413,868,713,277,24,412,155,44,6,32,6,111,97,14,0,545,519,198,34,287,26,26,26,0,0,0,0,0,0,21702
6677,21103,2279,4045,6999,5174,2606,1609,672,598,197,74,327,74,19,19,0,0,55,55,0,0,937,864,304,32,528,73,48,37,0,11,25,0,0,25,21703
6678,9099,398,1676,2315,2782,1928,630,317,274,66,45,163,43,39,18,0,21,4,0,0,4,313,266,70,19,177,47,39,39,0,0,8,0,0,8,21704
6679,1,0,0,0,0,1,0,0,0,0,0,0,0,0,0,0,0,0,0,0,0,0,0,0,0,0,0,0,0,0,0,0,0,0,0,21705
6680,3378,344,691,735,1108,500,325,156,156,36,15,105,0,0,0,0,0,0,0,0,0,169,169,37,0,132,0,0,0,0,0,0,0,0,0,21710
6681,585,90,338,75,42,40,35,15,11,0,0,11,4,4,0,4,0,0,0,0,0,20,20,10,0,10,0,0,0,0,0,0,0,0,0,21711
6682,6714,727,2475,1795,1060,657,431,228,159,54,0,105,69,69,34,0,35,0,0,0,0,203,184,149,10,25,19,18,0,0,18,1,0,0,1,21713
6683,40,0,35,0,5,0,0,0,0,0,0,0,0,0,0,0,0,0,0,0,0,0,0,0,0,0,0,0,0,0,0,0,0,0,0,21714
6684,3152,418,1094,1057,356,227,246,115,102,26,0,76,13,13,0,13,0,0,0,0,0,131,72,27,0,45,59,50,0,50,0,9,9,0,0,21716
6685,0,0,0,0,0,0,0,0,0,0,0,0,0,0,0,0,0,0,0,0,0,0,0,0,0,0,0,0,0,0,0,0,0,0,0,21717
6686,130,14,50,32,16,18,11,8,8,2,0,6,0,0,0,0,0,0,0,0,0,3,3,0,0,3,0,0,0,0,0,0,0,0,0,21718
6687,930,126,402,221,140,41,58,20,12,7,0,5,8,0,0,0,0,8,8,0,0,38,38,19,0,19,0,0,0,0,0,0,0,0,0,21719
6688,3728,484,1814,989,258,183,488,260,224,59,9,156,36,36,28,8,0,0,0,0,0,228,165,68,19,78,63,30,11,0,19,33,20,0,13,21722
6689,483,13,113,36,198,123,47,0,0,0,0,0,0,0,0,0,0,0,0,0,0,47,47,15,0,32,0,0,0,0,0,0,0,0,0,21723
6690,3193,419,1208,789,518,259,989,440,413,178,28,207,27,27,27,0,0,0,0,0,0,549,549,239,4,306,0,0,0,0,0,0,0,0,0,21727
6691,789,125,293,138,183,50,15,0,0,0,0,0,0,0,0,0,0,0,0,0,0,15,15,0,0,15,0,0,0,0,0,0,0,0,0,21733
6692,657,104,292,175,67,19,94,45,31,27,0,4,14,10,10,0,0,4,0,4,0,49,45,26,10,9,4,4,4,0,0,0,0,0,0,21734
6693,815,44,137,35,260,339,147,66,66,17,10,39,0,0,0,0,0,0,0,0,0,81,81,0,0,81,0,0,0,0,0,0,0,0,0,21737
6694,2262,33,327,484,898,520,242,86,86,45,0,41,0,0,0,0,0,0,0,0,0,156,142,33,0,109,14,14,14,0,0,0,0,0,0,21738
6695,41042,6863,15968,12229,4119,1863,3078,1651,1243,448,157,638,408,183,62,33,88,225,48,97,80,1427,1127,388,149,590,300,252,190,45,17,48,8,19,21,21740
6696,22276,2364,6449,6887,3690,2886,1579,802,533,125,104,304,269,205,137,35,33,64,21,0,43,777,650,368,29,253,127,49,26,23,0,78,52,0,26,21742
6697,2383,733,1042,521,57,30,80,80,29,0,0,29,51,34,0,0,34,17,0,0,17,0,0,0,0,0,0,0,0,0,0,0,0,0,0,21746
6698,2759,502,1426,600,150,81,138,85,76,25,0,51,9,9,0,0,9,0,0,0,0,53,53,24,4,25,0,0,0,0,0,0,0,0,0,21750
6699,4027,150,995,793,1228,861,461,212,212,77,26,109,0,0,0,0,0,0,0,0,0,249,241,62,10,169,8,8,8,0,0,0,0,0,0,21754
6700,3931,178,1389,1027,815,522,386,224,224,72,3,149,0,0,0,0,0,0,0,0,0,162,151,49,33,69,11,11,11,0,0,0,0,0,0,21755
6701,2236,240,745,641,380,230,184,137,134,17,0,117,3,3,3,0,0,0,0,0,0,47,39,8,2,29,8,8,0,0,8,0,0,0,0,21756
6702,2011,430,876,456,167,82,164,84,84,32,0,52,0,0,0,0,0,0,0,0,0,80,73,10,35,28,7,7,7,0,0,0,0,0,0,21757
6703,3570,283,1176,841,809,461,132,55,39,0,0,39,16,16,16,0,0,0,0,0,0,77,76,7,0,69,1,0,0,0,0,1,0,0,1,21758
6704,108,0,73,14,21,0,0,0,0,0,0,0,0,0,0,0,0,0,0,0,0,0,0,0,0,0,0,0,0,0,0,0,0,0,0,21762
6705,438,58,178,52,134,16,20,0,0,0,0,0,0,0,0,0,0,0,0,0,0,20,20,20,0,0,0,0,0,0,0,0,0,0,0,21766
6706,629,106,186,267,60,10,0,0,0,0,0,0,0,0,0,0,0,0,0,0,0,0,0,0,0,0,0,0,0,0,0,0,0,0,0,21767
6707,7664,287,2065,2054,1900,1358,802,435,360,88,19,253,75,66,31,35,0,9,9,0,0,367,344,81,33,230,23,8,8,0,0,15,0,15,0,21769
6708,3732,239,977,966,1016,534,433,246,210,15,14,181,36,36,36,0,0,0,0,0,0,187,187,54,0,133,0,0,0,0,0,0,0,0,0,21770
6709,18645,1172,4381,5377,4620,3095,1908,966,807,237,57,513,159,94,52,42,0,65,53,0,12,942,832,322,14,496,110,98,29,0,69,12,12,0,0,21771
6710,3772,314,1217,1013,742,486,379,219,186,42,0,144,33,23,23,0,0,10,0,10,0,160,160,65,5,90,0,0,0,0,0,0,0,0,0,21773
6711,7840,393,1536,2149,2008,1754,710,320,280,39,42,199,40,40,28,0,12,0,0,0,0,390,317,43,7,267,73,32,0,16,16,41,41,0,0,21774
6712,3642,284,1290,1009,682,377,238,101,97,51,0,46,4,4,0,0,4,0,0,0,0,137,137,74,13,50,0,0,0,0,0,0,0,0,0,21776
6713,1015,33,293,196,298,195,113,69,41,16,7,18,28,28,28,0,0,0,0,0,0,44,44,15,0,29,0,0,0,0,0,0,0,0,0,21777
6714,796,82,357,212,82,63,147,101,71,8,0,63,30,30,30,0,0,0,0,0,0,46,46,0,0,46,0,0,0,0,0,0,0,0,0,21778
6715,678,18,257,167,94,142,59,17,17,0,0,17,0,0,0,0,0,0,0,0,0,42,42,0,0,42,0,0,0,0,0,0,0,0,0,21779
6716,1198,117,527,372,120,62,147,121,115,9,0,106,6,6,6,0,0,0,0,0,0,26,26,21,0,5,0,0,0,0,0,0,0,0,0,21780
6717,0,0,0,0,0,0,49,22,22,7,0,15,0,0,0,0,0,0,0,0,0,27,27,9,0,18,0,0,0,0,0,0,0,0,0,21781
6718,3195,411,1409,813,358,204,229,139,90,27,4,59,49,49,49,0,0,0,0,0,0,90,69,26,14,29,21,21,14,4,3,0,0,0,0,21782
6719,6310,601,2272,1785,1141,511,399,216,185,96,14,75,31,16,0,7,9,15,0,15,0,183,177,101,13,63,6,6,6,0,0,0,0,0,0,21783
6720,26432,1541,6659,7356,6466,4410,2307,1054,944,278,67,599,110,110,89,10,11,0,0,0,0,1253,1151,473,34,644,102,96,11,67,18,6,0,0,6,21784
6721,7398,757,3021,2039,983,598,766,403,305,60,53,192,98,68,68,0,0,30,0,0,30,363,330,137,26,167,33,33,10,7,16,0,0,0,0,21787
6722,8018,795,3208,2183,1130,702,529,305,187,74,38,75,118,102,31,43,28,16,0,0,16,224,192,63,13,116,32,32,32,0,0,0,0,0,0,21788
6723,41,0,41,0,0,0,0,0,0,0,0,0,0,0,0,0,0,0,0,0,0,0,0,0,0,0,0,0,0,0,0,0,0,0,0,21790
6724,3807,269,1533,1187,579,239,276,159,136,45,11,80,23,14,10,0,4,9,0,9,0,117,105,27,3,75,12,12,8,4,0,0,0,0,0,21791
6725,6957,434,2041,2217,1364,901,593,256,229,107,13,109,27,27,0,21,6,0,0,0,0,337,294,111,80,103,43,28,9,19,0,15,9,0,6,21793
6726,1675,70,201,347,587,470,316,173,159,33,0,126,14,14,14,0,0,0,0,0,0,143,143,47,0,96,0,0,0,0,0,0,0,0,0,21794
6727,6758,891,2956,1820,691,400,432,199,167,43,15,109,32,32,0,27,5,0,0,0,0,233,196,166,9,21,37,37,19,11,7,0,0,0,0,21795
6728,5716,281,1443,1437,1452,1103,524,233,220,62,0,158,13,13,13,0,0,0,0,0,0,291,291,137,19,135,0,0,0,0,0,0,0,0,0,21797
6729,1838,154,565,547,402,170,176,95,74,31,17,26,21,14,14,0,0,7,0,0,7,81,78,42,6,30,3,3,0,0,3,0,0,0,0,21798
6730,18165,3064,5144,4488,3075,2394,3053,1168,1052,262,78,712,116,69,61,8,0,47,0,47,0,1885,1537,426,119,992,348,246,191,19,36,102,28,56,18,21801
6731,40,23,17,0,0,0,0,0,0,0,0,0,0,0,0,0,0,0,0,0,0,0,0,0,0,0,0,0,0,0,0,0,0,0,0,21802
6732,23373,2854,7155,6856,3973,2535,2670,1414,1098,293,30,775,316,164,104,0,60,152,51,0,101,1256,1127,456,116,555,129,90,13,25,52,39,39,0,0,21804
6733,165,41,10,68,46,0,0,0,0,0,0,0,0,0,0,0,0,0,0,0,0,0,0,0,0,0,0,0,0,0,0,0,0,0,0,21810
6734,16435,1562,5094,5168,2756,1855,848,422,366,145,40,181,56,56,19,0,37,0,0,0,0,426,376,174,14,188,50,29,19,0,10,21,0,0,21,21811
6735,1870,143,463,390,499,375,219,84,84,67,0,17,0,0,0,0,0,0,0,0,0,135,135,25,32,78,0,0,0,0,0,0,0,0,0,21813
6736,411,91,169,120,16,15,0,0,0,0,0,0,0,0,0,0,0,0,0,0,0,0,0,0,0,0,0,0,0,0,0,0,0,0,0,21814
6737,3214,542,1424,835,219,194,229,173,167,29,6,132,6,6,0,6,0,0,0,0,0,56,56,27,23,6,0,0,0,0,0,0,0,0,0,21817
6738,697,109,338,172,30,48,6,6,6,0,0,6,0,0,0,0,0,0,0,0,0,0,0,0,0,0,0,0,0,0,0,0,0,0,0,21821
6739,1272,312,413,268,175,104,122,22,22,0,22,0,0,0,0,0,0,0,0,0,0,100,93,35,0,58,7,7,0,0,7,0,0,0,0,21822
6740,107,31,41,28,3,4,0,0,0,0,0,0,0,0,0,0,0,0,0,0,0,0,0,0,0,0,0,0,0,0,0,0,0,0,0,21824
6741,3114,444,1012,700,533,425,181,149,149,0,41,108,0,0,0,0,0,0,0,0,0,32,32,0,0,32,0,0,0,0,0,0,0,0,0,21826
6742,547,43,199,257,48,0,53,23,23,0,0,23,0,0,0,0,0,0,0,0,0,30,30,30,0,0,0,0,0,0,0,0,0,0,0,21829
6743,2507,265,715,723,460,344,139,55,55,0,2,53,0,0,0,0,0,0,0,0,0,84,84,47,13,24,0,0,0,0,0,0,0,0,0,21830
6744,503,66,263,157,0,17,43,18,11,0,11,0,7,7,0,7,0,0,0,0,0,25,25,20,0,5,0,0,0,0,0,0,0,0,0,21835
6745,1934,235,928,517,149,105,172,72,36,19,0,17,36,9,9,0,0,27,0,27,0,100,97,39,0,58,3,3,0,0,3,0,0,0,0,21837
6746,1210,150,604,208,169,79,157,121,121,10,15,96,0,0,0,0,0,0,0,0,0,36,21,14,7,0,15,15,9,0,6,0,0,0,0,21838
6747,317,38,99,81,68,31,75,49,35,0,0,35,14,14,0,0,14,0,0,0,0,26,0,0,0,0,26,26,0,26,0,0,0,0,0,21840
6748,664,100,267,199,72,26,134,80,80,46,0,34,0,0,0,0,0,0,0,0,0,54,14,0,0,14,40,40,0,40,0,0,0,0,0,21841
6749,9106,565,2900,2401,2107,1133,237,146,104,101,0,3,42,42,0,29,13,0,0,0,0,91,87,5,0,82,4,4,4,0,0,0,0,0,0,21842
6750,2613,472,1155,576,295,115,145,145,145,35,23,87,0,0,0,0,0,0,0,0,0,0,0,0,0,0,0,0,0,0,0,0,0,0,0,21849
6751,1864,271,874,572,88,59,169,72,52,15,37,0,20,17,0,0,17,3,0,0,3,97,76,39,0,37,21,0,0,0,0,21,0,21,0,21850
6752,4904,966,1840,1114,618,366,486,283,129,0,61,68,154,124,83,22,19,30,12,0,18,203,130,33,33,64,73,73,28,45,0,0,0,0,0,21851
6753,5503,992,1799,1553,782,377,1703,789,758,202,0,556,31,31,0,12,19,0,0,0,0,914,886,206,17,663,28,20,20,0,0,8,0,0,8,21853
6754,623,82,178,214,121,28,46,36,36,36,0,0,0,0,0,0,0,0,0,0,0,10,10,0,0,10,0,0,0,0,0,0,0,0,0,21856
6755,585,101,232,176,57,19,28,0,0,0,0,0,0,0,0,0,0,0,0,0,0,28,14,5,0,9,14,14,0,14,0,0,0,0,0,21861
6756,350,55,295,0,0,0,0,0,0,0,0,0,0,0,0,0,0,0,0,0,0,0,0,0,0,0,0,0,0,0,0,0,0,0,0,21862
6757,3759,543,1351,1106,388,371,182,105,50,0,0,50,55,44,0,0,44,11,3,0,8,77,54,31,0,23,23,8,0,0,8,15,0,15,0,21863
6758,538,91,240,176,16,15,58,0,0,0,0,0,0,0,0,0,0,0,0,0,0,58,34,0,0,34,24,24,24,0,0,0,0,0,0,21864
6759,593,64,234,62,66,167,0,0,0,0,0,0,0,0,0,0,0,0,0,0,0,0,0,0,0,0,0,0,0,0,0,0,0,0,0,21865
6760,45,30,15,0,0,0,0,0,0,0,0,0,0,0,0,0,0,0,0,0,0,0,0,0,0,0,0,0,0,0,0,0,0,0,0,21866
6761,28,0,28,0,0,0,6,0,0,0,0,0,0,0,0,0,0,0,0,0,0,6,0,0,0,0,6,6,0,0,6,0,0,0,0,21867
6762,436,48,205,113,43,27,34,23,15,6,0,9,8,8,8,0,0,0,0,0,0,11,11,2,4,5,0,0,0,0,0,0,0,0,0,21869
6763,2609,600,1262,559,135,53,125,78,50,13,0,37,28,19,0,0,19,9,0,0,9,47,44,6,0,38,3,3,0,0,3,0,0,0,0,21871
6764,401,36,157,147,61,0,49,12,12,12,0,0,0,0,0,0,0,0,0,0,0,37,37,0,0,37,0,0,0,0,0,0,0,0,0,21872
6765,1669,165,681,547,165,111,157,85,64,44,0,20,21,16,13,0,3,5,0,0,5,72,72,61,0,11,0,0,0,0,0,0,0,0,0,21874
6766,4175,781,1544,1073,461,316,324,149,95,54,3,38,54,25,10,15,0,29,5,0,24,175,96,69,8,19,79,79,52,27,0,0,0,0,0,21875
6767,2370,753,1104,412,16,85,38,38,0,0,0,0,38,19,0,0,19,19,0,0,19,0,0,0,0,0,0,0,0,0,0,0,0,0,0,21890
6768,10889,1332,3538,3270,1808,941,991,561,353,71,6,276,208,113,75,38,0,95,0,77,18,430,325,179,42,104,105,105,10,95,0,0,0,0,0,21901
6769,176,78,52,25,6,15,5,5,0,0,0,0,5,0,0,0,0,5,0,0,5,0,0,0,0,0,0,0,0,0,0,0,0,0,0,21902
6770,4202,535,1629,887,844,307,609,365,309,63,43,203,56,23,12,11,0,33,0,0,33,244,102,6,23,73,142,59,46,0,13,83,0,0,83,21903
6771,5093,685,1956,1706,446,300,276,192,62,0,0,62,130,130,100,9,21,0,0,0,0,84,82,67,0,15,2,0,0,0,0,2,0,0,2,21904
6772,7561,961,2984,2365,848,403,593,298,259,74,26,159,39,39,18,0,21,0,0,0,0,295,220,94,13,113,75,17,12,0,5,58,58,0,0,21911
6773,637,23,165,313,72,64,27,27,11,11,0,0,16,16,16,0,0,0,0,0,0,0,0,0,0,0,0,0,0,0,0,0,0,0,0,21912
6774,431,69,220,106,18,18,57,30,27,6,7,14,3,0,0,0,0,3,0,3,0,27,20,20,0,0,7,0,0,0,0,7,0,0,7,21913
6775,425,32,199,129,47,18,29,17,17,17,0,0,0,0,0,0,0,0,0,0,0,12,12,3,0,9,0,0,0,0,0,0,0,0,0,21914
6776,2232,103,719,819,437,154,106,46,8,2,0,6,38,38,36,2,0,0,0,0,0,60,53,13,4,36,7,7,0,4,3,0,0,0,0,21915
6777,31,0,0,7,6,18,0,0,0,0,0,0,0,0,0,0,0,0,0,0,0,0,0,0,0,0,0,0,0,0,0,0,0,0,0,21916
6778,1731,89,687,578,287,90,141,52,44,44,0,0,8,0,0,0,0,8,0,0,8,89,63,43,20,0,26,0,0,0,0,26,26,0,0,21917
6779,2932,369,1207,861,372,123,238,76,50,0,12,38,26,8,8,0,0,18,9,9,0,162,103,46,0,57,59,14,0,14,0,45,34,0,11,21918
6780,2810,376,1188,789,288,169,243,26,14,0,0,14,12,12,0,12,0,0,0,0,0,217,170,90,20,60,47,12,12,0,0,35,14,0,21,21919
6781,146,74,26,46,0,0,0,0,0,0,0,0,0,0,0,0,0,0,0,0,0,0,0,0,0,0,0,0,0,0,0,0,0,0,0,21920
6782,27964,3700,9420,8025,4372,2447,2495,1365,1049,242,116,691,316,170,82,78,10,146,21,54,71,1130,975,290,143,542,155,61,6,5,50,94,14,10,70,21921
6783,116,0,59,28,12,17,0,0,0,0,0,0,0,0,0,0,0,0,0,0,0,0,0,0,0,0,0,0,0,0,0,0,0,0,0,21930
6784,40120,5454,7186,8520,10306,8654,2711,1480,1334,435,83,816,146,134,30,0,104,12,12,0,0,1231,1151,225,82,844,80,6,6,0,0,74,0,19,55,22003
6785,29766,1753,3520,6063,9925,8505,2330,1082,1082,161,98,823,0,0,0,0,0,0,0,0,0,1248,1147,273,0,874,101,101,64,0,37,0,0,0,0,22015
6786,11435,476,1929,3250,3006,2774,733,317,287,68,0,219,30,30,29,1,0,0,0,0,0,416,379,142,10,227,37,16,0,0,16,21,0,0,21,22025
6787,8762,1280,2290,2892,1289,1011,1197,725,699,37,64,598,26,26,26,0,0,0,0,0,0,472,438,51,0,387,34,0,0,0,0,34,0,0,34,22026
6788,1941,222,100,233,588,798,62,0,0,0,0,0,0,0,0,0,0,0,0,0,0,62,62,10,8,44,0,0,0,0,0,0,0,0,0,22027
6789,35097,2303,5236,7744,10815,8999,5043,2439,2302,530,152,1620,137,124,30,21,73,13,0,0,13,2604,2564,849,160,1555,40,40,14,26,0,0,0,0,0,22030
6790,22347,1343,3041,4101,6676,7186,975,571,501,49,24,428,70,10,10,0,0,60,0,60,0,404,395,148,1,246,9,9,9,0,0,0,0,0,0,22031
6791,19770,1004,2479,3878,6221,6188,1858,918,818,191,49,578,100,66,6,26,34,34,0,0,34,940,897,180,75,642,43,43,0,0,43,0,0,0,0,22032
6792,26594,1067,3131,5977,9627,6792,1372,747,747,217,0,530,0,0,0,0,0,0,0,0,0,625,625,146,52,427,0,0,0,0,0,0,0,0,0,22033
6793,0,0,0,0,0,0,0,0,0,0,0,0,0,0,0,0,0,0,0,0,0,0,0,0,0,0,0,0,0,0,0,0,0,0,0,22035
6794,12555,292,916,2348,4005,4994,1171,555,523,48,40,435,32,32,11,21,0,0,0,0,0,616,586,153,43,390,30,30,30,0,0,0,0,0,0,22039
6795,18312,4157,3061,3160,4050,3884,1278,641,477,70,6,401,164,61,8,0,53,103,0,55,48,637,466,45,0,421,171,140,47,0,93,31,0,0,31,22041
6796,23059,3412,4001,4718,6098,4830,1087,555,539,115,130,294,16,16,0,0,16,0,0,0,0,532,495,196,55,244,37,37,37,0,0,0,0,0,0,22042
6797,17799,1688,2433,2959,4847,5872,1270,859,765,234,0,531,94,20,20,0,0,74,0,0,74,411,366,159,0,207,45,45,45,0,0,0,0,0,0,22043
6798,9478,1310,1359,1687,2551,2571,410,213,185,21,12,152,28,28,0,0,28,0,0,0,0,197,191,51,0,140,6,0,0,0,0,6,6,0,0,22044
6799,11167,473,1227,1604,3409,4454,587,293,265,85,35,145,28,28,8,19,1,0,0,0,0,294,200,102,0,98,94,34,0,0,34,60,0,0,60,22046
6800,5229,126,677,2176,1140,1110,424,199,155,36,15,104,44,44,44,0,0,0,0,0,0,225,161,11,0,150,64,64,64,0,0,0,0,0,0,22060
6801,12650,241,931,1498,4647,5333,1512,657,657,188,0,469,0,0,0,0,0,0,0,0,0,855,855,201,18,636,0,0,0,0,0,0,0,0,0,22066
6802,21218,1452,3702,5448,6014,4602,1666,1069,893,431,54,408,176,88,64,0,24,88,0,63,25,597,592,195,38,359,5,5,5,0,0,0,0,0,0,22079
6803,20744,424,1210,2417,6326,10367,1779,916,903,195,22,686,13,0,0,0,0,13,13,0,0,863,812,154,10,648,51,34,14,0,20,17,5,0,12,22101
6804,16367,314,1028,2387,5395,7243,1071,698,683,191,0,492,15,15,0,0,15,0,0,0,0,373,373,26,75,272,0,0,0,0,0,0,0,0,0,22102
6805,12710,318,789,1993,4758,4852,976,537,529,180,12,337,8,8,8,0,0,0,0,0,0,439,411,105,52,254,28,28,13,0,15,0,0,0,0,22124
6806,524,5,70,139,158,152,14,5,5,0,0,5,0,0,0,0,0,0,0,0,0,9,9,3,0,6,0,0,0,0,0,0,0,0,0,22125
6807,3104,65,650,1216,950,223,644,513,72,45,0,27,441,441,434,0,7,0,0,0,0,131,15,0,0,15,116,116,116,0,0,0,0,0,0,22134
6808,19043,3221,4319,4035,4794,2674,1298,793,745,185,95,465,48,12,0,12,0,36,0,0,36,505,445,117,47,281,60,0,0,0,0,60,0,0,60,22150
6809,12024,1300,2737,3159,2681,2147,721,381,356,59,0,297,25,25,14,11,0,0,0,0,0,340,340,53,11,276,0,0,0,0,0,0,0,0,0,22151
6810,19985,926,3190,4719,5825,5325,1491,683,607,140,53,414,76,39,23,0,16,37,0,18,19,808,755,314,5,436,53,40,24,8,8,13,0,0,13,22152
6811,21281,1105,2960,4932,6127,6157,1733,923,902,267,57,578,21,21,0,21,0,0,0,0,0,810,774,157,10,607,36,27,0,27,0,9,0,0,9,22153
6812,5901,603,1359,1845,1346,748,466,138,120,37,16,67,18,18,18,0,0,0,0,0,0,328,309,71,29,209,19,19,0,0,19,0,0,0,0,22172
6813,16354,1151,1672,2509,5627,5395,1100,549,545,100,27,418,4,4,4,0,0,0,0,0,0,551,523,153,5,365,28,19,19,0,0,9,9,0,0,22180
6814,10422,679,925,1131,3438,4249,576,240,240,36,34,170,0,0,0,0,0,0,0,0,0,336,336,108,19,209,0,0,0,0,0,0,0,0,0,22181
6815,18033,527,1086,2611,6757,7052,1320,771,766,144,77,545,5,5,0,0,5,0,0,0,0,549,541,140,16,385,8,8,8,0,0,0,0,0,0,22182
6816,0,0,0,0,0,0,0,0,0,0,0,0,0,0,0,0,0,0,0,0,0,0,0,0,0,0,0,0,0,0,0,0,0,0,0,22185
6817,38238,7531,10110,9992,6466,4139,3320,1978,1628,472,143,1013,350,256,131,74,51,94,79,0,15,1342,1125,324,85,716,217,67,66,0,1,150,0,0,150,22191
6818,35885,2589,5722,10860,9550,7164,2389,1155,998,218,69,711,157,106,40,0,66,51,0,31,20,1234,1006,304,73,629,228,216,157,0,59,12,12,0,0,22192
6819,45987,5870,11326,15616,8175,5000,4757,2143,1902,321,156,1425,241,165,88,49,28,76,37,29,10,2614,2263,914,223,1126,351,294,260,21,13,57,17,0,40,22193
6820,26991,722,1371,2170,10853,11875,323,125,109,57,14,38,16,9,0,0,9,7,0,0,7,198,185,35,12,138,13,13,0,0,13,0,0,0,0,22201
6821,17403,485,829,1680,6240,8169,136,75,75,8,0,67,0,0,0,0,0,0,0,0,0,61,32,8,0,24,29,29,19,0,10,0,0,0,0,22202
6822,17508,1890,1534,2408,5280,6396,589,407,383,123,14,246,24,0,0,0,0,24,24,0,0,182,107,16,0,91,75,42,0,0,42,33,33,0,0,22203
6823,36397,4878,5789,6445,10918,8367,1678,897,760,204,48,508,137,43,42,1,0,94,37,0,57,781,714,146,9,559,67,67,11,0,56,0,0,0,0,22204
6824,12572,517,1415,1377,4283,4980,678,429,429,75,13,341,0,0,0,0,0,0,0,0,0,249,249,96,8,145,0,0,0,0,0,0,0,0,0,22205
6825,16253,804,1169,2433,6127,5720,405,152,56,6,0,50,96,96,78,0,18,0,0,0,0,253,151,93,0,58,102,90,69,21,0,12,12,0,0,22206
6826,22255,907,1617,2619,7018,10094,1741,744,676,149,7,520,68,21,21,0,0,47,24,0,23,997,941,267,55,619,56,13,13,0,0,43,25,0,18,22207
6827,9688,523,682,758,3760,3965,246,94,90,17,0,73,4,1,0,0,1,3,0,0,3,152,107,78,0,29,45,0,0,0,0,45,0,0,45,22209
6828,223,9,37,121,51,5,27,26,7,0,0,7,19,19,19,0,0,0,0,0,0,1,1,1,0,0,0,0,0,0,0,0,0,0,0,22211
6829,2447,102,177,227,972,969,168,102,102,10,0,92,0,0,0,0,0,0,0,0,0,66,66,9,0,57,0,0,0,0,0,0,0,0,0,22213
6830,30,0,10,20,0,0,20,0,0,0,0,0,0,0,0,0,0,0,0,0,0,20,10,10,0,0,10,10,10,0,0,0,0,0,0,22214
6831,8317,524,730,947,2837,3279,439,303,252,109,0,143,51,31,0,0,31,20,20,0,0,136,127,86,5,36,9,9,0,9,0,0,0,0,0,22301
6832,13723,1038,1333,2411,4589,4352,266,104,104,13,11,80,0,0,0,0,0,0,0,0,0,162,146,50,0,96,16,0,0,0,0,16,16,0,0,22302
6833,10315,1152,1382,1853,2925,3003,446,330,318,154,8,156,12,0,0,0,0,12,0,0,12,116,98,0,11,87,18,18,18,0,0,0,0,0,0,22303
6834,34142,2893,4347,6890,10828,9184,1278,615,554,161,28,365,61,44,44,0,0,17,0,0,17,663,516,106,21,389,147,93,42,43,8,54,0,0,54,22304
6835,11184,2303,1744,1511,2664,2962,334,229,174,35,10,129,55,55,41,0,14,0,0,0,0,105,99,19,13,67,6,6,0,0,6,0,0,0,0,22305
6836,21225,4385,4250,5017,3990,3583,1048,493,388,144,18,226,105,105,54,23,28,0,0,0,0,555,454,135,107,212,101,79,79,0,0,22,22,0,0,22306
6837,7604,430,955,1176,2607,2436,362,242,218,9,0,209,24,24,24,0,0,0,0,0,0,120,120,12,10,98,0,0,0,0,0,0,0,0,0,22307
6838,8924,174,512,1375,3003,3860,423,184,184,7,11,166,0,0,0,0,0,0,0,0,0,239,226,58,8,160,13,13,13,0,0,0,0,0,0,22308
6839,21355,3622,4760,5012,4418,3543,1574,1085,1081,202,66,813,4,4,0,0,4,0,0,0,0,489,438,63,9,366,51,20,20,0,0,31,0,0,31,22309
6840,20690,1426,3437,4399,6251,5177,1279,714,702,209,8,485,12,12,12,0,0,0,0,0,0,565,486,192,3,291,79,79,40,39,0,0,0,0,0,22310
6841,13985,1554,2861,3104,4026,2440,534,312,227,43,20,164,85,5,5,0,0,80,49,0,31,222,208,56,0,152,14,14,14,0,0,0,0,0,0,22311
6842,20659,3544,3400,4723,5385,3607,1062,513,495,132,0,363,18,0,0,0,0,18,18,0,0,549,514,181,10,323,35,13,13,0,0,22,0,0,22,22312
6843,24164,999,1734,2975,8042,10414,642,346,318,0,0,318,28,5,0,0,5,23,0,0,23,296,224,6,15,203,72,34,7,27,0,38,0,0,38,22314
6844,19170,751,2195,3984,6117,6123,894,424,400,11,51,338,24,24,24,0,0,0,0,0,0,470,419,192,6,221,51,46,12,0,34,5,0,0,5,22315
6845,14777,1438,3783,4370,2887,2299,1886,676,486,105,40,341,190,132,32,87,13,58,36,0,22,1210,1109,115,44,950,101,101,91,0,10,0,0,0,0,22401
6846,18971,1669,5397,5358,3777,2770,1685,966,791,129,58,604,175,119,107,9,3,56,6,30,20,719,676,140,4,532,43,43,6,37,0,0,0,0,0,22405
6847,13879,1134,3966,4503,2750,1526,1243,588,447,94,62,291,141,134,46,35,53,7,0,0,7,655,534,127,13,394,121,81,45,0,36,40,0,40,0,22406
6848,36003,3725,12045,10249,6069,3915,3686,1955,1383,285,141,957,572,204,83,114,7,368,51,99,218,1731,1450,563,67,820,281,269,180,28,61,12,12,0,0,22407
6849,17542,1188,5626,5179,3487,2062,1384,612,576,85,120,371,36,28,19,0,9,8,0,0,8,772,739,171,55,513,33,25,25,0,0,8,0,0,8,22408
6850,2132,485,838,457,246,106,278,183,119,25,0,94,64,44,4,16,24,20,13,0,7,95,95,2,43,50,0,0,0,0,0,0,0,0,0,22427
6851,289,35,149,94,11,0,42,0,0,0,0,0,0,0,0,0,0,0,0,0,0,42,0,0,0,0,42,42,42,0,0,0,0,0,0,22432
6852,185,18,64,67,36,0,0,0,0,0,0,0,0,0,0,0,0,0,0,0,0,0,0,0,0,0,0,0,0,0,0,0,0,0,0,22433
6853,1888,602,615,441,137,93,37,0,0,0,0,0,0,0,0,0,0,0,0,0,0,37,37,0,0,37,0,0,0,0,0,0,0,0,0,22435
6854,543,58,191,240,48,6,27,27,27,0,0,27,0,0,0,0,0,0,0,0,0,0,0,0,0,0,0,0,0,0,0,0,0,0,0,22436
6855,712,263,235,104,76,34,30,30,30,0,0,30,0,0,0,0,0,0,0,0,0,0,0,0,0,0,0,0,0,0,0,0,0,0,0,22437
6856,173,26,54,28,57,8,47,26,0,0,0,0,26,26,26,0,0,0,0,0,0,21,21,0,0,21,0,0,0,0,0,0,0,0,0,22438
6857,6034,1132,2676,1507,494,225,315,192,166,21,61,84,26,26,16,0,10,0,0,0,0,123,80,11,0,69,43,35,0,35,0,8,0,0,8,22443
6858,335,4,74,191,43,23,11,8,0,0,0,0,8,8,7,1,0,0,0,0,0,3,3,3,0,0,0,0,0,0,0,0,0,0,0,22448
6859,1404,268,580,369,101,86,55,47,47,8,30,9,0,0,0,0,0,0,0,0,0,8,8,0,0,8,0,0,0,0,0,0,0,0,0,22454
6860,1124,370,385,251,58,60,67,39,39,0,18,21,0,0,0,0,0,0,0,0,0,28,28,0,0,28,0,0,0,0,0,0,0,0,0,22460
6861,1224,346,509,262,10,97,75,49,25,0,0,25,24,0,0,0,0,24,0,0,24,26,26,0,0,26,0,0,0,0,0,0,0,0,0,22469
6862,3912,639,1310,1084,516,363,301,241,145,29,36,80,96,69,0,69,0,27,0,0,27,60,60,12,17,31,0,0,0,0,0,0,0,0,0,22473
6863,423,85,230,87,21,0,43,19,0,0,0,0,19,19,19,0,0,0,0,0,0,24,24,24,0,0,0,0,0,0,0,0,0,0,0,22476
6864,848,58,133,213,213,231,19,19,3,0,0,3,16,16,0,0,16,0,0,0,0,0,0,0,0,0,0,0,0,0,0,0,0,0,0,22480
6865,2489,342,768,779,388,212,123,104,78,23,0,55,26,0,0,0,0,26,0,4,22,19,19,0,0,19,0,0,0,0,0,0,0,0,0,22482
6866,15278,1388,4436,4660,2827,1967,1311,542,362,99,35,228,180,152,96,47,9,28,10,0,18,769,610,193,16,401,159,74,23,17,34,85,55,21,9,22485
6867,1012,206,415,95,156,140,26,18,18,0,0,18,0,0,0,0,0,0,0,0,0,8,8,0,8,0,0,0,0,0,0,0,0,0,0,22488
6868,3329,445,1049,998,620,217,201,81,81,32,13,36,0,0,0,0,0,0,0,0,0,120,31,0,0,31,89,89,89,0,0,0,0,0,0,22503
6869,152,45,49,32,11,15,10,10,10,0,0,10,0,0,0,0,0,0,0,0,0,0,0,0,0,0,0,0,0,0,0,0,0,0,0,22504
6870,9602,671,2938,3281,1688,1024,662,317,283,32,52,199,34,34,26,8,0,0,0,0,0,345,345,160,27,158,0,0,0,0,0,0,0,0,0,22508
6871,0,0,0,0,0,0,0,0,0,0,0,0,0,0,0,0,0,0,0,0,0,0,0,0,0,0,0,0,0,0,0,0,0,0,0,22509
6872,1057,133,336,359,146,83,22,22,22,0,8,14,0,0,0,0,0,0,0,0,0,0,0,0,0,0,0,0,0,0,0,0,0,0,0,22511
6873,1735,355,794,456,95,35,134,42,42,18,0,24,0,0,0,0,0,0,0,0,0,92,81,30,10,41,11,11,5,0,6,0,0,0,0,22514
6874,3814,798,1065,1178,387,386,294,202,186,0,8,178,16,5,5,0,0,11,0,0,11,92,79,31,1,47,13,4,4,0,0,9,0,0,9,22520
6875,423,168,143,112,0,0,0,0,0,0,0,0,0,0,0,0,0,0,0,0,0,0,0,0,0,0,0,0,0,0,0,0,0,0,0,22529
6876,103,0,0,50,53,0,0,0,0,0,0,0,0,0,0,0,0,0,0,0,0,0,0,0,0,0,0,0,0,0,0,0,0,0,0,22530
6877,1750,386,648,523,110,83,316,124,71,0,0,71,53,20,20,0,0,33,0,0,33,192,148,8,53,87,44,0,0,0,0,44,0,0,44,22534
6878,298,71,101,74,41,11,12,1,0,0,0,0,1,1,0,1,0,0,0,0,0,11,11,0,3,8,0,0,0,0,0,0,0,0,0,22535
6879,156,43,33,59,4,17,0,0,0,0,0,0,0,0,0,0,0,0,0,0,0,0,0,0,0,0,0,0,0,0,0,0,0,0,0,22538
6880,1822,75,569,778,321,79,57,24,24,17,0,7,0,0,0,0,0,0,0,0,0,33,33,26,0,7,0,0,0,0,0,0,0,0,0,22539
6881,997,132,371,264,105,125,37,0,0,0,0,0,0,0,0,0,0,0,0,0,0,37,24,0,0,24,13,0,0,0,0,13,0,0,13,22542
6882,10742,1873,3715,3113,1312,729,874,390,229,0,36,193,161,123,50,39,34,38,0,9,29,484,325,115,15,195,159,102,29,51,22,57,42,0,15,22546
6883,57,0,14,15,28,0,0,0,0,0,0,0,0,0,0,0,0,0,0,0,0,0,0,0,0,0,0,0,0,0,0,0,0,0,0,22548
6884,12120,2245,3877,3330,1739,929,1044,604,575,100,99,376,29,29,6,15,8,0,0,0,0,440,330,111,0,219,110,46,0,0,46,64,64,0,0,22551
6885,8592,631,2150,2720,1916,1175,870,561,442,76,43,323,119,112,42,39,31,7,0,7,0,309,279,58,26,195,30,25,8,17,0,5,5,0,0,22553
6886,32416,2296,6922,10500,7939,4759,3288,1749,1531,292,140,1099,218,192,110,49,33,26,11,0,15,1539,1276,315,54,907,263,246,178,0,68,17,0,0,17,22554
6887,16017,962,3909,5413,3318,2415,1818,979,808,137,45,626,171,160,15,28,117,11,10,0,1,839,714,241,29,444,125,125,32,23,70,0,0,0,0,22556
6888,4147,960,1485,1056,433,213,351,200,144,39,0,105,56,56,0,34,22,0,0,0,0,151,118,33,8,77,33,11,0,0,11,22,0,0,22,22560
6889,2191,532,797,548,131,183,147,54,36,0,0,36,18,0,0,0,0,18,0,0,18,93,93,54,0,39,0,0,0,0,0,0,0,0,0,22567
6890,5668,1292,2328,1336,528,184,366,111,108,0,59,49,3,3,2,0,1,0,0,0,0,255,232,0,39,193,23,23,0,0,23,0,0,0,0,22572
6891,1313,144,395,501,95,178,31,0,0,0,0,0,0,0,0,0,0,0,0,0,0,31,31,16,15,0,0,0,0,0,0,0,0,0,0,22576
6892,1758,155,438,502,368,295,77,58,34,6,0,28,24,24,0,0,24,0,0,0,0,19,18,18,0,0,1,0,0,0,0,1,0,1,0,22578
6893,57,0,0,17,0,40,0,0,0,0,0,0,0,0,0,0,0,0,0,0,0,0,0,0,0,0,0,0,0,0,0,0,0,0,0,22579
6894,3668,660,1493,901,417,197,215,92,85,0,7,78,7,4,2,0,2,3,0,3,0,123,97,33,32,32,26,26,0,11,15,0,0,0,0,22580
6895,18650,3320,5489,4693,3011,2137,1508,776,662,85,54,523,114,85,61,0,24,29,0,7,22,732,658,256,34,368,74,55,21,14,20,19,0,0,19,22601
6896,18696,2177,5699,5207,3455,2158,1685,906,756,249,84,423,150,150,55,72,23,0,0,0,0,779,717,207,69,441,62,42,31,11,0,20,10,0,10,22602
6897,10340,1863,3595,2555,1404,923,439,183,141,0,9,132,42,42,12,12,18,0,0,0,0,256,190,74,5,111,66,55,49,0,6,11,0,0,11,22603
6898,1252,221,567,274,152,38,50,23,23,7,0,16,0,0,0,0,0,0,0,0,0,27,7,0,0,7,20,20,0,20,0,0,0,0,0,22610
6899,6057,722,1677,1707,1171,780,305,108,108,13,8,87,0,0,0,0,0,0,0,0,0,197,187,80,12,95,10,10,0,10,0,0,0,0,0,22611
6900,1756,169,582,440,404,161,100,23,6,1,0,5,17,17,0,17,0,0,0,0,0,77,46,14,0,32,31,31,0,0,31,0,0,0,0,22620
6901,395,63,151,46,91,44,15,15,15,0,0,15,0,0,0,0,0,0,0,0,0,0,0,0,0,0,0,0,0,0,0,0,0,0,0,22623
6902,1886,252,695,531,224,184,149,85,74,63,0,11,11,11,11,0,0,0,0,0,0,64,64,33,0,31,0,0,0,0,0,0,0,0,0,22624
6903,2553,217,693,853,533,257,373,183,183,0,27,156,0,0,0,0,0,0,0,0,0,190,190,140,15,35,0,0,0,0,0,0,0,0,0,22625
6904,450,97,36,97,149,71,7,7,7,0,0,7,0,0,0,0,0,0,0,0,0,0,0,0,0,0,0,0,0,0,0,0,0,0,0,22627
6905,21022,3468,7756,5306,2798,1694,1773,949,794,150,40,604,155,124,17,67,40,31,25,0,6,824,777,246,80,451,47,47,7,27,13,0,0,0,0,22630
6906,1332,257,376,415,121,163,54,24,24,0,0,24,0,0,0,0,0,0,0,0,0,30,30,17,0,13,0,0,0,0,0,0,0,0,0,22637
6907,284,15,103,49,86,31,0,0,0,0,0,0,0,0,0,0,0,0,0,0,0,0,0,0,0,0,0,0,0,0,0,0,0,0,0,22639
6908,528,121,162,81,49,115,54,0,0,0,0,0,0,0,0,0,0,0,0,0,0,54,44,0,14,30,10,10,0,0,10,0,0,0,0,22640
6909,404,76,171,12,58,87,0,0,0,0,0,0,0,0,0,0,0,0,0,0,0,0,0,0,0,0,0,0,0,0,0,0,0,0,0,22641
6910,2627,235,853,911,337,291,132,80,55,22,8,25,25,25,0,14,11,0,0,0,0,52,52,43,0,9,0,0,0,0,0,0,0,0,0,22642
6911,84,0,17,40,7,20,0,0,0,0,0,0,0,0,0,0,0,0,0,0,0,0,0,0,0,0,0,0,0,0,0,0,0,0,0,22643
6912,1745,181,798,443,220,103,177,104,104,40,0,64,0,0,0,0,0,0,0,0,0,73,56,0,30,26,17,17,17,0,0,0,0,0,0,22644
6913,2631,475,1033,640,319,164,173,97,67,5,10,52,30,14,14,0,0,16,9,0,7,76,62,13,14,35,14,14,8,6,0,0,0,0,0,22645
6914,172,0,15,113,27,17,46,33,33,0,33,0,0,0,0,0,0,0,0,0,0,13,13,0,13,0,0,0,0,0,0,0,0,0,0,22646
6915,839,202,336,223,53,25,0,0,0,0,0,0,0,0,0,0,0,0,0,0,0,0,0,0,0,0,0,0,0,0,0,0,0,0,0,22650
6916,955,99,344,207,144,161,88,55,36,0,0,36,19,19,5,14,0,0,0,0,0,33,33,0,14,19,0,0,0,0,0,0,0,0,0,22652
6917,661,37,268,155,160,41,29,12,12,12,0,0,0,0,0,0,0,0,0,0,0,17,17,0,0,17,0,0,0,0,0,0,0,0,0,22654
6918,12643,1224,3254,4240,2363,1562,1097,657,584,108,80,396,73,68,44,23,1,5,0,0,5,440,418,145,26,247,22,22,12,10,0,0,0,0,0,22655
6919,1727,349,564,384,254,176,102,59,59,12,0,47,0,0,0,0,0,0,0,0,0,43,23,0,0,23,20,10,0,10,0,10,0,10,0,22656
6920,7531,1041,3250,2061,684,495,351,210,190,35,15,140,20,0,0,0,0,20,0,0,20,141,132,49,0,83,9,9,0,0,9,0,0,0,0,22657
6921,1288,179,602,296,144,67,119,69,24,0,0,24,45,45,0,12,33,0,0,0,0,50,46,14,0,32,4,4,4,0,0,0,0,0,0,22660
6922,1270,405,395,239,176,55,74,16,1,0,0,1,15,14,14,0,0,1,0,0,1,58,58,0,0,58,0,0,0,0,0,0,0,0,0,22663
6923,6203,1183,1976,1713,924,407,319,184,109,12,27,70,75,75,63,0,12,0,0,0,0,135,126,0,0,126,9,9,0,9,0,0,0,0,0,22664
6924,20917,3440,7192,5364,3166,1755,1665,667,582,108,62,412,85,72,34,17,21,13,0,0,13,998,904,256,30,618,94,94,94,0,0,0,0,0,0,22701
6925,676,152,221,183,67,53,17,0,0,0,0,0,0,0,0,0,0,0,0,0,0,17,17,0,0,17,0,0,0,0,0,0,0,0,0,22709
6926,10,0,0,0,10,0,0,0,0,0,0,0,0,0,0,0,0,0,0,0,0,0,0,0,0,0,0,0,0,0,0,0,0,0,0,22711
6927,5183,559,1994,1601,725,304,640,297,286,113,0,173,11,11,11,0,0,0,0,0,0,343,301,159,49,93,42,42,42,0,0,0,0,0,0,22712
6928,1081,75,628,202,98,78,34,34,34,21,0,13,0,0,0,0,0,0,0,0,0,0,0,0,0,0,0,0,0,0,0,0,0,0,0,22713
6929,810,131,298,175,157,49,75,17,17,11,0,6,0,0,0,0,0,0,0,0,0,58,35,0,0,35,23,23,23,0,0,0,0,0,0,22714
6930,1136,205,491,286,83,71,171,150,150,94,0,56,0,0,0,0,0,0,0,0,0,21,21,0,0,21,0,0,0,0,0,0,0,0,0,22715
6931,808,150,247,183,117,111,18,18,18,0,0,18,0,0,0,0,0,0,0,0,0,0,0,0,0,0,0,0,0,0,0,0,0,0,0,22716
6932,394,120,166,77,24,7,16,16,16,0,0,16,0,0,0,0,0,0,0,0,0,0,0,0,0,0,0,0,0,0,0,0,0,0,0,22718
6933,407,166,176,44,21,0,17,0,0,0,0,0,0,0,0,0,0,0,0,0,0,17,17,0,17,0,0,0,0,0,0,0,0,0,0,22719
6934,765,59,309,272,66,59,89,29,29,17,0,12,0,0,0,0,0,0,0,0,0,60,46,19,0,27,14,14,0,14,0,0,0,0,0,22720
6935,271,75,58,47,77,14,21,21,21,21,0,0,0,0,0,0,0,0,0,0,0,0,0,0,0,0,0,0,0,0,0,0,0,0,0,22722
6936,49,0,17,32,0,0,74,40,40,0,0,40,0,0,0,0,0,0,0,0,0,34,34,34,0,0,0,0,0,0,0,0,0,0,0,22723
6937,1295,218,358,312,260,147,43,8,8,0,8,0,0,0,0,0,0,0,0,0,0,35,35,0,0,35,0,0,0,0,0,0,0,0,0,22724
6938,342,79,199,30,17,17,123,107,46,12,22,12,61,47,0,0,47,14,0,0,14,16,16,9,0,7,0,0,0,0,0,0,0,0,0,22726
6939,3348,613,1004,888,572,271,255,64,64,0,6,58,0,0,0,0,0,0,0,0,0,191,168,56,0,112,23,23,23,0,0,0,0,0,0,22727
6940,2182,232,676,756,316,202,201,135,91,48,0,43,44,44,29,15,0,0,0,0,0,66,46,0,0,46,20,20,20,0,0,0,0,0,0,22728
6941,1111,414,478,169,50,0,8,7,0,0,0,0,7,7,0,0,7,0,0,0,0,1,0,0,0,0,1,1,0,0,1,0,0,0,0,22729
6942,43,15,9,19,0,0,0,0,0,0,0,0,0,0,0,0,0,0,0,0,0,0,0,0,0,0,0,0,0,0,0,0,0,0,0,22730
6943,49,0,10,39,0,0,0,0,0,0,0,0,0,0,0,0,0,0,0,0,0,0,0,0,0,0,0,0,0,0,0,0,0,0,0,22731
6944,204,60,20,67,57,0,0,0,0,0,0,0,0,0,0,0,0,0,0,0,0,0,0,0,0,0,0,0,0,0,0,0,0,0,0,22732
6945,937,80,338,320,129,70,249,239,89,0,0,89,150,96,0,0,96,54,0,0,54,10,10,0,0,10,0,0,0,0,0,0,0,0,0,22733
6946,2194,544,591,701,219,139,165,74,51,0,0,51,23,23,23,0,0,0,0,0,0,91,91,19,0,72,0,0,0,0,0,0,0,0,0,22734
6947,1159,248,468,233,158,52,75,39,39,0,16,23,0,0,0,0,0,0,0,0,0,36,26,15,0,11,10,10,0,10,0,0,0,0,0,22735
6948,570,70,178,196,104,22,37,30,30,0,19,11,0,0,0,0,0,0,0,0,0,7,7,0,0,7,0,0,0,0,0,0,0,0,0,22736
6949,2257,250,771,866,266,104,277,77,37,27,0,10,40,0,0,0,0,40,40,0,0,200,117,19,0,98,83,83,0,83,0,0,0,0,0,22737
6950,931,230,347,191,130,33,36,3,3,0,0,3,0,0,0,0,0,0,0,0,0,33,33,0,29,4,0,0,0,0,0,0,0,0,0,22738
6951,918,217,281,181,60,179,110,50,50,0,0,50,0,0,0,0,0,0,0,0,0,60,47,15,0,32,13,13,0,13,0,0,0,0,0,22740
6952,157,44,25,88,0,0,0,0,0,0,0,0,0,0,0,0,0,0,0,0,0,0,0,0,0,0,0,0,0,0,0,0,0,0,0,22741
6953,1323,94,530,441,207,51,217,122,122,21,0,101,0,0,0,0,0,0,0,0,0,95,95,19,15,61,0,0,0,0,0,0,0,0,0,22742
6954,142,0,12,11,62,57,0,0,0,0,0,0,0,0,0,0,0,0,0,0,0,0,0,0,0,0,0,0,0,0,0,0,0,0,0,22743
6955,777,66,179,246,156,130,0,0,0,0,0,0,0,0,0,0,0,0,0,0,0,0,0,0,0,0,0,0,0,0,0,0,0,0,0,22747
6956,275,53,53,66,73,30,23,0,0,0,0,0,0,0,0,0,0,0,0,0,0,23,14,14,0,0,9,9,0,0,9,0,0,0,0,22749
6957,17533,2910,4303,3429,4042,2849,4801,1752,1634,210,140,1284,118,24,0,0,24,94,0,80,14,3049,2866,708,115,2043,183,57,29,22,6,126,59,0,67,22801
6958,17924,3446,5313,4023,2981,2161,1634,643,483,146,0,337,160,160,126,8,26,0,0,0,0,991,831,261,23,547,160,142,79,20,43,18,0,0,18,22802
6959,20,0,14,0,0,6,2051,685,685,78,25,582,0,0,0,0,0,0,0,0,0,1366,1366,333,31,1002,0,0,0,0,0,0,0,0,0,22807
6960,605,41,211,124,138,91,22,10,10,10,0,0,0,0,0,0,0,0,0,0,0,12,12,0,0,12,0,0,0,0,0,0,0,0,0,22810
6961,361,149,166,26,14,6,12,0,0,0,0,0,0,0,0,0,0,0,0,0,0,12,12,0,0,12,0,0,0,0,0,0,0,0,0,22811
6962,5364,795,2002,987,939,641,1136,431,398,66,35,297,33,20,20,0,0,13,13,0,0,705,631,250,7,374,74,42,11,0,31,32,32,0,0,22812
6963,5376,1186,1925,1296,549,420,589,387,230,55,21,154,157,157,94,26,37,0,0,0,0,202,146,86,12,48,56,28,18,0,10,28,28,0,0,22815
6964,153,66,78,9,0,0,0,0,0,0,0,0,0,0,0,0,0,0,0,0,0,0,0,0,0,0,0,0,0,0,0,0,0,0,0,22820
6965,3834,950,1460,776,503,145,380,201,142,50,13,79,59,35,28,0,7,24,7,0,17,179,151,74,38,39,28,14,14,0,0,14,8,6,0,22821
6966,4391,585,1975,1015,502,314,167,60,60,13,0,47,0,0,0,0,0,0,0,0,0,107,107,46,5,56,0,0,0,0,0,0,0,0,0,22824
6967,6873,1799,3024,1245,633,172,475,250,204,20,12,172,46,37,8,22,7,9,0,9,0,225,212,68,6,138,13,13,13,0,0,0,0,0,0,22827
6968,1367,401,680,195,53,38,36,18,9,9,0,0,9,9,9,0,0,0,0,0,0,18,18,0,0,18,0,0,0,0,0,0,0,0,0,22830
6969,675,92,404,88,46,45,86,34,15,0,15,0,19,19,8,0,11,0,0,0,0,52,52,10,9,33,0,0,0,0,0,0,0,0,0,22831
6970,933,140,367,116,200,110,36,9,9,0,0,9,0,0,0,0,0,0,0,0,0,27,27,17,10,0,0,0,0,0,0,0,0,0,0,22832
6971,707,163,228,111,124,81,20,13,13,0,0,13,0,0,0,0,0,0,0,0,0,7,7,0,0,7,0,0,0,0,0,0,0,0,0,22834
6972,8388,1913,3220,1967,801,487,702,359,297,102,50,145,62,17,17,0,0,45,45,0,0,343,290,87,19,184,53,37,0,0,37,16,0,0,16,22835
6973,3499,268,1065,958,724,484,127,50,50,0,0,50,0,0,0,0,0,0,0,0,0,77,65,65,0,0,12,12,12,0,0,0,0,0,0,22840
6974,1924,278,704,440,261,241,155,95,93,26,0,67,2,2,2,0,0,0,0,0,0,60,60,13,0,47,0,0,0,0,0,0,0,0,0,22841
6975,3739,757,1298,1069,482,133,333,167,120,0,13,107,47,41,10,14,17,6,0,0,6,166,144,101,0,43,22,22,0,22,0,0,0,0,0,22842
6976,1709,346,818,316,166,63,108,32,32,18,0,14,0,0,0,0,0,0,0,0,0,76,76,21,0,55,0,0,0,0,0,0,0,0,0,22843
6977,3134,500,1182,734,401,317,182,155,95,30,38,27,60,60,60,0,0,0,0,0,0,27,27,22,0,5,0,0,0,0,0,0,0,0,0,22844
6978,0,0,0,0,0,0,0,0,0,0,0,0,0,0,0,0,0,0,0,0,0,0,0,0,0,0,0,0,0,0,0,0,0,0,0,22845
6979,1237,107,299,263,343,225,50,32,9,0,0,9,23,23,23,0,0,0,0,0,0,18,18,18,0,0,0,0,0,0,0,0,0,0,0,22846
6980,630,75,236,108,131,80,31,8,8,0,0,8,0,0,0,0,0,0,0,0,0,23,23,10,13,0,0,0,0,0,0,0,0,0,0,22847
6981,3318,710,1461,813,220,114,147,95,89,41,0,48,6,6,6,0,0,0,0,0,0,52,52,19,0,33,0,0,0,0,0,0,0,0,0,22849
6982,563,158,160,130,67,48,50,43,26,12,0,14,17,0,0,0,0,17,0,17,0,7,7,0,0,7,0,0,0,0,0,0,0,0,0,22850
6983,4243,1264,2085,640,209,45,423,188,157,115,0,42,31,31,16,15,0,0,0,0,0,235,235,35,9,191,0,0,0,0,0,0,0,0,0,22851
6984,3278,864,1388,510,277,239,251,71,57,25,0,32,14,10,10,0,0,4,0,0,4,180,165,42,0,123,15,12,12,0,0,3,0,0,3,22853
6985,22638,1259,4240,4845,5819,6475,1186,667,580,134,0,446,87,80,0,19,61,7,0,7,0,519,481,101,14,366,38,38,38,0,0,0,0,0,0,22901
6986,15235,2112,3024,2750,3345,4004,783,523,439,44,0,395,84,82,49,16,17,2,0,0,2,260,245,68,5,172,15,12,0,0,12,3,0,0,3,22902
6987,21702,1706,3762,3515,5979,6740,3725,2079,1988,298,16,1674,91,91,37,30,24,0,0,0,0,1646,1608,251,96,1261,38,32,32,0,0,6,6,0,0,22903
6988,51,0,6,11,6,28,3346,1388,1388,122,17,1249,0,0,0,0,0,0,0,0,0,1958,1958,268,109,1581,0,0,0,0,0,0,0,0,0,22904
6989,11912,877,1834,2629,3258,3314,834,350,327,51,17,259,23,17,9,0,8,6,0,6,0,484,339,88,11,240,145,136,96,40,0,9,9,0,0,22911
6990,3220,321,964,788,563,584,240,108,104,18,45,41,4,4,4,0,0,0,0,0,0,132,93,17,0,76,39,39,0,0,39,0,0,0,0,22920
6991,1500,345,369,393,300,93,131,67,67,7,0,60,0,0,0,0,0,0,0,0,0,64,64,0,0,64,0,0,0,0,0,0,0,0,0,22922
6992,2814,193,791,802,606,422,99,62,62,0,4,58,0,0,0,0,0,0,0,0,0,37,37,15,0,22,0,0,0,0,0,0,0,0,0,22923
6993,261,30,60,40,99,32,0,0,0,0,0,0,0,0,0,0,0,0,0,0,0,0,0,0,0,0,0,0,0,0,0,0,0,0,0,22931
6994,5245,736,1452,1053,961,1043,263,187,175,20,6,149,12,6,0,6,0,6,6,0,0,76,70,8,0,62,6,6,6,0,0,0,0,0,0,22932
6995,443,187,167,70,0,19,16,16,16,0,0,16,0,0,0,0,0,0,0,0,0,0,0,0,0,0,0,0,0,0,0,0,0,0,0,22935
6996,3213,136,533,680,1012,852,285,143,132,29,8,95,11,11,0,0,11,0,0,0,0,142,107,31,0,76,35,35,15,0,20,0,0,0,0,22936
6997,1308,427,402,289,122,68,80,39,23,0,0,23,16,0,0,0,0,16,0,0,16,41,18,18,0,0,23,7,7,0,0,16,0,0,16,22937
6998,1230,234,223,474,137,162,40,29,19,0,0,19,10,10,0,10,0,0,0,0,0,11,11,0,0,11,0,0,0,0,0,0,0,0,0,22938
6999,3179,371,890,818,690,410,324,165,131,104,0,27,34,27,20,0,7,7,0,0,7,159,132,63,0,69,27,27,0,0,27,0,0,0,0,22939
7000,739,76,165,187,193,118,49,42,26,0,0,26,16,16,0,0,16,0,0,0,0,7,7,0,0,7,0,0,0,0,0,0,0,0,0,22940
7001,5975,1001,1874,1668,876,556,444,177,93,18,2,73,84,84,0,21,63,0,0,0,0,267,201,37,0,164,66,51,28,17,6,15,0,0,15,22942
7002,216,12,28,85,33,58,9,9,9,0,0,9,0,0,0,0,0,0,0,0,0,0,0,0,0,0,0,0,0,0,0,0,0,0,0,22943
7003,130,24,42,40,17,7,9,0,0,0,0,0,0,0,0,0,0,0,0,0,0,9,9,0,0,9,0,0,0,0,0,0,0,0,0,22946
7004,3036,194,567,546,940,789,165,69,69,23,0,46,0,0,0,0,0,0,0,0,0,96,75,14,0,61,21,21,0,21,0,0,0,0,0,22947
7005,164,0,64,8,81,11,10,10,10,0,0,10,0,0,0,0,0,0,0,0,0,0,0,0,0,0,0,0,0,0,0,0,0,0,0,22948
7006,991,234,315,161,180,101,31,16,16,0,0,16,0,0,0,0,0,0,0,0,0,15,15,0,0,15,0,0,0,0,0,0,0,0,0,22949
7007,1579,188,690,358,257,86,119,106,106,51,0,55,0,0,0,0,0,0,0,0,0,13,13,0,0,13,0,0,0,0,0,0,0,0,0,22952
7008,1265,166,252,203,297,347,61,22,7,7,0,0,15,15,15,0,0,0,0,0,0,39,39,0,13,26,0,0,0,0,0,0,0,0,0,22958
7009,1087,172,369,213,270,63,26,8,8,0,0,8,0,0,0,0,0,0,0,0,0,18,18,0,0,18,0,0,0,0,0,0,0,0,0,22959
7010,8049,1761,2756,2087,960,485,558,408,374,12,0,362,34,20,0,0,20,14,0,0,14,150,100,23,13,64,50,39,39,0,0,11,0,11,0,22960
7011,10684,1139,2633,3149,2447,1316,503,172,172,21,0,151,0,0,0,0,0,0,0,0,0,331,322,115,8,199,9,9,9,0,0,0,0,0,0,22963
7012,91,0,40,51,0,0,0,0,0,0,0,0,0,0,0,0,0,0,0,0,0,0,0,0,0,0,0,0,0,0,0,0,0,0,0,22964
7013,1356,462,423,222,146,103,87,63,53,28,18,7,10,0,0,0,0,10,0,0,10,24,7,7,0,0,17,17,0,17,0,0,0,0,0,22967
7014,7079,1195,2228,1940,1321,395,631,352,233,82,0,151,119,119,54,23,42,0,0,0,0,279,243,57,0,186,36,24,24,0,0,12,0,12,0,22968
7015,925,296,384,127,93,25,31,31,31,10,0,21,0,0,0,0,0,0,0,0,0,0,0,0,0,0,0,0,0,0,0,0,0,0,0,22969
7016,1137,185,472,179,199,102,28,28,26,13,0,13,2,2,2,0,0,0,0,0,0,0,0,0,0,0,0,0,0,0,0,0,0,0,0,22971
7017,183,33,106,44,0,0,0,0,0,0,0,0,0,0,0,0,0,0,0,0,0,0,0,0,0,0,0,0,0,0,0,0,0,0,0,22972
7018,4622,853,1692,1015,635,427,240,91,74,22,0,52,17,0,0,0,0,17,0,17,0,149,94,72,8,14,55,55,55,0,0,0,0,0,0,22973
7019,4392,913,1238,1236,763,242,228,97,80,16,12,52,17,17,17,0,0,0,0,0,0,131,80,12,0,68,51,34,34,0,0,17,0,0,17,22974
7020,97,45,52,0,0,0,8,0,0,0,0,0,0,0,0,0,0,0,0,0,0,8,8,0,0,8,0,0,0,0,0,0,0,0,0,22976
7021,22232,3343,8745,5431,3260,1453,1468,763,507,180,24,303,256,176,72,13,91,80,12,12,56,705,587,186,20,381,118,104,93,11,0,14,0,0,14,22980
7022,79,0,0,0,12,67,22,22,22,0,0,22,0,0,0,0,0,0,0,0,0,0,0,0,0,0,0,0,0,0,0,0,0,0,0,22989
7023,7675,1688,2558,2247,879,303,617,371,301,13,0,288,70,42,19,0,23,28,21,0,7,246,128,22,0,106,118,118,52,0,66,0,0,0,0,23002
7024,588,134,339,98,17,0,0,0,0,0,0,0,0,0,0,0,0,0,0,0,0,0,0,0,0,0,0,0,0,0,0,0,0,0,0,23004
7025,9855,1148,3000,2731,1897,1079,1233,753,681,178,72,431,72,72,36,0,36,0,0,0,0,480,460,185,21,254,20,20,20,0,0,0,0,0,0,23005
7026,4216,491,1703,1212,655,155,454,261,182,68,0,114,79,79,48,0,31,0,0,0,0,193,120,34,9,77,73,42,21,0,21,31,0,0,31,23009
7027,1423,328,575,439,81,0,69,31,11,0,0,11,20,2,0,0,2,18,0,0,18,38,35,0,0,35,3,3,0,0,3,0,0,0,0,23011
7028,2992,307,821,838,679,347,68,34,34,0,14,20,0,0,0,0,0,0,0,0,0,34,34,0,24,10,0,0,0,0,0,0,0,0,0,23015
7029,330,43,70,59,89,69,0,0,0,0,0,0,0,0,0,0,0,0,0,0,0,0,0,0,0,0,0,0,0,0,0,0,0,0,0,23021
7030,790,98,165,318,109,100,149,99,99,44,0,55,0,0,0,0,0,0,0,0,0,50,0,0,0,0,50,0,0,0,0,50,50,0,0,23022
7031,219,8,98,74,19,20,15,15,15,0,15,0,0,0,0,0,0,0,0,0,0,0,0,0,0,0,0,0,0,0,0,0,0,0,0,23023
7032,6007,1253,2271,1365,732,386,547,366,313,32,56,225,53,53,11,15,27,0,0,0,0,181,167,43,11,113,14,14,14,0,0,0,0,0,0,23024
7033,160,0,87,50,16,7,0,0,0,0,0,0,0,0,0,0,0,0,0,0,0,0,0,0,0,0,0,0,0,0,0,0,0,0,0,23025
7034,893,161,402,287,43,0,96,30,30,0,0,30,0,0,0,0,0,0,0,0,0,66,66,0,0,66,0,0,0,0,0,0,0,0,0,23027
7035,3808,928,1520,840,319,201,199,110,92,2,22,68,18,18,7,11,0,0,0,0,0,89,86,12,11,63,3,3,0,3,0,0,0,0,0,23030
7036,171,21,49,75,26,0,50,26,26,0,0,26,0,0,0,0,0,0,0,0,0,24,24,3,0,21,0,0,0,0,0,0,0,0,0,23032
7037,934,132,298,316,62,126,111,39,39,0,0,39,0,0,0,0,0,0,0,0,0,72,72,12,0,60,0,0,0,0,0,0,0,0,0,23035
7038,1080,153,349,250,133,195,40,0,0,0,0,0,0,0,0,0,0,0,0,0,0,40,40,18,0,22,0,0,0,0,0,0,0,0,0,23038
7039,745,43,138,321,154,89,68,40,40,9,0,31,0,0,0,0,0,0,0,0,0,28,28,18,0,10,0,0,0,0,0,0,0,0,0,23039
7040,2792,620,978,828,221,145,215,188,172,37,8,127,16,16,0,0,16,0,0,0,0,27,27,13,0,14,0,0,0,0,0,0,0,0,0,23040
7041,1167,96,389,328,236,118,49,49,37,18,0,19,12,12,0,0,12,0,0,0,0,0,0,0,0,0,0,0,0,0,0,0,0,0,0,23043
7042,11,0,0,11,0,0,0,0,0,0,0,0,0,0,0,0,0,0,0,0,0,0,0,0,0,0,0,0,0,0,0,0,0,0,0,23045
7043,1215,96,454,248,284,133,147,99,95,38,0,57,4,0,0,0,0,4,0,0,4,48,48,30,0,18,0,0,0,0,0,0,0,0,0,23047
7044,484,90,164,216,8,6,47,10,10,0,0,10,0,0,0,0,0,0,0,0,0,37,37,0,0,37,0,0,0,0,0,0,0,0,0,23050
7045,700,213,244,138,43,62,1,0,0,0,0,0,0,0,0,0,0,0,0,0,0,1,0,0,0,0,1,1,0,0,1,0,0,0,0,23055
7046,351,35,150,55,92,19,0,0,0,0,0,0,0,0,0,0,0,0,0,0,0,0,0,0,0,0,0,0,0,0,0,0,0,0,0,23056
7047,21743,975,3257,4757,7624,5130,1628,962,926,356,29,541,36,36,18,0,18,0,0,0,0,666,632,188,25,419,34,34,32,0,2,0,0,0,0,23059
7048,23294,1716,4485,6447,6537,4109,1566,865,707,297,33,377,158,129,68,11,50,29,0,0,29,701,697,165,65,467,4,4,0,0,4,0,0,0,0,23060
7049,14151,1270,4793,4945,2024,1119,1238,685,506,107,81,318,179,170,154,0,16,9,9,0,0,553,462,141,63,258,91,60,52,8,0,31,0,20,11,23061
7050,1726,135,525,557,366,143,72,23,13,0,0,13,10,10,0,0,10,0,0,0,0,49,18,0,0,18,31,31,31,0,0,0,0,0,0,23062
7051,3956,853,1374,737,739,253,230,137,125,46,0,79,12,6,0,0,6,6,0,0,6,93,76,35,27,14,17,17,9,0,8,0,0,0,0,23063
7052,30,0,30,0,0,0,13,13,0,0,0,0,13,13,13,0,0,0,0,0,0,0,0,0,0,0,0,0,0,0,0,0,0,0,0,23064
7053,1385,92,568,401,180,144,196,88,88,21,27,40,0,0,0,0,0,0,0,0,0,108,108,48,0,60,0,0,0,0,0,0,0,0,0,23065
7054,454,31,128,157,15,123,0,0,0,0,0,0,0,0,0,0,0,0,0,0,0,0,0,0,0,0,0,0,0,0,0,0,0,0,0,23066
7055,277,0,82,103,38,54,8,8,8,0,0,8,0,0,0,0,0,0,0,0,0,0,0,0,0,0,0,0,0,0,0,0,0,0,0,23068
7056,2618,461,889,620,425,223,279,198,169,15,0,154,29,9,0,5,4,20,0,0,20,81,73,52,0,21,8,8,0,0,8,0,0,0,0,23069
7057,658,0,159,123,196,180,59,15,15,0,0,15,0,0,0,0,0,0,0,0,0,44,44,24,0,20,0,0,0,0,0,0,0,0,0,23070
7058,1272,88,262,385,347,190,76,64,49,13,0,36,15,15,0,0,15,0,0,0,0,12,12,0,0,12,0,0,0,0,0,0,0,0,0,23071
7059,8528,1152,2764,2787,1336,489,682,347,300,55,0,245,47,13,13,0,0,34,0,0,34,335,287,133,19,135,48,36,36,0,0,12,12,0,0,23072
7060,6820,1236,2626,2004,548,406,676,463,390,0,49,341,73,73,45,28,0,0,0,0,0,213,209,77,12,120,4,0,0,0,0,4,0,0,4,23075
7061,649,65,167,219,78,120,16,2,0,0,0,0,2,2,2,0,0,0,0,0,0,14,14,14,0,0,0,0,0,0,0,0,0,0,0,23076
7062,318,11,119,110,52,26,6,6,6,0,1,5,0,0,0,0,0,0,0,0,0,0,0,0,0,0,0,0,0,0,0,0,0,0,0,23079
7063,901,195,422,218,47,19,112,35,21,0,0,21,14,14,0,0,14,0,0,0,0,77,51,0,0,51,26,26,26,0,0,0,0,0,0,23083
7064,1173,111,412,322,242,86,81,16,8,0,0,8,8,8,8,0,0,0,0,0,0,65,65,0,6,59,0,0,0,0,0,0,0,0,0,23084
7065,312,77,138,52,45,0,0,0,0,0,0,0,0,0,0,0,0,0,0,0,0,0,0,0,0,0,0,0,0,0,0,0,0,0,0,23085
7066,2032,269,950,538,194,81,68,47,41,0,0,41,6,0,0,0,0,6,6,0,0,21,21,12,0,9,0,0,0,0,0,0,0,0,0,23086
7067,3379,311,1121,1044,648,255,239,95,95,12,0,83,0,0,0,0,0,0,0,0,0,144,72,25,14,33,72,72,15,57,0,0,0,0,0,23089
7068,226,55,73,42,37,19,0,0,0,0,0,0,0,0,0,0,0,0,0,0,0,0,0,0,0,0,0,0,0,0,0,0,0,0,0,23091
7069,378,26,120,161,42,29,0,0,0,0,0,0,0,0,0,0,0,0,0,0,0,0,0,0,0,0,0,0,0,0,0,0,0,0,0,23092
7070,9120,1677,3515,2314,1061,553,423,222,117,0,1,116,105,105,80,15,10,0,0,0,0,201,141,53,22,66,60,18,7,4,7,42,14,0,28,23093
7071,2576,534,730,552,426,334,46,19,14,0,14,0,5,0,0,0,0,5,0,0,5,27,27,18,0,9,0,0,0,0,0,0,0,0,0,23102
7072,3409,194,567,742,1091,815,195,84,57,0,0,57,27,9,9,0,0,18,0,0,18,111,111,42,0,69,0,0,0,0,0,0,0,0,0,23103
7073,741,75,354,220,59,33,7,0,0,0,0,0,0,0,0,0,0,0,0,0,0,7,7,0,0,7,0,0,0,0,0,0,0,0,0,23106
7074,178,0,135,43,0,0,0,0,0,0,0,0,0,0,0,0,0,0,0,0,0,0,0,0,0,0,0,0,0,0,0,0,0,0,0,23108
7075,1776,175,809,437,254,101,77,39,39,0,0,39,0,0,0,0,0,0,0,0,0,38,15,15,0,0,23,23,0,23,0,0,0,0,0,23109
7076,616,160,234,159,40,23,8,0,0,0,0,0,0,0,0,0,0,0,0,0,0,8,8,0,0,8,0,0,0,0,0,0,0,0,0,23110
7077,24684,1824,7631,8094,4901,2234,1945,900,844,153,104,587,56,56,38,8,10,0,0,0,0,1045,928,397,74,457,117,99,68,0,31,18,0,0,18,23111
7078,31831,1793,6564,9497,8929,5048,2675,1206,997,300,79,618,209,177,160,0,17,32,0,0,32,1469,1332,473,107,752,137,137,39,13,85,0,0,0,0,23112
7079,16620,462,2244,3696,5995,4223,1338,701,645,115,0,530,56,56,15,6,35,0,0,0,0,637,601,191,24,386,36,32,0,0,32,4,0,0,4,23113
7080,11778,426,1600,3345,4112,2295,1116,642,601,199,60,342,41,40,0,0,40,1,0,0,1,474,453,97,38,318,21,9,9,0,0,12,0,0,12,23114
7081,129,12,65,52,0,0,0,0,0,0,0,0,0,0,0,0,0,0,0,0,0,0,0,0,0,0,0,0,0,0,0,0,0,0,0,23115
7082,18310,1002,3784,4731,5778,3015,1649,739,703,181,54,468,36,36,30,6,0,0,0,0,0,910,892,263,76,553,18,18,18,0,0,0,0,0,0,23116
7083,6918,911,2912,1599,837,659,376,228,182,14,0,168,46,24,17,0,7,22,0,0,22,148,135,45,12,78,13,13,0,0,13,0,0,0,0,23117
7084,202,0,106,48,6,42,13,0,0,0,0,0,0,0,0,0,0,0,0,0,0,13,13,13,0,0,0,0,0,0,0,0,0,0,0,23119
7085,3890,232,736,895,1257,770,425,274,274,171,9,94,0,0,0,0,0,0,0,0,0,151,151,88,0,63,0,0,0,0,0,0,0,0,0,23120
7086,1116,172,551,222,159,12,70,21,0,0,0,0,21,21,21,0,0,0,0,0,0,49,32,0,9,23,17,0,0,0,0,17,0,0,17,23123
7087,2286,327,970,614,209,166,167,126,73,53,0,20,53,53,15,0,38,0,0,0,0,41,33,22,0,11,8,0,0,0,0,8,0,0,8,23124
7088,79,9,34,8,22,6,0,0,0,0,0,0,0,0,0,0,0,0,0,0,0,0,0,0,0,0,0,0,0,0,0,0,0,0,0,23125
7089,228,29,79,90,30,0,0,0,0,0,0,0,0,0,0,0,0,0,0,0,0,0,0,0,0,0,0,0,0,0,0,0,0,0,0,23126
7090,930,120,87,356,223,144,41,41,30,19,0,11,11,0,0,0,0,11,11,0,0,0,0,0,0,0,0,0,0,0,0,0,0,0,0,23128
7091,222,37,42,25,73,45,9,0,0,0,0,0,0,0,0,0,0,0,0,0,0,9,9,0,0,9,0,0,0,0,0,0,0,0,0,23129
7092,257,30,110,62,0,55,6,6,0,0,0,0,6,6,6,0,0,0,0,0,0,0,0,0,0,0,0,0,0,0,0,0,0,0,0,23130
7093,329,36,125,56,59,53,8,0,0,0,0,0,0,0,0,0,0,0,0,0,0,8,8,8,0,0,0,0,0,0,0,0,0,0,0,23138
7094,16327,1669,4483,5294,3344,1537,1483,936,750,269,17,464,186,84,36,0,48,102,49,0,53,547,513,188,91,234,34,13,13,0,0,21,0,0,21,23139
7095,4020,611,1236,1119,752,302,254,163,155,12,9,134,8,6,6,0,0,2,0,2,0,91,91,42,0,49,0,0,0,0,0,0,0,0,0,23140
7096,4340,384,1514,1402,814,226,277,187,150,75,0,75,37,0,0,0,0,37,0,37,0,90,90,10,0,80,0,0,0,0,0,0,0,0,0,23141
7097,2137,151,553,600,493,340,173,102,102,0,0,102,0,0,0,0,0,0,0,0,0,71,42,29,0,13,29,29,29,0,0,0,0,0,0,23146
7098,1469,403,539,327,134,66,63,58,58,27,0,31,0,0,0,0,0,0,0,0,0,5,0,0,0,0,5,5,0,5,0,0,0,0,0,23148
7099,2313,362,908,710,241,92,171,104,65,16,0,49,39,32,12,0,20,7,0,0,7,67,67,53,0,14,0,0,0,0,0,0,0,0,0,23149
7100,8657,1244,3166,2711,1131,405,472,209,177,0,31,146,32,32,0,19,13,0,0,0,0,263,171,18,27,126,92,92,67,25,0,0,0,0,0,23150
7101,904,90,269,274,181,90,22,22,22,0,0,22,0,0,0,0,0,0,0,0,0,0,0,0,0,0,0,0,0,0,0,0,0,0,0,23153
7102,1048,152,474,248,121,53,73,7,7,7,0,0,0,0,0,0,0,0,0,0,0,66,43,0,0,43,23,0,0,0,0,23,0,23,0,23156
7103,2775,1104,1140,418,74,39,17,17,0,0,0,0,17,4,0,0,4,13,0,0,13,0,0,0,0,0,0,0,0,0,0,0,0,0,0,23160
7104,59,0,20,17,15,7,0,0,0,0,0,0,0,0,0,0,0,0,0,0,0,0,0,0,0,0,0,0,0,0,0,0,0,0,0,23161
7105,230,58,53,27,20,72,0,0,0,0,0,0,0,0,0,0,0,0,0,0,0,0,0,0,0,0,0,0,0,0,0,0,0,0,0,23163
7106,4687,392,1410,1254,982,649,258,139,98,9,0,89,41,41,15,26,0,0,0,0,0,119,106,79,0,27,13,0,0,0,0,13,0,0,13,23168
7107,1150,254,272,502,94,28,51,28,28,0,8,20,0,0,0,0,0,0,0,0,0,23,23,0,0,23,0,0,0,0,0,0,0,0,0,23169
7108,64,0,0,0,26,38,929,527,527,90,42,395,0,0,0,0,0,0,0,0,0,402,402,94,70,238,0,0,0,0,0,0,0,0,0,23173
7109,1238,168,460,284,208,118,28,16,10,0,0,10,6,6,6,0,0,0,0,0,0,12,12,6,0,6,0,0,0,0,0,0,0,0,0,23175
7110,501,30,177,158,113,23,25,15,15,15,0,0,0,0,0,0,0,0,0,0,0,10,10,0,0,10,0,0,0,0,0,0,0,0,0,23176
7111,556,122,147,189,83,15,4,0,0,0,0,0,0,0,0,0,0,0,0,0,0,4,4,0,0,4,0,0,0,0,0,0,0,0,0,23177
7112,438,44,132,173,48,41,4,4,4,0,0,4,0,0,0,0,0,0,0,0,0,0,0,0,0,0,0,0,0,0,0,0,0,0,0,23180
7113,3837,315,1184,1447,588,303,261,133,101,19,7,75,32,15,0,15,0,17,0,0,17,128,128,71,0,57,0,0,0,0,0,0,0,0,0,23181
7114,30228,1945,5910,7911,7719,6743,4254,1878,1726,329,121,1276,152,114,93,0,21,38,0,12,26,2376,2206,457,236,1513,170,170,122,0,48,0,0,0,0,23185
7115,0,0,0,0,0,0,23,13,13,0,0,13,0,0,0,0,0,0,0,0,0,10,10,0,0,10,0,0,0,0,0,0,0,0,0,23187
7116,27825,1815,6076,7032,7946,4956,2005,1081,986,285,22,679,95,95,64,18,13,0,0,0,0,924,845,252,34,559,79,44,44,0,0,35,18,17,0,23188
7117,4769,433,1646,1422,863,405,351,229,204,43,36,125,25,25,14,11,0,0,0,0,0,122,122,29,0,93,0,0,0,0,0,0,0,0,0,23192
7118,1733,367,290,389,368,319,498,225,201,0,73,128,24,24,0,0,24,0,0,0,0,273,226,56,0,170,47,47,20,27,0,0,0,0,0,23219
7119,18006,2125,3008,4450,4940,3483,4690,1960,1821,235,270,1316,139,139,59,60,20,0,0,0,0,2730,2638,696,350,1592,92,62,6,0,56,30,0,30,0,23220
7120,11139,662,1036,2176,4412,2853,185,90,85,14,14,57,5,5,5,0,0,0,0,0,0,95,90,15,20,55,5,5,5,0,0,0,0,0,0,23221
7121,17016,3889,5457,4550,1905,1215,1537,846,617,175,45,397,229,113,45,19,49,116,10,0,106,691,545,84,90,371,146,78,8,54,16,68,8,0,60,23222
7122,31206,6847,9088,8761,4157,2353,2482,1280,897,114,78,705,383,215,51,56,108,168,0,12,156,1202,897,202,77,618,305,190,106,21,63,115,16,11,88,23223
7123,21581,6851,7289,5017,1658,766,1912,716,477,114,57,306,239,117,85,25,7,122,38,8,76,1196,940,135,212,593,256,147,80,0,67,109,0,19,90,23224
7124,28777,4416,7015,8023,5769,3554,1051,500,418,25,19,374,82,21,17,0,4,61,21,10,30,551,484,134,4,346,67,24,16,0,8,43,20,0,23,23225
7125,11178,739,1402,1840,4300,2897,414,194,192,74,21,97,2,0,0,0,0,2,0,0,2,220,220,69,8,143,0,0,0,0,0,0,0,0,0,23226
7126,18769,1940,4650,5420,4240,2519,911,384,257,55,27,175,127,127,22,56,49,0,0,0,0,527,416,35,201,180,111,111,72,34,5,0,0,0,0,23227
7127,23400,3461,5589,7899,4641,1810,1746,893,743,193,109,441,150,89,62,17,10,61,0,33,28,853,570,184,154,232,283,267,157,106,4,16,0,14,2,23228
7128,22818,1516,4358,5078,6709,5157,1712,873,785,171,133,481,88,19,7,12,0,69,51,0,18,839,783,159,33,591,56,56,48,0,8,0,0,0,0,23229
7129,4046,468,873,1036,992,677,170,69,51,35,5,11,18,14,14,0,0,4,0,0,4,101,83,14,13,56,18,13,13,0,0,5,0,0,5,23230
7130,23541,3256,7992,6945,3569,1779,1930,801,622,113,83,426,179,178,97,72,9,1,0,0,1,1129,1004,363,82,559,125,125,59,43,23,0,0,0,0,23231
7131,19713,713,2077,4088,7663,5172,1457,669,634,161,70,403,35,0,0,0,0,35,0,0,35,788,705,263,51,391,83,83,83,0,0,0,0,0,0,23233
7132,27249,6742,7979,7723,3358,1447,2829,1293,884,178,84,622,409,195,121,17,57,214,34,0,180,1536,1211,258,153,800,325,185,20,2,163,140,16,30,94,23234
7133,21505,1757,3872,5661,6304,3911,1441,849,707,95,65,547,142,64,15,0,49,78,0,0,78,592,446,148,23,275,146,139,0,8,131,7,0,0,7,23235
7134,18445,1313,4192,5952,4620,2368,1109,656,608,171,36,401,48,35,0,35,0,13,0,0,13,453,424,161,7,256,29,14,7,0,7,15,15,0,0,23236
7135,14240,2764,4525,4659,1711,581,1251,558,403,84,9,310,155,89,48,8,33,66,17,0,49,693,430,20,26,384,263,225,75,97,53,38,0,0,38,23237
7136,18561,1123,2736,4810,5880,4012,1162,741,670,256,36,378,71,24,24,0,0,47,0,35,12,421,378,121,19,238,43,43,13,30,0,0,0,0,0,23238
7137,0,0,0,0,0,0,0,0,0,0,0,0,0,0,0,0,0,0,0,0,0,0,0,0,0,0,0,0,0,0,0,0,0,0,0,23250
7138,11406,1169,2245,3549,2798,1645,433,204,204,24,32,148,0,0,0,0,0,0,0,0,0,229,212,81,15,116,17,0,0,0,0,17,17,0,0,23294
7139,1041,269,409,213,103,47,97,42,32,0,0,32,10,7,0,0,7,3,0,0,3,55,55,44,0,11,0,0,0,0,0,0,0,0,0,23301
7140,15,0,0,0,15,0,0,0,0,0,0,0,0,0,0,0,0,0,0,0,0,0,0,0,0,0,0,0,0,0,0,0,0,0,0,23302
7141,740,44,227,254,179,36,41,41,41,0,0,41,0,0,0,0,0,0,0,0,0,0,0,0,0,0,0,0,0,0,0,0,0,0,0,23303
7142,143,108,0,14,11,10,0,0,0,0,0,0,0,0,0,0,0,0,0,0,0,0,0,0,0,0,0,0,0,0,0,0,0,0,0,23304
7143,633,103,221,114,106,89,88,24,24,14,0,10,0,0,0,0,0,0,0,0,0,64,24,16,2,6,40,30,0,30,0,10,0,0,10,23306
7144,471,55,194,109,113,0,32,32,32,0,0,32,0,0,0,0,0,0,0,0,0,0,0,0,0,0,0,0,0,0,0,0,0,0,0,23307
7145,1301,355,597,246,52,51,77,41,2,0,0,2,39,39,0,0,39,0,0,0,0,36,30,2,0,28,6,0,0,0,0,6,0,0,6,23308
7146,3404,583,1235,898,489,199,296,81,72,1,0,71,9,9,9,0,0,0,0,0,0,215,189,5,0,184,26,9,0,0,9,17,0,0,17,23310
7147,74,16,25,0,0,33,33,16,0,0,0,0,16,0,0,0,0,16,16,0,0,17,0,0,0,0,17,17,17,0,0,0,0,0,0,23313
7148,4796,498,1096,1505,1127,570,340,193,193,8,20,165,0,0,0,0,0,0,0,0,0,147,130,43,9,78,17,17,17,0,0,0,0,0,0,23314
7149,1093,108,402,383,159,41,62,36,35,35,0,0,1,1,0,0,1,0,0,0,0,26,26,7,9,10,0,0,0,0,0,0,0,0,0,23315
7150,180,103,41,26,10,0,10,0,0,0,0,0,0,0,0,0,0,0,0,0,0,10,10,0,0,10,0,0,0,0,0,0,0,0,0,23316
7151,36135,2164,8786,12835,8035,4315,2390,1185,1064,229,59,776,121,75,38,4,33,46,0,24,22,1205,1063,411,202,450,142,142,123,13,6,0,0,0,0,23320
7152,22404,1960,5752,7626,4376,2690,1820,973,819,280,98,441,154,154,37,49,68,0,0,0,0,847,701,284,41,376,146,146,59,0,87,0,0,0,0,23321
7153,40952,2881,9803,14190,8544,5534,4749,2719,1977,564,126,1287,742,723,588,48,87,19,0,0,19,2030,1903,745,199,959,127,56,37,15,4,71,17,0,54,23322
7154,22442,2584,5943,8584,3397,1934,1979,938,861,154,116,591,77,77,15,46,16,0,0,0,0,1041,980,365,102,513,61,6,0,6,0,55,24,14,17,23323
7155,13283,3037,4215,4398,1214,419,1325,743,531,50,83,398,212,136,89,39,8,76,40,36,0,582,410,148,47,215,172,172,93,0,79,0,0,0,0,23324
7156,12150,1837,3644,4007,1679,983,789,437,336,33,51,252,101,101,67,28,6,0,0,0,0,352,256,45,24,187,96,96,43,53,0,0,0,0,0,23325
7157,2279,347,718,653,246,315,75,20,12,0,0,12,8,8,8,0,0,0,0,0,0,55,37,0,18,19,18,18,18,0,0,0,0,0,0,23336
7158,242,42,103,31,31,35,19,19,19,19,0,0,0,0,0,0,0,0,0,0,0,0,0,0,0,0,0,0,0,0,0,0,0,0,0,23337
7159,531,130,203,131,25,42,9,9,0,0,0,0,9,0,0,0,0,9,0,0,9,0,0,0,0,0,0,0,0,0,0,0,0,0,0,23347
7160,2640,748,951,538,208,195,70,31,26,18,0,8,5,5,5,0,0,0,0,0,0,39,30,2,0,28,9,9,9,0,0,0,0,0,0,23350
7161,147,17,38,2,90,0,20,3,0,0,0,0,3,3,3,0,0,0,0,0,0,17,17,0,0,17,0,0,0,0,0,0,0,0,0,23354
7162,827,80,336,106,213,92,18,0,0,0,0,0,0,0,0,0,0,0,0,0,0,18,18,0,0,18,0,0,0,0,0,0,0,0,0,23356
7163,451,140,172,7,56,76,0,0,0,0,0,0,0,0,0,0,0,0,0,0,0,0,0,0,0,0,0,0,0,0,0,0,0,0,0,23357
7164,17,9,0,8,0,0,0,0,0,0,0,0,0,0,0,0,0,0,0,0,0,0,0,0,0,0,0,0,0,0,0,0,0,0,0,23358
7165,657,269,251,101,24,12,17,17,17,0,2,15,0,0,0,0,0,0,0,0,0,0,0,0,0,0,0,0,0,0,0,0,0,0,0,23359
7166,119,0,0,0,0,119,0,0,0,0,0,0,0,0,0,0,0,0,0,0,0,0,0,0,0,0,0,0,0,0,0,0,0,0,0,23389
7167,232,73,142,17,0,0,0,0,0,0,0,0,0,0,0,0,0,0,0,0,0,0,0,0,0,0,0,0,0,0,0,0,0,0,0,23395
7168,38,0,17,0,10,11,0,0,0,0,0,0,0,0,0,0,0,0,0,0,0,0,0,0,0,0,0,0,0,0,0,0,0,0,0,23398
7169,91,19,40,30,0,2,13,6,6,0,0,6,0,0,0,0,0,0,0,0,0,7,7,0,0,7,0,0,0,0,0,0,0,0,0,23401
7170,832,217,200,242,129,44,35,35,11,0,0,11,24,24,24,0,0,0,0,0,0,0,0,0,0,0,0,0,0,0,0,0,0,0,0,23405
7171,317,78,133,106,0,0,28,0,0,0,0,0,0,0,0,0,0,0,0,0,0,28,28,0,0,28,0,0,0,0,0,0,0,0,0,23407
7172,38,0,28,10,0,0,0,0,0,0,0,0,0,0,0,0,0,0,0,0,0,0,0,0,0,0,0,0,0,0,0,0,0,0,0,23408
7173,5,0,0,0,0,5,0,0,0,0,0,0,0,0,0,0,0,0,0,0,0,0,0,0,0,0,0,0,0,0,0,0,0,0,0,23409
7174,1903,390,655,598,130,130,159,62,53,0,0,53,9,9,9,0,0,0,0,0,0,97,87,9,0,78,10,10,0,0,10,0,0,0,0,23410
7175,639,121,207,103,105,103,27,19,19,0,0,19,0,0,0,0,0,0,0,0,0,8,8,0,0,8,0,0,0,0,0,0,0,0,0,23413
7176,134,84,50,0,0,0,13,0,0,0,0,0,0,0,0,0,0,0,0,0,0,13,0,0,0,0,13,13,13,0,0,0,0,0,0,23414
7177,1318,324,578,329,60,27,0,0,0,0,0,0,0,0,0,0,0,0,0,0,0,0,0,0,0,0,0,0,0,0,0,0,0,0,0,23415
7178,286,46,130,60,0,50,60,60,60,0,0,60,0,0,0,0,0,0,0,0,0,0,0,0,0,0,0,0,0,0,0,0,0,0,0,23416
7179,2875,410,959,765,343,398,155,129,101,56,0,45,28,25,0,17,8,3,0,3,0,26,26,14,0,12,0,0,0,0,0,0,0,0,0,23417
7180,584,137,247,86,95,19,25,7,0,0,0,0,7,7,7,0,0,0,0,0,0,18,18,5,0,13,0,0,0,0,0,0,0,0,0,23418
7181,1883,330,702,542,191,118,38,28,26,23,0,3,2,0,0,0,0,2,0,0,2,10,10,3,0,7,0,0,0,0,0,0,0,0,0,23420
7182,3523,1063,1308,708,235,209,191,75,20,0,0,20,55,12,12,0,0,43,43,0,0,116,100,31,3,66,16,16,0,0,16,0,0,0,0,23421
7183,159,5,77,0,55,22,47,39,0,0,0,0,39,39,0,0,39,0,0,0,0,8,8,0,8,0,0,0,0,0,0,0,0,0,0,23422
7184,227,39,138,35,15,0,0,0,0,0,0,0,0,0,0,0,0,0,0,0,0,0,0,0,0,0,0,0,0,0,0,0,0,0,0,23423
7185,172,61,92,19,0,0,0,0,0,0,0,0,0,0,0,0,0,0,0,0,0,0,0,0,0,0,0,0,0,0,0,0,0,0,0,23426
7186,187,84,79,20,2,2,9,2,2,0,0,2,0,0,0,0,0,0,0,0,0,7,7,3,0,4,0,0,0,0,0,0,0,0,0,23427
7187,12077,1353,3083,4023,2181,1437,853,515,345,205,18,122,170,68,48,0,20,102,12,26,64,338,321,128,50,143,17,9,9,0,0,8,8,0,0,23430
7188,941,120,352,259,107,103,58,5,5,0,0,5,0,0,0,0,0,0,0,0,0,53,53,30,0,23,0,0,0,0,0,0,0,0,0,23432
7189,669,44,166,191,201,67,30,22,0,0,0,0,22,22,22,0,0,0,0,0,0,8,8,0,0,8,0,0,0,0,0,0,0,0,0,23433
7190,31265,4680,9868,9951,4282,2484,2364,1256,1106,175,177,754,150,92,10,82,0,58,0,22,36,1108,873,154,111,608,235,104,42,40,22,131,0,9,122,23434
7191,17359,1655,3919,5664,3933,2188,1827,1041,939,240,139,560,102,61,43,0,18,41,0,0,41,786,718,195,121,402,68,68,54,11,3,0,0,0,0,23435
7192,866,33,196,318,142,177,25,11,11,0,7,4,0,0,0,0,0,0,0,0,0,14,0,0,0,0,14,14,14,0,0,0,0,0,0,23436
7193,3156,477,1127,905,515,132,146,21,21,0,10,11,0,0,0,0,0,0,0,0,0,125,120,31,0,89,5,5,0,0,5,0,0,0,0,23437
7194,1432,130,587,455,124,136,81,57,44,8,0,36,13,13,13,0,0,0,0,0,0,24,24,0,0,24,0,0,0,0,0,0,0,0,0,23438
7195,395,149,183,36,21,6,28,18,12,3,0,9,6,6,6,0,0,0,0,0,0,10,10,0,0,10,0,0,0,0,0,0,0,0,0,23440
7196,31,14,17,0,0,0,0,0,0,0,0,0,0,0,0,0,0,0,0,0,0,0,0,0,0,0,0,0,0,0,0,0,0,0,0,23441
7197,812,121,422,238,11,20,89,47,47,0,0,47,0,0,0,0,0,0,0,0,0,42,42,6,0,36,0,0,0,0,0,0,0,0,0,23442
7198,29890,1361,5308,9922,8548,4751,1798,776,633,221,83,329,143,97,97,0,0,46,0,12,34,1022,735,345,24,366,287,272,199,43,30,15,0,0,15,23451
7199,40259,3334,10007,15408,7483,4027,2846,1447,1242,266,159,817,205,145,138,6,1,60,27,20,13,1399,1209,339,112,758,190,153,86,38,29,37,37,0,0,23452
7200,21943,1344,6071,10029,2974,1525,1886,1045,885,229,98,558,160,160,81,45,34,0,0,0,0,841,742,140,87,515,99,81,52,0,29,18,0,0,18,23453
7201,39916,2026,9528,14514,9182,4666,3871,1968,1325,448,55,822,643,525,385,57,83,118,45,0,73,1903,1616,646,113,857,287,277,207,34,36,10,10,0,0,23454
7202,32915,1828,7306,11368,7568,4845,2350,1298,839,328,38,473,459,459,365,32,62,0,0,0,0,1052,875,202,54,619,177,115,115,0,0,62,0,39,23,23455
7203,33869,1584,6690,13121,8005,4469,3275,1689,1483,380,123,980,206,189,104,0,85,17,0,0,17,1586,1516,579,68,869,70,64,41,0,23,6,0,0,6,23456
7204,3292,335,716,1381,541,319,192,109,98,29,0,69,11,11,11,0,0,0,0,0,0,83,83,44,0,39,0,0,0,0,0,0,0,0,0,23457
7205,497,0,119,317,44,17,44,21,0,0,0,0,21,21,21,0,0,0,0,0,0,23,0,0,0,0,23,0,0,0,0,23,0,0,23,23459
7206,149,0,72,30,29,18,90,75,0,0,0,0,75,75,75,0,0,0,0,0,0,15,0,0,0,0,15,15,15,0,0,0,0,0,0,23460
7207,72,0,0,40,25,7,52,39,0,0,0,0,39,39,39,0,0,0,0,0,0,13,0,0,0,0,13,13,13,0,0,0,0,0,0,23461
7208,39454,3554,10336,14828,7589,3147,3240,1620,1219,339,55,825,401,311,178,35,98,90,9,61,20,1620,1386,445,181,760,234,234,174,34,26,0,0,0,0,23462
7209,48236,3275,10901,18202,10958,4900,3780,1924,1724,458,95,1171,200,151,142,9,0,49,0,49,0,1856,1781,512,147,1122,75,68,34,24,10,7,0,0,7,23464
7210,254,51,97,67,18,21,0,0,0,0,0,0,0,0,0,0,0,0,0,0,0,0,0,0,0,0,0,0,0,0,0,0,0,0,0,23480
7211,127,7,75,10,0,35,21,0,0,0,0,0,0,0,0,0,0,0,0,0,0,21,21,0,0,21,0,0,0,0,0,0,0,0,0,23486
7212,4561,849,1752,1366,398,196,353,182,182,11,38,133,0,0,0,0,0,0,0,0,0,171,157,38,32,87,14,10,4,0,6,4,0,0,4,23487
7213,128,102,26,0,0,0,0,0,0,0,0,0,0,0,0,0,0,0,0,0,0,0,0,0,0,0,0,0,0,0,0,0,0,0,0,23488
7214,14491,2310,4599,4829,1924,829,1434,781,661,110,80,471,120,120,5,83,32,0,0,0,0,653,567,127,82,358,86,78,24,0,54,8,0,0,8,23502
7215,21867,2514,6030,8985,2864,1474,1697,860,567,188,65,314,293,276,237,26,13,17,17,0,0,837,725,199,73,453,112,112,37,55,20,0,0,0,0,23503
7216,12258,2895,3834,3537,1319,673,2317,1132,998,79,151,768,134,81,22,37,22,53,15,25,13,1185,1045,204,101,740,140,54,32,8,14,86,21,0,65,23504
7217,18471,1730,4920,6835,2899,2087,1228,536,297,65,19,213,239,179,83,0,96,60,18,42,0,692,530,166,74,290,162,122,43,31,48,40,0,0,40,23505
7218,5490,154,402,1417,1698,1819,213,85,53,5,0,48,32,32,25,0,7,0,0,0,0,128,36,16,7,13,92,92,92,0,0,0,0,0,0,23507
7219,9806,994,1657,2461,2258,2436,2931,1648,1583,207,96,1280,65,55,46,0,9,10,0,0,10,1283,1215,193,126,896,68,16,16,0,0,52,0,12,40,23508
7220,9174,1701,2596,2647,1342,888,677,334,230,28,28,174,104,96,91,5,0,8,0,0,8,343,301,25,69,207,42,13,8,0,5,29,0,0,29,23509
7221,4811,649,800,1068,1089,1205,186,91,38,0,0,38,53,11,0,0,11,42,0,0,42,95,80,17,0,63,15,0,0,0,0,15,0,0,15,23510
7222,2287,14,647,1032,485,109,1031,770,29,29,0,0,741,741,741,0,0,0,0,0,0,261,17,0,6,11,244,244,244,0,0,0,0,0,0,23511
7223,19414,3522,5975,7014,2147,756,1242,535,447,38,26,383,88,72,36,23,13,16,16,0,0,707,504,154,90,260,203,120,73,13,34,83,48,29,6,23513
7224,3173,272,549,800,995,557,108,59,59,15,21,23,0,0,0,0,0,0,0,0,0,49,42,4,18,20,7,0,0,0,0,7,7,0,0,23517
7225,20366,2803,6028,6720,3182,1633,1515,764,620,158,94,368,144,82,56,26,0,62,54,0,8,751,529,144,13,372,222,193,80,8,105,29,0,0,29,23518
7226,4368,875,1412,1734,235,112,500,232,104,7,0,97,128,31,30,0,1,97,0,42,55,268,191,81,17,93,77,31,25,0,6,46,0,15,31,23523
7227,101,0,33,65,3,0,75,75,0,0,0,0,75,75,75,0,0,0,0,0,0,0,0,0,0,0,0,0,0,0,0,0,0,0,0,23551
7228,16940,1486,5113,6221,2584,1536,1043,630,480,130,90,260,150,71,47,16,8,79,48,31,0,413,367,91,71,205,46,46,46,0,0,0,0,0,0,23601
7229,26986,2172,6926,9722,4898,3268,1931,1104,863,254,93,516,241,184,135,33,16,57,0,22,35,827,695,128,44,523,132,89,43,5,41,43,0,0,43,23602
7230,2194,161,377,1011,494,151,205,166,73,0,0,73,93,93,89,0,4,0,0,0,0,39,29,9,0,20,10,10,0,0,10,0,0,0,0,23603
7231,2456,0,582,1498,309,67,1370,1140,85,23,0,62,1055,1040,1040,0,0,15,15,0,0,230,91,38,1,52,139,139,94,0,45,0,0,0,0,23604
7232,8940,1412,3280,3216,697,335,699,366,293,73,18,202,73,46,46,0,0,27,0,10,17,333,281,47,48,186,52,43,0,43,0,9,0,0,9,23605
7233,17121,2022,3702,5531,3386,2480,2880,1205,1084,160,41,883,121,70,53,17,0,51,51,0,0,1675,1573,393,263,917,102,73,14,21,38,29,0,0,29,23606
7234,13927,2973,5498,3948,997,511,1582,889,622,199,11,412,267,190,21,92,77,77,0,25,52,693,561,159,124,278,132,103,83,5,15,29,7,0,22,23607
7235,26940,2306,7717,11135,4387,1395,2375,1104,1058,260,170,628,46,39,22,0,17,7,0,0,7,1271,1034,330,140,564,237,159,96,5,58,78,0,0,78,23608
7236,469,0,103,118,153,95,20,20,20,20,0,0,0,0,0,0,0,0,0,0,0,0,0,0,0,0,0,0,0,0,0,0,0,0,0,23651
7237,9725,1335,2965,3605,1065,755,589,270,183,19,29,135,87,68,18,10,40,19,17,0,2,319,233,37,18,178,86,46,20,9,17,40,0,0,40,23661
7238,8304,607,1970,2653,1830,1244,769,438,394,102,24,268,44,44,28,0,16,0,0,0,0,331,327,78,2,247,4,4,4,0,0,0,0,0,0,23662
7239,9321,1637,2769,3641,914,360,1152,698,574,102,81,391,124,124,80,44,0,0,0,0,0,454,326,102,17,207,128,128,12,55,61,0,0,0,0,23663
7240,6586,606,1524,2472,1139,845,628,235,147,16,26,105,88,80,60,11,9,8,0,8,0,393,294,66,36,192,99,57,48,9,0,42,0,0,42,23664
7241,2251,32,363,1188,464,204,350,186,71,11,0,60,115,115,80,0,35,0,0,0,0,164,63,0,0,63,101,101,52,0,49,0,0,0,0,23665
7242,33434,2829,8914,13674,5067,2950,1870,1151,1033,266,75,692,118,90,10,50,30,28,0,4,24,719,669,134,91,444,50,26,14,0,12,24,0,0,24,23666
7243,26672,2886,7513,10358,3748,2167,3518,1445,1260,169,71,1020,185,134,14,73,47,51,8,0,43,2073,1944,182,116,1646,129,94,88,0,6,35,11,6,18,23669
7244,2068,233,490,825,353,167,248,190,82,15,10,57,108,104,104,0,0,4,0,0,4,58,58,0,0,58,0,0,0,0,0,0,0,0,0,23690
7245,84,0,60,18,6,0,0,0,0,0,0,0,0,0,0,0,0,0,0,0,0,0,0,0,0,0,0,0,0,0,0,0,0,0,0,23691
7246,13214,703,2827,4511,2718,2455,1023,448,413,25,31,357,35,35,18,0,17,0,0,0,0,575,566,128,23,415,9,9,9,0,0,0,0,0,0,23692
7247,15668,534,2936,4479,4109,3610,1740,985,940,231,22,687,45,45,16,0,29,0,0,0,0,755,687,207,38,442,68,58,58,0,0,10,0,0,10,23693
7248,2568,162,718,699,610,379,172,92,84,7,0,77,8,8,8,0,0,0,0,0,0,80,80,22,0,58,0,0,0,0,0,0,0,0,0,23696
7249,16961,3009,5904,5064,2065,919,1094,553,420,143,54,223,133,60,40,0,20,73,0,0,73,541,385,102,38,245,156,156,87,0,69,0,0,0,0,23701
7250,7229,1694,2666,2235,497,137,619,354,259,49,49,161,95,95,38,30,27,0,0,0,0,265,198,39,11,148,67,53,21,0,32,14,0,14,0,23702
7251,17446,1752,4288,6634,3096,1676,1408,789,597,161,120,316,192,131,93,35,3,61,0,0,61,619,581,136,115,330,38,38,38,0,0,0,0,0,0,23703
7252,11808,2993,3243,3478,1205,889,1062,511,315,48,61,206,196,118,41,18,59,78,0,38,40,551,383,33,12,338,168,89,86,0,3,79,19,23,37,23704
7253,9525,1633,2776,3301,1049,766,571,341,260,16,55,189,81,65,36,29,0,16,0,0,16,230,207,50,77,80,23,23,18,0,5,0,0,0,0,23707
7254,62,0,4,58,0,0,110,77,0,0,0,0,77,77,77,0,0,0,0,0,0,33,0,0,0,0,33,33,33,0,0,0,0,0,0,23708
7255,20,0,20,0,0,0,20,20,0,0,0,0,20,20,20,0,0,0,0,0,0,0,0,0,0,0,0,0,0,0,0,0,0,0,0,23709
7256,2070,61,430,1035,430,114,674,288,204,115,17,72,84,84,46,3,35,0,0,0,0,386,244,10,31,203,142,135,105,0,30,7,0,0,7,23801
7257,26995,6819,9872,6945,2202,1157,2240,1045,835,80,93,662,210,133,90,8,35,77,17,0,60,1195,973,179,209,585,222,221,100,59,62,1,0,0,1,23803
7258,13670,2218,4964,3754,1850,884,872,470,358,9,79,270,112,81,36,0,45,31,9,0,22,402,245,51,73,121,157,73,73,0,0,84,0,0,84,23805
7259,15,0,6,0,9,0,1244,553,553,62,77,414,0,0,0,0,0,0,0,0,0,691,691,89,78,524,0,0,0,0,0,0,0,0,0,23806
7260,1178,282,394,391,52,59,37,25,21,0,0,21,4,4,4,0,0,0,0,0,0,12,8,6,0,2,4,0,0,0,0,4,0,4,0,23821
7261,5685,1469,2113,1309,441,353,284,156,156,64,0,92,0,0,0,0,0,0,0,0,0,128,110,73,16,21,18,7,0,0,7,11,0,11,0,23824
7262,1049,363,311,279,52,44,64,30,30,2,0,28,0,0,0,0,0,0,0,0,0,34,26,15,0,11,8,8,2,0,6,0,0,0,0,23827
7263,263,67,82,97,4,13,30,8,8,0,1,7,0,0,0,0,0,0,0,0,0,22,22,0,0,22,0,0,0,0,0,0,0,0,0,23828
7264,2124,701,811,403,142,67,28,22,2,0,0,2,20,13,0,5,8,7,0,0,7,6,6,3,0,3,0,0,0,0,0,0,0,0,0,23829
7265,825,154,401,241,18,11,58,14,14,0,0,14,0,0,0,0,0,0,0,0,0,44,44,44,0,0,0,0,0,0,0,0,0,0,0,23830
7266,21872,2179,6550,6370,4085,2688,2200,1079,970,247,25,698,109,97,58,13,26,12,0,0,12,1121,1044,255,51,738,77,77,34,20,23,0,0,0,0,23831
7267,21197,1869,5883,6322,4691,2432,1994,1015,903,321,82,500,112,68,51,0,17,44,0,30,14,979,848,256,82,510,131,101,94,0,7,30,9,0,21,23832
7268,1716,329,814,425,115,33,174,98,78,15,0,63,20,20,20,0,0,0,0,0,0,76,76,6,29,41,0,0,0,0,0,0,0,0,0,23833
7269,17265,2022,6192,5424,2303,1324,1829,1042,892,181,85,626,150,136,47,77,12,14,0,0,14,787,572,205,78,289,215,215,133,64,18,0,0,0,0,23834
7270,7687,781,1914,2264,1540,1188,726,277,227,45,0,182,50,50,50,0,0,0,0,0,0,449,449,18,97,334,0,0,0,0,0,0,0,0,0,23836
7271,3109,511,1094,989,355,160,166,124,116,26,0,90,8,8,1,7,0,0,0,0,0,42,33,5,0,28,9,0,0,0,0,9,0,0,9,23837
7272,11067,671,2970,3422,2445,1559,1070,557,489,136,90,263,68,68,14,54,0,0,0,0,0,513,468,159,26,283,45,45,45,0,0,0,0,0,0,23838
7273,580,33,236,249,56,6,58,39,39,4,7,28,0,0,0,0,0,0,0,0,0,19,19,2,10,7,0,0,0,0,0,0,0,0,0,23839
7274,1276,265,521,444,46,0,104,71,71,0,0,71,0,0,0,0,0,0,0,0,0,33,33,0,0,33,0,0,0,0,0,0,0,0,0,23840
7275,3005,456,1329,754,289,177,258,60,48,0,0,48,12,0,0,0,0,12,0,0,12,198,198,31,0,167,0,0,0,0,0,0,0,0,0,23841
7276,5305,891,1781,1620,692,321,331,169,157,29,26,102,12,10,5,0,5,2,0,0,2,162,131,0,58,73,31,31,31,0,0,0,0,0,0,23842
7277,424,109,150,122,34,9,21,0,0,0,0,0,0,0,0,0,0,0,0,0,0,21,11,0,0,11,10,10,0,10,0,0,0,0,0,23843
7278,509,186,118,119,58,28,58,28,12,0,12,0,16,0,0,0,0,16,0,0,16,30,30,0,0,30,0,0,0,0,0,0,0,0,0,23844
7279,191,12,77,36,54,12,9,0,0,0,0,0,0,0,0,0,0,0,0,0,0,9,9,0,0,9,0,0,0,0,0,0,0,0,0,23845
7280,430,84,139,130,31,46,17,12,5,0,0,5,7,7,0,7,0,0,0,0,0,5,5,0,0,5,0,0,0,0,0,0,0,0,0,23846
7281,11835,3463,4555,2660,633,524,525,375,218,35,33,150,157,89,75,11,3,68,0,0,68,150,130,8,0,122,20,18,18,0,0,2,0,0,2,23847
7282,427,76,261,71,19,0,43,13,0,0,0,0,13,13,0,13,0,0,0,0,0,30,10,3,7,0,20,6,0,6,0,14,0,0,14,23850
7283,9195,1890,2662,3070,1156,417,866,379,238,17,30,191,141,44,35,0,9,97,57,0,40,487,370,106,35,229,117,100,57,43,0,17,0,0,17,23851
7284,564,222,161,145,36,0,81,13,13,6,0,7,0,0,0,0,0,0,0,0,0,68,50,19,0,31,18,18,18,0,0,0,0,0,0,23856
7285,548,154,129,201,24,40,70,25,0,0,0,0,25,0,0,0,0,25,0,0,25,45,45,0,0,45,0,0,0,0,0,0,0,0,0,23857
7286,21645,4607,8411,6342,1461,824,1331,748,531,93,129,309,217,147,55,45,47,70,0,0,70,583,515,130,118,267,68,30,20,5,5,38,0,23,15,23860
7287,1505,287,472,514,143,89,136,76,76,0,52,24,0,0,0,0,0,0,0,0,0,60,60,25,0,35,0,0,0,0,0,0,0,0,0,23866
7288,1667,311,672,432,161,91,148,32,32,0,9,23,0,0,0,0,0,0,0,0,0,116,102,66,0,36,14,0,0,0,0,14,0,0,14,23867
7289,5218,1484,1751,1317,357,309,525,357,271,23,38,210,86,80,14,0,66,6,0,0,6,168,118,25,28,65,50,50,0,0,50,0,0,0,0,23868
7290,1634,359,626,376,169,104,59,42,28,0,0,28,14,0,0,0,0,14,0,0,14,17,15,0,0,15,2,2,2,0,0,0,0,0,0,23872
7291,685,138,206,221,58,62,10,5,5,0,0,5,0,0,0,0,0,0,0,0,0,5,5,0,0,5,0,0,0,0,0,0,0,0,0,23874
7292,7401,1140,2244,2620,860,537,514,304,273,105,37,131,31,24,20,0,4,7,7,0,0,210,200,119,53,28,10,0,0,0,0,10,0,0,10,23875
7293,379,72,49,81,121,56,28,28,28,0,0,28,0,0,0,0,0,0,0,0,0,0,0,0,0,0,0,0,0,0,0,0,0,0,0,23876
7294,834,103,344,248,108,31,104,78,29,0,0,29,49,5,0,5,0,44,0,0,44,26,26,0,0,26,0,0,0,0,0,0,0,0,0,23878
7295,411,51,183,115,35,27,96,56,56,0,0,56,0,0,0,0,0,0,0,0,0,40,0,0,0,0,40,40,9,0,31,0,0,0,0,23879
7296,1342,466,357,344,156,19,29,4,0,0,0,0,4,4,0,4,0,0,0,0,0,25,25,25,0,0,0,0,0,0,0,0,0,0,0,23881
7297,1413,269,525,377,186,56,61,25,25,0,0,25,0,0,0,0,0,0,0,0,0,36,36,6,0,30,0,0,0,0,0,0,0,0,0,23882
7298,2080,398,606,592,322,162,171,116,106,56,3,47,10,10,10,0,0,0,0,0,0,55,53,18,0,35,2,2,2,0,0,0,0,0,0,23883
7299,86,8,27,43,8,0,0,0,0,0,0,0,0,0,0,0,0,0,0,0,0,0,0,0,0,0,0,0,0,0,0,0,0,0,0,23884
7300,1937,293,844,514,185,101,166,121,100,20,30,50,21,9,9,0,0,12,0,0,12,45,45,22,8,15,0,0,0,0,0,0,0,0,0,23885
7301,273,82,65,88,18,20,0,0,0,0,0,0,0,0,0,0,0,0,0,0,0,0,0,0,0,0,0,0,0,0,0,0,0,0,0,23887
7302,1307,279,434,397,133,64,190,117,108,25,0,83,9,0,0,0,0,9,9,0,0,73,46,16,0,30,27,27,0,0,27,0,0,0,0,23888
7303,313,196,94,16,7,0,0,0,0,0,0,0,0,0,0,0,0,0,0,0,0,0,0,0,0,0,0,0,0,0,0,0,0,0,0,23889
7304,3549,1234,1306,689,197,123,142,131,99,23,8,68,32,7,0,7,0,25,0,0,25,11,8,2,2,4,3,3,0,3,0,0,0,0,0,23890
7305,1891,624,899,322,17,29,7,7,0,0,0,0,7,0,0,0,0,7,0,0,7,0,0,0,0,0,0,0,0,0,0,0,0,0,0,23891
7306,212,27,123,46,16,0,0,0,0,0,0,0,0,0,0,0,0,0,0,0,0,0,0,0,0,0,0,0,0,0,0,0,0,0,0,23893
7307,344,34,141,72,97,0,0,0,0,0,0,0,0,0,0,0,0,0,0,0,0,0,0,0,0,0,0,0,0,0,0,0,0,0,0,23894
7308,450,107,89,151,19,84,5,5,5,0,0,5,0,0,0,0,0,0,0,0,0,0,0,0,0,0,0,0,0,0,0,0,0,0,0,23897
7309,1839,383,733,498,163,62,120,52,18,18,0,0,34,34,21,13,0,0,0,0,0,68,68,8,11,49,0,0,0,0,0,0,0,0,0,23898
7310,285,65,115,70,6,29,23,16,16,8,0,8,0,0,0,0,0,0,0,0,0,7,7,0,0,7,0,0,0,0,0,0,0,0,0,23899
7311,9817,2152,3544,1793,1320,1008,1459,715,671,98,16,557,44,29,0,20,9,15,0,0,15,744,673,130,26,517,71,46,46,0,0,25,11,0,14,23901
7312,18,0,15,3,0,0,1286,350,350,125,0,225,0,0,0,0,0,0,0,0,0,936,936,229,14,693,0,0,0,0,0,0,0,0,0,23909
7313,668,229,271,120,12,36,20,6,0,0,0,0,6,0,0,0,0,6,0,0,6,14,0,0,0,0,14,14,14,0,0,0,0,0,0,23915
7314,2749,870,902,680,196,101,96,40,4,1,0,3,36,0,0,0,0,36,0,0,36,56,56,0,0,56,0,0,0,0,0,0,0,0,0,23917
7315,1988,315,523,883,122,145,99,30,30,8,0,22,0,0,0,0,0,0,0,0,0,69,69,0,5,64,0,0,0,0,0,0,0,0,0,23919
7316,2701,781,896,727,159,138,296,259,259,0,0,259,0,0,0,0,0,0,0,0,0,37,37,11,0,26,0,0,0,0,0,0,0,0,0,23920
7317,1201,345,292,256,173,135,54,47,47,0,0,47,0,0,0,0,0,0,0,0,0,7,0,0,0,0,7,7,0,0,7,0,0,0,0,23921
7318,1873,562,798,382,71,60,88,41,37,0,0,37,4,4,0,0,4,0,0,0,0,47,0,0,0,0,47,0,0,0,0,47,0,0,47,23922
7319,1582,451,462,490,81,98,72,28,15,0,0,15,13,0,0,0,0,13,0,11,2,44,23,9,0,14,21,21,21,0,0,0,0,0,0,23923
7320,4739,1128,1980,1264,201,166,313,198,133,18,3,112,65,65,32,23,10,0,0,0,0,115,103,72,0,31,12,12,5,3,4,0,0,0,0,23924
7321,3252,353,1184,996,433,286,159,76,40,10,7,23,36,36,36,0,0,0,0,0,0,83,81,60,0,21,2,2,2,0,0,0,0,0,0,23927
7322,4041,942,1572,1043,344,140,415,101,73,24,13,36,28,6,6,0,0,22,0,22,0,314,226,83,26,117,88,88,0,79,9,0,0,0,0,23930
7323,697,89,246,223,102,37,28,28,28,0,0,28,0,0,0,0,0,0,0,0,0,0,0,0,0,0,0,0,0,0,0,0,0,0,0,23934
7324,6972,2369,2517,1346,579,161,268,193,118,38,41,39,75,23,17,0,6,52,0,29,23,75,57,0,0,57,18,12,1,0,11,6,0,0,6,23936
7325,1519,448,476,398,120,77,164,58,58,6,0,52,0,0,0,0,0,0,0,0,0,106,99,0,5,94,7,7,1,0,6,0,0,0,0,23937
7326,236,55,82,50,49,0,0,0,0,0,0,0,0,0,0,0,0,0,0,0,0,0,0,0,0,0,0,0,0,0,0,0,0,0,0,23938
7327,829,206,249,230,49,95,121,112,62,0,7,55,50,50,50,0,0,0,0,0,0,9,0,0,0,0,9,9,0,9,0,0,0,0,0,23942
7328,41,0,13,0,14,14,71,71,71,34,0,37,0,0,0,0,0,0,0,0,0,0,0,0,0,0,0,0,0,0,0,0,0,0,0,23943
7329,2868,887,798,764,290,129,261,82,34,9,0,25,48,39,22,5,12,9,0,0,9,179,135,24,5,106,44,32,32,0,0,12,0,0,12,23944
7330,2386,456,864,495,400,171,214,147,128,25,29,74,19,19,0,19,0,0,0,0,0,67,55,2,0,53,12,12,0,12,0,0,0,0,0,23947
7331,2240,668,908,474,129,61,154,101,86,6,4,76,15,15,0,15,0,0,0,0,0,53,35,3,0,32,18,18,0,18,0,0,0,0,0,23950
7332,118,0,64,54,0,0,19,19,19,0,0,19,0,0,0,0,0,0,0,0,0,0,0,0,0,0,0,0,0,0,0,0,0,0,0,23952
7333,1505,310,598,371,134,92,148,63,63,0,0,63,0,0,0,0,0,0,0,0,0,85,56,13,0,43,29,29,0,0,29,0,0,0,0,23954
7334,2413,534,935,653,158,133,217,146,146,0,0,146,0,0,0,0,0,0,0,0,0,71,52,0,0,52,19,15,0,0,15,4,4,0,0,23958
7335,763,126,372,172,55,38,58,28,28,0,0,28,0,0,0,0,0,0,0,0,0,30,30,0,4,26,0,0,0,0,0,0,0,0,0,23959
7336,1371,337,492,422,101,19,57,32,32,0,0,32,0,0,0,0,0,0,0,0,0,25,25,0,0,25,0,0,0,0,0,0,0,0,0,23960
7337,275,70,82,101,22,0,0,0,0,0,0,0,0,0,0,0,0,0,0,0,0,0,0,0,0,0,0,0,0,0,0,0,0,0,0,23962
7338,268,50,137,0,53,28,74,57,36,36,0,0,21,21,0,21,0,0,0,0,0,17,6,0,0,6,11,11,0,0,11,0,0,0,0,23963
7339,864,180,399,122,136,27,55,55,55,0,11,44,0,0,0,0,0,0,0,0,0,0,0,0,0,0,0,0,0,0,0,0,0,0,0,23964
7340,1363,378,439,281,127,138,133,44,0,0,0,0,44,1,0,0,1,43,0,0,43,89,89,0,0,89,0,0,0,0,0,0,0,0,0,23966
7341,821,260,290,183,32,56,68,21,21,10,0,11,0,0,0,0,0,0,0,0,0,47,47,0,0,47,0,0,0,0,0,0,0,0,0,23967
7342,623,120,204,197,74,28,25,17,9,0,0,9,8,8,8,0,0,0,0,0,0,8,8,0,0,8,0,0,0,0,0,0,0,0,0,23968
7343,6191,1606,1809,1700,638,438,464,316,240,3,10,227,76,57,57,0,0,19,8,0,11,148,128,46,0,82,20,10,0,0,10,10,0,0,10,23970
7344,4066,1404,1464,874,194,130,116,58,50,6,4,40,8,8,0,0,8,0,0,0,0,58,58,44,0,14,0,0,0,0,0,0,0,0,0,23974
7345,115,32,40,0,43,0,0,0,0,0,0,0,0,0,0,0,0,0,0,0,0,0,0,0,0,0,0,0,0,0,0,0,0,0,0,23976
7346,144,6,16,14,53,55,26,17,17,3,11,3,0,0,0,0,0,0,0,0,0,9,9,9,0,0,0,0,0,0,0,0,0,0,0,24011
7347,20468,4067,6728,5833,2728,1112,1093,662,508,34,67,407,154,145,69,68,8,9,0,0,9,431,257,69,8,180,174,144,127,17,0,30,15,0,15,24012
7348,5239,1309,2207,1387,195,141,378,176,160,28,4,128,16,14,14,0,0,2,2,0,0,202,91,26,8,57,111,18,0,0,18,93,2,0,91,24013
7349,12591,1594,2985,3912,2491,1609,626,411,348,103,20,225,63,63,40,0,23,0,0,0,0,215,194,104,0,90,21,0,0,0,0,21,10,0,11,24014
7350,11346,909,1975,3530,2998,1934,656,392,350,88,29,233,42,10,10,0,0,32,0,0,32,264,250,56,0,194,14,7,7,0,0,7,0,7,0,24015
7351,6316,1766,1871,1370,691,618,485,285,252,31,23,198,33,24,23,0,1,9,0,0,9,200,132,23,9,100,68,54,18,36,0,14,0,14,0,24016
7352,15174,3231,5760,4320,1245,618,1240,530,385,102,6,277,145,76,15,17,44,69,10,16,43,710,590,129,56,405,120,107,65,0,42,13,13,0,0,24017
7353,27183,1054,4726,8367,7982,5054,1489,773,721,187,33,501,52,38,38,0,0,14,0,14,0,716,694,260,83,351,22,22,22,0,0,0,0,0,0,24018
7354,18656,1915,5766,6106,3601,1268,1408,662,522,151,42,329,140,140,127,0,13,0,0,0,0,746,695,296,34,365,51,39,31,0,8,12,12,0,0,24019
7355,24,0,0,24,0,0,159,0,0,0,0,0,0,0,0,0,0,0,0,0,0,159,159,31,8,120,0,0,0,0,0,0,0,0,0,24020
7356,1994,449,764,595,122,64,44,17,0,0,0,0,17,17,17,0,0,0,0,0,0,27,11,0,11,0,16,0,0,0,0,16,0,0,16,24053
7357,4603,1149,1643,1454,268,89,333,165,130,14,15,101,35,35,35,0,0,0,0,0,0,168,168,62,0,106,0,0,0,0,0,0,0,0,0,24054
7358,9268,2468,3455,2770,432,143,505,171,109,52,0,57,62,62,10,38,14,0,0,0,0,334,281,76,31,174,53,46,0,43,3,7,0,0,7,24055
7359,365,51,104,140,70,0,0,0,0,0,0,0,0,0,0,0,0,0,0,0,0,0,0,0,0,0,0,0,0,0,0,0,0,0,0,24058
7360,506,12,141,88,155,110,48,18,18,0,0,18,0,0,0,0,0,0,0,0,0,30,30,14,0,16,0,0,0,0,0,0,0,0,0,24059
7361,21900,1631,3264,3740,5225,8040,9790,5854,5830,780,317,4733,24,1,0,0,1,23,0,23,0,3936,3890,768,301,2821,46,46,19,0,27,0,0,0,0,24060
7362,3283,428,1283,891,484,197,202,52,52,12,0,40,0,0,0,0,0,0,0,0,0,150,113,69,0,44,37,37,21,16,0,0,0,0,0,24064
7363,4422,861,1469,1338,481,273,273,111,69,21,12,36,42,25,0,0,25,17,16,0,1,162,139,43,0,96,23,0,0,0,0,23,23,0,0,24065
7364,3204,435,1340,893,387,149,255,131,83,15,16,52,48,25,23,0,2,23,0,0,23,124,124,61,0,63,0,0,0,0,0,0,0,0,0,24066
7365,1742,337,662,410,268,65,211,31,20,0,0,20,11,11,11,0,0,0,0,0,0,180,158,21,0,137,22,22,22,0,0,0,0,0,0,24067
7366,1300,265,519,346,123,47,77,40,34,0,16,18,6,6,0,0,6,0,0,0,0,37,37,26,11,0,0,0,0,0,0,0,0,0,0,24069
7367,1020,59,353,452,127,29,128,28,14,14,0,0,14,14,0,0,14,0,0,0,0,100,100,27,0,73,0,0,0,0,0,0,0,0,0,24070
7368,974,122,338,429,72,13,81,21,21,21,0,0,0,0,0,0,0,0,0,0,0,60,41,17,14,10,19,19,19,0,0,0,0,0,0,24072
7369,20154,2034,5263,6186,4470,2201,1477,861,646,128,57,461,215,70,67,0,3,145,102,0,43,616,550,195,4,351,66,40,40,0,0,26,26,0,0,24073
7370,685,183,218,213,71,0,0,0,0,0,0,0,0,0,0,0,0,0,0,0,0,0,0,0,0,0,0,0,0,0,0,0,0,0,0,24076
7371,896,68,234,419,147,28,7,7,7,0,0,7,0,0,0,0,0,0,0,0,0,0,0,0,0,0,0,0,0,0,0,0,0,0,0,24077
7372,5356,1107,1723,1590,515,421,442,225,82,17,0,65,143,143,0,72,71,0,0,0,0,217,212,49,54,109,5,5,5,0,0,0,0,0,0,24078
7373,1411,341,607,357,72,34,120,73,73,0,58,15,0,0,0,0,0,0,0,0,0,47,47,0,0,47,0,0,0,0,0,0,0,0,0,24079
7374,342,0,147,132,50,13,33,33,12,0,0,12,21,21,0,21,0,0,0,0,0,0,0,0,0,0,0,0,0,0,0,0,0,0,0,24082
7375,1606,75,414,642,356,119,133,103,92,0,44,48,11,11,0,11,0,0,0,0,0,30,30,0,0,30,0,0,0,0,0,0,0,0,0,24083
7376,8328,1407,2963,2683,912,363,371,192,134,44,19,71,58,32,10,0,22,26,0,0,26,179,147,39,0,108,32,32,0,6,26,0,0,0,0,24084
7377,1484,226,714,330,122,92,44,34,22,0,0,22,12,0,0,0,0,12,0,0,12,10,10,0,0,10,0,0,0,0,0,0,0,0,0,24085
7378,116,43,17,32,12,12,0,0,0,0,0,0,0,0,0,0,0,0,0,0,0,0,0,0,0,0,0,0,0,0,0,0,0,0,0,24086
7379,3172,659,1307,778,287,141,236,115,101,19,4,78,14,14,14,0,0,0,0,0,0,121,120,44,30,46,1,1,1,0,0,0,0,0,0,24087
7380,2726,573,1049,742,238,124,855,444,420,108,88,224,24,12,0,12,0,12,0,0,12,411,380,200,48,132,31,24,24,0,0,7,7,0,0,24088
7381,2215,529,706,674,187,119,212,146,131,0,29,102,15,15,0,15,0,0,0,0,0,66,54,10,0,44,12,12,12,0,0,0,0,0,0,24089
7382,3652,383,1071,1043,799,356,207,60,60,32,2,26,0,0,0,0,0,0,0,0,0,147,147,24,0,123,0,0,0,0,0,0,0,0,0,24090
7383,4552,830,1347,1382,701,292,346,77,55,0,0,55,22,22,22,0,0,0,0,0,0,269,265,77,43,145,4,0,0,0,0,4,0,0,4,24091
7384,2330,735,760,599,193,43,189,102,81,0,0,81,21,21,0,0,21,0,0,0,0,87,76,10,0,66,11,0,0,0,0,11,0,0,11,24092
7385,134,6,61,65,2,0,3,3,3,0,0,3,0,0,0,0,0,0,0,0,0,0,0,0,0,0,0,0,0,0,0,0,0,0,0,24093
7386,2990,749,1107,834,216,84,219,144,121,55,0,66,23,23,23,0,0,0,0,0,0,75,75,47,0,28,0,0,0,0,0,0,0,0,0,24095
7387,4870,546,1717,1548,786,273,323,252,229,47,25,157,23,14,0,0,14,9,9,0,0,71,55,16,0,39,16,16,0,16,0,0,0,0,0,24101
7388,1203,236,467,400,45,55,150,67,52,6,26,20,15,15,7,8,0,0,0,0,0,83,68,46,0,22,15,4,0,4,0,11,11,0,0,24102
7389,2874,290,1067,968,371,178,84,29,0,0,0,0,29,9,9,0,0,20,0,0,20,55,55,12,25,18,0,0,0,0,0,0,0,0,0,24104
7390,707,164,423,50,53,17,69,11,0,0,0,0,11,11,0,0,11,0,0,0,0,58,58,0,0,58,0,0,0,0,0,0,0,0,0,24105
7391,23517,5213,7410,7523,2225,1146,1338,619,488,70,69,349,131,98,63,18,17,33,0,0,33,719,522,136,140,246,197,166,166,0,0,31,0,31,0,24112
7392,1377,320,328,536,154,39,58,29,29,29,0,0,0,0,0,0,0,0,0,0,0,29,29,10,0,19,0,0,0,0,0,0,0,0,0,24120
7393,7554,914,2199,2291,1347,803,250,65,46,0,46,0,19,19,19,0,0,0,0,0,0,185,153,86,0,67,32,32,32,0,0,0,0,0,0,24121
7394,1546,265,636,529,72,44,28,12,12,0,0,12,0,0,0,0,0,0,0,0,0,16,16,0,0,16,0,0,0,0,0,0,0,0,0,24122
7395,2955,573,1251,893,184,54,143,82,76,21,0,55,6,6,6,0,0,0,0,0,0,61,61,5,4,52,0,0,0,0,0,0,0,0,0,24124
7396,3040,308,1306,925,351,150,171,56,54,7,0,47,2,1,0,0,1,1,0,0,1,115,55,48,0,7,60,60,60,0,0,0,0,0,0,24127
7397,1351,204,416,288,224,219,50,18,10,10,0,0,8,8,8,0,0,0,0,0,0,32,32,7,10,15,0,0,0,0,0,0,0,0,0,24128
7398,0,0,0,0,0,0,0,0,0,0,0,0,0,0,0,0,0,0,0,0,0,0,0,0,0,0,0,0,0,0,0,0,0,0,0,24130
7399,31,0,17,14,0,0,0,0,0,0,0,0,0,0,0,0,0,0,0,0,0,0,0,0,0,0,0,0,0,0,0,0,0,0,0,24131
7400,282,47,100,74,61,0,0,0,0,0,0,0,0,0,0,0,0,0,0,0,0,0,0,0,0,0,0,0,0,0,0,0,0,0,0,24132
7401,1772,442,607,523,122,78,169,26,26,26,0,0,0,0,0,0,0,0,0,0,0,143,143,16,12,115,0,0,0,0,0,0,0,0,0,24133
7402,3820,928,1222,912,502,256,293,146,93,0,0,93,53,53,48,0,5,0,0,0,0,147,105,8,0,97,42,18,18,0,0,24,0,0,24,24134
7403,2479,390,963,659,273,194,167,84,45,37,0,8,39,30,27,3,0,9,9,0,0,83,70,34,1,35,13,0,0,0,0,13,0,0,13,24136
7404,2100,308,672,686,303,131,101,36,23,9,0,14,13,13,13,0,0,0,0,0,0,65,47,0,0,47,18,18,0,0,18,0,0,0,0,24137
7405,1186,35,458,328,296,69,134,96,76,61,15,0,20,0,0,0,0,20,20,0,0,38,38,38,0,0,0,0,0,0,0,0,0,0,0,24138
7406,599,303,198,80,18,0,9,0,0,0,0,0,0,0,0,0,0,0,0,0,0,9,9,0,0,9,0,0,0,0,0,0,0,0,0,24139
7407,12318,1704,3239,4081,1876,1418,1142,593,533,178,37,318,60,14,14,0,0,46,46,0,0,549,537,146,27,364,12,12,0,0,12,0,0,0,0,24141
7408,38,0,0,22,5,11,2134,835,835,96,15,724,0,0,0,0,0,0,0,0,0,1299,1299,240,133,926,0,0,0,0,0,0,0,0,0,24142
7409,948,104,393,382,34,35,34,11,6,4,0,2,5,5,0,5,0,0,0,0,0,23,21,2,0,19,2,2,0,0,2,0,0,0,0,24147
7410,5720,1030,2156,1966,402,166,325,202,145,17,30,98,57,57,39,0,18,0,0,0,0,123,109,39,13,57,14,14,14,0,0,0,0,0,0,24148
7411,2479,323,701,739,355,361,189,182,168,0,14,154,14,14,0,0,14,0,0,0,0,7,0,0,0,0,7,7,0,0,7,0,0,0,0,24149
7412,605,183,314,68,31,9,6,0,0,0,0,0,0,0,0,0,0,0,0,0,0,6,6,0,6,0,0,0,0,0,0,0,0,0,0,24150
7413,13264,2509,4550,4088,1391,726,830,396,321,68,41,212,75,47,25,22,0,28,0,0,28,434,290,109,27,154,144,144,45,12,87,0,0,0,0,24151
7414,25434,3001,7935,7282,4362,2854,2823,1211,1066,221,35,810,145,125,58,30,37,20,20,0,0,1612,1396,602,78,716,216,178,74,71,33,38,38,0,0,24153
7415,216,97,91,17,11,0,0,0,0,0,0,0,0,0,0,0,0,0,0,0,0,0,0,0,0,0,0,0,0,0,0,0,0,0,0,24161
7416,1576,362,491,533,90,100,38,8,8,0,0,8,0,0,0,0,0,0,0,0,0,30,22,22,0,0,8,8,8,0,0,0,0,0,0,24162
7417,933,248,332,252,61,40,13,13,13,0,0,13,0,0,0,0,0,0,0,0,0,0,0,0,0,0,0,0,0,0,0,0,0,0,0,24165
7418,208,28,154,26,0,0,34,9,9,9,0,0,0,0,0,0,0,0,0,0,0,25,25,0,0,25,0,0,0,0,0,0,0,0,0,24167
7419,175,7,61,66,36,5,7,0,0,0,0,0,0,0,0,0,0,0,0,0,0,7,7,0,0,7,0,0,0,0,0,0,0,0,0,24168
7420,6061,1379,2170,1832,410,270,288,126,126,4,25,97,0,0,0,0,0,0,0,0,0,162,162,36,8,118,0,0,0,0,0,0,0,0,0,24171
7421,1996,482,850,482,144,38,34,34,29,0,0,29,5,5,0,0,5,0,0,0,0,0,0,0,0,0,0,0,0,0,0,0,0,0,0,24174
7422,7072,592,2279,2238,1372,591,549,345,345,219,11,115,0,0,0,0,0,0,0,0,0,204,133,23,39,71,71,71,51,0,20,0,0,0,0,24175
7423,1263,112,323,492,212,124,109,100,100,0,77,23,0,0,0,0,0,0,0,0,0,9,9,0,0,9,0,0,0,0,0,0,0,0,0,24176
7424,13171,1892,4693,4262,1690,634,882,480,321,85,18,218,159,59,18,8,33,100,43,39,18,402,361,99,21,241,41,41,41,0,0,0,0,0,0,24179
7425,3545,662,1261,914,457,251,130,84,65,37,14,14,19,19,19,0,0,0,0,0,0,46,46,0,0,46,0,0,0,0,0,0,0,0,0,24184
7426,978,425,237,220,79,17,180,146,146,70,69,7,0,0,0,0,0,0,0,0,0,34,34,20,14,0,0,0,0,0,0,0,0,0,0,24185
7427,11890,2226,4037,3283,1591,753,877,476,432,65,47,320,44,22,0,7,15,22,20,0,2,401,378,126,23,229,23,8,0,0,8,15,9,0,6,24201
7428,9219,1344,3102,2910,1297,566,675,517,461,221,0,240,56,40,39,0,1,16,0,0,16,158,152,66,0,86,6,6,0,0,6,0,0,0,0,24202
7429,11969,2379,3709,3170,1572,1139,666,307,183,55,32,96,124,124,18,60,46,0,0,0,0,359,306,127,32,147,53,35,26,9,0,18,0,0,18,24210
7430,7818,931,2128,2038,1636,1085,347,203,196,46,14,136,7,7,7,0,0,0,0,0,0,144,144,9,8,127,0,0,0,0,0,0,0,0,0,24211
7431,1826,394,651,554,156,71,149,52,42,5,3,34,10,10,0,10,0,0,0,0,0,97,89,0,32,57,8,0,0,0,0,8,0,8,0,24216
7432,332,117,129,51,0,35,0,0,0,0,0,0,0,0,0,0,0,0,0,0,0,0,0,0,0,0,0,0,0,0,0,0,0,0,0,24217
7433,8327,2366,2465,2349,707,440,579,289,260,56,19,185,29,29,0,0,29,0,0,0,0,290,243,25,0,218,47,21,0,13,8,26,0,26,0,24219
7434,428,58,139,154,61,16,39,39,39,13,0,26,0,0,0,0,0,0,0,0,0,0,0,0,0,0,0,0,0,0,0,0,0,0,0,24220
7435,607,106,326,175,0,0,88,19,19,19,0,0,0,0,0,0,0,0,0,0,0,69,69,61,0,8,0,0,0,0,0,0,0,0,0,24221
7436,4830,1307,1961,1209,243,110,216,139,110,42,0,68,29,29,4,25,0,0,0,0,0,77,74,40,0,34,3,3,0,3,0,0,0,0,0,24224
7437,1406,391,590,294,93,38,57,33,33,0,0,33,0,0,0,0,0,0,0,0,0,24,9,1,0,8,15,12,6,6,0,3,3,0,0,24225
7438,1172,389,485,218,80,0,90,28,25,0,0,25,3,3,3,0,0,0,0,0,0,62,62,8,9,45,0,0,0,0,0,0,0,0,0,24226
7439,5170,1405,1733,1412,406,214,293,145,134,20,16,98,11,11,11,0,0,0,0,0,0,148,141,59,30,52,7,3,0,0,3,4,0,0,4,24228
7440,6108,1850,2220,1539,333,166,548,344,226,72,27,127,118,82,0,30,52,36,0,0,36,204,189,40,57,92,15,15,0,12,3,0,0,0,0,24230
7441,2628,515,1022,737,206,148,129,65,35,0,0,35,30,30,15,15,0,0,0,0,0,64,42,6,0,36,22,10,10,0,0,12,5,7,0,24236
7442,804,282,352,101,52,17,68,46,24,0,0,24,22,22,0,22,0,0,0,0,0,22,0,0,0,0,22,22,0,22,0,0,0,0,0,24237
7443,155,40,68,47,0,0,0,0,0,0,0,0,0,0,0,0,0,0,0,0,0,0,0,0,0,0,0,0,0,0,0,0,0,0,0,24239
7444,1774,324,546,662,181,61,121,75,75,0,18,57,0,0,0,0,0,0,0,0,0,46,46,40,0,6,0,0,0,0,0,0,0,0,0,24243
7445,4051,1339,1257,1191,174,90,239,106,76,0,0,76,30,30,0,0,30,0,0,0,0,133,133,87,0,46,0,0,0,0,0,0,0,0,0,24244
7446,786,233,300,150,49,54,63,48,36,0,0,36,12,12,0,0,12,0,0,0,0,15,15,0,0,15,0,0,0,0,0,0,0,0,0,24245
7447,322,117,54,151,0,0,20,0,0,0,0,0,0,0,0,0,0,0,0,0,0,20,0,0,0,0,20,0,0,0,0,20,0,0,20,24246
7448,1892,546,568,506,246,26,108,81,56,0,34,22,25,0,0,0,0,25,0,0,25,27,8,0,0,8,19,0,0,0,0,19,0,0,19,24248
7449,992,273,382,292,38,7,37,17,11,0,0,11,6,0,0,0,0,6,0,6,0,20,7,0,0,7,13,13,0,13,0,0,0,0,0,24250
7450,6141,1320,2522,1493,567,239,470,249,206,16,39,151,43,36,0,21,15,7,7,0,0,221,103,0,23,80,118,101,101,0,0,17,0,0,17,24251
7451,2489,794,824,687,93,91,134,20,18,0,0,18,2,2,2,0,0,0,0,0,0,114,114,25,19,70,0,0,0,0,0,0,0,0,0,24256
7452,1267,314,428,394,98,33,84,56,56,56,0,0,0,0,0,0,0,0,0,0,0,28,28,28,0,0,0,0,0,0,0,0,0,0,0,24258
7453,4454,1438,1714,1139,64,99,318,115,98,11,35,52,17,9,9,0,0,8,0,0,8,203,184,62,0,122,19,7,4,0,3,12,0,0,12,24260
7454,4638,1112,1457,1440,300,329,234,87,55,0,0,55,32,32,7,25,0,0,0,0,0,147,147,28,0,119,0,0,0,0,0,0,0,0,0,24263
7455,817,252,322,193,39,11,69,44,44,44,0,0,0,0,0,0,0,0,0,0,0,25,13,0,0,13,12,12,12,0,0,0,0,0,0,24265
7456,6386,1131,2167,1895,738,455,328,53,53,32,0,21,0,0,0,0,0,0,0,0,0,275,242,81,0,161,33,33,0,18,15,0,0,0,0,24266
7457,413,107,162,127,17,0,22,22,22,0,0,22,0,0,0,0,0,0,0,0,0,0,0,0,0,0,0,0,0,0,0,0,0,0,0,24269
7458,505,198,196,67,30,14,9,9,9,9,0,0,0,0,0,0,0,0,0,0,0,0,0,0,0,0,0,0,0,0,0,0,0,0,0,24270
7459,1875,427,731,518,127,72,97,63,55,2,11,42,8,8,0,0,8,0,0,0,0,34,34,0,0,34,0,0,0,0,0,0,0,0,0,24271
7460,221,47,43,56,18,57,0,0,0,0,0,0,0,0,0,0,0,0,0,0,0,0,0,0,0,0,0,0,0,0,0,0,0,0,0,24272
7461,4387,1003,1223,1509,477,175,439,202,166,72,0,94,36,28,0,0,28,8,0,8,0,237,191,66,24,101,46,25,25,0,0,21,0,21,0,24273
7462,4878,1311,1623,1450,309,185,275,161,161,0,31,130,0,0,0,0,0,0,0,0,0,114,102,52,0,50,12,0,0,0,0,12,0,12,0,24277
7463,4144,1319,1490,957,254,124,215,105,82,30,5,47,23,19,0,0,19,4,0,4,0,110,95,23,0,72,15,15,15,0,0,0,0,0,0,24279
7464,550,79,147,240,66,18,33,18,0,0,0,0,18,18,18,0,0,0,0,0,0,15,15,0,0,15,0,0,0,0,0,0,0,0,0,24280
7465,1864,534,764,315,209,42,70,64,64,0,10,54,0,0,0,0,0,0,0,0,0,6,6,0,6,0,0,0,0,0,0,0,0,0,0,24281
7466,483,183,126,162,0,12,17,12,0,0,0,0,12,3,0,0,3,9,0,5,4,5,5,0,0,5,0,0,0,0,0,0,0,0,0,24282
7467,1703,366,563,468,237,69,100,47,47,20,0,27,0,0,0,0,0,0,0,0,0,53,53,9,18,26,0,0,0,0,0,0,0,0,0,24283
7468,1790,369,723,379,194,125,46,26,19,5,7,7,7,2,0,0,2,5,5,0,0,20,6,0,0,6,14,14,0,14,0,0,0,0,0,24290
7469,493,166,227,80,20,0,24,24,23,0,0,23,1,0,0,0,0,1,1,0,0,0,0,0,0,0,0,0,0,0,0,0,0,0,0,24292
7470,6756,1390,2173,1868,738,587,717,282,257,66,31,160,25,25,0,25,0,0,0,0,0,435,421,92,78,251,14,14,14,0,0,0,0,0,0,24293
7471,10109,2323,3137,3342,966,341,730,418,333,105,36,192,85,65,43,8,14,20,0,0,20,312,220,49,0,171,92,92,46,10,36,0,0,0,0,24301
7472,1349,250,633,303,42,121,177,54,54,26,4,24,0,0,0,0,0,0,0,0,0,123,92,49,0,43,31,31,0,0,31,0,0,0,0,24311
7473,1501,393,492,469,84,63,42,20,20,0,0,20,0,0,0,0,0,0,0,0,0,22,14,0,14,0,8,0,0,0,0,8,8,0,0,24312
7474,762,148,306,269,39,0,85,68,44,0,0,44,24,24,0,24,0,0,0,0,0,17,17,0,0,17,0,0,0,0,0,0,0,0,0,24313
7475,1100,84,359,420,143,94,74,46,46,0,17,29,0,0,0,0,0,0,0,0,0,28,28,7,0,21,0,0,0,0,0,0,0,0,0,24314
7476,2977,584,1259,768,245,121,118,94,94,0,18,76,0,0,0,0,0,0,0,0,0,24,24,7,8,9,0,0,0,0,0,0,0,0,0,24315
7477,26,0,13,13,0,0,0,0,0,0,0,0,0,0,0,0,0,0,0,0,0,0,0,0,0,0,0,0,0,0,0,0,0,0,0,24316
7478,2994,904,865,867,287,71,247,95,58,10,0,48,37,37,37,0,0,0,0,0,0,152,145,0,12,133,7,7,7,0,0,0,0,0,0,24317
7479,656,79,232,221,64,60,4,4,4,4,0,0,0,0,0,0,0,0,0,0,0,0,0,0,0,0,0,0,0,0,0,0,0,0,0,24318
7480,4900,919,2085,1250,485,161,250,111,71,15,0,56,40,40,34,6,0,0,0,0,0,139,127,5,20,102,12,12,1,11,0,0,0,0,0,24319
7481,171,34,58,68,0,11,7,0,0,0,0,0,0,0,0,0,0,0,0,0,0,7,7,0,0,7,0,0,0,0,0,0,0,0,0,24322
7482,481,95,261,98,27,0,34,0,0,0,0,0,0,0,0,0,0,0,0,0,0,34,34,23,11,0,0,0,0,0,0,0,0,0,0,24323
7483,1637,234,509,557,246,91,70,0,0,0,0,0,0,0,0,0,0,0,0,0,0,70,61,0,0,61,9,9,0,0,9,0,0,0,0,24324
7484,915,285,273,238,88,31,28,21,21,11,0,10,0,0,0,0,0,0,0,0,0,7,0,0,0,0,7,7,7,0,0,0,0,0,0,24325
7485,687,52,234,200,147,54,116,69,15,0,0,15,54,54,0,54,0,0,0,0,0,47,47,0,0,47,0,0,0,0,0,0,0,0,0,24326
7486,1236,149,190,556,265,76,80,0,0,0,0,0,0,0,0,0,0,0,0,0,0,80,70,0,18,52,10,0,0,0,0,10,10,0,0,24328
7487,2687,896,836,767,93,95,92,38,21,0,0,21,17,17,0,17,0,0,0,0,0,54,54,13,7,34,0,0,0,0,0,0,0,0,0,24330
7488,12981,3073,4591,3574,1162,581,889,516,453,156,0,297,63,41,31,10,0,22,0,22,0,373,323,69,43,211,50,45,13,19,13,5,0,0,5,24333
7489,3754,504,1261,1319,475,195,364,178,171,65,7,99,7,7,0,0,7,0,0,0,0,186,176,29,25,122,10,10,0,0,10,0,0,0,0,24340
7490,6515,1304,2528,1923,505,255,268,102,95,40,0,55,7,0,0,0,0,7,0,0,7,166,97,25,31,41,69,64,55,0,9,5,0,0,5,24343
7491,1182,200,503,340,77,62,138,79,57,13,14,30,22,22,22,0,0,0,0,0,0,59,53,22,21,10,6,6,0,6,0,0,0,0,0,24347
7492,3073,675,1087,924,304,83,210,146,131,4,0,127,15,13,0,0,13,2,0,0,2,64,64,27,0,37,0,0,0,0,0,0,0,0,0,24348
7493,630,196,246,129,11,48,56,41,0,0,0,0,41,41,29,12,0,0,0,0,0,15,6,0,0,6,9,9,0,0,9,0,0,0,0,24350
7494,442,169,97,140,14,22,33,20,20,0,0,20,0,0,0,0,0,0,0,0,0,13,0,0,0,0,13,13,6,7,0,0,0,0,0,24351
7495,844,288,331,134,32,59,0,0,0,0,0,0,0,0,0,0,0,0,0,0,0,0,0,0,0,0,0,0,0,0,0,0,0,0,0,24352
7496,11192,2085,4348,3025,1095,639,748,410,345,163,42,140,65,27,0,27,0,38,23,10,5,338,199,0,0,199,139,125,83,9,33,14,6,0,8,24354
7497,4691,721,1897,1432,507,134,240,166,166,48,0,118,0,0,0,0,0,0,0,0,0,74,63,51,0,12,11,11,0,11,0,0,0,0,0,24360
7498,3459,705,1472,807,244,231,594,169,169,49,3,117,0,0,0,0,0,0,0,0,0,425,399,115,34,250,26,26,12,0,14,0,0,0,0,24361
7499,946,226,342,268,68,42,39,5,5,0,0,5,0,0,0,0,0,0,0,0,0,34,34,34,0,0,0,0,0,0,0,0,0,0,0,24363
7500,403,59,130,115,77,22,8,8,8,0,0,8,0,0,0,0,0,0,0,0,0,0,0,0,0,0,0,0,0,0,0,0,0,0,0,24366
7501,3366,539,1179,1265,219,164,231,103,80,13,5,62,23,23,23,0,0,0,0,0,0,128,121,59,10,52,7,4,4,0,0,3,0,0,3,24368
7502,4517,1072,1608,1079,430,328,265,139,101,37,14,50,38,38,24,4,10,0,0,0,0,126,102,18,0,84,24,24,24,0,0,0,0,0,0,24370
7503,748,127,313,207,24,77,39,16,16,16,0,0,0,0,0,0,0,0,0,0,0,23,6,6,0,0,17,17,17,0,0,0,0,0,0,24374
7504,1146,342,434,224,103,43,82,82,82,20,0,62,0,0,0,0,0,0,0,0,0,0,0,0,0,0,0,0,0,0,0,0,0,0,0,24375
7505,188,43,59,53,24,9,37,37,11,0,0,11,26,26,26,0,0,0,0,0,0,0,0,0,0,0,0,0,0,0,0,0,0,0,0,24377
7506,1090,274,390,284,108,34,59,15,15,0,0,15,0,0,0,0,0,0,0,0,0,44,44,0,0,44,0,0,0,0,0,0,0,0,0,24378
7507,1940,424,845,531,122,18,77,77,77,0,0,77,0,0,0,0,0,0,0,0,0,0,0,0,0,0,0,0,0,0,0,0,0,0,0,24380
7508,2506,548,997,745,153,63,193,155,103,0,0,103,52,52,17,0,35,0,0,0,0,38,28,8,0,20,10,10,0,0,10,0,0,0,0,24381
7509,10122,2009,3290,2971,1211,641,603,255,213,84,14,115,42,14,14,0,0,28,9,0,19,348,320,114,37,169,28,17,0,0,17,11,11,0,0,24382
7510,25192,3816,8452,6390,4195,2339,1993,732,552,137,69,346,180,116,73,0,43,64,0,0,64,1261,1099,395,31,673,162,162,42,16,104,0,0,0,0,24401
7511,55,0,55,0,0,0,0,0,0,0,0,0,0,0,0,0,0,0,0,0,0,0,0,0,0,0,0,0,0,0,0,0,0,0,0,24411
7512,97,0,59,11,17,10,0,0,0,0,0,0,0,0,0,0,0,0,0,0,0,0,0,0,0,0,0,0,0,0,0,0,0,0,0,24412
7513,134,32,36,26,19,21,0,0,0,0,0,0,0,0,0,0,0,0,0,0,0,0,0,0,0,0,0,0,0,0,0,0,0,0,0,24413
7514,57,15,15,0,27,0,0,0,0,0,0,0,0,0,0,0,0,0,0,0,0,0,0,0,0,0,0,0,0,0,0,0,0,0,0,24415
7515,5765,1223,2387,1392,455,308,671,336,301,100,2,199,35,35,24,0,11,0,0,0,0,335,305,129,24,152,30,0,0,0,0,30,0,20,10,24416
7516,2564,407,1167,555,312,123,202,75,75,28,17,30,0,0,0,0,0,0,0,0,0,127,127,69,0,58,0,0,0,0,0,0,0,0,0,24421
7517,4851,812,1801,1444,454,340,256,101,101,31,12,58,0,0,0,0,0,0,0,0,0,155,93,35,0,58,62,14,12,0,2,48,0,0,48,24422
7518,9947,1662,3794,3133,786,572,715,411,313,42,19,252,98,74,28,33,13,24,6,12,6,304,286,139,24,123,18,18,0,0,18,0,0,0,0,24426
7519,3791,1336,1757,602,67,29,92,44,13,0,0,13,31,14,14,0,0,17,6,0,11,48,48,5,0,43,0,0,0,0,0,0,0,0,0,24430
7520,1731,451,989,184,87,20,188,106,68,22,0,46,38,17,17,0,0,21,0,21,0,82,82,35,0,47,0,0,0,0,0,0,0,0,0,24431
7521,220,16,92,75,29,8,33,0,0,0,0,0,0,0,0,0,0,0,0,0,0,33,33,16,0,17,0,0,0,0,0,0,0,0,0,24432
7522,80,26,47,7,0,0,0,0,0,0,0,0,0,0,0,0,0,0,0,0,0,0,0,0,0,0,0,0,0,0,0,0,0,0,0,24433
7523,1689,172,562,400,308,247,84,61,61,0,0,61,0,0,0,0,0,0,0,0,0,23,8,0,0,8,15,15,0,0,15,0,0,0,0,24435
7524,936,43,238,250,184,221,38,38,38,24,0,14,0,0,0,0,0,0,0,0,0,0,0,0,0,0,0,0,0,0,0,0,0,0,0,24437
7525,1164,331,503,268,31,31,21,12,9,0,0,9,3,3,0,3,0,0,0,0,0,9,9,5,0,4,0,0,0,0,0,0,0,0,0,24439
7526,1906,334,889,397,164,122,105,55,45,30,0,15,10,0,0,0,0,10,0,0,10,50,36,22,0,14,14,14,14,0,0,0,0,0,0,24440
7527,4608,903,2090,1136,294,185,320,244,228,94,5,129,16,0,0,0,0,16,10,0,6,76,65,0,14,51,11,11,0,11,0,0,0,0,0,24441
7528,86,13,46,13,14,0,22,3,0,0,0,0,3,3,0,0,3,0,0,0,0,19,19,0,0,19,0,0,0,0,0,0,0,0,0,24442
7529,1567,310,747,343,117,50,79,52,52,0,0,52,0,0,0,0,0,0,0,0,0,27,27,0,8,19,0,0,0,0,0,0,0,0,0,24445
7530,309,68,119,80,24,18,23,16,16,0,7,9,0,0,0,0,0,0,0,0,0,7,7,0,0,7,0,0,0,0,0,0,0,0,0,24448
7531,9544,1631,2903,1963,1603,1444,1915,1413,1222,155,4,1063,191,154,32,23,99,37,0,0,37,502,448,112,0,336,54,18,0,0,18,36,0,0,36,24450
7532,187,62,41,66,18,0,0,0,0,0,0,0,0,0,0,0,0,0,0,0,0,0,0,0,0,0,0,0,0,0,0,0,0,0,0,24457
7533,388,105,181,32,48,22,29,4,4,3,0,1,0,0,0,0,0,0,0,0,0,25,0,0,0,0,25,25,25,0,0,0,0,0,0,24458
7534,645,0,311,137,94,103,8,8,8,0,0,8,0,0,0,0,0,0,0,0,0,0,0,0,0,0,0,0,0,0,0,0,0,0,0,24459
7535,1314,31,444,436,219,184,0,0,0,0,0,0,0,0,0,0,0,0,0,0,0,0,0,0,0,0,0,0,0,0,0,0,0,0,0,24460
7536,201,84,45,21,51,0,0,0,0,0,0,0,0,0,0,0,0,0,0,0,0,0,0,0,0,0,0,0,0,0,0,0,0,0,0,24464
7537,1086,196,401,230,175,84,47,25,19,0,0,19,6,6,6,0,0,0,0,0,0,22,22,7,0,15,0,0,0,0,0,0,0,0,0,24465
7538,1450,353,329,372,333,63,69,58,31,10,0,21,27,10,0,10,0,17,17,0,0,11,11,0,0,11,0,0,0,0,0,0,0,0,0,24467
7539,898,114,429,92,214,49,18,18,18,0,0,18,0,0,0,0,0,0,0,0,0,0,0,0,0,0,0,0,0,0,0,0,0,0,0,24471
7540,1371,139,646,326,178,82,37,14,14,0,0,14,0,0,0,0,0,0,0,0,0,23,23,21,0,2,0,0,0,0,0,0,0,0,0,24472
7541,588,38,127,250,113,60,76,47,0,0,0,0,47,47,47,0,0,0,0,0,0,29,0,0,0,0,29,29,0,0,29,0,0,0,0,24473
7542,355,154,117,74,10,0,35,10,10,0,0,10,0,0,0,0,0,0,0,0,0,25,25,0,25,0,0,0,0,0,0,0,0,0,0,24474
7543,202,39,61,28,62,12,0,0,0,0,0,0,0,0,0,0,0,0,0,0,0,0,0,0,0,0,0,0,0,0,0,0,0,0,0,24476
7544,6967,585,3430,1713,775,464,347,213,191,49,10,132,22,22,22,0,0,0,0,0,0,134,60,37,23,0,74,64,32,32,0,10,0,0,10,24477
7545,917,86,353,188,173,117,103,84,53,15,0,38,31,31,31,0,0,0,0,0,0,19,19,19,0,0,0,0,0,0,0,0,0,0,0,24479
7546,3063,530,1381,634,310,208,280,153,87,31,0,56,66,56,18,0,38,10,0,0,10,127,127,11,27,89,0,0,0,0,0,0,0,0,0,24482
7547,571,57,302,130,82,0,9,0,0,0,0,0,0,0,0,0,0,0,0,0,0,9,9,9,0,0,0,0,0,0,0,0,0,0,0,24483
7548,683,63,236,264,21,99,36,0,0,0,0,0,0,0,0,0,0,0,0,0,0,36,36,0,0,36,0,0,0,0,0,0,0,0,0,24484
7549,200,30,105,54,11,0,0,0,0,0,0,0,0,0,0,0,0,0,0,0,0,0,0,0,0,0,0,0,0,0,0,0,0,0,0,24485
7550,2416,269,909,705,367,166,147,84,84,17,0,67,0,0,0,0,0,0,0,0,0,63,54,42,0,12,9,9,0,0,9,0,0,0,0,24486
7551,258,116,64,39,39,0,0,0,0,0,0,0,0,0,0,0,0,0,0,0,0,0,0,0,0,0,0,0,0,0,0,0,0,0,0,24487
7552,15242,3119,5305,4025,1748,1045,2429,1111,1085,227,152,706,26,17,0,0,17,9,0,0,9,1318,1222,250,134,838,96,92,21,20,51,4,0,4,0,24501
7553,24289,2452,6364,8506,4689,2278,4937,2400,2314,572,311,1431,86,75,32,10,33,11,0,0,11,2537,2371,588,208,1575,166,119,71,8,40,47,0,0,47,24502
7554,13004,547,1918,3192,4289,3058,1245,532,513,151,96,266,19,0,0,0,0,19,0,12,7,713,713,218,25,470,0,0,0,0,0,0,0,0,0,24503
7555,7048,1921,2536,1649,599,343,481,129,129,19,28,82,0,0,0,0,0,0,0,0,0,352,239,0,15,224,113,91,0,81,10,22,0,0,22,24504
7556,4109,761,1568,1093,484,203,189,94,94,0,0,94,0,0,0,0,0,0,0,0,0,95,70,14,0,56,25,25,25,0,0,0,0,0,0,24517
7557,1463,201,507,384,203,168,91,62,51,0,0,51,11,11,4,7,0,0,0,0,0,29,29,0,0,29,0,0,0,0,0,0,0,0,0,24520
7558,7668,1858,2509,2001,937,363,451,260,192,83,25,84,68,54,37,15,2,14,0,0,14,191,160,12,13,135,31,17,10,7,0,14,0,10,4,24521
7559,6931,1153,2697,1922,715,444,384,138,98,15,12,71,40,40,6,14,20,0,0,0,0,246,228,118,14,96,18,18,18,0,0,0,0,0,0,24522
7560,13600,2227,5057,3763,1761,792,850,308,260,44,55,161,48,37,29,0,8,11,11,0,0,542,412,149,26,237,130,130,55,75,0,0,0,0,0,24523
7561,977,169,425,274,69,40,115,50,40,0,0,40,10,10,10,0,0,0,0,0,0,65,65,26,0,39,0,0,0,0,0,0,0,0,0,24526
7562,2112,356,884,683,107,82,119,34,22,0,16,6,12,12,0,0,12,0,0,0,0,85,85,22,8,55,0,0,0,0,0,0,0,0,0,24527
7563,2544,621,941,716,164,102,136,86,67,4,0,63,19,19,0,0,19,0,0,0,0,50,50,20,0,30,0,0,0,0,0,0,0,0,0,24528
7564,1041,218,441,242,95,45,52,11,11,10,0,1,0,0,0,0,0,0,0,0,0,41,30,5,0,25,11,11,8,3,0,0,0,0,0,24529
7565,813,213,325,216,59,0,36,0,0,0,0,0,0,0,0,0,0,0,0,0,0,36,27,0,0,27,9,9,0,9,0,0,0,0,0,24530
7566,6778,1522,2188,1888,852,328,451,210,184,26,4,154,26,26,12,0,14,0,0,0,0,241,204,30,43,131,37,17,17,0,0,20,0,20,0,24531
7567,1200,313,450,376,51,10,12,12,12,0,0,12,0,0,0,0,0,0,0,0,0,0,0,0,0,0,0,0,0,0,0,0,0,0,0,24534
7568,122,27,85,10,0,0,0,0,0,0,0,0,0,0,0,0,0,0,0,0,0,0,0,0,0,0,0,0,0,0,0,0,0,0,0,24536
7569,3609,906,1263,991,277,172,202,136,89,0,0,89,47,47,0,0,47,0,0,0,0,66,65,39,0,26,1,0,0,0,0,1,0,0,1,24538
7570,61,20,9,18,7,7,0,0,0,0,0,0,0,0,0,0,0,0,0,0,0,0,0,0,0,0,0,0,0,0,0,0,0,0,0,24539
7571,22074,4465,7305,7116,2206,982,1259,678,581,113,50,418,97,46,28,7,11,51,26,25,0,581,544,78,132,334,37,37,35,0,2,0,0,0,0,24540
7572,19652,4087,5713,6040,2255,1557,1745,951,837,237,80,520,114,74,11,6,57,40,6,0,34,794,659,175,55,429,135,109,101,0,8,26,0,18,8,24541
7573,3173,415,1125,1154,326,153,254,168,150,14,0,136,18,18,18,0,0,0,0,0,0,86,77,35,0,42,9,9,0,0,9,0,0,0,0,24549
7574,5237,674,1686,2006,700,171,517,272,240,29,53,158,32,32,26,0,6,0,0,0,0,245,200,10,38,152,45,0,0,0,0,45,0,0,45,24550
7575,14743,751,3759,4413,3762,2058,1338,736,704,239,37,428,32,32,15,17,0,0,0,0,0,602,529,167,0,362,73,59,59,0,0,14,14,0,0,24551
7576,1615,394,706,360,117,38,166,99,99,0,0,99,0,0,0,0,0,0,0,0,0,67,42,0,0,42,25,25,0,0,25,0,0,0,0,24553
7577,2310,381,929,631,237,132,265,138,131,59,20,52,7,0,0,0,0,7,7,0,0,127,127,62,0,65,0,0,0,0,0,0,0,0,0,24554
7578,1656,304,621,426,190,115,104,31,0,0,0,0,31,9,9,0,0,22,0,0,22,73,61,4,0,57,12,2,2,0,0,10,0,10,0,24555
7579,2538,187,837,882,387,245,96,21,13,0,0,13,8,8,8,0,0,0,0,0,0,75,61,26,0,35,14,0,0,0,0,14,14,0,0,24556
7580,5563,1424,2001,1523,450,165,319,91,70,11,12,47,21,15,11,4,0,6,6,0,0,228,209,0,0,209,19,10,10,0,0,9,0,0,9,24557
7581,4702,1026,1528,1345,454,349,270,91,82,9,9,64,9,7,0,0,7,2,0,0,2,179,137,3,4,130,42,42,39,0,3,0,0,0,0,24558
7582,270,63,102,49,31,25,23,23,23,0,0,23,0,0,0,0,0,0,0,0,0,0,0,0,0,0,0,0,0,0,0,0,0,0,0,24562
7583,3800,984,1283,1074,339,120,256,134,123,32,2,89,11,11,0,9,2,0,0,0,0,122,109,5,0,104,13,4,0,4,0,9,9,0,0,24563
7584,735,177,341,126,62,29,88,55,55,14,15,26,0,0,0,0,0,0,0,0,0,33,33,0,0,33,0,0,0,0,0,0,0,0,0,24565
7585,1073,174,541,219,72,67,28,7,7,0,0,7,0,0,0,0,0,0,0,0,0,21,21,0,0,21,0,0,0,0,0,0,0,0,0,24566
7586,815,315,315,134,41,10,48,48,34,10,0,24,14,14,14,0,0,0,0,0,0,0,0,0,0,0,0,0,0,0,0,0,0,0,0,24569
7587,0,0,0,0,0,0,0,0,0,0,0,0,0,0,0,0,0,0,0,0,0,0,0,0,0,0,0,0,0,0,0,0,0,0,0,24570
7588,1492,338,573,430,117,34,51,21,21,19,2,0,0,0,0,0,0,0,0,0,0,30,20,6,0,14,10,10,0,10,0,0,0,0,0,24571
7589,11120,2084,4059,2973,1437,567,801,471,401,180,48,173,70,0,0,0,0,70,0,57,13,330,237,61,36,140,93,88,12,13,63,5,0,2,3,24572
7590,2738,447,1020,826,230,215,333,239,239,59,0,180,0,0,0,0,0,0,0,0,0,94,70,4,0,66,24,10,10,0,0,14,14,0,0,24574
7591,3504,986,1306,764,253,195,261,135,104,20,27,57,31,15,11,0,4,16,16,0,0,126,108,39,32,37,18,15,15,0,0,3,0,0,3,24577
7592,657,118,186,103,166,84,46,26,26,0,0,26,0,0,0,0,0,0,0,0,0,20,20,20,0,0,0,0,0,0,0,0,0,0,0,24578
7593,930,189,536,132,73,0,39,39,35,0,0,35,4,0,0,0,0,4,0,0,4,0,0,0,0,0,0,0,0,0,0,0,0,0,0,24579
7594,387,85,183,66,36,17,8,8,0,0,0,0,8,0,0,0,0,8,0,0,8,0,0,0,0,0,0,0,0,0,0,0,0,0,0,24580
7595,0,0,0,0,0,0,0,0,0,0,0,0,0,0,0,0,0,0,0,0,0,0,0,0,0,0,0,0,0,0,0,0,0,0,0,24581
7596,4203,936,1264,1400,413,190,300,80,36,0,14,22,44,9,0,0,9,35,0,0,35,220,205,85,0,120,15,15,15,0,0,0,0,0,0,24586
7597,6385,1082,2482,1924,625,272,412,191,159,43,0,116,32,32,32,0,0,0,0,0,0,221,103,90,8,5,118,69,33,0,36,49,0,0,49,24588
7598,1449,298,497,547,60,47,197,138,135,19,4,112,3,3,0,0,3,0,0,0,0,59,32,22,0,10,27,0,0,0,0,27,27,0,0,24589
7599,5461,1096,1983,1509,442,431,384,223,211,12,14,185,12,12,0,12,0,0,0,0,0,161,161,27,0,134,0,0,0,0,0,0,0,0,0,24590
7600,10109,1879,3676,2972,957,625,776,414,273,70,6,197,141,88,13,27,48,53,22,0,31,362,289,50,17,222,73,73,17,9,47,0,0,0,0,24592
7601,1262,64,582,425,178,13,119,75,48,0,0,48,27,27,0,0,27,0,0,0,0,44,44,0,0,44,0,0,0,0,0,0,0,0,0,24593
7602,1041,365,177,363,73,63,9,9,9,0,0,9,0,0,0,0,0,0,0,0,0,0,0,0,0,0,0,0,0,0,0,0,0,0,0,24594
7603,106,49,16,28,0,13,347,0,0,0,0,0,0,0,0,0,0,0,0,0,0,347,347,99,24,224,0,0,0,0,0,0,0,0,0,24595
7604,890,154,315,266,106,49,93,2,0,0,0,0,2,2,2,0,0,0,0,0,0,91,59,9,0,50,32,32,32,0,0,0,0,0,0,24597
7605,1618,255,593,499,175,96,65,7,2,0,0,2,5,5,0,0,5,0,0,0,0,58,58,6,0,52,0,0,0,0,0,0,0,0,0,24598
7606,274,32,58,74,49,61,0,0,0,0,0,0,0,0,0,0,0,0,0,0,0,0,0,0,0,0,0,0,0,0,0,0,0,0,0,24599
7607,27,13,14,0,0,0,0,0,0,0,0,0,0,0,0,0,0,0,0,0,0,0,0,0,0,0,0,0,0,0,0,0,0,0,0,24601
7608,799,323,276,127,67,6,35,35,24,24,0,0,11,0,0,0,0,11,0,11,0,0,0,0,0,0,0,0,0,0,0,0,0,0,0,24602
7609,980,300,337,258,56,29,110,78,78,65,0,13,0,0,0,0,0,0,0,0,0,32,22,0,0,22,10,10,0,0,10,0,0,0,0,24603
7610,323,235,70,18,0,0,29,21,15,15,0,0,6,0,0,0,0,6,0,0,6,8,0,0,0,0,8,0,0,0,0,8,0,0,8,24604
7611,6390,1128,2229,1918,670,445,343,236,227,29,21,177,9,9,9,0,0,0,0,0,0,107,107,45,8,54,0,0,0,0,0,0,0,0,0,24605
7612,337,144,97,72,9,15,12,0,0,0,0,0,0,0,0,0,0,0,0,0,0,12,12,12,0,0,0,0,0,0,0,0,0,0,0,24606
7613,264,80,123,61,0,0,26,26,26,0,26,0,0,0,0,0,0,0,0,0,0,0,0,0,0,0,0,0,0,0,0,0,0,0,0,24607
7614,5322,1165,1937,1744,212,264,326,189,139,38,4,97,50,50,42,8,0,0,0,0,0,137,98,4,0,94,39,29,0,0,29,10,0,0,10,24609
7615,126,30,63,33,0,0,12,5,5,5,0,0,0,0,0,0,0,0,0,0,0,7,7,7,0,0,0,0,0,0,0,0,0,0,0,24612
7616,354,106,99,70,72,7,0,0,0,0,0,0,0,0,0,0,0,0,0,0,0,0,0,0,0,0,0,0,0,0,0,0,0,0,0,24613
7617,5482,1467,1996,1399,368,252,371,229,212,50,33,129,17,9,0,7,2,8,0,0,8,142,125,22,29,74,17,14,0,8,6,3,0,0,3,24614
7618,2231,766,754,574,101,36,205,97,55,0,28,27,42,27,0,27,0,15,0,0,15,108,72,58,0,14,36,19,0,0,19,17,0,0,17,24620
7619,646,216,242,135,37,16,43,28,28,0,0,28,0,0,0,0,0,0,0,0,0,15,15,6,0,9,0,0,0,0,0,0,0,0,0,24622
7620,186,53,44,78,0,11,38,38,38,0,0,38,0,0,0,0,0,0,0,0,0,0,0,0,0,0,0,0,0,0,0,0,0,0,0,24628
7621,5011,955,2062,1351,505,138,417,203,59,31,0,28,144,144,120,4,20,0,0,0,0,214,200,9,0,191,14,14,14,0,0,0,0,0,0,24630
7622,1777,519,603,489,139,27,66,37,10,0,0,10,27,14,0,0,14,13,0,0,13,29,29,5,8,16,0,0,0,0,0,0,0,0,0,24631
7623,545,159,208,104,65,9,57,22,0,0,0,0,22,22,0,0,22,0,0,0,0,35,35,0,0,35,0,0,0,0,0,0,0,0,0,24634
7624,947,212,415,302,17,1,20,16,7,0,0,7,9,9,0,9,0,0,0,0,0,4,4,4,0,0,0,0,0,0,0,0,0,0,0,24635
7625,2804,556,861,1095,246,46,178,59,39,0,0,39,20,20,20,0,0,0,0,0,0,119,119,25,0,94,0,0,0,0,0,0,0,0,0,24637
7626,2931,1270,964,617,28,52,186,135,94,0,0,94,41,21,11,10,0,20,0,0,20,51,51,36,0,15,0,0,0,0,0,0,0,0,0,24639
7627,4100,1039,1187,1342,323,209,217,114,73,6,0,67,41,24,9,15,0,17,8,0,9,103,81,13,7,61,22,22,22,0,0,0,0,0,0,24641
7628,443,134,146,120,22,21,62,33,33,0,0,33,0,0,0,0,0,0,0,0,0,29,29,0,0,29,0,0,0,0,0,0,0,0,0,24646
7629,2207,814,665,705,23,0,224,172,114,79,35,0,58,12,0,12,0,46,0,0,46,52,52,0,0,52,0,0,0,0,0,0,0,0,0,24649
7630,4430,893,1536,1099,489,413,371,217,196,9,23,164,21,21,0,0,21,0,0,0,0,154,143,22,0,121,11,0,0,0,0,11,0,0,11,24651
7631,2582,757,981,637,160,47,65,37,11,0,0,11,26,26,26,0,0,0,0,0,0,28,8,8,0,0,20,9,9,0,0,11,0,0,11,24656
7632,352,182,79,75,16,0,22,13,13,0,0,13,0,0,0,0,0,0,0,0,0,9,9,0,9,0,0,0,0,0,0,0,0,0,0,24657
7633,14854,2789,5371,4001,1833,860,1107,497,406,37,35,334,91,86,8,0,78,5,5,0,0,610,496,143,6,347,114,77,6,35,36,37,10,0,27,24701
7634,816,89,259,225,110,133,371,159,135,52,15,68,24,15,9,0,6,9,0,0,9,212,212,69,4,139,0,0,0,0,0,0,0,0,0,24712
7635,69,46,23,0,0,0,0,0,0,0,0,0,0,0,0,0,0,0,0,0,0,0,0,0,0,0,0,0,0,0,0,0,0,0,0,24714
7636,420,122,144,83,59,12,33,33,15,0,0,15,18,18,0,0,18,0,0,0,0,0,0,0,0,0,0,0,0,0,0,0,0,0,0,24715
7637,240,45,132,63,0,0,16,16,16,0,0,16,0,0,0,0,0,0,0,0,0,0,0,0,0,0,0,0,0,0,0,0,0,0,0,24716
7638,323,47,206,53,0,17,24,0,0,0,0,0,0,0,0,0,0,0,0,0,0,24,0,0,0,0,24,24,0,0,24,0,0,0,0,24719
7639,85,15,31,31,8,0,21,3,0,0,0,0,3,3,3,0,0,0,0,0,0,18,0,0,0,0,18,18,0,0,18,0,0,0,0,24724
7640,235,69,72,80,0,14,0,0,0,0,0,0,0,0,0,0,0,0,0,0,0,0,0,0,0,0,0,0,0,0,0,0,0,0,0,24726
7641,104,69,35,0,0,0,12,0,0,0,0,0,0,0,0,0,0,0,0,0,0,12,0,0,0,0,12,0,0,0,0,12,0,0,12,24729
7642,222,36,69,110,0,7,10,10,10,0,0,10,0,0,0,0,0,0,0,0,0,0,0,0,0,0,0,0,0,0,0,0,0,0,0,24731
7643,378,101,223,34,20,0,0,0,0,0,0,0,0,0,0,0,0,0,0,0,0,0,0,0,0,0,0,0,0,0,0,0,0,0,0,24733
7644,692,218,405,41,28,0,18,8,7,0,0,7,1,0,0,0,0,1,0,1,0,10,0,0,0,0,10,10,4,0,6,0,0,0,0,24736
7645,92,47,45,0,0,0,15,15,0,0,0,0,15,0,0,0,0,15,0,0,15,0,0,0,0,0,0,0,0,0,0,0,0,0,0,24737
7646,226,68,141,0,17,0,6,6,0,0,0,0,6,6,0,0,6,0,0,0,0,0,0,0,0,0,0,0,0,0,0,0,0,0,0,24738
7647,21906,3755,8548,5415,2930,1258,1095,630,444,52,8,384,186,114,52,0,62,72,8,0,64,465,381,99,35,247,84,50,11,0,39,34,13,21,0,24740
7648,2024,611,862,412,94,45,163,118,97,13,0,84,21,21,8,0,13,0,0,0,0,45,32,9,0,23,13,13,0,0,13,0,0,0,0,24747
7649,3157,826,1406,641,218,66,106,59,30,0,0,30,29,17,5,0,12,12,0,9,3,47,47,0,9,38,0,0,0,0,0,0,0,0,0,24801
7650,404,85,198,102,14,5,49,39,33,7,0,26,6,6,6,0,0,0,0,0,0,10,10,0,0,10,0,0,0,0,0,0,0,0,0,24808
7651,506,153,265,37,27,24,38,38,38,0,0,38,0,0,0,0,0,0,0,0,0,0,0,0,0,0,0,0,0,0,0,0,0,0,0,24811
7652,305,130,165,0,10,0,33,0,0,0,0,0,0,0,0,0,0,0,0,0,0,33,0,0,0,0,33,33,33,0,0,0,0,0,0,24813
7653,473,152,262,43,0,16,24,0,0,0,0,0,0,0,0,0,0,0,0,0,0,24,24,0,0,24,0,0,0,0,0,0,0,0,0,24815
7654,90,24,24,42,0,0,0,0,0,0,0,0,0,0,0,0,0,0,0,0,0,0,0,0,0,0,0,0,0,0,0,0,0,0,0,24816
7655,532,257,179,86,8,2,68,26,6,0,0,6,20,3,3,0,0,17,0,0,17,42,29,0,0,29,13,0,0,0,0,13,0,0,13,24817
7656,939,218,521,119,67,14,63,44,44,0,0,44,0,0,0,0,0,0,0,0,0,19,19,19,0,0,0,0,0,0,0,0,0,0,0,24818
7657,404,125,169,46,64,0,30,30,30,21,0,9,0,0,0,0,0,0,0,0,0,0,0,0,0,0,0,0,0,0,0,0,0,0,0,24822
7658,395,76,220,99,0,0,16,16,10,0,0,10,6,6,0,6,0,0,0,0,0,0,0,0,0,0,0,0,0,0,0,0,0,0,0,24823
7659,194,56,78,44,16,0,0,0,0,0,0,0,0,0,0,0,0,0,0,0,0,0,0,0,0,0,0,0,0,0,0,0,0,0,0,24826
7660,1075,384,398,253,10,30,114,85,85,0,0,85,0,0,0,0,0,0,0,0,0,29,9,0,0,9,20,20,0,0,20,0,0,0,0,24827
7661,718,334,327,43,12,2,20,18,18,10,0,8,0,0,0,0,0,0,0,0,0,2,0,0,0,0,2,0,0,0,0,2,0,0,2,24828
7662,96,31,48,16,1,0,1,0,0,0,0,0,0,0,0,0,0,0,0,0,0,1,0,0,0,0,1,1,0,0,1,0,0,0,0,24830
7663,152,64,16,66,0,6,0,0,0,0,0,0,0,0,0,0,0,0,0,0,0,0,0,0,0,0,0,0,0,0,0,0,0,0,0,24831
7664,307,53,152,77,13,12,0,0,0,0,0,0,0,0,0,0,0,0,0,0,0,0,0,0,0,0,0,0,0,0,0,0,0,0,0,24834
7665,441,89,243,68,30,11,30,21,21,0,0,21,0,0,0,0,0,0,0,0,0,9,9,0,0,9,0,0,0,0,0,0,0,0,0,24836
7666,779,336,394,28,21,0,85,23,17,7,0,10,6,6,6,0,0,0,0,0,0,62,62,0,0,62,0,0,0,0,0,0,0,0,0,24839
7667,123,47,65,0,11,0,0,0,0,0,0,0,0,0,0,0,0,0,0,0,0,0,0,0,0,0,0,0,0,0,0,0,0,0,0,24843
7668,1362,496,648,172,2,44,59,33,0,0,0,0,33,33,4,0,29,0,0,0,0,26,7,0,0,7,19,5,5,0,0,14,0,0,14,24844
7669,214,63,138,13,0,0,13,13,13,0,0,13,0,0,0,0,0,0,0,0,0,0,0,0,0,0,0,0,0,0,0,0,0,0,0,24845
7670,168,113,55,0,0,0,0,0,0,0,0,0,0,0,0,0,0,0,0,0,0,0,0,0,0,0,0,0,0,0,0,0,0,0,0,24846
7671,252,13,162,77,0,0,0,0,0,0,0,0,0,0,0,0,0,0,0,0,0,0,0,0,0,0,0,0,0,0,0,0,0,0,0,24847
7672,126,41,68,11,6,0,7,7,0,0,0,0,7,7,7,0,0,0,0,0,0,0,0,0,0,0,0,0,0,0,0,0,0,0,0,24848
7673,246,36,153,57,0,0,12,0,0,0,0,0,0,0,0,0,0,0,0,0,0,12,12,0,0,12,0,0,0,0,0,0,0,0,0,24849
7674,652,320,113,219,0,0,61,29,0,0,0,0,29,0,0,0,0,29,0,0,29,32,32,20,0,12,0,0,0,0,0,0,0,0,0,24850
7675,199,99,59,41,0,0,15,0,0,0,0,0,0,0,0,0,0,0,0,0,0,15,15,0,0,15,0,0,0,0,0,0,0,0,0,24851
7676,522,259,127,93,13,30,12,0,0,0,0,0,0,0,0,0,0,0,0,0,0,12,2,0,0,2,10,10,0,0,10,0,0,0,0,24853
7677,304,58,90,100,42,14,0,0,0,0,0,0,0,0,0,0,0,0,0,0,0,0,0,0,0,0,0,0,0,0,0,0,0,0,0,24854
7678,589,241,208,74,25,41,37,20,20,0,0,20,0,0,0,0,0,0,0,0,0,17,17,17,0,0,0,0,0,0,0,0,0,0,0,24857
7679,416,147,139,94,16,20,9,0,0,0,0,0,0,0,0,0,0,0,0,0,0,9,9,0,0,9,0,0,0,0,0,0,0,0,0,24860
7680,232,62,77,57,29,7,49,49,26,0,0,26,23,23,0,0,23,0,0,0,0,0,0,0,0,0,0,0,0,0,0,0,0,0,0,24861
7681,391,245,130,16,0,0,17,17,13,0,0,13,4,0,0,0,0,4,0,0,4,0,0,0,0,0,0,0,0,0,0,0,0,0,0,24862
7682,94,44,33,17,0,0,0,0,0,0,0,0,0,0,0,0,0,0,0,0,0,0,0,0,0,0,0,0,0,0,0,0,0,0,0,24866
7683,237,65,143,19,10,0,24,24,24,0,0,24,0,0,0,0,0,0,0,0,0,0,0,0,0,0,0,0,0,0,0,0,0,0,0,24867
7684,1113,374,429,214,82,14,69,45,45,3,0,42,0,0,0,0,0,0,0,0,0,24,24,0,0,24,0,0,0,0,0,0,0,0,0,24868
7685,259,78,118,27,0,36,0,0,0,0,0,0,0,0,0,0,0,0,0,0,0,0,0,0,0,0,0,0,0,0,0,0,0,0,0,24869
7686,2236,410,1080,540,121,85,168,72,29,2,0,27,43,43,35,6,2,0,0,0,0,96,79,4,0,75,17,17,0,13,4,0,0,0,0,24870
7687,158,69,50,32,0,7,12,0,0,0,0,0,0,0,0,0,0,0,0,0,0,12,5,0,0,5,7,0,0,0,0,7,0,0,7,24871
7688,596,330,199,56,11,0,8,0,0,0,0,0,0,0,0,0,0,0,0,0,0,8,8,0,0,8,0,0,0,0,0,0,0,0,0,24872
7689,442,195,131,50,51,15,17,17,12,0,0,12,5,5,5,0,0,0,0,0,0,0,0,0,0,0,0,0,0,0,0,0,0,0,0,24873
7690,1660,498,557,361,108,136,97,71,71,0,0,71,0,0,0,0,0,0,0,0,0,26,8,0,0,8,18,4,4,0,0,14,0,14,0,24874
7691,289,84,169,16,20,0,19,19,0,0,0,0,19,19,0,19,0,0,0,0,0,0,0,0,0,0,0,0,0,0,0,0,0,0,0,24878
7692,405,275,115,8,7,0,55,8,8,0,0,8,0,0,0,0,0,0,0,0,0,47,29,0,0,29,18,18,0,0,18,0,0,0,0,24879
7693,322,97,118,75,16,16,0,0,0,0,0,0,0,0,0,0,0,0,0,0,0,0,0,0,0,0,0,0,0,0,0,0,0,0,0,24880
7694,367,99,195,44,20,9,115,37,37,0,0,37,0,0,0,0,0,0,0,0,0,78,78,0,0,78,0,0,0,0,0,0,0,0,0,24881
7695,454,168,272,14,0,0,67,54,54,0,0,54,0,0,0,0,0,0,0,0,0,13,13,0,0,13,0,0,0,0,0,0,0,0,0,24882
7696,232,87,117,17,11,0,0,0,0,0,0,0,0,0,0,0,0,0,0,0,0,0,0,0,0,0,0,0,0,0,0,0,0,0,0,24884
7697,44,7,37,0,0,0,14,14,0,0,0,0,14,14,0,0,14,0,0,0,0,0,0,0,0,0,0,0,0,0,0,0,0,0,0,24887
7698,199,61,92,31,15,0,0,0,0,0,0,0,0,0,0,0,0,0,0,0,0,0,0,0,0,0,0,0,0,0,0,0,0,0,0,24888
7699,1179,458,549,137,28,7,51,36,21,0,21,0,15,0,0,0,0,15,0,10,5,15,15,8,0,7,0,0,0,0,0,0,0,0,0,24892
7700,155,34,95,18,8,0,24,3,0,0,0,0,3,3,0,0,3,0,0,0,0,21,15,0,0,15,6,6,0,0,6,0,0,0,0,24894
7701,84,35,49,0,0,0,0,0,0,0,0,0,0,0,0,0,0,0,0,0,0,0,0,0,0,0,0,0,0,0,0,0,0,0,0,24898
7702,6258,676,2013,1328,1296,945,190,111,96,23,20,53,15,0,0,0,0,15,0,0,15,79,52,19,0,33,27,0,0,0,0,27,13,0,14,24901
7703,4366,846,1836,1181,282,221,229,90,70,15,11,44,20,20,0,14,6,0,0,0,0,139,135,35,0,100,4,0,0,0,0,4,0,4,0,24910
7704,283,40,143,64,19,17,0,0,0,0,0,0,0,0,0,0,0,0,0,0,0,0,0,0,0,0,0,0,0,0,0,0,0,0,0,24915
7705,484,114,188,152,21,9,61,35,25,25,0,0,10,0,0,0,0,10,0,10,0,26,26,0,0,26,0,0,0,0,0,0,0,0,0,24916
7706,1109,278,468,172,137,54,116,53,21,0,21,0,32,0,0,0,0,32,32,0,0,63,63,48,0,15,0,0,0,0,0,0,0,0,0,24918
7707,321,106,163,34,18,0,17,0,0,0,0,0,0,0,0,0,0,0,0,0,0,17,17,0,0,17,0,0,0,0,0,0,0,0,0,24920
7708,236,55,133,39,9,0,27,0,0,0,0,0,0,0,0,0,0,0,0,0,0,27,27,27,0,0,0,0,0,0,0,0,0,0,0,24924
7709,476,88,244,92,38,14,19,12,12,12,0,0,0,0,0,0,0,0,0,0,0,7,0,0,0,0,7,7,7,0,0,0,0,0,0,24925
7710,163,25,117,21,0,0,4,0,0,0,0,0,0,0,0,0,0,0,0,0,0,4,4,0,0,4,0,0,0,0,0,0,0,0,0,24927
7711,1128,254,515,107,152,100,132,75,75,75,0,0,0,0,0,0,0,0,0,0,0,57,57,0,0,57,0,0,0,0,0,0,0,0,0,24931
7712,315,31,126,67,45,46,13,0,0,0,0,0,0,0,0,0,0,0,0,0,0,13,13,0,0,13,0,0,0,0,0,0,0,0,0,24934
7713,549,83,176,185,95,10,12,12,12,0,0,12,0,0,0,0,0,0,0,0,0,0,0,0,0,0,0,0,0,0,0,0,0,0,0,24935
7714,1265,332,628,140,104,61,66,50,34,0,34,0,16,0,0,0,0,16,16,0,0,16,16,0,0,16,0,0,0,0,0,0,0,0,0,24938
7715,1053,274,537,154,36,52,28,0,0,0,0,0,0,0,0,0,0,0,0,0,0,28,28,28,0,0,0,0,0,0,0,0,0,0,0,24941
7716,307,17,135,83,29,43,21,6,6,6,0,0,0,0,0,0,0,0,0,0,0,15,15,0,0,15,0,0,0,0,0,0,0,0,0,24944
7717,278,47,97,87,10,37,52,52,52,17,14,21,0,0,0,0,0,0,0,0,0,0,0,0,0,0,0,0,0,0,0,0,0,0,0,24945
7718,1345,205,481,335,227,97,45,26,19,0,6,13,7,7,4,0,3,0,0,0,0,19,16,0,0,16,3,3,0,3,0,0,0,0,0,24946
7719,928,277,381,153,106,11,30,30,30,0,15,15,0,0,0,0,0,0,0,0,0,0,0,0,0,0,0,0,0,0,0,0,0,0,0,24951
7720,2930,527,1278,721,265,139,114,32,29,0,0,29,3,0,0,0,0,3,3,0,0,82,82,8,7,67,0,0,0,0,0,0,0,0,0,24954
7721,132,0,72,32,0,28,3,3,3,0,0,3,0,0,0,0,0,0,0,0,0,0,0,0,0,0,0,0,0,0,0,0,0,0,0,24957
7722,88,44,25,19,0,0,6,6,6,0,0,6,0,0,0,0,0,0,0,0,0,0,0,0,0,0,0,0,0,0,0,0,0,0,0,24962
7723,2630,338,1394,531,268,99,274,191,87,34,35,18,104,104,104,0,0,0,0,0,0,83,83,42,0,41,0,0,0,0,0,0,0,0,0,24963
7724,807,55,428,183,77,64,50,6,6,0,0,6,0,0,0,0,0,0,0,0,0,44,35,33,0,2,9,9,9,0,0,0,0,0,0,24966
7725,3410,489,1504,1081,292,44,125,73,60,31,2,27,13,3,0,0,3,10,10,0,0,52,39,13,0,26,13,3,0,0,3,10,0,10,0,24970
7726,130,31,74,25,0,0,33,33,18,18,0,0,15,15,0,15,0,0,0,0,0,0,0,0,0,0,0,0,0,0,0,0,0,0,0,24974
7727,713,90,255,169,80,119,35,8,8,0,0,8,0,0,0,0,0,0,0,0,0,27,27,9,0,18,0,0,0,0,0,0,0,0,0,24976
7728,381,108,89,100,69,15,31,0,0,0,0,0,0,0,0,0,0,0,0,0,0,31,31,0,0,31,0,0,0,0,0,0,0,0,0,24977
7729,683,157,276,69,116,65,15,9,9,0,0,9,0,0,0,0,0,0,0,0,0,6,6,6,0,0,0,0,0,0,0,0,0,0,0,24981
7730,2117,416,1002,421,195,83,90,32,10,0,0,10,22,9,9,0,0,13,0,13,0,58,40,29,0,11,18,18,0,0,18,0,0,0,0,24983
7731,202,23,80,84,15,0,12,0,0,0,0,0,0,0,0,0,0,0,0,0,0,12,12,0,0,12,0,0,0,0,0,0,0,0,0,24984
7732,4040,723,1899,1173,195,50,226,118,107,48,15,44,11,0,0,0,0,11,0,0,11,108,58,38,0,20,50,50,0,0,50,0,0,0,0,24986
7733,438,31,119,235,18,35,28,13,0,0,0,0,13,13,13,0,0,0,0,0,0,15,15,0,0,15,0,0,0,0,0,0,0,0,0,24991
7734,95,27,0,40,28,0,0,0,0,0,0,0,0,0,0,0,0,0,0,0,0,0,0,0,0,0,0,0,0,0,0,0,0,0,0,25002
7735,1834,264,761,478,223,108,142,52,16,16,0,0,36,36,0,0,36,0,0,0,0,90,90,51,0,39,0,0,0,0,0,0,0,0,0,25003
7736,134,8,61,55,10,0,0,0,0,0,0,0,0,0,0,0,0,0,0,0,0,0,0,0,0,0,0,0,0,0,0,0,0,0,0,25005
7737,305,39,170,60,25,11,41,31,7,0,0,7,24,24,0,0,24,0,0,0,0,10,0,0,0,0,10,10,0,10,0,0,0,0,0,25007
7738,224,72,152,0,0,0,0,0,0,0,0,0,0,0,0,0,0,0,0,0,0,0,0,0,0,0,0,0,0,0,0,0,0,0,0,25008
7739,987,352,490,99,36,10,69,47,29,0,0,29,18,18,14,0,4,0,0,0,0,22,15,15,0,0,7,7,0,0,7,0,0,0,0,25009
7740,741,84,290,173,111,83,35,28,6,0,0,6,22,0,0,0,0,22,0,0,22,7,7,7,0,0,0,0,0,0,0,0,0,0,0,25011
7741,3091,606,1093,1040,287,65,245,142,98,12,0,86,44,15,15,0,0,29,0,29,0,103,33,5,4,24,70,70,0,33,37,0,0,0,0,25015
7742,375,99,188,71,17,0,24,5,5,0,0,5,0,0,0,0,0,0,0,0,0,19,16,0,0,16,3,3,3,0,0,0,0,0,0,25019
7743,212,106,91,8,0,7,11,11,0,0,0,0,11,0,0,0,0,11,0,0,11,0,0,0,0,0,0,0,0,0,0,0,0,0,0,25021
7744,104,20,55,29,0,0,0,0,0,0,0,0,0,0,0,0,0,0,0,0,0,0,0,0,0,0,0,0,0,0,0,0,0,0,0,25022
7745,574,139,357,49,16,13,30,30,30,0,0,30,0,0,0,0,0,0,0,0,0,0,0,0,0,0,0,0,0,0,0,0,0,0,0,25024
7746,131,37,75,4,15,0,20,0,0,0,0,0,0,0,0,0,0,0,0,0,0,20,20,0,0,20,0,0,0,0,0,0,0,0,0,25025
7747,278,111,92,47,28,0,22,3,0,0,0,0,3,3,0,0,3,0,0,0,0,19,0,0,0,0,19,19,0,0,19,0,0,0,0,25028
7748,369,113,196,60,0,0,5,5,5,0,5,0,0,0,0,0,0,0,0,0,0,0,0,0,0,0,0,0,0,0,0,0,0,0,0,25030
7749,661,140,269,184,49,19,31,0,0,0,0,0,0,0,0,0,0,0,0,0,0,31,0,0,0,0,31,31,31,0,0,0,0,0,0,25031
7750,1277,206,680,280,73,38,196,106,64,6,0,58,42,37,6,19,12,5,0,0,5,90,70,0,0,70,20,3,3,0,0,17,10,0,7,25033
7751,841,155,496,119,33,38,28,0,0,0,0,0,0,0,0,0,0,0,0,0,0,28,28,0,0,28,0,0,0,0,0,0,0,0,0,25035
7752,1040,294,396,339,7,4,14,14,0,0,0,0,14,0,0,0,0,14,0,0,14,0,0,0,0,0,0,0,0,0,0,0,0,0,0,25036
7753,812,220,467,94,23,8,82,30,30,16,0,14,0,0,0,0,0,0,0,0,0,52,30,6,3,21,22,4,4,0,0,18,0,0,18,25039
7754,411,113,107,165,26,0,14,14,14,0,0,14,0,0,0,0,0,0,0,0,0,0,0,0,0,0,0,0,0,0,0,0,0,0,0,25040
7755,1239,180,672,305,44,38,83,53,42,0,0,42,11,11,11,0,0,0,0,0,0,30,30,0,0,30,0,0,0,0,0,0,0,0,0,25043
7756,231,95,136,0,0,0,0,0,0,0,0,0,0,0,0,0,0,0,0,0,0,0,0,0,0,0,0,0,0,0,0,0,0,0,0,25044
7757,4096,944,1922,717,279,234,360,237,223,0,25,198,14,6,0,6,0,8,0,6,2,123,117,24,0,93,6,0,0,0,0,6,0,0,6,25045
7758,251,71,123,57,0,0,24,24,24,0,0,24,0,0,0,0,0,0,0,0,0,0,0,0,0,0,0,0,0,0,0,0,0,0,0,25047
7759,22,0,22,0,0,0,0,0,0,0,0,0,0,0,0,0,0,0,0,0,0,0,0,0,0,0,0,0,0,0,0,0,0,0,0,25048
7760,372,74,200,93,5,0,34,28,28,28,0,0,0,0,0,0,0,0,0,0,0,6,6,0,0,6,0,0,0,0,0,0,0,0,0,25049
7761,25,7,9,9,0,0,0,0,0,0,0,0,0,0,0,0,0,0,0,0,0,0,0,0,0,0,0,0,0,0,0,0,0,0,0,25051
7762,3050,863,1295,629,166,97,274,117,99,25,24,50,18,18,18,0,0,0,0,0,0,157,126,0,43,83,31,31,0,8,23,0,0,0,0,25053
7763,98,59,39,0,0,0,0,0,0,0,0,0,0,0,0,0,0,0,0,0,0,0,0,0,0,0,0,0,0,0,0,0,0,0,0,25054
7764,114,34,67,13,0,0,0,0,0,0,0,0,0,0,0,0,0,0,0,0,0,0,0,0,0,0,0,0,0,0,0,0,0,0,0,25057
7765,445,59,156,151,43,36,25,0,0,0,0,0,0,0,0,0,0,0,0,0,0,25,25,17,0,8,0,0,0,0,0,0,0,0,0,25059
7766,333,30,135,142,26,0,5,5,5,0,0,5,0,0,0,0,0,0,0,0,0,0,0,0,0,0,0,0,0,0,0,0,0,0,0,25060
7767,349,62,213,74,0,0,0,0,0,0,0,0,0,0,0,0,0,0,0,0,0,0,0,0,0,0,0,0,0,0,0,0,0,0,0,25061
7768,120,87,33,0,0,0,8,8,8,0,0,8,0,0,0,0,0,0,0,0,0,0,0,0,0,0,0,0,0,0,0,0,0,0,0,25062
7769,1109,344,424,288,44,9,63,63,63,26,0,37,0,0,0,0,0,0,0,0,0,0,0,0,0,0,0,0,0,0,0,0,0,0,0,25063
7770,6705,679,2539,2014,877,596,518,240,195,42,43,110,45,30,14,0,16,15,0,0,15,278,229,89,16,124,49,19,19,0,0,30,0,30,0,25064
7771,830,178,449,102,67,34,28,10,10,7,0,3,0,0,0,0,0,0,0,0,0,18,13,0,5,8,5,3,3,0,0,2,0,0,2,25067
7772,1405,116,683,365,165,76,32,20,12,0,3,9,8,0,0,0,0,8,8,0,0,12,12,0,0,12,0,0,0,0,0,0,0,0,0,25070
7773,8928,1054,4182,1974,1126,592,455,245,245,71,21,153,0,0,0,0,0,0,0,0,0,210,177,20,0,157,33,0,0,0,0,33,0,13,20,25071
7774,414,170,154,8,14,68,56,56,23,0,0,23,33,17,0,0,17,16,0,16,0,0,0,0,0,0,0,0,0,0,0,0,0,0,0,25075
7775,183,61,51,71,0,0,0,0,0,0,0,0,0,0,0,0,0,0,0,0,0,0,0,0,0,0,0,0,0,0,0,0,0,0,0,25076
7776,847,40,462,258,59,28,76,29,13,0,0,13,16,0,0,0,0,16,16,0,0,47,47,0,0,47,0,0,0,0,0,0,0,0,0,25081
7777,1215,98,643,305,129,40,116,58,58,11,0,47,0,0,0,0,0,0,0,0,0,58,38,8,11,19,20,0,0,0,0,20,0,0,20,25082
7778,386,36,243,39,68,0,9,0,0,0,0,0,0,0,0,0,0,0,0,0,0,9,9,0,0,9,0,0,0,0,0,0,0,0,0,25083
7779,694,185,277,177,49,6,49,20,6,0,0,6,14,10,0,10,0,4,4,0,0,29,29,3,9,17,0,0,0,0,0,0,0,0,0,25085
7780,670,182,338,109,34,7,37,19,19,0,0,19,0,0,0,0,0,0,0,0,0,18,18,6,5,7,0,0,0,0,0,0,0,0,0,25086
7781,78,14,41,13,10,0,0,0,0,0,0,0,0,0,0,0,0,0,0,0,0,0,0,0,0,0,0,0,0,0,0,0,0,0,0,25088
7782,116,89,27,0,0,0,0,0,0,0,0,0,0,0,0,0,0,0,0,0,0,0,0,0,0,0,0,0,0,0,0,0,0,0,0,25090
7783,84,68,0,16,0,0,0,0,0,0,0,0,0,0,0,0,0,0,0,0,0,0,0,0,0,0,0,0,0,0,0,0,0,0,0,25093
7784,231,52,101,61,9,8,16,6,6,3,0,3,0,0,0,0,0,0,0,0,0,10,10,2,0,8,0,0,0,0,0,0,0,0,0,25102
7785,137,20,68,20,20,9,0,0,0,0,0,0,0,0,0,0,0,0,0,0,0,0,0,0,0,0,0,0,0,0,0,0,0,0,0,25103
7786,459,91,239,43,62,24,59,21,21,0,0,21,0,0,0,0,0,0,0,0,0,38,38,0,0,38,0,0,0,0,0,0,0,0,0,25106
7787,273,39,205,29,0,0,47,43,43,0,43,0,0,0,0,0,0,0,0,0,0,4,4,0,0,4,0,0,0,0,0,0,0,0,0,25107
7788,306,95,121,68,0,22,18,18,18,0,0,18,0,0,0,0,0,0,0,0,0,0,0,0,0,0,0,0,0,0,0,0,0,0,0,25108
7789,347,75,217,55,0,0,0,0,0,0,0,0,0,0,0,0,0,0,0,0,0,0,0,0,0,0,0,0,0,0,0,0,0,0,0,25109
7790,340,93,91,131,12,13,0,0,0,0,0,0,0,0,0,0,0,0,0,0,0,0,0,0,0,0,0,0,0,0,0,0,0,0,0,25110
7791,433,145,189,77,0,22,14,14,5,0,0,5,9,0,0,0,0,9,9,0,0,0,0,0,0,0,0,0,0,0,0,0,0,0,0,25111
7792,0,0,0,0,0,0,57,21,21,11,0,10,0,0,0,0,0,0,0,0,0,36,36,12,24,0,0,0,0,0,0,0,0,0,0,25112
7793,613,158,298,136,1,20,87,28,28,0,0,28,0,0,0,0,0,0,0,0,0,59,59,0,0,59,0,0,0,0,0,0,0,0,0,25113
7794,590,120,338,95,37,0,34,0,0,0,0,0,0,0,0,0,0,0,0,0,0,34,34,0,0,34,0,0,0,0,0,0,0,0,0,25114
7795,186,0,97,89,0,0,29,29,29,0,29,0,0,0,0,0,0,0,0,0,0,0,0,0,0,0,0,0,0,0,0,0,0,0,0,25115
7796,911,163,435,281,32,0,65,47,47,0,0,47,0,0,0,0,0,0,0,0,0,18,0,0,0,0,18,18,18,0,0,0,0,0,0,25118
7797,278,81,107,65,23,2,75,73,29,0,0,29,44,19,0,19,0,25,7,18,0,2,2,0,0,2,0,0,0,0,0,0,0,0,0,25119
7798,729,109,473,110,0,37,35,0,0,0,0,0,0,0,0,0,0,0,0,0,0,35,0,0,0,0,35,35,0,0,35,0,0,0,0,25121
7799,2627,489,1413,480,193,52,141,115,115,0,0,115,0,0,0,0,0,0,0,0,0,26,26,0,0,26,0,0,0,0,0,0,0,0,0,25123
7800,1040,243,578,153,13,53,46,46,18,0,0,18,28,28,0,0,28,0,0,0,0,0,0,0,0,0,0,0,0,0,0,0,0,0,0,25124
7801,540,188,215,131,0,6,46,24,8,0,0,8,16,16,16,0,0,0,0,0,0,22,22,3,0,19,0,0,0,0,0,0,0,0,0,25125
7802,38,0,27,11,0,0,0,0,0,0,0,0,0,0,0,0,0,0,0,0,0,0,0,0,0,0,0,0,0,0,0,0,0,0,0,25126
7803,2518,273,1146,713,153,233,118,61,40,0,0,40,21,13,9,4,0,8,0,0,8,57,46,0,0,46,11,11,0,0,11,0,0,0,0,25130
7804,315,128,187,0,0,0,0,0,0,0,0,0,0,0,0,0,0,0,0,0,0,0,0,0,0,0,0,0,0,0,0,0,0,0,0,25132
7805,687,125,270,194,52,46,46,7,7,7,0,0,0,0,0,0,0,0,0,0,0,39,39,12,0,27,0,0,0,0,0,0,0,0,0,25133
7806,465,162,222,81,0,0,0,0,0,0,0,0,0,0,0,0,0,0,0,0,0,0,0,0,0,0,0,0,0,0,0,0,0,0,0,25134
7807,1142,160,415,321,145,101,304,202,196,31,3,162,6,6,0,6,0,0,0,0,0,102,100,30,0,70,2,0,0,0,0,2,0,0,2,25136
7808,185,38,40,72,28,7,0,0,0,0,0,0,0,0,0,0,0,0,0,0,0,0,0,0,0,0,0,0,0,0,0,0,0,0,0,25139
7809,644,174,348,80,24,18,88,75,41,0,0,41,34,34,21,13,0,0,0,0,0,13,13,0,0,13,0,0,0,0,0,0,0,0,0,25140
7810,165,32,88,23,22,0,0,0,0,0,0,0,0,0,0,0,0,0,0,0,0,0,0,0,0,0,0,0,0,0,0,0,0,0,0,25141
7811,286,67,117,30,72,0,38,18,0,0,0,0,18,0,0,0,0,18,0,18,0,20,0,0,0,0,20,0,0,0,0,20,0,20,0,25142
7812,6178,736,2440,1698,842,462,130,47,30,0,0,30,17,17,0,17,0,0,0,0,0,83,63,32,0,31,20,0,0,0,0,20,19,0,1,25143
7813,99,0,77,16,6,0,19,3,3,0,0,3,0,0,0,0,0,0,0,0,0,16,16,0,0,16,0,0,0,0,0,0,0,0,0,25148
7814,213,71,120,22,0,0,0,0,0,0,0,0,0,0,0,0,0,0,0,0,0,0,0,0,0,0,0,0,0,0,0,0,0,0,0,25149
7815,205,35,112,42,16,0,0,0,0,0,0,0,0,0,0,0,0,0,0,0,0,0,0,0,0,0,0,0,0,0,0,0,0,0,0,25152
7816,519,189,205,85,0,40,24,0,0,0,0,0,0,0,0,0,0,0,0,0,0,24,0,0,0,0,24,24,24,0,0,0,0,0,0,25154
7817,98,40,10,48,0,0,9,0,0,0,0,0,0,0,0,0,0,0,0,0,0,9,9,0,0,9,0,0,0,0,0,0,0,0,0,25156
7818,3798,529,1565,1052,426,226,231,148,148,29,20,99,0,0,0,0,0,0,0,0,0,83,77,0,0,77,6,6,6,0,0,0,0,0,0,25159
7819,121,8,85,28,0,0,53,41,41,0,0,41,0,0,0,0,0,0,0,0,0,12,0,0,0,0,12,0,0,0,0,12,0,12,0,25160
7820,190,72,91,27,0,0,34,34,34,18,0,16,0,0,0,0,0,0,0,0,0,0,0,0,0,0,0,0,0,0,0,0,0,0,0,25161
7821,354,15,134,108,55,42,30,7,7,6,0,1,0,0,0,0,0,0,0,0,0,23,23,10,0,13,0,0,0,0,0,0,0,0,0,25162
7822,899,324,315,190,49,21,48,33,15,0,0,15,18,0,0,0,0,18,0,18,0,15,15,15,0,0,0,0,0,0,0,0,0,0,0,25164
7823,337,43,107,146,13,28,25,12,12,0,0,12,0,0,0,0,0,0,0,0,0,13,0,0,0,0,13,0,0,0,0,13,5,0,8,25165
7824,1781,327,867,372,167,48,85,44,44,0,0,44,0,0,0,0,0,0,0,0,0,41,18,0,0,18,23,23,0,0,23,0,0,0,0,25168
7825,346,91,143,54,45,13,30,21,10,0,0,10,11,0,0,0,0,11,0,0,11,9,9,0,0,9,0,0,0,0,0,0,0,0,0,25169
7826,275,148,118,9,0,0,15,15,15,0,0,15,0,0,0,0,0,0,0,0,0,0,0,0,0,0,0,0,0,0,0,0,0,0,0,25173
7827,316,92,95,122,7,0,12,12,12,0,0,12,0,0,0,0,0,0,0,0,0,0,0,0,0,0,0,0,0,0,0,0,0,0,0,25174
7828,17429,1670,7093,5166,2371,1129,988,536,431,97,20,314,105,79,38,41,0,26,0,0,26,452,367,64,28,275,85,31,21,0,10,54,5,15,34,25177
7829,53,13,40,0,0,0,0,0,0,0,0,0,0,0,0,0,0,0,0,0,0,0,0,0,0,0,0,0,0,0,0,0,0,0,0,25180
7830,1435,483,586,279,52,35,226,77,63,16,47,0,14,0,0,0,0,14,0,0,14,149,101,52,13,36,48,48,48,0,0,0,0,0,0,25181
7831,0,0,0,0,0,0,0,0,0,0,0,0,0,0,0,0,0,0,0,0,0,0,0,0,0,0,0,0,0,0,0,0,0,0,0,25183
7832,447,82,266,89,10,0,0,0,0,0,0,0,0,0,0,0,0,0,0,0,0,0,0,0,0,0,0,0,0,0,0,0,0,0,0,25185
7833,730,121,331,203,49,26,21,12,3,0,0,3,9,9,0,0,9,0,0,0,0,9,9,0,0,9,0,0,0,0,0,0,0,0,0,25186
7834,633,67,256,278,32,0,16,16,16,0,0,16,0,0,0,0,0,0,0,0,0,0,0,0,0,0,0,0,0,0,0,0,0,0,0,25187
7835,455,60,245,124,19,7,4,4,4,0,0,4,0,0,0,0,0,0,0,0,0,0,0,0,0,0,0,0,0,0,0,0,0,0,0,25193
7836,27,0,0,13,0,14,0,0,0,0,0,0,0,0,0,0,0,0,0,0,0,0,0,0,0,0,0,0,0,0,0,0,0,0,0,25201
7837,787,90,305,278,88,26,24,13,0,0,0,0,13,13,0,13,0,0,0,0,0,11,0,0,0,0,11,11,0,11,0,0,0,0,0,25202
7838,53,0,23,21,9,0,0,0,0,0,0,0,0,0,0,0,0,0,0,0,0,0,0,0,0,0,0,0,0,0,0,0,0,0,0,25203
7839,184,45,87,52,0,0,0,0,0,0,0,0,0,0,0,0,0,0,0,0,0,0,0,0,0,0,0,0,0,0,0,0,0,0,0,25204
7840,234,20,122,24,42,26,0,0,0,0,0,0,0,0,0,0,0,0,0,0,0,0,0,0,0,0,0,0,0,0,0,0,0,0,0,25205
7841,355,215,66,74,0,0,18,7,7,0,0,7,0,0,0,0,0,0,0,0,0,11,0,0,0,0,11,0,0,0,0,11,0,0,11,25206
7842,623,181,318,124,0,0,29,0,0,0,0,0,0,0,0,0,0,0,0,0,0,29,0,0,0,0,29,13,0,13,0,16,0,0,16,25208
7843,773,214,387,150,10,12,14,3,3,0,0,3,0,0,0,0,0,0,0,0,0,11,11,0,0,11,0,0,0,0,0,0,0,0,0,25209
7844,76,13,63,0,0,0,9,0,0,0,0,0,0,0,0,0,0,0,0,0,0,9,0,0,0,0,9,9,0,9,0,0,0,0,0,25211
7845,4112,276,1448,1447,613,328,262,123,123,53,0,70,0,0,0,0,0,0,0,0,0,139,128,24,0,104,11,11,11,0,0,0,0,0,0,25213
7846,352,42,243,50,0,17,47,25,25,0,25,0,0,0,0,0,0,0,0,0,0,22,22,0,0,22,0,0,0,0,0,0,0,0,0,25214
7847,1281,233,694,198,147,9,93,44,28,0,28,0,16,16,16,0,0,0,0,0,0,49,49,0,0,49,0,0,0,0,0,0,0,0,0,25234
7848,483,142,213,84,0,44,9,9,9,0,0,9,0,0,0,0,0,0,0,0,0,0,0,0,0,0,0,0,0,0,0,0,0,0,0,25235
7849,1198,295,481,282,122,18,76,21,13,0,0,13,8,8,8,0,0,0,0,0,0,55,33,0,0,33,22,22,0,0,22,0,0,0,0,25239
7850,1088,136,347,386,149,70,39,29,29,0,0,29,0,0,0,0,0,0,0,0,0,10,10,10,0,0,0,0,0,0,0,0,0,0,0,25241
7851,444,80,242,106,16,0,21,21,21,0,0,21,0,0,0,0,0,0,0,0,0,0,0,0,0,0,0,0,0,0,0,0,0,0,0,25243
7852,577,307,152,30,31,57,79,11,0,0,0,0,11,0,0,0,0,11,0,0,11,68,68,0,0,68,0,0,0,0,0,0,0,0,0,25244
7853,503,44,215,163,31,50,0,0,0,0,0,0,0,0,0,0,0,0,0,0,0,0,0,0,0,0,0,0,0,0,0,0,0,0,0,25245
7854,408,95,176,121,12,4,41,28,16,0,0,16,12,7,3,0,4,5,0,5,0,13,13,9,4,0,0,0,0,0,0,0,0,0,0,25247
7855,2215,373,952,573,264,53,335,232,200,51,0,149,32,32,15,0,17,0,0,0,0,103,64,23,0,41,39,39,0,0,39,0,0,0,0,25248
7856,330,123,162,38,0,7,15,15,8,0,0,8,7,7,7,0,0,0,0,0,0,0,0,0,0,0,0,0,0,0,0,0,0,0,0,25251
7857,820,149,302,305,64,0,17,17,17,0,0,17,0,0,0,0,0,0,0,0,0,0,0,0,0,0,0,0,0,0,0,0,0,0,0,25252
7858,1400,221,716,388,64,11,148,50,29,0,0,29,21,11,11,0,0,10,10,0,0,98,21,13,0,8,77,0,0,0,0,77,77,0,0,25253
7859,489,127,251,58,34,19,27,15,6,0,0,6,9,0,0,0,0,9,0,9,0,12,12,0,6,6,0,0,0,0,0,0,0,0,0,25259
7860,1256,194,568,341,122,31,58,18,11,11,0,0,7,7,0,7,0,0,0,0,0,40,0,0,0,0,40,25,13,0,12,15,0,0,15,25260
7861,254,13,180,61,0,0,34,7,7,0,0,7,0,0,0,0,0,0,0,0,0,27,27,21,0,6,0,0,0,0,0,0,0,0,0,25261
7862,903,199,338,319,47,0,39,27,27,0,0,27,0,0,0,0,0,0,0,0,0,12,12,2,0,10,0,0,0,0,0,0,0,0,0,25262
7863,236,133,20,83,0,0,0,0,0,0,0,0,0,0,0,0,0,0,0,0,0,0,0,0,0,0,0,0,0,0,0,0,0,0,0,25264
7864,1019,127,433,345,70,44,20,20,20,0,0,20,0,0,0,0,0,0,0,0,0,0,0,0,0,0,0,0,0,0,0,0,0,0,0,25265
7865,718,283,344,32,59,0,80,56,43,0,0,43,13,13,13,0,0,0,0,0,0,24,24,0,0,24,0,0,0,0,0,0,0,0,0,25266
7866,427,81,148,127,27,44,0,0,0,0,0,0,0,0,0,0,0,0,0,0,0,0,0,0,0,0,0,0,0,0,0,0,0,0,0,25267
7867,585,144,374,32,35,0,23,7,7,0,7,0,0,0,0,0,0,0,0,0,0,16,16,0,16,0,0,0,0,0,0,0,0,0,0,25268
7868,773,159,395,130,80,9,49,2,2,0,0,2,0,0,0,0,0,0,0,0,0,47,25,17,0,8,22,22,22,0,0,0,0,0,0,25270
7869,6417,856,2467,1988,719,387,347,215,180,57,11,112,35,35,15,11,9,0,0,0,0,132,94,35,12,47,38,27,0,27,0,11,0,0,11,25271
7870,1478,238,583,465,132,60,95,75,32,7,0,25,43,15,15,0,0,28,0,5,23,20,20,0,0,20,0,0,0,0,0,0,0,0,0,25275
7871,5184,1236,2375,911,458,204,392,154,112,8,16,88,42,42,37,0,5,0,0,0,0,238,220,52,23,145,18,5,5,0,0,13,0,0,13,25276
7872,432,103,177,67,10,75,0,0,0,0,0,0,0,0,0,0,0,0,0,0,0,0,0,0,0,0,0,0,0,0,0,0,0,0,0,25285
7873,1197,240,638,228,54,37,69,61,32,0,0,32,29,29,16,0,13,0,0,0,0,8,0,0,0,0,8,0,0,0,0,8,0,0,8,25286
7874,959,279,347,261,65,7,4,4,4,0,4,0,0,0,0,0,0,0,0,0,0,0,0,0,0,0,0,0,0,0,0,0,0,0,0,25287
7875,1798,250,420,510,315,303,15,0,0,0,0,0,0,0,0,0,0,0,0,0,0,15,15,0,15,0,0,0,0,0,0,0,0,0,0,25301
7876,11185,1052,3955,3317,1590,1271,578,351,284,46,30,208,67,67,18,40,9,0,0,0,0,227,167,42,8,117,60,51,51,0,0,9,0,0,9,25302
7877,5237,204,1336,1642,1406,649,330,208,208,125,8,75,0,0,0,0,0,0,0,0,0,122,82,10,0,72,40,0,0,0,0,40,0,40,0,25303
7878,6509,431,1576,1619,1409,1474,540,278,278,57,47,174,0,0,0,0,0,0,0,0,0,262,241,83,16,142,21,16,0,16,0,5,5,0,0,25304
7879,0,0,0,0,0,0,0,0,0,0,0,0,0,0,0,0,0,0,0,0,0,0,0,0,0,0,0,0,0,0,0,0,0,0,0,25305
7880,4621,742,2380,1097,302,100,321,174,63,19,15,29,111,85,11,59,15,26,11,12,3,147,133,7,29,97,14,12,0,12,0,2,0,0,2,25306
7881,9979,1348,3602,2889,1267,873,645,362,287,78,15,194,75,63,49,0,14,12,12,0,0,283,261,83,0,178,22,22,7,0,15,0,0,0,0,25309
7882,7420,982,2282,2162,1092,902,596,158,132,32,0,100,26,8,0,0,8,18,0,12,6,438,398,116,19,263,40,33,9,11,13,7,7,0,0,25311
7883,10321,1716,4865,2214,1101,425,527,380,333,25,13,295,47,29,0,29,0,18,8,0,10,147,121,45,14,62,26,9,0,0,9,17,16,0,1,25312
7884,8812,913,3128,2153,1753,865,631,272,249,34,34,181,23,15,15,0,0,8,0,0,8,359,265,99,14,152,94,47,47,0,0,47,46,0,1,25313
7885,11410,592,1965,2040,3342,3471,797,420,363,67,11,285,57,22,11,11,0,35,0,19,16,377,366,113,41,212,11,0,0,0,0,11,0,11,0,25314
7886,2352,449,1158,530,169,46,158,85,46,12,4,30,39,32,25,7,0,7,0,0,7,73,69,10,0,59,4,4,4,0,0,0,0,0,0,25315
7887,4675,617,2155,1218,386,299,199,97,97,29,0,68,0,0,0,0,0,0,0,0,0,102,75,23,16,36,27,27,0,27,0,0,0,0,0,25320
7888,9789,1579,3955,2334,1161,760,758,308,264,25,35,204,44,31,8,23,0,13,0,13,0,450,383,127,54,202,67,39,28,11,0,28,28,0,0,25401
7889,8693,958,2484,2766,1712,773,622,264,162,1,66,95,102,85,42,29,14,17,17,0,0,358,346,155,22,169,12,12,12,0,0,0,0,0,0,25403
7890,14291,2374,5475,3888,1571,983,973,524,331,49,72,210,193,90,29,34,27,103,18,44,41,449,364,78,41,245,85,40,32,0,8,45,0,31,14,25404
7891,7847,1000,3001,2308,956,582,744,401,232,78,22,132,169,143,131,12,0,26,26,0,0,343,242,13,81,148,101,77,0,0,77,24,0,24,0,25405
7892,9327,1563,4269,1883,1008,604,735,308,261,38,22,201,47,39,23,16,0,8,8,0,0,427,299,78,0,221,128,128,24,104,0,0,0,0,0,25411
7893,5410,1019,2064,1626,510,191,248,139,96,22,0,74,43,43,0,0,43,0,0,0,0,109,101,15,12,74,8,8,0,8,0,0,0,0,0,25413
7894,11853,1141,3512,3498,2370,1332,623,339,278,57,62,159,61,0,0,0,0,61,0,52,9,284,229,87,28,114,55,54,18,36,0,1,0,0,1,25414
7895,6507,1076,2412,1687,875,457,379,156,101,30,0,71,55,55,24,0,31,0,0,0,0,223,114,55,0,59,109,75,19,0,56,34,34,0,0,25419
7896,2959,357,1158,1016,256,172,166,115,98,17,68,13,17,17,17,0,0,0,0,0,0,51,30,14,0,16,21,21,0,21,0,0,0,0,0,25420
7897,1491,373,659,279,123,57,12,12,0,0,0,0,12,6,0,0,6,6,0,6,0,0,0,0,0,0,0,0,0,0,0,0,0,0,0,25422
7898,8930,994,2662,2845,1554,875,455,208,173,32,33,108,35,35,15,20,0,0,0,0,0,247,224,34,18,172,23,23,7,0,16,0,0,0,0,25425
7899,9042,1260,3596,2248,1098,840,648,328,274,25,2,247,54,23,0,23,0,31,0,0,31,320,217,91,26,100,103,65,9,30,26,38,0,0,38,25427
7900,6728,507,3142,1829,760,490,373,141,119,41,10,68,22,22,22,0,0,0,0,0,0,232,200,89,13,98,32,14,14,0,0,18,18,0,0,25428
7901,6031,1111,2619,1307,703,291,420,130,105,54,0,51,25,10,0,10,0,15,0,0,15,290,244,105,40,99,46,0,0,0,0,46,8,12,26,25430
7902,190,76,100,0,0,14,10,0,0,0,0,0,0,0,0,0,0,0,0,0,0,10,0,0,0,0,10,10,0,10,0,0,0,0,0,25431
7903,74,4,38,32,0,0,0,0,0,0,0,0,0,0,0,0,0,0,0,0,0,0,0,0,0,0,0,0,0,0,0,0,0,0,0,25432
7904,1962,448,1197,287,21,9,101,10,10,0,0,10,0,0,0,0,0,0,0,0,0,91,77,0,0,77,14,14,14,0,0,0,0,0,0,25434
7905,186,57,121,8,0,0,0,0,0,0,0,0,0,0,0,0,0,0,0,0,0,0,0,0,0,0,0,0,0,0,0,0,0,0,0,25437
7906,4108,697,1824,900,503,184,391,256,205,20,0,185,51,41,7,16,18,10,10,0,0,135,92,14,30,48,43,33,33,0,0,10,0,10,0,25438
7907,1095,207,242,245,161,240,157,97,88,0,0,88,9,9,9,0,0,0,0,0,0,60,60,10,0,50,0,0,0,0,0,0,0,0,0,25442
7908,4078,284,720,1397,863,814,1158,560,544,140,67,337,16,0,0,0,0,16,0,0,16,598,589,138,42,409,9,9,9,0,0,0,0,0,0,25443
7909,227,33,134,48,0,12,0,0,0,0,0,0,0,0,0,0,0,0,0,0,0,0,0,0,0,0,0,0,0,0,0,0,0,0,0,25444
7910,1165,162,568,228,89,118,32,10,10,0,0,10,0,0,0,0,0,0,0,0,0,22,22,0,12,10,0,0,0,0,0,0,0,0,0,25446
7911,860,279,324,207,27,23,51,32,24,0,0,24,8,0,0,0,0,8,8,0,0,19,19,0,0,19,0,0,0,0,0,0,0,0,0,25501
7912,844,160,396,252,29,7,36,0,0,0,0,0,0,0,0,0,0,0,0,0,0,36,36,0,0,36,0,0,0,0,0,0,0,0,0,25502
7913,287,62,126,85,14,0,10,10,10,0,0,10,0,0,0,0,0,0,0,0,0,0,0,0,0,0,0,0,0,0,0,0,0,0,0,25503
7914,9160,1400,3050,2751,1310,649,753,273,186,84,0,102,87,26,24,0,2,61,12,0,49,480,398,100,15,283,82,82,33,49,0,0,0,0,0,25504
7915,492,128,187,138,39,0,30,0,0,0,0,0,0,0,0,0,0,0,0,0,0,30,0,0,0,0,30,30,30,0,0,0,0,0,0,25505
7916,2804,914,1302,446,96,46,321,141,102,0,13,89,39,10,0,10,0,29,0,0,29,180,54,28,14,12,126,88,0,0,88,38,0,0,38,25506
7917,738,212,215,202,74,35,51,34,34,0,16,18,0,0,0,0,0,0,0,0,0,17,5,3,0,2,12,12,0,0,12,0,0,0,0,25507
7918,6801,1488,2935,1731,438,209,448,241,199,27,0,172,42,42,0,42,0,0,0,0,0,207,138,16,24,98,69,69,0,15,54,0,0,0,0,25508
7919,3543,455,1333,858,584,313,162,83,63,38,0,25,20,20,0,0,20,0,0,0,0,79,71,23,0,48,8,8,8,0,0,0,0,0,0,25510
7920,715,286,346,48,35,0,8,8,8,0,0,8,0,0,0,0,0,0,0,0,0,0,0,0,0,0,0,0,0,0,0,0,0,0,0,25511
7921,809,349,298,121,35,6,14,14,14,0,0,14,0,0,0,0,0,0,0,0,0,0,0,0,0,0,0,0,0,0,0,0,0,0,0,25512
7922,2449,637,1145,501,111,55,89,46,35,3,0,32,11,11,0,2,9,0,0,0,0,43,41,6,0,35,2,2,0,0,2,0,0,0,0,25514
7923,1743,269,795,525,149,5,235,113,113,0,21,92,0,0,0,0,0,0,0,0,0,122,70,0,0,70,52,52,0,17,35,0,0,0,0,25515
7924,1961,794,881,249,21,16,268,136,106,0,0,106,30,24,19,0,5,6,0,6,0,132,123,0,0,123,9,9,0,0,9,0,0,0,0,25517
7925,1017,326,501,156,12,22,84,48,12,0,0,12,36,25,25,0,0,11,0,0,11,36,36,0,0,36,0,0,0,0,0,0,0,0,0,25520
7926,604,169,339,66,0,30,34,0,0,0,0,0,0,0,0,0,0,0,0,0,0,34,0,0,0,0,34,34,0,0,34,0,0,0,0,25521
7927,2246,359,884,578,248,177,142,60,44,11,7,26,16,16,0,3,13,0,0,0,0,82,66,5,5,56,16,16,0,0,16,0,0,0,0,25523
7928,2188,595,824,603,52,114,158,72,52,24,0,28,20,12,0,0,12,8,8,0,0,86,86,0,0,86,0,0,0,0,0,0,0,0,0,25524
7929,14960,1575,4862,4094,2812,1617,1086,634,451,194,29,228,183,160,109,13,38,23,23,0,0,452,430,138,18,274,22,22,10,0,12,0,0,0,0,25526
7930,1044,347,545,74,78,0,63,32,32,0,0,32,0,0,0,0,0,0,0,0,0,31,31,0,0,31,0,0,0,0,0,0,0,0,0,25529
7931,3862,588,1516,1292,321,145,230,72,72,26,14,32,0,0,0,0,0,0,0,0,0,158,100,36,0,64,58,58,10,0,48,0,0,0,0,25530
7932,231,75,70,71,15,0,7,7,7,0,0,7,0,0,0,0,0,0,0,0,0,0,0,0,0,0,0,0,0,0,0,0,0,0,0,25534
7933,1961,214,730,601,301,115,180,102,89,0,40,49,13,0,0,0,0,13,13,0,0,78,78,0,0,78,0,0,0,0,0,0,0,0,0,25535
7934,1332,331,526,339,55,81,73,26,26,0,13,13,0,0,0,0,0,0,0,0,0,47,19,13,0,6,28,28,12,0,16,0,0,0,0,25537
7935,190,61,99,30,0,0,7,7,7,7,0,0,0,0,0,0,0,0,0,0,0,0,0,0,0,0,0,0,0,0,0,0,0,0,0,25540
7936,6345,650,2678,1641,773,603,309,170,105,58,16,31,65,47,47,0,0,18,0,0,18,139,125,78,0,47,14,14,6,8,0,0,0,0,0,25541
7937,3617,493,1502,1005,396,221,299,135,135,0,0,135,0,0,0,0,0,0,0,0,0,164,85,21,6,58,79,79,79,0,0,0,0,0,0,25545
7938,798,133,353,248,64,0,138,8,8,0,0,8,0,0,0,0,0,0,0,0,0,130,130,0,0,130,0,0,0,0,0,0,0,0,0,25547
7939,6436,1068,2594,2032,472,270,442,315,315,3,30,282,0,0,0,0,0,0,0,0,0,127,116,3,0,113,11,0,0,0,0,11,0,0,11,25550
7940,1485,316,673,350,68,78,73,32,32,0,0,32,0,0,0,0,0,0,0,0,0,41,41,27,0,14,0,0,0,0,0,0,0,0,0,25555
7941,1148,374,412,264,32,66,89,17,8,0,0,8,9,9,9,0,0,0,0,0,0,72,14,14,0,0,58,14,0,0,14,44,0,0,44,25557
7942,1538,191,819,388,109,31,51,51,39,0,0,39,12,0,0,0,0,12,0,0,12,0,0,0,0,0,0,0,0,0,0,0,0,0,0,25559
7943,5848,424,1901,1627,1039,857,422,228,194,30,45,119,34,34,0,0,34,0,0,0,0,194,177,83,0,94,17,17,0,0,17,0,0,0,0,25560
7944,804,187,284,311,0,22,32,32,32,0,0,32,0,0,0,0,0,0,0,0,0,0,0,0,0,0,0,0,0,0,0,0,0,0,0,25564
7945,402,65,201,108,11,17,15,0,0,0,0,0,0,0,0,0,0,0,0,0,0,15,15,0,0,15,0,0,0,0,0,0,0,0,0,25565
7946,722,202,350,83,38,49,35,16,0,0,0,0,16,16,6,10,0,0,0,0,0,19,0,0,0,0,19,0,0,0,0,19,0,0,19,25567
7947,4676,1377,2061,922,221,95,326,102,92,0,0,92,10,7,7,0,0,3,0,0,3,224,167,22,0,145,57,41,0,6,35,16,0,16,0,25570
7948,1684,442,730,429,57,26,156,60,57,0,0,57,3,3,3,0,0,0,0,0,0,96,96,51,0,45,0,0,0,0,0,0,0,0,0,25571
7949,874,206,452,196,0,20,0,0,0,0,0,0,0,0,0,0,0,0,0,0,0,0,0,0,0,0,0,0,0,0,0,0,0,0,0,25573
7950,4057,938,1574,1023,352,170,227,165,105,2,0,103,60,43,22,21,0,17,0,0,17,62,54,21,2,31,8,8,0,0,8,0,0,0,0,25601
7951,455,63,250,105,14,23,54,35,29,0,0,29,6,0,0,0,0,6,0,0,6,19,0,0,0,0,19,0,0,0,0,19,0,0,19,25606
7952,572,93,313,141,18,7,47,8,8,0,5,3,0,0,0,0,0,0,0,0,0,39,27,9,0,18,12,12,0,0,12,0,0,0,0,25607
7953,890,365,318,165,25,17,12,0,0,0,0,0,0,0,0,0,0,0,0,0,0,12,12,0,0,12,0,0,0,0,0,0,0,0,0,25608
7954,475,150,137,172,16,0,0,0,0,0,0,0,0,0,0,0,0,0,0,0,0,0,0,0,0,0,0,0,0,0,0,0,0,0,0,25611
7955,583,193,232,75,25,58,31,31,18,18,0,0,13,0,0,0,0,13,0,13,0,0,0,0,0,0,0,0,0,0,0,0,0,0,0,25617
7956,1668,521,695,311,70,71,88,17,0,0,0,0,17,17,0,0,17,0,0,0,0,71,54,4,2,48,17,15,0,0,15,2,0,0,2,25621
7957,157,43,91,23,0,0,0,0,0,0,0,0,0,0,0,0,0,0,0,0,0,0,0,0,0,0,0,0,0,0,0,0,0,0,0,25624
7958,1146,269,289,483,94,11,52,41,41,0,0,41,0,0,0,0,0,0,0,0,0,11,11,0,0,11,0,0,0,0,0,0,0,0,0,25625
7959,398,94,213,66,25,0,0,0,0,0,0,0,0,0,0,0,0,0,0,0,0,0,0,0,0,0,0,0,0,0,0,0,0,0,0,25628
7960,566,168,262,108,28,0,64,52,47,0,0,47,5,0,0,0,0,5,5,0,0,12,12,0,0,12,0,0,0,0,0,0,0,0,0,25630
7961,653,233,309,66,45,0,18,18,18,0,0,18,0,0,0,0,0,0,0,0,0,0,0,0,0,0,0,0,0,0,0,0,0,0,0,25632
7962,781,235,254,198,32,62,53,36,0,0,0,0,36,36,36,0,0,0,0,0,0,17,17,0,0,17,0,0,0,0,0,0,0,0,0,25634
7963,1106,218,433,309,57,89,39,37,22,0,0,22,15,15,0,0,15,0,0,0,0,2,0,0,0,0,2,2,0,0,2,0,0,0,0,25635
7964,617,117,231,206,63,0,28,28,28,18,0,10,0,0,0,0,0,0,0,0,0,0,0,0,0,0,0,0,0,0,0,0,0,0,0,25637
7965,1122,279,463,304,76,0,69,47,47,19,0,28,0,0,0,0,0,0,0,0,0,22,22,22,0,0,0,0,0,0,0,0,0,0,0,25638
7966,400,62,293,45,0,0,0,0,0,0,0,0,0,0,0,0,0,0,0,0,0,0,0,0,0,0,0,0,0,0,0,0,0,0,0,25639
7967,245,80,128,37,0,0,26,5,5,5,0,0,0,0,0,0,0,0,0,0,0,21,11,0,0,11,10,0,0,0,0,10,0,10,0,25644
7968,743,86,282,233,74,68,20,20,20,0,0,20,0,0,0,0,0,0,0,0,0,0,0,0,0,0,0,0,0,0,0,0,0,0,0,25646
7969,467,180,181,81,0,25,17,8,0,0,0,0,8,8,8,0,0,0,0,0,0,9,9,0,0,9,0,0,0,0,0,0,0,0,0,25647
7970,679,233,228,123,41,54,33,33,33,17,0,16,0,0,0,0,0,0,0,0,0,0,0,0,0,0,0,0,0,0,0,0,0,0,0,25649
7971,537,164,261,95,17,0,16,7,0,0,0,0,7,7,0,7,0,0,0,0,0,9,9,0,0,9,0,0,0,0,0,0,0,0,0,25650
7972,390,259,88,19,12,12,31,13,0,0,0,0,13,13,13,0,0,0,0,0,0,18,18,0,18,0,0,0,0,0,0,0,0,0,0,25651
7973,938,279,441,209,0,9,37,0,0,0,0,0,0,0,0,0,0,0,0,0,0,37,37,25,0,12,0,0,0,0,0,0,0,0,0,25652
7974,574,93,251,123,36,71,24,0,0,0,0,0,0,0,0,0,0,0,0,0,0,24,24,0,0,24,0,0,0,0,0,0,0,0,0,25653
7975,142,57,50,31,4,0,0,0,0,0,0,0,0,0,0,0,0,0,0,0,0,0,0,0,0,0,0,0,0,0,0,0,0,0,0,25654
7976,4650,889,1607,1225,396,533,238,114,105,0,0,105,9,9,9,0,0,0,0,0,0,124,99,12,27,60,25,14,0,0,14,11,0,0,11,25661
7977,668,210,249,128,81,0,67,30,0,0,0,0,30,15,0,15,0,15,0,0,15,37,37,0,0,37,0,0,0,0,0,0,0,0,0,25666
7978,682,319,235,128,0,0,112,105,70,70,0,0,35,35,35,0,0,0,0,0,0,7,7,0,0,7,0,0,0,0,0,0,0,0,0,25669
7979,4585,987,2255,1003,283,57,331,173,138,26,5,107,35,35,23,12,0,0,0,0,0,158,148,19,10,119,10,4,0,0,4,6,0,6,0,25670
7980,913,339,280,208,73,13,27,27,0,0,0,0,27,16,16,0,0,11,0,0,11,0,0,0,0,0,0,0,0,0,0,0,0,0,0,25671
7981,169,66,59,15,0,29,34,34,34,0,0,34,0,0,0,0,0,0,0,0,0,0,0,0,0,0,0,0,0,0,0,0,0,0,0,25672
7982,1520,391,828,196,32,73,85,29,28,0,2,26,1,1,1,0,0,0,0,0,0,56,55,0,0,55,1,0,0,0,0,1,0,0,1,25674
7983,748,321,286,134,7,0,77,39,39,0,0,39,0,0,0,0,0,0,0,0,0,38,25,0,0,25,13,13,0,0,13,0,0,0,0,25676
7984,1090,304,394,273,93,26,87,32,24,4,0,20,8,8,8,0,0,0,0,0,0,55,51,3,3,45,4,4,0,0,4,0,0,0,0,25678
7985,277,78,110,54,0,35,0,0,0,0,0,0,0,0,0,0,0,0,0,0,0,0,0,0,0,0,0,0,0,0,0,0,0,0,0,25688
7986,194,44,90,60,0,0,14,0,0,0,0,0,0,0,0,0,0,0,0,0,0,14,0,0,0,0,14,14,14,0,0,0,0,0,0,25690
7987,532,168,255,73,36,0,11,11,11,0,0,11,0,0,0,0,0,0,0,0,0,0,0,0,0,0,0,0,0,0,0,0,0,0,0,25692
7988,32,0,11,13,0,8,10,0,0,0,0,0,0,0,0,0,0,0,0,0,0,10,10,0,0,10,0,0,0,0,0,0,0,0,0,25696
7989,70,47,23,0,0,0,10,10,0,0,0,0,10,10,0,10,0,0,0,0,0,0,0,0,0,0,0,0,0,0,0,0,0,0,0,25699
7990,16486,1916,4068,4321,3069,3112,1297,776,692,171,50,471,84,31,0,23,8,53,17,0,36,521,412,199,0,213,109,60,5,0,55,49,26,0,23,25701
7991,5833,1389,1896,1737,516,295,259,90,90,0,0,90,0,0,0,0,0,0,0,0,0,169,147,66,0,81,22,11,11,0,0,11,0,0,11,25702
7992,2372,516,726,801,227,102,1380,629,545,83,13,449,84,22,0,0,22,62,0,0,62,751,737,228,20,489,14,0,0,0,0,14,0,0,14,25703
7993,11435,1532,4163,3986,1042,712,748,479,425,136,18,271,54,30,24,6,0,24,0,24,0,269,241,26,35,180,28,17,0,6,11,11,1,0,10,25704
7994,14500,1347,4498,3893,2603,2159,918,503,407,36,32,339,96,46,20,19,7,50,0,27,23,415,304,88,19,197,111,42,42,0,0,69,0,32,37,25705
7995,24485,3787,9146,6714,3159,1679,1372,649,468,137,26,305,181,123,84,0,39,58,4,0,54,723,472,150,3,319,251,216,80,30,106,35,27,0,8,25801
7996,175,126,49,0,0,0,0,0,0,0,0,0,0,0,0,0,0,0,0,0,0,0,0,0,0,0,0,0,0,0,0,0,0,0,0,25810
7997,184,96,16,72,0,0,0,0,0,0,0,0,0,0,0,0,0,0,0,0,0,0,0,0,0,0,0,0,0,0,0,0,0,0,0,25811
7998,1487,267,786,252,127,55,103,74,74,9,0,65,0,0,0,0,0,0,0,0,0,29,23,0,0,23,6,3,3,0,0,3,0,0,3,25812
7999,6069,1538,2365,1360,548,258,191,95,46,26,1,19,49,38,17,12,9,11,0,0,11,96,70,45,0,25,26,7,7,0,0,19,0,0,19,25813
8000,427,0,238,101,70,18,44,36,36,0,0,36,0,0,0,0,0,0,0,0,0,8,8,8,0,0,0,0,0,0,0,0,0,0,0,25817
8001,362,55,166,40,101,0,0,0,0,0,0,0,0,0,0,0,0,0,0,0,0,0,0,0,0,0,0,0,0,0,0,0,0,0,0,25818
8002,336,131,120,41,9,35,48,48,0,0,0,0,48,18,18,0,0,30,0,0,30,0,0,0,0,0,0,0,0,0,0,0,0,0,0,25820
8003,1615,325,899,289,66,36,180,60,60,37,0,23,0,0,0,0,0,0,0,0,0,120,120,20,0,100,0,0,0,0,0,0,0,0,0,25823
8004,1566,308,676,337,98,147,80,13,0,0,0,0,13,13,0,13,0,0,0,0,0,67,44,17,0,27,23,23,11,0,12,0,0,0,0,25825
8005,107,0,54,37,16,0,22,0,0,0,0,0,0,0,0,0,0,0,0,0,0,22,22,0,0,22,0,0,0,0,0,0,0,0,0,25826
8006,2002,298,809,477,248,170,40,40,32,11,0,21,8,8,0,8,0,0,0,0,0,0,0,0,0,0,0,0,0,0,0,0,0,0,0,25827
8007,916,357,428,115,0,16,17,0,0,0,0,0,0,0,0,0,0,0,0,0,0,17,0,0,0,0,17,0,0,0,0,17,0,0,17,25831
8008,3250,398,834,1054,535,429,120,32,25,0,0,25,7,0,0,0,0,7,7,0,0,88,88,63,0,25,0,0,0,0,0,0,0,0,0,25832
8009,204,94,61,32,17,0,15,0,0,0,0,0,0,0,0,0,0,0,0,0,0,15,0,0,0,0,15,15,15,0,0,0,0,0,0,25836
8010,158,64,77,0,0,17,21,0,0,0,0,0,0,0,0,0,0,0,0,0,0,21,12,0,0,12,9,9,9,0,0,0,0,0,0,25837
8011,462,160,164,82,56,0,14,14,14,0,0,14,0,0,0,0,0,0,0,0,0,0,0,0,0,0,0,0,0,0,0,0,0,0,0,25839
8012,5688,900,2199,1385,723,481,278,150,150,0,0,150,0,0,0,0,0,0,0,0,0,128,111,16,0,95,17,17,0,17,0,0,0,0,0,25840
8013,580,79,278,177,46,0,0,0,0,0,0,0,0,0,0,0,0,0,0,0,0,0,0,0,0,0,0,0,0,0,0,0,0,0,0,25841
8014,707,48,283,216,160,0,40,13,13,13,0,0,0,0,0,0,0,0,0,0,0,27,0,0,0,0,27,0,0,0,0,27,0,27,0,25843
8015,1108,315,451,300,13,29,161,83,65,6,0,59,18,0,0,0,0,18,0,0,18,78,58,0,0,58,20,20,0,0,20,0,0,0,0,25844
8016,543,216,179,97,51,0,46,32,27,27,0,0,5,5,5,0,0,0,0,0,0,14,0,0,0,0,14,14,0,0,14,0,0,0,0,25845
8017,388,69,259,46,14,0,13,0,0,0,0,0,0,0,0,0,0,0,0,0,0,13,13,0,0,13,0,0,0,0,0,0,0,0,0,25846
8018,378,147,209,16,0,6,11,4,4,0,0,4,0,0,0,0,0,0,0,0,0,7,7,0,0,7,0,0,0,0,0,0,0,0,0,25848
8019,387,90,128,43,81,45,0,0,0,0,0,0,0,0,0,0,0,0,0,0,0,0,0,0,0,0,0,0,0,0,0,0,0,0,0,25849
8020,125,68,57,0,0,0,0,0,0,0,0,0,0,0,0,0,0,0,0,0,0,0,0,0,0,0,0,0,0,0,0,0,0,0,0,25853
8021,1052,133,445,301,139,34,88,27,27,0,14,13,0,0,0,0,0,0,0,0,0,61,61,7,15,39,0,0,0,0,0,0,0,0,0,25854
8022,205,138,31,20,16,0,0,0,0,0,0,0,0,0,0,0,0,0,0,0,0,0,0,0,0,0,0,0,0,0,0,0,0,0,0,25855
8023,292,127,123,42,0,0,58,58,58,0,0,58,0,0,0,0,0,0,0,0,0,0,0,0,0,0,0,0,0,0,0,0,0,0,0,25857
8024,171,13,129,14,0,15,11,11,11,0,11,0,0,0,0,0,0,0,0,0,0,0,0,0,0,0,0,0,0,0,0,0,0,0,0,25862
8025,133,20,70,43,0,0,0,0,0,0,0,0,0,0,0,0,0,0,0,0,0,0,0,0,0,0,0,0,0,0,0,0,0,0,0,25864
8026,984,208,405,174,123,74,58,20,12,0,0,12,8,2,0,2,0,6,0,0,6,38,38,0,0,38,0,0,0,0,0,0,0,0,0,25865
8027,389,31,209,119,11,19,40,0,0,0,0,0,0,0,0,0,0,0,0,0,0,40,0,0,0,0,40,0,0,0,0,40,40,0,0,25868
8028,80,17,63,0,0,0,0,0,0,0,0,0,0,0,0,0,0,0,0,0,0,0,0,0,0,0,0,0,0,0,0,0,0,0,0,25870
8029,369,71,186,64,15,33,43,20,15,0,5,10,5,5,5,0,0,0,0,0,0,23,0,0,0,0,23,9,3,6,0,14,7,0,7,25871
8030,580,115,374,26,20,45,35,7,0,0,0,0,7,7,0,0,7,0,0,0,0,28,28,0,0,28,0,0,0,0,0,0,0,0,0,25873
8031,356,45,164,89,58,0,7,0,0,0,0,0,0,0,0,0,0,0,0,0,0,7,7,0,0,7,0,0,0,0,0,0,0,0,0,25875
8032,136,0,84,29,12,11,10,10,10,0,0,10,0,0,0,0,0,0,0,0,0,0,0,0,0,0,0,0,0,0,0,0,0,0,0,25876
8033,603,113,367,103,9,11,34,22,22,0,0,22,0,0,0,0,0,0,0,0,0,12,12,12,0,0,0,0,0,0,0,0,0,0,0,25878
8034,438,230,89,94,25,0,44,44,44,0,31,13,0,0,0,0,0,0,0,0,0,0,0,0,0,0,0,0,0,0,0,0,0,0,0,25879
8035,4395,792,1844,1177,379,203,387,199,161,21,35,105,38,20,20,0,0,18,18,0,0,188,185,59,7,119,3,2,0,0,2,1,1,0,0,25880
8036,1918,271,845,455,210,137,141,61,58,0,3,55,3,3,3,0,0,0,0,0,0,80,63,8,0,55,17,17,2,15,0,0,0,0,0,25882
8037,7825,1741,3175,1867,709,333,454,245,200,0,49,151,45,39,15,0,24,6,6,0,0,209,130,11,27,92,79,61,61,0,0,18,0,0,18,25901
8038,314,181,85,48,0,0,19,0,0,0,0,0,0,0,0,0,0,0,0,0,0,19,19,19,0,0,0,0,0,0,0,0,0,0,0,25902
8039,228,0,142,80,6,0,5,5,5,0,0,5,0,0,0,0,0,0,0,0,0,0,0,0,0,0,0,0,0,0,0,0,0,0,0,25904
8040,325,23,168,66,59,9,0,0,0,0,0,0,0,0,0,0,0,0,0,0,0,0,0,0,0,0,0,0,0,0,0,0,0,0,0,25906
8041,118,0,52,53,13,0,13,13,13,13,0,0,0,0,0,0,0,0,0,0,0,0,0,0,0,0,0,0,0,0,0,0,0,0,0,25907
8042,32,0,17,15,0,0,0,0,0,0,0,0,0,0,0,0,0,0,0,0,0,0,0,0,0,0,0,0,0,0,0,0,0,0,0,25908
8043,14,0,8,6,0,0,0,0,0,0,0,0,0,0,0,0,0,0,0,0,0,0,0,0,0,0,0,0,0,0,0,0,0,0,0,25911
8044,233,53,105,75,0,0,54,9,9,0,0,9,0,0,0,0,0,0,0,0,0,45,45,0,0,45,0,0,0,0,0,0,0,0,0,25913
8045,190,96,55,31,6,2,23,7,5,0,0,5,2,0,0,0,0,2,0,0,2,16,12,11,0,1,4,4,4,0,0,0,0,0,0,25915
8046,121,32,89,0,0,0,21,5,5,0,0,5,0,0,0,0,0,0,0,0,0,16,16,0,0,16,0,0,0,0,0,0,0,0,0,25916
8047,1400,312,739,281,57,11,10,10,10,5,0,5,0,0,0,0,0,0,0,0,0,0,0,0,0,0,0,0,0,0,0,0,0,0,0,25917
8048,2907,519,1375,592,277,144,173,110,43,13,0,30,67,67,56,11,0,0,0,0,0,63,35,28,7,0,28,28,28,0,0,0,0,0,0,25918
8049,189,73,116,0,0,0,22,0,0,0,0,0,0,0,0,0,0,0,0,0,0,22,0,0,0,0,22,0,0,0,0,22,0,0,22,25920
8050,1193,232,605,258,66,32,156,87,72,7,0,65,15,4,4,0,0,11,0,4,7,69,57,19,26,12,12,4,4,0,0,8,8,0,0,25921
8051,179,23,60,35,41,20,9,9,9,0,0,9,0,0,0,0,0,0,0,0,0,0,0,0,0,0,0,0,0,0,0,0,0,0,0,25922
8052,299,97,177,25,0,0,34,9,9,0,0,9,0,0,0,0,0,0,0,0,0,25,25,0,0,25,0,0,0,0,0,0,0,0,0,25928
8053,87,0,39,0,18,30,0,0,0,0,0,0,0,0,0,0,0,0,0,0,0,0,0,0,0,0,0,0,0,0,0,0,0,0,0,25932
8054,16,9,0,3,4,0,11,5,5,0,0,5,0,0,0,0,0,0,0,0,0,6,0,0,0,0,6,6,0,0,6,0,0,0,0,25936
8055,801,183,363,171,72,12,77,64,43,0,0,43,21,21,0,0,21,0,0,0,0,13,0,0,0,0,13,13,0,0,13,0,0,0,0,25938
8056,71,26,45,0,0,0,0,0,0,0,0,0,0,0,0,0,0,0,0,0,0,0,0,0,0,0,0,0,0,0,0,0,0,0,0,25942
8057,4588,1182,1981,837,373,215,215,108,78,0,0,78,30,30,0,30,0,0,0,0,0,107,39,0,0,39,68,9,9,0,0,59,16,0,43,25951
8058,612,135,188,188,79,22,51,14,14,0,0,14,0,0,0,0,0,0,0,0,0,37,37,0,0,37,0,0,0,0,0,0,0,0,0,25958
8059,2774,598,1266,640,177,93,225,129,83,0,4,79,46,42,18,0,24,4,0,0,4,96,78,44,3,31,18,18,0,14,4,0,0,0,0,25962
8060,858,259,270,258,49,22,57,24,24,0,0,24,0,0,0,0,0,0,0,0,0,33,23,0,0,23,10,10,0,10,0,0,0,0,0,25969
8061,828,131,265,271,106,55,34,34,0,0,0,0,34,34,34,0,0,0,0,0,0,0,0,0,0,0,0,0,0,0,0,0,0,0,0,25971
8062,200,64,82,40,0,14,0,0,0,0,0,0,0,0,0,0,0,0,0,0,0,0,0,0,0,0,0,0,0,0,0,0,0,0,0,25972
8063,1673,423,783,251,123,93,139,56,52,1,0,51,4,4,4,0,0,0,0,0,0,83,63,1,0,62,20,20,0,0,20,0,0,0,0,25976
8064,117,13,104,0,0,0,0,0,0,0,0,0,0,0,0,0,0,0,0,0,0,0,0,0,0,0,0,0,0,0,0,0,0,0,0,25977
8065,490,81,276,110,0,23,36,16,16,0,0,16,0,0,0,0,0,0,0,0,0,20,10,0,0,10,10,10,10,0,0,0,0,0,0,25978
8066,473,27,247,107,67,25,19,19,10,0,0,10,9,9,9,0,0,0,0,0,0,0,0,0,0,0,0,0,0,0,0,0,0,0,0,25979
8067,787,175,326,192,4,90,129,73,53,38,3,12,20,20,3,0,17,0,0,0,0,56,41,0,15,26,15,0,0,0,0,15,15,0,0,25981
8068,1497,298,784,228,162,25,68,38,17,9,0,8,21,3,0,0,3,18,0,0,18,30,9,0,0,9,21,9,0,0,9,12,0,0,12,25984
8069,255,74,132,31,9,9,0,0,0,0,0,0,0,0,0,0,0,0,0,0,0,0,0,0,0,0,0,0,0,0,0,0,0,0,0,25985
8070,234,45,93,69,27,0,0,0,0,0,0,0,0,0,0,0,0,0,0,0,0,0,0,0,0,0,0,0,0,0,0,0,0,0,0,25989
8071,30524,2584,11036,8140,5514,3250,2306,1294,1124,307,51,766,170,80,53,27,0,90,7,0,83,1012,922,351,53,518,90,52,12,3,37,38,16,22,0,26003
8072,439,61,241,98,37,2,40,23,23,10,7,6,0,0,0,0,0,0,0,0,0,17,17,6,11,0,0,0,0,0,0,0,0,0,0,26030
8073,1125,159,548,308,96,14,63,47,32,2,4,26,15,9,4,5,0,6,4,0,2,16,16,4,0,12,0,0,0,0,0,0,0,0,0,26031
8074,463,34,132,119,69,109,614,355,355,95,16,244,0,0,0,0,0,0,0,0,0,259,259,53,22,184,0,0,0,0,0,0,0,0,0,26032
8075,1992,321,1024,416,175,56,102,63,63,0,0,63,0,0,0,0,0,0,0,0,0,39,16,0,0,16,23,23,0,17,6,0,0,0,0,26033
8076,3558,555,1531,1126,288,58,212,50,50,0,0,50,0,0,0,0,0,0,0,0,0,162,140,20,16,104,22,22,22,0,0,0,0,0,0,26034
8077,1881,145,938,502,171,125,178,124,109,22,0,87,15,0,0,0,0,15,0,15,0,54,22,0,0,22,32,32,0,0,32,0,0,0,0,26035
8078,368,100,130,87,43,8,7,0,0,0,0,0,0,0,0,0,0,0,0,0,0,7,7,0,0,7,0,0,0,0,0,0,0,0,0,26036
8079,5173,657,2357,1340,487,332,208,75,41,0,0,41,34,34,0,20,14,0,0,0,0,133,133,32,24,77,0,0,0,0,0,0,0,0,0,26037
8080,2291,128,783,723,334,323,144,61,61,48,2,11,0,0,0,0,0,0,0,0,0,83,83,28,0,55,0,0,0,0,0,0,0,0,0,26038
8081,622,47,372,150,22,31,60,32,32,0,0,32,0,0,0,0,0,0,0,0,0,28,28,0,0,28,0,0,0,0,0,0,0,0,0,26039
8082,1300,99,751,297,126,27,90,39,23,0,0,23,16,16,0,16,0,0,0,0,0,51,37,11,0,26,14,14,14,0,0,0,0,0,0,26040
8083,11823,1451,5563,3391,1057,361,661,343,315,117,17,181,28,28,28,0,0,0,0,0,0,318,237,76,14,147,81,53,48,0,5,28,0,0,28,26041
8084,4958,679,2276,1232,499,272,416,223,175,0,0,175,48,0,0,0,0,48,0,48,0,193,168,28,0,140,25,25,0,25,0,0,0,0,0,26047
8085,828,200,418,170,40,0,44,0,0,0,0,0,0,0,0,0,0,0,0,0,0,44,44,0,0,44,0,0,0,0,0,0,0,0,0,26050
8086,1333,311,662,306,47,7,45,24,14,0,0,14,10,10,10,0,0,0,0,0,0,21,10,0,0,10,11,11,11,0,0,0,0,0,0,26055
8087,171,0,92,54,25,0,4,0,0,0,0,0,0,0,0,0,0,0,0,0,0,4,4,0,0,4,0,0,0,0,0,0,0,0,0,26056
8088,2008,309,729,386,394,190,79,39,35,0,0,35,4,3,0,0,3,1,0,0,1,40,40,10,0,30,0,0,0,0,0,0,0,0,0,26059
8089,1153,82,584,283,134,70,199,122,104,8,0,96,18,18,0,0,18,0,0,0,0,77,62,16,0,46,15,15,12,0,3,0,0,0,0,26060
8090,15650,1535,6804,4478,2080,753,732,400,269,99,26,144,131,66,53,13,0,65,0,22,43,332,274,60,29,185,58,12,0,0,12,46,0,0,46,26062
8091,5944,574,2536,1793,696,345,386,208,161,6,12,143,47,40,22,0,18,7,0,0,7,178,166,65,9,92,12,12,6,6,0,0,0,0,0,26070
8092,260,21,72,108,47,12,438,30,30,11,0,19,0,0,0,0,0,0,0,0,0,408,404,202,14,188,4,4,4,0,0,0,0,0,0,26074
8093,365,36,171,122,36,0,21,19,17,3,0,14,2,0,0,0,0,2,0,0,2,2,2,0,0,2,0,0,0,0,0,0,0,0,0,26075
8094,20348,3103,8290,6457,1749,749,1296,604,512,131,83,298,92,80,0,55,25,12,0,7,5,692,548,171,56,321,144,121,42,69,10,23,0,23,0,26101
8095,13072,1242,4570,4217,1993,1050,726,313,240,55,0,185,73,31,0,20,11,42,42,0,0,413,323,86,32,205,90,39,39,0,0,51,13,0,38,26104
8096,8788,661,3044,2850,1435,798,517,300,254,95,17,142,46,46,25,21,0,0,0,0,0,217,181,38,12,131,36,0,0,0,0,36,0,0,36,26105
8097,1020,119,457,384,60,0,57,50,50,17,26,7,0,0,0,0,0,0,0,0,0,7,7,0,0,7,0,0,0,0,0,0,0,0,0,26133
8098,673,106,315,170,62,20,60,42,38,0,0,38,4,4,0,4,0,0,0,0,0,18,18,11,0,7,0,0,0,0,0,0,0,0,0,26134
8099,351,77,169,56,39,10,85,85,75,0,0,75,10,0,0,0,0,10,0,0,10,0,0,0,0,0,0,0,0,0,0,0,0,0,0,26136
8100,719,287,321,71,13,27,58,27,17,0,0,17,10,10,0,10,0,0,0,0,0,31,31,0,0,31,0,0,0,0,0,0,0,0,0,26137
8101,49,0,46,3,0,0,4,4,4,0,0,4,0,0,0,0,0,0,0,0,0,0,0,0,0,0,0,0,0,0,0,0,0,0,0,26138
8102,108,46,18,38,6,0,6,0,0,0,0,0,0,0,0,0,0,0,0,0,0,6,6,0,0,6,0,0,0,0,0,0,0,0,0,26141
8103,1561,167,575,557,167,95,283,220,189,0,39,150,31,0,0,0,0,31,0,31,0,63,63,12,17,34,0,0,0,0,0,0,0,0,0,26142
8104,3249,578,1471,886,208,106,285,102,93,4,0,89,9,9,0,9,0,0,0,0,0,183,77,0,7,70,106,49,28,0,21,57,0,25,32,26143
8105,655,43,309,264,39,0,18,5,0,0,0,0,5,5,5,0,0,0,0,0,0,13,9,0,0,9,4,4,0,4,0,0,0,0,0,26146
8106,1709,369,781,338,149,72,85,49,34,12,0,22,15,15,0,0,15,0,0,0,0,36,6,0,0,6,30,30,10,0,20,0,0,0,0,26147
8107,172,75,70,27,0,0,27,0,0,0,0,0,0,0,0,0,0,0,0,0,0,27,16,16,0,0,11,11,0,0,11,0,0,0,0,26148
8108,2055,393,966,558,58,80,143,71,38,0,0,38,33,4,0,4,0,29,0,0,29,72,62,6,16,40,10,10,0,0,10,0,0,0,0,26149
8109,4076,407,1462,1496,525,186,271,181,155,80,0,75,26,26,26,0,0,0,0,0,0,90,90,30,0,60,0,0,0,0,0,0,0,0,0,26150
8110,280,139,50,70,15,6,62,30,30,0,0,30,0,0,0,0,0,0,0,0,0,32,32,0,0,32,0,0,0,0,0,0,0,0,0,26151
8111,30,0,30,0,0,0,17,0,0,0,0,0,0,0,0,0,0,0,0,0,0,17,17,0,0,17,0,0,0,0,0,0,0,0,0,26152
8112,6362,946,3059,1593,467,297,410,160,142,29,7,106,18,8,8,0,0,10,0,0,10,250,179,16,0,163,71,57,0,24,33,14,0,0,14,26155
8113,1901,277,931,465,158,70,158,119,110,8,3,99,9,9,9,0,0,0,0,0,0,39,20,5,5,10,19,6,0,0,6,13,8,0,5,26159
8114,761,69,362,191,96,43,0,0,0,0,0,0,0,0,0,0,0,0,0,0,0,0,0,0,0,0,0,0,0,0,0,0,0,0,0,26160
8115,304,34,143,108,19,0,10,0,0,0,0,0,0,0,0,0,0,0,0,0,0,10,10,0,0,10,0,0,0,0,0,0,0,0,0,26161
8116,5833,605,2681,1537,593,417,436,222,192,19,11,162,30,30,25,5,0,0,0,0,0,214,173,94,0,79,41,0,0,0,0,41,15,0,26,26164
8117,749,83,435,198,23,10,67,44,12,0,0,12,32,32,16,0,16,0,0,0,0,23,23,0,0,23,0,0,0,0,0,0,0,0,0,26167
8118,643,83,297,170,8,85,17,17,8,8,0,0,9,9,9,0,0,0,0,0,0,0,0,0,0,0,0,0,0,0,0,0,0,0,0,26169
8119,4299,451,2071,1300,240,237,291,172,145,20,6,119,27,27,27,0,0,0,0,0,0,119,113,47,13,53,6,6,6,0,0,0,0,0,0,26170
8120,2401,260,1282,584,182,93,238,138,124,0,0,124,14,14,4,10,0,0,0,0,0,100,87,5,0,82,13,9,4,5,0,4,0,0,4,26175
8121,286,98,106,34,18,30,8,8,8,0,0,8,0,0,0,0,0,0,0,0,0,0,0,0,0,0,0,0,0,0,0,0,0,0,0,26178
8122,1231,292,475,398,31,35,90,68,68,13,0,55,0,0,0,0,0,0,0,0,0,22,22,0,0,22,0,0,0,0,0,0,0,0,0,26180
8123,4509,195,1648,1646,741,279,288,137,120,62,0,58,17,17,17,0,0,0,0,0,0,151,128,18,0,110,23,6,6,0,0,17,0,0,17,26181
8124,1677,371,602,584,88,32,167,73,73,23,17,33,0,0,0,0,0,0,0,0,0,94,94,0,0,94,0,0,0,0,0,0,0,0,0,26184
8125,4429,225,1252,1791,682,479,322,205,172,48,8,116,33,33,25,8,0,0,0,0,0,117,91,32,13,46,26,26,6,20,0,0,0,0,0,26187
8126,13410,2251,6160,2746,1260,993,1511,674,547,94,32,421,127,116,43,27,46,11,11,0,0,837,791,107,40,644,46,11,0,11,0,35,0,0,35,26201
8127,482,26,213,104,111,28,0,0,0,0,0,0,0,0,0,0,0,0,0,0,0,0,0,0,0,0,0,0,0,0,0,0,0,0,0,26202
8128,147,63,51,22,11,0,15,0,0,0,0,0,0,0,0,0,0,0,0,0,0,15,15,0,0,15,0,0,0,0,0,0,0,0,0,26203
8129,2078,422,1239,315,89,13,163,103,76,33,6,37,27,5,0,5,0,22,0,0,22,60,49,14,14,21,11,0,0,0,0,11,0,0,11,26205
8130,2007,430,1006,444,32,95,93,30,25,0,0,25,5,3,3,0,0,2,0,0,2,63,22,3,0,19,41,36,0,36,0,5,0,0,5,26206
8131,613,168,269,117,38,21,41,31,29,0,0,29,2,2,2,0,0,0,0,0,0,10,10,0,0,10,0,0,0,0,0,0,0,0,0,26208
8132,60,0,20,10,30,0,0,0,0,0,0,0,0,0,0,0,0,0,0,0,0,0,0,0,0,0,0,0,0,0,0,0,0,0,0,26209
8133,184,53,39,47,45,0,0,0,0,0,0,0,0,0,0,0,0,0,0,0,0,0,0,0,0,0,0,0,0,0,0,0,0,0,0,26215
8134,340,120,164,11,30,15,85,45,0,0,0,0,45,45,0,45,0,0,0,0,0,40,40,0,0,40,0,0,0,0,0,0,0,0,0,26217
8135,1664,336,944,242,90,52,90,74,63,7,0,56,11,11,11,0,0,0,0,0,0,16,16,0,0,16,0,0,0,0,0,0,0,0,0,26218
8136,262,75,88,56,17,26,4,0,0,0,0,0,0,0,0,0,0,0,0,0,0,4,4,0,0,4,0,0,0,0,0,0,0,0,0,26222
8137,204,49,131,16,8,0,0,0,0,0,0,0,0,0,0,0,0,0,0,0,0,0,0,0,0,0,0,0,0,0,0,0,0,0,0,26224
8138,50,9,25,0,16,0,0,0,0,0,0,0,0,0,0,0,0,0,0,0,0,0,0,0,0,0,0,0,0,0,0,0,0,0,0,26228
8139,112,8,74,17,13,0,0,0,0,0,0,0,0,0,0,0,0,0,0,0,0,0,0,0,0,0,0,0,0,0,0,0,0,0,0,26230
8140,1207,217,638,208,77,67,52,39,7,0,0,7,32,8,8,0,0,24,0,0,24,13,13,0,0,13,0,0,0,0,0,0,0,0,0,26234
8141,11,0,11,0,0,0,0,0,0,0,0,0,0,0,0,0,0,0,0,0,0,0,0,0,0,0,0,0,0,0,0,0,0,0,0,26236
8142,318,55,183,73,7,0,0,0,0,0,0,0,0,0,0,0,0,0,0,0,0,0,0,0,0,0,0,0,0,0,0,0,0,0,0,26237
8143,434,80,247,68,26,13,71,26,26,7,0,19,0,0,0,0,0,0,0,0,0,45,45,0,0,45,0,0,0,0,0,0,0,0,0,26238
8144,10460,1459,4603,1870,1522,1006,791,443,362,37,22,303,81,72,28,33,11,9,9,0,0,348,291,71,9,211,57,57,44,13,0,0,0,0,0,26241
8145,3652,1012,1697,678,159,106,300,134,53,3,10,40,81,39,6,33,0,42,0,0,42,166,158,27,0,131,8,8,8,0,0,0,0,0,0,26250
8146,2050,168,1014,448,216,204,102,22,13,6,0,7,9,5,0,0,5,4,0,4,0,80,68,15,0,53,12,8,1,0,7,4,0,0,4,26253
8147,394,105,139,49,42,59,0,0,0,0,0,0,0,0,0,0,0,0,0,0,0,0,0,0,0,0,0,0,0,0,0,0,0,0,0,26254
8148,626,161,330,53,42,40,59,8,8,3,2,3,0,0,0,0,0,0,0,0,0,51,51,2,0,49,0,0,0,0,0,0,0,0,0,26257
8149,85,45,0,26,14,0,0,0,0,0,0,0,0,0,0,0,0,0,0,0,0,0,0,0,0,0,0,0,0,0,0,0,0,0,0,26259
8150,1029,112,393,235,101,188,131,105,63,0,0,63,42,39,25,0,14,3,0,0,3,26,14,0,0,14,12,0,0,0,0,12,0,0,12,26260
8151,2226,520,1089,379,163,75,159,48,45,19,3,23,3,3,0,3,0,0,0,0,0,111,95,35,10,50,16,16,0,16,0,0,0,0,0,26261
8152,108,0,84,24,0,0,0,0,0,0,0,0,0,0,0,0,0,0,0,0,0,0,0,0,0,0,0,0,0,0,0,0,0,0,0,26263
8153,510,147,219,75,69,0,51,49,20,7,0,13,29,21,21,0,0,8,8,0,0,2,0,0,0,0,2,2,2,0,0,0,0,0,0,26264
8154,45,0,45,0,0,0,20,0,0,0,0,0,0,0,0,0,0,0,0,0,0,20,0,0,0,0,20,0,0,0,0,20,20,0,0,26266
8155,271,62,78,26,75,30,0,0,0,0,0,0,0,0,0,0,0,0,0,0,0,0,0,0,0,0,0,0,0,0,0,0,0,0,0,26267
8156,45,9,29,7,0,0,9,0,0,0,0,0,0,0,0,0,0,0,0,0,0,9,9,0,0,9,0,0,0,0,0,0,0,0,0,26268
8157,690,103,359,140,61,27,41,32,25,19,2,4,7,7,0,4,3,0,0,0,0,9,6,0,3,3,3,3,3,0,0,0,0,0,0,26269
8158,556,107,162,96,80,111,34,18,4,0,0,4,14,14,0,0,14,0,0,0,0,16,16,2,0,14,0,0,0,0,0,0,0,0,0,26270
8159,271,45,118,55,33,20,6,4,4,0,0,4,0,0,0,0,0,0,0,0,0,2,2,0,0,2,0,0,0,0,0,0,0,0,0,26271
8160,1596,445,632,388,43,88,18,0,0,0,0,0,0,0,0,0,0,0,0,0,0,18,16,16,0,0,2,0,0,0,0,2,0,0,2,26273
8161,540,186,269,73,0,12,28,15,15,0,0,15,0,0,0,0,0,0,0,0,0,13,13,13,0,0,0,0,0,0,0,0,0,0,0,26275
8162,298,8,150,54,50,36,32,0,0,0,0,0,0,0,0,0,0,0,0,0,0,32,32,18,14,0,0,0,0,0,0,0,0,0,0,26276
8163,410,66,246,33,58,7,29,29,0,0,0,0,29,29,0,0,29,0,0,0,0,0,0,0,0,0,0,0,0,0,0,0,0,0,0,26278
8164,1280,293,729,187,49,22,81,57,17,0,0,17,40,40,40,0,0,0,0,0,0,24,6,0,0,6,18,16,16,0,0,2,0,0,2,26280
8165,25,0,25,0,0,0,0,0,0,0,0,0,0,0,0,0,0,0,0,0,0,0,0,0,0,0,0,0,0,0,0,0,0,0,0,26282
8166,1547,291,719,279,140,118,107,54,54,0,0,54,0,0,0,0,0,0,0,0,0,53,35,0,0,35,18,18,17,0,1,0,0,0,0,26283
8167,223,48,147,28,0,0,0,0,0,0,0,0,0,0,0,0,0,0,0,0,0,0,0,0,0,0,0,0,0,0,0,0,0,0,0,26285
8168,2229,393,1029,529,181,97,120,74,54,3,8,43,20,20,20,0,0,0,0,0,0,46,37,3,5,29,9,9,4,0,5,0,0,0,0,26287
8169,2887,1010,1153,488,141,95,153,75,72,23,0,49,3,0,0,0,0,3,0,3,0,78,35,0,10,25,43,36,10,15,11,7,0,1,6,26288
8170,64,0,10,26,28,0,0,0,0,0,0,0,0,0,0,0,0,0,0,0,0,0,0,0,0,0,0,0,0,0,0,0,0,0,0,26291
8171,633,141,329,112,37,14,15,4,4,0,0,4,0,0,0,0,0,0,0,0,0,11,11,0,0,11,0,0,0,0,0,0,0,0,0,26292
8172,453,63,295,88,7,0,36,14,14,0,0,14,0,0,0,0,0,0,0,0,0,22,10,0,0,10,12,12,0,0,12,0,0,0,0,26293
8173,754,188,449,52,29,36,78,78,78,0,0,78,0,0,0,0,0,0,0,0,0,0,0,0,0,0,0,0,0,0,0,0,0,0,0,26294
8174,208,59,139,10,0,0,0,0,0,0,0,0,0,0,0,0,0,0,0,0,0,0,0,0,0,0,0,0,0,0,0,0,0,0,0,26296
8175,43,4,24,15,0,0,0,0,0,0,0,0,0,0,0,0,0,0,0,0,0,0,0,0,0,0,0,0,0,0,0,0,0,0,0,26298
8176,21198,3099,8779,5681,2593,1046,1278,657,535,102,78,355,122,116,45,4,67,6,0,6,0,621,513,114,21,378,108,74,31,16,27,34,6,20,8,26301
8177,563,183,221,132,13,14,27,0,0,0,0,0,0,0,0,0,0,0,0,0,0,27,27,0,0,27,0,0,0,0,0,0,0,0,0,26320
8178,479,91,223,67,89,9,45,45,35,35,0,0,10,10,0,10,0,0,0,0,0,0,0,0,0,0,0,0,0,0,0,0,0,0,0,26321
8179,471,125,195,111,22,18,31,27,9,0,0,9,18,5,0,0,5,13,0,9,4,4,4,0,0,4,0,0,0,0,0,0,0,0,0,26323
8180,318,109,133,74,0,2,0,0,0,0,0,0,0,0,0,0,0,0,0,0,0,0,0,0,0,0,0,0,0,0,0,0,0,0,0,26325
8181,41,0,16,25,0,0,0,0,0,0,0,0,0,0,0,0,0,0,0,0,0,0,0,0,0,0,0,0,0,0,0,0,0,0,0,26327
8182,9855,681,2836,2698,2324,1316,543,263,232,49,10,173,31,31,0,31,0,0,0,0,0,280,235,107,0,128,45,32,32,0,0,13,0,0,13,26330
8183,890,273,243,233,126,15,17,6,4,0,0,4,2,2,0,0,2,0,0,0,0,11,7,3,0,4,4,4,1,3,0,0,0,0,0,26335
8184,845,173,379,184,100,9,93,60,46,0,0,46,14,4,0,0,4,10,0,10,0,33,33,14,5,14,0,0,0,0,0,0,0,0,0,26337
8185,447,105,187,128,27,0,18,18,18,0,0,18,0,0,0,0,0,0,0,0,0,0,0,0,0,0,0,0,0,0,0,0,0,0,0,26338
8186,183,19,96,68,0,0,0,0,0,0,0,0,0,0,0,0,0,0,0,0,0,0,0,0,0,0,0,0,0,0,0,0,0,0,0,26339
8187,345,51,158,51,65,20,24,24,14,0,0,14,10,0,0,0,0,10,10,0,0,0,0,0,0,0,0,0,0,0,0,0,0,0,0,26342
8188,329,19,198,85,0,27,33,33,33,0,0,33,0,0,0,0,0,0,0,0,0,0,0,0,0,0,0,0,0,0,0,0,0,0,0,26343
8189,582,93,315,121,36,17,31,4,4,0,0,4,0,0,0,0,0,0,0,0,0,27,27,1,0,26,0,0,0,0,0,0,0,0,0,26346
8190,1583,252,772,276,111,172,101,48,31,7,0,24,17,17,0,17,0,0,0,0,0,53,53,0,0,53,0,0,0,0,0,0,0,0,0,26347
8191,96,24,65,7,0,0,9,9,9,0,0,9,0,0,0,0,0,0,0,0,0,0,0,0,0,0,0,0,0,0,0,0,0,0,0,26348
8192,145,15,78,42,10,0,0,0,0,0,0,0,0,0,0,0,0,0,0,0,0,0,0,0,0,0,0,0,0,0,0,0,0,0,0,26349
8193,3376,692,1196,916,300,272,453,238,202,51,38,113,36,36,0,36,0,0,0,0,0,215,201,99,13,89,14,14,0,14,0,0,0,0,0,26351
8194,7816,1116,3919,1716,739,326,436,241,164,12,34,118,77,59,36,0,23,18,18,0,0,195,135,22,6,107,60,60,8,26,26,0,0,0,0,26354
8195,109,36,40,5,0,28,5,5,0,0,0,0,5,0,0,0,0,5,0,0,5,0,0,0,0,0,0,0,0,0,0,0,0,0,0,26361
8196,2482,498,1135,578,116,155,191,105,90,0,32,58,15,15,0,15,0,0,0,0,0,86,80,12,0,68,6,2,0,2,0,4,0,0,4,26362
8197,127,42,51,17,17,0,22,0,0,0,0,0,0,0,0,0,0,0,0,0,0,22,22,0,0,22,0,0,0,0,0,0,0,0,0,26366
8198,443,65,228,100,29,21,11,0,0,0,0,0,0,0,0,0,0,0,0,0,0,11,11,0,0,11,0,0,0,0,0,0,0,0,0,26369
8199,469,104,158,94,60,53,36,30,16,0,0,16,14,0,0,0,0,14,0,14,0,6,6,0,0,6,0,0,0,0,0,0,0,0,0,26372
8200,1135,163,518,242,171,41,42,36,32,0,0,32,4,0,0,0,0,4,4,0,0,6,6,6,0,0,0,0,0,0,0,0,0,0,0,26374
8201,402,96,255,51,0,0,72,0,0,0,0,0,0,0,0,0,0,0,0,0,0,72,0,0,0,0,72,72,0,35,37,0,0,0,0,26376
8202,468,124,225,69,20,30,15,8,0,0,0,0,8,8,8,0,0,0,0,0,0,7,7,0,0,7,0,0,0,0,0,0,0,0,0,26377
8203,3151,396,1590,790,246,129,159,81,46,7,0,39,35,14,14,0,0,21,14,7,0,78,76,45,0,31,2,1,1,0,0,1,1,0,0,26378
8204,542,164,140,114,79,45,57,57,32,0,0,32,25,0,0,0,0,25,0,0,25,0,0,0,0,0,0,0,0,0,0,0,0,0,0,26384
8205,2898,391,1346,762,188,211,205,149,140,5,21,114,9,0,0,0,0,9,9,0,0,56,56,7,25,24,0,0,0,0,0,0,0,0,0,26385
8206,1938,225,935,459,185,134,173,106,64,23,8,33,42,29,14,4,11,13,0,0,13,67,65,31,7,27,2,2,2,0,0,0,0,0,0,26386
8207,278,41,108,83,46,0,0,0,0,0,0,0,0,0,0,0,0,0,0,0,0,0,0,0,0,0,0,0,0,0,0,0,0,0,0,26404
8208,884,122,527,158,61,16,10,10,10,0,0,10,0,0,0,0,0,0,0,0,0,0,0,0,0,0,0,0,0,0,0,0,0,0,0,26405
8209,2088,203,696,644,294,251,135,77,66,45,0,21,11,11,0,11,0,0,0,0,0,58,58,27,10,21,0,0,0,0,0,0,0,0,0,26408
8210,885,152,485,169,77,2,16,16,7,0,0,7,9,9,0,0,9,0,0,0,0,0,0,0,0,0,0,0,0,0,0,0,0,0,0,26410
8211,613,103,382,63,51,14,9,9,9,0,0,9,0,0,0,0,0,0,0,0,0,0,0,0,0,0,0,0,0,0,0,0,0,0,0,26411
8212,364,148,182,4,0,30,26,12,12,0,0,12,0,0,0,0,0,0,0,0,0,14,14,0,0,14,0,0,0,0,0,0,0,0,0,26412
8213,3056,631,1361,774,201,89,179,97,60,4,0,56,37,16,0,0,16,21,0,0,21,82,82,3,0,79,0,0,0,0,0,0,0,0,0,26415
8214,4720,905,2001,1054,483,277,492,311,305,117,3,185,6,0,0,0,0,6,0,0,6,181,162,47,25,90,19,0,0,0,0,19,0,0,19,26416
8215,736,150,351,181,42,12,50,23,16,0,0,16,7,0,0,0,0,7,0,7,0,27,27,0,0,27,0,0,0,0,0,0,0,0,0,26419
8216,166,28,58,63,17,0,3,3,3,0,0,3,0,0,0,0,0,0,0,0,0,0,0,0,0,0,0,0,0,0,0,0,0,0,0,26421
8217,398,42,205,142,9,0,0,0,0,0,0,0,0,0,0,0,0,0,0,0,0,0,0,0,0,0,0,0,0,0,0,0,0,0,0,26422
8218,367,118,171,78,0,0,75,33,33,0,0,33,0,0,0,0,0,0,0,0,0,42,42,21,0,21,0,0,0,0,0,0,0,0,0,26424
8219,991,167,630,92,56,46,41,8,8,0,0,8,0,0,0,0,0,0,0,0,0,33,22,0,0,22,11,9,0,9,0,2,0,0,2,26425
8220,4633,776,2074,1012,487,284,587,253,215,4,0,211,38,34,10,0,24,4,0,0,4,334,269,52,16,201,65,17,14,3,0,48,38,0,10,26426
8221,483,131,153,138,56,5,35,0,0,0,0,0,0,0,0,0,0,0,0,0,0,35,35,23,0,12,0,0,0,0,0,0,0,0,0,26430
8222,4425,722,1975,1296,308,124,222,106,91,8,5,78,15,0,0,0,0,15,15,0,0,116,94,34,0,60,22,0,0,0,0,22,0,0,22,26431
8223,78,38,15,25,0,0,0,0,0,0,0,0,0,0,0,0,0,0,0,0,0,0,0,0,0,0,0,0,0,0,0,0,0,0,0,26435
8224,95,0,70,25,0,0,0,0,0,0,0,0,0,0,0,0,0,0,0,0,0,0,0,0,0,0,0,0,0,0,0,0,0,0,0,26436
8225,533,205,235,67,15,11,12,5,2,0,0,2,3,1,0,0,1,2,0,0,2,7,6,0,0,6,1,1,1,0,0,0,0,0,0,26437
8226,110,0,62,37,0,11,0,0,0,0,0,0,0,0,0,0,0,0,0,0,0,0,0,0,0,0,0,0,0,0,0,0,0,0,0,26438
8227,709,93,370,197,24,25,43,0,0,0,0,0,0,0,0,0,0,0,0,0,0,43,19,8,4,7,24,21,21,0,0,3,0,0,3,26440
8228,116,0,45,44,14,13,0,0,0,0,0,0,0,0,0,0,0,0,0,0,0,0,0,0,0,0,0,0,0,0,0,0,0,0,0,26443
8229,2845,563,1450,489,245,98,183,129,81,3,7,71,48,39,14,19,6,9,6,3,0,54,41,1,15,25,13,13,8,0,5,0,0,0,0,26444
8230,738,255,307,115,25,36,35,14,14,7,7,0,0,0,0,0,0,0,0,0,0,21,11,0,0,11,10,10,10,0,0,0,0,0,0,26447
8231,1049,307,528,161,42,11,117,78,58,0,0,58,20,20,10,0,10,0,0,0,0,39,39,0,0,39,0,0,0,0,0,0,0,0,0,26448
8232,608,53,271,181,53,50,61,24,17,0,0,17,7,7,0,7,0,0,0,0,0,37,35,12,3,20,2,2,0,2,0,0,0,0,0,26451
8233,6808,788,3377,1440,838,365,407,232,196,37,22,137,36,21,0,0,21,15,7,0,8,175,134,39,0,95,41,35,16,19,0,6,0,0,6,26452
8234,2805,608,1110,684,320,83,252,108,74,0,0,74,34,34,34,0,0,0,0,0,0,144,65,25,0,40,79,79,0,0,79,0,0,0,0,26456
8235,13908,1561,4852,3321,2112,2062,528,268,207,48,15,144,61,39,39,0,0,22,0,0,22,260,202,39,0,163,58,47,10,0,37,11,11,0,0,26501
8236,16667,973,3253,3612,4315,4514,6464,3346,3226,606,224,2396,120,118,73,29,16,2,0,0,2,3118,3056,794,382,1880,62,41,20,10,11,21,6,0,15,26505
8237,20505,1835,6111,4430,3858,4271,1311,631,536,149,4,383,95,31,19,0,12,64,4,0,60,680,571,151,14,406,109,72,52,0,20,37,25,0,12,26508
8238,1317,255,715,245,75,27,139,25,22,0,16,6,3,3,3,0,0,0,0,0,0,114,109,0,12,97,5,5,0,0,5,0,0,0,0,26519
8239,558,66,226,194,36,36,0,0,0,0,0,0,0,0,0,0,0,0,0,0,0,0,0,0,0,0,0,0,0,0,0,0,0,0,0,26520
8240,176,21,123,12,12,8,16,10,2,0,0,2,8,8,1,0,7,0,0,0,0,6,4,0,0,4,2,2,0,2,0,0,0,0,0,26521
8241,5192,793,2551,1187,465,196,209,59,17,0,0,17,42,42,42,0,0,0,0,0,0,150,96,11,2,83,54,26,26,0,0,28,0,15,13,26525
8242,888,140,502,189,57,0,41,30,15,3,0,12,15,15,2,0,13,0,0,0,0,11,11,4,0,7,0,0,0,0,0,0,0,0,0,26534
8243,4024,787,1614,959,352,312,311,221,178,18,21,139,43,43,43,0,0,0,0,0,0,90,47,24,0,23,43,43,0,0,43,0,0,0,0,26537
8244,2325,394,1157,511,198,65,223,173,103,9,0,94,70,48,40,8,0,22,0,0,22,50,50,0,0,50,0,0,0,0,0,0,0,0,0,26541
8245,1964,430,946,440,98,50,187,77,69,0,0,69,8,8,8,0,0,0,0,0,0,110,96,12,24,60,14,0,0,0,0,14,0,0,14,26542
8246,95,39,32,24,0,0,20,10,0,0,0,0,10,10,10,0,0,0,0,0,0,10,10,10,0,0,0,0,0,0,0,0,0,0,0,26543
8247,1665,133,749,517,233,33,48,34,30,0,0,30,4,0,0,0,0,4,0,0,4,14,8,0,0,8,6,0,0,0,0,6,0,0,6,26547
8248,28729,3306,10629,7804,4537,2453,2477,1239,985,243,111,631,254,206,139,12,55,48,8,0,40,1238,1108,278,20,810,130,104,41,0,63,26,0,18,8,26554
8249,885,103,364,246,133,39,59,46,35,0,0,35,11,11,11,0,0,0,0,0,0,13,13,5,0,8,0,0,0,0,0,0,0,0,0,26559
8250,49,23,26,0,0,0,21,21,0,0,0,0,21,0,0,0,0,21,0,0,21,0,0,0,0,0,0,0,0,0,0,0,0,0,0,26560
8251,460,72,212,118,32,26,31,10,0,0,0,0,10,10,0,10,0,0,0,0,0,21,21,0,0,21,0,0,0,0,0,0,0,0,0,26562
8252,245,13,143,77,12,0,0,0,0,0,0,0,0,0,0,0,0,0,0,0,0,0,0,0,0,0,0,0,0,0,0,0,0,0,0,26563
8253,536,69,219,164,26,58,46,14,14,0,0,14,0,0,0,0,0,0,0,0,0,32,32,0,0,32,0,0,0,0,0,0,0,0,0,26568
8254,2327,370,1140,595,146,76,134,87,52,9,3,40,35,19,19,0,0,16,16,0,0,47,46,15,0,31,1,1,1,0,0,0,0,0,0,26570
8255,1467,221,692,448,76,30,50,20,10,0,0,10,10,10,5,0,5,0,0,0,0,30,22,6,0,16,8,8,8,0,0,0,0,0,0,26571
8256,225,20,205,0,0,0,0,0,0,0,0,0,0,0,0,0,0,0,0,0,0,0,0,0,0,0,0,0,0,0,0,0,0,0,0,26572
8257,391,49,194,95,20,33,43,10,10,0,0,10,0,0,0,0,0,0,0,0,0,33,17,5,0,12,16,6,6,0,0,10,0,0,10,26574
8258,687,185,268,181,35,18,59,15,11,4,0,7,4,4,4,0,0,0,0,0,0,44,17,17,0,0,27,27,0,0,27,0,0,0,0,26575
8259,141,15,35,69,22,0,9,0,0,0,0,0,0,0,0,0,0,0,0,0,0,9,9,0,0,9,0,0,0,0,0,0,0,0,0,26576
8260,659,165,360,103,31,0,93,75,32,0,0,32,43,21,0,0,21,22,0,0,22,18,9,0,0,9,9,3,0,0,3,6,0,0,6,26581
8261,3473,538,1793,712,280,150,269,92,52,9,1,42,40,35,35,0,0,5,5,0,0,177,139,8,9,122,38,38,0,29,9,0,0,0,0,26582
8262,345,116,178,44,7,0,18,18,0,0,0,0,18,0,0,0,0,18,0,18,0,0,0,0,0,0,0,0,0,0,0,0,0,0,0,26585
8263,0,0,0,0,0,0,0,0,0,0,0,0,0,0,0,0,0,0,0,0,0,0,0,0,0,0,0,0,0,0,0,0,0,0,0,26586
8264,308,17,129,104,25,33,17,17,17,17,0,0,0,0,0,0,0,0,0,0,0,0,0,0,0,0,0,0,0,0,0,0,0,0,0,26587
8265,2040,208,1127,466,169,70,133,55,48,2,0,46,7,7,0,0,7,0,0,0,0,78,48,0,0,48,30,30,0,0,30,0,0,0,0,26588
8266,542,42,330,112,48,10,69,69,43,0,0,43,26,26,0,0,26,0,0,0,0,0,0,0,0,0,0,0,0,0,0,0,0,0,0,26590
8267,1178,237,554,242,108,37,14,14,14,0,0,14,0,0,0,0,0,0,0,0,0,0,0,0,0,0,0,0,0,0,0,0,0,0,0,26591
8268,3918,893,1755,729,393,148,282,177,98,30,4,64,79,10,10,0,0,69,0,0,69,105,58,3,12,43,47,12,0,12,0,35,25,0,10,26601
8269,620,152,317,85,57,9,81,35,28,9,0,19,7,7,0,0,7,0,0,0,0,46,13,0,0,13,33,33,19,14,0,0,0,0,0,26610
8270,97,49,43,5,0,0,9,0,0,0,0,0,0,0,0,0,0,0,0,0,0,9,9,0,0,9,0,0,0,0,0,0,0,0,0,26611
8271,245,81,157,0,7,0,0,0,0,0,0,0,0,0,0,0,0,0,0,0,0,0,0,0,0,0,0,0,0,0,0,0,0,0,0,26615
8272,100,28,30,34,8,0,0,0,0,0,0,0,0,0,0,0,0,0,0,0,0,0,0,0,0,0,0,0,0,0,0,0,0,0,0,26617
8273,348,78,105,117,48,0,8,8,8,0,0,8,0,0,0,0,0,0,0,0,0,0,0,0,0,0,0,0,0,0,0,0,0,0,0,26619
8274,491,148,204,129,10,0,30,30,30,0,0,30,0,0,0,0,0,0,0,0,0,0,0,0,0,0,0,0,0,0,0,0,0,0,0,26621
8275,820,140,416,161,95,8,147,81,39,0,0,39,42,42,0,42,0,0,0,0,0,66,54,0,54,0,12,0,0,0,0,12,0,0,12,26623
8276,2153,394,1107,374,153,125,107,32,22,10,0,12,10,10,10,0,0,0,0,0,0,75,68,0,0,68,7,7,7,0,0,0,0,0,0,26624
8277,248,77,146,13,0,12,0,0,0,0,0,0,0,0,0,0,0,0,0,0,0,0,0,0,0,0,0,0,0,0,0,0,0,0,0,26627
8278,226,0,139,87,0,0,15,15,15,15,0,0,0,0,0,0,0,0,0,0,0,0,0,0,0,0,0,0,0,0,0,0,0,0,0,26629
8279,312,72,188,29,23,0,15,15,0,0,0,0,15,15,0,0,15,0,0,0,0,0,0,0,0,0,0,0,0,0,0,0,0,0,0,26631
8280,349,115,138,67,18,11,0,0,0,0,0,0,0,0,0,0,0,0,0,0,0,0,0,0,0,0,0,0,0,0,0,0,0,0,0,26636
8281,134,52,69,13,0,0,0,0,0,0,0,0,0,0,0,0,0,0,0,0,0,0,0,0,0,0,0,0,0,0,0,0,0,0,0,26638
8282,7563,1439,3091,1789,784,460,578,305,226,57,0,169,79,56,13,34,9,23,0,0,23,273,240,105,21,114,33,33,33,0,0,0,0,0,0,26651
8283,218,14,127,35,35,7,11,11,11,11,0,0,0,0,0,0,0,0,0,0,0,0,0,0,0,0,0,0,0,0,0,0,0,0,0,26656
8284,222,15,148,59,0,0,0,0,0,0,0,0,0,0,0,0,0,0,0,0,0,0,0,0,0,0,0,0,0,0,0,0,0,0,0,26660
8285,719,73,291,98,68,189,19,19,19,0,0,19,0,0,0,0,0,0,0,0,0,0,0,0,0,0,0,0,0,0,0,0,0,0,0,26662
8286,403,37,242,97,12,15,62,45,29,0,0,29,16,16,16,0,0,0,0,0,0,17,17,0,0,17,0,0,0,0,0,0,0,0,0,26676
8287,933,101,573,182,50,27,64,36,36,0,0,36,0,0,0,0,0,0,0,0,0,28,28,0,0,28,0,0,0,0,0,0,0,0,0,26678
8288,1270,202,491,318,140,119,35,11,11,6,5,0,0,0,0,0,0,0,0,0,0,24,20,12,0,8,4,0,0,0,0,4,0,0,4,26679
8289,154,34,54,59,0,7,0,0,0,0,0,0,0,0,0,0,0,0,0,0,0,0,0,0,0,0,0,0,0,0,0,0,0,0,0,26680
8290,1029,90,669,224,0,46,78,43,12,12,0,0,31,31,31,0,0,0,0,0,0,35,15,15,0,0,20,20,0,20,0,0,0,0,0,26681
8291,34,0,17,17,0,0,0,0,0,0,0,0,0,0,0,0,0,0,0,0,0,0,0,0,0,0,0,0,0,0,0,0,0,0,0,26684
8292,355,103,135,117,0,0,13,2,2,0,0,2,0,0,0,0,0,0,0,0,0,11,0,0,0,0,11,11,0,0,11,0,0,0,0,26690
8293,287,68,189,30,0,0,52,7,7,0,0,7,0,0,0,0,0,0,0,0,0,45,27,0,0,27,18,18,18,0,0,0,0,0,0,26691
8294,4215,894,2155,767,288,111,242,158,153,27,0,126,5,5,0,0,5,0,0,0,0,84,61,26,0,35,23,23,0,0,23,0,0,0,0,26704
8295,793,130,344,238,81,0,73,32,32,20,0,12,0,0,0,0,0,0,0,0,0,41,41,0,0,41,0,0,0,0,0,0,0,0,0,26705
8296,280,82,171,19,5,3,17,4,2,0,0,2,2,2,2,0,0,0,0,0,0,13,13,0,0,13,0,0,0,0,0,0,0,0,0,26707
8297,1596,274,808,365,92,57,90,37,37,0,0,37,0,0,0,0,0,0,0,0,0,53,36,33,0,3,17,17,0,0,17,0,0,0,0,26710
8298,1518,283,774,321,69,71,79,72,29,0,0,29,43,43,19,24,0,0,0,0,0,7,7,0,0,7,0,0,0,0,0,0,0,0,0,26711
8299,336,107,185,39,0,5,11,11,11,0,0,11,0,0,0,0,0,0,0,0,0,0,0,0,0,0,0,0,0,0,0,0,0,0,0,26714
8300,520,56,185,228,38,13,23,17,6,0,0,6,11,11,11,0,0,0,0,0,0,6,6,0,0,6,0,0,0,0,0,0,0,0,0,26716
8301,940,202,559,130,33,16,37,10,7,0,0,7,3,0,0,0,0,3,0,0,3,27,27,0,0,27,0,0,0,0,0,0,0,0,0,26717
8302,1846,177,823,464,281,101,108,0,0,0,0,0,0,0,0,0,0,0,0,0,0,108,108,20,0,88,0,0,0,0,0,0,0,0,0,26719
8303,51,0,26,25,0,0,0,0,0,0,0,0,0,0,0,0,0,0,0,0,0,0,0,0,0,0,0,0,0,0,0,0,0,0,0,26720
8304,564,42,386,108,18,10,56,0,0,0,0,0,0,0,0,0,0,0,0,0,0,56,56,0,0,56,0,0,0,0,0,0,0,0,0,26722
8305,8806,1106,4111,2349,718,522,1026,577,512,49,181,282,65,46,0,46,0,19,0,0,19,449,380,46,61,273,69,44,24,0,20,25,0,0,25,26726
8306,178,18,138,22,0,0,0,0,0,0,0,0,0,0,0,0,0,0,0,0,0,0,0,0,0,0,0,0,0,0,0,0,0,0,0,26731
8307,642,96,421,106,15,4,53,23,10,0,0,10,13,13,13,0,0,0,0,0,0,30,4,0,0,4,26,0,0,0,0,26,0,0,26,26739
8308,1214,107,685,269,62,91,65,46,46,9,0,37,0,0,0,0,0,0,0,0,0,19,19,8,0,11,0,0,0,0,0,0,0,0,0,26743
8309,691,96,440,115,23,17,40,22,22,0,0,22,0,0,0,0,0,0,0,0,0,18,15,0,0,15,3,3,3,0,0,0,0,0,0,26750
8310,4503,552,2211,1102,486,152,318,123,95,22,0,73,28,28,10,17,1,0,0,0,0,195,145,53,5,87,50,16,16,0,0,34,34,0,0,26753
8311,669,93,456,77,34,9,0,0,0,0,0,0,0,0,0,0,0,0,0,0,0,0,0,0,0,0,0,0,0,0,0,0,0,0,0,26755
8312,4689,1000,2387,732,401,169,428,231,136,64,24,48,95,47,0,0,47,48,0,0,48,197,167,13,25,129,30,30,30,0,0,0,0,0,0,26757
8313,345,65,231,26,0,23,0,0,0,0,0,0,0,0,0,0,0,0,0,0,0,0,0,0,0,0,0,0,0,0,0,0,0,0,0,26761
8314,1182,293,540,287,55,7,82,54,29,0,0,29,25,0,0,0,0,25,0,0,25,28,0,0,0,0,28,28,28,0,0,0,0,0,0,26763
8315,2901,505,1281,719,239,157,200,58,31,10,11,10,27,20,20,0,0,7,0,7,0,142,108,15,4,89,34,31,25,0,6,3,0,3,0,26764
8316,417,96,159,139,17,6,12,0,0,0,0,0,0,0,0,0,0,0,0,0,0,12,12,12,0,0,0,0,0,0,0,0,0,0,0,26767
8317,798,274,302,141,34,47,26,26,26,0,0,26,0,0,0,0,0,0,0,0,0,0,0,0,0,0,0,0,0,0,0,0,0,0,0,26801
8318,920,92,502,219,78,29,26,7,0,0,0,0,7,7,7,0,0,0,0,0,0,19,19,0,0,19,0,0,0,0,0,0,0,0,0,26802
8319,487,141,243,99,4,0,7,2,0,0,0,0,2,0,0,0,0,2,0,0,2,5,5,0,0,5,0,0,0,0,0,0,0,0,0,26804
8320,2083,398,848,466,280,91,98,69,56,0,0,56,13,13,13,0,0,0,0,0,0,29,29,0,0,29,0,0,0,0,0,0,0,0,0,26807
8321,585,154,240,142,11,38,23,23,23,0,0,23,0,0,0,0,0,0,0,0,0,0,0,0,0,0,0,0,0,0,0,0,0,0,0,26808
8322,205,40,84,29,31,21,0,0,0,0,0,0,0,0,0,0,0,0,0,0,0,0,0,0,0,0,0,0,0,0,0,0,0,0,0,26810
8323,1293,325,650,181,44,93,23,0,0,0,0,0,0,0,0,0,0,0,0,0,0,23,23,0,0,23,0,0,0,0,0,0,0,0,0,26812
8324,331,86,160,67,18,0,9,9,9,0,0,9,0,0,0,0,0,0,0,0,0,0,0,0,0,0,0,0,0,0,0,0,0,0,0,26814
8325,555,123,209,132,60,31,20,0,0,0,0,0,0,0,0,0,0,0,0,0,0,20,20,0,0,20,0,0,0,0,0,0,0,0,0,26815
8326,309,27,221,61,0,0,22,22,0,0,0,0,22,22,0,22,0,0,0,0,0,0,0,0,0,0,0,0,0,0,0,0,0,0,0,26817
8327,482,129,182,141,30,0,153,11,11,0,0,11,0,0,0,0,0,0,0,0,0,142,114,0,21,93,28,28,28,0,0,0,0,0,0,26818
8328,159,69,72,0,18,0,0,0,0,0,0,0,0,0,0,0,0,0,0,0,0,0,0,0,0,0,0,0,0,0,0,0,0,0,0,26823
8329,1596,294,900,258,138,6,100,79,79,0,0,79,0,0,0,0,0,0,0,0,0,21,21,0,0,21,0,0,0,0,0,0,0,0,0,26833
8330,4549,930,2207,1008,252,152,366,181,119,58,0,61,62,34,6,20,8,28,28,0,0,185,138,69,9,60,47,47,0,32,15,0,0,0,0,26836
8331,579,0,197,307,55,20,14,14,14,0,14,0,0,0,0,0,0,0,0,0,0,0,0,0,0,0,0,0,0,0,0,0,0,0,0,26845
8332,4801,900,2339,944,314,304,323,117,108,42,7,59,9,0,0,0,0,9,0,0,9,206,189,94,11,84,17,6,0,0,6,11,0,0,11,26847
8333,1702,344,926,314,103,15,164,104,101,19,0,82,3,3,0,0,3,0,0,0,0,60,60,3,3,54,0,0,0,0,0,0,0,0,0,26851
8334,580,133,324,111,0,12,0,0,0,0,0,0,0,0,0,0,0,0,0,0,0,0,0,0,0,0,0,0,0,0,0,0,0,0,0,26852
8335,561,236,220,42,43,20,18,18,0,0,0,0,18,0,0,0,0,18,18,0,0,0,0,0,0,0,0,0,0,0,0,0,0,0,0,26855
8336,145,52,93,0,0,0,0,0,0,0,0,0,0,0,0,0,0,0,0,0,0,0,0,0,0,0,0,0,0,0,0,0,0,0,0,26865
8337,717,212,336,92,23,54,63,28,28,0,0,28,0,0,0,0,0,0,0,0,0,35,0,0,0,0,35,0,0,0,0,35,0,0,35,26866
8338,435,63,255,58,23,36,63,47,34,0,0,34,13,13,5,8,0,0,0,0,0,16,16,0,0,16,0,0,0,0,0,0,0,0,0,26884
8339,10336,758,2588,2828,2617,1545,586,290,267,16,0,251,23,23,0,0,23,0,0,0,0,296,259,123,12,124,37,7,7,0,0,30,0,15,15,27006
8340,1381,145,509,512,116,99,133,53,53,17,0,36,0,0,0,0,0,0,0,0,0,80,59,32,0,27,21,21,7,0,14,0,0,0,0,27007
8341,2008,300,676,585,343,104,96,0,0,0,0,0,0,0,0,0,0,0,0,0,0,96,46,0,0,46,50,0,0,0,0,50,0,0,50,27009
8342,3765,744,1503,1183,218,117,423,219,83,2,14,67,136,124,85,0,39,12,0,12,0,204,185,20,14,151,19,10,0,10,0,9,0,0,9,27011
8343,17991,1014,4234,5179,5092,2472,1207,569,515,63,14,438,54,0,0,0,0,54,0,31,23,638,602,195,0,407,36,36,23,0,13,0,0,0,0,27012
8344,4447,922,1466,1716,226,117,341,170,120,20,13,87,50,0,0,0,0,50,43,0,7,171,119,41,27,51,52,52,52,0,0,0,0,0,0,27013
8345,479,116,216,127,16,4,41,21,21,3,2,16,0,0,0,0,0,0,0,0,0,20,16,2,0,14,4,4,4,0,0,0,0,0,0,27014
8346,1474,291,595,309,218,61,106,44,44,8,5,31,0,0,0,0,0,0,0,0,0,62,47,0,36,11,15,0,0,0,0,15,0,0,15,27016
8347,6292,1781,1680,2055,390,386,508,292,189,42,10,137,103,62,21,18,23,41,0,0,41,216,136,37,0,99,80,72,49,10,13,8,0,0,8,27017
8348,5397,926,1931,1585,788,167,310,198,143,15,21,107,55,0,0,0,0,55,19,0,36,112,87,0,0,87,25,23,9,14,0,2,0,0,2,27018
8349,2839,482,1046,835,331,145,89,13,13,0,0,13,0,0,0,0,0,0,0,0,0,76,76,14,18,44,0,0,0,0,0,0,0,0,0,27019
8350,4246,1239,1307,1237,303,160,385,173,88,13,0,75,85,85,11,48,26,0,0,0,0,212,212,76,0,136,0,0,0,0,0,0,0,0,0,27020
8351,11922,1969,4620,3541,1359,433,852,509,346,39,76,231,163,131,15,56,60,32,12,0,20,343,323,161,0,162,20,20,20,0,0,0,0,0,0,27021
8352,1378,439,485,276,136,42,114,59,23,0,0,23,36,36,25,0,11,0,0,0,0,55,49,14,0,35,6,0,0,0,0,6,0,0,6,27022
8353,8197,518,1686,2646,2218,1129,622,209,209,30,11,168,0,0,0,0,0,0,0,0,0,413,379,64,29,286,34,34,0,0,34,0,0,0,0,27023
8354,1921,809,429,537,79,67,247,131,89,45,24,20,42,17,0,12,5,25,0,0,25,116,82,48,0,34,34,34,0,0,34,0,0,0,0,27024
8355,8356,1650,3251,2449,795,211,500,260,179,21,41,117,81,71,13,45,13,10,10,0,0,240,223,0,6,217,17,4,4,0,0,13,0,0,13,27025
8356,2914,678,1244,738,217,37,239,117,88,5,13,70,29,17,17,0,0,12,0,7,5,122,73,16,0,57,49,0,0,0,0,49,0,40,9,27027
8357,17857,3325,6599,4931,2101,901,1575,775,642,109,56,477,133,73,44,18,11,60,15,0,45,800,713,227,26,460,87,87,56,0,31,0,0,0,0,27028
8358,26229,7107,7531,7732,2735,1124,1802,933,685,227,74,384,248,149,136,5,8,99,58,29,12,869,805,167,101,537,64,34,26,0,8,30,0,0,30,27030
8359,8029,601,2437,2363,1603,1025,803,451,352,104,38,210,99,75,18,12,45,24,0,13,11,352,294,64,33,197,58,58,58,0,0,0,0,0,0,27040
8360,5670,1058,1897,1847,601,267,352,183,160,35,0,125,23,23,15,0,8,0,0,0,0,169,148,49,6,93,21,9,0,0,9,12,0,0,12,27041
8361,454,154,139,73,45,43,28,12,12,0,0,12,0,0,0,0,0,0,0,0,0,16,16,0,0,16,0,0,0,0,0,0,0,0,0,27042
8362,4455,487,1921,1366,348,333,284,151,80,19,0,61,71,0,0,0,0,71,0,23,48,133,126,8,0,118,7,7,7,0,0,0,0,0,0,27043
8363,6277,790,1922,2018,1130,417,425,171,171,54,0,117,0,0,0,0,0,0,0,0,0,254,193,37,22,134,61,47,11,0,36,14,14,0,0,27045
8364,1661,455,606,500,100,0,76,22,1,0,0,1,21,21,0,0,21,0,0,0,0,54,54,0,0,54,0,0,0,0,0,0,0,0,0,27046
8365,720,106,252,348,14,0,85,85,69,0,0,69,16,16,0,16,0,0,0,0,0,0,0,0,0,0,0,0,0,0,0,0,0,0,0,27047
8366,6174,1677,2056,1822,446,173,342,148,133,27,49,57,15,4,0,4,0,11,0,11,0,194,183,50,2,131,11,0,0,0,0,11,0,0,11,27048
8367,3005,443,1079,913,353,217,268,138,78,7,9,62,60,9,0,0,9,51,0,0,51,130,130,12,5,113,0,0,0,0,0,0,0,0,0,27050
8368,5422,995,2055,1571,665,136,438,186,125,11,20,94,61,0,0,0,0,61,0,0,61,252,173,41,9,123,79,26,26,0,0,53,0,0,53,27051
8369,7326,1272,3206,2058,692,98,567,255,178,59,0,119,77,7,0,5,2,70,42,0,28,312,295,127,56,112,17,17,10,0,7,0,0,0,0,27052
8370,2425,444,1056,452,326,147,178,41,41,9,0,32,0,0,0,0,0,0,0,0,0,137,119,22,0,97,18,0,0,0,0,18,0,0,18,27053
8371,1444,257,632,489,50,16,69,14,14,14,0,0,0,0,0,0,0,0,0,0,0,55,55,0,0,55,0,0,0,0,0,0,0,0,0,27054
8372,9712,1934,3514,2879,1097,288,691,442,338,30,72,236,104,87,30,4,53,17,0,0,17,249,224,44,33,147,25,15,4,11,0,10,10,0,0,27055
8373,11929,2265,3103,3400,2047,1114,931,593,406,57,91,258,187,0,0,0,0,187,103,10,74,338,329,48,48,233,9,8,0,0,8,1,0,1,0,27101
8374,24482,2999,5646,7131,5692,3014,1375,590,493,136,4,353,97,22,22,0,0,75,0,21,54,785,608,253,12,343,177,136,59,44,33,41,16,0,25,27103
8375,20241,1112,2775,5148,6478,4728,1248,593,586,144,70,372,7,1,0,0,1,6,0,0,6,655,587,166,32,389,68,67,34,30,3,1,0,0,1,27104
8376,24741,5515,8682,7106,2514,924,2436,1272,747,94,35,618,525,224,27,113,84,301,74,125,102,1164,837,108,42,687,327,99,45,0,54,228,0,11,217,27105
8377,29096,3387,5569,7087,7738,5315,2405,1187,1030,93,62,875,157,22,16,0,6,135,79,48,8,1218,1134,239,30,865,84,84,84,0,0,0,0,0,0,27106
8378,29327,6107,9409,8744,3606,1461,2578,1383,1059,234,199,626,324,152,72,58,22,172,50,105,17,1195,1028,146,130,752,167,149,78,0,71,18,0,0,18,27107
8379,6,0,0,0,6,0,1475,588,588,88,0,500,0,0,0,0,0,0,0,0,0,887,887,147,15,725,0,0,0,0,0,0,0,0,0,27109
8380,57,0,0,57,0,0,958,236,236,56,0,180,0,0,0,0,0,0,0,0,0,722,722,126,117,479,0,0,0,0,0,0,0,0,0,27110
8381,23818,2794,6745,7019,4674,2586,1919,1119,941,151,131,659,178,115,5,52,58,63,36,13,14,800,723,114,38,571,77,63,27,0,36,14,0,0,14,27127
8382,32,6,2,11,0,13,3,3,3,0,0,3,0,0,0,0,0,0,0,0,0,0,0,0,0,0,0,0,0,0,0,0,0,0,0,27201
8383,13282,3914,4406,3148,1372,442,855,387,288,63,39,186,99,64,15,25,24,35,22,0,13,468,393,37,26,330,75,37,17,0,20,38,0,36,2,27203
8384,22516,4269,7542,6831,2915,959,2006,1045,795,259,70,466,250,132,98,10,24,118,45,0,73,961,725,181,53,491,236,210,66,73,71,26,0,0,26,27205
8385,2749,433,989,853,225,249,190,98,80,28,18,34,18,11,0,11,0,7,0,7,0,92,36,22,0,14,56,14,14,0,0,42,0,0,42,27207
8386,1249,188,508,341,130,82,35,26,26,0,0,26,0,0,0,0,0,0,0,0,0,9,9,9,0,0,0,0,0,0,0,0,0,0,0,27208
8387,2222,763,568,720,125,46,288,156,129,17,12,100,27,14,10,4,0,13,0,13,0,132,91,31,5,55,41,7,7,0,0,34,0,0,34,27209
8388,1669,498,546,434,88,103,16,0,0,0,0,0,0,0,0,0,0,0,0,0,0,16,16,16,0,0,0,0,0,0,0,0,0,0,0,27212
8389,6999,776,2436,2053,1304,430,639,399,277,39,14,224,122,106,67,39,0,16,0,0,16,240,184,0,0,184,56,39,0,39,0,17,0,0,17,27214
8390,28311,3569,6989,9350,5901,2502,1549,821,654,134,49,471,167,75,14,61,0,92,47,45,0,728,535,185,0,350,193,90,52,16,22,103,43,60,0,27215
8391,22923,5651,7998,6600,1921,753,2012,930,831,253,53,525,99,73,26,28,19,26,26,0,0,1082,838,229,69,540,244,87,66,0,21,157,30,19,108,27217
8392,2755,1094,681,585,286,109,322,121,75,0,0,75,46,46,0,40,6,0,0,0,0,201,191,12,0,179,10,8,0,8,0,2,0,0,2,27229
8393,1269,285,402,305,216,61,94,14,6,1,1,4,8,7,7,0,0,1,0,0,1,80,65,14,0,51,15,13,0,13,0,2,2,0,0,27231
8394,2506,480,1082,620,248,76,155,93,93,0,12,81,0,0,0,0,0,0,0,0,0,62,62,0,15,47,0,0,0,0,0,0,0,0,0,27233
8395,3162,160,850,974,829,349,200,121,95,7,0,88,26,26,11,0,15,0,0,0,0,79,79,0,0,79,0,0,0,0,0,0,0,0,0,27235
8396,6466,1556,2322,1777,537,274,458,216,185,42,5,138,31,20,20,0,0,11,3,0,8,242,242,64,17,161,0,0,0,0,0,0,0,0,0,27239
8397,1082,196,523,232,131,0,1,1,1,0,0,1,0,0,0,0,0,0,0,0,0,0,0,0,0,0,0,0,0,0,0,0,0,0,0,27242
8398,2894,239,659,785,531,680,213,98,80,19,0,61,18,6,0,6,0,12,0,4,8,115,113,27,52,34,2,2,0,2,0,0,0,0,0,27243
8399,6986,1078,1941,2426,1174,367,2701,1336,1313,78,135,1100,23,2,2,0,0,21,0,0,21,1365,1360,239,23,1098,5,5,0,0,5,0,0,0,0,27244
8400,3081,723,1261,821,202,74,282,180,129,81,0,48,51,42,0,0,42,9,3,0,6,102,80,31,28,21,22,0,0,0,0,22,0,22,0,27248
8401,8909,1332,2969,2587,1235,786,564,299,287,66,11,210,12,12,0,0,12,0,0,0,0,265,265,101,24,140,0,0,0,0,0,0,0,0,0,27249
8402,1570,324,513,507,167,59,31,29,20,2,2,16,9,9,0,0,9,0,0,0,0,2,0,0,0,0,2,0,0,0,0,2,0,2,0,27252
8403,19419,3322,6138,6233,2548,1178,1192,608,489,145,21,323,119,62,55,6,1,57,21,24,12,584,502,201,17,284,82,3,0,0,3,79,0,0,79,27253
8404,4399,838,1588,1332,502,139,317,181,181,44,7,130,0,0,0,0,0,0,0,0,0,136,90,14,2,74,46,46,43,3,0,0,0,0,0,27258
8405,13828,4298,4892,3820,696,122,1591,808,539,24,121,394,269,99,35,53,11,170,0,98,72,783,598,150,58,390,185,69,25,17,27,116,50,6,60,27260
8406,15814,2690,3860,4534,3309,1421,2070,1084,954,154,52,748,130,10,0,2,8,120,0,40,80,986,893,174,105,614,93,33,33,0,0,60,50,0,10,27262
8407,14619,3104,5151,4810,1122,432,1038,466,435,120,0,315,31,0,0,0,0,31,0,0,31,572,468,84,33,351,104,87,52,0,35,17,0,5,12,27263
8408,31779,2336,7462,10706,7974,3301,2398,1198,1010,222,34,754,188,170,63,51,56,18,0,5,13,1200,1030,371,63,596,170,146,128,6,12,24,0,0,24,27265
8409,16440,2066,3540,4314,3759,2761,1114,650,592,114,69,409,58,58,13,0,45,0,0,0,0,464,416,56,78,282,48,9,0,9,0,39,0,0,39,27278
8410,1599,336,360,541,234,128,80,49,49,29,0,20,0,0,0,0,0,0,0,0,0,31,14,8,0,6,17,0,0,0,0,17,0,0,17,27281
8411,11338,701,2193,3124,3742,1578,883,348,307,53,14,240,41,37,29,8,0,4,0,0,4,535,498,91,8,399,37,37,13,9,15,0,0,0,0,27282
8412,2266,261,871,653,317,164,116,72,63,8,0,55,9,8,0,8,0,1,0,0,1,44,44,19,0,25,0,0,0,0,0,0,0,0,0,27283
8413,35860,3307,10336,11572,7664,2981,2606,1432,1029,187,47,795,403,252,122,73,57,151,53,24,74,1174,980,347,85,548,194,131,26,26,79,63,0,15,48,27284
8414,16705,3577,5791,5282,1302,753,1287,726,636,54,72,510,90,42,21,6,15,48,20,0,28,561,494,20,54,420,67,41,0,14,27,26,0,0,26,27288
8415,1256,436,319,425,76,0,93,56,38,15,0,23,18,0,0,0,0,18,0,18,0,37,37,12,0,25,0,0,0,0,0,0,0,0,0,27291
8416,26491,6419,9161,7312,2425,1174,2317,1255,1051,129,146,776,204,124,74,50,0,80,49,8,23,1062,803,150,264,389,259,127,12,38,77,132,11,11,110,27292
8417,26778,5154,9400,7493,3521,1210,1952,1069,730,259,53,418,339,209,186,16,7,130,19,13,98,883,774,197,117,460,109,51,51,0,0,58,0,29,29,27295
8418,6518,1245,2254,2094,545,380,261,144,133,50,3,80,11,11,0,11,0,0,0,0,0,117,101,4,9,88,16,11,0,11,0,5,0,0,5,27298
8419,3480,720,1563,953,234,10,333,156,125,8,0,117,31,18,18,0,0,13,0,0,13,177,128,0,54,74,49,49,49,0,0,0,0,0,0,27299
8420,6124,653,1853,2060,1154,404,670,341,286,8,64,214,55,12,12,0,0,43,0,0,43,329,226,65,43,118,103,103,19,29,55,0,0,0,0,27301
8421,18761,2364,5058,6210,3370,1759,1209,532,339,44,72,223,193,134,111,8,15,59,56,0,3,677,570,228,35,307,107,55,53,0,2,52,17,21,14,27302
8422,1235,263,477,408,43,44,39,19,19,0,0,19,0,0,0,0,0,0,0,0,0,20,20,6,0,14,0,0,0,0,0,0,0,0,0,27305
8423,4849,1270,1478,1364,528,209,277,121,91,0,9,82,30,30,0,30,0,0,0,0,0,156,104,3,30,71,52,52,41,11,0,0,0,0,0,27306
8424,4417,161,916,1060,1358,922,317,169,169,17,0,152,0,0,0,0,0,0,0,0,0,148,148,94,19,35,0,0,0,0,0,0,0,0,0,27310
8425,2541,501,1091,779,148,22,156,120,93,0,36,57,27,0,0,0,0,27,0,27,0,36,36,16,8,12,0,0,0,0,0,0,0,0,0,27311
8426,14334,1329,2807,3799,3399,3000,569,284,272,43,0,229,12,3,0,0,3,9,0,0,9,285,285,75,13,197,0,0,0,0,0,0,0,0,0,27312
8427,4940,520,1893,1675,583,269,217,158,130,27,10,93,28,28,0,28,0,0,0,0,0,59,59,21,14,24,0,0,0,0,0,0,0,0,0,27313
8428,1285,221,505,459,59,41,34,0,0,0,0,0,0,0,0,0,0,0,0,0,0,34,34,23,0,11,0,0,0,0,0,0,0,0,0,27314
8429,1763,538,607,435,101,82,86,39,28,7,0,21,11,0,0,0,0,11,0,11,0,47,47,7,8,32,0,0,0,0,0,0,0,0,0,27315
8430,4676,983,1552,1395,510,236,321,220,158,27,12,119,62,8,0,8,0,54,0,30,24,101,62,3,0,59,39,4,4,0,0,35,9,0,26,27316
8431,11234,2198,4243,3192,1287,314,796,436,389,80,34,275,47,17,17,0,0,30,18,12,0,360,344,29,27,288,16,16,16,0,0,0,0,0,0,27317
8432,27151,5545,9276,8546,2852,932,2006,935,657,69,50,538,278,157,63,52,42,121,64,0,57,1071,926,155,86,685,145,100,35,2,63,45,32,0,13,27320
8433,4406,969,1688,1226,359,164,515,123,115,7,0,108,8,0,0,0,0,8,0,0,8,392,215,10,0,205,177,177,21,156,0,0,0,0,0,27325
8434,2643,688,928,833,156,38,274,186,147,12,0,135,39,8,8,0,0,31,0,31,0,88,52,29,0,23,36,0,0,0,0,36,0,9,27,27326
8435,25978,4958,7543,7889,4053,1535,2295,1105,865,272,25,568,240,151,86,0,65,89,45,0,44,1190,802,330,81,391,388,319,192,63,64,69,25,12,32,27330
8436,19388,3083,4663,7604,2877,1161,1418,885,766,157,102,507,119,34,34,0,0,85,58,27,0,533,435,46,56,333,98,7,0,0,7,91,39,19,33,27332
8437,33,0,0,0,0,33,0,0,0,0,0,0,0,0,0,0,0,0,0,0,0,0,0,0,0,0,0,0,0,0,0,0,0,0,0,27340
8438,4072,1034,1323,1246,370,99,475,244,162,2,18,142,82,82,17,65,0,0,0,0,0,231,127,54,18,55,104,67,0,32,35,37,19,18,0,27341
8439,1065,186,474,244,57,104,55,5,5,0,0,5,0,0,0,0,0,0,0,0,0,50,18,0,0,18,32,0,0,0,0,32,0,0,32,27343
8440,11865,3074,3956,3032,1024,779,1147,582,358,71,41,246,224,87,87,0,0,137,63,64,10,565,485,66,58,361,80,80,31,40,9,0,0,0,0,27344
8441,4698,1007,1756,1288,480,167,347,91,76,14,17,45,15,15,0,0,15,0,0,0,0,256,256,143,16,97,0,0,0,0,0,0,0,0,0,27349
8442,5189,1253,1997,1367,467,105,208,136,116,0,0,116,20,20,20,0,0,0,0,0,0,72,22,0,9,13,50,19,0,0,19,31,0,0,31,27350
8443,1618,394,700,428,75,21,246,73,59,6,2,51,14,14,0,0,14,0,0,0,0,173,118,81,0,37,55,0,0,0,0,55,0,0,55,27355
8444,2097,698,629,605,129,36,143,35,17,0,8,9,18,10,10,0,0,8,0,0,8,108,100,17,0,83,8,8,8,0,0,0,0,0,0,27356
8445,4640,748,1602,1378,656,256,445,206,158,58,22,78,48,48,0,48,0,0,0,0,0,239,150,87,16,47,89,15,0,0,15,74,0,0,74,27357
8446,10198,735,2157,2689,3059,1558,891,425,323,26,18,279,102,49,49,0,0,53,0,0,53,466,376,176,9,191,90,90,73,17,0,0,0,0,0,27358
8447,30579,6841,10521,9096,3060,1061,2116,1191,1007,105,236,666,184,84,24,29,31,100,0,35,65,925,767,137,131,499,158,135,41,15,79,23,0,0,23,27360
8448,10015,1988,3677,3050,893,407,644,352,278,53,0,225,74,29,14,0,15,45,30,0,15,292,257,0,45,212,35,12,12,0,0,23,0,0,23,27370
8449,5685,1236,1507,2005,644,293,397,289,189,12,30,147,100,87,76,0,11,13,0,13,0,108,104,38,5,61,4,4,0,4,0,0,0,0,0,27371
8450,7235,348,1595,2671,1689,932,574,265,228,14,0,214,37,25,25,0,0,12,0,12,0,309,284,24,17,243,25,18,0,0,18,7,0,0,7,27376
8451,5214,372,1515,1459,1210,658,422,172,155,16,0,139,17,17,0,0,17,0,0,0,0,250,191,37,0,154,59,7,7,0,0,52,0,0,52,27377
8452,3413,978,1078,1037,192,128,251,90,75,11,23,41,15,15,10,0,5,0,0,0,0,161,107,10,3,94,54,38,20,9,9,16,0,0,16,27379
8453,11359,2366,3102,3204,1793,894,2872,1264,1193,283,162,748,71,39,29,10,0,32,0,0,32,1608,1559,332,98,1129,49,49,30,0,19,0,0,0,0,27401
8454,11345,1277,2205,3321,2648,1894,3188,1369,1329,139,133,1057,40,20,0,0,20,20,0,0,20,1819,1798,396,224,1178,21,21,21,0,0,0,0,0,0,27403
8455,28116,5973,8738,8900,3280,1225,2727,1367,1102,126,114,862,265,196,27,21,148,69,0,18,51,1360,1075,153,112,810,285,191,28,25,138,94,84,0,10,27405
8456,36642,5741,10987,10796,6426,2692,2849,1589,1317,161,59,1097,272,115,15,16,84,157,7,55,95,1260,1028,229,88,711,232,95,24,0,71,137,24,17,96,27406
8457,31291,4655,8647,8499,6909,2581,2552,1116,892,54,130,708,224,133,88,45,0,91,21,12,58,1436,1194,104,38,1052,242,60,0,6,54,182,44,54,84,27407
8458,13426,667,1815,3396,4835,2713,744,357,341,80,8,253,16,0,0,0,0,16,0,0,16,387,347,55,0,292,40,17,17,0,0,23,0,0,23,27408
8459,10365,680,2867,3427,2313,1078,492,185,171,69,14,88,14,14,14,0,0,0,0,0,0,307,292,94,105,93,15,15,0,15,0,0,0,0,0,27409
8460,37652,1602,5627,10401,12402,7620,2732,1436,1338,247,45,1046,98,98,31,37,30,0,0,0,0,1296,1178,249,115,814,118,110,28,32,50,8,0,0,8,27410
8461,19900,906,4332,5514,5812,3336,1377,718,564,205,39,320,154,80,0,0,80,74,0,0,74,659,511,63,0,448,148,87,0,0,87,61,24,0,37,27455
8462,11515,1875,4071,3741,1346,482,609,201,170,50,23,97,31,31,31,0,0,0,0,0,0,408,342,75,48,219,66,66,47,7,12,0,0,0,0,27501
8463,19996,881,2210,4742,7966,4197,1544,752,716,351,61,304,36,36,36,0,0,0,0,0,0,792,714,355,87,272,78,78,0,78,0,0,0,0,0,27502
8464,5478,762,2162,1396,523,635,167,128,120,0,0,120,8,8,0,0,8,0,0,0,0,39,39,0,0,39,0,0,0,0,0,0,0,0,0,27503
8465,10044,2053,2876,3389,1329,397,701,279,226,15,0,211,53,37,0,12,25,16,0,0,16,422,363,66,1,296,59,30,0,30,0,29,0,0,29,27504
8466,3645,754,1215,1230,282,164,341,215,156,40,26,90,59,47,47,0,0,12,0,12,0,126,111,20,0,91,15,15,5,0,10,0,0,0,0,27505
8467,968,286,318,270,94,0,11,11,11,0,0,11,0,0,0,0,0,0,0,0,0,0,0,0,0,0,0,0,0,0,0,0,0,0,0,27507
8468,1499,452,514,403,117,13,49,29,2,0,2,0,27,25,21,0,4,2,0,0,2,20,0,0,0,0,20,20,0,0,20,0,0,0,0,27508
8469,2983,814,980,912,182,95,490,405,163,0,0,163,242,41,0,0,41,201,0,0,201,85,82,8,30,44,3,3,0,0,3,0,0,0,0,27509
8470,9954,1198,1217,1701,2743,3095,322,99,87,7,0,80,12,0,0,0,0,12,0,0,12,223,162,37,0,125,61,61,0,0,61,0,0,0,0,27510
8471,23101,2696,3655,5969,6723,4058,1820,1118,919,268,48,603,199,86,86,0,0,113,57,32,24,702,601,164,23,414,101,92,38,0,54,9,9,0,0,27511
8472,27734,960,2984,6828,10701,6261,1995,1141,1106,310,115,681,35,35,24,11,0,0,0,0,0,854,822,181,147,494,32,19,0,0,19,13,0,13,0,27513
8473,15470,1073,1182,1846,4086,7283,6504,2812,2719,363,64,2292,93,53,0,0,53,40,40,0,0,3692,3671,811,171,2689,21,21,21,0,0,0,0,0,0,27514
8474,21530,1174,2408,3539,6485,7924,2528,1146,1090,166,54,870,56,28,6,22,0,28,0,14,14,1382,1309,253,106,950,73,64,23,0,41,9,9,0,0,27516
8475,17445,687,1322,2674,6015,6747,879,494,479,39,46,394,15,15,15,0,0,0,0,0,0,385,237,34,0,203,148,64,64,0,0,84,0,0,84,27517
8476,13945,385,1294,2830,5330,4106,1111,473,452,29,16,407,21,19,10,0,9,2,0,0,2,638,638,228,16,394,0,0,0,0,0,0,0,0,0,27518
8477,25980,377,2111,4402,10815,8275,1724,890,802,161,25,616,88,75,75,0,0,13,0,13,0,834,813,186,107,520,21,21,21,0,0,0,0,0,0,27519
8478,24354,2232,6063,10067,4576,1416,2123,1031,820,223,0,597,211,133,93,15,25,78,65,13,0,1092,1003,274,40,689,89,89,89,0,0,0,0,0,0,27520
8479,4226,776,1331,1376,541,202,336,147,117,19,4,94,30,22,22,0,0,8,0,0,8,189,186,63,7,116,3,0,0,0,0,3,0,0,3,27521
8480,8250,991,3074,2862,838,485,701,356,269,4,0,265,87,37,22,0,15,50,0,0,50,345,345,78,105,162,0,0,0,0,0,0,0,0,0,27522
8481,6597,384,938,1701,2280,1294,497,309,270,96,0,174,39,24,18,0,6,15,0,0,15,188,176,50,8,118,12,12,0,0,12,0,0,0,0,27523
8482,7638,2064,2395,2172,607,400,810,533,377,104,16,257,156,110,102,0,8,46,0,46,0,277,230,90,57,83,47,37,20,0,17,10,0,0,10,27524
8483,8945,1716,2631,2990,1365,243,512,295,214,52,27,135,81,54,6,5,43,27,0,0,27,217,202,69,21,112,15,5,0,5,0,10,0,4,6,27525
8484,27343,2385,6858,9440,5945,2715,1803,775,627,44,79,504,148,108,82,0,26,40,11,0,29,1028,877,295,71,511,151,106,26,25,55,45,32,0,13,27526
8485,11265,871,2995,3608,2913,878,1044,677,553,70,45,438,124,124,83,26,15,0,0,0,0,367,318,66,57,195,49,38,38,0,0,11,11,0,0,27527
8486,28705,2776,7556,9900,6232,2241,2085,864,768,192,28,548,96,35,15,0,20,61,61,0,0,1221,1169,397,82,690,52,15,15,0,0,37,18,14,5,27529
8487,27015,4570,7836,9940,3107,1562,1811,912,739,189,79,471,173,82,39,43,0,91,28,11,52,899,754,164,105,485,145,71,10,45,16,74,19,7,48,27530
8488,21,0,2,19,0,0,143,122,0,0,0,0,122,122,122,0,0,0,0,0,0,21,3,3,0,0,18,18,18,0,0,0,0,0,0,27531
8489,20338,2824,5354,7892,2748,1520,1771,960,773,274,116,383,187,131,54,52,25,56,0,55,1,811,697,203,97,397,114,69,57,0,12,45,0,33,12,27534
8490,10335,2567,3553,2769,1000,446,975,463,411,137,39,235,52,11,0,0,11,41,0,10,31,512,456,36,31,389,56,56,0,20,36,0,0,0,0,27536
8491,16917,4047,6429,4786,1105,550,1443,672,452,35,58,359,220,179,87,23,69,41,17,0,24,771,594,127,0,467,177,126,86,13,27,51,16,0,35,27537
8492,12545,773,2378,3638,3971,1785,841,457,450,143,0,307,7,7,7,0,0,0,0,0,0,384,374,105,8,261,10,10,0,0,10,0,0,0,0,27539
8493,18736,593,2723,5569,6721,3130,1273,666,562,166,70,326,104,32,11,21,0,72,0,0,72,607,593,110,22,461,14,10,0,0,10,4,0,0,4,27540
8494,3113,361,859,1251,475,167,156,61,61,3,0,58,0,0,0,0,0,0,0,0,0,95,84,11,0,73,11,11,11,0,0,0,0,0,0,27541
8495,5765,817,2162,2003,647,136,383,200,106,20,0,86,94,74,16,0,58,20,6,0,14,183,135,31,24,80,48,48,16,24,8,0,0,0,0,27542
8496,2831,859,917,739,287,29,162,121,107,40,21,46,14,14,0,14,0,0,0,0,0,41,41,4,0,37,0,0,0,0,0,0,0,0,0,27544
8497,15793,2050,4394,4306,3602,1441,1329,667,547,102,60,385,120,97,97,0,0,23,0,0,23,662,622,173,51,398,40,17,17,0,0,23,0,23,0,27545
8498,12313,2043,3708,4079,1613,870,1655,734,690,160,40,490,44,35,3,0,32,9,9,0,0,921,904,138,73,693,17,17,6,0,11,0,0,0,0,27546
8499,16807,3395,5640,4944,1702,1126,1630,909,793,185,61,547,116,81,13,0,68,35,0,35,0,721,628,143,31,454,93,22,0,0,22,71,0,53,18,27549
8500,1625,354,573,377,195,126,198,138,116,0,0,116,22,0,0,0,0,22,22,0,0,60,60,0,0,60,0,0,0,0,0,0,0,0,0,27551
8501,1781,580,436,472,192,101,35,35,35,0,0,35,0,0,0,0,0,0,0,0,0,0,0,0,0,0,0,0,0,0,0,0,0,0,0,27553
8502,279,30,123,108,16,2,9,1,1,0,0,1,0,0,0,0,0,0,0,0,0,8,0,0,0,0,8,8,1,0,7,0,0,0,0,27555
8503,204,33,134,26,6,5,7,0,0,0,0,0,0,0,0,0,0,0,0,0,0,7,7,0,0,7,0,0,0,0,0,0,0,0,0,27556
8504,3903,894,1535,1026,356,92,275,148,97,17,0,80,51,13,13,0,0,38,3,0,35,127,75,60,0,15,52,52,52,0,0,0,0,0,0,27557
8505,1689,284,378,623,285,119,57,40,40,0,0,40,0,0,0,0,0,0,0,0,0,17,17,17,0,0,0,0,0,0,0,0,0,0,0,27559
8506,15976,554,1912,3681,6151,3678,705,439,357,105,39,213,82,65,65,0,0,17,0,0,17,266,229,39,13,177,37,20,20,0,0,17,17,0,0,27560
8507,1252,317,284,262,264,125,83,74,64,13,0,51,10,10,10,0,0,0,0,0,0,9,9,0,0,9,0,0,0,0,0,0,0,0,0,27562
8508,3372,639,1450,902,265,116,96,70,48,0,0,48,22,21,0,0,21,1,0,0,1,26,26,7,0,19,0,0,0,0,0,0,0,0,0,27563
8509,18746,3961,6108,5941,1873,863,1386,782,618,83,133,402,164,112,72,11,29,52,0,19,33,604,478,69,28,381,126,54,37,0,17,72,7,23,42,27565
8510,322,37,105,149,25,6,23,0,0,0,0,0,0,0,0,0,0,0,0,0,0,23,23,3,0,20,0,0,0,0,0,0,0,0,0,27568
8511,5010,1212,1462,1922,321,93,553,300,235,14,59,162,65,44,22,16,6,21,6,15,0,253,236,55,0,181,17,0,0,0,0,17,0,0,17,27569
8512,2876,414,641,937,577,307,178,96,57,16,14,27,39,3,3,0,0,36,0,0,36,82,62,20,22,20,20,0,0,0,0,20,4,0,16,27571
8513,4891,491,1770,1346,911,373,357,227,162,36,34,92,65,12,12,0,0,53,53,0,0,130,130,57,0,73,0,0,0,0,0,0,0,0,0,27572
8514,7258,1861,2462,1968,764,203,610,378,351,60,31,260,27,0,0,0,0,27,0,0,27,232,190,11,0,179,42,42,34,8,0,0,0,0,0,27573
8515,10214,1445,3725,3517,1130,397,733,350,235,42,35,158,115,100,68,0,32,15,0,1,14,383,320,36,36,248,63,40,1,34,5,23,0,0,23,27574
8516,11092,2869,3479,3343,1017,384,959,526,407,77,42,288,119,39,23,16,0,80,0,73,7,433,376,83,11,282,57,36,17,0,19,21,0,0,21,27576
8517,16845,4049,5563,4392,1937,904,1182,548,510,137,22,351,38,32,30,2,0,6,0,0,6,634,408,154,42,212,226,198,147,0,51,28,0,0,28,27577
8518,3734,761,1450,1100,322,101,299,149,122,23,0,99,27,13,2,0,11,14,0,0,14,150,150,29,0,121,0,0,0,0,0,0,0,0,0,27581
8519,102,12,13,56,4,17,2,0,0,0,0,0,0,0,0,0,0,0,0,0,0,2,0,0,0,0,2,2,0,0,2,0,0,0,0,27582
8520,4926,647,1812,1601,688,178,251,111,101,0,0,101,10,10,10,0,0,0,0,0,0,140,140,48,10,82,0,0,0,0,0,0,0,0,0,27583
8521,34911,2059,6301,11063,10546,4942,2683,1637,1301,348,76,877,336,270,158,68,44,66,18,0,48,1046,1013,313,77,623,33,21,21,0,0,12,12,0,0,27587
8522,5941,1704,1958,1649,411,219,452,180,119,38,5,76,61,61,41,3,17,0,0,0,0,272,203,38,42,123,69,0,0,0,0,69,0,0,69,27589
8523,14261,2321,4261,4523,2396,760,905,472,353,108,0,245,119,65,44,21,0,54,26,0,28,433,346,56,0,290,87,60,51,0,9,27,0,0,27,27591
8524,10146,1312,2709,3262,2273,590,1047,508,417,278,15,124,91,13,13,0,0,78,78,0,0,539,435,162,6,267,104,0,0,0,0,104,45,0,59,27592
8525,10531,1204,2919,3830,1840,738,943,462,320,70,0,250,142,111,42,0,69,31,22,0,9,481,439,105,28,306,42,0,0,0,0,42,0,0,42,27596
8526,15739,2896,5156,4621,2329,737,1389,801,658,88,47,523,143,124,93,14,17,19,0,19,0,588,478,97,78,303,110,54,41,0,13,56,9,0,47,27597
8527,5727,1420,1567,1294,1005,441,1067,578,408,21,11,376,170,19,7,0,12,151,35,40,76,489,414,67,11,336,75,36,0,0,36,39,17,11,11,27601
8528,30126,4244,6444,8796,7324,3318,2029,1269,1042,276,162,604,227,56,26,10,20,171,17,110,44,760,613,176,28,409,147,54,26,28,0,93,0,0,93,27603
8529,27434,3991,5753,8043,6916,2731,2276,1181,992,177,91,724,189,124,19,76,29,65,54,5,6,1095,863,204,145,514,232,141,0,88,53,91,9,0,82,27604
8530,3914,307,379,696,1606,926,71,46,46,12,0,34,0,0,0,0,0,0,0,0,0,25,25,16,0,9,0,0,0,0,0,0,0,0,0,27605
8531,24891,2755,3517,6065,7836,4718,2835,1212,1069,256,32,781,143,106,106,0,0,37,10,14,13,1623,1615,450,42,1123,8,7,7,0,0,1,0,0,1,27606
8532,12432,1157,1539,2462,4004,3270,6004,2836,2774,280,61,2433,62,61,45,0,16,1,0,0,1,3168,3120,520,99,2501,48,48,48,0,0,0,0,0,0,27607
8533,7950,171,875,1183,3384,2337,251,112,86,19,13,54,26,12,12,0,0,14,14,0,0,139,128,22,17,89,11,11,0,11,0,0,0,0,0,27608
8534,22545,2317,3830,5294,7247,3857,784,410,367,114,33,220,43,16,16,0,0,27,27,0,0,374,374,160,34,180,0,0,0,0,0,0,0,0,0,27609
8535,41377,7416,10489,14064,6683,2725,5158,2395,2256,388,335,1533,139,61,7,32,22,78,26,42,10,2763,2335,303,220,1812,428,254,219,17,18,174,34,78,62,27610
8536,25575,852,3219,6178,10288,5038,1231,627,488,30,23,435,139,107,87,0,20,32,32,0,0,604,523,92,39,392,81,28,12,16,0,53,11,0,42,27612
8537,29756,1197,3009,6729,12441,6380,2062,1019,989,221,64,704,30,14,0,14,0,16,0,6,10,1043,980,277,41,662,63,63,63,0,0,0,0,0,0,27613
8538,20202,368,1959,5235,8474,4166,2327,1240,1200,536,42,622,40,40,14,26,0,0,0,0,0,1087,1037,475,44,518,50,12,0,12,0,38,14,0,24,27614
8539,30623,1170,4137,6861,11886,6569,1737,958,851,215,92,544,107,107,95,6,6,0,0,0,0,779,711,178,15,518,68,33,26,0,7,35,19,0,16,27615
8540,27398,3027,5610,8845,7566,2350,2652,1435,1298,248,246,804,137,113,39,72,2,24,23,0,1,1217,993,107,164,722,224,198,110,23,65,26,13,13,0,27616
8541,10905,187,979,2672,4281,2786,445,259,211,9,0,202,48,48,48,0,0,0,0,0,0,186,186,87,0,99,0,0,0,0,0,0,0,0,0,27617
8542,13628,3517,2562,2810,2268,2471,730,278,149,29,8,112,129,60,16,36,8,69,2,0,67,452,325,25,32,268,127,30,17,13,0,97,0,37,60,27701
8543,28777,5072,6151,7903,6256,3395,2256,1328,1121,210,141,770,207,105,32,26,47,102,25,0,77,928,659,171,16,472,269,243,164,53,26,26,0,0,26,27703
8544,21325,3558,5958,6444,3673,1692,1830,826,580,124,45,411,246,177,90,31,56,69,52,0,17,1004,834,149,68,617,170,112,16,38,58,58,9,0,49,27704
8545,30507,4233,5693,5997,7179,7405,4846,2319,2061,362,157,1542,258,107,19,48,40,151,41,40,70,2527,2404,374,120,1910,123,64,26,13,25,59,0,0,59,27705
8546,30673,4494,4545,7332,7270,7032,2884,1291,1231,172,124,935,60,38,37,0,1,22,16,0,6,1593,1446,308,98,1040,147,68,56,0,12,79,61,14,4,27707
8547,565,61,18,109,228,149,4,4,4,0,0,4,0,0,0,0,0,0,0,0,0,0,0,0,0,0,0,0,0,0,0,0,0,0,0,27709
8548,14481,1185,2889,3726,4070,2611,1103,585,444,73,61,310,141,5,0,5,0,136,22,58,56,518,450,164,0,286,68,68,18,0,50,0,0,0,0,27712
8549,32872,1680,2986,6864,10937,10405,1293,654,637,164,126,347,17,17,17,0,0,0,0,0,0,639,638,222,70,346,1,1,1,0,0,0,0,0,0,27713
8550,14311,2701,5624,4700,967,319,1315,764,634,96,186,352,130,21,16,0,5,109,43,20,46,551,486,19,140,327,65,55,43,12,0,10,10,0,0,27801
8551,14170,2483,5043,3987,1966,691,1390,652,515,63,50,402,137,90,45,44,1,47,12,12,23,738,730,252,62,416,8,8,8,0,0,0,0,0,0,27803
8552,20092,2890,5965,5954,3976,1307,1634,857,682,125,86,471,175,61,58,0,3,114,0,87,27,777,668,153,62,453,109,0,0,0,0,109,0,57,52,27804
8553,2783,688,1015,876,143,61,231,66,66,5,5,56,0,0,0,0,0,0,0,0,0,165,111,0,3,108,54,38,38,0,0,16,0,16,0,27805
8554,1892,375,818,491,145,63,92,18,18,0,0,18,0,0,0,0,0,0,0,0,0,74,65,6,2,57,9,0,0,0,0,9,0,0,9,27806
8555,4476,938,1914,1184,396,44,355,163,65,6,2,57,98,45,0,38,7,53,53,0,0,192,137,48,0,89,55,44,41,0,3,11,0,0,11,27807
8556,1562,174,385,515,373,115,102,54,27,0,0,27,27,0,0,0,0,27,0,0,27,48,8,0,0,8,40,0,0,0,0,40,40,0,0,27808
8557,2691,424,827,893,469,78,268,69,69,15,18,36,0,0,0,0,0,0,0,0,0,199,195,117,3,75,4,0,0,0,0,4,0,0,4,27809
8558,3068,728,977,925,234,204,173,79,68,10,20,38,11,11,0,6,5,0,0,0,0,94,82,49,2,31,12,12,0,0,12,0,0,0,0,27810
8559,2120,482,685,679,187,87,122,67,57,7,0,50,10,10,0,10,0,0,0,0,0,55,55,0,48,7,0,0,0,0,0,0,0,0,0,27812
8560,398,69,156,141,18,14,33,20,10,0,0,10,10,10,0,2,8,0,0,0,0,13,13,5,0,8,0,0,0,0,0,0,0,0,0,27813
8561,1200,207,431,398,135,29,15,15,15,15,0,0,0,0,0,0,0,0,0,0,0,0,0,0,0,0,0,0,0,0,0,0,0,0,0,27814
8562,1635,400,568,450,177,40,86,22,22,0,0,22,0,0,0,0,0,0,0,0,0,64,64,17,2,45,0,0,0,0,0,0,0,0,0,27816
8563,4989,771,1576,1595,626,421,277,242,103,15,0,88,139,139,62,0,77,0,0,0,0,35,18,0,2,16,17,17,0,0,17,0,0,0,0,27817
8564,1155,257,400,378,50,70,34,25,25,0,0,25,0,0,0,0,0,0,0,0,0,9,7,0,0,7,2,2,0,0,2,0,0,0,0,27818
8565,266,70,72,111,13,0,5,2,0,0,0,0,2,0,0,0,0,2,0,2,0,3,3,0,0,3,0,0,0,0,0,0,0,0,0,27819
8566,2041,333,858,595,211,44,224,162,162,0,38,124,0,0,0,0,0,0,0,0,0,62,62,35,0,27,0,0,0,0,0,0,0,0,0,27820
8567,149,73,41,28,7,0,0,0,0,0,0,0,0,0,0,0,0,0,0,0,0,0,0,0,0,0,0,0,0,0,0,0,0,0,0,27821
8568,5809,1040,2461,1847,355,106,328,142,123,33,9,81,19,3,0,3,0,16,0,0,16,186,147,73,0,74,39,39,7,7,25,0,0,0,0,27822
8569,5163,1480,2036,1324,266,57,326,136,110,10,20,80,26,26,14,6,6,0,0,0,0,190,148,41,0,107,42,42,0,37,5,0,0,0,0,27823
8570,1269,268,349,459,179,14,157,93,93,85,0,8,0,0,0,0,0,0,0,0,0,64,64,32,18,14,0,0,0,0,0,0,0,0,0,27824
8571,58,6,27,15,4,6,11,0,0,0,0,0,0,0,0,0,0,0,0,0,0,11,11,0,0,11,0,0,0,0,0,0,0,0,0,27825
8572,784,257,286,241,0,0,85,36,0,0,0,0,36,36,0,36,0,0,0,0,0,49,13,0,0,13,36,36,36,0,0,0,0,0,0,27826
8573,44,9,22,8,4,1,0,0,0,0,0,0,0,0,0,0,0,0,0,0,0,0,0,0,0,0,0,0,0,0,0,0,0,0,0,27827
8574,5828,1159,1955,2031,551,132,517,199,127,22,85,20,72,37,0,24,13,35,19,16,0,318,252,175,0,77,66,17,9,0,8,49,0,0,49,27828
8575,1476,355,607,354,135,25,81,34,34,7,3,24,0,0,0,0,0,0,0,0,0,47,34,0,4,30,13,0,0,0,0,13,0,0,13,27829
8576,3435,624,1340,1131,275,65,218,149,118,67,24,27,31,0,0,0,0,31,31,0,0,69,66,0,21,45,3,3,0,0,3,0,0,0,0,27830
8577,2596,877,918,642,141,18,240,114,114,5,0,109,0,0,0,0,0,0,0,0,0,126,68,0,29,39,58,58,0,47,11,0,0,0,0,27831
8578,1729,721,561,370,33,44,149,41,36,0,0,36,5,0,0,0,0,5,5,0,0,108,97,3,3,91,11,11,0,0,11,0,0,0,0,27832
8579,31969,5877,9219,10067,4403,2403,2654,1260,1064,254,285,525,196,81,0,0,81,115,25,63,27,1394,1200,323,176,701,194,123,0,69,54,71,3,14,54,27834
8580,3975,614,1202,1448,525,186,121,66,66,10,2,54,0,0,0,0,0,0,0,0,0,55,54,0,0,54,1,0,0,0,0,1,0,0,1,27837
8581,3266,820,1320,905,138,83,154,37,26,0,0,26,11,11,0,0,11,0,0,0,0,117,117,15,2,100,0,0,0,0,0,0,0,0,0,27839
8582,293,75,89,110,15,4,21,10,10,0,3,7,0,0,0,0,0,0,0,0,0,11,11,0,5,6,0,0,0,0,0,0,0,0,0,27840
8583,42,2,10,22,5,3,0,0,0,0,0,0,0,0,0,0,0,0,0,0,0,0,0,0,0,0,0,0,0,0,0,0,0,0,0,27841
8584,1349,158,395,547,105,144,42,21,0,0,0,0,21,21,21,0,0,0,0,0,0,21,21,0,0,21,0,0,0,0,0,0,0,0,0,27842
8585,875,250,325,219,80,1,100,36,28,26,0,2,8,8,0,1,7,0,0,0,0,64,58,0,8,50,6,2,0,0,2,4,0,0,4,27843
8586,1916,607,638,541,94,36,177,95,49,3,0,46,46,23,8,15,0,23,0,0,23,82,43,14,5,24,39,30,25,0,5,9,0,0,9,27844
8587,2123,502,697,760,140,24,25,7,3,0,0,3,4,0,0,0,0,4,0,0,4,18,18,0,0,18,0,0,0,0,0,0,0,0,0,27845
8588,2256,349,758,939,164,46,164,82,82,9,23,50,0,0,0,0,0,0,0,0,0,82,65,13,21,31,17,9,9,0,0,8,0,0,8,27846
8589,687,185,316,148,31,7,33,20,20,14,6,0,0,0,0,0,0,0,0,0,0,13,13,0,0,13,0,0,0,0,0,0,0,0,0,27847
8590,970,340,352,170,106,2,172,101,100,5,5,90,1,0,0,0,0,1,0,1,0,71,71,0,0,71,0,0,0,0,0,0,0,0,0,27849
8591,5631,791,1986,1866,639,349,421,183,125,38,0,87,58,40,37,0,3,18,0,0,18,238,176,54,0,122,62,37,37,0,0,25,7,0,18,27850
8592,3894,776,1574,1139,359,46,223,76,76,19,14,43,0,0,0,0,0,0,0,0,0,147,130,41,31,58,17,17,0,0,17,0,0,0,0,27851
8593,1896,286,716,652,158,84,216,122,84,9,41,34,38,38,0,23,15,0,0,0,0,94,94,0,6,88,0,0,0,0,0,0,0,0,0,27852
8594,366,134,103,101,19,9,38,12,12,0,0,12,0,0,0,0,0,0,0,0,0,26,11,0,0,11,15,15,15,0,0,0,0,0,0,27853
8595,3692,659,1218,1007,429,379,715,298,288,21,47,220,10,0,0,0,0,10,0,0,10,417,391,105,8,278,26,19,0,19,0,7,0,0,7,27855
8596,11808,2016,3402,4178,1679,533,656,414,361,103,46,212,53,23,8,14,1,30,0,0,30,242,214,89,0,125,28,22,21,1,0,6,6,0,0,27856
8597,831,189,320,250,59,13,57,41,21,11,0,10,20,20,0,20,0,0,0,0,0,16,16,0,0,16,0,0,0,0,0,0,0,0,0,27857
8598,29284,2247,5847,9223,7228,4739,7379,3023,2894,599,398,1897,129,50,10,33,7,79,72,7,0,4356,4311,1080,284,2947,45,25,16,0,9,20,0,12,8,27858
8599,1869,390,767,605,71,36,260,128,37,30,1,6,91,38,0,0,38,53,45,0,8,132,132,84,0,48,0,0,0,0,0,0,0,0,0,27860
8600,61,18,27,16,0,0,0,0,0,0,0,0,0,0,0,0,0,0,0,0,0,0,0,0,0,0,0,0,0,0,0,0,0,0,0,27861
8601,596,43,167,195,110,81,29,28,23,2,0,21,5,0,0,0,0,5,0,0,5,1,1,0,0,1,0,0,0,0,0,0,0,0,0,27862
8602,8157,1042,2611,3220,949,335,670,358,275,123,45,107,83,13,13,0,0,70,0,20,50,312,292,147,18,127,20,11,1,10,0,9,5,4,0,27863
8603,3283,694,1247,1039,253,50,254,96,69,21,0,48,27,22,22,0,0,5,0,5,0,158,146,57,29,60,12,6,6,0,0,6,0,6,0,27864
8604,1265,143,471,582,46,23,116,116,116,31,43,42,0,0,0,0,0,0,0,0,0,0,0,0,0,0,0,0,0,0,0,0,0,0,0,27865
8605,564,191,142,186,45,0,40,40,40,0,0,40,0,0,0,0,0,0,0,0,0,0,0,0,0,0,0,0,0,0,0,0,0,0,0,27866
8606,1587,457,645,368,73,44,116,33,22,0,0,22,11,6,6,0,0,5,0,5,0,83,83,0,32,51,0,0,0,0,0,0,0,0,0,27869
8607,18057,3696,5958,5775,1680,948,1894,1017,689,68,28,593,328,75,0,67,8,253,44,142,67,877,843,159,78,606,34,21,0,0,21,13,0,0,13,27870
8608,3155,817,1139,936,201,62,245,129,89,49,0,40,40,40,0,27,13,0,0,0,0,116,90,0,29,61,26,26,9,11,6,0,0,0,0,27871
8609,252,95,91,48,17,1,6,6,3,0,1,2,3,0,0,0,0,3,3,0,0,0,0,0,0,0,0,0,0,0,0,0,0,0,0,27872
8610,234,46,115,37,31,5,2,2,2,0,0,2,0,0,0,0,0,0,0,0,0,0,0,0,0,0,0,0,0,0,0,0,0,0,0,27873
8611,3229,1175,1135,691,185,43,187,164,136,0,0,136,28,3,3,0,0,25,12,0,13,23,23,0,0,23,0,0,0,0,0,0,0,0,0,27874
8612,448,73,117,219,17,22,33,33,0,0,0,0,33,33,0,0,33,0,0,0,0,0,0,0,0,0,0,0,0,0,0,0,0,0,0,27875
8613,1015,242,401,262,100,10,76,30,27,0,0,27,3,3,0,0,3,0,0,0,0,46,46,24,0,22,0,0,0,0,0,0,0,0,0,27876
8614,1038,189,360,435,31,23,89,65,65,19,18,28,0,0,0,0,0,0,0,0,0,24,24,0,10,14,0,0,0,0,0,0,0,0,0,27878
8615,177,59,24,81,11,2,16,11,11,1,0,10,0,0,0,0,0,0,0,0,0,5,5,0,0,5,0,0,0,0,0,0,0,0,0,27879
8616,2116,581,660,646,200,29,242,202,201,38,0,163,1,1,1,0,0,0,0,0,0,40,4,4,0,0,36,36,27,0,9,0,0,0,0,27880
8617,66,19,31,16,0,0,6,1,0,0,0,0,1,0,0,0,0,1,0,0,1,5,5,0,0,5,0,0,0,0,0,0,0,0,0,27881
8618,4786,958,1825,1349,502,152,325,145,114,0,39,75,31,0,0,0,0,31,26,0,5,180,174,73,11,90,6,6,6,0,0,0,0,0,0,27882
8619,2371,569,786,702,150,164,157,107,76,12,0,64,31,1,1,0,0,30,0,0,30,50,36,6,0,30,14,14,1,10,3,0,0,0,0,27883
8620,726,193,210,237,73,13,1,1,1,0,0,1,0,0,0,0,0,0,0,0,0,0,0,0,0,0,0,0,0,0,0,0,0,0,0,27884
8621,1069,251,377,326,115,0,20,5,5,5,0,0,0,0,0,0,0,0,0,0,0,15,15,0,0,15,0,0,0,0,0,0,0,0,0,27885
8622,14908,3298,5318,4431,1393,468,1161,423,297,47,79,171,126,58,12,33,13,68,17,0,51,738,713,159,55,499,25,11,5,0,6,14,3,0,11,27886
8623,1504,533,444,358,110,59,218,118,96,0,1,95,22,22,0,22,0,0,0,0,0,100,45,28,2,15,55,0,0,0,0,55,0,0,55,27888
8624,18858,3658,6035,5512,2186,1467,1406,708,587,119,45,423,121,30,29,0,1,91,73,7,11,698,609,136,63,410,89,89,0,41,48,0,0,0,0,27889
8625,1670,448,521,441,132,128,153,112,112,13,0,99,0,0,0,0,0,0,0,0,0,41,32,0,0,32,9,9,0,9,0,0,0,0,0,27890
8626,3619,812,1529,941,266,71,284,79,79,0,3,76,0,0,0,0,0,0,0,0,0,205,168,38,0,130,37,37,0,15,22,0,0,0,0,27891
8627,10445,1733,4102,3157,1052,401,635,352,330,72,0,258,22,0,0,0,0,22,0,14,8,283,258,41,11,206,25,24,0,24,0,1,0,0,1,27892
8628,26430,7407,8175,7235,2788,825,2315,1004,768,155,118,495,236,136,100,14,22,100,49,6,45,1311,1124,245,136,743,187,70,20,44,6,117,39,49,29,27893
8629,13835,1331,3586,4208,3226,1484,1198,682,619,208,46,365,63,31,20,11,0,32,0,24,8,516,425,72,50,303,91,41,41,0,0,50,0,34,16,27896
8630,1346,489,552,258,25,22,85,41,28,0,0,28,13,0,0,0,0,13,0,0,13,44,30,10,0,20,14,14,0,0,14,0,0,0,0,27897
8631,26419,4291,7529,9272,3433,1894,2589,1148,1043,360,167,516,105,84,50,12,22,21,0,18,3,1441,1259,268,201,790,182,130,65,49,16,52,20,0,32,27909
8632,7968,1912,2447,2398,841,370,677,436,352,26,63,263,84,30,1,8,21,54,7,41,6,241,213,60,12,141,28,18,6,0,12,10,10,0,0,27910
8633,681,146,159,159,156,61,56,40,0,0,0,0,40,40,40,0,0,0,0,0,0,16,16,16,0,0,0,0,0,0,0,0,0,0,0,27915
8634,434,16,155,190,51,22,0,0,0,0,0,0,0,0,0,0,0,0,0,0,0,0,0,0,0,0,0,0,0,0,0,0,0,0,0,27916
8635,707,120,364,182,41,0,59,24,12,12,0,0,12,12,12,0,0,0,0,0,0,35,0,0,0,0,35,35,0,0,35,0,0,0,0,27917
8636,699,79,236,174,173,37,68,11,11,0,0,11,0,0,0,0,0,0,0,0,0,57,47,21,0,26,10,10,10,0,0,0,0,0,0,27919
8637,843,95,276,357,105,10,39,39,39,0,0,39,0,0,0,0,0,0,0,0,0,0,0,0,0,0,0,0,0,0,0,0,0,0,0,27920
8638,2911,229,774,1305,333,270,386,252,252,92,76,84,0,0,0,0,0,0,0,0,0,134,123,28,8,87,11,0,0,0,0,11,11,0,0,27921
8639,702,147,230,259,50,16,27,11,5,0,0,5,6,6,6,0,0,0,0,0,0,16,16,0,0,16,0,0,0,0,0,0,0,0,0,27922
8640,294,40,42,94,76,42,24,0,0,0,0,0,0,0,0,0,0,0,0,0,0,24,24,14,0,10,0,0,0,0,0,0,0,0,0,27923
8641,1878,510,688,452,181,47,51,7,7,0,4,3,0,0,0,0,0,0,0,0,0,44,16,0,0,16,28,28,28,0,0,0,0,0,0,27924
8642,3050,902,1103,799,140,106,270,155,143,35,71,37,12,12,12,0,0,0,0,0,0,115,98,25,6,67,17,17,13,0,4,0,0,0,0,27925
8643,1151,224,479,377,37,34,50,38,18,0,0,18,20,14,14,0,0,6,0,0,6,12,12,0,0,12,0,0,0,0,0,0,0,0,0,27926
8644,722,0,158,226,213,125,14,0,0,0,0,0,0,0,0,0,0,0,0,0,0,14,14,0,0,14,0,0,0,0,0,0,0,0,0,27927
8645,1529,132,680,617,43,57,147,85,66,0,8,58,19,0,0,0,0,19,0,19,0,62,48,0,0,48,14,0,0,0,0,14,0,14,0,27928
8646,1061,70,411,319,213,48,99,71,32,13,19,0,39,32,0,32,0,7,0,0,7,28,28,12,0,16,0,0,0,0,0,0,0,0,0,27929
8647,8836,1827,2884,2330,1109,686,799,500,400,24,42,334,100,100,100,0,0,0,0,0,0,299,270,22,16,232,29,29,8,0,21,0,0,0,0,27932
8648,1033,190,385,299,112,47,63,37,19,0,7,12,18,18,0,18,0,0,0,0,0,26,26,26,0,0,0,0,0,0,0,0,0,0,0,27935
8649,766,219,76,176,186,109,76,56,21,0,0,21,35,35,35,0,0,0,0,0,0,20,20,0,0,20,0,0,0,0,0,0,0,0,0,27936
8650,2858,435,1109,1118,166,30,240,132,81,0,5,76,51,51,0,17,34,0,0,0,0,108,89,16,8,65,19,19,0,0,19,0,0,0,0,27937
8651,1120,256,281,378,133,72,81,48,48,0,0,48,0,0,0,0,0,0,0,0,0,33,25,3,0,22,8,8,0,8,0,0,0,0,0,27938
8652,1848,263,685,661,185,54,25,25,25,0,0,25,0,0,0,0,0,0,0,0,0,0,0,0,0,0,0,0,0,0,0,0,0,0,0,27939
8653,378,33,76,110,137,22,0,0,0,0,0,0,0,0,0,0,0,0,0,0,0,0,0,0,0,0,0,0,0,0,0,0,0,0,0,27941
8654,477,110,166,134,62,5,9,0,0,0,0,0,0,0,0,0,0,0,0,0,0,9,4,0,3,1,5,5,0,0,5,0,0,0,0,27942
8655,203,14,84,43,62,0,0,0,0,0,0,0,0,0,0,0,0,0,0,0,0,0,0,0,0,0,0,0,0,0,0,0,0,0,0,27943
8656,8944,1442,3186,2733,1115,468,488,230,228,86,0,142,2,1,0,0,1,1,0,0,1,258,203,82,5,116,55,55,0,55,0,0,0,0,0,27944
8657,1032,144,541,255,84,8,43,43,43,0,0,43,0,0,0,0,0,0,0,0,0,0,0,0,0,0,0,0,0,0,0,0,0,0,0,27946
8658,970,262,356,207,101,44,53,35,11,11,0,0,24,24,24,0,0,0,0,0,0,18,18,12,0,6,0,0,0,0,0,0,0,0,0,27947
8659,7924,410,2146,3030,1831,507,354,256,233,141,29,63,23,0,0,0,0,23,23,0,0,98,73,39,0,34,25,25,25,0,0,0,0,0,0,27948
8660,5330,219,1099,1785,1497,730,397,189,179,83,0,96,10,10,10,0,0,0,0,0,0,208,208,61,54,93,0,0,0,0,0,0,0,0,0,27949
8661,1547,246,578,522,143,58,85,14,14,0,0,14,0,0,0,0,0,0,0,0,0,71,63,27,13,23,8,8,8,0,0,0,0,0,0,27950
8662,718,230,163,175,98,52,72,41,18,0,18,0,23,15,0,15,0,8,0,8,0,31,18,0,0,18,13,0,0,0,0,13,0,0,13,27953
8663,4527,491,1229,1690,716,401,230,111,99,21,0,78,12,6,6,0,0,6,0,0,6,119,105,74,0,31,14,14,6,0,8,0,0,0,0,27954
8664,126,8,32,58,28,0,23,8,0,0,0,0,8,0,0,0,0,8,0,0,8,15,15,15,0,0,0,0,0,0,0,0,0,0,0,27956
8665,1141,276,393,337,108,27,67,67,67,11,0,56,0,0,0,0,0,0,0,0,0,0,0,0,0,0,0,0,0,0,0,0,0,0,0,27957
8666,6369,1039,2138,2199,758,235,653,376,272,22,23,227,104,53,33,20,0,51,0,51,0,277,255,21,14,220,22,22,22,0,0,0,0,0,0,27958
8667,2283,73,415,914,573,308,89,62,62,0,22,40,0,0,0,0,0,0,0,0,0,27,27,27,0,0,0,0,0,0,0,0,0,0,0,27959
8668,448,0,195,180,73,0,16,2,2,0,0,2,0,0,0,0,0,0,0,0,0,14,14,14,0,0,0,0,0,0,0,0,0,0,0,27960
8669,4950,1123,1771,1336,444,276,460,197,159,0,27,132,38,0,0,0,0,38,0,0,38,263,248,27,6,215,15,15,0,15,0,0,0,0,0,27962
8670,351,14,89,143,46,59,37,0,0,0,0,0,0,0,0,0,0,0,0,0,0,37,37,37,0,0,0,0,0,0,0,0,0,0,0,27964
8671,364,71,117,137,27,12,0,0,0,0,0,0,0,0,0,0,0,0,0,0,0,0,0,0,0,0,0,0,0,0,0,0,0,0,0,27965
8672,852,152,330,171,147,52,23,23,23,17,0,6,0,0,0,0,0,0,0,0,0,0,0,0,0,0,0,0,0,0,0,0,0,0,0,27966
8673,103,16,59,20,6,2,3,1,1,1,0,0,0,0,0,0,0,0,0,0,0,2,2,0,0,2,0,0,0,0,0,0,0,0,0,27967
8674,200,72,0,72,22,34,26,26,26,26,0,0,0,0,0,0,0,0,0,0,0,0,0,0,0,0,0,0,0,0,0,0,0,0,0,27968
8675,2287,582,870,600,154,81,229,140,140,10,25,105,0,0,0,0,0,0,0,0,0,89,37,0,22,15,52,52,18,34,0,0,0,0,0,27970
8676,131,0,29,39,33,30,0,0,0,0,0,0,0,0,0,0,0,0,0,0,0,0,0,0,0,0,0,0,0,0,0,0,0,0,0,27972
8677,989,311,244,294,92,48,40,23,23,0,0,23,0,0,0,0,0,0,0,0,0,17,17,0,0,17,0,0,0,0,0,0,0,0,0,27973
8678,1094,200,284,452,125,33,145,113,113,27,0,86,0,0,0,0,0,0,0,0,0,32,32,0,0,32,0,0,0,0,0,0,0,0,0,27974
8679,2328,351,551,950,425,51,140,72,23,0,0,23,49,16,0,0,16,33,0,0,33,68,68,11,16,41,0,0,0,0,0,0,0,0,0,27976
8680,210,20,92,63,14,21,25,25,0,0,0,0,25,0,0,0,0,25,0,0,25,0,0,0,0,0,0,0,0,0,0,0,0,0,0,27978
8681,1228,142,322,515,193,56,76,36,18,0,0,18,18,18,0,10,8,0,0,0,0,40,33,0,0,33,7,7,7,0,0,0,0,0,0,27979
8682,1322,290,491,288,142,111,141,125,105,0,0,105,20,20,0,20,0,0,0,0,0,16,16,0,8,8,0,0,0,0,0,0,0,0,0,27980
8683,1342,147,401,686,82,26,65,24,24,17,0,7,0,0,0,0,0,0,0,0,0,41,41,34,0,7,0,0,0,0,0,0,0,0,0,27981
8684,96,0,0,39,57,0,0,0,0,0,0,0,0,0,0,0,0,0,0,0,0,0,0,0,0,0,0,0,0,0,0,0,0,0,0,27982
8685,7430,2073,2624,1839,626,268,483,253,246,19,0,227,7,7,7,0,0,0,0,0,0,230,230,36,18,176,0,0,0,0,0,0,0,0,0,27983
8686,201,50,77,47,22,5,11,0,0,0,0,0,0,0,0,0,0,0,0,0,0,11,11,0,0,11,0,0,0,0,0,0,0,0,0,27985
8687,2692,625,1112,647,198,110,48,41,24,22,0,2,17,4,0,0,4,13,0,4,9,7,7,2,5,0,0,0,0,0,0,0,0,0,0,27986
8688,18008,3643,5698,5437,2306,924,1216,576,493,55,66,372,83,40,34,0,6,43,0,9,34,640,557,142,100,315,83,65,24,0,41,18,0,0,18,28001
8689,801,126,232,384,44,15,159,30,17,0,0,17,13,13,0,13,0,0,0,0,0,129,129,0,0,129,0,0,0,0,0,0,0,0,0,28006
8690,478,76,230,130,42,0,29,14,14,0,0,14,0,0,0,0,0,0,0,0,0,15,15,0,8,7,0,0,0,0,0,0,0,0,0,28007
8691,623,62,178,268,83,32,43,20,20,0,9,11,0,0,0,0,0,0,0,0,0,23,7,3,0,4,16,16,0,16,0,0,0,0,0,28009
8692,14089,1909,3496,4762,2514,1408,1024,573,485,94,24,367,88,88,63,25,0,0,0,0,0,451,379,65,30,284,72,60,48,12,0,12,0,11,1,28012
8693,8739,1991,3107,2895,564,182,672,316,251,17,26,208,65,54,16,0,38,11,0,0,11,356,313,149,0,164,43,43,14,0,29,0,0,0,0,28016
8694,0,0,0,0,0,0,339,92,92,4,0,88,0,0,0,0,0,0,0,0,0,247,247,40,0,207,0,0,0,0,0,0,0,0,0,28017
8695,4122,735,1349,1343,467,228,476,318,295,90,64,141,23,21,0,21,0,2,0,0,2,158,113,28,30,55,45,0,0,0,0,45,0,0,45,28018
8696,0,0,0,0,0,0,0,0,0,0,0,0,0,0,0,0,0,0,0,0,0,0,0,0,0,0,0,0,0,0,0,0,0,0,0,28019
8697,1584,417,643,446,46,32,51,21,10,0,0,10,11,7,7,0,0,4,0,4,0,30,25,0,0,25,5,5,5,0,0,0,0,0,0,28020
8698,8574,1500,2762,2631,1025,656,759,351,276,69,73,134,75,60,22,0,38,15,0,5,10,408,337,60,57,220,71,41,19,9,13,30,8,22,0,28021
8699,9930,1774,3255,3470,774,657,558,251,185,85,9,91,66,11,0,11,0,55,0,0,55,307,289,43,84,162,18,18,0,0,18,0,0,0,0,28023
8700,33205,5046,9366,11450,5200,2143,2865,1641,1336,177,255,904,305,266,191,62,13,39,16,0,23,1224,1036,220,225,591,188,94,50,27,17,94,0,19,75,28025
8701,36482,4348,9149,12074,7647,3264,3485,1830,1520,367,90,1063,310,150,100,41,9,160,70,57,33,1655,1508,296,108,1104,147,141,69,0,72,6,0,3,3,28027
8702,17363,1061,3001,4468,5992,2841,1281,729,597,242,38,317,132,61,61,0,0,71,0,22,49,552,384,141,11,232,168,39,39,0,0,129,0,45,84,28031
8703,2144,390,471,600,460,223,143,84,40,19,0,21,44,44,44,0,0,0,0,0,0,59,30,13,0,17,29,29,0,0,29,0,0,0,0,28032
8704,1993,419,832,618,59,65,83,37,30,0,0,30,7,0,0,0,0,7,0,7,0,46,46,0,0,46,0,0,0,0,0,0,0,0,0,28033
8705,11803,2232,3842,4255,1228,246,694,483,433,103,37,293,50,39,0,39,0,11,0,0,11,211,133,15,21,97,78,38,0,0,38,40,0,9,31,28034
8706,8811,345,1428,2051,2887,2100,1543,846,822,184,24,614,24,24,24,0,0,0,0,0,0,697,673,141,101,431,24,24,24,0,0,0,0,0,0,28036
8707,12937,643,3567,4599,3045,1083,817,481,327,74,47,206,154,111,111,0,0,43,43,0,0,336,284,50,24,210,52,31,31,0,0,21,0,0,21,28037
8708,51,6,32,13,0,0,0,0,0,0,0,0,0,0,0,0,0,0,0,0,0,0,0,0,0,0,0,0,0,0,0,0,0,0,0,28039
8709,4908,667,1381,2043,447,370,379,195,153,0,0,153,42,0,0,0,0,42,0,0,42,184,132,69,0,63,52,12,12,0,0,40,0,0,40,28040
8710,14667,3336,4228,5016,1241,846,1211,513,467,70,164,233,46,39,38,0,1,7,0,0,7,698,578,113,21,444,120,77,28,0,49,43,0,14,29,28043
8711,22590,6820,7539,5925,1670,636,2163,956,724,163,79,482,232,68,0,49,19,164,26,9,129,1207,808,200,60,548,399,242,134,68,40,157,22,50,85,28052
8712,23146,4126,6158,8103,3299,1460,1865,989,824,181,42,601,165,75,5,40,30,90,24,15,51,876,821,178,67,576,55,29,29,0,0,26,0,20,6,28054
8713,21914,2775,5660,7888,4068,1523,1719,949,793,249,77,467,156,86,5,46,35,70,0,0,70,770,714,272,84,358,56,32,24,0,8,24,13,0,11,28056
8714,2507,536,831,825,187,128,168,89,42,0,22,20,47,22,0,12,10,25,15,10,0,79,65,41,0,24,14,14,0,14,0,0,0,0,0,28071
8715,899,142,236,371,116,34,76,32,32,22,0,10,0,0,0,0,0,0,0,0,0,44,44,19,0,25,0,0,0,0,0,0,0,0,0,28072
8716,3349,804,1152,1117,210,66,277,118,99,7,5,87,19,7,7,0,0,12,0,12,0,159,110,0,8,102,49,0,0,0,0,49,0,2,47,28073
8717,10043,598,2040,3570,2444,1391,1188,333,305,109,38,158,28,28,20,0,8,0,0,0,0,855,840,141,35,664,15,15,15,0,0,0,0,0,0,28075
8718,697,308,296,65,10,18,76,46,29,0,0,29,17,0,0,0,0,17,17,0,0,30,30,0,0,30,0,0,0,0,0,0,0,0,0,28076
8719,273,120,95,49,9,0,40,8,0,0,0,0,8,0,0,0,0,8,0,0,8,32,25,2,0,23,7,0,0,0,0,7,0,7,0,28077
8720,34831,2065,5445,9186,12848,5287,2058,1000,888,299,129,460,112,80,80,0,0,32,0,0,32,1058,904,382,61,461,154,41,24,17,0,113,29,74,10,28078
8721,19893,1187,5117,6886,4900,1803,2107,1027,993,210,60,723,34,10,0,6,4,24,4,0,20,1080,1020,294,210,516,60,60,43,0,17,0,0,0,0,28079
8722,5583,690,1650,2438,694,111,584,341,304,9,28,267,37,0,0,0,0,37,0,0,37,243,243,125,0,118,0,0,0,0,0,0,0,0,0,28080
8723,16920,3646,5849,4729,1904,792,991,405,304,39,19,246,101,47,30,17,0,54,21,21,12,586,415,76,65,274,171,145,32,63,50,26,0,0,26,28081
8724,16060,3756,5059,5191,1460,594,1126,510,397,33,94,270,113,92,0,59,33,21,0,0,21,616,539,95,83,361,77,65,13,32,20,12,0,0,12,28083
8725,18346,3166,6474,6311,1617,778,1524,921,803,116,42,645,118,91,55,19,17,27,0,27,0,603,476,215,124,137,127,106,75,31,0,21,9,12,0,28086
8726,2170,308,962,588,312,0,40,19,19,0,0,19,0,0,0,0,0,0,0,0,0,21,21,0,0,21,0,0,0,0,0,0,0,0,0,28088
8727,58,9,19,2,23,5,78,10,10,0,0,10,0,0,0,0,0,0,0,0,0,68,68,0,0,68,0,0,0,0,0,0,0,0,0,28089
8728,5857,1114,2150,1908,433,252,424,282,230,23,3,204,52,39,25,0,14,13,0,3,10,142,119,5,30,84,23,0,0,0,0,23,7,0,16,28090
8729,1620,327,708,475,69,41,116,79,60,0,19,41,19,19,19,0,0,0,0,0,0,37,37,10,3,24,0,0,0,0,0,0,0,0,0,28091
8730,26490,5996,7913,8685,2933,963,1783,972,746,213,127,406,226,88,77,10,1,138,0,0,138,811,704,209,113,382,107,63,36,14,13,44,0,28,16,28092
8731,3839,417,1395,1573,237,217,176,75,50,7,12,31,25,25,0,25,0,0,0,0,0,101,87,37,7,43,14,8,8,0,0,6,0,0,6,28097
8732,2741,468,1047,851,231,144,212,69,47,11,0,36,22,22,9,0,13,0,0,0,0,143,52,0,0,52,91,91,65,10,16,0,0,0,0,28098
8733,528,76,164,190,52,46,30,12,7,0,0,7,5,5,5,0,0,0,0,0,0,18,18,0,0,18,0,0,0,0,0,0,0,0,0,28101
8734,52,3,21,10,16,2,7,0,0,0,0,0,0,0,0,0,0,0,0,0,0,7,7,0,0,7,0,0,0,0,0,0,0,0,0,28102
8735,7159,1249,2780,2013,667,450,493,199,113,37,22,54,86,64,64,0,0,22,0,16,6,294,250,29,5,216,44,33,33,0,0,11,0,5,6,28103
8736,19229,1086,3334,5815,6735,2259,1919,969,951,358,150,443,18,13,0,13,0,5,1,0,4,950,899,241,51,607,51,51,47,0,4,0,0,0,0,28104
8737,27038,1500,4928,8435,8534,3641,2098,932,849,203,57,589,83,62,0,54,8,21,0,13,8,1166,1032,432,79,521,134,103,27,0,76,31,31,0,0,28105
8738,4802,564,1872,1758,462,146,562,339,186,46,0,140,153,106,45,12,49,47,22,0,25,223,217,87,48,82,6,6,0,0,6,0,0,0,0,28107
8739,61,0,31,30,0,0,0,0,0,0,0,0,0,0,0,0,0,0,0,0,0,0,0,0,0,0,0,0,0,0,0,0,0,0,0,28108
8740,110,14,10,34,22,30,114,57,57,7,0,50,0,0,0,0,0,0,0,0,0,57,57,8,0,49,0,0,0,0,0,0,0,0,0,28109
8741,31798,5623,10455,9164,5079,1477,3050,1646,1180,238,156,786,466,258,161,96,1,208,64,36,108,1404,1238,219,99,920,166,146,89,57,0,20,7,0,13,28110
8742,17292,3783,5425,5546,1918,620,1361,750,506,132,27,347,244,213,166,23,24,31,0,0,31,611,507,57,27,423,104,71,32,16,23,33,0,20,13,28112
8743,5097,873,1627,1990,337,270,230,79,76,19,25,32,3,3,0,3,0,0,0,0,0,151,121,40,19,62,30,1,1,0,0,29,0,29,0,28114
8744,22156,2747,6239,8353,3518,1299,2450,1401,1162,185,116,861,239,105,89,0,16,134,0,114,20,1049,730,422,26,282,319,204,104,2,98,115,0,0,115,28115
8745,24199,1680,4120,7516,7451,3432,1938,1161,977,199,127,651,184,168,68,33,67,16,8,0,8,777,705,212,50,443,72,72,72,0,0,0,0,0,0,28117
8746,2155,895,761,346,111,42,247,94,69,0,42,27,25,0,0,0,0,25,0,0,25,153,105,0,14,91,48,23,12,8,3,25,0,25,0,28119
8747,14522,2307,4010,5290,2285,630,992,693,639,79,87,473,54,36,0,36,0,18,0,18,0,299,263,79,8,176,36,22,16,0,6,14,0,14,0,28120
8748,4489,620,1754,1498,460,157,280,126,107,0,16,91,19,19,0,0,19,0,0,0,0,154,146,86,2,58,8,6,0,0,6,2,0,0,2,28124
8749,1775,172,570,514,391,128,121,59,59,12,16,31,0,0,0,0,0,0,0,0,0,62,62,0,18,44,0,0,0,0,0,0,0,0,0,28125
8750,5730,1207,1932,1625,642,324,410,189,150,37,25,88,39,27,2,0,25,12,0,0,12,221,207,45,58,104,14,14,14,0,0,0,0,0,0,28127
8751,4917,995,1505,1543,560,314,312,126,75,9,4,62,51,44,29,0,15,7,0,0,7,186,157,28,24,105,29,29,29,0,0,0,0,0,0,28128
8752,3966,673,1443,1306,425,119,209,74,68,21,14,33,6,6,1,5,0,0,0,0,0,135,101,9,47,45,34,0,0,0,0,34,0,0,34,28129
8753,2078,384,1104,389,145,56,172,156,118,68,25,25,38,14,0,14,0,24,0,0,24,16,16,0,0,16,0,0,0,0,0,0,0,0,0,28133
8754,7072,1163,1640,2116,1484,669,366,173,167,23,35,109,6,6,6,0,0,0,0,0,0,193,187,115,0,72,6,6,0,0,6,0,0,0,0,28134
8755,4256,1021,1811,1157,133,134,244,121,50,5,0,45,71,25,25,0,0,46,0,42,4,123,83,0,22,61,40,27,19,8,0,13,0,13,0,28135
8756,1953,260,648,681,270,94,363,201,177,43,2,132,24,2,0,2,0,22,0,0,22,162,151,48,5,98,11,11,11,0,0,0,0,0,0,28137
8757,6757,1251,2656,2067,571,212,544,255,160,0,0,160,95,49,0,0,49,46,35,3,8,289,228,98,12,118,61,61,31,5,25,0,0,0,0,28138
8758,14047,2405,4650,4288,1806,898,1138,532,460,22,28,410,72,31,19,0,12,41,0,0,41,606,461,80,29,352,145,107,35,15,57,38,0,9,29,28139
8759,16232,2993,4702,4759,2416,1362,1442,778,719,110,53,556,59,20,5,6,9,39,10,22,7,664,577,99,64,414,87,13,13,0,0,74,0,5,69,28144
8760,18511,3111,6238,5573,2240,1349,1365,805,683,197,35,451,122,114,60,10,44,8,0,8,0,560,530,211,18,301,30,21,20,0,1,9,0,0,9,28146
8761,16339,2973,5162,4849,2450,905,1330,844,680,119,40,521,164,112,23,31,58,52,0,0,52,486,474,134,30,310,12,12,12,0,0,0,0,0,0,28147
8762,19050,3386,5938,6183,2335,1208,1447,576,509,87,71,351,67,58,0,9,49,9,0,0,9,871,770,108,94,568,101,61,34,0,27,40,0,0,40,28150
8763,16667,2646,5844,4774,2153,1250,1242,598,476,164,39,273,122,57,38,0,19,65,65,0,0,644,474,61,58,355,170,103,61,27,15,67,11,39,17,28152
8764,2019,370,725,697,174,53,376,259,241,25,34,182,18,0,0,0,0,18,0,10,8,117,117,17,19,81,0,0,0,0,0,0,0,0,0,28159
8765,2730,531,770,935,369,125,135,63,54,21,33,0,9,0,0,0,0,9,0,0,9,72,72,0,0,72,0,0,0,0,0,0,0,0,0,28160
8766,3537,778,1238,1091,342,88,517,297,273,49,40,184,24,20,0,17,3,4,0,0,4,220,171,23,18,130,49,46,0,46,0,3,0,0,3,28163
8767,9406,1629,2399,3471,1411,496,396,189,150,71,0,79,39,0,0,0,0,39,19,11,9,207,190,42,54,94,17,17,17,0,0,0,0,0,0,28164
8768,6030,748,2019,2012,840,411,773,404,252,5,77,170,152,127,105,0,22,25,13,0,12,369,259,81,14,164,110,82,82,0,0,28,0,18,10,28166
8769,1913,293,669,725,138,88,146,127,89,0,14,75,38,0,0,0,0,38,0,38,0,19,16,10,0,6,3,3,0,0,3,0,0,0,0,28167
8770,7683,1575,2638,2195,939,336,815,397,344,18,42,284,53,34,0,10,24,19,4,0,15,418,364,63,31,270,54,44,34,10,0,10,0,10,0,28168
8771,87,23,42,20,2,0,8,1,0,0,0,0,1,0,0,0,0,1,0,1,0,7,6,0,0,6,1,0,0,0,0,1,0,0,1,28169
8772,7796,1683,2848,2185,675,405,464,217,209,25,67,117,8,6,0,0,6,2,0,0,2,247,234,0,18,216,13,0,0,0,0,13,0,0,13,28170
8773,26970,1201,4128,7673,9763,4205,2735,1472,1276,392,75,809,196,15,6,5,4,181,0,42,139,1263,1158,275,65,818,105,42,26,0,16,63,0,44,19,28173
8774,5235,1299,1802,1339,537,258,1090,400,377,44,17,316,23,0,0,0,0,23,23,0,0,690,590,148,23,419,100,60,0,60,0,40,0,0,40,28174
8775,7088,412,528,1321,3118,1709,731,217,217,48,0,169,0,0,0,0,0,0,0,0,0,514,409,148,43,218,105,0,0,0,0,105,0,105,0,28202
8776,8705,754,1152,1199,3133,2467,240,144,71,34,5,32,73,11,0,11,0,62,19,43,0,96,96,39,8,49,0,0,0,0,0,0,0,0,0,28203
8777,3889,339,457,867,1464,762,130,70,48,0,21,27,22,5,0,0,5,17,0,0,17,60,52,13,11,28,8,8,0,8,0,0,0,0,0,28204
8778,30563,6930,6670,8273,5691,2999,1422,813,644,103,97,444,169,107,40,40,27,62,0,9,53,609,541,113,57,371,68,34,0,20,14,34,0,16,18,28205
8779,7086,2361,2246,1809,601,69,659,246,195,3,47,145,51,17,17,0,0,34,0,28,6,413,300,20,140,140,113,46,0,28,18,67,0,63,4,28206
8780,6108,98,312,649,2954,2095,692,234,228,49,31,148,6,0,0,0,0,6,6,0,0,458,435,83,33,319,23,23,17,0,6,0,0,0,0,28207
8781,21210,6162,6989,5612,1859,588,2021,1033,861,44,219,598,172,67,16,18,33,105,0,31,74,988,704,208,98,398,284,84,51,25,8,200,16,88,96,28208
8782,15943,1087,1854,3843,6015,3144,444,200,200,41,0,159,0,0,0,0,0,0,0,0,0,244,204,77,32,95,40,0,0,0,0,40,0,0,40,28209
8783,29847,2143,4296,7786,10889,4733,1361,680,572,108,24,440,108,49,30,10,9,59,51,0,8,681,604,114,29,461,77,50,24,0,26,27,17,0,10,28210
8784,20330,1351,2157,4154,7596,5072,915,467,429,88,45,296,38,38,18,0,20,0,0,0,0,448,431,98,36,297,17,0,0,0,0,17,0,17,0,28211
8785,23774,5736,6088,7531,3222,1197,1910,960,751,124,117,510,209,105,62,4,39,104,53,19,32,950,712,102,106,504,238,150,62,2,86,88,60,28,0,28212
8786,23015,4192,5283,7191,4437,1912,2038,967,847,148,141,558,120,48,0,0,48,72,25,8,39,1071,900,203,96,601,171,106,48,14,44,65,0,53,12,28213
8787,21995,3037,5672,7627,4238,1421,1545,911,812,109,91,612,99,86,14,0,72,13,13,0,0,634,500,85,0,415,134,97,49,12,36,37,0,14,23,28214
8788,34928,5796,9320,12035,5459,2318,2844,1324,1138,173,64,901,186,99,67,31,1,87,0,15,72,1520,1373,255,76,1042,147,92,33,0,59,55,0,0,55,28215
8789,31300,3916,8428,10074,6253,2629,3176,1377,1243,122,124,997,134,125,51,43,31,9,0,0,9,1799,1693,317,201,1175,106,89,17,11,61,17,0,17,0,28216
8790,17286,4842,4144,4858,2200,1242,1337,764,507,44,1,462,257,121,12,30,79,136,68,14,54,573,485,52,92,341,88,5,0,0,5,83,60,0,23,28217
8791,26438,836,3302,7054,10342,4904,1550,744,620,199,64,357,124,65,0,65,0,59,47,0,12,806,690,190,31,469,116,83,69,0,14,33,33,0,0,28226
8792,33964,4110,8908,11397,7130,2419,2780,1394,1053,243,50,760,341,127,61,11,55,214,178,36,0,1386,1292,291,53,948,94,94,38,30,26,0,0,0,0,28227
8793,0,0,0,0,0,0,0,0,0,0,0,0,0,0,0,0,0,0,0,0,0,0,0,0,0,0,0,0,0,0,0,0,0,0,0,28244
8794,21012,1361,3822,6234,6707,2888,4895,2542,2417,535,325,1557,125,125,63,62,0,0,0,0,0,2353,2230,703,301,1226,123,122,94,0,28,1,0,0,1,28262
8795,47570,3420,10093,16071,12656,5330,4194,2368,2049,365,154,1530,319,211,106,74,31,108,0,0,108,1826,1647,451,128,1068,179,135,26,45,64,44,17,0,27,28269
8796,21955,812,2700,5535,8367,4541,1837,875,868,258,67,543,7,7,0,7,0,0,0,0,0,962,897,210,226,461,65,58,58,0,0,7,7,0,0,28270
8797,21150,2113,4672,7381,5141,1843,1879,889,655,161,311,183,234,164,155,9,0,70,18,0,52,990,765,166,231,368,225,109,0,95,14,116,45,59,12,28273
8798,41112,820,4415,9431,18498,7948,2592,1171,1063,272,33,758,108,102,58,0,44,6,0,0,6,1421,1257,354,20,883,164,146,118,28,0,18,0,9,9,28277
8799,14363,1068,2358,4675,4386,1876,867,554,451,156,24,271,103,103,33,0,70,0,0,0,0,313,249,80,0,169,64,51,15,36,0,13,0,0,13,28278
8800,0,0,0,0,0,0,0,0,0,0,0,0,0,0,0,0,0,0,0,0,0,0,0,0,0,0,0,0,0,0,0,0,0,0,0,28280
8801,0,0,0,0,0,0,0,0,0,0,0,0,0,0,0,0,0,0,0,0,0,0,0,0,0,0,0,0,0,0,0,0,0,0,0,28282
8802,10595,2034,3100,3524,1325,612,1662,795,709,79,93,537,86,8,0,0,8,78,19,0,59,867,738,109,119,510,129,50,14,32,4,79,0,0,79,28301
8803,19678,1767,5152,7560,3410,1789,1277,492,436,118,59,259,56,56,21,9,26,0,0,0,0,785,699,144,103,452,86,65,65,0,0,21,0,17,4,28303
8804,24135,2639,6915,9368,3567,1646,2104,1131,946,78,81,787,185,127,63,41,23,58,15,0,43,973,839,176,58,605,134,98,80,0,18,36,0,29,7,28304
8805,4491,442,1014,1259,1249,527,287,128,115,0,19,96,13,0,0,0,0,13,12,0,1,159,152,51,5,96,7,7,7,0,0,0,0,0,0,28305
8806,25690,3871,6721,9683,3285,2130,2946,1320,982,60,98,824,338,222,38,42,142,116,57,30,29,1626,1323,406,113,804,303,253,98,80,75,50,0,36,14,28306
8807,7797,249,1628,4298,1147,475,548,337,127,37,0,90,210,210,203,7,0,0,0,0,0,211,125,29,0,96,86,80,54,5,21,6,0,0,6,28307
8808,62,0,2,32,28,0,26,21,1,0,0,1,20,20,20,0,0,0,0,0,0,5,1,0,0,1,4,4,4,0,0,0,0,0,0,28308
8809,1404,0,328,846,131,99,420,347,96,96,0,0,251,241,241,0,0,10,0,0,10,73,0,0,0,0,73,73,73,0,0,0,0,0,0,28310
8810,20508,1522,4696,7880,3748,2662,2191,1143,1031,181,106,744,112,94,29,50,15,18,0,10,8,1048,924,197,111,616,124,120,86,11,23,4,0,0,4,28311
8811,12606,1836,4153,4221,1521,875,971,534,409,66,10,333,125,90,42,0,48,35,0,18,17,437,268,51,17,200,169,156,84,39,33,13,0,13,0,28312
8812,31579,2012,6814,15027,5356,2370,2764,1416,1178,106,113,959,238,171,114,42,15,67,0,17,50,1348,863,192,37,634,485,386,106,164,116,99,0,28,71,28314
8813,8065,1190,1917,3079,1348,531,705,320,254,42,39,173,66,23,0,0,23,43,0,0,43,385,316,102,34,180,69,52,52,0,0,17,17,0,0,28315
8814,3309,741,1218,725,392,233,275,130,94,14,9,71,36,24,0,24,0,12,0,12,0,145,102,0,0,102,43,30,30,0,0,13,13,0,0,28318
8815,5920,1345,1991,1956,472,156,488,240,217,29,0,188,23,23,0,0,23,0,0,0,0,248,248,100,10,138,0,0,0,0,0,0,0,0,0,28320
8816,2158,311,772,718,272,85,160,84,78,10,5,63,6,6,3,0,3,0,0,0,0,76,55,0,5,50,21,2,2,0,0,19,0,0,19,28323
8817,362,102,124,106,23,7,76,43,28,22,0,6,15,12,12,0,0,3,0,0,3,33,24,9,0,15,9,9,0,9,0,0,0,0,0,28325
8818,10039,1409,2601,4148,1454,427,1003,697,478,84,0,394,219,101,24,68,9,118,0,0,118,306,296,0,42,254,10,10,0,0,10,0,0,0,0,28326
8819,10472,1040,3234,3721,1599,878,611,378,302,25,0,277,76,63,41,0,22,13,13,0,0,233,160,31,36,93,73,73,41,0,32,0,0,0,0,28327
8820,18637,4679,6021,5440,1690,807,1577,860,629,99,75,455,231,99,42,45,12,132,73,37,22,717,573,116,45,412,144,106,56,29,21,38,4,12,22,28328
8821,245,42,119,84,0,0,0,0,0,0,0,0,0,0,0,0,0,0,0,0,0,0,0,0,0,0,0,0,0,0,0,0,0,0,0,28330
8822,268,33,56,141,11,27,22,4,4,0,0,4,0,0,0,0,0,0,0,0,0,18,18,8,0,10,0,0,0,0,0,0,0,0,0,28332
8823,7369,1720,1997,2656,853,143,359,194,114,0,25,89,80,41,10,25,6,39,25,5,9,165,148,35,0,113,17,17,2,0,15,0,0,0,0,28333
8824,16668,3259,5802,5223,1708,676,1341,640,538,138,48,352,102,38,13,7,18,64,13,28,23,701,587,255,61,271,114,79,42,5,32,35,0,17,18,28334
8825,6807,1598,1920,2355,720,214,615,401,326,69,12,245,75,52,0,52,0,23,23,0,0,214,147,0,0,147,67,34,28,0,6,33,0,0,33,28337
8826,2997,643,1130,855,302,67,259,132,114,0,15,99,18,10,0,10,0,8,4,4,0,127,97,31,17,49,30,30,30,0,0,0,0,0,0,28338
8827,4566,966,1567,1410,441,182,399,213,157,45,3,109,56,39,13,26,0,17,0,0,17,186,174,81,10,83,12,10,0,0,10,2,0,2,0,28339
8828,7283,2024,2633,1881,513,232,706,363,273,0,42,231,90,41,20,0,21,49,0,0,49,343,273,39,71,163,70,33,4,21,8,37,3,0,34,28340
8829,2929,957,783,868,247,74,144,84,84,27,7,50,0,0,0,0,0,0,0,0,0,60,60,14,19,27,0,0,0,0,0,0,0,0,0,28341
8830,195,26,55,59,24,31,66,31,24,0,0,24,7,2,0,0,2,5,0,0,5,35,22,0,6,16,13,13,11,0,2,0,0,0,0,28342
8831,876,96,444,279,27,30,122,54,43,0,0,43,11,0,0,0,0,11,0,0,11,68,61,0,3,58,7,7,7,0,0,0,0,0,0,28343
8832,1935,551,792,445,109,38,207,96,78,46,0,32,18,16,0,13,3,2,0,0,2,111,47,11,16,20,64,61,61,0,0,3,0,0,3,28344
8833,8333,1811,3313,2469,564,176,564,369,311,33,48,230,58,7,5,0,2,51,38,0,13,195,143,15,10,118,52,0,0,0,0,52,18,0,34,28345
8834,1169,331,429,310,43,56,151,59,44,0,0,44,15,3,3,0,0,12,0,0,12,92,53,17,0,36,39,29,0,17,12,10,0,0,10,28347
8835,20188,2094,6030,8019,2793,1252,2162,1028,854,175,53,626,174,119,45,45,29,55,19,35,1,1134,993,206,71,716,141,141,87,20,34,0,0,0,0,28348
8836,2916,636,1093,876,269,42,153,65,29,7,0,22,36,36,22,0,14,0,0,0,0,88,88,37,0,51,0,0,0,0,0,0,0,0,0,28349
8837,233,20,93,51,69,0,29,14,14,0,0,14,0,0,0,0,0,0,0,0,0,15,0,0,0,0,15,0,0,0,0,15,15,0,0,28350
8838,2586,550,1074,662,175,125,241,180,120,39,0,81,60,0,0,0,0,60,8,52,0,61,47,0,13,34,14,14,0,0,14,0,0,0,0,28351
8839,17354,4106,5912,4696,1705,935,1567,773,737,71,49,617,36,21,4,5,12,15,0,0,15,794,754,81,47,626,40,22,6,6,10,18,13,0,5,28352
8840,3284,565,1101,886,479,253,236,169,135,0,31,104,34,33,0,29,4,1,0,0,1,67,55,14,20,21,12,11,0,0,11,1,0,0,1,28356
8841,2076,401,764,721,136,54,273,184,102,23,14,65,82,52,0,0,52,30,0,19,11,89,33,21,0,12,56,56,0,0,56,0,0,0,0,28357
8842,24913,6723,7173,7424,2405,1188,2297,1131,757,103,100,554,374,252,102,12,138,122,0,2,120,1166,929,224,22,683,237,166,89,18,59,71,0,5,66,28358
8843,9795,3167,3124,2299,844,361,898,494,273,0,10,263,221,73,17,0,56,148,86,12,50,404,265,83,12,170,139,47,0,0,47,92,0,8,84,28360
8844,823,139,336,227,111,10,66,36,35,0,0,35,1,1,1,0,0,0,0,0,0,30,17,17,0,0,13,0,0,0,0,13,0,13,0,28363
8845,9175,2861,3153,2237,684,240,909,442,305,37,4,264,137,69,29,27,13,68,0,0,68,467,413,86,26,301,54,16,7,0,9,38,0,22,16,28364
8846,11851,4115,3508,2803,977,448,1137,549,400,4,22,374,149,111,43,47,21,38,14,0,24,588,416,100,93,223,172,58,0,40,18,114,0,8,106,28365
8847,2950,762,830,983,255,120,418,201,177,49,10,118,24,24,21,0,3,0,0,0,0,217,217,113,0,104,0,0,0,0,0,0,0,0,0,28366
8848,72,12,36,22,0,2,0,0,0,0,0,0,0,0,0,0,0,0,0,0,0,0,0,0,0,0,0,0,0,0,0,0,0,0,0,28367
8849,1580,343,536,547,78,76,78,44,38,0,0,38,6,0,0,0,0,6,0,6,0,34,34,21,0,13,0,0,0,0,0,0,0,0,0,28369
8850,4057,606,1697,1133,412,209,498,275,224,87,19,118,51,51,0,22,29,0,0,0,0,223,201,4,0,197,22,0,0,0,0,22,0,0,22,28371
8851,7482,1767,2170,2264,906,375,1518,605,575,49,70,456,30,30,7,8,15,0,0,0,0,913,857,113,138,606,56,24,0,24,0,32,9,0,23,28372
8852,1636,163,519,707,154,93,123,93,72,0,15,57,21,4,0,4,0,17,0,0,17,30,30,18,0,12,0,0,0,0,0,0,0,0,0,28373
8853,13214,415,2253,3611,4259,2676,349,197,170,54,0,116,27,27,27,0,0,0,0,0,0,152,136,10,0,126,16,16,16,0,0,0,0,0,0,28374
8854,91,28,34,18,0,11,7,5,5,0,0,5,0,0,0,0,0,0,0,0,0,2,2,0,0,2,0,0,0,0,0,0,0,0,0,28375
8855,23729,3245,6219,9834,3296,1135,2010,937,608,81,80,447,329,158,125,28,5,171,68,28,75,1073,764,123,39,602,309,121,91,16,14,188,21,83,84,28376
8856,8462,3053,2477,1937,653,342,678,401,322,32,14,276,79,52,38,0,14,27,20,7,0,277,148,6,0,142,129,68,47,11,10,61,22,0,39,28377
8857,17312,3120,6170,5483,1572,967,1493,767,643,140,118,385,124,54,24,24,6,70,0,0,70,726,653,96,12,545,73,52,36,16,0,21,0,0,21,28379
8858,4846,992,1727,1521,451,155,383,234,160,18,32,110,74,62,15,27,20,12,0,8,4,149,127,21,29,77,22,22,16,0,6,0,0,0,0,28382
8859,4874,1314,1692,1374,359,135,406,170,155,1,18,136,15,7,2,5,0,8,0,0,8,236,199,36,8,155,37,31,11,7,13,6,0,0,6,28383
8860,7981,2204,2874,2139,614,150,578,324,255,8,4,243,69,9,7,2,0,60,6,12,42,254,167,22,39,106,87,38,0,0,38,49,0,9,40,28384
8861,1920,259,718,561,265,117,81,7,7,0,3,4,0,0,0,0,0,0,0,0,0,74,66,29,4,33,8,0,0,0,0,8,0,0,8,28385
8862,3497,1378,1102,745,214,58,319,181,161,17,44,100,20,20,10,10,0,0,0,0,0,138,101,18,11,72,37,23,0,9,14,14,0,0,14,28386
8863,10660,1081,2281,3373,2176,1749,513,328,299,67,111,121,29,29,8,21,0,0,0,0,0,185,151,33,0,118,34,0,0,0,0,34,13,0,21,28387
8864,12295,1608,3699,4849,1473,666,855,524,428,96,75,257,96,86,41,38,7,10,0,6,4,331,298,61,49,188,33,27,1,20,6,6,0,3,3,28390
8865,3723,608,1256,1318,321,220,289,124,81,2,13,66,43,11,11,0,0,32,0,0,32,165,146,33,0,113,19,15,11,0,4,4,4,0,0,28391
8866,997,146,397,422,30,2,44,7,0,0,0,0,7,7,0,7,0,0,0,0,0,37,0,0,0,0,37,37,0,0,37,0,0,0,0,28392
8867,1067,336,405,251,54,21,115,66,49,0,15,34,17,16,16,0,0,1,0,0,1,49,27,4,21,2,22,8,0,0,8,14,0,0,14,28393
8868,3865,624,1426,1100,416,299,211,73,73,11,18,44,0,0,0,0,0,0,0,0,0,138,138,25,0,113,0,0,0,0,0,0,0,0,0,28394
8869,1414,213,503,485,185,28,35,13,5,2,0,3,8,8,4,4,0,0,0,0,0,22,14,4,0,10,8,0,0,0,0,8,0,3,5,28395
8870,2048,324,707,699,195,123,202,96,70,15,3,52,26,26,7,19,0,0,0,0,0,106,98,13,1,84,8,8,0,0,8,0,0,0,0,28396
8871,4971,1298,1344,1768,392,169,317,175,148,36,32,80,27,27,27,0,0,0,0,0,0,142,135,8,0,127,7,7,7,0,0,0,0,0,0,28398
8872,1437,368,557,350,134,28,216,92,66,26,0,40,26,0,0,0,0,26,26,0,0,124,124,27,0,97,0,0,0,0,0,0,0,0,0,28399
8873,15720,2881,4815,4770,2081,1173,759,336,220,44,73,103,116,42,0,8,34,74,9,0,65,423,304,54,49,201,119,76,76,0,0,43,0,25,18,28401
8874,21436,2847,4228,6204,5454,2703,4214,1562,1472,370,185,917,90,15,0,15,0,75,48,0,27,2652,2474,903,229,1342,178,116,39,32,45,62,0,0,62,28403
8875,19932,1927,4552,6154,4829,2470,1406,797,633,85,67,481,164,122,60,61,1,42,8,21,13,609,608,102,112,394,1,0,0,0,0,1,0,0,1,28405
8876,21747,1193,3657,6262,7069,3566,1581,842,829,443,68,318,13,0,0,0,0,13,0,0,13,739,642,202,124,316,97,34,34,0,0,63,8,31,24,28409
8877,22994,1288,4303,8102,6210,3091,1249,681,587,108,61,418,94,69,26,0,43,25,25,0,0,568,376,120,0,256,192,136,44,92,0,56,0,0,56,28411
8878,25187,2027,5870,8896,5509,2885,1469,730,578,73,235,270,152,31,0,27,4,121,37,45,39,739,670,287,41,342,69,42,25,0,17,27,0,0,27,28412
8879,2441,613,863,729,226,10,117,88,56,2,54,0,32,32,2,0,30,0,0,0,0,29,29,0,0,29,0,0,0,0,0,0,0,0,0,28420
8880,893,192,311,329,19,42,46,39,38,13,0,25,1,1,0,0,1,0,0,0,0,7,7,0,0,7,0,0,0,0,0,0,0,0,0,28421
8881,4774,526,1473,1867,518,390,409,287,216,17,1,198,71,23,12,0,11,48,0,48,0,122,83,7,51,25,39,39,39,0,0,0,0,0,0,28422
8882,1576,347,511,589,90,39,137,61,41,0,4,37,20,12,0,0,12,8,8,0,0,76,76,5,3,68,0,0,0,0,0,0,0,0,0,28423
8883,45,2,27,16,0,0,6,6,6,0,0,6,0,0,0,0,0,0,0,0,0,0,0,0,0,0,0,0,0,0,0,0,0,0,0,28424
8884,8021,1433,2457,2965,847,319,537,267,222,84,46,92,45,45,45,0,0,0,0,0,0,270,167,35,0,132,103,68,12,36,20,35,28,0,7,28425
8885,4388,204,846,1703,937,698,262,178,158,26,34,98,20,16,16,0,0,4,4,0,0,84,84,59,0,25,0,0,0,0,0,0,0,0,0,28428
8886,5864,678,2040,2118,830,198,460,249,165,31,43,91,84,18,0,10,8,66,0,33,33,211,135,34,14,87,76,0,0,0,0,76,0,21,55,28429
8887,976,216,416,272,38,34,150,29,29,0,0,29,0,0,0,0,0,0,0,0,0,121,98,41,0,57,23,0,0,0,0,23,0,23,0,28430
8888,4076,952,1336,1503,177,108,210,98,86,16,21,49,12,12,0,12,0,0,0,0,0,112,101,57,13,31,11,0,0,0,0,11,0,0,11,28431
8889,1204,246,393,450,81,34,80,36,36,8,0,28,0,0,0,0,0,0,0,0,0,44,44,0,0,44,0,0,0,0,0,0,0,0,0,28432
8890,3467,859,1151,1260,122,75,227,128,128,0,32,96,0,0,0,0,0,0,0,0,0,99,91,11,7,73,8,0,0,0,0,8,8,0,0,28433
8891,1090,296,537,156,48,53,48,36,16,0,0,16,20,0,0,0,0,20,0,20,0,12,12,0,0,12,0,0,0,0,0,0,0,0,0,28434
8892,1770,436,806,372,98,58,212,49,0,0,0,0,49,3,0,0,3,46,46,0,0,163,163,36,0,127,0,0,0,0,0,0,0,0,0,28435
8893,1428,208,646,443,89,42,94,58,22,0,0,22,36,18,5,0,13,18,0,18,0,36,36,16,8,12,0,0,0,0,0,0,0,0,0,28436
8894,1218,208,533,401,42,34,119,105,95,18,0,77,10,0,0,0,0,10,0,0,10,14,14,0,5,9,0,0,0,0,0,0,0,0,0,28438
8895,1292,230,402,475,129,56,12,10,10,0,0,10,0,0,0,0,0,0,0,0,0,2,2,0,2,0,0,0,0,0,0,0,0,0,0,28439
8896,2333,704,797,680,90,62,196,87,84,0,65,19,3,3,3,0,0,0,0,0,0,109,98,13,11,74,11,11,0,0,11,0,0,0,0,28441
8897,1006,106,346,379,89,86,34,9,1,0,0,1,8,8,8,0,0,0,0,0,0,25,25,0,0,25,0,0,0,0,0,0,0,0,0,28442
8898,11959,711,3192,4026,2694,1336,905,487,348,134,90,124,139,87,50,17,20,52,27,25,0,418,335,100,16,219,83,65,45,3,17,18,0,18,0,28443
8899,1810,462,750,406,153,39,118,31,31,1,0,30,0,0,0,0,0,0,0,0,0,87,49,42,0,7,38,38,29,0,9,0,0,0,0,28444
8900,4480,352,1006,1675,948,499,273,139,139,10,26,103,0,0,0,0,0,0,0,0,0,134,99,24,0,75,35,16,16,0,0,19,0,14,5,28445
8901,1294,483,369,382,60,0,71,19,19,15,0,4,0,0,0,0,0,0,0,0,0,52,52,0,0,52,0,0,0,0,0,0,0,0,0,28447
8902,831,201,180,384,66,0,28,28,28,0,0,28,0,0,0,0,0,0,0,0,0,0,0,0,0,0,0,0,0,0,0,0,0,0,0,28448
8903,1400,29,331,419,391,230,48,24,15,0,0,15,9,9,9,0,0,0,0,0,0,24,24,6,0,18,0,0,0,0,0,0,0,0,0,28449
8904,1640,266,388,543,328,115,170,79,69,0,0,69,10,4,4,0,0,6,0,0,6,91,86,0,25,61,5,5,0,5,0,0,0,0,0,28450
8905,19927,3296,4700,6937,3137,1857,1163,642,464,28,72,364,178,109,42,0,67,69,13,14,42,521,409,43,76,290,112,53,16,20,17,59,0,22,37,28451
8906,493,158,290,33,12,0,129,0,0,0,0,0,0,0,0,0,0,0,0,0,0,129,68,0,0,68,61,61,0,61,0,0,0,0,0,28452
8907,2874,939,700,1054,107,74,383,226,224,82,0,142,2,0,0,0,0,2,2,0,0,157,152,41,15,96,5,5,5,0,0,0,0,0,0,28453
8908,1224,312,477,372,45,18,191,120,107,0,0,107,13,0,0,0,0,13,0,0,13,71,71,0,31,40,0,0,0,0,0,0,0,0,0,28454
8909,1278,334,269,412,240,23,111,63,63,25,0,38,0,0,0,0,0,0,0,0,0,48,48,21,27,0,0,0,0,0,0,0,0,0,0,28455
8910,2298,522,854,682,161,79,156,104,103,11,0,92,1,1,0,0,1,0,0,0,0,52,44,1,21,22,8,8,0,0,8,0,0,0,0,28456
8911,6737,975,2771,2343,437,211,629,308,147,74,33,40,161,64,51,0,13,97,16,73,8,321,265,55,51,159,56,56,56,0,0,0,0,0,0,28457
8912,3763,1128,1266,1150,161,58,390,200,149,37,10,102,51,4,4,0,0,47,0,14,33,190,145,31,0,114,45,0,0,0,0,45,0,4,41,28458
8913,5445,524,1371,2199,782,569,339,156,127,15,0,112,29,29,29,0,0,0,0,0,0,183,164,58,3,103,19,0,0,0,0,19,0,0,19,28460
8914,12995,1036,3442,4246,2666,1605,393,161,161,81,0,80,0,0,0,0,0,0,0,0,0,232,231,155,23,53,1,1,0,0,1,0,0,0,0,28461
8915,8458,1680,2739,2685,930,424,426,309,264,104,33,127,45,43,43,0,0,2,0,0,2,117,110,35,19,56,7,7,0,7,0,0,0,0,0,28462
8916,7372,2018,2328,2226,436,364,597,375,228,102,0,126,147,51,10,0,41,96,0,0,96,222,172,0,11,161,50,50,25,25,0,0,0,0,0,28463
8917,1413,647,326,347,60,33,57,39,39,0,0,39,0,0,0,0,0,0,0,0,0,18,18,5,0,13,0,0,0,0,0,0,0,0,0,28464
8918,5376,397,1360,1784,1119,716,301,128,100,22,29,49,28,28,8,20,0,0,0,0,0,173,173,6,35,132,0,0,0,0,0,0,0,0,0,28465
8919,7602,2136,2230,2436,526,274,363,126,84,18,6,60,42,42,0,0,42,0,0,0,0,237,171,52,30,89,66,17,17,0,0,49,0,0,49,28466
8920,7948,703,2640,2916,1006,683,195,169,162,61,0,101,7,0,0,0,0,7,7,0,0,26,26,14,0,12,0,0,0,0,0,0,0,0,0,28467
8921,3903,341,698,1227,1152,485,31,7,7,0,7,0,0,0,0,0,0,0,0,0,0,24,17,0,13,4,7,7,7,0,0,0,0,0,0,28468
8922,5232,888,879,1633,1213,619,258,133,113,0,0,113,20,20,20,0,0,0,0,0,0,125,112,31,0,81,13,0,0,0,0,13,0,0,13,28469
8923,7155,1230,2660,2178,837,250,555,313,271,149,0,122,42,32,23,9,0,10,10,0,0,242,208,108,11,89,34,0,0,0,0,34,34,0,0,28470
8924,14259,2720,4087,5526,1339,587,1139,568,494,53,42,399,74,70,23,18,29,4,0,0,4,571,519,88,71,360,52,39,21,0,18,13,0,0,13,28472
8925,3030,609,1006,1053,281,81,158,122,121,28,9,84,1,1,0,0,1,0,0,0,0,36,36,0,0,36,0,0,0,0,0,0,0,0,0,28478
8926,4306,473,1123,1636,901,173,78,45,27,0,0,27,18,18,0,18,0,0,0,0,0,33,33,0,0,33,0,0,0,0,0,0,0,0,0,28479
8927,1574,16,118,388,757,295,120,50,50,20,9,21,0,0,0,0,0,0,0,0,0,70,67,14,0,53,3,3,3,0,0,0,0,0,0,28480
8928,13582,3182,4429,4423,1032,516,1181,592,519,75,136,308,73,37,26,0,11,36,0,7,29,589,428,145,93,190,161,114,59,30,25,47,0,47,0,28501
8929,14631,2618,4256,5134,1926,697,1444,753,530,98,105,327,223,142,77,39,26,81,0,78,3,691,643,172,19,452,48,39,32,0,7,9,0,9,0,28504
8930,1583,414,453,482,154,80,92,92,27,0,0,27,65,13,13,0,0,52,52,0,0,0,0,0,0,0,0,0,0,0,0,0,0,0,0,28508
8931,1006,108,298,346,145,109,85,50,39,0,0,39,11,0,0,0,0,11,0,0,11,35,21,19,0,2,14,11,11,0,0,3,0,0,3,28510
8932,484,64,195,181,33,11,4,0,0,0,0,0,0,0,0,0,0,0,0,0,0,4,4,4,0,0,0,0,0,0,0,0,0,0,0,28511
8933,2938,155,569,1030,808,376,76,14,14,1,0,13,0,0,0,0,0,0,0,0,0,62,62,24,0,38,0,0,0,0,0,0,0,0,0,28512
8934,6725,1672,2215,2035,575,228,466,256,217,32,21,164,39,14,14,0,0,25,0,25,0,210,189,49,44,96,21,10,0,6,4,11,11,0,0,28513
8935,1892,313,731,679,113,56,118,80,70,39,14,17,10,10,10,0,0,0,0,0,0,38,38,0,8,30,0,0,0,0,0,0,0,0,0,28515
8936,8978,1497,2172,3233,1391,685,568,206,165,70,36,59,41,35,0,0,35,6,0,0,6,362,318,64,105,149,44,23,0,0,23,21,21,0,0,28516
8937,5619,1145,1841,1957,413,263,417,269,161,16,12,133,108,13,0,0,13,95,95,0,0,148,148,42,43,63,0,0,0,0,0,0,0,0,0,28518
8938,189,38,71,51,18,11,0,0,0,0,0,0,0,0,0,0,0,0,0,0,0,0,0,0,0,0,0,0,0,0,0,0,0,0,0,28519
8939,244,29,92,123,0,0,32,0,0,0,0,0,0,0,0,0,0,0,0,0,0,32,32,0,0,32,0,0,0,0,0,0,0,0,0,28520
8940,1674,423,588,477,139,47,153,68,58,20,0,38,10,10,10,0,0,0,0,0,0,85,78,13,0,65,7,7,0,0,7,0,0,0,0,28521
8941,1701,287,461,776,117,60,103,51,51,0,4,47,0,0,0,0,0,0,0,0,0,52,52,0,0,52,0,0,0,0,0,0,0,0,0,28523
8942,344,9,127,127,64,17,9,0,0,0,0,0,0,0,0,0,0,0,0,0,0,9,9,0,0,9,0,0,0,0,0,0,0,0,0,28524
8943,1918,476,622,648,118,54,76,40,40,0,0,40,0,0,0,0,0,0,0,0,0,36,36,0,0,36,0,0,0,0,0,0,0,0,0,28525
8944,1787,456,788,481,45,17,265,168,31,0,0,31,137,126,2,0,124,11,0,11,0,97,97,15,0,82,0,0,0,0,0,0,0,0,0,28526
8945,1045,91,485,368,54,47,87,47,21,0,0,21,26,26,14,0,12,0,0,0,0,40,40,28,0,12,0,0,0,0,0,0,0,0,0,28527
8946,424,92,150,143,28,11,0,0,0,0,0,0,0,0,0,0,0,0,0,0,0,0,0,0,0,0,0,0,0,0,0,0,0,0,0,28528
8947,1948,402,713,569,179,85,181,123,52,5,39,8,71,56,56,0,0,15,0,15,0,58,54,14,0,40,4,4,0,4,0,0,0,0,0,28529
8948,5107,1117,2039,1456,342,153,271,181,149,54,35,60,32,6,0,6,0,26,0,26,0,90,62,16,0,46,28,5,5,0,0,23,0,0,23,28530
8949,1108,283,359,336,113,17,63,41,0,0,0,0,41,9,0,0,9,32,32,0,0,22,22,9,0,13,0,0,0,0,0,0,0,0,0,28531
8950,13355,1162,4064,6509,1195,425,1493,855,631,154,53,424,224,195,78,13,104,29,0,17,12,638,412,142,48,222,226,208,21,15,172,18,0,0,18,28532
8951,294,0,57,205,27,5,329,291,9,9,0,0,282,282,282,0,0,0,0,0,0,38,0,0,0,0,38,38,38,0,0,0,0,0,0,28533
8952,100,19,46,35,0,0,20,20,20,20,0,0,0,0,0,0,0,0,0,0,0,0,0,0,0,0,0,0,0,0,0,0,0,0,0,28537
8953,1472,367,460,491,114,40,101,77,77,28,0,49,0,0,0,0,0,0,0,0,0,24,24,5,14,5,0,0,0,0,0,0,0,0,0,28538
8954,8806,826,2786,4034,789,371,576,307,243,96,71,76,64,35,0,35,0,29,0,0,29,269,205,42,49,114,64,57,57,0,0,7,0,0,7,28539
8955,27885,2841,9288,10807,3765,1184,3083,1728,925,311,85,529,803,714,610,103,1,89,0,12,77,1355,767,197,31,539,588,541,146,123,272,47,0,38,9,28540
8956,1520,56,595,745,124,0,95,67,56,0,0,56,11,11,11,0,0,0,0,0,0,28,21,10,0,11,7,7,0,0,7,0,0,0,0,28543
8957,2581,311,906,1082,252,30,225,180,92,0,53,39,88,18,18,0,0,70,0,70,0,45,22,18,0,4,23,23,9,5,9,0,0,0,0,28544
8958,23914,2284,6497,10333,3228,1572,2524,1440,959,370,72,517,481,398,398,0,0,83,18,0,65,1084,796,189,90,517,288,239,71,19,149,49,0,8,41,28546
8959,4565,30,709,2786,667,373,2978,2762,338,145,9,184,2424,2424,2420,0,4,0,0,0,0,216,142,13,25,104,74,74,63,11,0,0,0,0,0,28547
8960,9095,1532,3093,3137,962,371,523,232,232,48,11,173,0,0,0,0,0,0,0,0,0,291,231,114,18,99,60,60,0,0,60,0,0,0,0,28551
8961,110,19,47,44,0,0,0,0,0,0,0,0,0,0,0,0,0,0,0,0,0,0,0,0,0,0,0,0,0,0,0,0,0,0,0,28552
8962,327,31,123,163,10,0,0,0,0,0,0,0,0,0,0,0,0,0,0,0,0,0,0,0,0,0,0,0,0,0,0,0,0,0,0,28553
8963,178,8,0,170,0,0,13,0,0,0,0,0,0,0,0,0,0,0,0,0,0,13,13,0,0,13,0,0,0,0,0,0,0,0,0,28554
8964,3264,455,1261,1142,363,43,264,161,130,73,0,57,31,18,0,18,0,13,13,0,0,103,80,6,0,74,23,23,4,3,16,0,0,0,0,28555
8965,766,50,191,365,107,53,21,21,21,0,0,21,0,0,0,0,0,0,0,0,0,0,0,0,0,0,0,0,0,0,0,0,0,0,0,28556
8966,10589,978,2727,3740,2043,1101,518,248,130,47,17,66,118,28,12,16,0,90,0,82,8,270,244,104,59,81,26,26,24,0,2,0,0,0,0,28557
8967,19780,2978,5735,6694,2997,1376,1381,774,562,131,127,304,212,51,25,12,14,161,44,117,0,607,487,124,18,345,120,23,23,0,0,97,11,0,86,28560
8968,25179,2648,6010,9070,4914,2537,1328,503,367,113,47,207,136,57,43,10,4,79,46,0,33,825,762,395,149,218,63,49,49,0,0,14,7,7,0,28562
8969,14786,1947,4977,5729,1593,540,1091,701,601,266,14,321,100,47,28,19,0,53,25,0,28,390,347,92,33,222,43,29,17,12,0,14,0,0,14,28570
8970,2415,167,465,937,535,311,117,11,11,0,0,11,0,0,0,0,0,0,0,0,0,106,88,70,0,18,18,18,18,0,0,0,0,0,0,28571
8971,4544,1156,1689,1235,330,134,294,100,91,4,0,87,9,9,9,0,0,0,0,0,0,194,183,32,57,94,11,11,0,11,0,0,0,0,0,28572
8972,1715,233,592,607,210,73,213,129,69,9,4,56,60,57,39,0,18,3,0,3,0,84,36,0,0,36,48,24,0,24,0,24,0,0,24,28573
8973,9071,1112,3105,3578,976,300,667,245,106,12,0,94,139,139,139,0,0,0,0,0,0,422,329,27,0,302,93,93,93,0,0,0,0,0,0,28574
8974,189,18,86,32,35,18,15,8,8,5,0,3,0,0,0,0,0,0,0,0,0,7,7,0,0,7,0,0,0,0,0,0,0,0,0,28575
8975,500,79,98,266,19,38,14,0,0,0,0,0,0,0,0,0,0,0,0,0,0,14,14,14,0,0,0,0,0,0,0,0,0,0,0,28577
8976,3388,1311,745,1046,212,74,372,196,182,18,81,83,14,0,0,0,0,14,14,0,0,176,153,26,9,118,23,23,0,0,23,0,0,0,0,28578
8977,371,29,122,134,79,7,25,25,25,0,0,25,0,0,0,0,0,0,0,0,0,0,0,0,0,0,0,0,0,0,0,0,0,0,0,28579
8978,9233,2103,3044,3064,820,202,542,320,269,94,29,146,51,26,16,10,0,25,22,3,0,222,185,42,48,95,37,9,9,0,0,28,0,9,19,28580
8979,137,10,65,62,0,0,0,0,0,0,0,0,0,0,0,0,0,0,0,0,0,0,0,0,0,0,0,0,0,0,0,0,0,0,0,28581
8980,1239,62,418,539,171,49,57,57,34,14,0,20,23,9,9,0,0,14,0,0,14,0,0,0,0,0,0,0,0,0,0,0,0,0,0,28582
8981,115,23,66,20,5,1,0,0,0,0,0,0,0,0,0,0,0,0,0,0,0,0,0,0,0,0,0,0,0,0,0,0,0,0,0,28583
8982,7978,761,1788,3036,1494,899,585,275,208,81,18,109,67,17,11,6,0,50,50,0,0,310,296,93,64,139,14,10,6,4,0,4,0,0,4,28584
8983,2736,490,1015,998,140,93,111,54,42,8,0,34,12,8,8,0,0,4,0,0,4,57,34,1,0,33,23,12,12,0,0,11,0,0,11,28585
8984,5116,1151,2038,1601,217,109,310,229,184,12,52,120,45,15,0,5,10,30,0,0,30,81,49,25,3,21,32,32,32,0,0,0,0,0,0,28586
8985,261,53,138,55,10,5,37,34,34,3,0,31,0,0,0,0,0,0,0,0,0,3,3,0,0,3,0,0,0,0,0,0,0,0,0,28587
8986,313,0,149,105,20,39,0,0,0,0,0,0,0,0,0,0,0,0,0,0,0,0,0,0,0,0,0,0,0,0,0,0,0,0,0,28589
8987,15418,940,2593,5385,3905,2595,1152,666,579,106,89,384,87,87,12,22,53,0,0,0,0,486,470,137,13,320,16,16,8,8,0,0,0,0,0,28590
8988,2930,122,650,797,894,467,76,44,44,0,0,44,0,0,0,0,0,0,0,0,0,32,32,0,0,32,0,0,0,0,0,0,0,0,0,28594
8989,32600,4807,8274,10180,6314,3025,2714,1443,1323,202,125,996,120,37,37,0,0,83,14,0,69,1271,1030,284,70,676,241,167,32,15,120,74,0,10,64,28601
8990,20763,4938,6347,5903,2394,1181,1171,630,537,50,36,451,93,42,32,8,2,51,20,10,21,541,406,45,60,301,135,131,113,0,18,4,0,0,4,28602
8991,4435,415,777,1488,1188,567,546,307,293,83,3,207,14,13,3,10,0,1,0,0,1,239,239,44,20,175,0,0,0,0,0,0,0,0,0,28604
8992,2805,235,587,786,595,602,158,16,16,10,0,6,0,0,0,0,0,0,0,0,0,142,142,31,14,97,0,0,0,0,0,0,0,0,0,28605
8993,1121,294,284,401,129,13,58,38,29,0,0,29,9,9,9,0,0,0,0,0,0,20,20,0,12,8,0,0,0,0,0,0,0,0,0,28606
8994,15513,1481,2676,4712,3937,2707,5061,2490,2463,409,397,1657,27,15,13,0,2,12,12,0,0,2571,2560,396,207,1957,11,10,10,0,0,1,0,0,1,28607
8995,4293,777,1503,1218,631,164,323,210,161,86,0,75,49,36,20,16,0,13,0,13,0,113,83,13,0,70,30,30,0,30,0,0,0,0,0,28609
8996,6674,1250,2116,2282,762,264,604,251,204,63,21,120,47,47,39,8,0,0,0,0,0,353,316,146,12,158,37,37,35,0,2,0,0,0,0,28610
8997,690,91,332,159,104,4,39,39,39,0,0,39,0,0,0,0,0,0,0,0,0,0,0,0,0,0,0,0,0,0,0,0,0,0,0,28611
8998,8785,2196,3159,2531,606,293,716,374,329,79,33,217,45,27,3,18,6,18,0,17,1,342,276,67,32,177,66,57,49,0,8,9,0,0,9,28612
8999,15654,2929,4970,4948,1940,867,1118,578,474,54,84,336,104,86,74,0,12,18,0,0,18,540,370,105,52,213,170,159,135,4,20,11,0,11,0,28613
9000,1560,450,518,439,72,81,88,52,34,0,0,34,18,0,0,0,0,18,0,18,0,36,16,0,0,16,20,20,0,0,20,0,0,0,0,28615
9001,159,5,55,43,45,11,18,10,10,0,0,10,0,0,0,0,0,0,0,0,0,8,8,0,0,8,0,0,0,0,0,0,0,0,0,28616
9002,1623,274,490,416,358,85,89,12,0,0,0,0,12,12,12,0,0,0,0,0,0,77,53,33,0,20,24,0,0,0,0,24,24,0,0,28617
9003,1406,298,192,436,274,206,103,19,19,0,0,19,0,0,0,0,0,0,0,0,0,84,52,19,12,21,32,32,32,0,0,0,0,0,0,28618
9004,814,205,189,299,72,49,34,22,17,0,0,17,5,5,5,0,0,0,0,0,0,12,12,0,0,12,0,0,0,0,0,0,0,0,0,28619
9005,7696,1782,2669,2042,886,317,403,218,172,48,0,124,46,38,31,7,0,8,6,0,2,185,145,31,7,107,40,11,0,0,11,29,6,0,23,28621
9006,1565,279,533,533,169,51,50,28,28,0,0,28,0,0,0,0,0,0,0,0,0,22,22,2,0,20,0,0,0,0,0,0,0,0,0,28622
9007,1138,251,453,284,124,26,63,17,17,0,0,17,0,0,0,0,0,0,0,0,0,46,46,16,0,30,0,0,0,0,0,0,0,0,0,28623
9008,1527,478,599,389,28,33,68,31,17,0,0,17,14,14,0,14,0,0,0,0,0,37,37,0,0,37,0,0,0,0,0,0,0,0,0,28624
9009,25298,3557,8971,8324,3208,1238,1859,890,752,160,113,479,138,104,0,50,54,34,12,0,22,969,836,256,34,546,133,58,0,29,29,75,0,24,51,28625
9010,1787,143,522,551,374,197,22,22,22,0,22,0,0,0,0,0,0,0,0,0,0,0,0,0,0,0,0,0,0,0,0,0,0,0,0,28626
9011,1097,249,336,469,43,0,130,78,30,0,24,6,48,48,0,10,38,0,0,0,0,52,52,22,0,30,0,0,0,0,0,0,0,0,0,28627
9012,208,36,31,88,49,4,0,0,0,0,0,0,0,0,0,0,0,0,0,0,0,0,0,0,0,0,0,0,0,0,0,0,0,0,0,28628
9013,77,0,0,0,77,0,0,0,0,0,0,0,0,0,0,0,0,0,0,0,0,0,0,0,0,0,0,0,0,0,0,0,0,0,0,28629
9014,13752,3310,4594,4425,1100,323,1375,744,624,89,111,424,120,80,35,45,0,40,8,0,32,631,473,121,48,304,158,127,46,20,61,31,4,0,27,28630
9015,447,50,123,89,112,73,9,0,0,0,0,0,0,0,0,0,0,0,0,0,0,9,9,0,0,9,0,0,0,0,0,0,0,0,0,28631
9016,3969,894,1713,915,308,139,212,106,92,21,0,71,14,14,14,0,0,0,0,0,0,106,97,0,8,89,9,6,0,6,0,3,3,0,0,28634
9017,2612,872,913,734,59,34,239,134,118,12,12,94,16,0,0,0,0,16,0,0,16,105,65,43,15,7,40,40,20,0,20,0,0,0,0,28635
9018,4181,1021,1701,1173,144,142,276,105,95,8,8,79,10,0,0,0,0,10,10,0,0,171,139,0,0,139,32,32,32,0,0,0,0,0,0,28636
9019,1110,272,433,291,84,30,107,82,75,0,0,75,7,7,7,0,0,0,0,0,0,25,14,6,0,8,11,11,11,0,0,0,0,0,0,28637
9020,8479,1953,2928,2696,459,443,629,327,260,15,20,225,67,67,47,0,20,0,0,0,0,302,272,65,56,151,30,30,0,8,22,0,0,0,0,28638
9021,3362,736,1046,998,428,154,263,161,119,79,5,35,42,21,21,0,0,21,14,0,7,102,102,14,2,86,0,0,0,0,0,0,0,0,0,28640
9022,4047,904,1437,1285,312,109,348,154,139,81,31,27,15,0,0,0,0,15,5,10,0,194,112,44,14,54,82,64,6,0,58,18,0,18,0,28642
9023,2904,652,1048,738,378,88,216,117,94,0,4,90,23,17,11,0,6,6,0,0,6,99,94,22,0,72,5,5,5,0,0,0,0,0,0,28643
9024,989,162,236,350,172,69,0,0,0,0,0,0,0,0,0,0,0,0,0,0,0,0,0,0,0,0,0,0,0,0,0,0,0,0,0,28644
9025,32969,8398,10630,9613,3055,1273,2129,1047,971,215,40,716,76,42,19,16,7,34,14,0,20,1082,962,230,65,667,120,56,22,22,12,64,0,0,64,28645
9026,458,58,57,205,95,43,59,17,17,11,0,6,0,0,0,0,0,0,0,0,0,42,42,14,0,28,0,0,0,0,0,0,0,0,0,28646
9027,68,0,12,10,19,27,0,0,0,0,0,0,0,0,0,0,0,0,0,0,0,0,0,0,0,0,0,0,0,0,0,0,0,0,0,28647
9028,892,347,373,156,16,0,125,54,54,0,54,0,0,0,0,0,0,0,0,0,0,71,71,71,0,0,0,0,0,0,0,0,0,0,0,28649
9029,8313,1611,3027,2927,514,234,584,362,307,118,74,115,55,18,18,0,0,37,22,0,15,222,174,73,16,85,48,48,39,9,0,0,0,0,0,28650
9030,4660,1093,1879,1336,204,148,208,57,48,9,16,23,9,0,0,0,0,9,0,9,0,151,87,37,10,40,64,0,0,0,0,64,0,39,25,28651
9031,64,0,32,32,0,0,16,16,16,0,0,16,0,0,0,0,0,0,0,0,0,0,0,0,0,0,0,0,0,0,0,0,0,0,0,28652
9032,2856,470,959,908,330,189,146,85,85,16,0,69,0,0,0,0,0,0,0,0,0,61,61,19,18,24,0,0,0,0,0,0,0,0,0,28654
9033,37296,8243,10766,11556,4254,2477,4070,2646,1896,381,325,1190,750,191,31,36,124,559,91,12,456,1424,1236,324,127,785,188,150,77,28,45,38,11,0,27,28655
9034,7537,1461,2611,2102,852,511,331,155,132,18,0,114,23,20,19,1,0,3,0,0,3,176,147,44,0,103,29,29,29,0,0,0,0,0,0,28657
9035,18134,3769,5931,5344,2191,899,1246,515,440,22,32,386,75,64,40,0,24,11,0,0,11,731,541,168,66,307,190,99,33,47,19,91,0,0,91,28658
9036,14314,4255,4407,3973,1278,401,1042,589,419,79,74,266,170,101,10,70,21,69,40,29,0,453,381,131,38,212,72,30,0,30,0,42,0,26,16,28659
9037,1542,270,488,515,185,84,119,78,78,0,18,60,0,0,0,0,0,0,0,0,0,41,41,0,0,41,0,0,0,0,0,0,0,0,0,28660
9038,13,0,0,0,13,0,0,0,0,0,0,0,0,0,0,0,0,0,0,0,0,0,0,0,0,0,0,0,0,0,0,0,0,0,0,28662
9039,496,66,164,176,62,28,11,5,5,0,0,5,0,0,0,0,0,0,0,0,0,6,6,0,6,0,0,0,0,0,0,0,0,0,0,28663
9040,1748,338,526,548,235,101,160,91,56,9,13,34,35,0,0,0,0,35,0,21,14,69,69,31,23,15,0,0,0,0,0,0,0,0,0,28665
9041,269,108,52,61,48,0,0,0,0,0,0,0,0,0,0,0,0,0,0,0,0,0,0,0,0,0,0,0,0,0,0,0,0,0,0,28666
9042,329,97,79,130,8,15,16,4,4,4,0,0,0,0,0,0,0,0,0,0,0,12,12,4,0,8,0,0,0,0,0,0,0,0,0,28667
9043,307,22,58,90,93,44,34,34,34,0,0,34,0,0,0,0,0,0,0,0,0,0,0,0,0,0,0,0,0,0,0,0,0,0,0,28668
9044,2286,610,895,685,83,13,339,59,20,8,6,6,39,39,39,0,0,0,0,0,0,280,234,0,17,217,46,46,0,0,46,0,0,0,0,28669
9045,2138,570,804,486,191,87,334,114,28,0,0,28,86,52,25,27,0,34,0,34,0,220,220,17,55,148,0,0,0,0,0,0,0,0,0,28670
9046,506,194,120,118,41,33,44,31,31,0,0,31,0,0,0,0,0,0,0,0,0,13,13,0,9,4,0,0,0,0,0,0,0,0,0,28671
9047,0,0,0,0,0,0,0,0,0,0,0,0,0,0,0,0,0,0,0,0,0,0,0,0,0,0,0,0,0,0,0,0,0,0,0,28672
9048,4014,357,1115,1309,886,347,183,92,92,46,23,23,0,0,0,0,0,0,0,0,0,91,91,8,22,61,0,0,0,0,0,0,0,0,0,28673
9049,4433,968,1499,1111,585,270,295,117,66,15,4,47,51,18,0,11,7,33,0,0,33,178,116,30,0,86,62,45,2,17,26,17,0,0,17,28675
9050,2680,561,698,839,434,148,76,52,46,23,0,23,6,6,6,0,0,0,0,0,0,24,24,11,0,13,0,0,0,0,0,0,0,0,0,28676
9051,21423,4860,6967,6362,2131,1103,1468,556,473,29,25,419,83,56,0,47,9,27,0,17,10,912,642,107,46,489,270,108,74,21,13,162,41,30,91,28677
9052,3431,698,1380,991,265,97,254,210,72,18,0,54,138,61,61,0,0,77,77,0,0,44,44,0,0,44,0,0,0,0,0,0,0,0,0,28678
9053,1499,311,408,431,221,128,43,33,33,2,0,31,0,0,0,0,0,0,0,0,0,10,10,0,0,10,0,0,0,0,0,0,0,0,0,28679
9054,17930,3738,7178,5115,1274,625,1483,780,586,79,119,388,194,130,124,5,1,64,41,0,23,703,572,198,41,333,131,131,131,0,0,0,0,0,0,28681
9055,790,82,145,288,163,112,19,0,0,0,0,0,0,0,0,0,0,0,0,0,0,19,0,0,0,0,19,19,0,0,19,0,0,0,0,28682
9056,1398,210,624,433,94,37,70,39,39,19,0,20,0,0,0,0,0,0,0,0,0,31,31,7,0,24,0,0,0,0,0,0,0,0,0,28683
9057,1863,245,489,718,296,115,94,20,17,7,0,10,3,3,3,0,0,0,0,0,0,74,47,0,26,21,27,27,27,0,0,0,0,0,0,28684
9058,1209,260,462,392,61,34,114,46,20,0,0,20,26,26,26,0,0,0,0,0,0,68,68,27,0,41,0,0,0,0,0,0,0,0,0,28685
9059,1245,174,555,343,145,28,113,71,32,0,0,32,39,17,0,17,0,22,22,0,0,42,11,0,0,11,31,19,0,0,19,12,0,12,0,28689
9060,6736,1155,2100,1998,872,611,405,237,237,23,0,214,0,0,0,0,0,0,0,0,0,168,123,111,0,12,45,9,0,9,0,36,0,36,0,28690
9061,2550,338,710,732,394,376,95,56,40,17,0,23,16,16,0,16,0,0,0,0,0,39,39,0,0,39,0,0,0,0,0,0,0,0,0,28692
9062,1080,286,204,483,70,37,81,81,35,0,0,35,46,0,0,0,0,46,0,0,46,0,0,0,0,0,0,0,0,0,0,0,0,0,0,28693
9063,5699,943,1922,1850,611,373,332,182,157,25,25,107,25,4,4,0,0,21,21,0,0,150,138,41,19,78,12,12,0,12,0,0,0,0,0,28694
9064,9180,2108,2210,3021,1301,540,368,224,201,53,23,125,23,20,12,0,8,3,0,0,3,144,128,0,0,128,16,15,7,0,8,1,0,1,0,28697
9065,1495,153,555,480,165,142,105,10,10,3,0,7,0,0,0,0,0,0,0,0,0,95,71,0,0,71,24,24,0,0,24,0,0,0,0,28698
9066,2832,282,1040,1007,360,143,258,94,77,24,0,53,17,17,0,0,17,0,0,0,0,164,111,72,0,39,53,53,53,0,0,0,0,0,0,28701
9067,447,19,107,178,106,37,32,10,10,0,0,10,0,0,0,0,0,0,0,0,0,22,22,0,0,22,0,0,0,0,0,0,0,0,0,28702
9068,14893,1306,3068,5049,3460,2010,1143,828,782,404,38,340,46,22,0,0,22,24,0,10,14,315,288,136,0,152,27,0,0,0,0,27,17,0,10,28704
9069,5002,1091,1825,1228,657,201,270,183,168,19,0,149,15,2,0,0,2,13,0,5,8,87,58,14,21,23,29,29,16,13,0,0,0,0,0,28705
9070,100,0,37,46,8,9,0,0,0,0,0,0,0,0,0,0,0,0,0,0,0,0,0,0,0,0,0,0,0,0,0,0,0,0,0,28707
9071,441,33,187,171,16,34,58,20,20,0,0,20,0,0,0,0,0,0,0,0,0,38,38,0,0,38,0,0,0,0,0,0,0,0,0,28708
9072,1548,437,627,266,90,128,32,23,23,0,0,23,0,0,0,0,0,0,0,0,0,9,9,9,0,0,0,0,0,0,0,0,0,0,0,28709
9073,9025,1007,2420,2599,1846,1153,548,299,246,79,0,167,53,14,14,0,0,39,0,0,39,249,239,118,9,112,10,10,0,0,10,0,0,0,0,28711
9074,13227,1656,3540,3975,2473,1583,999,541,434,95,35,304,107,92,32,56,4,15,0,0,15,458,458,155,22,281,0,0,0,0,0,0,0,0,0,28712
9075,6624,1073,2090,2248,736,477,614,351,234,120,0,114,117,102,65,0,37,15,0,15,0,263,211,37,14,160,52,42,0,25,17,10,0,0,10,28713
9076,12130,1926,4069,3902,1494,739,678,386,321,117,14,190,65,43,0,43,0,22,0,0,22,292,283,114,19,150,9,9,9,0,0,0,0,0,0,28714
9077,18452,2861,6153,5939,2475,1024,1083,414,371,49,51,271,43,42,0,42,0,1,0,0,1,669,543,294,23,226,126,62,11,51,0,64,29,15,20,28715
9078,12123,1680,4521,4073,1363,486,926,532,471,50,29,392,61,37,9,10,18,24,11,13,0,394,303,82,26,195,91,52,40,12,0,39,16,15,8,28716
9079,1657,118,404,420,464,251,16,0,0,0,0,0,0,0,0,0,0,0,0,0,0,16,16,16,0,0,0,0,0,0,0,0,0,0,0,28717
9080,292,40,37,91,82,42,13,13,13,0,0,13,0,0,0,0,0,0,0,0,0,0,0,0,0,0,0,0,0,0,0,0,0,0,0,28718
9081,4952,1080,1847,1528,355,142,447,206,146,41,0,105,60,19,19,0,0,41,0,0,41,241,82,0,0,82,159,133,87,0,46,26,0,0,26,28719
9082,112,6,31,50,21,4,8,8,8,8,0,0,0,0,0,0,0,0,0,0,0,0,0,0,0,0,0,0,0,0,0,0,0,0,0,28720
9083,6918,1296,2261,1980,918,463,485,326,204,52,0,152,122,52,3,49,0,70,38,0,32,159,145,25,40,80,14,11,9,0,2,3,3,0,0,28721
9084,5203,681,1603,1626,564,729,277,178,132,13,3,116,46,46,11,11,24,0,0,0,0,99,95,10,0,85,4,0,0,0,0,4,4,0,0,28722
9085,4120,493,1061,1189,540,837,2365,1096,1054,144,62,848,42,41,41,0,0,1,0,0,1,1269,1266,311,21,934,3,3,0,0,3,0,0,0,0,28723
9086,8,0,0,3,5,0,0,0,0,0,0,0,0,0,0,0,0,0,0,0,0,0,0,0,0,0,0,0,0,0,0,0,0,0,0,28725
9087,2520,612,830,685,324,69,71,71,71,36,11,24,0,0,0,0,0,0,0,0,0,0,0,0,0,0,0,0,0,0,0,0,0,0,0,28726
9088,2012,115,573,689,304,331,263,195,152,12,46,94,43,43,43,0,0,0,0,0,0,68,68,68,0,0,0,0,0,0,0,0,0,0,0,28729
9089,7461,587,2177,1990,1810,897,279,99,88,36,0,52,11,10,0,10,0,1,0,0,1,180,151,66,0,85,29,29,0,29,0,0,0,0,0,28730
9090,5448,670,1166,2036,976,600,335,283,208,14,0,194,75,32,32,0,0,43,0,0,43,52,40,28,0,12,12,12,12,0,0,0,0,0,0,28731
9091,11035,1199,2758,3548,2386,1144,592,322,315,59,34,222,7,0,0,0,0,7,7,0,0,270,255,64,26,165,15,15,0,0,15,0,0,0,0,28732
9092,45,25,20,0,0,0,12,0,0,0,0,0,0,0,0,0,0,0,0,0,0,12,12,0,0,12,0,0,0,0,0,0,0,0,0,28733
9093,19618,3073,6216,6919,2213,1197,1194,717,599,144,31,424,118,77,39,24,14,41,0,14,27,477,383,78,27,278,94,71,54,16,1,23,0,15,8,28734
9094,153,10,8,64,31,40,9,9,9,0,0,9,0,0,0,0,0,0,0,0,0,0,0,0,0,0,0,0,0,0,0,0,0,0,0,28735
9095,808,266,190,241,69,42,46,37,20,20,0,0,17,17,0,0,17,0,0,0,0,9,9,9,0,0,0,0,0,0,0,0,0,0,0,28736
9096,15726,1225,3300,5486,3375,2340,714,421,375,93,12,270,46,22,17,0,5,24,0,24,0,293,184,23,20,141,109,27,0,0,27,82,55,27,0,28739
9097,1271,299,603,255,96,18,154,69,38,0,0,38,31,31,31,0,0,0,0,0,0,85,43,17,0,26,42,42,20,0,22,0,0,0,0,28740
9098,3105,230,543,847,855,630,78,36,18,4,0,14,18,0,0,0,0,18,10,4,4,42,39,17,0,22,3,1,0,0,1,2,2,0,0,28741
9099,2526,64,880,1134,346,102,194,101,83,75,0,8,18,18,18,0,0,0,0,0,0,93,78,0,0,78,15,0,0,0,0,15,15,0,0,28742
9100,1462,442,555,325,93,47,42,1,0,0,0,0,1,0,0,0,0,1,1,0,0,41,22,8,0,14,19,14,0,0,14,5,0,0,5,28743
9101,522,11,36,175,94,206,57,57,49,49,0,0,8,8,8,0,0,0,0,0,0,0,0,0,0,0,0,0,0,0,0,0,0,0,0,28745
9102,2144,107,547,759,464,267,96,24,0,0,0,0,24,24,0,24,0,0,0,0,0,72,67,49,18,0,5,5,5,0,0,0,0,0,0,28746
9103,1789,262,494,704,173,156,61,61,39,0,0,39,22,22,0,22,0,0,0,0,0,0,0,0,0,0,0,0,0,0,0,0,0,0,0,28747
9104,8341,1413,3379,2560,697,292,640,282,269,94,1,174,13,0,0,0,0,13,0,13,0,358,324,75,26,223,34,34,0,0,34,0,0,0,0,28748
9105,0,0,0,0,0,0,0,0,0,0,0,0,0,0,0,0,0,0,0,0,0,0,0,0,0,0,0,0,0,0,0,0,0,0,0,28749
9106,2574,212,909,746,438,269,130,91,76,0,0,76,15,15,15,0,0,0,0,0,0,39,39,21,4,14,0,0,0,0,0,0,0,0,0,28751
9107,21650,3959,7940,6385,2292,1074,1259,624,429,129,42,258,195,49,21,20,8,146,19,0,127,635,496,115,58,323,139,117,5,101,11,22,0,0,22,28752
9108,8283,1467,2842,2649,816,509,494,284,255,73,6,176,29,10,2,2,6,19,0,0,19,210,156,81,8,67,54,54,54,0,0,0,0,0,0,28753
9109,5137,892,1489,1528,811,417,654,359,354,36,27,291,5,0,0,0,0,5,0,0,5,295,258,71,5,182,37,0,0,0,0,37,0,0,37,28754
9110,2869,408,1003,1118,266,74,176,84,84,7,0,77,0,0,0,0,0,0,0,0,0,92,92,0,0,92,0,0,0,0,0,0,0,0,0,28756
9111,267,23,0,59,61,124,17,8,8,0,0,8,0,0,0,0,0,0,0,0,0,9,9,0,0,9,0,0,0,0,0,0,0,0,0,28757
9112,4973,355,1320,1830,764,704,206,162,122,54,0,68,40,12,0,12,0,28,28,0,0,44,23,0,0,23,21,21,13,0,8,0,0,0,0,28759
9113,5240,1020,1793,1633,506,288,503,309,296,116,34,146,13,13,0,0,13,0,0,0,0,194,194,57,16,121,0,0,0,0,0,0,0,0,0,28761
9114,5031,1127,1973,1510,294,127,340,130,81,22,21,38,49,11,0,0,11,38,0,38,0,210,185,102,0,83,25,20,20,0,0,5,0,5,0,28762
9115,1918,197,597,841,151,132,61,13,0,0,0,0,13,13,0,0,13,0,0,0,0,48,48,24,0,24,0,0,0,0,0,0,0,0,0,28763
9116,988,75,405,389,89,30,34,34,34,0,34,0,0,0,0,0,0,0,0,0,0,0,0,0,0,0,0,0,0,0,0,0,0,0,0,28766
9117,5350,392,1529,1769,943,717,325,147,129,3,54,72,18,0,0,0,0,18,0,0,18,178,178,157,0,21,0,0,0,0,0,0,0,0,0,28768
9118,5500,1239,1895,1649,500,217,430,157,110,3,4,103,47,34,21,0,13,13,0,0,13,273,258,71,28,159,15,5,5,0,0,10,0,0,10,28771
9119,1202,293,345,432,84,48,10,7,7,0,0,7,0,0,0,0,0,0,0,0,0,3,3,0,0,3,0,0,0,0,0,0,0,0,0,28772
9120,2089,235,659,487,453,255,144,85,29,17,10,2,56,56,53,0,3,0,0,0,0,59,59,18,0,41,0,0,0,0,0,0,0,0,0,28773
9121,1179,70,262,377,275,195,79,39,39,39,0,0,0,0,0,0,0,0,0,0,0,40,40,20,0,20,0,0,0,0,0,0,0,0,0,28774
9122,183,26,76,53,28,0,87,0,0,0,0,0,0,0,0,0,0,0,0,0,0,87,87,87,0,0,0,0,0,0,0,0,0,0,0,28775
9123,7553,1410,2521,2527,752,343,448,265,170,76,13,81,95,37,26,11,0,58,45,0,13,183,165,63,17,85,18,0,0,0,0,18,11,0,7,28777
9124,6983,995,2101,2112,1283,492,1028,532,484,136,7,341,48,41,41,0,0,7,0,0,7,496,402,139,7,256,94,0,0,0,0,94,0,32,62,28778
9125,11846,1809,2948,3638,2346,1105,459,235,185,4,3,178,50,3,0,0,3,47,0,0,47,224,206,28,21,157,18,18,0,1,17,0,0,0,0,28779
9126,675,79,359,152,46,39,0,0,0,0,0,0,0,0,0,0,0,0,0,0,0,0,0,0,0,0,0,0,0,0,0,0,0,0,0,28781
9127,5329,700,1146,1612,1117,754,210,78,74,29,0,45,4,4,0,4,0,0,0,0,0,132,124,44,10,70,8,8,8,0,0,0,0,0,0,28782
9128,763,272,241,173,68,9,85,61,13,0,0,13,48,16,0,0,16,32,0,0,32,24,10,0,0,10,14,7,0,0,7,7,7,0,0,28783
9129,5852,558,1505,1919,1237,633,366,165,132,54,57,21,33,33,33,0,0,0,0,0,0,201,180,68,0,112,21,12,12,0,0,9,0,0,9,28785
9130,15537,2290,4357,4981,2508,1401,753,302,239,119,43,77,63,55,22,0,33,8,0,8,0,451,411,94,19,298,40,8,0,0,8,32,12,0,20,28786
9131,13808,1287,4292,4203,2488,1538,874,418,321,87,53,181,97,44,10,34,0,53,31,0,22,456,406,224,32,150,50,50,50,0,0,0,0,0,0,28787
9132,3417,436,886,1282,452,361,193,179,169,45,23,101,10,10,0,10,0,0,0,0,0,14,14,11,0,3,0,0,0,0,0,0,0,0,0,28789
9133,2436,352,721,819,415,129,178,114,100,7,30,63,14,0,0,0,0,14,0,14,0,64,64,0,18,46,0,0,0,0,0,0,0,0,0,28790
9134,11261,1094,2849,3459,2427,1432,632,239,203,34,63,106,36,0,0,0,0,36,0,36,0,393,355,68,63,224,38,0,0,0,0,38,38,0,0,28791
9135,23025,4250,7134,6970,3076,1595,1321,530,363,47,44,272,167,56,18,38,0,111,12,6,93,791,606,54,44,508,185,18,10,0,8,167,17,11,139,28792
9136,10114,1394,1876,2836,2532,1476,597,303,276,35,57,184,27,5,0,5,0,22,0,0,22,294,197,66,42,89,97,92,25,66,1,5,0,0,5,28801
9137,21475,2063,4149,5348,6580,3335,1275,891,602,142,91,369,289,137,47,57,33,152,60,60,32,384,320,84,0,236,64,13,6,0,7,51,27,14,10,28803
9138,14487,1084,2750,3826,3784,3043,1490,704,659,194,66,399,45,33,27,6,0,12,0,12,0,786,744,196,51,497,42,14,0,0,14,28,21,0,7,28804
9139,13282,961,2954,4049,3079,2239,668,392,374,186,0,188,18,12,12,0,0,6,0,0,6,276,267,93,52,122,9,9,9,0,0,0,0,0,0,28805
9140,26509,3131,6275,8411,5907,2785,1382,772,660,217,0,443,112,85,0,0,85,27,0,0,27,610,358,137,11,210,252,164,68,50,46,88,9,61,18,28806
9141,3924,865,1398,1068,460,133,330,165,118,47,4,67,47,31,0,0,31,16,0,0,16,165,147,6,0,141,18,18,0,4,14,0,0,0,0,28901
9142,1192,120,371,478,138,85,55,55,55,0,0,55,0,0,0,0,0,0,0,0,0,0,0,0,0,0,0,0,0,0,0,0,0,0,0,28902
9143,5980,758,1780,2144,666,632,333,118,75,23,5,47,43,40,21,0,19,3,0,0,3,215,204,17,26,161,11,3,0,0,3,8,0,0,8,28904
9144,2014,344,598,577,235,260,132,126,121,0,0,121,5,5,0,0,5,0,0,0,0,6,6,6,0,0,0,0,0,0,0,0,0,0,0,28905
9145,14172,2490,4399,5022,1477,784,756,319,300,31,42,227,19,10,0,5,5,9,0,0,9,437,436,42,38,356,1,1,0,1,0,0,0,0,0,28906
9146,838,142,208,362,67,59,20,20,8,8,0,0,12,0,0,0,0,12,0,0,12,0,0,0,0,0,0,0,0,0,0,0,0,0,0,28909
9147,1250,375,336,332,147,60,145,34,30,0,0,30,4,4,0,0,4,0,0,0,0,111,96,20,8,68,15,0,0,0,0,15,0,0,15,29001
9148,4536,896,1243,1545,520,332,499,193,149,0,17,132,44,0,0,0,0,44,0,0,44,306,300,20,0,280,6,0,0,0,0,6,0,0,6,29003
9149,6270,1201,2658,1638,514,259,422,237,127,51,0,76,110,84,78,6,0,26,16,0,10,185,171,4,15,152,14,9,9,0,0,5,0,0,5,29006
9150,1658,427,636,461,94,40,105,91,68,1,22,45,23,21,12,0,9,2,0,0,2,14,5,0,2,3,9,9,0,0,9,0,0,0,0,29009
9151,8199,2113,3079,2211,525,271,556,329,246,79,47,120,83,57,44,0,13,26,0,0,26,227,156,15,40,101,71,12,0,0,12,59,0,59,0,29010
9152,1334,276,390,506,138,24,97,59,40,0,12,28,19,19,19,0,0,0,0,0,0,38,37,26,0,11,1,1,1,0,0,0,0,0,0,29014
9153,957,165,502,167,106,17,99,45,44,12,0,32,1,0,0,0,0,1,0,0,1,54,46,0,0,46,8,8,8,0,0,0,0,0,0,29015
9154,11016,768,2184,3383,3146,1535,779,408,403,146,0,257,5,5,2,2,1,0,0,0,0,371,320,32,0,288,51,51,46,0,5,0,0,0,0,29016
9155,2496,319,1215,581,248,133,191,69,59,16,3,40,10,0,0,0,0,10,0,4,6,122,122,18,39,65,0,0,0,0,0,0,0,0,0,29018
9156,15682,2534,4993,4919,2206,1030,1112,572,462,153,13,296,110,47,17,23,7,63,10,0,53,540,435,32,32,371,105,24,16,0,8,81,13,0,68,29020
9157,1608,294,506,460,244,104,124,46,46,12,0,34,0,0,0,0,0,0,0,0,0,78,78,0,0,78,0,0,0,0,0,0,0,0,0,29030
9158,1033,253,441,282,40,17,15,13,13,12,0,1,0,0,0,0,0,0,0,0,0,2,2,0,0,2,0,0,0,0,0,0,0,0,0,29031
9159,2780,554,1593,437,114,82,236,87,48,24,0,24,39,0,0,0,0,39,0,29,10,149,149,59,12,78,0,0,0,0,0,0,0,0,0,29032
9160,8246,1003,2631,2670,1257,685,461,244,183,40,51,92,61,37,37,0,0,24,10,0,14,217,189,11,35,143,28,17,0,0,17,11,11,0,0,29033
9161,13542,846,2666,4099,3885,2046,674,370,247,65,18,164,123,106,81,13,12,17,0,8,9,304,271,10,45,216,33,33,8,0,25,0,0,0,0,29036
9162,658,106,267,224,37,24,74,13,13,0,0,13,0,0,0,0,0,0,0,0,0,61,61,0,37,24,0,0,0,0,0,0,0,0,0,29037
9163,1857,511,648,490,183,25,118,72,54,16,0,38,18,1,1,0,0,17,0,17,0,46,36,10,13,13,10,10,0,0,10,0,0,0,0,29038
9164,2575,588,874,779,222,112,285,88,47,22,0,25,41,11,1,0,10,30,0,30,0,197,197,17,34,146,0,0,0,0,0,0,0,0,0,29039
9165,5644,746,1803,1914,717,464,603,215,142,8,0,134,73,52,19,33,0,21,0,10,11,388,258,15,23,220,130,77,0,60,17,53,10,0,43,29040
9166,3249,861,677,1122,458,131,618,350,334,15,0,319,16,0,0,0,0,16,16,0,0,268,255,0,26,229,13,13,0,0,13,0,0,0,0,29042
9167,3975,623,1590,1166,431,165,349,160,151,27,11,113,9,0,0,0,0,9,9,0,0,189,189,53,0,136,0,0,0,0,0,0,0,0,0,29044
9168,14812,1687,4333,4855,2361,1576,669,317,220,54,0,166,97,77,0,26,51,20,10,0,10,352,274,30,1,243,78,51,0,48,3,27,0,9,18,29045
9169,263,132,66,8,33,24,0,0,0,0,0,0,0,0,0,0,0,0,0,0,0,0,0,0,0,0,0,0,0,0,0,0,0,0,0,29046
9170,2705,598,1033,635,288,151,200,135,121,12,0,109,14,5,0,0,5,9,0,0,9,65,63,12,18,33,2,0,0,0,0,2,0,0,2,29047
9171,3396,955,1196,889,202,154,448,234,214,34,0,180,20,4,4,0,0,16,0,0,16,214,152,30,0,122,62,0,0,0,0,62,1,0,61,29048
9172,1115,354,470,232,59,0,159,150,54,5,0,49,96,34,0,0,34,62,0,0,62,9,9,0,0,9,0,0,0,0,0,0,0,0,0,29051
9173,1380,267,704,362,47,0,98,41,9,0,0,9,32,32,0,32,0,0,0,0,0,57,57,0,0,57,0,0,0,0,0,0,0,0,0,29052
9174,12313,2692,4897,3595,850,279,1307,741,332,17,5,310,409,263,49,100,114,146,84,29,33,566,355,13,0,342,211,140,69,0,71,71,14,0,57,29053
9175,6386,1006,2013,1957,925,485,512,225,187,35,0,152,38,38,0,38,0,0,0,0,0,287,263,77,16,170,24,24,24,0,0,0,0,0,0,29054
9176,3151,875,1272,728,181,95,286,207,192,64,5,123,15,10,0,10,0,5,0,5,0,79,79,4,13,62,0,0,0,0,0,0,0,0,0,29055
9177,1677,293,722,505,54,103,134,121,103,11,18,74,18,18,0,0,18,0,0,0,0,13,13,0,0,13,0,0,0,0,0,0,0,0,0,29056
9178,3200,535,1248,1134,172,111,209,94,94,15,0,79,0,0,0,0,0,0,0,0,0,115,107,12,0,95,8,7,0,7,0,1,0,0,1,29058
9179,3432,1025,1148,741,304,214,215,71,64,15,1,48,7,4,4,0,0,3,0,0,3,144,85,33,6,46,59,0,0,0,0,59,0,59,0,29059
9180,9810,1059,3284,3625,1351,491,902,345,269,54,24,191,76,36,11,25,0,40,0,40,0,557,535,32,46,457,22,0,0,0,0,22,22,0,0,29061
9181,95,0,57,30,8,0,0,0,0,0,0,0,0,0,0,0,0,0,0,0,0,0,0,0,0,0,0,0,0,0,0,0,0,0,0,29062
9182,21361,842,4519,6695,6018,3287,1970,1054,884,89,95,700,170,36,25,0,11,134,134,0,0,916,854,386,57,411,62,62,39,23,0,0,0,0,0,29063
9183,584,163,231,106,74,10,0,0,0,0,0,0,0,0,0,0,0,0,0,0,0,0,0,0,0,0,0,0,0,0,0,0,0,0,0,29065
9184,7821,1987,3117,2195,359,163,362,188,152,22,7,123,36,24,5,3,16,12,12,0,0,174,145,37,0,108,29,4,0,0,4,25,22,0,3,29067
9185,3562,782,1372,957,315,136,263,118,115,0,48,67,3,3,0,0,3,0,0,0,0,145,110,44,0,66,35,35,0,0,35,0,0,0,0,29069
9186,10520,1802,3773,3376,1063,506,675,329,310,71,2,237,19,16,0,0,16,3,0,3,0,346,306,43,74,189,40,20,0,9,11,20,0,16,4,29070
9187,33947,1873,6520,10362,9583,5609,2790,1645,1448,351,120,977,197,108,12,55,41,89,29,6,54,1145,1053,446,47,560,92,63,29,0,34,29,11,0,18,29072
9188,26823,3379,8454,9460,3657,1873,2150,1200,1071,170,41,860,129,129,39,90,0,0,0,0,0,950,800,179,127,494,150,95,70,12,13,55,11,0,44,29073
9189,195,0,94,50,9,42,9,9,9,0,0,9,0,0,0,0,0,0,0,0,0,0,0,0,0,0,0,0,0,0,0,0,0,0,0,29074
9190,2361,461,668,721,255,256,147,82,82,62,2,18,0,0,0,0,0,0,0,0,0,65,65,41,0,24,0,0,0,0,0,0,0,0,0,29075
9191,9747,1068,3114,3301,1391,873,955,529,408,60,117,231,121,102,10,81,11,19,0,0,19,426,272,50,0,222,154,128,42,43,43,26,0,26,0,29078
9192,46,0,0,46,0,0,0,0,0,0,0,0,0,0,0,0,0,0,0,0,0,0,0,0,0,0,0,0,0,0,0,0,0,0,0,29079
9193,2253,707,827,528,117,74,166,58,30,8,5,17,28,28,0,0,28,0,0,0,0,108,62,6,0,56,46,39,39,0,0,7,0,0,7,29080
9194,820,223,241,248,79,29,66,24,24,0,0,24,0,0,0,0,0,0,0,0,0,42,38,0,0,38,4,0,0,0,0,4,0,0,4,29081
9195,395,48,142,152,29,24,47,39,39,0,0,39,0,0,0,0,0,0,0,0,0,8,8,1,0,7,0,0,0,0,0,0,0,0,0,29082
9196,1906,369,742,632,127,36,229,85,61,0,20,41,24,24,0,0,24,0,0,0,0,144,142,36,10,96,2,2,0,0,2,0,0,0,0,29101
9197,12145,2362,4755,3446,940,642,1083,542,396,46,44,306,146,108,49,22,37,38,19,19,0,541,509,180,37,292,32,31,0,7,24,1,0,0,1,29102
9198,1148,219,486,294,124,25,105,76,66,0,6,60,10,8,8,0,0,2,0,0,2,29,29,0,8,21,0,0,0,0,0,0,0,0,0,29104
9199,641,165,131,181,156,8,31,1,1,0,0,1,0,0,0,0,0,0,0,0,0,30,23,12,0,11,7,7,7,0,0,0,0,0,0,29105
9200,2157,419,841,629,199,69,134,76,43,9,0,34,33,0,0,0,0,33,0,32,1,58,37,6,0,31,21,20,20,0,0,1,0,0,1,29107
9201,13104,3511,4064,2838,1821,870,1364,693,571,126,56,389,122,54,54,0,0,68,0,43,25,671,640,309,0,331,31,31,20,11,0,0,0,0,0,29108
9202,1040,188,420,231,132,69,150,61,47,13,0,34,14,14,6,0,8,0,0,0,0,89,82,71,0,11,7,7,0,0,7,0,0,0,0,29111
9203,3290,887,1114,926,330,33,295,110,81,14,10,57,29,5,0,5,0,24,0,24,0,185,165,10,14,141,20,8,0,8,0,12,0,0,12,29112
9204,1373,293,721,245,74,40,80,37,37,0,0,37,0,0,0,0,0,0,0,0,0,43,40,0,0,40,3,0,0,0,0,3,0,3,0,29113
9205,1470,445,634,225,103,63,113,53,17,7,0,10,36,36,2,34,0,0,0,0,0,60,58,0,1,57,2,2,2,0,0,0,0,0,0,29114
9206,17903,3604,5961,4684,2137,1517,1959,896,837,65,87,685,59,46,30,7,9,13,0,0,13,1063,939,75,45,819,124,56,11,0,45,68,37,0,31,29115
9207,10,0,0,4,6,0,612,342,342,21,3,318,0,0,0,0,0,0,0,0,0,270,270,4,3,263,0,0,0,0,0,0,0,0,0,29117
9208,10899,1324,3228,2867,1844,1636,710,296,267,21,0,246,29,4,0,0,4,25,0,0,25,414,362,54,16,292,52,52,0,0,52,0,0,0,0,29118
9209,38,6,11,11,8,2,8,0,0,0,0,0,0,0,0,0,0,0,0,0,0,8,7,6,1,0,1,1,0,0,1,0,0,0,0,29122
9210,4801,1083,1973,1418,279,48,273,27,27,4,0,23,0,0,0,0,0,0,0,0,0,246,221,46,0,175,25,0,0,0,0,25,0,25,0,29123
9211,1742,442,647,467,129,57,88,69,51,17,18,16,18,18,0,18,0,0,0,0,0,19,19,0,7,12,0,0,0,0,0,0,0,0,0,29125
9212,1559,307,578,487,83,104,148,96,96,0,16,80,0,0,0,0,0,0,0,0,0,52,52,0,0,52,0,0,0,0,0,0,0,0,0,29126
9213,5626,857,1823,1650,896,400,242,177,177,6,34,137,0,0,0,0,0,0,0,0,0,65,41,6,0,35,24,24,24,0,0,0,0,0,0,29127
9214,4043,1210,1333,1010,311,179,493,319,244,14,15,215,75,48,0,0,48,27,0,0,27,174,159,39,15,105,15,0,0,0,0,15,0,0,15,29128
9215,2588,436,978,697,346,131,148,104,86,0,7,79,18,10,10,0,0,8,8,0,0,44,23,0,11,12,21,15,8,0,7,6,0,0,6,29129
9216,5411,756,2113,1585,590,367,459,219,139,25,17,97,80,58,24,0,34,22,0,22,0,240,182,68,17,97,58,58,24,0,34,0,0,0,0,29130
9217,830,202,260,251,43,74,106,67,67,44,0,23,0,0,0,0,0,0,0,0,0,39,37,0,0,37,2,0,0,0,0,2,2,0,0,29133
9218,6008,1184,2285,1662,606,271,410,135,101,0,0,101,34,13,13,0,0,21,0,0,21,275,206,12,21,173,69,49,42,7,0,20,8,0,12,29135
9219,1890,383,982,408,65,52,157,58,58,0,0,58,0,0,0,0,0,0,0,0,0,99,99,0,25,74,0,0,0,0,0,0,0,0,0,29137
9220,6945,1977,2704,1563,519,182,489,344,293,9,22,262,51,49,49,0,0,2,0,0,2,145,132,76,0,56,13,13,9,0,4,0,0,0,0,29138
9221,3689,1026,1408,764,378,113,285,136,64,0,0,64,72,72,60,0,12,0,0,0,0,149,128,43,0,85,21,21,0,4,17,0,0,0,0,29142
9222,504,159,129,137,73,6,26,16,16,2,0,14,0,0,0,0,0,0,0,0,0,10,10,0,0,10,0,0,0,0,0,0,0,0,0,29145
9223,1247,237,559,238,162,51,55,24,10,2,0,8,14,14,6,0,8,0,0,0,0,31,11,0,0,11,20,20,15,5,0,0,0,0,0,29146
9224,0,0,0,0,0,0,0,0,0,0,0,0,0,0,0,0,0,0,0,0,0,0,0,0,0,0,0,0,0,0,0,0,0,0,0,29147
9225,4946,1298,1734,1248,393,273,295,171,161,22,0,139,10,0,0,0,0,10,0,6,4,124,124,0,0,124,0,0,0,0,0,0,0,0,0,29148
9226,26075,4313,7403,8412,3565,2382,2119,1100,938,116,85,737,162,103,55,48,0,59,0,0,59,1019,891,179,76,636,128,110,40,60,10,18,12,0,6,29150
9227,522,0,23,481,18,0,218,147,10,8,0,2,137,137,137,0,0,0,0,0,0,71,10,10,0,0,61,61,22,5,34,0,0,0,0,29152
9228,10237,2247,4018,2585,903,484,1150,654,460,34,35,391,194,65,27,0,38,129,79,0,50,496,446,49,0,397,50,40,40,0,0,10,0,0,10,29153
9229,19232,2898,5421,7022,2611,1280,1309,644,555,70,21,464,89,89,29,0,60,0,0,0,0,665,595,80,77,438,70,25,11,0,14,45,18,9,18,29154
9230,5575,956,2039,1724,540,316,298,174,111,0,0,111,63,12,12,0,0,51,8,43,0,124,124,35,33,56,0,0,0,0,0,0,0,0,0,29160
9231,7629,1761,2890,2095,586,297,383,196,169,13,8,148,27,27,0,8,19,0,0,0,0,187,143,36,11,96,44,32,12,0,20,12,0,0,12,29161
9232,1886,432,692,570,108,84,159,116,73,17,7,49,43,14,7,0,7,29,3,10,16,43,39,7,22,10,4,4,3,0,1,0,0,0,0,29162
9233,1457,462,500,300,111,84,164,47,45,3,0,42,2,2,0,0,2,0,0,0,0,117,111,0,0,111,6,0,0,0,0,6,0,5,1,29163
9234,2778,540,1173,784,202,79,146,82,82,10,10,62,0,0,0,0,0,0,0,0,0,64,39,4,8,27,25,10,3,0,7,15,0,0,15,29164
9235,772,136,327,196,91,22,3,3,3,0,0,3,0,0,0,0,0,0,0,0,0,0,0,0,0,0,0,0,0,0,0,0,0,0,0,29166
9236,1875,440,628,639,121,47,107,97,56,0,0,56,41,0,0,0,0,41,0,20,21,10,10,5,0,5,0,0,0,0,0,0,0,0,0,29168
9237,15863,2167,3920,4495,3357,1924,899,437,245,46,13,186,192,139,56,52,31,53,27,0,26,462,351,20,42,289,111,49,41,8,0,62,17,0,45,29169
9238,13856,1428,4700,4796,1962,970,1272,707,494,105,21,368,213,211,133,33,45,2,1,0,1,565,480,119,30,331,85,58,45,2,11,27,0,0,27,29170
9239,5867,715,2308,2095,544,205,468,205,178,79,0,99,27,21,21,0,0,6,0,6,0,263,226,67,12,147,37,37,15,8,14,0,0,0,0,29172
9240,249,30,144,75,0,0,25,25,25,0,25,0,0,0,0,0,0,0,0,0,0,0,0,0,0,0,0,0,0,0,0,0,0,0,0,29175
9241,2243,535,937,559,136,76,184,84,48,0,0,48,36,27,0,14,13,9,0,0,9,100,69,29,3,37,31,20,0,20,0,11,0,0,11,29178
9242,8997,1629,3356,2445,884,683,835,412,356,38,5,313,56,50,44,0,6,6,0,6,0,423,334,112,35,187,89,0,0,0,0,89,0,42,47,29180
9243,8035,869,1287,1830,2423,1626,3020,1309,1309,213,113,983,0,0,0,0,0,0,0,0,0,1711,1653,440,151,1062,58,48,48,0,0,10,0,0,10,29201
9244,102,0,18,4,60,20,36,6,6,6,0,0,0,0,0,0,0,0,0,0,0,30,30,22,0,8,0,0,0,0,0,0,0,0,0,29202
9245,26136,4626,8879,7380,3195,2056,2731,1147,988,199,209,580,159,75,18,26,31,84,0,70,14,1584,1441,328,200,913,143,81,61,4,16,62,10,4,48,29203
9246,13345,2457,2689,3904,2431,1864,2066,973,894,140,138,616,79,46,33,0,13,33,23,0,10,1093,1034,200,214,620,59,40,0,0,40,19,0,19,0,29204
9247,15592,1516,2147,3155,4243,4531,2203,1407,1340,190,112,1038,67,40,0,0,40,27,22,0,5,796,789,106,40,643,7,7,0,0,7,0,0,0,0,29205
9248,12592,486,1200,3523,4347,3036,900,406,404,74,58,272,2,2,2,0,0,0,0,0,0,494,423,67,80,276,71,71,71,0,0,0,0,0,0,29206
9249,2102,2,257,1232,482,129,4210,2835,1304,1304,0,0,1531,1531,1516,0,15,0,0,0,0,1375,596,596,0,0,779,779,719,0,60,0,0,0,0,29207
9250,12,0,0,12,0,0,578,258,258,38,0,220,0,0,0,0,0,0,0,0,0,320,320,103,41,176,0,0,0,0,0,0,0,0,0,29208
9251,21997,2217,4994,7383,4365,3038,1329,754,489,68,133,288,265,129,75,28,26,136,0,76,60,575,474,90,53,331,101,61,61,0,0,40,12,12,16,29209
9252,26736,3937,6720,8671,4862,2546,1767,950,629,105,113,411,321,156,40,55,61,165,17,44,104,817,676,304,99,273,141,100,53,32,15,41,9,21,11,29210
9253,20458,1060,3777,6623,5625,3373,1774,901,750,86,131,533,151,50,17,33,0,101,0,0,101,873,745,294,132,319,128,43,20,0,23,85,12,0,73,29212
9254,34611,3435,7631,11881,7268,4396,2377,1476,1162,254,246,662,314,267,75,97,95,47,0,10,37,901,757,254,93,410,144,65,10,9,46,79,13,29,37,29223
9255,6,0,0,0,6,0,907,67,67,12,4,51,0,0,0,0,0,0,0,0,0,840,840,161,71,608,0,0,0,0,0,0,0,0,0,29225
9256,26553,1401,4440,9856,6503,4353,2398,1071,999,186,243,570,72,72,0,15,57,0,0,0,0,1327,1283,387,162,734,44,44,35,0,9,0,0,0,0,29229
9257,19083,2669,5474,5842,3104,1994,1806,828,707,97,61,549,121,94,82,0,12,27,18,0,9,978,868,173,54,641,110,104,58,35,11,6,0,6,0,29301
9258,11978,1361,2542,3231,2899,1945,1141,416,328,91,27,210,88,88,60,23,5,0,0,0,0,725,654,235,78,341,71,41,0,0,41,30,10,20,0,29302
9259,14874,5009,4725,3872,934,334,2179,856,691,159,24,508,165,128,80,29,19,37,0,3,34,1323,1194,438,102,654,129,38,0,12,26,91,18,20,53,29303
9260,10333,2442,3054,3127,991,719,949,370,308,40,26,242,62,34,0,28,6,28,0,0,28,579,421,67,46,308,158,128,128,0,0,30,0,8,22,29306
9261,13523,1584,3363,4109,2452,2015,788,452,371,75,29,267,81,48,22,0,26,33,15,11,7,336,320,54,29,237,16,8,8,0,0,8,8,0,0,29307
9262,14388,1692,4025,4765,2559,1347,1351,865,777,401,37,339,88,78,60,0,18,10,0,10,0,486,472,112,11,349,14,14,14,0,0,0,0,0,0,29316
9263,411,189,106,18,98,0,101,65,0,0,0,0,65,65,0,65,0,0,0,0,0,36,0,0,0,0,36,36,0,36,0,0,0,0,0,29320
9264,1661,382,616,415,163,85,168,95,43,15,0,28,52,40,0,0,40,12,0,0,12,73,73,0,0,73,0,0,0,0,0,0,0,0,0,29321
9265,5961,1045,2151,1565,877,323,446,184,137,79,12,46,47,20,20,0,0,27,17,9,1,262,250,79,43,128,12,12,0,5,7,0,0,0,0,29322
9266,10233,2289,3819,3060,849,216,814,433,307,110,42,155,126,75,75,0,0,51,0,36,15,381,302,108,8,186,79,79,58,3,18,0,0,0,0,29323
9267,107,21,65,21,0,0,9,5,5,0,5,0,0,0,0,0,0,0,0,0,0,4,4,0,0,4,0,0,0,0,0,0,0,0,0,29324
9268,9154,2561,2893,1906,1122,672,993,514,392,52,0,340,122,57,26,11,20,65,0,0,65,479,447,162,53,232,32,32,32,0,0,0,0,0,0,29325
9269,104,35,49,20,0,0,24,11,11,0,11,0,0,0,0,0,0,0,0,0,0,13,13,0,13,0,0,0,0,0,0,0,0,0,0,29329
9270,5387,1455,1702,1545,507,178,535,201,117,7,12,98,84,28,15,13,0,56,37,0,19,334,225,35,72,118,109,109,51,0,58,0,0,0,0,29330
9271,123,37,10,76,0,0,40,0,0,0,0,0,0,0,0,0,0,0,0,0,0,40,32,0,0,32,8,0,0,0,0,8,8,0,0,29331
9272,2252,518,831,670,154,79,100,89,80,10,0,70,9,5,0,0,5,4,0,0,4,11,10,0,0,10,1,1,0,1,0,0,0,0,0,29332
9273,436,120,189,110,17,0,0,0,0,0,0,0,0,0,0,0,0,0,0,0,0,0,0,0,0,0,0,0,0,0,0,0,0,0,0,29333
9274,8316,862,2498,2938,1330,688,665,330,207,56,19,132,123,108,88,0,20,15,15,0,0,335,313,105,31,177,22,22,0,22,0,0,0,0,0,29334
9275,3986,1037,1438,1127,268,116,325,200,188,8,25,155,12,10,0,0,10,2,0,0,2,125,105,14,30,61,20,20,9,0,11,0,0,0,0,29335
9276,11,11,0,0,0,0,0,0,0,0,0,0,0,0,0,0,0,0,0,0,0,0,0,0,0,0,0,0,0,0,0,0,0,0,0,29338
9277,13619,4196,4897,2933,1200,393,1371,723,594,104,101,389,129,60,13,47,0,69,0,33,36,648,601,223,28,350,47,47,22,7,18,0,0,0,0,29340
9278,12929,2171,4625,3590,1778,765,879,555,457,77,86,294,98,97,97,0,0,1,0,0,1,324,283,67,97,119,41,41,41,0,0,0,0,0,0,29341
9279,134,53,52,23,0,6,0,0,0,0,0,0,0,0,0,0,0,0,0,0,0,0,0,0,0,0,0,0,0,0,0,0,0,0,0,29346
9280,19846,3283,6723,6159,2468,1213,1560,863,636,117,88,431,227,130,84,34,12,97,86,0,11,697,536,186,67,283,161,36,36,0,0,125,85,0,40,29349
9281,1027,268,219,315,210,15,78,35,15,0,0,15,20,20,0,20,0,0,0,0,0,43,43,43,0,0,0,0,0,0,0,0,0,0,0,29351
9282,2384,685,914,583,116,86,206,113,99,0,11,88,14,0,0,0,0,14,4,8,2,93,79,0,0,79,14,5,5,0,0,9,0,0,9,29353
9283,652,186,189,180,54,43,55,16,16,0,0,16,0,0,0,0,0,0,0,0,0,39,25,0,0,25,14,0,0,0,0,14,0,0,14,29355
9284,5440,880,1742,1396,859,563,448,253,222,38,25,159,31,26,18,8,0,5,0,5,0,195,188,36,4,148,7,0,0,0,0,7,0,7,0,29356
9285,14193,2839,5445,3700,1512,697,1073,606,491,121,114,256,115,76,11,31,34,39,10,9,20,467,352,25,0,327,115,55,7,16,32,60,0,0,60,29360
9286,437,101,187,145,0,4,14,9,9,0,0,9,0,0,0,0,0,0,0,0,0,5,5,0,0,5,0,0,0,0,0,0,0,0,0,29364
9287,6537,1176,2152,2023,973,213,560,415,359,73,12,274,56,48,0,48,0,8,0,8,0,145,125,32,0,93,20,10,10,0,0,10,0,10,0,29365
9288,16,0,16,0,0,0,0,0,0,0,0,0,0,0,0,0,0,0,0,0,0,0,0,0,0,0,0,0,0,0,0,0,0,0,0,29368
9289,9221,813,1957,3285,2051,1115,791,418,367,76,58,233,51,13,13,0,0,38,4,34,0,373,336,92,50,194,37,24,8,0,16,13,0,13,0,29369
9290,405,38,194,96,45,32,29,22,16,0,0,16,6,0,0,0,0,6,0,6,0,7,0,0,0,0,7,7,0,0,7,0,0,0,0,29370
9291,3233,769,1343,879,158,84,247,133,97,0,29,68,36,24,0,1,23,12,0,0,12,114,114,57,2,55,0,0,0,0,0,0,0,0,0,29372
9292,111,10,72,29,0,0,0,0,0,0,0,0,0,0,0,0,0,0,0,0,0,0,0,0,0,0,0,0,0,0,0,0,0,0,0,29373
9293,2177,292,629,832,268,156,84,59,54,0,10,44,5,0,0,0,0,5,0,0,5,25,23,23,0,0,2,2,2,0,0,0,0,0,0,29374
9294,70,13,48,9,0,0,6,6,6,0,0,6,0,0,0,0,0,0,0,0,0,0,0,0,0,0,0,0,0,0,0,0,0,0,0,29375
9295,4386,606,1376,1507,641,256,377,264,233,85,31,117,31,31,8,0,23,0,0,0,0,113,113,50,30,33,0,0,0,0,0,0,0,0,0,29376
9296,327,21,72,219,15,0,50,50,50,0,0,50,0,0,0,0,0,0,0,0,0,0,0,0,0,0,0,0,0,0,0,0,0,0,0,29377
9297,118,66,52,0,0,0,0,0,0,0,0,0,0,0,0,0,0,0,0,0,0,0,0,0,0,0,0,0,0,0,0,0,0,0,0,29378
9298,13586,2823,4999,3794,1379,591,1087,576,454,71,16,367,122,114,69,24,21,8,0,0,8,511,430,126,10,294,81,60,58,2,0,21,0,16,5,29379
9299,3319,597,1214,1124,335,49,331,142,90,0,10,80,52,0,0,0,0,52,0,52,0,189,164,45,0,119,25,25,25,0,0,0,0,0,0,29384
9300,5226,930,2104,1662,378,152,296,140,124,0,0,124,16,8,0,8,0,8,0,8,0,156,140,13,0,127,16,16,11,5,0,0,0,0,0,29385
9301,9700,2225,3519,2538,863,555,646,271,226,36,68,122,45,20,20,0,0,25,25,0,0,375,350,45,8,297,25,22,5,17,0,3,0,0,3,29388
9302,6134,190,324,1105,2543,1972,1574,414,406,41,26,339,8,8,8,0,0,0,0,0,0,1160,1160,155,121,884,0,0,0,0,0,0,0,0,0,29401
9303,12599,2130,2905,2840,3025,1699,1563,728,641,134,30,477,87,60,36,5,19,27,9,18,0,835,744,132,52,560,91,56,47,9,0,35,0,16,19,29403
9304,394,35,81,223,25,30,56,20,6,6,0,0,14,10,10,0,0,4,4,0,0,36,0,0,0,0,36,36,36,0,0,0,0,0,0,29404
9305,18509,5464,5743,5255,1509,538,1339,780,556,141,51,364,224,133,6,51,76,91,22,7,62,559,428,107,120,201,131,118,33,29,56,13,5,0,8,29405
9306,17957,4364,5567,5043,2228,755,1393,626,479,97,49,333,147,88,88,0,0,59,18,21,20,767,647,224,76,347,120,61,8,16,37,59,44,15,0,29406
9307,24613,1922,5598,7071,6409,3613,1609,704,616,145,61,410,88,39,27,12,0,49,12,37,0,905,807,172,34,601,98,98,52,46,0,0,0,0,0,29407
9308,51,0,5,4,9,33,970,884,884,35,0,849,0,0,0,0,0,0,0,0,0,86,86,0,10,76,0,0,0,0,0,0,0,0,0,29409
9309,12480,1687,3152,4524,2142,975,834,434,426,143,26,257,8,8,0,0,8,0,0,0,0,400,300,74,22,204,100,84,84,0,0,16,7,0,9,29410
9310,26722,1967,4609,7580,7713,4853,1290,771,714,118,250,346,57,30,10,0,20,27,0,27,0,519,482,174,23,285,37,23,0,11,12,14,0,0,14,29412
9311,24840,1186,4515,7813,7606,3720,1202,598,518,142,26,350,80,5,0,0,5,75,59,0,16,604,585,98,42,445,19,19,19,0,0,0,0,0,0,29414
9312,15497,2448,4937,5287,2224,601,946,514,431,67,12,352,83,28,14,14,0,55,8,34,13,432,310,54,0,256,122,84,60,0,24,38,0,0,38,29418
9313,14009,1593,3890,5060,2397,1069,1237,729,606,79,75,452,123,98,98,0,0,25,0,0,25,508,496,149,53,294,12,0,0,0,0,12,0,0,12,29420
9314,0,0,0,0,0,0,356,99,99,0,0,99,0,0,0,0,0,0,0,0,0,257,257,54,39,164,0,0,0,0,0,0,0,0,0,29423
9315,0,0,0,0,0,0,229,82,82,20,0,62,0,0,0,0,0,0,0,0,0,147,147,20,19,108,0,0,0,0,0,0,0,0,0,29424
9316,1216,330,518,238,111,19,38,18,18,0,0,18,0,0,0,0,0,0,0,0,0,20,12,0,0,12,8,0,0,0,0,8,0,0,8,29426
9317,2123,397,565,581,410,170,89,52,45,0,4,41,7,0,0,0,0,7,0,0,7,37,20,11,0,9,17,7,0,7,0,10,0,0,10,29429
9318,3959,858,1629,1147,196,129,437,125,125,11,29,85,0,0,0,0,0,0,0,0,0,312,230,95,0,135,82,69,0,69,0,13,13,0,0,29431
9319,2040,354,878,480,273,55,79,47,39,4,0,35,8,8,0,0,8,0,0,0,0,32,32,12,0,20,0,0,0,0,0,0,0,0,0,29432
9320,308,112,86,90,20,0,2,0,0,0,0,0,0,0,0,0,0,0,0,0,0,2,2,0,0,2,0,0,0,0,0,0,0,0,0,29434
9321,2578,523,987,845,132,91,257,123,96,48,1,47,27,1,1,0,0,26,2,0,24,134,107,21,2,84,27,5,4,1,0,22,0,0,22,29435
9322,2923,513,1329,717,192,172,224,191,100,0,0,100,91,51,10,41,0,40,40,0,0,33,22,0,0,22,11,0,0,0,0,11,0,11,0,29436
9323,1684,285,690,568,90,51,170,75,75,0,0,75,0,0,0,0,0,0,0,0,0,95,72,0,0,72,23,23,0,9,14,0,0,0,0,29437
9324,1999,135,447,486,484,447,42,20,12,0,12,0,8,8,8,0,0,0,0,0,0,22,22,0,0,22,0,0,0,0,0,0,0,0,0,29438
9325,2026,69,148,754,703,352,124,18,18,18,0,0,0,0,0,0,0,0,0,0,0,106,106,106,0,0,0,0,0,0,0,0,0,0,0,29439
9326,19344,3877,6937,5684,1650,1196,1327,747,608,62,83,463,139,68,68,0,0,71,0,50,21,580,575,91,16,468,5,5,0,0,5,0,0,0,0,29440
9327,33722,2893,10271,12864,5612,2082,3726,2285,1101,202,139,760,1184,1112,958,154,0,72,46,0,26,1441,1163,273,185,705,278,199,110,38,51,79,15,14,50,29445
9328,901,187,299,245,125,45,99,41,41,0,0,41,0,0,0,0,0,0,0,0,0,58,58,0,0,58,0,0,0,0,0,0,0,0,0,29446
9329,1497,282,705,338,86,86,101,68,49,0,13,36,19,7,0,7,0,12,0,12,0,33,33,0,0,33,0,0,0,0,0,0,0,0,0,29448
9330,5880,1093,1525,1814,856,592,345,155,144,44,30,70,11,0,0,0,0,11,0,0,11,190,165,5,8,152,25,25,6,19,0,0,0,0,0,29449
9331,1881,389,899,369,99,125,186,57,57,0,0,57,0,0,0,0,0,0,0,0,0,129,83,0,0,83,46,46,0,46,0,0,0,0,0,29450
9332,3103,32,271,765,1246,789,280,189,189,13,68,108,0,0,0,0,0,0,0,0,0,91,63,19,0,44,28,28,28,0,0,0,0,0,0,29451
9333,127,26,44,26,13,18,56,31,16,0,0,16,15,0,0,0,0,15,0,15,0,25,25,0,0,25,0,0,0,0,0,0,0,0,0,29452
9334,1019,204,528,206,76,5,109,52,50,0,36,14,2,2,0,2,0,0,0,0,0,57,57,6,51,0,0,0,0,0,0,0,0,0,0,29453
9335,15815,1994,3274,4122,3967,2458,862,392,287,84,0,203,105,72,72,0,0,33,13,20,0,470,420,196,43,181,50,50,0,0,50,0,0,0,0,29455
9336,18465,2295,5918,7069,2212,971,1672,792,649,63,69,517,143,50,21,0,29,93,0,93,0,880,716,94,37,585,164,128,53,75,0,36,0,0,36,29456
9337,1860,625,489,433,218,95,164,57,56,22,17,17,1,1,1,0,0,0,0,0,0,107,95,16,55,24,12,0,0,0,0,12,0,0,12,29458
9338,21306,3209,7394,7147,2483,1073,1507,777,574,120,24,430,203,119,91,11,17,84,15,0,69,730,634,222,39,373,96,69,26,24,19,27,27,0,0,29461
9339,31910,1287,4340,7824,11972,6487,1398,875,729,294,102,333,146,118,104,14,0,28,28,0,0,523,396,96,28,272,127,23,23,0,0,104,45,43,16,29464
9340,19535,663,2823,4895,6862,4292,1098,465,451,110,9,332,14,14,14,0,0,0,0,0,0,633,479,268,0,211,154,154,27,0,127,0,0,0,0,29466
9341,1231,402,502,176,66,85,41,41,41,0,0,41,0,0,0,0,0,0,0,0,0,0,0,0,0,0,0,0,0,0,0,0,0,0,0,29468
9342,458,94,27,173,97,67,17,17,17,17,0,0,0,0,0,0,0,0,0,0,0,0,0,0,0,0,0,0,0,0,0,0,0,0,0,29469
9343,2940,535,1071,947,273,114,158,33,33,0,0,33,0,0,0,0,0,0,0,0,0,125,104,18,37,49,21,21,21,0,0,0,0,0,0,29470
9344,1026,265,359,251,70,81,7,5,5,0,0,5,0,0,0,0,0,0,0,0,0,2,0,0,0,0,2,0,0,0,0,2,0,0,2,29471
9345,6868,1806,2732,1800,336,194,508,189,137,0,42,95,52,3,0,3,0,49,24,0,25,319,305,88,19,198,14,14,11,0,3,0,0,0,0,29472
9346,1747,413,601,433,232,68,115,52,44,0,0,44,8,0,0,0,0,8,0,8,0,63,45,0,0,45,18,0,0,0,0,18,0,0,18,29474
9347,1894,431,784,559,78,42,142,15,15,0,0,15,0,0,0,0,0,0,0,0,0,127,106,15,28,63,21,0,0,0,0,21,12,0,9,29475
9348,4691,910,1708,1375,495,203,217,142,127,0,2,125,15,15,0,15,0,0,0,0,0,75,75,14,0,61,0,0,0,0,0,0,0,0,0,29477
9349,5368,1067,2333,1246,381,341,386,294,203,22,10,171,91,63,18,0,45,28,0,0,28,92,89,14,44,31,3,3,0,0,3,0,0,0,0,29479
9350,1331,297,606,352,59,17,238,122,84,16,0,68,38,38,26,12,0,0,0,0,0,116,59,4,0,55,57,51,47,4,0,6,0,0,6,29481
9351,1462,35,43,288,585,511,49,22,17,4,5,8,5,5,5,0,0,0,0,0,0,27,27,0,0,27,0,0,0,0,0,0,0,0,0,29482
9352,42712,5321,12600,15074,5894,3823,3486,1829,1373,318,196,859,456,253,167,46,40,203,125,4,74,1657,1431,349,76,1006,226,206,124,60,22,20,0,6,14,29483
9353,31620,2174,8401,11961,5875,3209,2868,1563,1184,119,94,971,379,171,40,0,131,208,121,31,56,1305,1133,420,44,669,172,156,49,38,69,16,0,8,8,29485
9354,2186,433,413,533,430,377,165,65,65,0,0,65,0,0,0,0,0,0,0,0,0,100,100,37,0,63,0,0,0,0,0,0,0,0,0,29487
9355,14512,3062,4951,4312,1376,811,986,540,408,60,12,336,132,42,31,11,0,90,0,40,50,446,300,76,0,224,146,78,26,0,52,68,37,31,0,29488
9356,7214,268,928,1517,2661,1840,246,126,126,38,0,88,0,0,0,0,0,0,0,0,0,120,91,0,0,91,29,29,29,0,0,0,0,0,0,29492
9357,82,10,38,18,9,7,0,0,0,0,0,0,0,0,0,0,0,0,0,0,0,0,0,0,0,0,0,0,0,0,0,0,0,0,0,29493
9358,29246,3308,8141,8580,5699,3518,2189,1136,972,185,87,700,164,83,14,16,53,81,14,31,36,1053,958,205,38,715,95,81,9,19,53,14,0,0,14,29501
9359,17489,1856,5138,5587,3039,1869,1329,562,492,87,85,320,70,34,13,21,0,36,0,8,28,767,694,178,54,462,73,21,9,12,0,52,0,0,52,29505
9360,12738,2668,4862,3341,1143,724,1514,797,652,208,57,387,145,108,86,6,16,37,0,10,27,717,660,174,114,372,57,57,29,6,22,0,0,0,0,29506
9361,6775,1858,2637,1782,304,194,666,398,295,24,20,251,103,96,24,30,42,7,7,0,0,268,232,11,19,202,36,4,0,4,0,32,15,0,17,29510
9362,3278,563,1169,1019,360,167,170,78,27,0,3,24,51,51,29,11,11,0,0,0,0,92,90,25,13,52,2,2,0,0,2,0,0,0,0,29511
9363,13700,4407,5221,2859,736,477,769,356,256,37,58,161,100,62,40,11,11,38,10,0,28,413,353,0,106,247,60,45,8,10,27,15,0,0,15,29512
9364,609,184,304,92,27,2,46,46,46,0,0,46,0,0,0,0,0,0,0,0,0,0,0,0,0,0,0,0,0,0,0,0,0,0,0,29516
9365,909,171,411,153,105,69,48,48,48,0,0,48,0,0,0,0,0,0,0,0,0,0,0,0,0,0,0,0,0,0,0,0,0,0,0,29518
9366,252,89,120,39,0,4,0,0,0,0,0,0,0,0,0,0,0,0,0,0,0,0,0,0,0,0,0,0,0,0,0,0,0,0,0,29519
9367,10387,2340,3650,2675,1096,626,801,444,295,14,0,281,149,149,89,0,60,0,0,0,0,357,265,39,4,222,92,74,0,27,47,18,18,0,0,29520
9368,1144,282,578,172,72,40,149,75,75,0,13,62,0,0,0,0,0,0,0,0,0,74,69,0,9,60,5,2,0,2,0,3,0,0,3,29525
9369,25633,3932,8166,8669,2969,1897,2944,1500,1117,342,125,650,383,272,161,23,88,111,84,0,27,1444,1234,338,78,818,210,184,67,59,58,26,0,0,26,29526
9370,15466,3145,5843,4565,1356,557,1435,821,596,118,99,379,225,97,97,0,0,128,0,58,70,614,406,119,34,253,208,135,48,48,39,73,59,14,0,29527
9371,1589,538,635,386,10,20,74,13,13,0,0,13,0,0,0,0,0,0,0,0,0,61,61,2,0,59,0,0,0,0,0,0,0,0,0,29530
9372,13369,3089,5154,3138,1264,724,1334,652,544,60,42,442,108,92,6,0,86,16,0,0,16,682,571,30,117,424,111,85,43,24,18,26,0,0,26,29532
9373,11363,3843,4179,2486,485,370,1032,594,475,73,39,363,119,61,9,52,0,58,0,25,33,438,317,49,0,268,121,67,16,29,22,54,0,0,54,29536
9374,4081,1351,1622,678,315,115,336,134,126,29,31,66,8,8,8,0,0,0,0,0,0,202,147,14,7,126,55,43,0,34,9,12,0,3,9,29540
9375,5885,1226,2319,1609,542,189,335,190,175,0,32,143,15,0,0,0,0,15,0,0,15,145,125,56,0,69,20,20,0,0,20,0,0,0,0,29541
9376,514,156,126,98,112,22,0,0,0,0,0,0,0,0,0,0,0,0,0,0,0,0,0,0,0,0,0,0,0,0,0,0,0,0,0,29543
9377,3352,936,1140,857,275,144,390,202,55,16,0,39,147,21,0,4,17,126,26,32,68,188,106,23,0,83,82,40,27,13,0,42,28,0,14,29544
9378,1159,182,384,490,87,16,239,107,107,0,0,107,0,0,0,0,0,0,0,0,0,132,87,0,0,87,45,45,0,25,20,0,0,0,0,29545
9379,1891,353,815,432,152,139,138,98,76,37,0,39,22,22,0,20,2,0,0,0,0,40,26,15,0,11,14,14,14,0,0,0,0,0,0,29546
9380,1283,358,636,221,39,29,81,29,4,0,0,4,25,15,13,0,2,10,0,0,10,52,52,0,13,39,0,0,0,0,0,0,0,0,0,29547
9381,21584,3963,7531,5642,3296,1152,1821,1128,944,207,150,587,184,135,52,59,24,49,2,0,47,693,511,151,123,237,182,59,12,0,47,123,0,33,90,29550
9382,6248,1559,2703,1352,285,349,572,367,214,27,0,187,153,153,97,0,56,0,0,0,0,205,192,20,0,172,13,0,0,0,0,13,0,13,0,29554
9383,3960,818,1604,995,262,281,587,297,256,19,19,218,41,41,19,22,0,0,0,0,0,290,287,31,19,237,3,3,0,3,0,0,0,0,0,29555
9384,8053,1435,2934,2292,904,488,675,298,256,23,74,159,42,41,0,0,41,1,0,0,1,377,354,11,64,279,23,23,0,23,0,0,0,0,0,29556
9385,8683,2227,3160,2200,837,259,598,284,256,63,0,193,28,21,0,0,21,7,7,0,0,314,244,12,18,214,70,24,0,15,9,46,0,0,46,29560
9386,1639,313,752,423,117,34,119,64,49,0,0,49,15,7,4,0,3,8,8,0,0,55,55,0,0,55,0,0,0,0,0,0,0,0,0,29563
9387,516,141,189,124,54,8,18,18,15,0,0,15,3,3,0,0,3,0,0,0,0,0,0,0,0,0,0,0,0,0,0,0,0,0,0,29564
9388,4717,1063,2263,983,248,160,453,229,211,9,4,198,18,0,0,0,0,18,0,18,0,224,170,93,0,77,54,54,0,0,54,0,0,0,0,29565
9389,13090,1264,4360,4435,2254,777,427,229,202,0,14,188,27,27,27,0,0,0,0,0,0,198,178,54,8,116,20,9,0,0,9,11,0,0,11,29566
9390,370,121,177,57,12,3,64,54,54,2,0,52,0,0,0,0,0,0,0,0,0,10,9,0,0,9,1,1,0,1,0,0,0,0,0,29567
9391,9764,895,3790,3427,1330,322,409,323,223,38,66,119,100,91,56,35,0,9,0,9,0,86,34,25,2,7,52,52,52,0,0,0,0,0,0,29568
9392,10352,2366,3981,2873,734,398,861,292,219,30,39,150,73,39,39,0,0,34,34,0,0,569,393,147,43,203,176,111,95,0,16,65,0,24,41,29569
9393,2536,618,1195,553,112,58,216,101,89,33,23,33,12,12,0,2,10,0,0,0,0,115,101,23,0,78,14,3,3,0,0,11,0,0,11,29570
9394,10138,1503,4458,2696,980,501,915,494,430,35,62,333,64,42,9,25,8,22,0,0,22,421,373,88,67,218,48,27,11,0,16,21,7,14,0,29571
9395,6848,466,1495,2136,1777,974,129,79,79,40,0,39,0,0,0,0,0,0,0,0,0,50,50,35,0,15,0,0,0,0,0,0,0,0,0,29572
9396,8305,1748,3542,1949,738,328,678,301,144,43,0,101,157,46,46,0,0,111,34,49,28,377,372,53,9,310,5,0,0,0,0,5,5,0,0,29574
9397,12741,725,3903,4442,2450,1221,547,234,211,15,41,155,23,23,23,0,0,0,0,0,0,313,285,61,0,224,28,28,0,28,0,0,0,0,0,29575
9398,20962,1453,6394,6870,4175,2070,623,377,334,118,17,199,43,43,29,14,0,0,0,0,0,246,203,121,7,75,43,43,0,0,43,0,0,0,0,29576
9399,19115,3350,6119,5321,2701,1624,912,513,320,40,57,223,193,101,101,0,0,92,46,0,46,399,281,48,56,177,118,98,25,57,16,20,0,11,9,29577
9400,20880,1360,5336,7658,4815,1711,1652,900,824,278,143,403,76,76,0,76,0,0,0,0,0,752,637,283,17,337,115,90,11,0,79,25,25,0,0,29579
9401,973,262,438,151,69,53,45,0,0,0,0,0,0,0,0,0,0,0,0,0,0,45,45,0,0,45,0,0,0,0,0,0,0,0,0,29580
9402,3034,666,884,1006,341,137,219,91,80,3,0,77,11,11,3,0,8,0,0,0,0,128,101,36,5,60,27,19,12,0,7,8,0,0,8,29581
9403,12511,1031,3490,4063,2397,1530,487,224,202,62,28,112,22,22,22,0,0,0,0,0,0,263,222,135,0,87,41,41,0,41,0,0,0,0,0,29582
9404,3792,934,1577,854,275,152,282,139,122,33,13,76,17,17,17,0,0,0,0,0,0,143,123,35,30,58,20,20,18,2,0,0,0,0,0,29583
9405,1602,414,720,437,12,19,198,86,48,28,0,20,38,38,2,0,36,0,0,0,0,112,109,10,0,99,3,0,0,0,0,3,0,0,3,29584
9406,10665,546,2472,3217,2482,1948,649,364,364,186,0,178,0,0,0,0,0,0,0,0,0,285,281,104,0,177,4,4,4,0,0,0,0,0,0,29585
9407,25642,2639,8665,9324,3341,1673,1554,760,633,176,42,415,127,85,85,0,0,42,26,0,16,794,660,299,54,307,134,35,12,9,14,99,67,32,0,29588
9408,3208,888,1451,715,130,24,202,123,35,0,0,35,88,88,0,18,70,0,0,0,0,79,79,0,37,42,0,0,0,0,0,0,0,0,0,29590
9409,3661,1074,1269,977,187,154,259,130,116,31,12,73,14,14,0,13,1,0,0,0,0,129,93,23,9,61,36,9,0,9,0,27,13,14,0,29591
9410,699,150,232,277,40,0,0,0,0,0,0,0,0,0,0,0,0,0,0,0,0,0,0,0,0,0,0,0,0,0,0,0,0,0,0,29592
9411,1721,375,672,406,200,68,125,69,69,40,0,29,0,0,0,0,0,0,0,0,0,56,56,8,3,45,0,0,0,0,0,0,0,0,0,29593
9412,97,31,34,22,6,4,8,3,3,0,3,0,0,0,0,0,0,0,0,0,0,5,0,0,0,0,5,5,0,5,0,0,0,0,0,29594
9413,1750,475,698,396,123,58,103,60,60,10,0,50,0,0,0,0,0,0,0,0,0,43,43,10,0,33,0,0,0,0,0,0,0,0,0,29596
9414,8134,1975,2057,1699,1274,1129,534,202,124,20,11,93,78,19,10,0,9,59,0,0,59,332,201,37,9,155,131,121,86,26,9,10,0,0,10,29601
9415,22937,4206,6415,5718,4167,2431,1747,1025,861,158,70,633,164,128,103,0,25,36,13,7,16,722,554,178,50,326,168,118,58,51,9,50,0,0,50,29605
9416,24055,2514,5233,6509,6176,3623,1436,706,640,144,16,480,66,17,7,0,10,49,26,6,17,730,641,54,109,478,89,25,25,0,0,64,0,27,37,29607
9417,18751,3367,4016,4884,3956,2528,1517,756,627,176,64,387,129,40,26,14,0,89,38,19,32,761,634,257,59,318,127,86,22,41,23,41,27,5,9,29609
9418,18738,5571,6923,4450,1331,463,1449,726,550,20,72,458,176,100,73,14,13,76,41,23,12,723,413,89,46,278,310,181,34,37,110,129,0,22,107,29611
9419,40,0,0,14,15,11,796,333,333,80,0,253,0,0,0,0,0,0,0,0,0,463,463,124,9,330,0,0,0,0,0,0,0,0,0,29613
9420,200,2,5,22,113,58,1062,350,350,211,16,123,0,0,0,0,0,0,0,0,0,712,712,386,25,301,0,0,0,0,0,0,0,0,0,29614
9421,23857,1503,4113,6868,7599,3774,1331,716,655,117,86,452,61,34,17,17,0,27,0,0,27,615,605,145,18,442,10,0,0,0,0,10,10,0,0,29615
9422,16877,4062,5805,4153,1578,1279,1399,704,547,59,24,464,157,145,74,27,44,12,0,0,12,695,576,160,38,378,119,51,0,51,0,68,20,9,39,29617
9423,8859,2027,2833,2939,710,350,809,411,289,14,42,233,122,109,64,14,31,13,0,0,13,398,295,6,0,289,103,85,8,0,77,18,0,0,18,29620
9424,27116,3011,6829,8818,5296,3162,2406,1271,1151,147,186,818,120,50,10,9,31,70,0,36,34,1135,1012,307,41,664,123,68,21,0,47,55,17,33,5,29621
9425,9431,3254,3541,2158,367,111,668,369,231,36,7,188,138,14,14,0,0,124,6,99,19,299,263,14,9,240,36,13,0,0,13,23,0,0,23,29624
9426,18657,3241,6163,5842,2257,1154,1235,638,523,151,20,352,115,59,27,17,15,56,10,9,37,597,454,133,0,321,143,134,36,21,77,9,0,0,9,29625
9427,9651,2341,3377,2823,825,285,536,287,275,33,0,242,12,12,0,12,0,0,0,0,0,249,212,30,28,154,37,37,0,0,37,0,0,0,0,29626
9428,12045,2448,4356,3646,1028,567,1040,466,355,64,60,231,111,78,66,12,0,33,0,10,23,574,562,109,132,321,12,12,12,0,0,0,0,0,0,29627
9429,1825,532,687,461,103,42,134,112,106,0,60,46,6,0,0,0,0,6,0,0,6,22,22,0,4,18,0,0,0,0,0,0,0,0,0,29628
9430,7641,1089,1912,2018,1318,1304,921,526,420,103,58,259,106,71,45,0,26,35,31,4,0,395,372,159,32,181,23,23,23,0,0,0,0,0,0,29630
9431,6421,179,738,1414,1901,2189,693,360,341,63,40,238,19,19,19,0,0,0,0,0,0,333,333,61,14,258,0,0,0,0,0,0,0,0,0,29631
9432,6,0,0,6,0,0,4601,2276,2276,256,62,1958,0,0,0,0,0,0,0,0,0,2325,2325,439,74,1812,0,0,0,0,0,0,0,0,0,29634
9433,1024,235,254,228,157,150,71,15,15,0,15,0,0,0,0,0,0,0,0,0,0,56,56,8,48,0,0,0,0,0,0,0,0,0,0,29635
9434,2161,441,652,818,156,94,118,74,70,9,18,43,4,0,0,0,0,4,0,0,4,44,41,10,0,31,3,0,0,0,0,3,3,0,0,29638
9435,818,141,246,169,95,167,359,264,264,45,7,212,0,0,0,0,0,0,0,0,0,95,95,32,0,63,0,0,0,0,0,0,0,0,0,29639
9436,20969,4665,7267,6232,1993,812,1160,633,575,155,23,397,58,37,14,14,9,21,19,0,2,527,405,46,45,314,122,73,35,0,38,49,49,0,0,29640
9437,19659,2684,5315,6255,3492,1913,1315,596,474,96,67,311,122,67,12,37,18,55,37,18,0,719,671,130,87,454,48,21,14,7,0,27,10,11,6,29642
9438,2256,378,718,777,303,80,80,75,75,0,0,75,0,0,0,0,0,0,0,0,0,5,5,0,0,5,0,0,0,0,0,0,0,0,0,29643
9439,12389,1928,4160,4003,1436,862,1002,576,465,133,153,179,111,111,42,40,29,0,0,0,0,426,286,168,27,91,140,77,0,77,0,63,0,63,0,29644
9440,6294,1390,2351,1954,522,77,472,255,212,51,65,96,43,8,0,0,8,35,17,0,18,217,199,79,63,57,18,17,17,0,0,1,1,0,0,29645
9441,17942,4683,5777,4711,1893,878,1855,917,601,105,18,478,316,82,39,0,43,234,44,129,61,938,801,153,199,449,137,69,43,0,26,68,53,0,15,29646
9442,16820,1774,4227,5152,3918,1749,1609,685,633,101,137,395,52,10,5,0,5,42,0,13,29,924,825,189,105,531,99,41,41,0,0,58,20,27,11,29649
9443,23063,1615,4533,6266,6960,3689,1608,723,690,151,83,456,33,29,23,0,6,4,0,0,4,885,806,122,41,643,79,62,58,4,0,17,9,0,8,29650
9444,29861,5144,8820,8852,4927,2118,2064,1198,890,239,0,651,308,125,41,55,29,183,76,10,97,866,761,191,69,501,105,42,42,0,0,63,15,29,19,29651
9445,3515,930,1075,917,408,185,450,219,195,22,0,173,24,24,7,11,6,0,0,0,0,231,203,30,50,123,28,28,28,0,0,0,0,0,0,29653
9446,7202,1533,2471,2139,658,401,457,201,161,28,31,102,40,40,0,31,9,0,0,0,0,256,242,35,21,186,14,14,0,14,0,0,0,0,0,29654
9447,5105,1342,1860,1581,216,106,517,369,308,102,32,174,61,11,0,0,11,50,2,0,48,148,62,0,16,46,86,86,75,11,0,0,0,0,0,29655
9448,9739,2172,3159,2889,1044,475,947,389,276,45,10,221,113,65,17,48,0,48,0,36,12,558,435,94,139,202,123,74,20,19,35,49,21,0,28,29657
9449,226,22,127,65,12,0,16,16,16,0,0,16,0,0,0,0,0,0,0,0,0,0,0,0,0,0,0,0,0,0,0,0,0,0,0,29658
9450,83,23,41,19,0,0,8,0,0,0,0,0,0,0,0,0,0,0,0,0,0,8,8,0,0,8,0,0,0,0,0,0,0,0,0,29659
9451,3908,1257,1119,1131,321,80,262,156,129,23,0,106,27,0,0,0,0,27,0,0,27,106,80,15,5,60,26,0,0,0,0,26,26,0,0,29661
9452,10163,1056,2376,3657,2048,1026,733,263,232,50,0,182,31,31,18,0,13,0,0,0,0,470,363,80,13,270,107,107,65,13,29,0,0,0,0,29662
9453,1391,139,443,432,214,163,107,39,30,10,0,20,9,0,0,0,0,9,0,0,9,68,68,30,0,38,0,0,0,0,0,0,0,0,0,29664
9454,42,0,8,34,0,0,7,7,7,7,0,0,0,0,0,0,0,0,0,0,0,0,0,0,0,0,0,0,0,0,0,0,0,0,0,29665
9455,4808,744,1796,1502,543,223,280,104,85,36,3,46,19,19,19,0,0,0,0,0,0,176,110,23,4,83,66,11,0,6,5,55,45,0,10,29666
9456,172,58,60,48,2,4,11,5,3,0,3,0,2,2,0,2,0,0,0,0,0,6,6,6,0,0,0,0,0,0,0,0,0,0,0,29667
9457,8443,1544,3157,2712,732,298,590,240,201,74,35,92,39,0,0,0,0,39,32,7,0,350,339,57,60,222,11,11,0,0,11,0,0,0,0,29669
9458,6193,950,1814,1812,867,750,291,137,76,0,0,76,61,61,53,0,8,0,0,0,0,154,56,0,46,10,98,98,44,0,54,0,0,0,0,29670
9459,12217,2640,4205,3431,1221,720,748,414,340,64,0,276,74,43,8,35,0,31,0,4,27,334,312,96,20,196,22,3,0,3,0,19,0,10,9,29671
9460,8130,874,1916,2457,1581,1302,492,286,266,0,19,247,20,20,20,0,0,0,0,0,0,206,194,28,18,148,12,12,0,0,12,0,0,0,0,29672
9461,17328,2540,6095,5737,2134,822,1534,765,648,172,133,343,117,74,23,6,45,43,0,28,15,769,588,128,27,433,181,61,13,48,0,120,0,36,84,29673
9462,4538,275,1339,1347,954,623,89,80,71,11,0,60,9,9,9,0,0,0,0,0,0,9,9,0,0,9,0,0,0,0,0,0,0,0,0,29676
9463,15154,2619,5120,4357,1841,1217,1324,660,546,39,25,482,114,85,58,6,21,29,7,22,0,664,637,118,106,413,27,11,11,0,0,16,0,16,0,29678
9464,18598,1600,5215,6066,3833,1884,1539,832,713,77,92,544,119,82,59,6,17,37,0,14,23,707,493,80,61,352,214,165,110,14,41,49,27,22,0,29680
9465,32905,2286,6951,9062,9512,5094,2329,1159,1128,296,116,716,31,31,12,19,0,0,0,0,0,1170,1140,361,92,687,30,30,11,0,19,0,0,0,0,29681
9466,2745,470,797,996,314,168,229,127,99,38,10,51,28,28,0,28,0,0,0,0,0,102,93,31,14,48,9,9,9,0,0,0,0,0,0,29682
9467,225,181,0,0,27,17,0,0,0,0,0,0,0,0,0,0,0,0,0,0,0,0,0,0,0,0,0,0,0,0,0,0,0,0,0,29683
9468,3218,887,1260,857,175,39,162,63,50,0,27,23,13,13,10,3,0,0,0,0,0,99,97,24,0,73,2,2,2,0,0,0,0,0,0,29684
9469,855,97,237,142,191,188,65,40,36,0,0,36,4,0,0,0,0,4,0,0,4,25,9,9,0,0,16,0,0,0,0,16,0,0,16,29685
9470,733,108,305,178,131,11,96,64,34,0,0,34,30,0,0,0,0,30,0,30,0,32,9,0,0,9,23,0,0,0,0,23,23,0,0,29686
9471,29191,3987,8323,9581,4948,2352,1998,1096,923,167,61,695,173,127,50,0,77,46,37,0,9,902,709,161,49,499,193,112,102,0,10,81,17,0,64,29687
9472,3029,480,1083,938,371,157,258,186,131,52,0,79,55,40,26,14,0,15,0,15,0,72,42,26,0,16,30,30,0,0,30,0,0,0,0,29689
9473,12680,1951,3748,4180,1620,1181,1848,949,766,107,65,594,183,119,119,0,0,64,55,0,9,899,782,290,85,407,117,33,13,12,8,84,38,0,46,29690
9474,7478,1697,2710,2100,381,590,328,207,167,10,20,137,40,37,0,0,37,3,0,0,3,121,120,0,0,120,1,1,1,0,0,0,0,0,0,29691
9475,3200,768,1056,959,251,166,392,281,146,46,30,70,135,96,96,0,0,39,5,34,0,111,106,0,4,102,5,5,0,5,0,0,0,0,0,29692
9476,9994,2387,3954,2386,705,562,731,326,255,61,0,194,71,41,41,0,0,30,8,6,16,405,341,86,32,223,64,31,17,0,14,33,0,11,22,29693
9477,2853,438,944,723,614,134,136,79,49,6,0,43,30,30,0,30,0,0,0,0,0,57,57,25,12,20,0,0,0,0,0,0,0,0,0,29696
9478,8142,1430,2634,2691,1062,325,441,191,142,24,17,101,49,49,49,0,0,0,0,0,0,250,173,21,0,152,77,22,22,0,0,55,38,0,17,29697
9479,6675,1997,2364,1764,412,138,554,261,162,18,8,136,99,15,15,0,0,84,53,0,31,293,253,72,13,168,40,32,14,9,9,8,8,0,0,29702
9480,2764,533,1158,736,233,104,210,138,35,0,0,35,103,89,89,0,0,14,0,14,0,72,72,0,17,55,0,0,0,0,0,0,0,0,0,29704
9481,13412,2930,5304,3474,1168,536,940,476,365,35,63,267,111,96,34,62,0,15,0,9,6,464,386,133,42,211,78,54,54,0,0,24,0,0,24,29706
9482,14092,855,3409,4605,3613,1610,840,438,376,143,40,193,62,39,0,0,39,23,23,0,0,402,384,270,0,114,18,0,0,0,0,18,18,0,0,29707
9483,17466,674,2768,4833,6280,2911,1400,728,696,125,52,519,32,20,20,0,0,12,0,12,0,672,672,285,33,354,0,0,0,0,0,0,0,0,0,29708
9484,4318,1071,1571,1018,394,264,215,65,49,6,3,40,16,8,0,0,8,8,0,0,8,150,133,19,9,105,17,17,10,0,7,0,0,0,0,29709
9485,19686,2585,6153,5937,3599,1412,1503,719,524,113,53,358,195,88,43,29,16,107,36,13,58,784,749,197,9,543,35,23,23,0,0,12,12,0,0,29710
9486,1580,253,562,537,168,60,190,46,46,0,0,46,0,0,0,0,0,0,0,0,0,144,97,8,0,89,47,47,32,0,15,0,0,0,0,29712
9487,1774,405,742,462,125,40,187,117,86,0,19,67,31,27,0,27,0,4,0,4,0,70,58,0,0,58,12,2,2,0,0,10,10,0,0,29714
9488,16644,1559,3787,5608,4149,1541,1108,703,639,137,67,435,64,55,25,21,9,9,9,0,0,405,382,62,1,319,23,7,0,0,7,16,0,0,16,29715
9489,787,154,370,213,38,12,87,41,41,0,0,41,0,0,0,0,0,0,0,0,0,46,19,2,0,17,27,23,10,13,0,4,0,0,4,29717
9490,2447,607,800,787,157,96,158,76,66,6,8,52,10,7,0,0,7,3,0,0,3,82,74,2,0,72,8,7,0,0,7,1,1,0,0,29718
9491,30977,6623,11626,8514,2923,1291,2488,1206,1029,340,46,643,177,133,31,40,62,44,27,0,17,1282,1066,160,111,795,216,137,69,63,5,79,38,16,25,29720
9492,14,14,0,0,0,0,0,0,0,0,0,0,0,0,0,0,0,0,0,0,0,0,0,0,0,0,0,0,0,0,0,0,0,0,0,29724
9493,1383,354,357,494,116,62,94,70,59,3,55,1,11,11,11,0,0,0,0,0,0,24,24,12,3,9,0,0,0,0,0,0,0,0,0,29726
9494,964,249,421,199,68,27,109,23,23,0,0,23,0,0,0,0,0,0,0,0,0,86,60,14,8,38,26,26,26,0,0,0,0,0,0,29727
9495,6202,2036,2584,1137,308,137,839,459,353,95,38,220,106,53,22,8,23,53,0,4,49,380,374,54,43,277,6,0,0,0,0,6,0,0,6,29728
9496,1585,319,617,410,175,64,89,35,35,0,3,32,0,0,0,0,0,0,0,0,0,54,51,8,0,43,3,0,0,0,0,3,0,0,3,29729
9497,33525,5925,10767,10506,4227,2100,3049,1401,1121,248,83,790,280,159,78,49,32,121,26,60,35,1648,1451,252,140,1059,197,103,47,43,13,94,11,29,54,29730
9498,36739,3128,9078,12114,7880,4539,2772,1364,1171,232,23,916,193,106,106,0,0,87,33,0,54,1408,1054,259,85,710,354,252,63,62,127,102,37,13,52,29732
9499,12,0,0,1,11,0,1112,257,257,83,26,148,0,0,0,0,0,0,0,0,0,855,855,285,45,525,0,0,0,0,0,0,0,0,0,29733
9500,1616,288,869,280,116,63,37,18,11,0,0,11,7,7,0,0,7,0,0,0,0,19,19,11,0,8,0,0,0,0,0,0,0,0,0,29741
9501,1881,295,820,583,163,20,125,72,48,0,0,48,24,10,0,10,0,14,0,14,0,53,53,17,15,21,0,0,0,0,0,0,0,0,0,29742
9502,709,90,410,127,39,43,22,14,8,0,0,8,6,6,0,6,0,0,0,0,0,8,0,0,0,0,8,8,8,0,0,0,0,0,0,29743
9503,20091,3716,7052,5529,2571,1223,1448,838,722,187,78,457,116,90,26,64,0,26,0,21,5,610,537,127,14,396,73,44,34,10,0,29,9,0,20,29745
9504,17660,2971,6041,4862,2332,1454,1825,943,774,143,48,583,169,41,10,16,15,128,0,84,44,882,716,148,64,504,166,57,10,17,30,109,4,0,105,29801
9505,27134,1969,6386,7829,6417,4533,2027,973,726,191,93,442,247,206,128,42,36,41,0,41,0,1054,884,195,91,598,170,37,13,24,0,133,48,60,25,29803
9506,3964,917,1206,1126,475,240,257,103,92,23,0,69,11,11,11,0,0,0,0,0,0,154,104,11,0,93,50,50,12,26,12,0,0,0,0,29805
9507,1574,202,646,597,101,28,76,25,25,0,14,11,0,0,0,0,0,0,0,0,0,51,51,0,2,49,0,0,0,0,0,0,0,0,0,29809
9508,3190,841,1049,748,421,131,330,238,141,0,0,141,97,0,0,0,0,97,0,0,97,92,92,0,14,78,0,0,0,0,0,0,0,0,0,29810
9509,7201,1366,2840,2151,616,228,486,218,162,0,0,162,56,23,5,18,0,33,0,26,7,268,228,5,37,186,40,6,0,6,0,34,3,0,31,29812
9510,902,248,393,194,54,13,99,33,15,0,15,0,18,0,0,0,0,18,18,0,0,66,27,0,0,27,39,0,0,0,0,39,0,0,39,29816
9511,3807,832,1538,1073,261,103,315,154,144,5,45,94,10,0,0,0,0,10,10,0,0,161,143,45,13,85,18,0,0,0,0,18,0,18,0,29817
9512,946,297,332,221,88,8,68,28,14,0,0,14,14,0,0,0,0,14,0,14,0,40,35,15,0,20,5,0,0,0,0,5,0,0,5,29819
9513,844,205,283,170,59,127,14,14,14,0,0,14,0,0,0,0,0,0,0,0,0,0,0,0,0,0,0,0,0,0,0,0,0,0,0,29821
9514,6454,1328,2619,1798,511,198,315,164,88,12,9,67,76,32,32,0,0,44,44,0,0,151,125,0,18,107,26,26,26,0,0,0,0,0,0,29824
9515,79,28,31,12,3,5,6,4,4,0,0,4,0,0,0,0,0,0,0,0,0,2,2,0,0,2,0,0,0,0,0,0,0,0,0,29826
9516,3313,1011,1156,767,262,117,208,125,125,16,0,109,0,0,0,0,0,0,0,0,0,83,37,0,4,33,46,0,0,0,0,46,8,0,38,29827
9517,837,376,257,150,54,0,76,76,76,0,0,76,0,0,0,0,0,0,0,0,0,0,0,0,0,0,0,0,0,0,0,0,0,0,0,29828
9518,6147,1100,2318,1675,699,355,495,205,161,22,25,114,44,5,0,0,5,39,6,0,33,290,219,76,0,143,71,40,4,0,36,31,0,0,31,29829
9519,2564,402,1129,786,203,44,176,61,35,11,0,24,26,11,8,3,0,15,0,0,15,115,100,28,3,69,15,15,12,0,3,0,0,0,0,29831
9520,3866,1116,1654,582,202,312,395,203,118,15,0,103,85,19,9,0,10,66,0,0,66,192,181,7,15,159,11,5,0,5,0,6,0,6,0,29832
9521,941,306,349,241,45,0,134,54,54,24,8,22,0,0,0,0,0,0,0,0,0,80,75,15,40,20,5,0,0,0,0,5,0,0,5,29834
9522,5412,941,1378,1879,695,519,239,110,83,3,4,76,27,0,0,0,0,27,16,0,11,129,92,18,30,44,37,1,0,0,1,36,0,13,23,29835
9523,443,110,161,82,73,17,12,0,0,0,0,0,0,0,0,0,0,0,0,0,0,12,12,0,6,6,0,0,0,0,0,0,0,0,0,29836
9524,492,31,69,224,126,42,0,0,0,0,0,0,0,0,0,0,0,0,0,0,0,0,0,0,0,0,0,0,0,0,0,0,0,0,0,29838
9525,165,83,28,21,18,15,18,18,18,0,0,18,0,0,0,0,0,0,0,0,0,0,0,0,0,0,0,0,0,0,0,0,0,0,0,29840
9526,22343,2567,6849,7299,3617,2011,1390,654,531,8,63,460,123,70,31,0,39,53,0,13,40,736,678,137,26,515,58,0,0,0,0,58,0,0,58,29841
9527,5881,1219,2283,1824,288,267,534,400,311,65,19,227,89,9,9,0,0,80,0,0,80,134,92,23,0,69,42,21,21,0,0,21,0,0,21,29842
9528,1095,390,421,232,26,26,167,108,62,0,5,57,46,0,0,0,0,46,0,0,46,59,43,0,7,36,16,0,0,0,0,16,0,0,16,29843
9529,85,23,29,33,0,0,0,0,0,0,0,0,0,0,0,0,0,0,0,0,0,0,0,0,0,0,0,0,0,0,0,0,0,0,0,29844
9530,731,141,232,270,64,24,24,10,10,3,0,7,0,0,0,0,0,0,0,0,0,14,14,1,0,13,0,0,0,0,0,0,0,0,0,29845
9531,3311,631,1324,855,394,107,184,49,22,0,0,22,27,14,0,0,14,13,0,0,13,135,123,3,0,120,12,12,0,0,12,0,0,0,0,29847
9532,756,222,257,228,39,10,32,0,0,0,0,0,0,0,0,0,0,0,0,0,0,32,20,0,7,13,12,0,0,0,0,12,0,0,12,29848
9533,165,24,57,49,16,19,1,0,0,0,0,0,0,0,0,0,0,0,0,0,0,1,1,0,0,1,0,0,0,0,0,0,0,0,0,29849
9534,205,93,80,32,0,0,0,0,0,0,0,0,0,0,0,0,0,0,0,0,0,0,0,0,0,0,0,0,0,0,0,0,0,0,0,29850
9535,4600,1237,1654,1102,461,146,352,239,167,10,0,157,72,60,38,0,22,12,0,0,12,113,108,11,16,81,5,0,0,0,0,5,0,0,5,29851
9536,4148,992,1303,1303,377,173,547,367,335,14,0,321,32,32,0,0,32,0,0,0,0,180,145,0,0,145,35,20,0,0,20,15,0,15,0,29853
9537,2068,450,715,753,125,25,296,140,117,11,0,106,23,0,0,0,0,23,0,0,23,156,113,14,0,99,43,21,21,0,0,22,0,22,0,29856
9538,10051,1544,2704,2853,1943,1007,876,492,391,33,27,331,101,74,20,5,49,27,27,0,0,384,261,103,6,152,123,123,108,0,15,0,0,0,0,29860
9539,1093,360,501,222,10,0,5,5,0,0,0,0,5,0,0,0,0,5,0,0,5,0,0,0,0,0,0,0,0,0,0,0,0,0,0,29899
9540,9414,943,1980,2740,2192,1559,877,570,309,134,0,175,261,249,172,6,71,12,0,0,12,307,141,57,0,84,166,96,50,0,46,70,29,41,0,29902
9541,44,0,15,18,11,0,116,106,16,16,0,0,90,90,84,0,6,0,0,0,0,10,2,2,0,0,8,8,6,0,2,0,0,0,0,29904
9542,690,11,258,266,141,14,1837,1436,442,397,0,45,994,970,766,0,204,24,6,0,18,401,97,52,0,45,304,304,234,0,70,0,0,0,0,29905
9543,12017,1199,4037,4816,1258,707,1138,583,421,89,23,309,162,126,84,0,42,36,11,25,0,555,400,1,45,354,155,133,59,55,19,22,15,0,7,29906
9544,8448,603,1950,2730,1801,1364,378,235,198,64,13,121,37,37,16,21,0,0,0,0,0,143,135,28,12,95,8,8,8,0,0,0,0,0,0,29907
9545,15035,483,3443,4014,3844,3251,269,169,150,48,41,61,19,19,19,0,0,0,0,0,0,100,100,12,0,88,0,0,0,0,0,0,0,0,0,29909
9546,23167,2536,6172,7175,4916,2368,1660,756,638,227,0,411,118,65,37,25,3,53,53,0,0,904,735,169,152,414,169,132,73,13,46,37,0,0,37,29910
9547,1334,325,513,386,49,61,122,69,48,0,0,48,21,21,21,0,0,0,0,0,0,53,44,0,4,40,9,0,0,0,0,9,9,0,0,29911
9548,0,0,0,0,0,0,0,0,0,0,0,0,0,0,0,0,0,0,0,0,0,0,0,0,0,0,0,0,0,0,0,0,0,0,0,29912
9549,406,120,38,54,113,81,0,0,0,0,0,0,0,0,0,0,0,0,0,0,0,0,0,0,0,0,0,0,0,0,0,0,0,0,0,29915
9550,1107,240,423,316,115,13,41,3,3,0,0,3,0,0,0,0,0,0,0,0,0,38,38,0,0,38,0,0,0,0,0,0,0,0,0,29916
9551,3633,993,1463,805,188,184,310,104,104,0,42,62,0,0,0,0,0,0,0,0,0,206,192,27,10,155,14,4,4,0,0,10,10,0,0,29918
9552,6982,825,2047,1738,1132,1240,511,238,184,14,0,170,54,31,5,0,26,23,2,0,21,273,273,18,0,255,0,0,0,0,0,0,0,0,0,29920
9553,160,58,59,32,8,3,15,10,10,6,0,4,0,0,0,0,0,0,0,0,0,5,5,0,0,5,0,0,0,0,0,0,0,0,0,29921
9554,841,266,441,109,0,25,45,18,2,0,0,2,16,0,0,0,0,16,0,0,16,27,27,15,0,12,0,0,0,0,0,0,0,0,0,29922
9555,343,196,82,32,33,0,27,12,5,3,0,2,7,7,0,0,7,0,0,0,0,15,10,0,0,10,5,0,0,0,0,5,0,0,5,29923
9556,2616,474,916,773,271,182,282,178,90,5,6,79,88,49,22,0,27,39,0,0,39,104,78,28,27,23,26,26,0,0,26,0,0,0,0,29924
9557,18575,1582,3758,4942,5018,3275,882,366,350,147,87,116,16,16,5,0,11,0,0,0,0,516,416,81,59,276,100,69,69,0,0,31,0,31,0,29926
9558,4701,1068,1920,982,564,167,248,206,195,47,78,70,11,9,9,0,0,2,0,0,2,42,42,16,0,26,0,0,0,0,0,0,0,0,0,29927
9559,13623,754,1979,3289,4917,2684,399,222,211,117,7,87,11,11,11,0,0,0,0,0,0,177,166,63,13,90,11,11,11,0,0,0,0,0,0,29928
9560,709,82,300,200,124,3,16,8,8,3,5,0,0,0,0,0,0,0,0,0,0,8,8,0,0,8,0,0,0,0,0,0,0,0,0,29929
9561,141,22,64,45,10,0,6,3,3,0,2,1,0,0,0,0,0,0,0,0,0,3,3,0,0,3,0,0,0,0,0,0,0,0,0,29932
9562,821,200,468,153,0,0,58,52,0,0,0,0,52,52,52,0,0,0,0,0,0,6,6,0,0,6,0,0,0,0,0,0,0,0,0,29934
9563,2224,282,575,791,194,382,128,56,56,42,6,8,0,0,0,0,0,0,0,0,0,72,72,0,0,72,0,0,0,0,0,0,0,0,0,29935
9564,9526,1952,3758,2738,758,320,678,372,246,47,75,124,126,52,0,0,52,74,0,62,12,306,306,3,0,303,0,0,0,0,0,0,0,0,0,29936
9565,153,50,74,16,9,4,10,0,0,0,0,0,0,0,0,0,0,0,0,0,0,10,10,0,0,10,0,0,0,0,0,0,0,0,0,29939
9566,2757,542,1157,708,267,83,230,59,59,0,15,44,0,0,0,0,0,0,0,0,0,171,108,0,0,108,63,63,25,38,0,0,0,0,0,29940
9567,414,12,123,140,108,31,0,0,0,0,0,0,0,0,0,0,0,0,0,0,0,0,0,0,0,0,0,0,0,0,0,0,0,0,0,29941
9568,369,91,204,24,50,0,0,0,0,0,0,0,0,0,0,0,0,0,0,0,0,0,0,0,0,0,0,0,0,0,0,0,0,0,0,29943
9569,3714,734,1429,1054,348,149,295,170,99,0,0,99,71,49,43,6,0,22,0,10,12,125,92,20,15,57,33,33,22,11,0,0,0,0,0,29944
9570,2727,697,980,780,177,93,309,168,100,39,21,40,68,43,9,29,5,25,21,4,0,141,141,25,10,106,0,0,0,0,0,0,0,0,0,29945
9571,4337,512,610,1099,855,1261,58,28,28,0,0,28,0,0,0,0,0,0,0,0,0,30,30,10,0,20,0,0,0,0,0,0,0,0,0,30002
9572,35504,1118,4375,8482,14013,7516,2554,1175,1119,134,36,949,56,56,18,0,38,0,0,0,0,1379,1289,345,80,864,90,78,45,0,33,12,12,0,0,30004
9573,22734,761,2275,4850,9057,5791,2216,1427,1409,326,95,988,18,0,0,0,0,18,0,0,18,789,741,265,0,476,48,48,0,39,9,0,0,0,0,30005
9574,20208,4256,5237,6190,3330,1195,1937,1283,824,118,80,626,459,212,71,21,120,247,66,0,181,654,525,95,53,377,129,108,0,17,91,21,0,0,21,30008
9575,9844,554,1591,2847,3381,1471,875,413,302,116,9,177,111,108,94,14,0,3,0,0,3,462,448,126,0,322,14,5,0,5,0,9,0,0,9,30009
9576,9458,1227,3486,3086,1113,546,794,424,355,78,43,234,69,53,23,30,0,16,0,0,16,370,330,56,13,261,40,17,4,13,0,23,0,0,23,30011
9577,16980,3788,5714,4872,1665,941,1721,842,676,65,227,384,166,92,10,50,32,74,0,0,74,879,725,143,40,542,154,110,50,25,35,44,0,0,44,30012
9578,16194,1793,4367,5212,3267,1555,1537,902,741,34,160,547,161,100,23,6,71,61,0,14,47,635,554,34,43,477,81,53,11,13,29,28,0,28,0,30013
9579,23354,4722,8247,6029,2677,1679,2074,852,644,114,147,383,208,109,44,43,22,99,5,18,76,1222,993,204,267,522,229,154,46,40,68,75,23,31,21,30014
9580,30995,4299,9651,11351,3739,1955,3365,2010,1849,393,207,1249,161,86,50,13,23,75,19,24,32,1355,1199,342,89,768,156,90,51,39,0,66,0,31,35,30016
9581,13955,458,3256,4560,3688,1993,1204,708,681,104,69,508,27,27,27,0,0,0,0,0,0,496,440,119,20,301,56,29,2,0,27,27,0,0,27,30017
9582,25096,1881,5679,8036,6116,3384,2872,1279,1088,186,34,868,191,126,32,94,0,65,0,0,65,1593,1315,294,97,924,278,278,141,0,137,0,0,0,0,30019
9583,14441,4247,3906,3722,1741,825,1064,535,420,20,58,342,115,35,0,22,13,80,22,0,58,529,449,16,50,383,80,80,14,44,22,0,0,0,0,30021
9584,42506,1672,4880,9518,17114,9322,3919,1942,1829,203,247,1379,113,113,12,79,22,0,0,0,0,1977,1883,536,25,1322,94,29,12,17,0,65,65,0,0,30022
9585,41732,1910,6408,10061,15701,7652,3508,1937,1890,379,113,1398,47,28,28,0,0,19,0,0,19,1571,1486,247,77,1162,85,85,50,0,35,0,0,0,0,30024
9586,5809,785,2051,1802,837,334,358,230,181,48,21,112,49,23,7,7,9,26,0,0,26,128,83,0,0,83,45,39,39,0,0,6,6,0,0,30025
9587,13338,1323,3892,4231,2805,1087,1569,806,744,246,120,378,62,62,25,37,0,0,0,0,0,763,672,191,50,431,91,86,56,0,30,5,0,0,5,30028
9588,17967,825,1779,3155,5995,6213,1032,430,410,52,39,319,20,20,0,20,0,0,0,0,0,602,590,142,52,396,12,3,0,0,3,9,0,9,0,30030
9589,33059,6724,11462,9888,3547,1438,2347,1079,681,39,125,517,398,247,70,144,33,151,7,45,99,1268,910,117,209,584,358,169,58,98,13,189,23,85,81,30032
9590,20138,1346,2618,4360,5903,5911,1416,648,511,109,42,360,137,92,0,47,45,45,33,12,0,768,683,167,92,424,85,30,30,0,0,55,55,0,0,30033
9591,29346,2588,9397,10500,4565,2296,2761,1668,1508,94,282,1132,160,85,37,48,0,75,62,0,13,1093,991,57,164,770,102,74,14,0,60,28,0,0,28,30034
9592,13008,1832,3888,4442,1909,937,861,372,281,9,51,221,91,72,26,25,21,19,7,12,0,489,393,27,25,341,96,42,17,0,25,54,0,0,54,30035
9593,24657,1647,5161,9802,5970,2077,2873,1147,917,60,176,681,230,147,21,93,33,83,0,32,51,1726,1262,136,152,974,464,425,81,82,262,39,0,0,39,30038
9594,26310,1634,6603,10327,4659,3087,3000,1232,1042,153,157,732,190,129,1,16,112,61,0,61,0,1768,1594,168,175,1251,174,62,0,62,0,112,0,0,112,30039
9595,36687,3856,7980,10003,10480,4368,2995,1658,1321,250,52,1019,337,192,109,24,59,145,0,0,145,1337,1288,246,146,896,49,41,20,12,9,8,0,0,8,30040
9596,36079,2415,6858,10033,11754,5019,2545,1259,982,225,67,690,277,174,82,11,81,103,0,0,103,1286,1183,367,71,745,103,51,17,0,34,52,8,0,44,30041
9597,52163,5483,12474,15868,13226,5112,5706,3152,2741,542,173,2026,411,259,137,87,35,152,12,8,132,2554,2163,714,17,1432,391,214,23,82,109,177,11,0,166,30043
9598,51104,7900,13598,14176,10969,4461,4623,2706,2457,358,192,1907,249,141,92,0,49,108,48,32,28,1917,1673,324,116,1233,244,200,107,37,56,44,0,19,25,30044
9599,20162,2432,4084,6875,4928,1843,2325,1517,1278,421,50,807,239,47,20,27,0,192,67,22,103,808,690,98,79,513,118,56,47,0,9,62,0,0,62,30045
9600,21144,3914,6195,6400,3349,1286,1896,1069,877,120,27,730,192,70,50,0,20,122,31,41,50,827,717,119,22,576,110,110,56,31,23,0,0,0,0,30046
9601,40578,6265,8171,11491,9291,5360,3415,1938,1735,278,118,1339,203,82,55,18,9,121,46,10,65,1477,1216,219,95,902,261,132,21,1,110,129,6,11,112,30047
9602,36382,4301,10840,12379,6321,2541,3845,1900,1680,294,392,994,220,147,26,18,103,73,23,50,0,1945,1753,521,83,1149,192,172,33,139,0,20,0,0,20,30052
9603,7622,819,2419,2588,1262,534,1336,638,604,54,89,461,34,20,20,0,0,14,0,14,0,698,660,226,68,366,38,20,8,0,12,18,0,18,0,30054
9604,2070,284,893,558,194,141,124,79,76,9,0,67,3,3,3,0,0,0,0,0,0,45,42,20,0,22,3,3,2,0,1,0,0,0,0,30055
9605,1593,309,678,370,135,101,67,38,25,14,0,11,13,13,13,0,0,0,0,0,0,29,14,8,0,6,15,15,0,15,0,0,0,0,0,30056
9606,32272,3284,8719,11803,6015,2451,3961,2156,1532,199,178,1155,624,361,107,168,86,263,0,134,129,1805,1614,176,195,1243,191,179,8,126,45,12,0,0,12,30058
9607,21375,5842,6328,5455,2817,933,2600,1293,973,235,194,544,320,165,99,66,0,155,117,0,38,1307,1110,417,59,634,197,137,47,0,90,60,17,12,31,30060
9608,43365,2452,6337,11350,15298,7928,3056,1514,1423,247,90,1086,91,34,20,14,0,57,25,24,8,1542,1312,375,44,893,230,214,195,19,0,16,0,1,15,30062
9609,32322,2427,6178,8535,10077,5105,2131,950,909,187,101,621,41,41,41,0,0,0,0,0,0,1181,1072,209,99,764,109,90,90,0,0,19,0,0,19,30064
9610,35764,1841,6388,10310,11780,5445,2418,1235,1207,226,75,906,28,28,28,0,0,0,0,0,0,1183,1061,278,105,678,122,84,59,10,15,38,14,20,4,30066
9611,29428,2366,4826,8345,9273,4618,2419,1304,1007,162,42,803,297,223,54,62,107,74,9,55,10,1115,726,124,93,509,389,345,136,113,96,44,19,25,0,30067
9612,22102,457,2575,4680,8917,5473,2038,1134,1048,203,28,817,86,31,19,0,12,55,38,0,17,904,793,191,51,551,111,61,31,18,12,50,37,0,13,30068
9613,184,42,78,50,9,5,10,2,0,0,0,0,2,0,0,0,0,2,0,2,0,8,0,0,0,0,8,0,0,0,0,8,8,0,0,30070
9614,12748,4014,3386,2676,1793,879,1212,670,457,59,71,327,213,171,136,35,0,42,29,13,0,542,378,119,17,242,164,116,66,44,6,48,0,0,48,30071
9615,497,36,109,119,137,96,14,8,8,0,0,8,0,0,0,0,0,0,0,0,0,6,6,6,0,0,0,0,0,0,0,0,0,0,0,30072
9616,38183,1644,5059,8013,15161,8306,2773,1465,1353,295,30,1028,112,21,16,0,5,91,4,34,53,1308,1190,306,141,743,118,30,30,0,0,88,56,0,32,30075
9617,28299,3152,3880,6985,9127,5155,1695,757,662,103,51,508,95,15,0,0,15,80,24,29,27,938,808,215,33,560,130,130,84,15,31,0,0,0,0,30076
9618,22897,1526,5323,7534,5758,2756,2040,1002,752,119,76,557,250,201,136,10,55,49,0,39,10,1038,953,235,52,666,85,45,0,18,27,40,0,30,10,30078
9619,2111,247,635,574,364,291,135,53,53,0,5,48,0,0,0,0,0,0,0,0,0,82,34,26,0,8,48,48,0,48,0,0,0,0,0,30079
9620,37096,3883,5709,9184,11435,6885,1644,894,665,36,94,535,229,66,66,0,0,163,52,61,50,750,637,176,14,447,113,45,0,28,17,68,10,0,58,30080
9621,17195,1566,2869,4380,5217,3163,1093,477,438,26,70,342,39,39,0,39,0,0,0,0,0,616,417,110,0,307,199,138,0,61,77,61,0,46,15,30082
9622,32402,3572,8296,12266,5581,2687,2399,1352,1002,182,214,606,350,260,209,43,8,90,0,64,26,1047,785,143,97,545,262,262,66,128,68,0,0,0,0,30083
9623,24969,3460,5767,5923,5943,3876,1312,618,490,101,0,389,128,37,37,0,0,91,30,0,61,694,542,107,78,357,152,126,60,39,27,26,14,2,10,30084
9624,23677,1289,4361,7588,6420,4019,1969,731,704,216,30,458,27,27,0,11,16,0,0,0,0,1238,1203,201,177,825,35,12,11,1,0,23,12,10,1,30087
9625,17510,1377,4669,6685,3420,1359,1775,800,664,53,169,442,136,107,44,63,0,29,0,12,17,975,860,84,100,676,115,78,31,47,0,37,0,0,37,30088
9626,20767,1696,3026,5639,6805,3601,1876,1153,1019,210,52,757,134,103,30,63,10,31,21,10,0,723,646,89,52,505,77,77,39,25,13,0,0,0,0,30092
9627,33244,11580,8377,8514,3526,1247,2716,1352,927,201,15,711,425,192,131,12,49,233,147,28,58,1364,960,64,61,835,404,218,80,43,95,186,7,19,160,30093
9628,20530,1839,5528,6779,4328,2056,1606,837,728,78,132,518,109,31,0,31,0,78,0,0,78,769,687,150,40,497,82,66,27,0,39,16,0,0,16,30094
9629,43057,4234,10995,12505,10445,4878,2923,1270,1042,137,79,826,228,126,54,0,72,102,1,72,29,1653,1448,216,270,962,205,137,116,0,21,68,40,28,0,30096
9630,26432,978,2757,5692,10911,6094,2740,1257,1184,177,63,944,73,34,24,0,10,39,0,0,39,1483,1410,183,21,1206,73,73,41,0,32,0,0,0,0,30097
9631,34707,3090,8115,10431,8720,4351,3112,1534,1370,344,139,887,164,144,25,31,88,20,19,0,1,1578,1534,474,154,906,44,30,0,24,6,14,3,0,11,30101
9632,23440,3396,6025,7905,4278,1836,1912,1123,845,189,69,587,278,113,65,33,15,165,18,40,107,789,667,251,14,402,122,90,13,61,16,32,0,32,0,30102
9633,10580,2325,4179,2701,952,423,893,513,364,45,9,310,149,54,22,24,8,95,0,0,95,380,372,44,16,312,8,8,8,0,0,0,0,0,0,30103
9634,3033,852,987,861,257,76,163,112,87,62,0,25,25,12,12,0,0,13,0,0,13,51,51,3,6,42,0,0,0,0,0,0,0,0,0,30104
9635,1565,179,573,576,116,121,118,71,71,61,0,10,0,0,0,0,0,0,0,0,0,47,47,0,16,31,0,0,0,0,0,0,0,0,0,30105
9636,12990,1266,4788,3646,2216,1074,901,508,421,0,12,409,87,20,20,0,0,67,23,44,0,393,360,39,56,265,33,33,22,11,0,0,0,0,0,30106
9637,8726,1314,2724,2763,1312,613,558,273,260,112,6,142,13,13,13,0,0,0,0,0,0,285,232,74,10,148,53,53,3,16,34,0,0,0,0,30107
9638,4987,1213,2143,990,301,340,328,148,139,0,26,113,9,9,9,0,0,0,0,0,0,180,136,19,36,81,44,16,0,0,16,28,0,0,28,30108
9639,8316,1830,3001,2005,959,521,629,230,204,22,0,182,26,0,0,0,0,26,0,26,0,399,316,140,18,158,83,37,0,4,33,46,0,36,10,30110
9640,4188,1294,1504,833,275,282,404,288,268,106,49,113,20,15,0,9,6,5,0,0,5,116,108,31,0,77,8,8,0,0,8,0,0,0,0,30113
9641,32337,5566,8156,8669,6904,3042,2539,934,667,171,52,444,267,161,161,0,0,106,25,0,81,1605,1465,510,143,812,140,26,13,13,0,114,6,39,69,30114
9642,23824,2214,5804,7503,5811,2492,1785,773,642,226,75,341,131,131,48,83,0,0,0,0,0,1012,885,382,18,485,127,85,77,0,8,42,0,0,42,30115
9643,14665,2740,5249,3605,2025,1046,1418,798,658,87,14,557,140,87,0,38,49,53,19,0,34,620,539,177,18,344,81,19,8,11,0,62,0,20,42,30116
9644,20368,4499,6540,4904,2638,1787,1937,760,688,192,108,388,72,65,0,64,1,7,0,0,7,1177,1085,259,99,727,92,71,42,0,29,21,0,4,17,30117
9645,56,0,0,56,0,0,1862,965,965,326,81,558,0,0,0,0,0,0,0,0,0,897,897,180,165,552,0,0,0,0,0,0,0,0,0,30118
9646,23158,4659,8242,5821,2840,1596,1758,881,793,134,38,621,88,0,0,0,0,88,52,0,36,877,692,179,29,484,185,66,23,43,0,119,56,0,63,30120
9647,14258,2815,5309,3877,1256,1001,1427,810,419,48,36,335,391,165,109,0,56,226,64,97,65,617,426,206,11,209,191,45,19,26,0,146,0,0,146,30121
9648,14950,1806,5178,4446,2274,1246,1353,722,616,68,186,362,106,89,17,10,62,17,0,0,17,631,519,47,101,371,112,43,30,0,13,69,32,0,37,30122
9649,1917,255,582,615,275,190,270,116,95,17,3,75,21,21,0,0,21,0,0,0,0,154,128,13,28,87,26,26,20,6,0,0,0,0,0,30124
9650,15530,4599,5478,3446,1138,869,1521,932,627,17,90,520,305,87,45,29,13,218,143,33,42,589,475,38,48,389,114,80,0,67,13,34,34,0,0,30125
9651,26045,3205,5103,6027,7272,4438,1579,783,720,141,21,558,63,29,29,0,0,34,0,12,22,796,676,104,0,572,120,37,23,14,0,83,12,13,58,30126
9652,38031,3087,9484,12044,8980,4436,4310,2222,1918,187,170,1561,304,190,117,0,73,114,49,22,43,2088,1761,356,152,1253,327,269,101,79,89,58,0,20,38,30127
9653,20934,2756,7041,6076,3056,2005,1848,999,714,145,127,442,285,194,30,117,47,91,0,27,64,849,707,211,111,385,142,112,48,44,20,30,0,30,0,30132
9654,26674,4211,8956,8378,3433,1696,2798,1397,1030,51,186,793,367,244,140,40,64,123,25,58,40,1401,1229,278,145,806,172,165,79,25,61,7,0,0,7,30134
9655,39075,4084,11444,12944,6999,3604,3855,1825,1570,130,245,1195,255,222,124,70,28,33,12,0,21,2030,1728,514,19,1195,302,227,80,77,70,75,13,20,42,30135
9656,1312,318,606,227,117,44,83,30,30,0,0,30,0,0,0,0,0,0,0,0,0,53,53,18,16,19,0,0,0,0,0,0,0,0,0,30137
9657,2853,789,1026,715,205,118,171,73,63,19,0,44,10,7,7,0,0,3,0,0,3,98,95,1,0,94,3,0,0,0,0,3,0,0,3,30139
9658,13664,1652,5553,3674,1833,952,1332,896,816,254,106,456,80,53,18,27,8,27,0,10,17,436,408,126,62,220,28,15,12,0,3,13,0,0,13,30141
9659,15551,2797,4500,3901,2938,1415,852,484,462,59,30,373,22,18,15,0,3,4,0,0,4,368,281,118,52,111,87,31,25,6,0,56,0,37,19,30143
9660,30631,1583,6587,9995,8953,3513,4130,1949,1815,620,233,962,134,104,54,42,8,30,0,18,12,2181,2073,652,301,1120,108,96,66,30,0,12,12,0,0,30144
9661,5534,750,2645,1585,274,280,571,332,237,65,19,153,95,0,0,0,0,95,0,41,54,239,148,33,15,100,91,74,74,0,0,17,17,0,0,30145
9662,3635,1016,1508,926,114,71,98,28,8,0,8,0,20,12,0,12,0,8,0,0,8,70,26,17,0,9,44,20,12,0,8,24,0,0,24,30147
9663,313,39,175,89,10,0,0,0,0,0,0,0,0,0,0,0,0,0,0,0,0,0,0,0,0,0,0,0,0,0,0,0,0,0,0,30148
9664,15,1,0,1,9,4,727,88,88,79,5,4,0,0,0,0,0,0,0,0,0,639,639,526,17,96,0,0,0,0,0,0,0,0,0,30149
9665,26233,1559,5433,7789,8062,3390,3335,1651,1439,145,181,1113,212,212,178,16,18,0,0,0,0,1684,1602,388,133,1081,82,70,0,2,68,12,12,0,0,30152
9666,12101,2681,4895,2843,1043,639,828,444,306,54,0,252,138,103,8,95,0,35,0,26,9,384,341,15,33,293,43,40,0,0,40,3,0,3,0,30153
9667,28814,3359,10316,9079,3977,2083,2942,1708,1206,301,80,825,502,367,283,54,30,135,31,9,95,1234,1155,124,172,859,79,79,63,16,0,0,0,0,0,30157
9668,24223,5526,6764,6868,2740,2325,1747,943,702,127,72,503,241,46,0,46,0,195,0,83,112,804,596,89,69,438,208,140,15,13,112,68,0,19,49,30161
9669,0,0,0,0,0,0,0,0,0,0,0,0,0,0,0,0,0,0,0,0,0,0,0,0,0,0,0,0,0,0,0,0,0,0,0,30164
9670,25290,5686,8181,6904,2592,1927,2515,1146,999,234,131,634,147,27,18,9,0,120,77,18,25,1369,1266,354,43,869,103,70,34,36,0,33,0,33,0,30165
9671,14833,3181,4080,4624,2019,929,1321,678,451,137,84,230,227,94,57,0,37,133,64,63,6,643,483,103,49,331,160,86,73,0,13,74,14,32,28,30168
9672,2241,462,827,521,266,165,218,106,53,10,0,43,53,21,21,0,0,32,0,29,3,112,102,18,10,74,10,9,0,0,9,1,0,1,0,30170
9673,2479,284,1241,398,241,315,161,105,92,16,0,76,13,13,13,0,0,0,0,0,0,56,56,0,14,42,0,0,0,0,0,0,0,0,0,30171
9674,3815,767,1000,1362,270,416,271,159,125,16,13,96,34,34,34,0,0,0,0,0,0,112,112,19,0,93,0,0,0,0,0,0,0,0,0,30173
9675,4118,917,1485,1221,269,226,173,80,80,0,22,58,0,0,0,0,0,0,0,0,0,93,85,21,0,64,8,8,8,0,0,0,0,0,0,30175
9676,4671,1189,1804,1190,346,142,575,302,211,44,0,167,91,0,0,0,0,91,32,48,11,273,209,0,7,202,64,13,0,13,0,51,0,0,51,30176
9677,802,210,316,149,89,38,204,82,47,0,0,47,35,9,9,0,0,26,0,0,26,122,100,42,0,58,22,22,19,3,0,0,0,0,0,30177
9678,2318,275,1112,635,183,113,103,21,11,9,0,2,10,10,10,0,0,0,0,0,0,82,80,63,0,17,2,2,2,0,0,0,0,0,0,30178
9679,10973,2700,4402,2751,823,297,867,391,379,0,94,285,12,0,0,0,0,12,12,0,0,476,440,95,9,336,36,24,0,13,11,12,12,0,0,30179
9680,21575,3015,6839,6841,3172,1708,1756,872,613,48,110,455,259,94,63,13,18,165,76,51,38,884,789,137,74,578,95,83,70,0,13,12,0,0,12,30180
9681,2016,482,968,364,104,98,182,66,66,26,26,14,0,0,0,0,0,0,0,0,0,116,112,33,0,79,4,0,0,0,0,4,0,0,4,30182
9682,3531,488,1259,961,489,334,496,314,286,64,42,180,28,0,0,0,0,28,18,0,10,182,169,12,9,148,13,0,0,0,0,13,0,13,0,30183
9683,5187,626,1997,1748,407,409,338,152,145,13,28,104,7,0,0,0,0,7,0,5,2,186,119,30,0,89,67,19,19,0,0,48,0,0,48,30184
9684,2643,600,1209,568,152,114,308,228,121,20,0,101,107,79,37,0,42,28,0,25,3,80,30,14,0,16,50,23,0,0,23,27,0,0,27,30185
9685,6165,675,2620,1538,858,474,583,355,289,110,26,153,66,52,34,12,6,14,0,0,14,228,228,167,0,61,0,0,0,0,0,0,0,0,0,30187
9686,35789,2653,8192,10656,9886,4402,2229,1338,996,210,118,668,342,132,102,30,0,210,65,47,98,891,872,253,17,602,19,19,0,19,0,0,0,0,0,30188
9687,23286,1433,4619,7381,7703,2150,2293,1283,1102,189,82,831,181,170,121,10,39,11,0,11,0,1010,911,262,68,581,99,86,40,15,31,13,0,13,0,30189
9688,7908,1269,3221,2343,627,448,1418,705,638,30,159,449,67,52,0,45,7,15,5,0,10,713,643,36,91,516,70,53,0,0,53,17,17,0,0,30204
9689,1956,123,611,622,465,135,251,93,81,26,0,55,12,0,0,0,0,12,12,0,0,158,117,26,12,79,41,30,29,0,1,11,0,11,0,30205
9690,1882,399,734,521,139,89,157,90,73,0,7,66,17,17,14,3,0,0,0,0,0,67,58,9,0,49,9,0,0,0,0,9,9,0,0,30206
9691,18160,2376,4614,6581,2663,1926,1633,911,828,159,125,544,83,71,2,14,55,12,0,12,0,722,608,77,48,483,114,49,0,49,0,65,27,38,0,30213
9692,20329,1806,5224,6511,4408,2380,1983,962,851,255,56,540,111,55,28,27,0,56,10,10,36,1021,981,197,75,709,40,34,27,0,7,6,0,0,6,30214
9693,21145,851,4874,6403,6106,2911,2061,1078,932,219,78,635,146,62,20,15,27,84,19,0,65,983,866,240,55,571,117,43,14,19,10,74,7,51,16,30215
9694,1481,314,804,212,69,82,54,17,13,0,0,13,4,4,0,0,4,0,0,0,0,37,36,1,0,35,1,1,0,0,1,0,0,0,0,30216
9695,6145,1682,2369,1587,316,191,602,276,204,8,11,185,72,50,18,21,11,22,0,22,0,326,257,45,3,209,69,46,46,0,0,23,0,2,21,30217
9696,1452,301,628,368,97,58,120,87,85,0,0,85,2,2,0,2,0,0,0,0,0,33,15,0,0,15,18,14,0,0,14,4,0,0,4,30218
9697,3143,525,1219,881,395,123,300,156,141,25,28,88,15,10,2,3,5,5,0,0,5,144,70,7,3,60,74,51,22,13,16,23,0,0,23,30220
9698,3420,1187,1204,771,197,61,242,89,70,5,14,51,19,0,0,0,0,19,0,8,11,153,86,0,0,86,67,42,22,10,10,25,0,9,16,30222
9699,23364,6315,8695,5867,1714,773,1874,973,717,156,35,526,256,104,46,50,8,152,9,129,14,901,718,172,122,424,183,115,7,70,38,68,0,36,32,30223
9700,17053,3139,5524,4735,2122,1533,1176,454,383,119,27,237,71,27,0,27,0,44,0,14,30,722,656,69,44,543,66,19,0,19,0,47,0,0,47,30224
9701,22311,2750,6731,7647,3205,1978,2126,1369,1146,92,73,981,223,95,20,36,39,128,59,1,68,757,658,251,80,327,99,50,18,32,0,49,36,13,0,30228
9702,5919,1478,2232,1542,485,182,396,193,190,21,38,131,3,3,3,0,0,0,0,0,0,203,114,87,0,27,89,41,0,0,41,48,15,8,25,30230
9703,15944,4264,6580,3685,800,615,1149,657,494,62,79,353,163,97,54,11,32,66,20,15,31,492,426,52,0,374,66,58,0,46,12,8,0,0,8,30233
9704,1192,204,646,255,42,45,149,122,122,0,0,122,0,0,0,0,0,0,0,0,0,27,23,15,0,8,4,4,4,0,0,0,0,0,0,30234
9705,27662,4857,8127,8449,4208,2021,2273,1184,877,24,108,745,307,173,85,18,70,134,0,38,96,1089,818,91,146,581,271,150,20,92,38,121,29,13,79,30236
9706,21259,3306,7493,7092,2388,980,3047,1367,971,68,220,683,396,336,130,187,19,60,3,0,57,1680,1288,93,94,1101,392,217,116,36,65,175,18,8,149,30238
9707,18539,2741,5830,5437,2702,1829,1805,837,743,104,148,491,94,59,41,18,0,35,0,0,35,968,903,231,114,558,65,65,31,31,3,0,0,0,0,30240
9708,14714,3148,5363,3819,1521,863,1593,879,563,72,46,445,316,93,35,39,19,223,19,70,134,714,624,49,25,550,90,32,14,18,0,58,0,29,29,30241
9709,14725,1800,5514,4057,2694,660,1199,628,401,70,0,331,227,161,161,0,0,66,49,17,0,571,500,31,107,362,71,71,34,26,11,0,0,0,0,30248
9710,641,235,198,180,10,18,122,103,17,0,0,17,86,10,0,0,10,76,0,0,76,19,10,0,0,10,9,0,0,0,0,9,0,0,9,30250
9711,1777,597,760,319,79,22,84,50,45,31,0,14,5,5,5,0,0,0,0,0,0,34,30,7,0,23,4,4,0,4,0,0,0,0,0,30251
9712,26631,2115,8295,9228,4627,2366,3076,1855,1501,172,151,1178,354,239,119,57,63,115,0,72,43,1221,1070,304,19,747,151,151,45,14,92,0,0,0,0,30252
9713,32140,3082,9328,10476,6144,3110,3574,1638,1375,153,68,1154,263,220,33,99,88,43,0,20,23,1936,1728,415,134,1179,208,168,108,0,60,40,0,0,40,30253
9714,1658,152,700,539,163,104,168,61,53,18,9,26,8,8,0,0,8,0,0,0,0,107,84,15,0,69,23,1,1,0,0,22,0,0,22,30256
9715,3060,644,1007,913,278,218,154,60,38,8,7,23,22,11,11,0,0,11,0,0,11,94,90,24,29,37,4,4,4,0,0,0,0,0,0,30257
9716,1859,299,842,490,118,110,126,96,71,20,5,46,25,9,9,0,0,16,0,16,0,30,30,5,10,15,0,0,0,0,0,0,0,0,0,30258
9717,2087,363,694,643,208,179,124,76,38,0,1,37,38,7,4,0,3,31,31,0,0,48,46,28,8,10,2,0,0,0,0,2,0,2,0,30259
9718,16783,3857,5393,4655,2121,757,1878,997,837,150,108,579,160,118,56,16,46,42,0,27,15,881,794,85,179,530,87,87,38,0,49,0,0,0,0,30260
9719,34619,5719,13334,8390,4345,2831,2548,1366,1033,279,17,737,333,252,160,11,81,81,15,17,49,1182,911,121,49,741,271,144,77,56,11,127,54,0,73,30263
9720,20724,1476,5235,6377,5063,2573,1670,835,818,85,207,526,17,17,17,0,0,0,0,0,0,835,762,186,89,487,73,73,40,9,24,0,0,0,0,30265
9721,6045,1079,2073,1866,764,263,528,270,213,8,0,205,57,57,15,28,14,0,0,0,0,258,258,24,91,143,0,0,0,0,0,0,0,0,0,30268
9722,23047,1012,3567,6390,7692,4386,2260,1151,1074,190,142,742,77,24,0,10,14,53,20,0,33,1109,1053,377,17,659,56,0,0,0,0,56,0,0,56,30269
9723,8563,882,2465,3193,1559,464,744,443,337,92,72,173,106,11,0,0,11,95,0,0,95,301,285,73,0,212,16,16,16,0,0,0,0,0,0,30273
9724,21197,3865,6480,7338,2464,1050,1531,776,635,100,65,470,141,67,58,9,0,74,38,17,19,755,626,47,73,506,129,129,5,61,63,0,0,0,0,30274
9725,0,0,0,0,0,0,0,0,0,0,0,0,0,0,0,0,0,0,0,0,0,0,0,0,0,0,0,0,0,0,0,0,0,0,0,30275
9726,9493,920,2987,3191,1688,707,724,353,271,71,41,159,82,82,82,0,0,0,0,0,0,371,350,118,27,205,21,21,21,0,0,0,0,0,0,30276
9727,14272,1256,4072,4322,3156,1466,1499,708,565,102,72,391,143,110,78,32,0,33,0,19,14,791,722,168,75,479,69,45,2,43,0,24,24,0,0,30277
9728,42210,5204,12727,13877,7220,3182,3862,1851,1617,202,82,1333,234,186,95,45,46,48,26,21,1,2011,1820,234,87,1499,191,127,84,7,36,64,0,9,55,30281
9729,43,1,21,2,11,8,0,0,0,0,0,0,0,0,0,0,0,0,0,0,0,0,0,0,0,0,0,0,0,0,0,0,0,0,0,30284
9730,338,35,151,136,8,8,54,54,0,0,0,0,54,54,27,0,27,0,0,0,0,0,0,0,0,0,0,0,0,0,0,0,0,0,0,30285
9731,15975,3750,5788,4563,993,881,1364,671,517,123,0,394,154,68,10,31,27,86,17,0,69,693,569,78,66,425,124,67,22,29,16,57,0,0,57,30286
9732,6587,834,2407,2337,596,413,513,127,127,0,99,28,0,0,0,0,0,0,0,0,0,386,325,27,61,237,61,33,32,1,0,28,0,0,28,30288
9733,38,7,9,11,0,11,0,0,0,0,0,0,0,0,0,0,0,0,0,0,0,0,0,0,0,0,0,0,0,0,0,0,0,0,0,30289
9734,5618,391,1095,1793,1396,943,510,305,288,63,10,215,17,17,17,0,0,0,0,0,0,205,205,73,0,132,0,0,0,0,0,0,0,0,0,30290
9735,12978,2017,3620,4337,2284,720,1494,705,555,23,105,427,150,46,18,0,28,104,10,0,94,789,698,0,84,614,91,59,0,34,25,32,0,0,32,30291
9736,4072,585,1608,1258,396,225,460,246,169,45,12,112,77,44,26,0,18,33,0,6,27,214,183,34,39,110,31,31,0,16,15,0,0,0,0,30292
9737,1777,373,935,342,107,20,170,81,62,11,0,51,19,16,0,16,0,3,3,0,0,89,89,14,0,75,0,0,0,0,0,0,0,0,0,30293
9738,23669,2467,6304,8337,4642,1919,2762,1344,1060,96,138,826,284,234,13,151,70,50,0,0,50,1418,1253,158,75,1020,165,102,11,65,26,63,0,0,63,30294
9739,2984,441,931,1185,248,179,215,110,76,13,0,63,34,34,8,0,26,0,0,0,0,105,86,39,0,47,19,19,5,0,14,0,0,0,0,30295
9740,16496,2130,4341,6226,2460,1339,1645,797,639,47,69,523,158,63,12,15,36,95,33,7,55,848,758,154,88,516,90,47,35,0,12,43,0,0,43,30296
9741,16235,5519,6010,3571,815,320,1568,938,718,39,179,500,220,111,48,47,16,109,62,0,47,630,453,7,91,355,177,157,52,105,0,20,0,0,20,30297
9742,2242,584,478,551,440,189,1044,446,439,76,0,363,7,0,0,0,0,7,0,0,7,598,598,91,43,464,0,0,0,0,0,0,0,0,0,30303
9743,16503,375,977,2201,8054,4896,487,239,137,0,0,137,102,5,5,0,0,97,0,97,0,248,226,17,0,209,22,22,0,0,22,0,0,0,0,30305
9744,16052,414,1032,2383,5929,6294,537,305,240,58,13,169,65,65,0,0,65,0,0,0,0,232,216,6,0,210,16,2,0,2,0,14,0,0,14,30306
9745,12930,377,973,2215,4490,4875,597,386,358,80,0,278,28,5,0,0,5,23,9,0,14,211,180,46,2,132,31,31,5,26,0,0,0,0,0,30307
9746,11876,770,1404,2238,4296,3168,587,264,264,37,0,227,0,0,0,0,0,0,0,0,0,323,283,77,51,155,40,40,10,30,0,0,0,0,0,30308
9747,16876,504,1123,2606,6955,5688,487,133,133,10,12,111,0,0,0,0,0,0,0,0,0,354,269,112,0,157,85,85,85,0,0,0,0,0,0,30309
9748,18021,4571,5968,4520,2016,946,1635,893,731,99,105,527,162,37,8,4,25,125,16,37,72,742,612,63,128,421,130,52,22,10,20,78,0,34,44,30310
9749,23648,4177,8087,6254,2943,2187,1760,807,658,53,136,469,149,99,28,39,32,50,0,50,0,953,681,20,107,554,272,108,38,70,0,164,0,17,147,30311
9750,13953,1529,2253,3060,4572,2539,465,190,181,10,19,152,9,0,0,0,0,9,0,0,9,275,219,19,64,136,56,56,29,27,0,0,0,0,0,30312
9751,3149,209,697,750,986,507,2921,1920,1920,300,97,1523,0,0,0,0,0,0,0,0,0,1001,1001,188,71,742,0,0,0,0,0,0,0,0,0,30313
9752,11193,2376,3466,3008,1443,900,3978,1609,1513,324,68,1121,96,10,8,0,2,86,0,0,86,2369,2231,485,208,1538,138,47,7,17,23,91,0,8,83,30314
9753,21185,5441,7497,4659,2297,1291,1958,798,574,21,53,500,224,168,0,96,72,56,0,0,56,1160,925,113,101,711,235,92,31,1,60,143,0,21,122,30315
9754,22524,3335,6053,5066,4670,3400,1099,437,433,55,27,351,4,4,0,0,4,0,0,0,0,662,572,34,29,509,90,27,27,0,0,63,0,0,63,30316
9755,8525,1029,1810,1772,2467,1447,436,221,163,37,0,126,58,25,20,0,5,33,0,0,33,215,180,45,0,135,35,16,0,3,13,19,0,19,0,30317
9756,32981,4852,7786,6369,8439,5535,2958,1794,1420,303,217,900,374,188,34,99,55,186,0,29,157,1164,834,117,100,617,330,266,91,62,113,64,0,38,26,30318
9757,28046,1623,3204,4212,11716,7291,1149,619,567,29,30,508,52,37,10,27,0,15,15,0,0,530,484,145,24,315,46,46,28,0,18,0,0,0,0,30319
9758,64,0,0,0,27,37,1284,610,610,152,0,458,0,0,0,0,0,0,0,0,0,674,665,170,38,457,9,9,0,9,0,0,0,0,0,30322
9759,20112,1164,2493,3950,7409,5096,463,239,233,33,20,180,6,0,0,0,0,6,6,0,0,224,224,37,42,145,0,0,0,0,0,0,0,0,0,30324
9760,3874,59,206,795,1727,1087,146,51,8,0,0,8,43,0,0,0,0,43,0,0,43,95,95,0,0,95,0,0,0,0,0,0,0,0,0,30326
9761,15702,117,934,2008,6746,5897,1130,502,463,50,24,389,39,16,16,0,0,23,0,0,23,628,578,34,0,544,50,50,0,0,50,0,0,0,0,30327
9762,23562,608,2720,4702,9226,6306,885,422,409,165,27,217,13,13,13,0,0,0,0,0,0,463,322,100,0,222,141,37,24,0,13,104,40,64,0,30328
9763,17755,2942,3094,3215,4283,4221,721,352,208,11,0,197,144,69,36,33,0,75,30,45,0,369,257,77,0,180,112,112,60,29,23,0,0,0,0,30329
9764,37054,3941,9608,11464,7445,4596,3537,1798,1361,142,184,1035,437,281,75,123,83,156,0,34,122,1739,1575,271,257,1047,164,110,64,19,27,54,0,0,54,30331
9765,56,0,0,14,34,8,1579,892,892,125,69,698,0,0,0,0,0,0,0,0,0,687,687,88,22,577,0,0,0,0,0,0,0,0,0,30332
9766,0,0,0,0,0,0,0,0,0,0,0,0,0,0,0,0,0,0,0,0,0,0,0,0,0,0,0,0,0,0,0,0,0,0,0,30334
9767,458,38,111,120,105,84,79,38,37,0,0,37,1,1,0,0,1,0,0,0,0,41,41,40,0,1,0,0,0,0,0,0,0,0,0,30336
9768,7187,1172,2354,2033,952,676,813,494,388,110,52,226,106,59,0,34,25,47,20,0,27,319,277,0,48,229,42,0,0,0,0,42,20,0,22,30337
9769,23226,907,2426,3702,9141,7050,1132,679,518,81,11,426,161,130,65,1,64,31,0,0,31,453,448,90,19,339,5,5,0,0,5,0,0,0,0,30338
9770,14316,409,1275,2637,6346,3649,478,165,64,5,0,59,101,101,86,0,15,0,0,0,0,313,219,19,0,200,94,54,11,0,43,40,0,0,40,30339
9771,19797,6002,4557,3823,3324,2091,1809,1072,881,301,120,460,191,145,93,46,6,46,46,0,0,737,631,133,0,498,106,49,49,0,0,57,0,14,43,30340
9772,21239,3968,3440,4269,5901,3661,1178,643,362,106,15,241,281,0,0,0,0,281,179,68,34,535,407,92,40,275,128,92,0,35,57,36,11,0,25,30341
9773,21286,2420,2884,3612,8126,4244,1373,784,639,103,32,504,145,0,0,0,0,145,130,0,15,589,552,63,50,439,37,37,0,0,37,0,0,0,0,30342
9774,20680,3744,5625,6057,3629,1625,2241,868,769,81,55,633,99,58,20,26,12,41,30,4,7,1373,1225,155,208,862,148,64,0,16,48,84,0,0,84,30344
9775,16528,1947,2425,3350,4494,4312,843,382,319,108,48,163,63,47,38,9,0,16,0,16,0,461,427,27,39,361,34,16,14,0,2,18,0,0,18,30345
9776,4296,93,196,846,2256,905,24,24,24,0,0,24,0,0,0,0,0,0,0,0,0,0,0,0,0,0,0,0,0,0,0,0,0,0,0,30346
9777,42028,4117,11545,14307,7393,4666,4011,1786,1437,144,164,1129,349,255,102,73,80,94,0,24,70,2225,1796,351,178,1267,429,255,87,86,82,174,0,76,98,30349
9778,23277,1410,3490,6651,7462,4264,1240,612,546,98,157,291,66,36,30,0,6,30,0,30,0,628,613,65,7,541,15,15,15,0,0,0,0,0,0,30350
9779,10145,2306,3419,2944,1014,462,1191,653,487,0,14,473,166,53,30,0,23,113,17,84,12,538,460,76,31,353,78,59,0,14,45,19,0,0,19,30354
9780,10062,2171,1934,2040,2299,1618,564,307,171,21,9,141,136,30,30,0,0,106,67,0,39,257,211,44,29,138,46,32,32,0,0,14,0,14,0,30360
9781,1812,108,128,439,738,399,79,60,60,0,0,60,0,0,0,0,0,0,0,0,0,19,19,0,9,10,0,0,0,0,0,0,0,0,0,30363
9782,8447,2113,3118,2167,626,423,826,380,212,41,9,162,168,88,0,24,64,80,0,64,16,446,375,94,28,253,71,71,21,16,34,0,0,0,0,30401
9783,1351,247,550,321,104,129,79,40,40,0,0,40,0,0,0,0,0,0,0,0,0,39,21,9,0,12,18,18,0,0,18,0,0,0,0,30410
9784,4099,1089,2263,416,234,97,110,105,8,0,0,8,97,41,0,0,41,56,0,0,56,5,5,0,0,5,0,0,0,0,0,0,0,0,0,30411
9785,47,6,23,14,0,4,3,3,0,0,0,0,3,3,0,0,3,0,0,0,0,0,0,0,0,0,0,0,0,0,0,0,0,0,0,30412
9786,1175,344,432,290,89,20,77,26,26,0,0,26,0,0,0,0,0,0,0,0,0,51,39,5,0,34,12,12,0,12,0,0,0,0,0,30413
9787,5117,728,1995,1190,845,359,605,331,215,55,13,147,116,79,4,57,18,37,0,0,37,274,215,0,32,183,59,59,19,40,0,0,0,0,0,30415
9788,7079,1509,2876,1707,622,365,511,381,311,73,8,230,70,28,5,23,0,42,16,0,26,130,110,4,0,106,20,11,11,0,0,9,0,0,9,30417
9789,778,154,334,196,79,15,68,31,31,8,0,23,0,0,0,0,0,0,0,0,0,37,37,6,0,31,0,0,0,0,0,0,0,0,0,30420
9790,2412,559,1111,473,176,93,199,69,32,20,2,10,37,4,0,0,4,33,0,2,31,130,102,23,0,79,28,7,7,0,0,21,0,0,21,30421
9791,132,46,59,12,2,13,21,0,0,0,0,0,0,0,0,0,0,0,0,0,0,21,21,0,0,21,0,0,0,0,0,0,0,0,0,30423
9792,993,156,301,300,190,46,90,70,51,7,7,37,19,0,0,0,0,19,0,0,19,20,6,0,0,6,14,0,0,0,0,14,0,0,14,30425
9793,665,252,261,116,18,18,69,53,53,13,0,40,0,0,0,0,0,0,0,0,0,16,10,0,0,10,6,0,0,0,0,6,0,0,6,30426
9794,7855,1775,3098,1897,606,479,658,414,222,40,0,182,192,177,95,49,33,15,0,0,15,244,187,21,0,166,57,4,0,4,0,53,0,0,53,30427
9795,1610,294,883,241,136,56,64,10,2,0,0,2,8,6,0,0,6,2,1,0,1,54,50,0,0,50,4,4,0,4,0,0,0,0,0,30428
9796,184,133,37,14,0,0,49,15,15,0,0,15,0,0,0,0,0,0,0,0,0,34,27,0,0,27,7,7,0,0,7,0,0,0,0,30429
9797,3757,1023,1599,773,251,111,324,151,112,3,0,109,39,10,0,10,0,29,0,7,22,173,155,35,11,109,18,6,0,0,6,12,11,1,0,30434
9798,7101,1456,3247,1656,480,262,762,448,229,27,18,184,219,194,163,0,31,25,0,5,20,314,226,16,0,210,88,80,44,0,36,8,0,0,8,30436
9799,45,4,33,8,0,0,5,5,5,0,0,5,0,0,0,0,0,0,0,0,0,0,0,0,0,0,0,0,0,0,0,0,0,0,0,30438
9800,7041,1543,2839,1628,699,332,625,297,189,17,14,158,108,40,32,8,0,68,45,12,11,328,290,123,9,158,38,38,0,11,27,0,0,0,0,30439
9801,1233,330,538,277,71,17,83,39,33,5,0,28,6,6,0,0,6,0,0,0,0,44,44,9,0,35,0,0,0,0,0,0,0,0,0,30441
9802,4877,1454,1864,1024,408,127,487,277,261,79,0,182,16,0,0,0,0,16,0,16,0,210,159,0,0,159,51,51,0,51,0,0,0,0,0,30442
9803,2101,330,1021,477,153,120,431,222,166,37,0,129,56,49,0,28,21,7,0,0,7,209,187,51,0,136,22,0,0,0,0,22,0,0,22,30445
9804,1034,201,387,299,111,36,95,50,39,10,0,29,11,0,0,0,0,11,5,0,6,45,45,13,0,32,0,0,0,0,0,0,0,0,0,30446
9805,37,10,6,13,0,8,4,4,4,0,0,4,0,0,0,0,0,0,0,0,0,0,0,0,0,0,0,0,0,0,0,0,0,0,0,30448
9806,79,24,41,12,2,0,12,12,12,0,0,12,0,0,0,0,0,0,0,0,0,0,0,0,0,0,0,0,0,0,0,0,0,0,0,30449
9807,1466,312,571,406,145,32,120,92,65,27,0,38,27,21,21,0,0,6,6,0,0,28,19,3,0,16,9,9,9,0,0,0,0,0,0,30450
9808,28,2,13,12,0,1,0,0,0,0,0,0,0,0,0,0,0,0,0,0,0,0,0,0,0,0,0,0,0,0,0,0,0,0,0,30451
9809,1055,229,364,317,41,104,99,30,30,0,18,12,0,0,0,0,0,0,0,0,0,69,60,11,18,31,9,9,0,4,5,0,0,0,0,30452
9810,6721,2023,2911,1226,362,199,509,369,201,1,0,200,168,59,0,0,59,109,21,0,88,140,98,39,8,51,42,5,4,1,0,37,0,0,37,30453
9811,341,163,146,19,13,0,0,0,0,0,0,0,0,0,0,0,0,0,0,0,0,0,0,0,0,0,0,0,0,0,0,0,0,0,0,30454
9812,341,85,166,48,25,17,0,0,0,0,0,0,0,0,0,0,0,0,0,0,0,0,0,0,0,0,0,0,0,0,0,0,0,0,0,30455
9813,1499,369,603,418,69,40,112,75,74,7,0,67,1,0,0,0,0,1,1,0,0,37,28,0,0,28,9,6,0,0,6,3,0,2,1,30456
9814,4090,1091,1835,706,320,138,290,166,112,0,0,112,54,54,13,0,41,0,0,0,0,124,87,0,0,87,37,37,37,0,0,0,0,0,0,30457
9815,18593,2292,4744,5568,3466,2523,5354,2562,2405,258,76,2071,157,103,60,11,32,54,0,0,54,2792,2703,454,152,2097,89,33,11,0,22,56,0,0,56,30458
9816,26,0,0,26,0,0,597,272,272,0,0,272,0,0,0,0,0,0,0,0,0,325,325,59,27,239,0,0,0,0,0,0,0,0,0,30460
9817,8627,1249,2547,2395,1139,1297,616,401,323,73,31,219,78,6,0,0,6,72,0,0,72,215,151,26,13,112,64,54,22,0,32,10,0,10,0,30461
9818,54,23,17,14,0,0,10,6,1,0,0,1,5,5,0,5,0,0,0,0,0,4,4,0,0,4,0,0,0,0,0,0,0,0,0,30464
9819,8313,1721,3425,2092,664,411,766,375,235,50,30,155,140,62,0,26,36,78,0,0,78,391,346,41,0,305,45,29,23,0,6,16,16,0,0,30467
9820,334,1,134,150,19,30,27,1,0,0,0,0,1,1,1,0,0,0,0,0,0,26,26,9,0,17,0,0,0,0,0,0,0,0,0,30470
9821,3230,664,1378,878,193,117,229,130,103,16,22,65,27,12,6,0,6,15,0,10,5,99,95,22,0,73,4,0,0,0,0,4,0,0,4,30471
9822,1836,487,799,355,135,60,170,79,56,10,0,46,23,11,6,0,5,12,0,12,0,91,91,0,3,88,0,0,0,0,0,0,0,0,0,30473
9823,10939,2175,3872,2735,1375,782,898,466,339,42,54,243,127,108,17,0,91,19,8,9,2,432,390,30,35,325,42,9,0,9,0,33,0,12,21,30474
9824,0,0,0,0,0,0,0,0,0,0,0,0,0,0,0,0,0,0,0,0,0,0,0,0,0,0,0,0,0,0,0,0,0,0,0,30475
9825,2134,703,923,395,100,13,189,112,64,28,5,31,48,19,0,19,0,29,0,0,29,77,66,0,21,45,11,11,0,5,6,0,0,0,0,30477
9826,15877,5302,4298,3098,1686,1493,1831,823,485,112,11,362,338,223,159,2,62,115,27,0,88,1008,870,234,88,548,138,58,11,0,47,80,0,29,51,30501
9827,13436,4473,4212,2759,1298,694,1009,640,438,53,25,360,202,117,65,52,0,85,0,0,85,369,248,51,32,165,121,48,47,1,0,73,0,73,0,30504
9828,29206,3661,7863,8629,5476,3577,1972,1333,905,167,142,596,428,342,170,156,16,86,37,24,25,639,527,127,44,356,112,49,48,1,0,63,1,0,62,30506
9829,17387,5283,6200,3550,1502,852,1949,703,504,31,123,350,199,74,27,14,33,125,42,0,83,1246,931,299,86,546,315,198,36,0,162,117,27,14,76,30507
9830,5563,1832,1866,1314,253,298,439,295,205,33,28,144,90,67,51,16,0,23,0,3,20,144,121,20,18,83,23,23,9,0,14,0,0,0,0,30510
9831,2207,433,850,527,322,75,59,14,5,0,0,5,9,9,9,0,0,0,0,0,0,45,29,8,0,21,16,14,14,0,0,2,0,0,2,30511
9832,14643,2319,5045,4322,1683,1274,685,381,292,42,32,218,89,11,0,9,2,78,78,0,0,304,263,116,33,114,41,41,0,31,10,0,0,0,0,30512
9833,8376,1917,3728,1688,622,421,374,152,131,0,0,131,21,21,21,0,0,0,0,0,0,222,155,44,28,83,67,67,4,63,0,0,0,0,0,30513
9834,1229,247,529,334,61,58,50,19,16,1,0,15,3,0,0,0,0,3,3,0,0,31,27,5,1,21,4,0,0,0,0,4,3,0,1,30516
9835,8542,1005,2309,2396,1812,1020,455,225,204,39,0,165,21,20,6,0,14,1,0,0,1,230,195,124,0,71,35,35,35,0,0,0,0,0,0,30517
9836,28811,4167,7516,9001,5499,2628,1948,1045,784,171,39,574,261,171,0,100,71,90,90,0,0,903,769,237,79,453,134,134,12,37,85,0,0,0,0,30518
9837,25459,2636,5934,8478,5859,2552,2560,1400,1213,207,178,828,187,90,38,0,52,97,0,0,97,1160,1026,208,63,755,134,89,41,38,10,45,14,0,31,30519
9838,2942,815,1170,648,218,91,195,132,58,14,0,44,74,33,23,10,0,41,0,0,41,63,55,17,0,38,8,0,0,0,0,8,0,0,8,30520
9839,3009,969,939,601,269,231,159,70,27,13,0,14,43,0,0,0,0,43,43,0,0,89,70,3,0,67,19,19,3,0,16,0,0,0,0,30521
9840,658,67,255,188,64,84,0,0,0,0,0,0,0,0,0,0,0,0,0,0,0,0,0,0,0,0,0,0,0,0,0,0,0,0,0,30522
9841,9259,1303,2985,2718,1318,935,592,332,307,25,0,282,25,14,0,0,14,11,9,2,0,260,257,66,11,180,3,3,0,0,3,0,0,0,0,30523
9842,5284,887,1826,1374,685,512,432,221,194,21,50,123,27,0,0,0,0,27,0,0,27,211,170,43,8,119,41,21,0,0,21,20,0,0,20,30525
9843,2856,359,1104,843,335,215,232,159,122,16,0,106,37,37,37,0,0,0,0,0,0,73,70,36,0,34,3,0,0,0,0,3,0,3,0,30527
9844,15222,2569,5529,4753,1535,836,1340,639,567,161,69,337,72,35,8,27,0,37,0,0,37,701,685,254,21,410,16,16,16,0,0,0,0,0,0,30528
9845,6917,1769,2969,1338,464,377,549,267,149,0,13,136,118,87,38,11,38,31,14,0,17,282,195,54,11,130,87,42,19,0,23,45,20,12,13,30529
9846,4648,1385,2060,744,231,228,348,250,189,26,16,147,61,49,27,9,13,12,0,12,0,98,79,7,18,54,19,19,19,0,0,0,0,0,0,30530
9847,7117,2053,2293,1733,693,345,756,351,312,59,72,181,39,5,5,0,0,34,19,13,2,405,365,19,15,331,40,30,24,0,6,10,0,0,10,30531
9848,16330,2450,4896,4856,2760,1368,2572,1212,1078,222,57,799,134,96,96,0,0,38,0,0,38,1360,1099,378,223,498,261,131,120,11,0,130,110,20,0,30533
9849,19224,3364,5740,5600,3386,1134,1466,703,534,167,15,352,169,128,84,23,21,41,0,0,41,763,669,337,121,211,94,34,34,0,0,60,15,0,45,30534
9850,4472,758,1980,998,345,391,625,153,120,36,4,80,33,16,0,16,0,17,0,17,0,472,465,147,31,287,7,7,7,0,0,0,0,0,0,30535
9851,6174,947,2390,1761,736,340,217,109,109,7,0,102,0,0,0,0,0,0,0,0,0,108,75,31,0,44,33,33,19,14,0,0,0,0,0,30536
9852,1339,223,301,283,365,167,22,5,5,2,0,3,0,0,0,0,0,0,0,0,0,17,17,1,0,16,0,0,0,0,0,0,0,0,0,30537
9853,1837,356,851,552,65,13,139,86,86,26,38,22,0,0,0,0,0,0,0,0,0,53,53,0,0,53,0,0,0,0,0,0,0,0,0,30538
9854,12297,3488,3625,3251,1207,726,982,529,351,73,25,253,178,140,114,4,22,38,14,3,21,453,365,187,57,121,88,12,10,0,2,76,4,18,54,30540
9855,1330,202,440,523,131,34,74,37,37,19,0,18,0,0,0,0,0,0,0,0,0,37,28,0,0,28,9,9,0,9,0,0,0,0,0,30541
9856,21381,2657,5899,6941,3814,2070,2086,1076,859,91,88,680,217,154,112,29,13,63,9,0,54,1010,838,256,36,546,172,109,48,32,29,63,0,0,63,30542
9857,2819,765,1105,668,165,116,207,154,154,66,13,75,0,0,0,0,0,0,0,0,0,53,26,4,0,22,27,10,10,0,0,17,0,0,17,30543
9858,542,29,136,236,102,39,33,33,3,3,0,0,30,30,30,0,0,0,0,0,0,0,0,0,0,0,0,0,0,0,0,0,0,0,0,30545
9859,5360,701,2102,1364,687,506,223,136,77,13,0,64,59,33,12,0,21,26,11,0,15,87,87,35,26,26,0,0,0,0,0,0,0,0,0,30546
9860,2291,449,962,539,210,131,256,114,91,24,0,67,23,10,10,0,0,13,0,0,13,142,101,26,29,46,41,16,16,0,0,25,21,4,0,30547
9861,10811,739,3277,3289,2506,1000,809,457,424,47,20,357,33,33,33,0,0,0,0,0,0,352,200,21,10,169,152,142,0,0,142,10,0,0,10,30548
9862,14799,2382,4623,4206,2458,1130,1074,627,483,59,22,402,144,83,3,70,10,61,31,2,28,447,441,22,13,406,6,6,0,2,4,0,0,0,0,30549
9863,1161,130,303,349,249,130,103,72,72,14,0,58,0,0,0,0,0,0,0,0,0,31,31,0,9,22,0,0,0,0,0,0,0,0,0,30552
9864,4974,977,1906,1321,590,180,432,209,66,49,0,17,143,101,68,33,0,42,0,0,42,223,126,22,26,78,97,44,15,22,7,53,0,0,53,30553
9865,5223,1071,2280,1305,390,177,424,170,165,40,9,116,5,5,5,0,0,0,0,0,0,254,226,29,34,163,28,15,15,0,0,13,13,0,0,30554
9866,1440,343,520,375,130,72,74,35,35,0,0,35,0,0,0,0,0,0,0,0,0,39,31,4,0,27,8,8,4,0,4,0,0,0,0,30555
9867,3163,820,1162,876,220,85,267,178,149,24,5,120,29,29,10,19,0,0,0,0,0,89,89,20,0,69,0,0,0,0,0,0,0,0,0,30557
9868,3492,748,1567,829,275,73,261,173,166,17,0,149,7,7,5,0,2,0,0,0,0,88,55,2,0,53,33,14,5,9,0,19,19,0,0,30558
9869,2985,661,1047,802,233,242,303,212,173,29,10,134,39,39,0,39,0,0,0,0,0,91,91,0,82,9,0,0,0,0,0,0,0,0,0,30559
9870,3298,520,1290,909,399,180,133,122,107,33,0,74,15,15,15,0,0,0,0,0,0,11,7,7,0,0,4,4,0,0,4,0,0,0,0,30560
9871,447,94,171,125,31,26,22,11,11,3,0,8,0,0,0,0,0,0,0,0,0,11,3,0,0,3,8,6,6,0,0,2,2,0,0,30562
9872,3757,851,1139,1221,371,175,238,153,115,17,12,86,38,27,21,6,0,11,0,11,0,85,61,14,6,41,24,24,24,0,0,0,0,0,0,30563
9873,2505,450,936,679,262,178,300,151,106,7,0,99,45,45,45,0,0,0,0,0,0,149,149,12,13,124,0,0,0,0,0,0,0,0,0,30564
9874,2721,783,927,630,283,98,336,137,120,16,0,104,17,15,6,0,9,2,2,0,0,199,183,36,12,135,16,12,12,0,0,4,4,0,0,30565
9875,4942,1047,1686,1107,643,459,427,283,172,6,34,132,111,111,46,65,0,0,0,0,0,144,119,21,0,98,25,6,6,0,0,19,19,0,0,30566
9876,1981,382,665,477,276,181,196,125,115,29,0,86,10,10,10,0,0,0,0,0,0,71,57,10,0,47,14,14,7,0,7,0,0,0,0,30567
9877,1715,271,664,375,251,154,117,0,0,0,0,0,0,0,0,0,0,0,0,0,0,117,93,25,27,41,24,0,0,0,0,24,9,0,15,30568
9878,3204,199,809,1045,749,402,112,86,86,21,0,65,0,0,0,0,0,0,0,0,0,26,26,0,0,26,0,0,0,0,0,0,0,0,0,30571
9879,1254,229,401,322,211,91,41,39,39,0,0,39,0,0,0,0,0,0,0,0,0,2,1,0,0,1,1,0,0,0,0,1,0,0,1,30572
9880,96,2,3,19,8,64,0,0,0,0,0,0,0,0,0,0,0,0,0,0,0,0,0,0,0,0,0,0,0,0,0,0,0,0,0,30573
9881,828,383,311,45,76,13,104,81,81,59,0,22,0,0,0,0,0,0,0,0,0,23,13,12,0,1,10,0,0,0,0,10,0,10,0,30575
9882,1763,160,654,500,299,150,89,46,39,0,0,39,7,7,0,0,7,0,0,0,0,43,39,1,11,27,4,4,0,0,4,0,0,0,0,30576
9883,15195,2999,6063,3643,1478,1012,1582,587,514,163,105,246,73,50,50,0,0,23,0,16,7,995,761,68,102,591,234,170,0,103,67,64,0,44,20,30577
9884,0,0,0,0,0,0,0,0,0,0,0,0,0,0,0,0,0,0,0,0,0,0,0,0,0,0,0,0,0,0,0,0,0,0,0,30581
9885,3124,410,1182,952,248,332,606,327,327,17,30,280,0,0,0,0,0,0,0,0,0,279,279,114,34,131,0,0,0,0,0,0,0,0,0,30582
9886,10990,2654,3731,2524,1107,974,973,481,353,61,32,260,128,46,46,0,0,82,0,9,73,492,380,41,20,319,112,105,26,13,66,7,0,7,0,30601
9887,5,0,0,5,0,0,1783,706,706,137,36,533,0,0,0,0,0,0,0,0,0,1077,1077,180,53,844,0,0,0,0,0,0,0,0,0,30602
9888,19403,2219,3289,4302,4554,5039,5634,2533,2507,415,101,1991,26,26,3,5,18,0,0,0,0,3101,3018,563,260,2195,83,69,7,0,62,14,0,0,14,30605
9889,24382,2604,4596,5725,5738,5719,1660,799,640,112,64,464,159,147,33,22,92,12,0,0,12,861,761,276,9,476,100,100,74,0,26,0,0,0,0,30606
9890,6799,1603,1861,1714,875,746,477,174,134,28,5,101,40,26,13,0,13,14,0,14,0,303,261,46,50,165,42,19,0,0,19,23,0,8,15,30607
9891,12,0,0,0,0,12,1588,439,439,44,23,372,0,0,0,0,0,0,0,0,0,1149,1149,103,91,955,0,0,0,0,0,0,0,0,0,30609
9892,1092,104,415,192,132,249,97,57,57,43,0,14,0,0,0,0,0,0,0,0,0,40,21,6,0,15,19,19,0,1,18,0,0,0,0,30619
9893,7757,1078,2314,2774,1122,469,492,148,141,51,35,55,7,0,0,0,0,7,0,7,0,344,235,10,25,200,109,76,74,2,0,33,0,33,0,30620
9894,3174,389,709,977,562,537,374,166,146,51,2,93,20,20,20,0,0,0,0,0,0,208,168,45,8,115,40,40,19,21,0,0,0,0,0,30621
9895,6979,679,1496,2106,1477,1221,380,191,157,13,14,130,34,34,2,0,32,0,0,0,0,189,146,53,19,74,43,43,0,0,43,0,0,0,0,30622
9896,134,35,50,10,16,23,2,0,0,0,0,0,0,0,0,0,0,0,0,0,0,2,2,1,0,1,0,0,0,0,0,0,0,0,0,30623
9897,2007,369,873,475,172,118,189,73,69,10,12,47,4,4,4,0,0,0,0,0,0,116,71,20,1,50,45,4,0,0,4,41,26,0,15,30624
9898,1748,141,811,470,247,79,120,51,20,8,4,8,31,31,0,0,31,0,0,0,0,69,69,29,0,40,0,0,0,0,0,0,0,0,0,30625
9899,1632,519,620,317,134,42,57,52,52,9,0,43,0,0,0,0,0,0,0,0,0,5,5,1,0,4,0,0,0,0,0,0,0,0,0,30627
9900,4741,731,1816,1366,505,323,268,141,136,34,0,102,5,5,5,0,0,0,0,0,0,127,105,24,0,81,22,0,0,0,0,22,0,22,0,30628
9901,3136,859,1207,604,262,204,172,50,50,10,0,40,0,0,0,0,0,0,0,0,0,122,88,25,5,58,34,10,0,0,10,24,0,0,24,30629
9902,1471,332,615,265,129,130,97,47,39,39,0,0,8,3,0,0,3,5,0,0,5,50,50,3,0,47,0,0,0,0,0,0,0,0,0,30630
9903,1292,406,545,234,66,41,85,30,23,0,0,23,7,7,0,0,7,0,0,0,0,55,39,12,0,27,16,16,0,16,0,0,0,0,0,30631
9904,5749,1108,2364,1589,350,338,771,407,310,50,0,260,97,97,70,20,7,0,0,0,0,364,314,34,0,280,50,24,0,24,0,26,3,7,16,30633
9905,1722,489,767,335,108,23,101,21,11,0,0,11,10,0,0,0,0,10,0,10,0,80,48,0,13,35,32,32,20,0,12,0,0,0,0,30634
9906,10834,2338,5016,2272,703,505,713,448,338,39,31,268,110,51,8,31,12,59,0,19,40,265,218,64,0,154,47,30,0,0,30,17,0,17,0,30635
9907,1589,245,737,344,171,92,86,32,6,0,0,6,26,0,0,0,0,26,26,0,0,54,54,13,0,41,0,0,0,0,0,0,0,0,0,30641
9908,8028,1650,2574,1668,1204,932,476,196,166,44,3,119,30,26,26,0,0,4,0,4,0,280,227,60,105,62,53,49,0,0,49,4,0,0,4,30642
9909,11768,2184,4516,3029,1316,723,744,363,332,44,72,216,31,30,25,0,5,1,0,0,1,381,351,15,44,292,30,30,30,0,0,0,0,0,0,30643
9910,4529,1129,1473,1234,465,228,219,77,77,26,24,27,0,0,0,0,0,0,0,0,0,142,129,52,17,60,13,13,13,0,0,0,0,0,0,30646
9911,2306,712,804,486,188,116,224,94,94,29,46,19,0,0,0,0,0,0,0,0,0,130,130,32,7,91,0,0,0,0,0,0,0,0,0,30648
9912,7808,1390,2525,1932,1220,741,580,306,272,66,0,206,34,29,2,0,27,5,0,0,5,274,260,53,7,200,14,14,0,1,13,0,0,0,0,30650
9913,14817,3022,4953,4373,1744,725,1112,574,382,68,117,197,192,106,39,12,55,86,29,0,57,538,406,49,8,349,132,70,0,38,32,62,0,0,62,30655
9914,10638,1814,3252,3812,1209,551,850,490,292,25,20,247,198,183,0,0,183,15,0,15,0,360,307,97,37,173,53,44,26,0,18,9,0,0,9,30656
9915,718,168,344,126,18,62,96,62,27,2,0,25,35,33,0,0,33,2,0,0,2,34,31,0,0,31,3,3,0,3,0,0,0,0,0,30660
9916,5397,1324,1928,1419,430,296,738,381,282,20,18,244,99,48,44,0,4,51,0,15,36,357,346,60,17,269,11,11,0,8,3,0,0,0,0,30662
9917,2291,623,904,460,216,88,203,141,116,66,16,34,25,21,10,0,11,4,0,0,4,62,60,15,0,45,2,2,2,0,0,0,0,0,0,30663
9918,11,2,9,0,0,0,0,0,0,0,0,0,0,0,0,0,0,0,0,0,0,0,0,0,0,0,0,0,0,0,0,0,0,0,0,30664
9919,67,17,49,1,0,0,14,12,12,0,0,12,0,0,0,0,0,0,0,0,0,2,2,0,2,0,0,0,0,0,0,0,0,0,0,30665
9920,6093,1071,2036,1673,795,518,398,159,159,4,0,155,0,0,0,0,0,0,0,0,0,239,201,98,6,97,38,14,14,0,0,24,0,0,24,30666
9921,541,163,149,143,57,29,77,72,72,0,0,72,0,0,0,0,0,0,0,0,0,5,5,5,0,0,0,0,0,0,0,0,0,0,0,30667
9922,1378,218,705,344,68,43,156,80,56,12,14,30,24,24,14,0,10,0,0,0,0,76,76,0,14,62,0,0,0,0,0,0,0,0,0,30668
9923,2309,530,1115,422,107,135,95,36,26,0,0,26,10,9,4,0,5,1,0,0,1,59,52,12,0,40,7,7,0,0,7,0,0,0,0,30669
9924,5559,1353,2048,1221,551,386,396,177,143,31,0,112,34,23,0,0,23,11,0,0,11,219,179,26,0,153,40,0,0,0,0,40,0,0,40,30673
9925,10934,946,2267,3256,2394,2071,1092,606,554,150,57,347,52,42,42,0,0,10,6,0,4,486,411,155,0,256,75,19,19,0,0,56,0,0,56,30677
9926,1169,252,552,220,116,29,25,0,0,0,0,0,0,0,0,0,0,0,0,0,0,25,25,0,0,25,0,0,0,0,0,0,0,0,0,30678
9927,24824,4802,8467,7412,2886,1257,2469,1430,1167,134,271,762,263,142,116,21,5,121,0,50,71,1039,921,323,68,530,118,78,65,13,0,40,0,40,0,30680
9928,4645,778,1312,1269,749,537,232,117,83,6,0,77,34,0,0,0,0,34,0,0,34,115,104,18,11,75,11,0,0,0,0,11,0,11,0,30683
9929,25031,6577,8151,6478,2196,1629,2398,1303,1031,161,67,803,272,185,115,47,23,87,65,0,22,1095,960,204,81,675,135,65,52,13,0,70,0,18,52,30701
9930,21983,6592,8031,5101,1234,1025,1962,1056,861,69,60,732,195,100,57,41,2,95,5,12,78,906,774,85,73,616,132,79,35,0,44,53,0,16,37,30705
9931,10939,2143,4176,3516,778,326,645,389,270,43,35,192,119,113,23,53,37,6,6,0,0,256,190,49,0,141,66,55,18,23,14,11,11,0,0,30707
9932,259,84,45,124,6,0,0,0,0,0,0,0,0,0,0,0,0,0,0,0,0,0,0,0,0,0,0,0,0,0,0,0,0,0,0,30708
9933,4056,1037,1206,1078,465,270,443,235,186,5,15,166,49,40,0,0,40,9,0,9,0,208,200,91,0,109,8,8,4,4,0,0,0,0,0,30710
9934,2594,904,940,585,105,60,171,61,61,0,3,58,0,0,0,0,0,0,0,0,0,110,85,0,0,85,25,11,0,11,0,14,0,0,14,30711
9935,18876,4579,5058,5241,2541,1457,1223,579,436,113,47,276,143,36,36,0,0,107,9,0,98,644,496,126,33,337,148,93,3,69,21,55,0,33,22,30720
9936,30720,12118,9292,6957,1254,1099,3423,1801,1306,201,244,861,495,341,288,22,31,154,32,27,95,1622,1210,196,121,893,412,233,166,27,40,179,72,0,107,30721
9937,2762,288,1095,599,611,169,166,60,32,0,0,32,28,28,28,0,0,0,0,0,0,106,87,18,0,69,19,19,19,0,0,0,0,0,0,30725
9938,0,0,0,0,0,0,0,0,0,0,0,0,0,0,0,0,0,0,0,0,0,0,0,0,0,0,0,0,0,0,0,0,0,0,0,30726
9939,13257,2976,5132,3757,1005,387,750,355,269,32,85,152,86,16,16,0,0,70,0,0,70,395,308,96,82,130,87,87,27,16,44,0,0,0,0,30728
9940,1085,199,549,273,49,15,97,59,41,9,1,31,18,12,0,12,0,6,0,0,6,38,21,0,0,21,17,2,0,2,0,15,0,3,12,30730
9941,1572,365,592,451,94,70,101,77,59,10,7,42,18,3,0,3,0,15,0,4,11,24,18,0,0,18,6,1,0,0,1,5,5,0,0,30731
9942,1159,454,366,263,27,49,150,58,53,7,10,36,5,5,5,0,0,0,0,0,0,92,92,27,0,65,0,0,0,0,0,0,0,0,0,30733
9943,2405,755,923,487,175,65,170,97,68,20,0,48,29,0,0,0,0,29,0,0,29,73,57,0,0,57,16,0,0,0,0,16,0,16,0,30734
9944,3803,1200,1519,715,284,85,121,56,53,0,22,31,3,3,3,0,0,0,0,0,0,65,65,13,18,34,0,0,0,0,0,0,0,0,0,30735
9945,27365,4043,8066,9576,3939,1741,2642,1540,1069,233,125,711,471,258,128,106,24,213,55,41,117,1102,987,363,91,533,115,87,66,21,0,28,0,28,0,30736
9946,2699,370,867,869,427,166,231,111,79,40,9,30,32,0,0,0,0,32,32,0,0,120,93,17,19,57,27,27,27,0,0,0,0,0,0,30738
9947,4014,682,1719,1029,373,211,306,100,45,11,0,34,55,49,49,0,0,6,0,0,6,206,183,18,34,131,23,23,23,0,0,0,0,0,0,30739
9948,5546,872,1575,1871,717,511,370,211,182,15,30,137,29,29,29,0,0,0,0,0,0,159,144,0,0,144,15,15,0,15,0,0,0,0,0,30740
9949,21697,5086,7740,6276,1722,873,1585,887,641,153,15,473,246,70,49,21,0,176,0,57,119,698,516,55,37,424,182,132,78,20,34,50,12,20,18,30741
9950,4956,954,1808,1499,467,228,293,172,134,64,0,70,38,27,18,9,0,11,0,0,11,121,88,28,31,29,33,33,33,0,0,0,0,0,0,30742
9951,883,241,298,228,50,66,65,55,55,0,0,55,0,0,0,0,0,0,0,0,0,10,0,0,0,0,10,0,0,0,0,10,10,0,0,30746
9952,12243,3813,4545,2901,706,278,713,267,211,19,45,147,56,39,35,0,4,17,6,0,11,446,312,19,10,283,134,45,7,11,27,89,0,27,62,30747
9953,2381,190,442,437,822,490,700,340,298,102,0,196,42,42,42,0,0,0,0,0,0,360,346,121,15,210,14,14,13,1,0,0,0,0,0,30750
9954,47,16,18,13,0,0,6,6,6,0,0,6,0,0,0,0,0,0,0,0,0,0,0,0,0,0,0,0,0,0,0,0,0,0,0,30751
9955,6538,1503,2386,1797,637,215,458,281,229,29,87,113,52,35,33,0,2,17,0,0,17,177,163,30,36,97,14,14,0,14,0,0,0,0,0,30752
9956,4484,1536,1658,1047,199,44,467,338,304,17,0,287,34,19,0,0,19,15,12,0,3,129,118,0,3,115,11,0,0,0,0,11,0,7,4,30753
9957,5743,1627,1702,1633,480,301,502,353,313,52,12,249,40,12,12,0,0,28,13,0,15,149,135,30,27,78,14,14,0,0,14,0,0,0,0,30755
9958,77,39,11,27,0,0,22,11,11,0,0,11,0,0,0,0,0,0,0,0,0,11,0,0,0,0,11,0,0,0,0,11,0,11,0,30756
9959,1557,257,596,469,148,87,134,38,18,18,0,0,20,20,20,0,0,0,0,0,0,96,96,0,0,96,0,0,0,0,0,0,0,0,0,30757
9960,3815,524,1173,981,790,347,485,261,117,25,0,92,144,34,18,13,3,110,0,0,110,224,189,20,12,157,35,35,0,0,35,0,0,0,0,30802
9961,504,128,259,100,14,3,20,10,9,1,0,8,1,1,0,1,0,0,0,0,0,10,10,6,0,4,0,0,0,0,0,0,0,0,0,30803
9962,1584,298,655,493,95,43,89,52,47,0,16,31,5,5,0,0,5,0,0,0,0,37,37,6,16,15,0,0,0,0,0,0,0,0,0,30805
9963,67,14,37,14,1,1,14,0,0,0,0,0,0,0,0,0,0,0,0,0,0,14,14,0,0,14,0,0,0,0,0,0,0,0,0,30807
9964,3356,874,1305,936,173,68,243,63,60,0,0,60,3,0,0,0,0,3,3,0,0,180,180,0,0,180,0,0,0,0,0,0,0,0,0,30808
9965,26697,1203,4930,8434,6763,5367,2289,1037,933,284,66,583,104,104,104,0,0,0,0,0,0,1252,1081,401,134,546,171,123,77,16,30,48,0,0,48,30809
9966,1443,331,644,380,43,45,125,66,51,8,0,43,15,0,0,0,0,15,0,0,15,59,59,10,8,41,0,0,0,0,0,0,0,0,0,30810
9967,425,238,97,50,25,15,0,0,0,0,0,0,0,0,0,0,0,0,0,0,0,0,0,0,0,0,0,0,0,0,0,0,0,0,0,30812
9968,20306,2956,5314,7123,3605,1308,1737,918,733,27,34,672,185,87,21,19,47,98,21,0,77,819,753,229,85,439,66,46,16,30,0,20,0,7,13,30813
9969,5577,1147,2186,1466,546,232,569,295,201,61,7,133,94,43,9,18,16,51,0,0,51,274,216,9,36,171,58,58,58,0,0,0,0,0,0,30814
9970,26565,3587,8804,9992,2755,1427,2726,1416,954,147,106,701,462,189,102,14,73,273,13,20,240,1310,1176,145,112,919,134,55,16,15,24,79,0,19,60,30815
9971,1631,297,862,378,28,66,116,79,65,2,40,23,14,0,0,0,0,14,0,14,0,37,25,0,0,25,12,10,0,10,0,2,0,2,0,30816
9972,5326,969,2426,1316,341,274,456,234,193,14,14,165,41,15,12,0,3,26,9,0,17,222,212,58,5,149,10,10,10,0,0,0,0,0,0,30817
9973,294,98,111,46,39,0,0,0,0,0,0,0,0,0,0,0,0,0,0,0,0,0,0,0,0,0,0,0,0,0,0,0,0,0,0,30818
9974,977,165,483,285,25,19,86,77,72,4,0,68,5,5,5,0,0,0,0,0,0,9,9,0,0,9,0,0,0,0,0,0,0,0,0,30820
9975,706,234,305,150,3,14,54,9,9,0,0,9,0,0,0,0,0,0,0,0,0,45,45,0,0,45,0,0,0,0,0,0,0,0,0,30821
9976,529,122,278,78,13,38,25,25,25,0,0,25,0,0,0,0,0,0,0,0,0,0,0,0,0,0,0,0,0,0,0,0,0,0,0,30822
9977,1175,377,430,194,117,57,73,17,2,0,0,2,15,0,0,0,0,15,15,0,0,56,56,22,2,32,0,0,0,0,0,0,0,0,0,30823
9978,10820,2698,3907,2499,1013,703,972,539,487,42,34,411,52,16,16,0,0,36,0,20,16,433,404,28,68,308,29,21,21,0,0,8,8,0,0,30824
9979,2682,764,1176,513,150,79,257,121,51,0,0,51,70,55,34,21,0,15,0,15,0,136,135,0,0,135,1,0,0,0,0,1,0,0,1,30828
9980,8470,1909,3038,2468,729,326,763,391,253,24,0,229,138,112,5,78,29,26,0,0,26,372,302,59,30,213,70,67,36,9,22,3,0,0,3,30830
9981,2277,379,1066,558,137,137,187,76,53,0,5,48,23,20,15,0,5,3,0,0,3,111,99,46,0,53,12,12,0,0,12,0,0,0,0,30833
9982,10286,3612,3504,2124,663,383,855,390,234,41,11,182,156,97,22,43,32,59,4,0,55,465,313,44,14,255,152,62,2,0,60,90,8,38,44,30901
9983,311,0,39,91,100,81,39,30,30,0,0,30,0,0,0,0,0,0,0,0,0,9,9,9,0,0,0,0,0,0,0,0,0,0,0,30903
9984,17731,3396,5274,4705,2864,1492,1118,519,445,117,116,212,74,45,29,16,0,29,0,23,6,599,555,143,57,355,44,10,10,0,0,34,0,22,12,30904
9985,3022,90,565,1430,680,257,985,716,196,72,0,124,520,504,482,0,22,16,16,0,0,269,54,9,0,45,215,213,182,0,31,2,0,0,2,30905
9986,36594,7028,13318,12040,2749,1459,3938,2129,1442,114,98,1230,687,339,114,101,124,348,107,18,223,1809,1243,177,39,1027,566,382,166,27,189,184,13,10,161,30906
9987,33535,2387,8627,11247,6508,4766,2703,1396,1090,192,92,806,306,170,113,11,46,136,30,45,61,1307,1175,363,76,736,132,89,0,66,23,43,32,11,0,30907
9988,26065,1934,6478,8402,5382,3869,1588,791,622,97,59,466,169,125,101,10,14,44,11,0,33,797,644,233,5,406,153,153,30,0,123,0,0,0,0,30909
9989,138,25,22,39,38,14,73,0,0,0,0,0,0,0,0,0,0,0,0,0,0,73,73,0,16,57,0,0,0,0,0,0,0,0,0,30912
9990,3714,1083,1616,714,267,34,189,79,43,6,0,37,36,33,0,0,33,3,0,0,3,110,64,0,12,52,46,7,0,0,7,39,0,0,39,31001
9991,2094,470,803,568,207,46,188,111,80,0,0,80,31,31,31,0,0,0,0,0,0,77,77,19,0,58,0,0,0,0,0,0,0,0,0,31002
9992,136,8,41,63,14,10,0,0,0,0,0,0,0,0,0,0,0,0,0,0,0,0,0,0,0,0,0,0,0,0,0,0,0,0,0,31003
9993,10343,541,2613,4064,1622,1503,851,460,371,81,118,172,89,89,6,83,0,0,0,0,0,391,339,47,58,234,52,52,36,0,16,0,0,0,0,31005
9994,3204,885,1345,777,119,78,265,157,128,7,46,75,29,25,0,13,12,4,0,4,0,108,108,23,0,85,0,0,0,0,0,0,0,0,0,31006
9995,743,245,280,140,59,19,50,17,17,0,0,17,0,0,0,0,0,0,0,0,0,33,22,0,6,16,11,11,0,0,11,0,0,0,0,31007
9996,12370,1899,4131,4054,1657,629,585,250,236,23,27,186,14,0,0,0,0,14,0,14,0,335,308,105,16,187,27,14,14,0,0,13,0,0,13,31008
9997,1146,268,493,243,79,63,37,6,6,3,0,3,0,0,0,0,0,0,0,0,0,31,31,5,0,26,0,0,0,0,0,0,0,0,0,31009
9998,713,138,252,112,135,76,46,10,6,0,0,6,4,3,0,0,3,1,0,0,1,36,12,0,0,12,24,24,0,21,3,0,0,0,0,31011
9999,2252,608,1011,454,112,67,165,77,13,0,0,13,64,25,3,0,22,39,0,4,35,88,75,0,16,59,13,0,0,0,0,13,0,13,0,31012
10000,8593,1782,3499,2105,634,573,1338,569,470,24,24,422,99,58,9,0,49,41,0,29,12,769,684,102,66,516,85,79,48,31,0,6,0,0,6,31014
10001,14554,3047,5154,4111,1443,799,1396,731,519,90,7,422,212,80,46,0,34,132,0,36,96,665,548,141,87,320,117,77,39,0,38,40,0,40,0,31015
10002,881,190,318,260,74,39,82,82,82,13,65,4,0,0,0,0,0,0,0,0,0,0,0,0,0,0,0,0,0,0,0,0,0,0,0,31016
10003,1136,245,502,275,46,68,86,65,56,0,0,56,9,9,0,9,0,0,0,0,0,21,16,0,0,16,5,5,0,0,5,0,0,0,0,31017
10004,2316,656,1077,445,101,37,136,81,46,0,0,46,35,27,25,0,2,8,0,0,8,55,31,1,0,30,24,5,0,0,5,19,10,0,9,31018
10005,1485,283,745,300,93,64,171,103,65,0,0,65,38,38,3,0,35,0,0,0,0,68,68,3,3,62,0,0,0,0,0,0,0,0,0,31019
10006,1772,658,592,348,165,9,77,43,0,0,0,0,43,0,0,0,0,43,43,0,0,34,0,0,0,0,34,0,0,0,0,34,0,34,0,31020
10007,18379,3353,7214,4252,2015,1545,1641,849,674,103,16,555,175,81,0,9,72,94,48,0,46,792,607,134,28,445,185,119,81,18,20,66,36,0,30,31021
10008,932,125,387,252,64,104,85,41,30,6,0,24,11,11,0,6,5,0,0,0,0,44,44,8,0,36,0,0,0,0,0,0,0,0,0,31022
10009,9470,1658,4000,2209,997,606,838,467,229,22,22,185,238,144,0,29,115,94,17,3,74,371,320,101,60,159,51,50,43,0,7,1,0,0,1,31023
10010,14567,2262,5672,3941,1727,965,1020,589,367,75,6,286,222,222,65,62,95,0,0,0,0,431,251,7,29,215,180,178,112,19,47,2,2,0,0,31024
10011,1018,128,340,324,165,61,172,92,92,0,27,65,0,0,0,0,0,0,0,0,0,80,72,41,31,0,8,8,0,0,8,0,0,0,0,31025
10012,7016,1742,3540,1344,286,104,460,243,184,8,15,161,59,25,6,0,19,34,27,0,7,217,120,9,11,100,97,46,8,0,38,51,0,0,51,31027
10013,3619,391,1070,1274,503,381,241,204,151,0,0,151,53,53,29,0,24,0,0,0,0,37,8,0,0,8,29,29,29,0,0,0,0,0,0,31028
10014,10970,2472,4092,2744,994,668,1054,545,486,8,28,450,59,41,15,10,16,18,0,0,18,509,474,250,2,222,35,35,13,0,22,0,0,0,0,31029
10015,10696,2281,3516,3071,1088,740,2765,1464,1286,166,92,1028,178,137,127,10,0,41,34,0,7,1301,1223,61,102,1060,78,70,26,28,16,8,0,3,5,31030
10016,4347,797,2040,1118,294,98,480,266,179,35,0,144,87,25,25,0,0,62,62,0,0,214,115,2,12,101,99,48,0,0,48,51,0,0,51,31031
10017,9071,848,3537,2782,1204,700,764,418,291,24,24,243,127,105,55,7,43,22,0,0,22,346,302,43,6,253,44,44,31,13,0,0,0,0,0,31032
10018,1434,121,708,389,175,41,86,25,0,0,0,0,25,25,0,25,0,0,0,0,0,61,61,0,0,61,0,0,0,0,0,0,0,0,0,31033
10019,897,273,371,192,47,14,87,53,49,0,2,47,4,0,0,0,0,4,0,0,4,34,32,7,0,25,2,0,0,0,0,2,0,0,2,31035
10020,9272,2001,4085,2212,578,396,489,179,173,55,0,118,6,6,0,0,6,0,0,0,0,310,286,25,49,212,24,11,0,11,0,13,0,0,13,31036
10021,2738,851,1449,239,143,56,133,93,57,0,0,57,36,0,0,0,0,36,0,0,36,40,40,0,0,40,0,0,0,0,0,0,0,0,0,31037
10022,559,114,223,133,86,3,107,61,32,0,0,32,29,0,0,0,0,29,0,29,0,46,46,46,0,0,0,0,0,0,0,0,0,0,0,31038
10023,0,0,0,0,0,0,0,0,0,0,0,0,0,0,0,0,0,0,0,0,0,0,0,0,0,0,0,0,0,0,0,0,0,0,0,31039
10024,737,254,237,216,25,5,53,8,8,1,0,7,0,0,0,0,0,0,0,0,0,45,45,0,0,45,0,0,0,0,0,0,0,0,0,31041
10025,1386,300,664,275,77,70,182,61,42,1,0,41,19,19,0,14,5,0,0,0,0,121,121,0,0,121,0,0,0,0,0,0,0,0,0,31042
10026,1784,502,732,264,163,123,176,106,58,3,0,55,48,10,0,0,10,38,0,34,4,70,64,0,0,64,6,6,0,6,0,0,0,0,0,31044
10027,65,8,38,12,0,7,12,12,12,0,0,12,0,0,0,0,0,0,0,0,0,0,0,0,0,0,0,0,0,0,0,0,0,0,0,31045
10028,2530,442,912,804,272,100,72,38,38,0,16,22,0,0,0,0,0,0,0,0,0,34,34,0,0,34,0,0,0,0,0,0,0,0,0,31046
10029,7081,496,1614,2409,1421,1141,437,198,179,15,0,164,19,19,19,0,0,0,0,0,0,239,220,74,16,130,19,9,9,0,0,10,0,10,0,31047
10030,1316,312,560,207,195,42,98,72,72,14,9,49,0,0,0,0,0,0,0,0,0,26,26,0,2,24,0,0,0,0,0,0,0,0,0,31049
10031,779,184,321,203,23,48,39,39,38,38,0,0,1,0,0,0,0,1,0,0,1,0,0,0,0,0,0,0,0,0,0,0,0,0,0,31050
10032,127,42,52,13,20,0,16,14,14,0,0,14,0,0,0,0,0,0,0,0,0,2,2,0,0,2,0,0,0,0,0,0,0,0,0,31051
10033,6109,899,2300,1572,982,356,345,214,148,0,0,148,66,40,0,29,11,26,0,0,26,131,119,18,0,101,12,12,12,0,0,0,0,0,0,31052
10034,1177,301,585,227,64,0,69,30,23,2,0,21,7,5,0,1,4,2,0,2,0,39,16,0,0,16,23,12,10,2,0,11,0,1,10,31054
10035,7408,1808,3413,1226,450,511,526,194,152,3,0,149,42,34,34,0,0,8,0,0,8,332,223,62,0,161,109,109,50,0,59,0,0,0,0,31055
10036,1533,354,504,433,161,81,176,76,63,0,0,63,13,6,6,0,0,7,7,0,0,100,34,20,0,14,66,37,4,0,33,29,29,0,0,31057
10037,1010,183,490,249,69,19,61,24,8,0,0,8,16,16,0,16,0,0,0,0,0,37,18,0,0,18,19,19,0,0,19,0,0,0,0,31058
10038,1307,312,506,332,112,45,115,59,59,0,1,58,0,0,0,0,0,0,0,0,0,56,56,13,0,43,0,0,0,0,0,0,0,0,0,31060
10039,26670,4662,9767,7019,2679,2543,3211,1740,1371,168,127,1076,369,253,101,111,41,116,0,26,90,1471,1255,257,92,906,216,95,44,8,43,121,0,0,121,31061
10040,240,128,83,10,11,8,7,7,7,0,0,7,0,0,0,0,0,0,0,0,0,0,0,0,0,0,0,0,0,0,0,0,0,0,0,31062
10041,3416,1018,1352,664,290,92,282,207,158,0,6,152,49,49,0,30,19,0,0,0,0,75,66,0,0,66,9,9,0,0,9,0,0,0,0,31063
10042,6203,1011,2265,2038,527,362,503,217,181,55,13,113,36,19,0,19,0,17,17,0,0,286,246,53,0,193,40,40,0,30,10,0,0,0,0,31064
10043,719,237,288,123,55,16,16,14,2,0,2,0,12,12,4,0,8,0,0,0,0,2,2,0,1,1,0,0,0,0,0,0,0,0,0,31065
10044,717,110,329,134,87,57,70,70,28,0,0,28,42,12,12,0,0,30,30,0,0,0,0,0,0,0,0,0,0,0,0,0,0,0,0,31066
10045,221,56,84,58,23,0,1,0,0,0,0,0,0,0,0,0,0,0,0,0,0,1,1,1,0,0,0,0,0,0,0,0,0,0,0,31067
10046,3737,1353,1377,710,155,142,317,189,114,0,26,88,75,4,0,0,4,71,0,0,71,128,82,5,4,73,46,10,0,0,10,36,0,36,0,31068
10047,13752,1374,4934,4401,1927,1116,1408,658,485,77,88,320,173,134,100,34,0,39,0,0,39,750,624,194,91,339,126,44,17,0,27,82,0,33,49,31069
10048,867,159,381,195,117,15,75,4,0,0,0,0,4,0,0,0,0,4,0,0,4,71,68,0,0,68,3,3,3,0,0,0,0,0,0,31070
10049,851,177,354,265,34,21,89,55,43,7,8,28,12,0,0,0,0,12,0,12,0,34,31,0,0,31,3,3,0,0,3,0,0,0,0,31071
10050,921,140,463,221,50,47,130,50,36,11,0,25,14,14,0,14,0,0,0,0,0,80,62,7,10,45,18,18,0,0,18,0,0,0,0,31072
10051,1559,271,766,307,119,96,184,83,83,43,0,40,0,0,0,0,0,0,0,0,0,101,101,18,12,71,0,0,0,0,0,0,0,0,0,31075
10052,2199,393,835,658,168,145,201,106,71,0,2,69,35,9,8,0,1,26,0,0,26,95,92,10,0,82,3,3,3,0,0,0,0,0,0,31076
10053,761,188,357,120,53,43,6,4,4,0,0,4,0,0,0,0,0,0,0,0,0,2,2,0,0,2,0,0,0,0,0,0,0,0,0,31077
10054,2312,548,612,903,177,72,117,69,38,7,0,31,31,4,0,4,0,27,1,26,0,48,48,10,22,16,0,0,0,0,0,0,0,0,0,31078
10055,1510,259,680,410,117,44,122,86,20,6,0,14,66,20,20,0,0,46,0,0,46,36,35,11,0,24,1,0,0,0,0,1,0,1,0,31079
10056,66,0,0,45,21,0,0,0,0,0,0,0,0,0,0,0,0,0,0,0,0,0,0,0,0,0,0,0,0,0,0,0,0,0,0,31081
10057,6457,1343,2731,1478,619,286,527,312,235,36,40,159,77,59,45,0,14,18,0,8,10,215,152,18,11,123,63,63,0,0,63,0,0,0,0,31082
10058,159,22,113,15,0,9,10,4,0,0,0,0,4,4,4,0,0,0,0,0,0,6,0,0,0,0,6,6,0,0,6,0,0,0,0,31083
10059,42,5,11,26,0,0,23,0,0,0,0,0,0,0,0,0,0,0,0,0,0,23,0,0,0,0,23,23,0,0,23,0,0,0,0,31084
10060,703,175,326,91,72,39,82,29,29,7,0,22,0,0,0,0,0,0,0,0,0,53,23,23,0,0,30,12,0,0,12,18,18,0,0,31085
10061,6524,1625,2811,1462,454,172,624,337,203,13,0,190,134,56,0,47,9,78,0,0,78,287,160,15,0,145,127,45,0,12,33,82,5,77,0,31087
10062,32065,2898,8118,12244,5483,3322,3421,1757,1674,535,194,945,83,33,33,0,0,50,0,0,50,1664,1566,353,219,994,98,76,26,50,0,22,14,8,0,31088
10063,2939,702,1205,638,320,74,322,163,111,22,2,87,52,48,0,0,48,4,0,4,0,159,152,45,30,77,7,2,0,0,2,5,0,0,5,31089
10064,476,112,197,135,22,10,25,3,3,0,0,3,0,0,0,0,0,0,0,0,0,22,22,0,0,22,0,0,0,0,0,0,0,0,0,31090
10065,3922,1201,1852,651,146,72,209,172,69,3,12,54,103,72,0,0,72,31,0,0,31,37,20,0,0,20,17,17,17,0,0,0,0,0,0,31091
10066,4432,1148,1457,1212,365,250,562,290,206,33,17,156,84,42,42,0,0,42,42,0,0,272,192,40,14,138,80,80,75,0,5,0,0,0,0,31092
10067,18228,3572,6431,5924,1402,899,1569,738,464,87,37,340,274,73,48,25,0,201,81,59,61,831,671,59,155,457,160,104,46,0,58,56,43,13,0,31093
10068,782,116,265,344,38,19,14,5,5,0,5,0,0,0,0,0,0,0,0,0,0,9,9,0,4,5,0,0,0,0,0,0,0,0,0,31094
10069,5120,1270,2005,1347,271,227,351,142,92,43,0,49,50,50,49,0,1,0,0,0,0,209,171,0,25,146,38,9,0,0,9,29,0,0,29,31096
10070,905,160,326,348,57,14,100,49,38,13,12,13,11,0,0,0,0,11,0,11,0,51,40,10,2,28,11,0,0,0,0,11,0,0,11,31097
10071,1309,48,208,694,225,134,138,86,64,23,22,19,22,22,17,5,0,0,0,0,0,52,47,14,14,19,5,0,0,0,0,5,0,0,5,31098
10072,5884,1560,2098,1336,552,338,481,151,77,7,13,57,74,50,0,0,50,24,0,0,24,330,313,43,5,265,17,17,12,5,0,0,0,0,0,31201
10073,19985,3997,6678,5301,2353,1656,1826,960,763,99,46,618,197,90,61,29,0,107,63,8,36,866,681,92,121,468,185,67,42,6,19,118,53,1,64,31204
10074,16938,4992,6531,4372,705,338,2176,1045,748,90,94,564,297,216,129,59,28,81,4,15,62,1131,892,17,99,776,239,115,35,59,21,124,45,10,69,31206
10075,0,0,0,0,0,0,867,198,198,29,0,169,0,0,0,0,0,0,0,0,0,669,669,55,0,614,0,0,0,0,0,0,0,0,0,31207
10076,21095,1129,4526,5473,6074,3893,1991,1017,956,205,37,714,61,53,0,0,53,8,0,0,8,974,914,181,76,657,60,34,16,0,18,26,9,17,0,31210
10077,10364,1573,3741,2977,1285,788,536,288,234,5,10,219,54,5,0,5,0,49,29,0,20,248,213,42,14,157,35,27,0,27,0,8,0,0,8,31211
10078,0,0,0,0,0,0,0,0,0,0,0,0,0,0,0,0,0,0,0,0,0,0,0,0,0,0,0,0,0,0,0,0,0,0,0,31213
10079,11912,1848,4544,3406,1529,585,541,319,287,81,0,206,32,18,5,0,13,14,0,0,14,222,201,71,9,121,21,3,0,0,3,18,18,0,0,31216
10080,11947,3050,4873,3228,586,210,1146,741,568,31,52,485,173,92,50,9,33,81,14,0,67,405,283,38,38,207,122,65,18,0,47,57,0,7,50,31217
10081,9087,485,2635,3176,1802,989,742,362,267,46,47,174,95,42,0,16,26,53,0,0,53,380,223,21,40,162,157,155,93,0,62,2,0,0,2,31220
10082,2786,416,1138,878,217,137,271,144,43,0,0,43,101,37,33,4,0,64,30,0,34,127,65,7,0,58,62,11,3,4,4,51,0,42,9,31301
10083,5597,1109,2166,1509,542,271,292,109,71,7,5,59,38,0,0,0,0,38,38,0,0,183,110,0,0,110,73,29,11,0,18,44,0,0,44,31302
10084,1483,280,636,389,77,101,77,58,50,21,0,29,8,0,0,0,0,8,0,0,8,19,19,0,0,19,0,0,0,0,0,0,0,0,0,31303
10085,0,0,0,0,0,0,0,0,0,0,0,0,0,0,0,0,0,0,0,0,0,0,0,0,0,0,0,0,0,0,0,0,0,0,0,31304
10086,4821,1000,1823,1427,423,148,553,326,158,4,0,154,168,160,77,83,0,8,0,0,8,227,160,0,120,40,67,67,0,0,67,0,0,0,0,31305
10087,496,178,122,173,23,0,27,0,0,0,0,0,0,0,0,0,0,0,0,0,0,27,27,0,0,27,0,0,0,0,0,0,0,0,0,31307
10088,4678,1069,1828,1174,430,177,375,237,170,57,4,109,67,67,14,0,53,0,0,0,0,138,111,0,3,108,27,27,0,5,22,0,0,0,0,31308
10089,655,126,153,300,60,16,112,82,17,0,0,17,65,65,65,0,0,0,0,0,0,30,30,11,0,19,0,0,0,0,0,0,0,0,0,31309
10090,9986,1393,3975,3190,979,449,1083,550,464,121,18,325,86,77,26,0,51,9,0,0,9,533,475,161,0,314,58,17,17,0,0,41,21,0,20,31312
10091,23450,1910,7248,9277,3427,1588,2283,1064,738,108,26,604,326,245,69,48,128,81,0,1,80,1219,990,214,83,693,229,216,86,23,107,13,0,0,13,31313
10092,279,0,113,128,38,0,265,261,0,0,0,0,261,261,261,0,0,0,0,0,0,4,0,0,0,0,4,4,4,0,0,0,0,0,0,31314
10093,3269,164,909,1590,454,152,339,174,81,0,0,81,93,93,72,21,0,0,0,0,0,165,85,2,0,83,80,50,0,0,50,30,0,17,13,31315
10094,6342,813,2497,2052,718,262,493,248,186,38,0,148,62,32,32,0,0,30,0,0,30,245,197,5,4,188,48,12,0,0,12,36,0,6,30,31316
10095,290,47,170,51,22,0,0,0,0,0,0,0,0,0,0,0,0,0,0,0,0,0,0,0,0,0,0,0,0,0,0,0,0,0,0,31318
10096,6240,723,2204,2032,864,417,306,153,141,2,4,135,12,9,6,3,0,3,3,0,0,153,66,11,6,49,87,46,17,29,0,41,37,0,4,31320
10097,3725,862,1416,908,359,180,290,186,151,56,21,74,35,24,15,0,9,11,0,9,2,104,85,0,6,79,19,6,3,3,0,13,0,0,13,31321
10098,14016,771,3265,4398,3592,1990,1073,380,365,167,0,198,15,15,15,0,0,0,0,0,0,693,639,206,31,402,54,54,28,0,26,0,0,0,0,31322
10099,1118,228,527,235,55,73,120,104,84,7,4,73,20,9,0,0,9,11,0,11,0,16,8,0,0,8,8,8,0,0,8,0,0,0,0,31323
10100,13404,818,2956,4434,3452,1744,1430,624,573,235,41,297,51,51,44,7,0,0,0,0,0,806,550,123,8,419,256,210,118,73,19,46,46,0,0,31324
10101,12179,1531,3906,4000,1745,997,1247,646,631,86,88,457,15,15,5,0,10,0,0,0,0,601,513,85,58,370,88,88,62,0,26,0,0,0,0,31326
10102,121,37,0,84,0,0,0,0,0,0,0,0,0,0,0,0,0,0,0,0,0,0,0,0,0,0,0,0,0,0,0,0,0,0,0,31327
10103,2867,290,632,818,613,514,72,21,21,0,0,21,0,0,0,0,0,0,0,0,0,51,36,0,0,36,15,15,0,0,15,0,0,0,0,31328
10104,6001,940,2489,1745,429,398,531,304,159,27,5,127,145,145,9,1,135,0,0,0,0,227,180,91,0,89,47,47,6,0,41,0,0,0,0,31329
10105,4631,870,1613,1177,471,500,271,45,45,21,0,24,0,0,0,0,0,0,0,0,0,226,118,62,0,56,108,108,90,0,18,0,0,0,0,31331
10106,11236,1811,2594,2634,2734,1463,2354,953,796,182,11,603,157,92,19,6,67,65,0,0,65,1401,1373,111,171,1091,28,21,20,0,1,7,0,0,7,31401
10107,19290,3190,7331,5289,2366,1114,2730,1428,1067,149,106,812,361,234,123,42,69,127,6,42,79,1302,1244,151,295,798,58,43,11,30,2,15,0,11,4,31404
10108,24281,2945,6252,7518,4747,2819,1927,1064,863,100,45,718,201,44,10,10,24,157,27,31,99,863,658,81,67,510,205,145,44,19,82,60,4,0,56,31405
10109,23389,2674,6902,7062,4426,2325,1752,851,634,76,23,535,217,102,12,79,11,115,57,38,20,901,677,158,115,404,224,60,20,23,17,164,67,44,53,31406
10110,5266,440,1409,1101,1349,967,58,49,49,11,0,38,0,0,0,0,0,0,0,0,0,9,6,6,0,0,3,3,3,0,0,0,0,0,0,31407
10111,6654,1412,2971,1677,401,193,399,255,165,37,13,115,90,49,40,0,9,41,0,0,41,144,95,22,0,73,49,3,0,3,0,46,0,46,0,31408
10112,63,0,27,23,13,0,59,44,7,7,0,0,37,37,27,0,10,0,0,0,0,15,0,0,0,0,15,15,15,0,0,0,0,0,0,31409
10113,17049,469,3417,5351,5210,2602,1039,677,599,141,72,386,78,78,38,26,14,0,0,0,0,362,326,11,5,310,36,35,35,0,0,1,0,0,1,31410
10114,6893,56,534,1357,2513,2433,220,151,151,0,0,151,0,0,0,0,0,0,0,0,0,69,69,0,6,63,0,0,0,0,0,0,0,0,0,31411
10115,7608,1900,3280,1723,497,208,721,380,280,40,19,221,100,63,11,35,17,37,18,6,13,341,289,32,0,257,52,48,21,18,9,4,0,0,4,31415
10116,34266,3326,8792,12775,6168,3205,3279,1447,1021,208,36,777,426,237,139,34,64,189,0,104,85,1832,1584,321,172,1091,248,187,47,92,48,61,23,38,0,31419
10117,10280,1886,3997,2637,984,776,608,409,315,78,0,237,94,56,23,24,9,38,0,0,38,199,158,64,23,71,41,27,0,0,27,14,0,0,14,31501
10118,14006,2629,6081,3756,835,705,1189,567,517,26,45,446,50,44,24,0,20,6,0,0,6,622,491,125,63,303,131,58,10,45,3,73,0,0,73,31503
10119,6804,1850,2605,1559,515,275,564,337,231,12,0,219,106,55,36,0,19,51,14,37,0,227,89,32,1,56,138,62,57,5,0,76,76,0,0,31510
10120,1670,269,537,525,249,90,58,12,10,0,0,10,2,2,0,2,0,0,0,0,0,46,46,5,0,41,0,0,0,0,0,0,0,0,0,31512
10121,10878,2623,4577,2230,951,497,991,634,348,112,0,236,286,137,102,35,0,149,107,0,42,357,247,73,18,156,110,101,0,0,101,9,0,0,9,31513
10122,9464,2132,3598,2558,604,572,799,412,312,33,22,257,100,82,31,36,15,18,18,0,0,387,313,68,9,236,74,49,0,0,49,25,0,0,25,31516
10123,413,96,203,85,5,24,13,0,0,0,0,0,0,0,0,0,0,0,0,0,0,13,13,0,3,10,0,0,0,0,0,0,0,0,0,31518
10124,2087,537,740,399,189,222,152,92,66,21,0,45,26,13,0,0,13,13,0,13,0,60,57,12,3,42,3,0,0,0,0,3,0,0,3,31519
10125,13850,3158,5044,3966,1022,660,1347,905,555,56,108,391,350,124,32,0,92,226,27,81,118,442,391,126,14,251,51,45,10,0,35,6,0,0,6,31520
10126,11979,427,1274,3513,3807,2958,413,218,200,78,0,122,18,0,0,0,0,18,0,0,18,195,177,82,0,95,18,18,18,0,0,0,0,0,0,31522
10127,8791,1021,2613,3118,1337,702,743,309,194,62,0,132,115,78,0,78,0,37,17,0,20,434,345,115,98,132,89,89,59,0,30,0,0,0,0,31523
10128,0,0,0,0,0,0,0,0,0,0,0,0,0,0,0,0,0,0,0,0,0,0,0,0,0,0,0,0,0,0,0,0,0,0,0,31524
10129,18704,2651,6653,6209,2016,1175,1281,574,401,13,41,347,173,162,141,21,0,11,0,0,11,707,488,179,66,243,219,141,39,59,43,78,47,3,28,31525
10130,652,54,19,269,182,128,0,0,0,0,0,0,0,0,0,0,0,0,0,0,0,0,0,0,0,0,0,0,0,0,0,0,0,0,0,31527
10131,595,99,348,101,2,45,133,97,97,22,0,75,0,0,0,0,0,0,0,0,0,36,14,0,0,14,22,22,6,1,15,0,0,0,0,31532
10132,10394,2505,3688,2638,796,767,975,453,376,63,34,279,77,66,43,0,23,11,0,0,11,522,441,104,47,290,81,45,45,0,0,36,0,18,18,31533
10133,7270,1533,2935,1991,501,310,835,367,312,39,9,264,55,36,0,0,36,19,0,19,0,468,365,96,21,248,103,103,0,38,65,0,0,0,0,31535
10134,7951,2134,3205,1791,478,343,477,264,233,96,0,137,31,2,0,0,2,29,0,0,29,213,203,59,12,132,10,0,0,0,0,10,10,0,0,31537
10135,9098,1889,3836,2516,569,288,663,352,213,26,12,175,139,37,0,37,0,102,69,0,33,311,199,72,10,117,112,37,37,0,0,75,0,18,57,31539
10136,1639,296,838,295,125,85,255,150,61,0,0,61,89,32,0,0,32,57,49,0,8,105,53,0,0,53,52,0,0,0,0,52,0,0,52,31542
10137,2563,554,1159,735,71,44,101,63,39,0,17,22,24,0,0,0,0,24,24,0,0,38,38,0,0,38,0,0,0,0,0,0,0,0,0,31543
10138,370,168,157,40,5,0,49,49,23,23,0,0,26,0,0,0,0,26,0,0,26,0,0,0,0,0,0,0,0,0,0,0,0,0,0,31544
10139,10286,1803,4091,3200,798,394,778,363,253,30,30,193,110,40,0,24,16,70,45,0,25,415,322,41,34,247,93,33,27,0,6,60,60,0,0,31545
10140,6071,1408,2336,1571,433,323,305,143,115,0,14,101,28,18,0,18,0,10,0,0,10,162,153,38,0,115,9,0,0,0,0,9,0,9,0,31546
10141,247,29,79,70,45,24,95,64,15,10,0,5,49,49,46,0,3,0,0,0,0,31,9,0,0,9,22,22,19,0,3,0,0,0,0,31547
10142,12715,1018,4223,5241,1586,647,1179,732,555,94,25,436,177,81,81,0,0,96,42,30,24,447,390,141,46,203,57,12,0,12,0,45,7,0,38,31548
10143,1030,282,515,189,30,14,156,106,64,6,0,58,42,42,0,0,42,0,0,0,0,50,28,0,0,28,22,22,0,0,22,0,0,0,0,31549
10144,417,38,231,78,10,60,60,0,0,0,0,0,0,0,0,0,0,0,0,0,0,60,60,43,0,17,0,0,0,0,0,0,0,0,0,31550
10145,621,178,279,103,27,34,31,0,0,0,0,0,0,0,0,0,0,0,0,0,0,31,31,0,0,31,0,0,0,0,0,0,0,0,0,31551
10146,728,234,230,216,15,33,78,41,30,10,8,12,11,11,11,0,0,0,0,0,0,37,37,37,0,0,0,0,0,0,0,0,0,0,0,31552
10147,3515,969,1589,768,107,82,239,75,75,2,0,73,0,0,0,0,0,0,0,0,0,164,88,17,0,71,76,0,0,0,0,76,0,27,49,31553
10148,5465,1802,2548,759,196,160,270,136,52,2,27,23,84,0,0,0,0,84,0,18,66,134,117,17,0,100,17,17,0,6,11,0,0,0,0,31554
10149,1852,311,926,428,94,93,300,205,119,0,0,119,86,0,0,0,0,86,0,0,86,95,94,42,0,52,1,1,0,0,1,0,0,0,0,31555
10150,61,28,19,11,0,3,0,0,0,0,0,0,0,0,0,0,0,0,0,0,0,0,0,0,0,0,0,0,0,0,0,0,0,0,0,31556
10151,1986,468,797,510,160,51,203,155,80,5,0,75,75,75,62,13,0,0,0,0,0,48,42,23,0,19,6,2,0,0,2,4,0,0,4,31557
10152,12126,919,3625,4893,1402,1287,1108,485,428,59,93,276,57,57,40,0,17,0,0,0,0,623,442,13,28,401,181,163,131,15,17,18,0,0,18,31558
10153,1874,219,972,501,127,55,78,47,43,0,0,43,4,4,0,4,0,0,0,0,0,31,17,11,2,4,14,0,0,0,0,14,11,0,3,31560
10154,299,0,62,64,173,0,144,15,15,0,0,15,0,0,0,0,0,0,0,0,0,129,129,114,15,0,0,0,0,0,0,0,0,0,0,31561
10155,1441,268,502,615,31,25,110,73,28,0,20,8,45,45,45,0,0,0,0,0,0,37,0,0,0,0,37,10,0,0,10,27,0,0,27,31562
10156,978,151,465,276,42,44,35,33,33,0,0,33,0,0,0,0,0,0,0,0,0,2,2,0,0,2,0,0,0,0,0,0,0,0,0,31563
10157,1121,273,389,195,228,36,51,33,33,0,0,33,0,0,0,0,0,0,0,0,0,18,18,18,0,0,0,0,0,0,0,0,0,0,0,31565
10158,2845,781,1191,675,116,82,272,125,75,32,0,43,50,0,0,0,0,50,0,50,0,147,125,0,0,125,22,22,22,0,0,0,0,0,0,31566
10159,724,143,360,129,83,9,44,32,32,0,0,32,0,0,0,0,0,0,0,0,0,12,0,0,0,0,12,0,0,0,0,12,0,0,12,31567
10160,695,162,315,141,63,14,65,29,29,6,0,23,0,0,0,0,0,0,0,0,0,36,0,0,0,0,36,36,0,36,0,0,0,0,0,31568
10161,3787,544,1244,1344,366,289,269,117,78,28,6,44,39,31,4,0,27,8,0,0,8,152,144,26,0,118,8,8,0,8,0,0,0,0,0,31569
10162,18656,4666,6926,5012,1292,760,2655,1225,776,172,123,481,449,215,51,94,70,234,36,0,198,1430,990,189,33,768,440,273,162,40,71,167,38,29,100,31601
10163,20225,2620,5333,6475,3761,2036,1787,1007,892,147,59,686,115,70,44,26,0,45,38,7,0,780,651,215,55,381,129,82,44,0,38,47,0,0,47,31602
10164,12146,925,2700,4622,2493,1406,1529,723,448,99,25,324,275,188,37,131,20,87,0,12,75,806,711,184,39,488,95,71,70,0,1,24,11,0,13,31605
10165,2587,505,1059,615,281,127,245,160,88,9,19,60,72,44,16,28,0,28,0,18,10,85,73,34,0,39,12,12,0,0,12,0,0,0,0,31606
10166,7155,1736,2589,1816,547,467,524,265,235,29,15,191,30,0,0,0,0,30,0,0,30,259,213,34,24,155,46,46,46,0,0,0,0,0,0,31620
10167,1236,220,452,466,55,43,86,29,29,0,0,29,0,0,0,0,0,0,0,0,0,57,19,0,0,19,38,38,0,0,38,0,0,0,0,31622
10168,66,37,22,7,0,0,8,5,0,0,0,0,5,0,0,0,0,5,0,5,0,3,0,0,0,0,3,3,0,0,3,0,0,0,0,31623
10169,632,211,194,170,32,25,14,14,14,0,0,14,0,0,0,0,0,0,0,0,0,0,0,0,0,0,0,0,0,0,0,0,0,0,0,31624
10170,1046,296,331,368,36,15,50,38,38,0,0,38,0,0,0,0,0,0,0,0,0,12,0,0,0,0,12,12,0,12,0,0,0,0,0,31625
10171,2618,654,980,541,272,171,138,45,39,12,8,19,6,6,0,6,0,0,0,0,0,93,57,0,22,35,36,24,24,0,0,12,0,0,12,31626
10172,141,56,40,38,7,0,6,0,0,0,0,0,0,0,0,0,0,0,0,0,0,6,6,0,0,6,0,0,0,0,0,0,0,0,0,31627
10173,594,127,217,193,33,24,37,26,26,0,23,3,0,0,0,0,0,0,0,0,0,11,11,0,1,10,0,0,0,0,0,0,0,0,0,31629
10174,242,45,97,34,22,44,102,25,25,0,0,25,0,0,0,0,0,0,0,0,0,77,56,0,0,56,21,21,0,21,0,0,0,0,0,31630
10175,444,149,197,73,18,7,8,2,2,0,0,2,0,0,0,0,0,0,0,0,0,6,3,3,0,0,3,0,0,0,0,3,0,0,3,31631
10176,6756,917,2098,2032,899,810,618,392,258,62,0,196,134,72,48,0,24,62,31,5,26,226,171,35,15,121,55,49,49,0,0,6,0,0,6,31632
10177,3685,1012,1551,651,234,237,227,121,98,16,0,82,23,23,0,23,0,0,0,0,0,106,83,20,22,41,23,0,0,0,0,23,23,0,0,31634
10178,3993,954,1205,1339,249,246,206,143,110,0,0,110,33,12,0,0,12,21,0,0,21,63,63,0,16,47,0,0,0,0,0,0,0,0,0,31635
10179,6225,1214,2416,1627,635,333,714,389,384,73,46,265,5,5,0,0,5,0,0,0,0,325,271,104,68,99,54,12,12,0,0,42,0,0,42,31636
10180,2141,474,842,621,114,90,198,131,100,0,0,100,31,7,4,0,3,24,13,0,11,67,63,17,0,46,4,4,0,0,4,0,0,0,0,31637
10181,727,199,266,172,65,25,10,2,1,1,0,0,1,1,0,0,1,0,0,0,0,8,8,0,2,6,0,0,0,0,0,0,0,0,0,31638
10182,7101,1640,2229,2310,529,393,622,230,226,15,25,186,4,4,4,0,0,0,0,0,0,392,392,15,40,337,0,0,0,0,0,0,0,0,0,31639
10183,1113,162,535,259,92,65,28,28,16,0,0,16,12,12,12,0,0,0,0,0,0,0,0,0,0,0,0,0,0,0,0,0,0,0,0,31641
10184,3015,1171,1151,503,105,85,390,165,101,7,0,94,64,6,6,0,0,58,35,0,23,225,135,0,14,121,90,42,0,0,42,48,3,40,5,31642
10185,5700,1208,2332,1432,498,230,554,366,297,85,24,188,69,64,31,29,4,5,1,2,2,188,163,22,36,105,25,22,0,8,14,3,0,0,3,31643
10186,3586,635,1089,1276,407,179,433,354,336,8,12,316,18,4,4,0,0,14,14,0,0,79,79,31,9,39,0,0,0,0,0,0,0,0,0,31645
10187,1884,617,705,381,98,83,207,118,72,0,11,61,46,29,7,0,22,17,17,0,0,89,31,14,8,9,58,11,11,0,0,47,0,0,47,31647
10188,639,179,248,189,8,15,64,36,36,14,0,22,0,0,0,0,0,0,0,0,0,28,28,0,10,18,0,0,0,0,0,0,0,0,0,31648
10189,916,292,249,251,61,63,25,0,0,0,0,0,0,0,0,0,0,0,0,0,0,25,15,0,0,15,10,0,0,0,0,10,0,0,10,31649
10190,1970,549,768,474,86,93,179,138,87,40,0,47,51,13,0,13,0,38,16,6,16,41,41,0,5,36,0,0,0,0,0,0,0,0,0,31650
10191,5,0,0,5,0,0,1235,229,229,22,62,145,0,0,0,0,0,0,0,0,0,1006,1006,97,71,838,0,0,0,0,0,0,0,0,0,31698
10192,40,0,18,17,5,0,72,47,2,2,0,0,45,45,45,0,0,0,0,0,0,25,0,0,0,0,25,25,25,0,0,0,0,0,0,31699
10193,13306,4056,3996,3810,872,572,1283,725,535,42,29,464,190,85,34,23,28,105,24,25,56,558,455,80,19,356,103,67,33,19,15,36,7,16,13,31701
10194,19650,5184,6007,6694,1130,635,3023,1494,1254,334,74,846,240,49,13,14,22,191,62,56,73,1529,1294,287,244,763,235,98,37,34,27,137,75,0,62,31705
10195,16525,2334,4997,5706,2039,1449,1584,688,540,103,91,346,148,39,38,0,1,109,36,24,49,896,838,310,137,391,58,58,17,37,4,0,0,0,0,31707
10196,9476,1763,3357,2191,1150,1015,862,506,466,122,81,263,40,12,7,5,0,28,19,9,0,356,347,65,24,258,9,9,0,0,9,0,0,0,0,31709
10197,517,212,102,161,20,22,128,43,0,0,0,0,43,0,0,0,0,43,0,22,21,85,2,0,0,2,83,0,0,0,0,83,0,0,83,31711
10198,734,92,333,211,83,15,17,10,5,0,0,5,5,0,0,0,0,5,0,5,0,7,7,3,0,4,0,0,0,0,0,0,0,0,0,31712
10199,4031,1273,1419,1043,134,162,353,247,235,0,0,235,12,0,0,0,0,12,0,0,12,106,84,0,0,84,22,22,0,22,0,0,0,0,0,31714
10200,1876,427,705,605,98,41,128,48,35,0,14,21,13,13,10,0,3,0,0,0,0,80,80,3,0,77,0,0,0,0,0,0,0,0,0,31716
10201,6597,1732,2178,1643,638,406,829,394,349,30,29,290,45,14,0,9,5,31,0,12,19,435,384,0,81,303,51,51,0,51,0,0,0,0,0,31719
10202,308,106,147,46,8,1,49,7,7,0,0,7,0,0,0,0,0,0,0,0,0,42,42,4,16,22,0,0,0,0,0,0,0,0,0,31720
10203,13131,1057,3081,4490,2359,2144,939,487,406,81,39,286,81,75,59,0,16,6,0,6,0,452,349,92,17,240,103,58,10,0,48,45,0,17,28,31721
10204,323,78,136,75,34,0,52,18,15,0,0,15,3,0,0,0,0,3,0,0,3,34,22,0,0,22,12,12,0,0,12,0,0,0,0,31722
10205,6155,1558,2511,1242,559,285,475,221,163,32,0,131,58,33,33,0,0,25,0,0,25,254,179,30,0,149,75,75,0,0,75,0,0,0,0,31730
10206,1457,118,562,538,87,152,105,55,41,10,0,31,14,0,0,0,0,14,0,0,14,50,39,33,0,6,11,0,0,0,0,11,11,0,0,31733
10207,567,141,170,144,47,65,49,5,5,0,0,5,0,0,0,0,0,0,0,0,0,44,0,0,0,0,44,44,0,0,44,0,0,0,0,31735
10208,1227,197,449,408,96,77,102,39,34,12,0,22,5,1,1,0,0,4,4,0,0,63,44,0,3,41,19,6,0,0,6,13,0,0,13,31738
10209,272,95,99,59,8,11,10,2,2,0,0,2,0,0,0,0,0,0,0,0,0,8,8,0,0,8,0,0,0,0,0,0,0,0,0,31743
10210,1741,408,600,459,219,55,110,52,42,5,10,27,10,0,0,0,0,10,0,0,10,58,47,2,2,43,11,2,0,0,2,9,0,0,9,31744
10211,104,57,27,13,2,5,6,3,3,0,0,3,0,0,0,0,0,0,0,0,0,3,3,0,0,3,0,0,0,0,0,0,0,0,0,31747
10212,1809,565,427,699,85,33,282,151,55,0,0,55,96,58,6,0,52,38,25,13,0,131,58,23,6,29,73,0,0,0,0,73,0,10,63,31749
10213,11926,2659,4643,3333,841,450,1169,533,359,0,53,306,174,92,92,0,0,82,11,48,23,636,451,55,30,366,185,122,39,0,83,63,0,0,63,31750
10214,864,247,355,152,62,48,142,41,41,0,0,41,0,0,0,0,0,0,0,0,0,101,101,101,0,0,0,0,0,0,0,0,0,0,0,31756
10215,7179,965,2972,2161,609,472,580,223,190,26,10,154,33,27,0,27,0,6,0,0,6,357,312,11,19,282,45,45,11,0,34,0,0,0,0,31757
10216,15467,2633,4533,5245,1783,1273,1212,713,617,62,83,472,96,77,40,0,37,19,0,19,0,499,457,204,13,240,42,23,15,0,8,19,12,0,7,31763
10217,988,250,362,262,55,59,122,29,28,4,0,24,1,1,0,0,1,0,0,0,0,93,84,14,5,65,9,9,0,0,9,0,0,0,0,31764
10218,1858,534,791,332,136,65,212,136,136,7,12,117,0,0,0,0,0,0,0,0,0,76,76,4,11,61,0,0,0,0,0,0,0,0,0,31765
10219,15425,4477,5775,3326,1143,704,1063,609,478,97,6,375,131,38,15,0,23,93,0,23,70,454,279,17,62,200,175,144,45,93,6,31,0,13,18,31768
10220,3746,902,1472,941,237,194,450,148,148,5,17,126,0,0,0,0,0,0,0,0,0,302,279,112,36,131,23,14,0,11,3,9,9,0,0,31771
10221,352,125,119,63,36,9,43,24,24,0,0,24,0,0,0,0,0,0,0,0,0,19,19,0,0,19,0,0,0,0,0,0,0,0,0,31772
10222,2488,746,914,667,104,57,313,162,116,27,0,89,46,26,14,12,0,20,0,0,20,151,135,19,8,108,16,16,0,0,16,0,0,0,0,31773
10223,4334,986,1816,1266,170,96,180,105,63,0,14,49,42,10,10,0,0,32,0,0,32,75,37,0,0,37,38,38,0,38,0,0,0,0,0,31774
10224,1811,587,788,298,104,34,52,26,26,6,0,20,0,0,0,0,0,0,0,0,0,26,17,0,5,12,9,0,0,0,0,9,9,0,0,31775
10225,1844,497,676,488,104,79,68,25,6,2,4,0,19,12,12,0,0,7,0,7,0,43,34,9,0,25,9,9,0,3,6,0,0,0,0,31778
10226,6882,1993,2877,1609,320,83,487,264,137,18,0,119,127,68,6,0,62,59,12,0,47,223,223,19,14,190,0,0,0,0,0,0,0,0,0,31779
10227,1453,482,505,298,125,43,170,82,49,11,0,38,33,33,25,0,8,0,0,0,0,88,88,27,0,61,0,0,0,0,0,0,0,0,0,31780
10228,1292,340,610,264,46,32,156,105,87,15,18,54,18,18,8,6,4,0,0,0,0,51,28,7,0,21,23,23,0,5,18,0,0,0,0,31781
10229,696,99,251,277,51,18,102,36,33,0,0,33,3,0,0,0,0,3,0,0,3,66,66,0,0,66,0,0,0,0,0,0,0,0,0,31783
10230,474,122,138,146,34,34,68,21,19,7,0,12,2,0,0,0,0,2,0,0,2,47,17,2,0,15,30,8,0,0,8,22,0,0,22,31784
10231,736,183,250,199,74,30,97,49,49,0,12,37,0,0,0,0,0,0,0,0,0,48,2,0,0,2,46,46,0,46,0,0,0,0,0,31787
10232,6003,1761,2098,1216,625,303,715,463,296,41,45,210,167,101,42,0,59,66,0,0,66,252,180,16,24,140,72,40,0,12,28,32,0,3,29,31788
10233,1145,344,461,282,52,6,116,84,54,0,0,54,30,27,0,27,0,3,0,0,3,32,31,11,0,20,1,0,0,0,0,1,0,0,1,31789
10234,1342,288,423,430,120,81,51,33,29,4,0,25,4,4,0,0,4,0,0,0,0,18,18,18,0,0,0,0,0,0,0,0,0,0,0,31790
10235,7773,2245,2820,1960,420,328,426,204,139,18,45,76,65,30,30,0,0,35,0,35,0,222,160,70,0,90,62,26,0,0,26,36,0,36,0,31791
10236,15519,2523,4680,4631,1991,1694,1189,657,546,80,174,292,111,45,0,17,28,66,1,25,40,532,398,127,106,165,134,45,16,0,29,89,0,89,0,31792
10237,5001,1002,1416,1323,674,586,1137,570,486,111,12,363,84,0,0,0,0,84,84,0,0,567,556,59,51,446,11,0,0,0,0,11,0,0,11,31793
10238,17093,4033,5764,4832,1238,1226,1458,803,713,138,77,498,90,29,8,0,21,61,0,0,61,655,564,117,39,408,91,19,0,0,19,72,72,0,0,31794
10239,1429,264,614,457,51,43,146,54,51,13,7,31,3,0,0,0,0,3,0,0,3,92,92,0,5,87,0,0,0,0,0,0,0,0,0,31795
10240,945,201,382,299,42,21,51,22,18,0,5,13,4,4,4,0,0,0,0,0,0,29,26,3,12,11,3,3,3,0,0,0,0,0,0,31796
10241,604,108,175,175,54,92,84,55,38,0,0,38,17,17,17,0,0,0,0,0,0,29,0,0,0,0,29,29,0,0,29,0,0,0,0,31798
10242,1805,456,669,516,138,26,55,28,16,0,0,16,12,12,0,0,12,0,0,0,0,27,13,0,0,13,14,14,0,0,14,0,0,0,0,31801
10243,4481,1115,1794,1023,329,220,356,242,127,0,0,127,115,4,0,0,4,111,40,0,71,114,92,27,0,65,22,0,0,0,0,22,0,0,22,31803
10244,4038,391,1242,1397,555,453,363,120,97,75,17,5,23,23,0,0,23,0,0,0,0,243,243,61,47,135,0,0,0,0,0,0,0,0,0,31804
10245,2020,296,856,708,74,86,331,179,86,0,29,57,93,0,0,0,0,93,0,0,93,152,143,19,17,107,9,9,0,0,9,0,0,0,0,31805
10246,3250,873,1175,723,304,175,346,121,100,16,4,80,21,12,0,0,12,9,0,0,9,225,194,69,9,116,31,7,0,0,7,24,0,0,24,31806
10247,1671,79,381,669,346,196,103,72,72,72,0,0,0,0,0,0,0,0,0,0,0,31,31,0,0,31,0,0,0,0,0,0,0,0,0,31807
10248,4523,253,1309,1351,873,737,399,213,205,29,67,109,8,8,8,0,0,0,0,0,0,186,186,53,0,133,0,0,0,0,0,0,0,0,0,31808
10249,178,30,72,67,9,0,0,0,0,0,0,0,0,0,0,0,0,0,0,0,0,0,0,0,0,0,0,0,0,0,0,0,0,0,0,31810
10250,3386,312,1084,1012,504,474,440,276,251,18,65,168,25,5,0,1,4,20,0,0,20,164,109,0,5,104,55,18,0,0,18,37,0,0,37,31811
10251,324,60,192,65,2,5,19,19,19,0,0,19,0,0,0,0,0,0,0,0,0,0,0,0,0,0,0,0,0,0,0,0,0,0,0,31812
10252,125,39,52,13,13,8,49,24,24,0,0,24,0,0,0,0,0,0,0,0,0,25,25,25,0,0,0,0,0,0,0,0,0,0,0,31814
10253,2073,843,708,285,166,71,129,97,34,21,0,13,63,29,22,0,7,34,0,0,34,32,32,0,0,32,0,0,0,0,0,0,0,0,0,31815
10254,3643,860,1495,899,249,140,501,311,217,0,0,217,94,8,0,8,0,86,0,0,86,190,108,0,0,108,82,18,18,0,0,64,0,0,64,31816
10255,5811,250,973,1972,1483,1133,603,272,267,57,0,210,5,5,5,0,0,0,0,0,0,331,276,27,16,233,55,55,13,42,0,0,0,0,0,31820
10256,262,75,171,16,0,0,0,0,0,0,0,0,0,0,0,0,0,0,0,0,0,0,0,0,0,0,0,0,0,0,0,0,0,0,0,31821
10257,3825,454,1410,1152,445,364,307,201,129,39,0,90,72,32,17,5,10,40,0,0,40,106,86,11,4,71,20,20,9,11,0,0,0,0,0,31822
10258,484,79,137,172,74,22,84,12,12,0,0,12,0,0,0,0,0,0,0,0,0,72,57,5,20,32,15,0,0,0,0,15,0,15,0,31823
10259,1213,234,577,293,32,77,111,88,88,20,0,68,0,0,0,0,0,0,0,0,0,23,23,0,0,23,0,0,0,0,0,0,0,0,0,31824
10260,2126,718,801,375,101,131,186,72,12,0,0,12,60,31,31,0,0,29,0,21,8,114,96,15,0,81,18,11,11,0,0,7,0,0,7,31825
10261,1994,356,840,582,174,42,147,78,70,0,0,70,8,8,8,0,0,0,0,0,0,69,30,11,2,17,39,32,32,0,0,7,7,0,0,31826
10262,1795,503,657,443,73,119,284,198,116,7,15,94,82,81,0,66,15,1,0,0,1,86,65,17,0,48,21,0,0,0,0,21,21,0,0,31827
10263,733,35,215,242,154,87,154,80,80,0,0,80,0,0,0,0,0,0,0,0,0,74,74,14,0,60,0,0,0,0,0,0,0,0,0,31829
10264,1396,295,462,477,112,50,139,49,46,12,0,34,3,3,0,0,3,0,0,0,0,90,84,5,24,55,6,6,0,0,6,0,0,0,0,31830
10265,2500,593,640,916,185,166,175,151,88,7,8,73,63,58,52,6,0,5,0,0,5,24,24,21,3,0,0,0,0,0,0,0,0,0,0,31831
10266,127,41,46,9,31,0,0,0,0,0,0,0,0,0,0,0,0,0,0,0,0,0,0,0,0,0,0,0,0,0,0,0,0,0,0,31832
10267,5348,1047,2193,1326,462,320,371,203,137,48,0,89,66,44,0,0,44,22,0,0,22,168,98,44,38,16,70,70,70,0,0,0,0,0,0,31833
10268,638,163,283,117,18,57,42,30,20,7,0,13,10,10,10,0,0,0,0,0,0,12,6,0,0,6,6,6,6,0,0,0,0,0,0,31836
10269,5096,1570,1307,1400,535,284,622,286,201,6,42,153,85,6,2,0,4,79,0,0,79,336,266,62,92,112,70,7,0,7,0,63,36,0,27,31901
10270,12974,3674,4749,3876,503,172,1685,976,551,127,35,389,425,361,314,21,26,64,18,2,44,709,600,108,107,385,109,103,7,15,81,6,0,0,6,31903
10271,22203,3606,6179,6542,3545,2331,1300,746,590,90,108,392,156,82,61,21,0,74,9,5,60,554,454,117,73,264,100,28,8,10,10,72,49,16,7,31904
10272,7028,323,1622,3254,1430,399,3325,2994,867,779,14,74,2127,2092,2069,0,23,35,35,0,0,331,268,7,7,254,63,63,24,14,25,0,0,0,0,31905
10273,13524,2410,3916,4097,1789,1312,1156,517,401,44,50,307,116,49,25,0,24,67,0,14,53,639,532,34,87,411,107,55,31,16,8,52,0,0,52,31906
10274,37013,4964,11043,14519,4174,2313,3462,1533,1227,269,87,871,306,117,16,59,42,189,32,20,137,1929,1712,467,96,1149,217,137,53,22,62,80,0,33,47,31907
10275,22846,1295,4902,8759,4989,2901,1668,676,595,114,34,447,81,33,16,17,0,48,6,22,20,992,848,211,126,511,144,131,43,56,32,13,13,0,0,31909
10276,18500,586,3409,5979,5575,2951,1980,857,776,58,113,605,81,51,9,0,42,30,30,0,0,1123,1072,319,117,636,51,51,37,0,14,0,0,0,0,32003
10277,4171,946,1888,964,290,83,271,169,166,64,0,102,3,3,3,0,0,0,0,0,0,102,88,14,25,49,14,0,0,0,0,14,0,14,0,32008
10278,1850,349,880,471,127,23,247,192,192,39,10,143,0,0,0,0,0,0,0,0,0,55,55,24,0,31,0,0,0,0,0,0,0,0,0,32009
10279,9841,1596,4322,2981,668,274,910,517,378,39,59,280,139,132,27,77,28,7,0,0,7,393,334,33,0,301,59,48,26,0,22,11,0,0,11,32011
10280,13654,2282,5021,4813,877,661,830,470,329,115,70,144,141,109,33,23,53,32,0,0,32,360,301,42,50,209,59,50,0,0,50,9,0,0,9,32024
10281,15039,2752,4907,5213,1192,975,1228,482,321,30,63,228,161,81,27,0,54,80,0,0,80,746,543,121,47,375,203,194,164,30,0,9,5,4,0,32025
10282,706,378,199,114,15,0,18,18,0,0,0,0,18,4,0,0,4,14,0,0,14,0,0,0,0,0,0,0,0,0,0,0,0,0,0,32026
10283,3262,299,982,1157,583,241,194,129,121,0,0,121,8,0,0,0,0,8,0,0,8,65,65,63,0,2,0,0,0,0,0,0,0,0,0,32033
10284,23965,1305,6443,7690,5768,2759,1029,478,408,63,29,316,70,28,28,0,0,42,0,42,0,551,445,167,28,250,106,90,90,0,0,16,0,0,16,32034
10285,5931,1023,1857,2370,384,297,383,237,158,19,10,129,79,79,0,31,48,0,0,0,0,146,127,27,23,77,19,5,5,0,0,14,0,0,14,32038
10286,4723,700,2471,1190,175,187,441,236,224,50,4,170,12,12,12,0,0,0,0,0,0,205,175,70,30,75,30,22,14,8,0,8,0,8,0,32040
10287,16918,2327,5387,6170,2159,875,1396,713,576,184,31,361,137,91,37,16,38,46,0,8,38,683,615,79,76,460,68,57,17,33,7,11,0,0,11,32043
10288,1507,400,526,577,2,2,46,23,23,0,0,23,0,0,0,0,0,0,0,0,0,23,23,1,0,22,0,0,0,0,0,0,0,0,0,32044
10289,5933,1028,2477,1897,394,137,746,419,377,58,0,319,42,42,35,7,0,0,0,0,0,327,280,90,30,160,47,14,14,0,0,33,0,33,0,32046
10290,5746,1506,2315,1465,351,109,471,388,101,6,44,51,287,99,63,0,36,188,0,23,165,83,29,5,0,24,54,36,36,0,0,18,0,8,10,32052
10291,2779,725,957,771,253,73,263,141,79,0,2,77,62,33,9,18,6,29,10,10,9,122,97,5,0,92,25,0,0,0,0,25,8,0,17,32053
10292,8039,1828,3141,2210,604,256,721,505,329,0,38,291,176,101,46,0,55,75,2,0,73,216,183,0,0,183,33,19,13,6,0,14,0,0,14,32054
10293,11121,2308,3918,3351,1112,432,794,414,374,153,0,221,40,15,0,0,15,25,0,0,25,380,336,112,86,138,44,23,23,0,0,21,0,0,21,32055
10294,3516,958,1548,773,171,66,142,88,70,0,35,35,18,0,0,0,0,18,0,0,18,54,32,10,0,22,22,22,13,9,0,0,0,0,0,32058
10295,1430,182,527,601,91,29,77,48,44,0,12,32,4,0,0,0,0,4,0,4,0,29,29,0,0,29,0,0,0,0,0,0,0,0,0,32059
10296,16089,2949,7294,4160,1201,485,1013,558,376,45,40,291,182,134,44,23,67,48,0,0,48,455,383,63,32,288,72,72,36,0,36,0,0,0,0,32060
10297,88,0,47,41,0,0,20,0,0,0,0,0,0,0,0,0,0,0,0,0,0,20,20,0,11,9,0,0,0,0,0,0,0,0,0,32061
10298,1403,230,647,381,68,77,52,0,0,0,0,0,0,0,0,0,0,0,0,0,0,52,52,0,0,52,0,0,0,0,0,0,0,0,0,32062
10299,9016,1733,3934,2139,797,413,816,430,350,66,56,228,80,57,13,0,44,23,0,0,23,386,314,38,0,276,72,72,0,33,39,0,0,0,0,32063
10300,4425,1302,1918,801,277,127,213,162,145,0,19,126,17,17,0,0,17,0,0,0,0,51,40,16,0,24,11,11,0,11,0,0,0,0,0,32064
10301,21581,1970,5360,8213,4311,1727,2477,1514,1363,358,233,772,151,56,19,7,30,95,65,30,0,963,898,180,34,684,65,29,0,0,29,36,0,0,36,32065
10302,4620,1020,1725,1493,231,151,504,198,130,63,22,45,68,68,0,57,11,0,0,0,0,306,271,74,33,164,35,29,0,0,29,6,0,0,6,32066
10303,32130,3753,10800,12359,3690,1528,2781,1464,1111,171,190,750,353,311,2,271,38,42,37,0,5,1317,1093,239,347,507,224,123,35,23,65,101,49,0,52,32068
10304,1796,217,804,623,87,65,233,169,112,25,0,87,57,0,0,0,0,57,0,0,57,64,64,0,0,64,0,0,0,0,0,0,0,0,0,32071
10305,150,0,128,22,0,0,13,0,0,0,0,0,0,0,0,0,0,0,0,0,0,13,13,0,0,13,0,0,0,0,0,0,0,0,0,32072
10306,26701,2182,7740,10825,3861,2093,2268,1190,935,288,110,537,255,140,4,136,0,115,74,23,18,1078,890,224,74,592,188,161,94,67,0,27,13,0,14,32073
10307,293,50,79,43,38,83,0,0,0,0,0,0,0,0,0,0,0,0,0,0,0,0,0,0,0,0,0,0,0,0,0,0,0,0,0,32079
10308,17002,541,3226,5040,4844,3351,885,436,356,197,0,159,80,30,30,0,0,50,9,0,41,449,398,243,47,108,51,51,16,0,35,0,0,0,0,32080
10309,2840,103,248,674,1147,668,210,64,64,20,14,30,0,0,0,0,0,0,0,0,0,146,105,32,0,73,41,41,0,0,41,0,0,0,0,32081
10310,22164,522,2664,5437,8378,5163,1592,881,874,401,8,465,7,7,0,7,0,0,0,0,0,711,700,157,15,528,11,0,0,0,0,11,0,0,11,32082
10311,3858,1511,1151,947,184,65,178,106,54,5,0,49,52,22,9,10,3,30,0,0,30,72,39,4,2,33,33,24,9,15,0,9,9,0,0,32083
10312,21010,2761,6360,6661,3355,1873,2087,981,820,75,32,713,161,47,47,0,0,114,46,0,68,1106,1048,298,10,740,58,38,38,0,0,20,12,8,0,32084
10313,18601,1519,5307,6852,3356,1567,1118,654,602,87,23,492,52,41,18,21,2,11,0,0,11,464,409,103,89,217,55,48,48,0,0,7,0,7,0,32086
10314,3480,1012,1689,609,68,102,247,150,104,0,41,63,46,46,0,46,0,0,0,0,0,97,70,0,0,70,27,0,0,0,0,27,0,0,27,32087
10315,10247,2063,3913,3219,638,414,817,358,310,40,17,253,48,3,3,0,0,45,8,25,12,459,341,67,36,238,118,107,0,0,107,11,0,11,0,32091
10316,19104,1219,4058,5586,6106,2135,1594,1066,998,364,50,584,68,67,67,0,0,1,0,0,1,528,385,104,12,269,143,143,70,18,55,0,0,0,0,32092
10317,1683,287,629,559,142,66,104,70,70,0,0,70,0,0,0,0,0,0,0,0,0,34,34,25,0,9,0,0,0,0,0,0,0,0,0,32094
10318,4740,599,1463,1395,871,412,235,134,77,0,0,77,57,24,24,0,0,33,0,0,33,101,101,32,0,69,0,0,0,0,0,0,0,0,0,32095
10319,1850,249,1007,415,81,98,117,79,73,17,23,33,6,2,0,2,0,4,4,0,0,38,38,15,0,23,0,0,0,0,0,0,0,0,0,32096
10320,10760,1245,4232,3469,1165,649,683,279,197,35,0,162,82,54,54,0,0,28,0,20,8,404,384,212,20,152,20,0,0,0,0,20,0,2,18,32097
10321,1711,573,599,423,64,52,57,46,33,0,0,33,13,9,9,0,0,4,0,0,4,11,11,0,0,11,0,0,0,0,0,0,0,0,0,32102
10322,5278,905,2385,1576,324,88,446,189,147,27,0,120,42,35,16,10,9,7,0,0,7,257,204,111,17,76,53,36,4,32,0,17,0,0,17,32110
10323,5505,1884,1937,1223,303,158,388,192,164,12,6,146,28,28,22,0,6,0,0,0,0,196,108,3,4,101,88,31,20,3,8,57,0,0,57,32112
10324,4241,897,1661,1064,445,174,259,96,85,25,30,30,11,11,4,0,7,0,0,0,0,163,160,0,0,160,3,0,0,0,0,3,0,0,3,32113
10325,19857,3392,6371,6927,2253,914,3612,2175,2032,311,107,1614,143,108,35,0,73,35,8,0,27,1437,1347,290,84,973,90,48,48,0,0,42,8,0,34,32114
10326,17749,3949,6729,4873,1442,756,993,538,480,73,58,349,58,26,0,0,26,32,7,11,14,455,402,107,0,295,53,45,2,0,43,8,0,0,8,32117
10327,13590,1143,4261,4559,2203,1424,277,132,106,31,0,75,26,26,26,0,0,0,0,0,0,145,111,26,33,52,34,33,1,17,15,1,0,0,1,32118
10328,14840,1615,5039,5544,1822,820,937,349,266,93,27,146,83,48,42,0,6,35,35,0,0,588,477,166,15,296,111,68,26,42,0,43,0,5,38,32119
10329,3929,779,1249,1231,350,320,321,251,148,0,0,148,103,36,0,0,36,67,0,0,67,70,41,16,0,25,29,26,0,26,0,3,0,0,3,32124
10330,23098,2391,7728,7714,3465,1800,1458,715,641,290,0,351,74,37,0,37,0,37,16,21,0,743,694,230,77,387,49,49,38,0,11,0,0,0,0,32127
10331,12658,653,3228,4363,2645,1769,507,242,234,9,0,225,8,8,8,0,0,0,0,0,0,265,202,30,22,150,63,63,63,0,0,0,0,0,0,32128
10332,15266,1912,5501,5074,1983,796,585,179,168,11,23,134,11,0,0,0,0,11,0,0,11,406,298,89,20,189,108,43,34,9,0,65,0,0,65,32129
10333,3969,937,1292,1155,417,168,199,67,67,11,11,45,0,0,0,0,0,0,0,0,0,132,78,0,62,16,54,54,0,0,54,0,0,0,0,32130
10334,3156,525,1159,886,384,202,157,103,80,10,21,49,23,23,0,23,0,0,0,0,0,54,54,20,0,34,0,0,0,0,0,0,0,0,0,32131
10335,5174,643,1931,1771,528,301,175,66,66,22,13,31,0,0,0,0,0,0,0,0,0,109,109,37,25,47,0,0,0,0,0,0,0,0,0,32132
10336,77,0,38,39,0,0,0,0,0,0,0,0,0,0,0,0,0,0,0,0,0,0,0,0,0,0,0,0,0,0,0,0,0,0,0,32133
10337,5957,1281,2690,1611,180,195,564,226,172,88,31,53,54,54,23,5,26,0,0,0,0,338,235,48,5,182,103,42,42,0,0,61,16,0,45,32134
10338,6185,370,1945,2112,1180,578,219,93,86,0,16,70,7,7,0,7,0,0,0,0,0,126,126,8,0,118,0,0,0,0,0,0,0,0,0,32136
10339,27945,2312,8838,9307,4953,2535,1324,771,649,121,25,503,122,77,16,13,48,45,0,45,0,553,463,140,47,276,90,60,31,0,29,30,10,11,9,32137
10340,960,282,439,153,51,35,36,22,22,0,0,22,0,0,0,0,0,0,0,0,0,14,14,14,0,0,0,0,0,0,0,0,0,0,0,32139
10341,836,136,334,209,148,9,0,0,0,0,0,0,0,0,0,0,0,0,0,0,0,0,0,0,0,0,0,0,0,0,0,0,0,0,0,32140
10342,13975,1257,5405,5252,1323,738,734,410,353,31,70,252,57,57,28,29,0,0,0,0,0,324,264,100,35,129,60,37,9,0,28,23,0,0,23,32141
10343,3397,715,1437,871,261,113,418,259,215,60,0,155,44,41,33,0,8,3,0,0,3,159,138,39,38,61,21,5,0,0,5,16,0,0,16,32145
10344,20,0,8,12,0,0,0,0,0,0,0,0,0,0,0,0,0,0,0,0,0,0,0,0,0,0,0,0,0,0,0,0,0,0,0,32147
10345,7699,2140,2904,2158,314,183,509,278,203,56,11,136,75,37,7,0,30,38,0,21,17,231,202,29,0,173,29,13,3,0,10,16,0,0,16,32148
10346,246,63,136,47,0,0,27,0,0,0,0,0,0,0,0,0,0,0,0,0,0,27,27,0,0,27,0,0,0,0,0,0,0,0,0,32157
10347,25181,2753,9277,7515,3375,2261,706,343,206,31,27,148,137,62,34,28,0,75,38,0,37,363,354,20,55,279,9,9,9,0,0,0,0,0,0,32159
10348,49315,2194,13014,16820,10049,7238,2,0,0,0,0,0,0,0,0,0,0,0,0,0,0,2,2,0,0,2,0,0,0,0,0,0,0,0,0,32162
10349,31588,3446,10743,10789,4605,2005,2362,971,781,104,132,545,190,129,19,0,110,61,13,26,22,1391,1161,415,35,711,230,192,21,105,66,38,0,0,38,32164
10350,18764,1868,6614,6099,2904,1279,909,547,499,162,14,323,48,15,15,0,0,33,10,23,0,362,331,42,18,271,31,31,18,0,13,0,0,0,0,32168
10351,8659,499,1893,3000,1733,1534,249,194,159,4,8,147,35,26,12,0,14,9,0,0,9,55,43,29,0,14,12,3,0,0,3,9,9,0,0,32169
10352,36340,2720,10212,12941,6129,4338,1758,800,645,231,67,347,155,99,46,35,18,56,29,0,27,958,813,273,0,540,145,56,55,1,0,89,32,0,57,32174
10353,11829,944,3237,3958,2021,1669,465,219,159,57,0,102,60,31,31,0,0,29,0,10,19,246,201,65,52,84,45,45,0,6,39,0,0,0,0,32176
10354,16984,3236,7261,4410,1496,581,1757,836,510,33,85,392,326,129,22,29,78,197,72,0,125,921,769,97,56,616,152,112,32,55,25,40,0,0,40,32177
10355,5156,1096,2007,1618,292,143,266,181,157,0,34,123,24,24,0,0,24,0,0,0,0,85,85,39,0,46,0,0,0,0,0,0,0,0,0,32179
10356,2673,965,819,644,140,105,280,162,108,18,10,80,54,3,0,0,3,51,0,0,51,118,59,0,9,50,59,53,21,4,28,6,0,0,6,32180
10357,1643,443,700,395,53,52,139,93,67,13,6,48,26,21,19,2,0,5,0,0,5,46,40,5,12,23,6,6,0,0,6,0,0,0,0,32181
10358,1453,418,505,439,70,21,58,41,41,17,0,24,0,0,0,0,0,0,0,0,0,17,17,17,0,0,0,0,0,0,0,0,0,0,0,32187
10359,4785,1175,2216,885,285,224,171,29,29,15,0,14,0,0,0,0,0,0,0,0,0,142,126,15,12,99,16,16,16,0,0,0,0,0,0,32189
10360,395,131,89,91,66,18,27,27,24,15,0,9,3,3,3,0,0,0,0,0,0,0,0,0,0,0,0,0,0,0,0,0,0,0,0,32190
10361,843,136,323,192,109,83,77,22,22,4,0,18,0,0,0,0,0,0,0,0,0,55,19,2,0,17,36,36,0,0,36,0,0,0,0,32193
10362,2421,359,1079,786,98,99,92,63,63,22,0,41,0,0,0,0,0,0,0,0,0,29,14,0,0,14,15,15,0,15,0,0,0,0,0,32195
10363,4591,1413,1358,1378,210,232,284,238,69,0,0,69,169,39,0,39,0,130,0,0,130,46,31,0,0,31,15,0,0,0,0,15,0,0,15,32202
10364,4923,575,1207,1458,1074,609,94,52,50,0,10,40,2,0,0,0,0,2,0,0,2,42,42,0,0,42,0,0,0,0,0,0,0,0,0,32204
10365,20418,2566,5510,6838,3542,1962,1351,675,452,65,0,387,223,153,59,43,51,70,27,13,30,676,484,35,101,348,192,111,28,48,35,81,10,0,71,32205
10366,11328,2999,3805,2663,1322,539,940,529,373,25,23,325,156,85,58,8,19,71,0,22,49,411,330,37,10,283,81,46,28,0,18,35,0,0,35,32206
10367,23143,3564,5706,7206,4161,2506,1065,482,397,64,78,255,85,77,27,0,50,8,0,0,8,583,515,82,29,404,68,58,8,0,50,10,0,0,10,32207
10368,20426,4102,8406,5392,1673,853,1816,1208,879,36,106,737,329,252,23,0,229,77,13,6,58,608,475,26,157,292,133,109,43,38,28,24,0,14,10,32208
10369,21318,5521,8202,4997,1995,603,2505,1100,791,61,113,617,309,105,9,5,91,204,8,0,196,1405,1110,143,51,916,295,114,45,7,62,181,9,0,172,32209
10370,38593,5583,11642,13626,5563,2179,2681,1433,970,109,72,789,463,297,171,110,16,166,10,33,123,1248,1032,142,136,754,216,177,95,48,34,39,11,21,7,32210
10371,19917,2669,7159,7020,2340,729,1551,835,665,69,42,554,170,98,22,0,76,72,35,22,15,716,643,121,11,511,73,73,73,0,0,0,0,0,0,32211
10372,679,27,257,242,139,14,115,115,11,11,0,0,104,104,104,0,0,0,0,0,0,0,0,0,0,0,0,0,0,0,0,0,0,0,0,32212
10373,24246,2550,7588,7377,5224,1507,1293,643,577,52,60,465,66,66,66,0,0,0,0,0,0,650,539,297,15,227,111,70,30,13,27,41,29,0,12,32216
10374,13556,1944,2603,4434,3011,1564,973,464,358,100,0,258,106,105,95,10,0,1,0,0,1,509,459,37,8,414,50,31,31,0,0,19,0,0,19,32217
10375,34403,4917,11170,11648,4634,2034,3439,1700,1284,217,39,1028,416,234,136,11,87,182,52,12,118,1739,1372,124,140,1108,367,149,45,55,49,218,6,0,212,32218
10376,7780,1343,2558,2547,965,367,652,194,154,17,0,137,40,38,0,38,0,2,0,0,2,458,329,114,58,157,129,102,0,0,102,27,17,0,10,32219
10377,9426,1249,4221,2703,995,258,607,356,304,29,102,173,52,22,22,0,0,30,17,0,13,251,210,68,19,123,41,41,7,0,34,0,0,0,0,32220
10378,18692,2476,6416,6660,2465,675,1620,639,550,22,52,476,89,43,0,9,34,46,46,0,0,981,728,117,55,556,253,197,65,45,87,56,24,15,17,32221
10379,6410,664,2168,2699,581,298,693,231,231,105,33,93,0,0,0,0,0,0,0,0,0,462,406,13,106,287,56,37,37,0,0,19,0,0,19,32222
10380,18087,881,4177,6219,4641,2169,1000,430,414,151,33,230,16,16,0,0,16,0,0,0,0,570,527,243,43,241,43,43,21,0,22,0,0,0,0,32223
10381,22717,943,4091,7339,7129,3215,3121,1432,1194,307,77,810,238,223,198,0,25,15,0,15,0,1689,1556,355,180,1021,133,89,50,39,0,44,0,0,44,32224
10382,36055,2807,9098,13072,7842,3236,2370,1188,923,192,123,608,265,238,111,0,127,27,0,27,0,1182,927,159,53,715,255,238,192,0,46,17,17,0,0,32225
10383,10929,1220,3470,3910,1504,825,684,263,251,13,18,220,12,12,0,0,12,0,0,0,0,421,357,39,14,304,64,64,17,0,47,0,0,0,0,32226
10384,1007,27,320,550,53,57,129,84,17,0,0,17,67,67,67,0,0,0,0,0,0,45,32,19,0,13,13,13,0,0,13,0,0,0,0,32227
10385,41,0,31,10,0,0,19,19,0,0,0,0,19,19,19,0,0,0,0,0,0,0,0,0,0,0,0,0,0,0,0,0,0,0,0,32228
10386,15804,1653,4020,4863,3388,1880,1327,679,548,93,46,409,131,93,93,0,0,38,0,0,38,648,507,93,23,391,141,141,127,14,0,0,0,0,0,32233
10387,3945,766,1569,1329,251,30,313,209,196,45,20,131,13,6,0,6,0,7,7,0,0,104,96,14,7,75,8,4,0,0,4,4,0,4,0,32234
10388,37822,4906,11442,14496,5448,1530,3069,1808,1659,304,199,1156,149,141,79,0,62,8,0,6,2,1261,1091,474,126,491,170,36,15,0,21,134,26,75,33,32244
10389,32632,4364,9019,10233,6564,2452,2758,1252,1001,146,138,717,251,169,69,0,100,82,0,14,68,1506,1372,377,55,940,134,116,0,16,100,18,0,0,18,32246
10390,19273,1336,4142,6460,4800,2535,843,426,349,41,18,290,77,0,0,0,0,77,31,0,46,417,370,129,0,241,47,36,36,0,0,11,0,0,11,32250
10391,8152,2303,3395,2078,306,70,1095,515,358,0,62,296,157,67,0,38,29,90,24,0,66,580,394,33,26,335,186,117,40,0,77,69,0,18,51,32254
10392,27426,940,4325,8087,8917,5157,1567,833,824,135,105,584,9,9,0,9,0,0,0,0,0,734,636,171,17,448,98,67,11,0,56,31,31,0,0,32256
10393,24843,1482,6880,8537,5172,2772,1958,959,891,194,136,561,68,44,15,17,12,24,0,0,24,999,884,273,61,550,115,76,68,8,0,39,0,0,39,32257
10394,18905,972,3240,6859,5205,2629,942,525,421,88,102,231,104,104,18,36,50,0,0,0,0,417,417,166,47,204,0,0,0,0,0,0,0,0,0,32258
10395,24669,1027,3429,7983,8771,3459,2747,1237,1055,225,97,733,182,171,145,0,26,11,11,0,0,1510,1420,331,114,975,90,78,19,31,28,12,0,0,12,32259
10396,4898,100,712,1617,1517,952,297,168,147,59,14,74,21,21,21,0,0,0,0,0,0,129,86,0,0,86,43,43,27,16,0,0,0,0,0,32266
10397,18145,1543,5889,6460,3121,1132,2059,1147,1075,246,101,728,72,66,22,44,0,6,0,6,0,912,845,151,77,617,67,45,9,0,36,22,0,0,22,32277
10398,15643,931,2920,4898,4077,2817,2928,1008,916,196,124,596,92,69,22,15,32,23,0,23,0,1920,1854,389,222,1243,66,40,0,25,15,26,0,9,17,32301
10399,27529,1942,5562,8711,6940,4374,2603,1287,1025,172,115,738,262,148,139,0,9,114,52,0,62,1316,1302,383,108,811,14,14,7,0,7,0,0,0,0,32303
10400,13079,2498,2822,4274,2436,1049,9678,4296,4008,435,1008,2565,288,172,69,33,70,116,19,59,38,5382,5188,1171,622,3395,194,172,72,0,100,22,13,0,9,32304
10401,11940,2147,4157,3755,1084,797,1192,447,354,25,85,244,93,79,16,30,33,14,12,0,2,745,655,178,159,318,90,77,0,38,39,13,0,0,13,32305
10402,16090,844,2750,3892,4225,4379,728,437,433,85,91,257,4,0,0,0,0,4,0,0,4,291,278,50,27,201,13,13,0,0,13,0,0,0,0,32308
10403,21619,1020,3201,5403,6766,5229,1731,904,841,204,29,608,63,58,24,0,34,5,0,0,5,827,739,121,19,599,88,57,57,0,0,31,0,0,31,32309
10404,10081,1832,3250,2565,1461,973,1563,1131,1057,87,226,744,74,25,0,25,0,49,0,4,45,432,393,33,162,198,39,30,0,0,30,9,0,9,0,32310
10405,13768,864,2644,3840,3638,2782,823,427,377,53,89,235,50,0,0,0,0,50,20,0,30,396,298,80,11,207,98,78,30,12,36,20,0,0,20,32311
10406,21661,756,2838,5000,7062,6005,1795,751,694,157,29,508,57,51,43,8,0,6,0,0,6,1044,1044,329,121,594,0,0,0,0,0,0,0,0,0,32312
10407,9099,349,1303,2547,2916,1984,640,290,290,22,0,268,0,0,0,0,0,0,0,0,0,350,285,63,3,219,65,0,0,0,0,65,0,0,65,32317
10408,2422,449,1058,574,276,65,123,91,61,0,9,52,30,2,2,0,0,28,2,0,26,32,32,22,10,0,0,0,0,0,0,0,0,0,0,32320
10409,4289,1049,1727,916,339,258,395,327,316,0,171,145,11,0,0,0,0,11,0,11,0,68,65,0,0,65,3,3,3,0,0,0,0,0,0,32321
10410,3403,921,1336,860,216,70,76,69,28,0,0,28,41,0,0,0,0,41,0,41,0,7,7,0,0,7,0,0,0,0,0,0,0,0,0,32322
10411,190,10,89,91,0,0,0,0,0,0,0,0,0,0,0,0,0,0,0,0,0,0,0,0,0,0,0,0,0,0,0,0,0,0,0,32323
10412,3771,1163,1348,905,189,166,226,105,36,0,9,27,69,45,45,0,0,24,0,0,24,121,79,0,23,56,42,11,0,0,11,31,0,0,31,32324
10413,19134,2358,7126,6416,2051,1183,1312,664,583,197,0,386,81,81,46,27,8,0,0,0,0,648,549,144,134,271,99,47,26,21,0,52,0,13,39,32327
10414,2463,445,669,807,374,168,147,59,43,11,0,32,16,7,0,7,0,9,9,0,0,88,76,59,0,17,12,12,12,0,0,0,0,0,0,32328
10415,563,290,161,65,42,5,10,4,4,0,4,0,0,0,0,0,0,0,0,0,0,6,3,0,0,3,3,0,0,0,0,3,0,0,3,32330
10416,3465,852,1456,775,215,167,256,123,91,0,0,91,32,32,5,25,2,0,0,0,0,133,110,6,19,85,23,23,23,0,0,0,0,0,0,32331
10417,1048,341,405,188,86,28,135,63,50,17,4,29,13,8,0,4,4,5,0,0,5,72,72,0,0,72,0,0,0,0,0,0,0,0,0,32332
10418,7703,1041,2529,2575,1063,495,406,276,192,23,14,155,84,54,3,0,51,30,10,0,20,130,102,12,0,90,28,24,0,0,24,4,0,4,0,32333
10419,1229,298,553,266,112,0,112,60,20,0,6,14,40,40,13,27,0,0,0,0,0,52,52,0,0,52,0,0,0,0,0,0,0,0,0,32334
10420,1043,240,376,310,79,38,152,79,36,5,0,31,43,22,22,0,0,21,0,0,21,73,37,0,18,19,36,36,0,36,0,0,0,0,0,32336
10421,8010,1813,3024,2384,462,327,522,217,128,5,37,86,89,22,0,22,0,67,36,0,31,305,278,63,5,210,27,0,0,0,0,27,0,27,0,32340
10422,1921,168,743,579,266,165,215,116,116,13,18,85,0,0,0,0,0,0,0,0,0,99,68,0,0,68,31,31,31,0,0,0,0,0,0,32343
10423,9675,1797,3289,2973,1069,547,580,270,240,15,28,197,30,15,15,0,0,15,0,0,15,310,297,63,37,197,13,13,0,0,13,0,0,0,0,32344
10424,1258,123,450,355,170,160,49,36,30,0,0,30,6,0,0,0,0,6,0,0,6,13,13,0,0,13,0,0,0,0,0,0,0,0,0,32346
10425,5483,1017,2119,1732,413,202,416,205,176,43,18,115,29,29,0,29,0,0,0,0,0,211,178,37,0,141,33,33,12,21,0,0,0,0,0,32347
10426,8964,2411,3458,2027,593,475,514,338,257,81,0,176,81,52,32,20,0,29,0,0,29,176,75,12,14,49,101,23,0,0,23,78,0,0,78,32348
10427,1210,301,360,444,72,33,116,0,0,0,0,0,0,0,0,0,0,0,0,0,0,116,116,43,0,73,0,0,0,0,0,0,0,0,0,32350
10428,12761,3227,4826,3090,956,662,826,325,233,45,7,181,92,63,32,31,0,29,0,0,29,501,320,22,26,272,181,104,0,0,104,77,17,13,47,32351
10429,4195,1057,1304,1182,281,371,339,148,116,0,17,99,32,0,0,0,0,32,0,0,32,191,191,40,21,130,0,0,0,0,0,0,0,0,0,32352
10430,204,19,86,58,40,1,7,0,0,0,0,0,0,0,0,0,0,0,0,0,0,7,7,0,0,7,0,0,0,0,0,0,0,0,0,32355
10431,78,32,0,46,0,0,0,0,0,0,0,0,0,0,0,0,0,0,0,0,0,0,0,0,0,0,0,0,0,0,0,0,0,0,0,32356
10432,1347,160,646,320,166,55,59,21,6,0,6,0,15,0,0,0,0,15,0,0,15,38,38,34,0,4,0,0,0,0,0,0,0,0,0,32358
10433,1297,165,301,676,101,54,15,0,0,0,0,0,0,0,0,0,0,0,0,0,0,15,15,0,15,0,0,0,0,0,0,0,0,0,0,32359
10434,65,10,0,4,13,38,0,0,0,0,0,0,0,0,0,0,0,0,0,0,0,0,0,0,0,0,0,0,0,0,0,0,0,0,0,32361
10435,0,0,0,0,0,0,0,0,0,0,0,0,0,0,0,0,0,0,0,0,0,0,0,0,0,0,0,0,0,0,0,0,0,0,0,32399
10436,16156,2986,4964,5584,1588,1034,1244,655,413,71,24,318,242,88,11,51,26,154,18,106,30,589,531,156,14,361,58,22,0,10,12,36,0,33,3,32401
10437,1151,14,199,565,286,87,374,262,57,47,0,10,205,193,193,0,0,12,12,0,0,112,45,27,4,14,67,53,28,0,25,14,0,0,14,32403
10438,25255,3815,8578,8769,2674,1419,1999,950,733,279,0,454,217,155,85,22,48,62,14,47,1,1049,746,221,24,501,303,108,98,0,10,195,75,38,82,32404
10439,20412,2582,6570,6515,2923,1822,1364,658,493,101,53,339,165,51,35,0,16,114,0,27,87,706,471,152,36,283,235,218,186,0,32,17,0,17,0,32405
10440,6151,455,1617,2567,1123,389,259,129,46,27,0,19,83,76,70,0,6,7,0,0,7,130,106,22,0,84,24,15,9,6,0,9,9,0,0,32407
10441,12209,821,3069,4658,2518,1143,737,353,298,33,40,225,55,48,24,24,0,7,0,0,7,384,289,185,17,87,95,60,60,0,0,35,7,0,28,32408
10442,6215,604,2148,2464,711,288,462,193,177,77,0,100,16,16,16,0,0,0,0,0,0,269,239,107,17,115,30,30,30,0,0,0,0,0,0,32409
10443,878,31,306,272,140,129,38,8,5,0,0,5,3,3,0,0,3,0,0,0,0,30,30,1,3,26,0,0,0,0,0,0,0,0,0,32410
10444,9731,1056,2888,2980,1837,970,625,349,308,17,0,291,41,41,33,8,0,0,0,0,0,276,223,73,26,124,53,35,0,0,35,18,0,18,0,32413
10445,1476,203,619,517,79,58,52,28,28,11,0,17,0,0,0,0,0,0,0,0,0,24,24,7,0,17,0,0,0,0,0,0,0,0,0,32420
10446,3166,864,1322,722,182,76,322,158,71,16,0,55,87,64,15,0,49,23,0,0,23,164,146,3,16,127,18,14,10,4,0,4,0,4,0,32421
10447,744,55,237,330,80,42,103,30,27,5,7,15,3,3,0,3,0,0,0,0,0,73,51,0,0,51,22,0,0,0,0,22,0,0,22,32423
10448,5745,1639,2149,1509,311,137,212,78,78,57,7,14,0,0,0,0,0,0,0,0,0,134,112,80,5,27,22,22,0,0,22,0,0,0,0,32424
10449,9797,2469,3602,2443,775,508,594,343,270,79,11,180,73,24,0,2,22,49,0,0,49,251,183,11,14,158,68,34,15,0,19,34,0,32,2,32425
10450,642,191,223,182,45,1,23,21,9,0,0,9,12,12,12,0,0,0,0,0,0,2,2,0,0,2,0,0,0,0,0,0,0,0,0,32426
10451,898,237,384,234,27,16,81,16,12,0,0,12,4,4,4,0,0,0,0,0,0,65,37,0,0,37,28,6,3,0,3,22,22,0,0,32427
10452,12235,2370,4800,3519,1016,530,866,453,213,29,37,147,240,128,79,30,19,112,109,0,3,413,346,69,25,252,67,67,22,0,45,0,0,0,0,32428
10453,666,113,255,243,42,13,18,10,0,0,0,0,10,10,10,0,0,0,0,0,0,8,0,0,0,0,8,8,0,0,8,0,0,0,0,32430
10454,2854,666,1134,859,119,76,188,71,62,9,13,40,9,9,9,0,0,0,0,0,0,117,93,20,35,38,24,24,12,0,12,0,0,0,0,32431
10455,53,21,0,32,0,0,0,0,0,0,0,0,0,0,0,0,0,0,0,0,0,0,0,0,0,0,0,0,0,0,0,0,0,0,0,32432
10456,11164,2698,4184,3204,836,242,990,480,375,64,51,260,105,20,12,0,8,85,84,0,1,510,411,86,28,297,99,72,31,41,0,27,0,27,0,32433
10457,5312,1040,1847,1469,636,320,405,280,206,15,16,175,74,33,32,0,1,41,24,16,1,125,86,0,0,86,39,39,39,0,0,0,0,0,0,32435
10458,566,164,215,170,17,0,55,16,15,9,0,6,1,0,0,0,0,1,0,1,0,39,39,0,0,39,0,0,0,0,0,0,0,0,0,32437
10459,2642,724,901,946,71,0,191,172,127,21,46,60,45,42,42,0,0,3,0,0,3,19,19,0,0,19,0,0,0,0,0,0,0,0,0,32438
10460,5545,981,1828,1787,624,325,340,202,125,35,3,87,77,60,0,13,47,17,0,0,17,138,133,8,0,125,5,5,5,0,0,0,0,0,0,32439
10461,5715,1470,2066,1583,379,217,340,168,160,60,19,81,8,8,0,0,8,0,0,0,0,172,144,31,8,105,28,28,0,0,28,0,0,0,0,32440
10462,2697,529,924,935,261,48,153,70,56,12,0,44,14,14,11,0,3,0,0,0,0,83,45,36,0,9,38,38,38,0,0,0,0,0,0,32442
10463,1983,361,584,711,244,83,123,90,72,2,6,64,18,13,0,13,0,5,0,5,0,33,33,2,21,10,0,0,0,0,0,0,0,0,0,32443
10464,13470,1470,3590,4640,2447,1323,962,662,611,93,51,467,51,51,51,0,0,0,0,0,0,300,234,73,14,147,66,0,0,0,0,66,0,4,62,32444
10465,2384,749,792,515,230,98,77,57,38,16,0,22,19,6,0,0,6,13,0,0,13,20,20,0,0,20,0,0,0,0,0,0,0,0,0,32445
10466,7769,1130,2257,2238,1390,754,688,286,224,68,8,148,62,30,0,0,30,32,32,0,0,402,354,46,31,277,48,14,6,0,8,34,0,0,34,32446
10467,10,10,0,0,0,0,250,236,236,0,0,236,0,0,0,0,0,0,0,0,0,14,14,0,0,14,0,0,0,0,0,0,0,0,0,32447
10468,5993,1242,2351,1872,311,217,269,179,154,46,0,108,25,25,10,15,0,0,0,0,0,90,51,20,0,31,39,39,25,0,14,0,0,0,0,32448
10469,487,112,281,60,34,0,29,14,14,0,0,14,0,0,0,0,0,0,0,0,0,15,15,0,0,15,0,0,0,0,0,0,0,0,0,32449
10470,2892,646,1052,808,240,146,289,214,208,23,0,185,6,6,0,0,6,0,0,0,0,75,75,12,0,63,0,0,0,0,0,0,0,0,0,32455
10471,5738,708,2144,1587,940,359,280,120,97,58,0,39,23,22,22,0,0,1,0,0,1,160,160,42,27,91,0,0,0,0,0,0,0,0,0,32456
10472,9254,537,2015,3201,2193,1308,303,124,95,0,26,69,29,29,29,0,0,0,0,0,0,179,179,78,0,101,0,0,0,0,0,0,0,0,0,32459
10473,4431,1278,1553,1169,266,165,180,90,39,0,8,31,51,51,0,32,19,0,0,0,0,90,90,0,0,90,0,0,0,0,0,0,0,0,0,32460
10474,28,0,0,0,13,15,0,0,0,0,0,0,0,0,0,0,0,0,0,0,0,0,0,0,0,0,0,0,0,0,0,0,0,0,0,32461
10475,2563,504,1032,736,225,66,136,78,75,34,0,41,3,3,0,0,3,0,0,0,0,58,32,0,0,32,26,26,5,5,16,0,0,0,0,32462
10476,76,18,25,33,0,0,2,0,0,0,0,0,0,0,0,0,0,0,0,0,0,2,2,0,0,2,0,0,0,0,0,0,0,0,0,32463
10477,2817,777,1183,688,94,75,145,36,15,12,0,3,21,13,0,0,13,8,1,0,7,109,104,13,0,91,5,5,0,5,0,0,0,0,0,32464
10478,6460,1777,2342,1927,305,109,364,164,93,16,0,77,71,57,0,0,57,14,14,0,0,200,123,17,0,106,77,33,33,0,0,44,0,0,44,32465
10479,4057,794,1711,1246,202,104,389,90,27,27,0,0,63,0,0,0,0,63,38,0,25,299,233,16,0,217,66,49,0,49,0,17,0,0,17,32466
10480,8273,1831,2724,2178,898,642,589,291,154,6,12,136,137,51,0,0,51,86,0,3,83,298,186,20,12,154,112,55,36,0,19,57,0,13,44,32501
10481,2317,309,604,828,380,196,177,132,129,27,16,86,3,0,0,0,0,3,0,0,3,45,29,27,0,2,16,16,0,0,16,0,0,0,0,32502
10482,21038,2376,5408,6362,4135,2757,2890,1247,1065,385,54,626,182,72,51,11,10,110,39,27,44,1643,1477,656,53,768,166,116,17,99,0,50,0,50,0,32503
10483,15324,1024,3479,5928,3114,1779,1202,850,700,206,68,426,150,66,50,16,0,84,11,8,65,352,282,96,0,186,70,48,48,0,0,22,0,0,22,32504
10484,16629,3461,6366,4832,1329,641,1501,780,575,74,6,495,205,115,49,66,0,90,0,59,31,721,558,73,77,408,163,65,0,65,0,98,14,31,53,32505
10485,22594,2304,6362,9381,3289,1258,1759,876,708,64,120,524,168,145,92,38,15,23,0,0,23,883,719,181,36,502,164,127,51,13,63,37,0,17,20,32506
10486,18620,2221,4928,6625,3241,1605,846,400,310,37,8,265,90,77,64,13,0,13,10,0,3,446,401,96,0,305,45,45,29,16,0,0,0,0,0,32507
10487,1137,20,234,591,253,39,2754,2283,245,245,0,0,2038,2029,2029,0,0,9,9,0,0,471,94,84,0,10,377,366,366,0,0,11,11,0,0,32508
10488,687,74,245,295,60,13,0,0,0,0,0,0,0,0,0,0,0,0,0,0,0,0,0,0,0,0,0,0,0,0,0,0,0,0,0,32509
10489,168,0,36,103,28,1,429,387,33,33,0,0,354,354,354,0,0,0,0,0,0,42,39,29,0,10,3,3,3,0,0,0,0,0,0,32511
10490,25787,2150,6252,9208,5205,2972,2558,1453,1316,341,124,851,137,68,68,0,0,69,0,9,60,1105,892,332,120,440,213,185,61,19,105,28,0,0,28,32514
10491,25158,3011,7461,10201,3032,1453,1831,915,789,158,84,547,126,73,53,0,20,53,0,10,43,916,841,125,75,641,75,38,19,0,19,37,0,28,9,32526
10492,98,28,0,70,0,0,0,0,0,0,0,0,0,0,0,0,0,0,0,0,0,0,0,0,0,0,0,0,0,0,0,0,0,0,0,32530
10493,3671,446,1405,1218,287,315,411,190,167,27,0,140,23,0,0,0,0,23,23,0,0,221,212,24,0,188,9,9,0,0,9,0,0,0,0,32531
10494,18324,2039,5433,6385,2827,1640,1654,801,681,101,137,443,120,30,0,25,5,90,68,0,22,853,766,212,155,399,87,0,0,0,0,87,52,28,7,32533
10495,9430,1100,2876,3714,1291,449,817,341,275,17,70,188,66,31,16,15,0,35,24,0,11,476,432,68,51,313,44,44,44,0,0,0,0,0,0,32534
10496,4378,1235,1678,1121,293,51,348,172,123,0,0,123,49,35,35,0,0,14,0,10,4,176,173,38,15,120,3,3,0,0,3,0,0,0,0,32535
10497,13097,1090,3627,5827,1616,937,1233,687,482,106,131,245,205,177,177,0,0,28,6,0,22,546,378,87,51,240,168,90,74,0,16,78,42,0,36,32536
10498,16714,2213,5298,6519,1814,870,1089,528,351,59,76,216,177,148,70,58,20,29,0,0,29,561,468,87,43,338,93,93,23,46,24,0,0,0,0,32539
10499,11904,656,2447,4074,3097,1630,571,367,293,182,39,72,74,74,56,4,14,0,0,0,0,204,192,69,0,123,12,12,7,0,5,0,0,0,0,32541
10500,1179,14,235,624,183,123,305,245,104,36,0,68,141,141,141,0,0,0,0,0,0,60,41,0,0,41,19,9,5,4,0,10,10,0,0,32542
10501,484,0,27,341,112,4,247,212,32,26,0,6,180,180,180,0,0,0,0,0,0,35,0,0,0,0,35,35,14,21,0,0,0,0,0,32544
10502,22574,2812,6319,8561,3014,1868,1872,924,768,207,58,503,156,109,109,0,0,47,0,17,30,948,806,344,32,430,142,133,94,0,39,9,0,9,0,32547
10503,14038,1676,4410,4839,2026,1087,768,381,327,29,75,223,54,39,9,0,30,15,15,0,0,387,326,108,22,196,61,27,8,0,19,34,0,29,5,32548
10504,5209,307,934,1556,1792,620,70,0,0,0,0,0,0,0,0,0,0,0,0,0,0,70,70,0,0,70,0,0,0,0,0,0,0,0,0,32550
10505,6182,178,1355,1836,1661,1152,414,248,248,82,0,166,0,0,0,0,0,0,0,0,0,166,166,49,0,117,0,0,0,0,0,0,0,0,0,32561
10506,16905,957,3851,6357,3877,1863,944,440,376,189,45,142,64,49,29,0,20,15,15,0,0,504,491,157,48,286,13,0,0,0,0,13,0,0,13,32563
10507,1986,298,786,603,261,38,132,96,65,44,14,7,31,1,0,0,1,30,0,0,30,36,36,7,0,29,0,0,0,0,0,0,0,0,0,32564
10508,4219,834,1641,1177,428,139,213,57,56,16,10,30,1,0,0,0,0,1,0,0,1,156,156,92,0,64,0,0,0,0,0,0,0,0,0,32565
10509,22980,1788,4941,9267,4759,2225,1870,907,647,335,57,255,260,210,184,0,26,50,34,16,0,963,925,152,17,756,38,38,0,12,26,0,0,0,0,32566
10510,2365,450,1009,675,121,110,93,61,57,16,5,36,4,4,0,0,4,0,0,0,0,32,28,4,0,24,4,0,0,0,0,4,0,0,4,32567
10511,2097,330,823,626,254,64,101,67,67,45,0,22,0,0,0,0,0,0,0,0,0,34,8,0,0,8,26,0,0,0,0,26,0,0,26,32568
10512,8068,832,2211,2906,1392,727,410,103,67,0,10,57,36,28,28,0,0,8,8,0,0,307,307,180,7,120,0,0,0,0,0,0,0,0,0,32569
10513,19526,2396,6301,7027,2802,1000,1448,735,551,103,72,376,184,123,19,46,58,61,0,0,61,713,518,145,41,332,195,185,51,27,107,10,8,2,0,32570
10514,19670,1633,5612,7284,3295,1846,1736,1038,942,221,79,642,96,77,71,6,0,19,19,0,0,698,655,193,51,411,43,39,7,0,32,4,0,4,0,32571
10515,3334,411,1046,1317,340,220,284,55,37,17,0,20,18,10,10,0,0,8,0,8,0,229,212,77,46,89,17,17,17,0,0,0,0,0,0,32577
10516,21149,912,4821,6294,4783,4339,1644,953,781,316,16,449,172,172,79,25,68,0,0,0,0,691,638,269,47,322,53,38,9,0,29,15,0,0,15,32578
10517,7195,307,1739,2327,1661,1161,514,244,219,119,4,96,25,25,25,0,0,0,0,0,0,270,247,107,0,140,23,23,0,0,23,0,0,0,0,32579
10518,2786,80,579,1123,407,597,216,150,93,25,7,61,57,57,57,0,0,0,0,0,0,66,41,0,0,41,25,25,25,0,0,0,0,0,0,32580
10519,18179,3439,5581,5713,2066,1380,1300,784,502,33,147,322,282,141,36,47,58,141,0,49,92,516,468,83,81,304,48,25,17,0,8,23,0,0,23,32583
10520,9073,678,1631,2712,1668,2384,1614,620,572,28,99,445,48,29,0,29,0,19,0,0,19,994,919,155,51,713,75,45,0,0,45,30,0,0,30,32601
10521,1689,152,71,182,615,669,2270,1006,999,155,58,786,7,7,7,0,0,0,0,0,0,1264,1248,213,77,958,16,5,5,0,0,11,0,0,11,32603
10522,16247,537,2490,4190,3980,5050,798,558,507,159,33,315,51,51,34,17,0,0,0,0,0,240,208,53,0,155,32,32,23,0,9,0,0,0,0,32605
10523,15715,838,2239,4507,4131,4000,862,475,444,107,51,286,31,14,14,0,0,17,0,0,17,387,372,115,0,257,15,15,15,0,0,0,0,0,0,32606
10524,14364,1391,2435,3964,3539,3035,2034,954,742,220,78,444,212,147,147,0,0,65,58,0,7,1080,1043,275,54,714,37,37,27,0,10,0,0,0,0,32607
10525,24622,1363,3816,6393,6166,6884,1983,988,897,139,48,710,91,41,0,41,0,50,3,0,47,995,946,310,15,621,49,25,4,15,6,24,24,0,0,32608
10526,11723,2243,3531,3723,1660,566,1039,589,399,42,14,343,190,137,89,24,24,53,0,0,53,450,255,48,43,164,195,163,33,93,37,32,0,0,32,32609
10527,10,0,0,6,0,4,5277,1938,1938,169,41,1728,0,0,0,0,0,0,0,0,0,3339,3339,460,124,2755,0,0,0,0,0,0,0,0,0,32612
10528,10564,819,2536,3985,2207,1017,858,425,371,45,62,264,54,14,14,0,0,40,1,0,39,433,378,119,0,259,55,55,11,0,44,0,0,0,0,32615
10529,328,2,132,109,62,23,5,5,5,0,0,5,0,0,0,0,0,0,0,0,0,0,0,0,0,0,0,0,0,0,0,0,0,0,0,32616
10530,3179,550,1231,1076,187,135,254,148,81,21,10,50,67,57,0,39,18,10,0,10,0,106,73,0,0,73,33,33,18,0,15,0,0,0,0,32617
10531,5420,644,1534,2197,591,454,368,239,228,87,0,141,11,11,0,11,0,0,0,0,0,129,112,41,2,69,17,0,0,0,0,17,0,0,17,32618
10532,3207,469,1363,927,307,141,178,89,53,0,0,53,36,1,1,0,0,35,6,29,0,89,87,10,0,77,2,2,1,1,0,0,0,0,0,32619
10533,4307,950,1441,1572,275,69,194,103,96,6,31,59,7,3,0,0,3,4,0,0,4,91,91,0,3,88,0,0,0,0,0,0,0,0,0,32621
10534,944,242,420,236,35,11,58,27,26,0,20,6,1,0,0,0,0,1,0,0,1,31,31,0,0,31,0,0,0,0,0,0,0,0,0,32622
10535,1175,145,463,358,149,60,131,51,13,0,0,13,38,38,38,0,0,0,0,0,0,80,80,0,0,80,0,0,0,0,0,0,0,0,0,32625
10536,6143,1275,2651,1552,503,162,283,152,145,0,0,145,7,0,0,0,0,7,0,7,0,131,113,0,19,94,18,13,0,0,13,5,5,0,0,32626
10537,3716,980,1565,862,223,86,230,121,65,0,21,44,56,53,7,21,25,3,0,0,3,109,109,62,0,47,0,0,0,0,0,0,0,0,0,32628
10538,256,0,66,75,38,77,0,0,0,0,0,0,0,0,0,0,0,0,0,0,0,0,0,0,0,0,0,0,0,0,0,0,0,0,0,32631
10539,50,10,23,17,0,0,0,0,0,0,0,0,0,0,0,0,0,0,0,0,0,0,0,0,0,0,0,0,0,0,0,0,0,0,0,32639
10540,8055,1356,3083,2438,779,399,447,341,230,24,26,180,111,67,51,0,16,44,0,0,44,106,63,9,2,52,43,25,15,0,10,18,0,0,18,32640
10541,8164,1651,3240,2450,590,233,936,532,221,0,36,185,311,127,44,0,83,184,0,37,147,404,281,0,30,251,123,57,15,25,17,66,0,0,66,32641
10542,7241,807,2235,2657,993,549,334,137,136,0,33,103,1,0,0,0,0,1,0,0,1,197,174,33,0,141,23,22,0,0,22,1,0,0,1,32643
10543,238,58,85,69,26,0,6,0,0,0,0,0,0,0,0,0,0,0,0,0,0,6,0,0,0,0,6,6,0,0,6,0,0,0,0,32648
10544,9929,510,1788,2770,2454,2407,641,416,302,50,7,245,114,21,0,21,0,93,0,0,93,225,211,24,9,178,14,14,14,0,0,0,0,0,0,32653
10545,9566,1435,3491,3007,1184,449,738,402,363,131,8,224,39,39,7,20,12,0,0,0,0,336,325,39,63,223,11,11,0,2,9,0,0,0,0,32656
10546,132,21,49,37,24,1,20,0,0,0,0,0,0,0,0,0,0,0,0,0,0,20,14,0,0,14,6,6,0,0,6,0,0,0,0,32658
10547,334,0,127,112,46,49,3,0,0,0,0,0,0,0,0,0,0,0,0,0,0,3,0,0,0,0,3,3,3,0,0,0,0,0,0,32664
10548,5009,626,1833,1795,422,333,466,297,253,0,0,253,44,29,0,0,29,15,0,15,0,169,128,10,18,100,41,25,25,0,0,16,0,6,10,32666
10549,2820,336,756,787,462,479,141,73,73,2,0,71,0,0,0,0,0,0,0,0,0,68,68,18,0,50,0,0,0,0,0,0,0,0,0,32667
10550,3451,519,1340,1010,319,263,191,123,123,0,0,123,0,0,0,0,0,0,0,0,0,68,68,13,0,55,0,0,0,0,0,0,0,0,0,32668
10551,7805,597,2059,2696,1644,809,333,219,171,49,9,113,48,40,40,0,0,8,0,0,8,114,114,13,0,101,0,0,0,0,0,0,0,0,0,32669
10552,7294,1468,2752,2504,362,208,305,202,165,0,9,156,37,0,0,0,0,37,0,0,37,103,86,33,0,53,17,0,0,0,0,17,0,0,17,32680
10553,138,38,60,0,40,0,0,0,0,0,0,0,0,0,0,0,0,0,0,0,0,0,0,0,0,0,0,0,0,0,0,0,0,0,0,32681
10554,240,23,185,32,0,0,24,18,18,0,0,18,0,0,0,0,0,0,0,0,0,6,0,0,0,0,6,0,0,0,0,6,0,6,0,32683
10555,4007,524,1990,997,239,257,458,214,121,0,1,120,93,76,0,28,48,17,0,17,0,244,231,0,52,179,13,0,0,0,0,13,0,13,0,32686
10556,263,0,42,134,64,23,0,0,0,0,0,0,0,0,0,0,0,0,0,0,0,0,0,0,0,0,0,0,0,0,0,0,0,0,0,32692
10557,8051,2047,2989,2221,546,248,1337,900,506,5,36,465,394,136,13,0,123,258,18,16,224,437,350,83,15,252,87,57,4,0,53,30,0,0,30,32693
10558,1932,252,744,582,120,234,93,29,29,12,0,17,0,0,0,0,0,0,0,0,0,64,38,0,0,38,26,26,5,0,21,0,0,0,0,32694
10559,7664,1127,3110,2393,704,330,588,330,299,108,30,161,31,31,6,9,16,0,0,0,0,258,220,33,0,187,38,33,13,20,0,5,5,0,0,32696
10560,131,56,63,12,0,0,24,0,0,0,0,0,0,0,0,0,0,0,0,0,0,24,0,0,0,0,24,0,0,0,0,24,24,0,0,32697
10561,16256,1728,4198,4952,3739,1639,903,408,337,20,23,294,71,50,34,0,16,21,0,11,10,495,486,92,20,374,9,9,0,0,9,0,0,0,0,32701
10562,2098,509,867,461,219,42,80,64,56,0,0,56,8,8,0,0,8,0,0,0,0,16,16,0,10,6,0,0,0,0,0,0,0,0,0,32702
10563,30617,5522,9610,9061,4462,1962,2544,1417,1195,177,70,948,222,170,118,52,0,52,0,41,11,1127,949,197,64,688,178,105,81,2,22,73,59,0,14,32703
10564,24776,2355,6998,8807,4660,1956,1475,605,521,132,28,361,84,84,84,0,0,0,0,0,0,870,724,195,28,501,146,77,0,26,51,69,0,19,50,32707
10565,29394,1727,7403,9380,7184,3700,2554,1410,1332,195,35,1102,78,78,0,0,78,0,0,0,0,1144,1121,181,97,843,23,0,0,0,0,23,23,0,0,32708
10566,1590,290,589,504,176,31,126,27,27,0,0,27,0,0,0,0,0,0,0,0,0,99,99,34,0,65,0,0,0,0,0,0,0,0,0,32709
10567,28605,3420,7557,9367,5410,2851,2152,1228,1204,152,52,1000,24,14,9,5,0,10,0,6,4,924,851,231,136,484,73,37,8,0,29,36,36,0,0,32712
10568,14891,1561,4336,5319,2407,1268,509,386,295,51,0,244,91,32,20,0,12,59,0,0,59,123,72,0,0,72,51,3,0,0,3,48,0,0,48,32713
10569,24637,2214,6493,8354,5351,2225,1720,853,586,17,56,513,267,169,0,94,75,98,25,41,32,867,724,167,29,528,143,116,99,0,17,27,0,0,27,32714
10570,21454,3062,6752,7459,2469,1712,2281,1178,994,91,83,820,184,134,31,32,71,50,0,0,50,1103,984,242,139,603,119,23,23,0,0,96,0,0,96,32720
10571,21232,2931,6415,6712,2801,2373,2048,958,750,70,61,619,208,145,127,0,18,63,0,19,44,1090,845,135,41,669,245,192,117,52,23,53,23,0,30,32724
10572,31278,4611,11181,10643,3294,1549,2273,1091,797,124,51,622,294,224,163,47,14,70,0,0,70,1182,1083,272,74,737,99,86,78,8,0,13,0,0,13,32725
10573,14025,2017,5020,4352,1632,1004,902,475,348,122,53,173,127,117,98,0,19,10,0,10,0,427,383,37,54,292,44,35,0,35,0,9,0,9,0,32726
10574,3925,321,1163,1526,640,275,189,144,87,14,0,73,57,57,57,0,0,0,0,0,0,45,45,45,0,0,0,0,0,0,0,0,0,0,0,32730
10575,3073,525,1059,826,310,353,130,45,45,19,0,26,0,0,0,0,0,0,0,0,0,85,85,16,11,58,0,0,0,0,0,0,0,0,0,32732
10576,2644,407,893,972,199,173,104,40,40,0,0,40,0,0,0,0,0,0,0,0,0,64,64,0,0,64,0,0,0,0,0,0,0,0,0,32735
10577,6970,1253,2237,1986,979,515,401,113,84,21,3,60,29,0,0,0,0,29,0,10,19,288,230,42,7,181,58,58,31,9,18,0,0,0,0,32736
10578,27860,3846,9660,9968,3076,1310,2614,1277,1018,84,184,750,259,189,110,26,53,70,43,0,27,1337,1047,311,118,618,290,229,109,38,82,61,0,0,61,32738
10579,2542,335,926,856,342,83,194,159,132,4,0,128,27,3,3,0,0,24,0,4,20,35,34,21,0,13,1,0,0,0,0,1,0,0,1,32744
10580,28400,1498,4722,9542,8252,4386,1847,1018,955,285,66,604,63,38,38,0,0,25,0,0,25,829,819,158,29,632,10,10,10,0,0,0,0,0,0,32746
10581,16349,1547,4686,5262,3299,1555,1408,740,694,127,83,484,46,38,23,15,0,8,0,8,0,668,663,192,46,425,5,5,4,0,1,0,0,0,0,32750
10582,14922,861,2342,3992,4677,3050,1101,514,511,155,71,285,3,3,3,0,0,0,0,0,0,587,437,23,47,367,150,135,74,61,0,15,0,0,15,32751
10583,7564,1089,2976,2100,1024,375,566,247,218,10,39,169,29,26,7,19,0,3,0,3,0,319,300,66,40,194,19,0,0,0,0,19,0,17,2,32754
10584,16734,1972,5146,5270,2851,1495,1061,551,445,102,31,312,106,41,13,0,28,65,0,18,47,510,441,86,66,289,69,32,32,0,0,37,0,0,37,32757
10585,2145,409,868,696,82,90,133,81,20,0,0,20,61,52,0,0,52,9,0,0,9,52,33,11,8,14,19,0,0,0,0,19,7,5,7,32759
10586,14965,1962,5794,5279,1312,618,936,350,312,61,39,212,38,20,0,0,20,18,18,0,0,586,505,106,64,335,81,0,0,0,0,81,0,0,81,32763
10587,2546,336,1129,730,316,35,308,221,154,10,14,130,67,67,33,20,14,0,0,0,0,87,68,23,0,45,19,19,0,0,19,0,0,0,0,32764
10588,35320,1887,7238,10419,10048,5728,3474,2006,1850,539,232,1079,156,142,70,45,27,14,8,0,6,1468,1383,352,127,904,85,44,27,17,0,41,17,24,0,32765
10589,9292,499,2061,2857,2432,1443,1356,900,831,332,74,425,69,0,0,0,0,69,14,0,55,456,427,141,51,235,29,29,13,0,16,0,0,0,0,32766
10590,1820,621,707,401,48,43,337,212,212,48,42,122,0,0,0,0,0,0,0,0,0,125,77,0,0,77,48,48,48,0,0,0,0,0,0,32767
10591,31314,4203,8156,9763,6001,3191,2404,1194,907,92,113,702,287,181,0,52,129,106,18,17,71,1210,1035,137,96,802,175,140,34,61,45,35,0,25,10,32771
10592,18928,2352,5754,6804,2705,1313,1456,648,604,107,32,465,44,37,29,0,8,7,0,0,7,808,743,208,63,472,65,17,0,17,0,48,0,17,31,32773
10593,7005,1388,1900,2030,1284,403,473,282,282,25,0,257,0,0,0,0,0,0,0,0,0,191,191,76,20,95,0,0,0,0,0,0,0,0,0,32776
10594,15258,1675,6452,4557,1580,994,560,252,175,0,0,175,77,11,0,11,0,66,0,33,33,308,274,49,0,225,34,18,18,0,0,16,0,0,16,32778
10595,19856,883,3055,5762,6435,3721,1678,715,598,73,20,505,117,117,17,57,43,0,0,0,0,963,918,155,58,705,45,45,11,0,34,0,0,0,0,32779
10596,24908,2160,7416,9369,3961,2002,1672,818,681,122,74,485,137,95,17,19,59,42,34,8,0,854,742,186,133,423,112,66,21,45,0,46,0,16,30,32780
10597,7955,1453,2970,2458,672,402,661,504,452,16,33,403,52,2,2,0,0,50,14,0,36,157,82,63,0,19,75,15,15,0,0,60,0,0,60,32784
10598,17012,1042,2650,3927,5087,4306,1728,737,716,88,26,602,21,12,12,0,0,9,0,0,9,991,959,132,72,755,32,19,19,0,0,13,13,0,0,32789
10599,31655,2447,7851,11413,6797,3147,2852,1432,1230,204,118,908,202,180,103,2,75,22,0,13,9,1420,1140,306,84,750,280,213,136,77,0,67,0,21,46,32792
10600,15747,1883,5893,5175,1857,939,989,489,430,89,30,311,59,58,35,0,23,1,0,0,1,500,437,199,10,228,63,63,7,0,56,0,0,0,0,32796
10601,2369,388,1058,693,195,35,165,95,37,37,0,0,58,0,0,0,0,58,0,19,39,70,70,0,0,70,0,0,0,0,0,0,0,0,0,32798
10602,9198,689,1865,2454,2670,1520,221,142,131,19,18,94,11,11,0,0,11,0,0,0,0,79,31,15,0,16,48,48,27,0,21,0,0,0,0,32801
10603,14099,487,2667,3930,4584,2431,360,250,229,44,11,174,21,21,5,0,16,0,0,0,0,110,90,44,0,46,20,7,0,0,7,13,0,0,13,32803
10604,13115,677,2153,3625,4323,2337,397,137,112,23,15,74,25,25,25,0,0,0,0,0,0,260,248,43,14,191,12,0,0,0,0,12,12,0,0,32804
10605,14516,3724,5416,3414,1368,594,1074,502,396,59,33,304,106,75,10,49,16,31,0,12,19,572,382,45,60,277,190,115,7,25,83,75,0,28,47,32805
10606,18831,1243,5082,5647,4351,2508,1001,425,331,42,62,227,94,16,6,0,10,78,0,23,55,576,495,94,33,368,81,31,30,0,1,50,0,0,50,32806
10607,21252,4832,7181,6325,2101,813,1532,867,615,71,58,486,252,216,124,31,61,36,19,14,3,665,545,107,92,346,120,120,88,0,32,0,0,0,0,32807
10608,29658,6887,10485,8993,2160,1133,3209,1746,1319,167,241,911,427,166,85,75,6,261,92,56,113,1463,1231,118,135,978,232,232,115,23,94,0,0,0,0,32808
10609,16467,3486,5865,4530,1824,762,1798,875,689,158,37,494,186,75,26,32,17,111,21,20,70,923,828,204,61,563,95,67,0,0,67,28,18,0,10,32809
10610,22015,3055,6669,7304,3698,1289,1684,707,616,23,27,566,91,73,11,0,62,18,18,0,0,977,857,95,100,662,120,73,10,20,43,47,0,0,47,32810
10611,23199,3755,7818,7238,3317,1071,1987,1077,773,187,144,442,304,237,116,10,111,67,7,34,26,910,765,47,136,582,145,65,8,57,0,80,17,63,0,32811
10612,24888,2661,6640,8958,5021,1608,1966,964,757,58,48,651,207,81,18,0,63,126,32,18,76,1002,973,217,38,718,29,23,12,0,11,6,0,0,6,32812
10613,4214,10,372,722,1763,1347,167,98,98,15,0,83,0,0,0,0,0,0,0,0,0,69,69,19,0,50,0,0,0,0,0,0,0,0,0,32814
10614,18654,2194,4753,5636,4101,1970,4112,1924,1838,204,54,1580,86,61,34,0,27,25,0,0,25,2188,2116,481,130,1505,72,72,31,31,10,0,0,0,0,32817
10615,27889,5111,9456,8288,3564,1470,3288,1723,1392,160,175,1057,331,172,79,36,57,159,57,36,66,1565,1456,231,251,974,109,64,40,24,0,45,6,9,30,32818
10616,17160,1273,3412,5390,4690,2395,1810,994,869,86,110,673,125,12,3,0,9,113,11,0,102,816,769,213,13,543,47,47,47,0,0,0,0,0,0,32819
10617,5426,745,1222,1539,1067,853,375,229,229,0,0,229,0,0,0,0,0,0,0,0,0,146,146,57,12,77,0,0,0,0,0,0,0,0,0,32820
10618,12126,956,3313,3476,3419,962,808,416,320,13,0,307,96,70,70,0,0,26,0,0,26,392,265,125,26,114,127,112,66,0,46,15,0,0,15,32821
10619,35760,6609,12266,10991,4186,1708,3553,1881,1528,201,134,1193,353,164,50,21,93,189,60,15,114,1672,1283,220,335,728,389,248,67,68,113,141,32,39,70,32822
10620,23206,4047,7171,7235,3705,1048,2623,1442,1163,118,107,938,279,204,42,47,115,75,64,0,11,1181,1061,262,11,788,120,113,81,17,15,7,0,0,7,32824
10621,37368,4517,9788,12356,7602,3105,3084,1438,1223,200,158,865,215,93,36,3,54,122,15,29,78,1646,1491,293,227,971,155,140,45,0,95,15,0,0,15,32825
10622,12490,1413,2644,3906,3141,1386,6990,3494,3465,387,139,2939,29,29,6,7,16,0,0,0,0,3496,3389,648,231,2510,107,77,5,23,49,30,8,0,22,32826
10623,4531,212,886,1209,1310,914,195,136,136,65,2,69,0,0,0,0,0,0,0,0,0,59,59,26,0,33,0,0,0,0,0,0,0,0,0,32827
10624,33861,2101,6156,10808,9633,5163,4062,2074,2009,143,104,1762,65,65,19,46,0,0,0,0,0,1988,1778,478,59,1241,210,210,68,50,92,0,0,0,0,32828
10625,12985,1336,2828,4207,3168,1446,913,546,429,37,14,378,117,117,55,62,0,0,0,0,0,367,330,91,13,226,37,37,37,0,0,0,0,0,0,32829
10626,7,3,4,0,0,0,0,0,0,0,0,0,0,0,0,0,0,0,0,0,0,0,0,0,0,0,0,0,0,0,0,0,0,0,0,32830
10627,2295,768,992,419,97,19,152,126,17,0,0,17,109,17,0,0,17,92,0,0,92,26,22,0,0,22,4,4,4,0,0,0,0,0,0,32831
10628,9939,624,1519,3165,3191,1440,551,266,251,14,0,237,15,12,12,0,0,3,0,0,3,285,183,16,0,167,102,102,62,0,40,0,0,0,0,32832
10629,6097,662,1961,1964,961,549,237,131,78,0,0,78,53,53,22,31,0,0,0,0,0,106,61,0,0,61,45,34,0,0,34,11,0,0,11,32833
10630,28141,2645,7173,8190,6598,3535,2404,1201,1028,108,117,803,173,86,76,10,0,87,20,0,67,1203,1048,175,220,653,155,110,39,51,20,45,0,45,0,32835
10631,11074,700,1742,2557,3573,2502,878,467,449,53,0,396,18,18,18,0,0,0,0,0,0,411,411,138,16,257,0,0,0,0,0,0,0,0,0,32836
10632,35361,3583,10121,11102,7357,3198,2691,1494,1366,358,166,842,128,104,27,66,11,24,0,0,24,1197,1098,232,103,763,99,70,43,27,0,29,0,7,22,32837
10633,29569,5707,11202,8041,3285,1334,2343,1376,915,135,167,613,461,234,50,47,137,227,70,0,157,967,805,151,91,563,162,122,10,0,112,40,15,0,25,32839
10634,17465,2623,4904,5594,2885,1459,1386,957,925,178,65,682,32,21,0,0,21,11,1,0,10,429,354,57,15,282,75,53,28,25,0,22,0,0,22,32901
10635,9610,369,2093,2513,2481,2154,575,335,335,72,87,176,0,0,0,0,0,0,0,0,0,240,232,74,0,158,8,8,0,8,0,0,0,0,0,32903
10636,19228,1255,5827,6609,3702,1835,1595,843,807,134,117,556,36,12,12,0,0,24,0,0,24,752,561,168,153,240,191,10,5,5,0,181,35,15,131,32904
10637,15867,1754,5526,5506,2003,1078,1040,482,397,52,30,315,85,58,58,0,0,27,0,27,0,558,455,117,84,254,103,27,27,0,0,76,24,0,52,32905
10638,28681,4104,9913,9542,3294,1828,2589,1632,1515,226,254,1035,117,40,24,0,16,77,0,52,25,957,783,180,124,479,174,72,0,0,72,102,0,58,44,32907
10639,7178,893,2425,3020,661,179,732,311,263,10,8,245,48,48,24,24,0,0,0,0,0,421,266,114,65,87,155,139,68,8,63,16,0,0,16,32908
10640,20218,2545,6724,7510,2298,1141,1866,779,569,60,42,467,210,91,91,0,0,119,0,14,105,1087,962,163,152,647,125,27,0,9,18,98,31,0,67,32909
10641,8365,692,2312,3093,1262,1006,313,210,197,34,0,163,13,0,0,0,0,13,0,0,13,103,52,0,0,52,51,51,6,45,0,0,0,0,0,32920
10642,10080,2141,3274,3285,860,520,808,405,325,32,82,211,80,73,45,0,28,7,0,7,0,403,395,61,61,273,8,0,0,0,0,8,0,0,8,32922
10643,644,19,43,344,200,38,54,13,2,2,0,0,11,11,11,0,0,0,0,0,0,41,12,0,0,12,29,19,15,0,4,10,0,0,10,32925
10644,16589,2260,5667,6043,1776,843,1021,688,457,64,0,393,231,177,57,92,28,54,0,14,40,333,264,77,16,171,69,69,18,0,51,0,0,0,0,32926
10645,17792,1928,5997,6988,1939,940,1761,1107,838,85,38,715,269,157,81,22,54,112,36,0,76,654,447,168,20,259,207,207,86,16,105,0,0,0,0,32927
10646,11325,417,2197,4121,2642,1948,568,285,276,121,13,142,9,9,0,0,9,0,0,0,0,283,267,70,65,132,16,16,16,0,0,0,0,0,0,32931
10647,13162,1133,3744,4009,2306,1970,856,491,413,129,16,268,78,78,44,0,34,0,0,0,0,365,365,65,16,284,0,0,0,0,0,0,0,0,0,32934
10648,29586,3141,9659,10531,3970,2285,1768,1084,942,213,70,659,142,60,0,0,60,82,22,0,60,684,597,140,50,407,87,60,45,0,15,27,15,0,12,32935
10649,18689,1053,4191,6484,4133,2828,1110,509,408,93,29,286,101,29,22,7,0,72,0,51,21,601,559,172,53,334,42,42,41,1,0,0,0,0,0,32937
10650,24970,1154,5118,7707,6076,4915,1408,705,681,81,36,564,24,0,0,0,0,24,0,0,24,703,697,123,55,519,6,0,0,0,0,6,0,0,6,32940
10651,4421,1678,1459,1166,108,10,457,210,112,35,0,77,98,98,33,65,0,0,0,0,0,247,122,38,0,84,125,92,14,61,17,33,0,19,14,32948
10652,2111,100,722,691,338,260,75,65,65,30,0,35,0,0,0,0,0,0,0,0,0,10,10,5,0,5,0,0,0,0,0,0,0,0,0,32949
10653,3010,284,884,1115,530,197,209,112,100,16,15,69,12,0,0,0,0,12,12,0,0,97,97,28,0,69,0,0,0,0,0,0,0,0,0,32950
10654,9122,394,2027,2596,2737,1368,460,218,168,46,0,122,50,34,34,0,0,16,0,0,16,242,241,81,0,160,1,0,0,0,0,1,0,0,1,32951
10655,14958,1009,3847,4629,3231,2242,897,489,415,19,33,363,74,74,0,38,36,0,0,0,0,408,396,107,62,227,12,12,12,0,0,0,0,0,0,32952
10656,16396,1361,4511,5916,2824,1784,1232,615,496,78,63,355,119,81,50,0,31,38,0,38,0,617,562,114,23,425,55,55,45,10,0,0,0,0,0,32953
10657,25443,1923,6008,9323,5010,3179,1533,793,691,162,138,391,102,40,21,19,0,62,0,21,41,740,574,194,40,340,166,148,138,0,10,18,18,0,0,32955
10658,19904,2630,6836,6846,2454,1138,1031,546,457,143,53,261,89,53,53,0,0,36,0,16,20,485,432,230,50,152,53,37,21,16,0,16,0,0,16,32958
10659,15042,2465,4385,4857,2131,1204,682,518,446,52,75,319,72,25,0,0,25,47,0,16,31,164,155,55,0,100,9,9,9,0,0,0,0,0,0,32960
10660,15554,2332,5267,4910,2053,992,1080,632,625,225,45,355,7,0,0,0,0,7,7,0,0,448,382,132,89,161,66,42,5,0,37,24,6,0,18,32962
10661,13123,222,1439,3174,4635,3653,466,121,121,0,24,97,0,0,0,0,0,0,0,0,0,345,321,89,32,200,24,10,0,0,10,14,0,0,14,32963
10662,12846,1325,4145,4229,1942,1205,500,288,251,20,0,231,37,16,15,0,1,21,8,0,13,212,170,21,0,149,42,42,42,0,0,0,0,0,0,32966
10663,13287,1994,4065,4302,1797,1129,920,529,458,135,19,304,71,34,34,0,0,37,22,0,15,391,319,43,28,248,72,36,14,0,22,36,10,0,26,32967
10664,9656,761,2250,3383,2167,1095,840,423,321,51,31,239,102,36,30,0,6,66,0,0,66,417,417,137,12,268,0,0,0,0,0,0,0,0,0,32968
10665,464,119,148,141,32,24,0,0,0,0,0,0,0,0,0,0,0,0,0,0,0,0,0,0,0,0,0,0,0,0,0,0,0,0,0,32970
10666,8102,1267,3448,2469,621,297,117,59,43,0,7,36,16,8,8,0,0,8,8,0,0,58,44,19,0,25,14,0,0,0,0,14,0,14,0,32976
10667,211,33,30,79,42,27,0,0,0,0,0,0,0,0,0,0,0,0,0,0,0,0,0,0,0,0,0,0,0,0,0,0,0,0,0,33001
10668,11208,1740,3430,3459,1687,892,438,182,138,28,33,77,44,10,6,4,0,34,0,0,34,256,225,6,79,140,31,16,0,16,0,15,0,15,0,33004
10669,31821,4884,9655,8804,5293,3185,1199,443,360,31,53,276,83,10,10,0,0,73,57,0,16,756,657,86,119,452,99,11,11,0,0,88,0,27,61,33009
10670,34154,12321,12555,5417,3027,834,2355,1246,834,81,51,702,412,294,10,136,148,118,0,17,101,1109,840,162,83,595,269,192,19,60,113,77,0,0,77,33010
10671,54877,17403,18950,10297,5385,2842,3466,1729,1361,133,133,1095,368,206,124,12,70,162,51,0,111,1737,1514,270,82,1162,223,203,134,23,46,20,20,0,0,33012
10672,24291,7402,9329,5151,1776,633,1137,575,278,87,72,119,297,148,92,0,56,149,0,49,100,562,463,51,23,389,99,88,33,23,32,11,0,0,11,33013
10673,28772,5940,9035,8307,3754,1736,2338,1247,1043,130,178,735,204,149,0,36,113,55,18,0,37,1091,1042,121,80,841,49,49,29,0,20,0,0,0,0,33014
10674,41524,5746,11605,13765,7165,3243,3442,1735,1489,123,39,1327,246,207,151,3,53,39,26,0,13,1707,1452,212,68,1172,255,100,78,14,8,155,83,0,72,33015
10675,32607,7121,11981,8012,4322,1171,3091,1674,1389,174,80,1135,285,232,93,55,84,53,11,22,20,1417,1197,97,56,1044,220,119,23,7,89,101,30,0,71,33016
10676,31734,7320,10096,8134,4372,1812,2847,1516,1324,57,25,1242,192,124,39,33,52,68,0,16,52,1331,1020,183,28,809,311,190,93,52,45,121,63,0,58,33018
10677,11528,668,2342,3032,2987,2499,206,60,55,11,0,44,5,5,0,0,5,0,0,0,0,146,146,0,0,146,0,0,0,0,0,0,0,0,0,33019
10678,29977,4110,10570,8948,4500,1849,1968,1010,866,122,106,638,144,122,52,70,0,22,0,0,22,958,764,207,68,489,194,174,109,42,23,20,0,0,20,33020
10679,34330,3850,9483,10192,6863,3942,2140,1017,892,101,98,693,125,90,62,10,18,35,17,18,0,1123,1006,312,59,635,117,65,0,19,46,52,0,41,11,33021
10680,42195,8015,15000,12823,4719,1638,3805,2037,1729,275,395,1059,308,199,55,111,33,109,39,36,34,1768,1568,240,152,1176,200,194,46,127,21,6,0,0,6,33023
10681,46301,7488,13868,15819,6125,3001,4010,2264,1936,417,200,1319,328,196,95,45,56,132,7,80,45,1746,1461,456,206,799,285,169,96,11,62,116,18,46,52,33024
10682,37401,3284,9235,13517,7502,3863,3090,1592,1311,125,46,1140,281,163,5,94,64,118,0,79,39,1498,1364,118,124,1122,134,76,41,35,0,58,0,0,58,33025
10683,21287,1351,4691,6840,4992,3413,2064,1281,1067,202,116,749,214,214,171,43,0,0,0,0,0,783,783,176,128,479,0,0,0,0,0,0,0,0,0,33026
10684,39707,3747,8653,12149,9538,5620,2921,1360,1143,76,232,835,217,217,161,7,49,0,0,0,0,1561,1522,232,72,1218,39,39,39,0,0,0,0,0,0,33027
10685,17574,1056,3309,5555,4368,3286,1577,580,541,154,0,387,39,39,39,0,0,0,0,0,0,997,881,187,57,637,116,77,58,0,19,39,0,0,39,33028
10686,30237,1868,5805,10579,6543,5442,3037,1498,1409,103,319,987,89,89,28,61,0,0,0,0,0,1539,1447,343,182,922,92,92,92,0,0,0,0,0,0,33029
10687,20073,8909,5337,3932,1345,550,1826,882,611,78,43,490,271,97,31,0,66,174,21,61,92,944,690,21,54,615,254,56,9,37,10,198,0,27,171,33030
10688,4441,763,972,1296,769,641,290,160,93,32,33,28,67,0,0,0,0,67,0,0,67,130,104,25,0,79,26,26,19,0,7,0,0,0,0,33031
10689,22011,5487,6367,6250,2762,1145,2305,1163,984,164,86,734,179,113,0,59,54,66,13,0,53,1142,934,51,33,850,208,104,44,34,26,104,0,70,34,33032
10690,30005,8556,8581,8260,3264,1344,3385,1837,1140,238,63,839,697,294,156,16,122,403,161,20,222,1548,1110,188,94,828,438,294,102,41,151,144,32,26,86,33033
10691,17863,8189,5288,3437,661,288,1373,591,454,0,58,396,137,61,41,0,20,76,0,0,76,782,450,33,46,371,332,100,50,0,50,232,71,46,115,33034
10692,8847,1350,2369,2553,1789,786,430,298,194,15,9,170,104,15,15,0,0,89,0,0,89,132,132,0,31,101,0,0,0,0,0,0,0,0,0,33035
10693,3270,111,1301,957,569,332,136,65,53,26,9,18,12,12,12,0,0,0,0,0,0,71,71,22,0,49,0,0,0,0,0,0,0,0,0,33036
10694,10154,1196,2896,2896,1849,1317,455,277,254,32,20,202,23,7,0,0,7,16,16,0,0,178,175,75,33,67,3,3,0,3,0,0,0,0,0,33037
10695,231,160,30,41,0,0,0,0,0,0,0,0,0,0,0,0,0,0,0,0,0,0,0,0,0,0,0,0,0,0,0,0,0,0,0,33039
10696,24771,2792,7421,7991,4199,2368,997,568,353,58,0,295,215,195,113,73,9,20,7,0,13,429,338,126,12,200,91,83,28,2,53,8,0,7,1,33040
10697,5282,322,1360,1803,1095,702,138,108,108,16,15,77,0,0,0,0,0,0,0,0,0,30,24,0,12,12,6,6,6,0,0,0,0,0,0,33042
10698,3207,276,1108,1145,454,224,181,56,39,0,0,39,17,17,17,0,0,0,0,0,0,125,125,21,20,84,0,0,0,0,0,0,0,0,0,33043
10699,6271,921,1661,2062,1066,561,375,227,190,26,24,140,37,8,8,0,0,29,6,23,0,148,144,21,57,66,4,4,0,4,0,0,0,0,0,33050
10700,604,18,113,195,143,135,15,3,3,0,0,3,0,0,0,0,0,0,0,0,0,12,4,0,0,4,8,8,8,0,0,0,0,0,0,33051
10701,17258,4930,6369,4239,1307,413,2359,1159,841,55,40,746,318,130,0,31,99,188,0,0,188,1200,801,112,47,642,399,321,107,0,214,78,10,0,68,33054
10702,31360,8074,12589,6750,2731,1216,2588,1154,785,61,59,665,369,236,85,23,128,133,0,0,133,1434,1172,212,58,902,262,117,15,0,102,145,10,0,135,33055
10703,21153,3927,7975,6200,2004,1047,1988,1084,896,74,75,747,188,114,36,18,60,74,4,0,70,904,756,104,66,586,148,138,65,0,73,10,10,0,0,33056
10704,23216,4764,7434,6646,3107,1265,1933,978,781,68,76,637,197,102,27,60,15,95,32,20,43,955,743,200,100,443,212,115,51,0,64,97,13,18,66,33060
10705,19846,1350,5134,5335,5132,2895,332,139,129,49,33,47,10,0,0,0,0,10,0,10,0,193,155,18,0,137,38,0,0,0,0,38,0,0,38,33062
10706,38348,4778,13131,11272,6536,2631,2013,1039,900,124,195,581,139,139,89,18,32,0,0,0,0,974,910,243,23,644,64,64,58,0,6,0,0,0,0,33063
10707,38036,7258,13850,9425,4933,2570,2413,1297,966,50,46,870,331,99,67,22,10,232,32,118,82,1116,996,325,35,636,120,37,28,0,9,83,69,0,14,33064
10708,33341,4090,9596,11540,6027,2088,3634,1919,1621,402,211,1008,298,260,144,19,97,38,38,0,0,1715,1514,366,278,870,201,114,67,47,0,87,0,0,87,33065
10709,12997,1255,3823,3768,2551,1600,527,419,408,137,0,271,11,0,0,0,0,11,11,0,0,108,97,40,9,48,11,11,11,0,0,0,0,0,0,33066
10710,16488,614,2584,4828,5559,2903,1616,841,829,162,103,564,12,12,12,0,0,0,0,0,0,775,764,264,26,474,11,0,0,0,0,11,11,0,0,33067
10711,30342,6510,11243,7931,3647,1011,3359,1506,1297,187,251,859,209,69,16,0,53,140,30,88,22,1853,1636,304,113,1219,217,192,52,50,90,25,25,0,0,33068
10712,19878,3264,6651,5200,3105,1658,929,502,318,20,61,237,184,103,21,38,44,81,0,14,67,427,315,50,42,223,112,109,14,3,92,3,0,0,3,33069
10713,3636,159,1318,1146,689,324,292,192,149,13,0,136,43,43,43,0,0,0,0,0,0,100,88,0,0,88,12,0,0,0,0,12,0,0,12,33070
10714,24609,1362,5075,8565,6286,3321,2547,1283,1217,195,134,888,66,42,28,0,14,24,0,24,0,1264,1189,419,110,660,75,75,0,38,37,0,0,0,0,33071
10715,19014,1173,5671,5807,4644,1719,1846,950,893,234,30,629,57,36,0,36,0,21,0,0,21,896,592,95,66,431,304,189,79,0,110,115,71,44,0,33073
10716,19059,454,3041,5516,6207,3841,2049,1217,1125,305,30,790,92,80,7,15,58,12,0,0,12,832,802,257,22,523,30,30,16,0,14,0,0,0,0,33076
10717,0,0,0,0,0,0,0,0,0,0,0,0,0,0,0,0,0,0,0,0,0,0,0,0,0,0,0,0,0,0,0,0,0,0,0,33101
10718,364,89,56,0,73,146,0,0,0,0,0,0,0,0,0,0,0,0,0,0,0,0,0,0,0,0,0,0,0,0,0,0,0,0,0,33109
10719,0,0,0,0,0,0,0,0,0,0,0,0,0,0,0,0,0,0,0,0,0,0,0,0,0,0,0,0,0,0,0,0,0,0,0,33122
10720,40153,14980,15248,5292,3635,998,2015,1048,766,55,13,698,282,135,56,0,79,147,0,30,117,967,775,86,44,645,192,22,21,1,0,170,10,0,160,33125
10721,34938,9996,10687,8481,4184,1590,1993,841,669,36,19,614,172,151,47,30,74,21,21,0,0,1152,998,323,82,593,154,154,116,0,38,0,0,0,0,33126
10722,19069,7414,6474,3570,1280,331,1359,737,607,52,82,473,130,43,0,33,10,87,0,28,59,622,422,86,0,336,200,105,0,0,105,95,0,32,63,33127
10723,5608,2725,1659,730,328,166,299,147,130,47,0,83,17,17,0,0,17,0,0,0,0,152,152,45,0,107,0,0,0,0,0,0,0,0,0,33128
10724,11199,1113,1762,2389,2907,3028,246,192,147,0,0,147,45,45,18,0,27,0,0,0,0,54,54,11,0,43,0,0,0,0,0,0,0,0,0,33129
10725,17742,6236,5048,2502,2872,1084,848,502,371,22,12,337,131,102,35,0,67,29,0,0,29,346,238,0,0,238,108,74,16,0,58,34,0,0,34,33130
10726,11243,237,789,1868,4574,3775,272,97,97,68,0,29,0,0,0,0,0,0,0,0,0,175,158,0,0,158,17,17,17,0,0,0,0,0,0,33131
10727,8408,900,1487,1840,2209,1972,183,96,96,0,16,80,0,0,0,0,0,0,0,0,0,87,87,17,0,70,0,0,0,0,0,0,0,0,0,33132
10728,24217,2921,4372,5298,6600,5026,1274,759,687,146,82,459,72,72,72,0,0,0,0,0,0,515,460,94,17,349,55,55,1,54,0,0,0,0,0,33133
10729,30443,4283,5967,6830,6762,6601,1612,781,770,100,81,589,11,11,11,0,0,0,0,0,0,831,635,85,43,507,196,127,87,0,40,69,0,0,69,33134
10730,26381,8949,9425,4593,2430,984,1744,868,545,59,60,426,323,104,59,0,45,219,89,0,130,876,733,89,25,619,143,106,0,0,106,37,20,0,17,33135
10731,9047,3239,2624,1657,1137,390,641,322,251,0,15,236,71,0,0,0,0,71,17,0,54,319,261,15,0,246,58,52,8,0,44,6,0,0,6,33136
10732,15061,2525,3722,4003,2855,1956,751,357,232,30,21,181,125,38,8,0,30,87,0,39,48,394,300,31,35,234,94,54,19,14,21,40,40,0,0,33137
10733,20317,4207,5102,4659,3298,3051,1020,663,598,126,59,413,65,47,47,0,0,18,0,0,18,357,330,23,12,295,27,23,0,23,0,4,4,0,0,33138
10734,31267,4198,5076,7758,7545,6690,341,184,69,0,11,58,115,16,16,0,0,99,99,0,0,157,145,49,0,96,12,0,0,0,0,12,0,0,12,33139
10735,16415,1250,2790,3581,4225,4569,553,295,242,19,0,223,53,0,0,0,0,53,0,0,53,258,220,23,0,197,38,13,3,0,10,25,0,0,25,33140
10736,27388,4501,7287,6844,5313,3443,2193,1108,863,69,59,735,245,108,108,0,0,137,0,0,137,1085,863,182,54,627,222,63,43,20,0,159,64,0,95,33141
10737,35616,13455,14337,5270,1927,627,3340,1729,1245,50,80,1115,484,223,87,51,85,261,21,58,182,1611,1279,73,149,1057,332,209,10,101,98,123,29,14,80,33142
10738,21539,2043,3425,4996,6308,4767,1155,674,674,52,9,613,0,0,0,0,0,0,0,0,0,481,448,48,20,380,33,15,15,0,0,18,0,9,9,33143
10739,19880,7609,5169,3721,2390,991,914,412,330,81,31,218,82,50,12,38,0,32,0,18,14,502,502,17,0,485,0,0,0,0,0,0,0,0,0,33144
10740,24016,5875,6593,4674,4844,2030,1341,631,559,164,52,343,72,41,0,34,7,31,13,0,18,710,616,158,27,431,94,94,94,0,0,0,0,0,0,33145
10741,7199,337,588,1252,2519,2503,3643,1883,1883,346,35,1502,0,0,0,0,0,0,0,0,0,1760,1760,563,112,1085,0,0,0,0,0,0,0,0,0,33146
10742,28083,7897,10920,6747,1752,767,2768,1614,1333,80,94,1159,281,154,53,61,40,127,13,0,114,1154,1012,96,174,742,142,124,35,53,36,18,0,5,13,33147
10743,8010,188,473,1269,3124,2956,508,217,217,45,0,172,0,0,0,0,0,0,0,0,0,291,291,8,0,283,0,0,0,0,0,0,0,0,0,33149
10744,17123,5228,5408,4301,1362,824,1530,823,644,40,104,500,179,57,9,11,37,122,0,53,69,707,641,65,82,494,66,66,3,30,33,0,0,0,0,33150
10745,9987,784,1709,2349,3103,2042,330,184,184,0,14,170,0,0,0,0,0,0,0,0,0,146,146,0,0,146,0,0,0,0,0,0,0,0,0,33154
10746,33947,6946,8115,8809,5875,4202,1459,882,681,84,58,539,201,166,97,0,69,35,17,2,16,577,528,112,27,389,49,17,0,17,0,32,32,0,0,33155
10747,21334,1340,2551,4664,6377,6402,1809,920,905,158,87,660,15,13,0,13,0,2,0,0,2,889,844,57,49,738,45,41,41,0,0,4,0,0,4,33156
10748,43510,6467,11929,12212,7914,4988,4402,1927,1786,210,84,1492,141,121,76,29,16,20,0,20,0,2475,2287,441,167,1679,188,125,94,31,0,63,0,34,29,33157
10749,4497,126,350,1143,1622,1256,598,404,404,0,0,404,0,0,0,0,0,0,0,0,0,194,183,0,0,183,11,11,11,0,0,0,0,0,0,33158
10750,30777,2362,6361,8510,7284,6260,744,358,329,21,0,308,29,29,15,0,14,0,0,0,0,386,326,38,0,288,60,7,7,0,0,53,0,0,53,33160
10751,33668,9042,10127,9151,3771,1577,3763,1933,1472,170,102,1200,461,284,46,137,101,177,0,40,137,1830,1508,317,102,1089,322,180,40,26,114,142,34,0,108,33161
10752,28683,5955,9921,7766,3425,1616,2879,1494,1201,103,7,1091,293,253,113,37,103,40,0,13,27,1385,1229,311,98,820,156,106,81,25,0,50,0,0,50,33162
10753,41948,9063,14316,8619,7086,2864,2401,1142,1003,172,43,788,139,90,12,25,53,49,0,18,31,1259,1108,174,38,896,151,150,0,31,119,1,0,0,1,33165
10754,15975,2864,4410,4603,2569,1529,1093,665,436,72,33,331,229,74,13,32,29,155,0,0,155,428,403,114,0,289,25,19,0,10,9,6,0,0,6,33166
10755,12865,3557,4538,3372,961,437,1346,553,396,34,30,332,157,11,11,0,0,146,34,54,58,793,613,31,9,573,180,84,55,0,29,96,13,0,83,33167
10756,17590,5785,5179,4125,1557,944,1827,984,869,112,88,669,115,53,53,0,0,62,0,13,49,843,706,72,37,597,137,52,0,0,52,85,0,0,85,33168
10757,24665,3981,9183,7630,2520,1351,1882,1000,727,31,69,627,273,224,60,14,150,49,0,0,49,882,798,109,80,609,84,52,0,22,30,32,32,0,0,33169
10758,6988,1230,3004,1569,801,384,873,350,279,36,17,226,71,0,0,0,0,71,0,29,42,523,457,36,39,382,66,44,34,10,0,22,0,0,22,33170
10759,27629,5977,8386,6294,5239,1733,1504,643,620,28,32,560,23,0,0,0,0,23,0,0,23,861,634,118,25,491,227,121,0,0,121,106,0,0,106,33172
10760,25806,4426,5552,7041,5902,2885,1347,792,647,187,10,450,145,118,0,42,76,27,10,11,6,555,490,46,37,407,65,58,12,46,0,7,0,0,7,33173
10761,20351,5271,5790,4428,3533,1329,2233,901,886,81,20,785,15,15,8,0,7,0,0,0,0,1332,1302,205,19,1078,30,26,0,26,0,4,0,0,4,33174
10762,37895,8568,11643,8790,6063,2831,2510,1331,1277,126,119,1032,54,45,20,0,25,9,0,0,9,1179,1084,135,66,883,95,95,23,28,44,0,0,0,0,33175
10763,35524,3471,7686,9427,8991,5949,2807,1466,1364,306,206,852,102,102,0,0,102,0,0,0,0,1341,1297,326,15,956,44,28,20,8,0,16,16,0,0,33176
10764,37880,7907,12741,10078,5025,2129,3344,1878,1495,275,86,1134,383,249,63,56,130,134,62,18,54,1466,1365,263,122,980,101,22,11,0,11,79,10,0,69,33177
10765,26667,1567,5079,5345,9769,4907,2530,1320,1185,204,23,958,135,90,35,15,40,45,0,0,45,1210,1143,128,18,997,67,67,0,34,33,0,0,0,0,33178
10766,29317,3762,8770,9132,4970,2683,1813,786,736,174,32,530,50,17,0,0,17,33,0,0,33,1027,922,47,21,854,105,36,18,0,18,69,27,21,21,33179
10767,24561,1367,4936,5986,6461,5811,1039,493,472,22,29,421,21,21,21,0,0,0,0,0,0,546,514,28,25,461,32,9,0,9,0,23,0,0,23,33180
10768,11802,1377,3019,3675,2049,1682,893,477,443,66,13,364,34,34,10,0,24,0,0,0,0,416,416,74,7,335,0,0,0,0,0,0,0,0,0,33181
10769,11373,2221,3394,2627,2068,1063,1130,572,510,107,0,403,62,16,0,0,16,46,0,12,34,558,541,73,0,468,17,17,5,0,12,0,0,0,0,33182
10770,26503,3944,7151,7936,5261,2211,2260,996,788,110,40,638,208,69,0,42,27,139,18,62,59,1264,1088,151,62,875,176,106,0,62,44,70,0,45,25,33183
10771,15026,3599,4100,3394,2794,1139,1048,380,326,18,0,308,54,33,33,0,0,21,0,0,21,668,577,80,29,468,91,91,39,36,16,0,0,0,0,33184
10772,18700,3477,3447,5461,3977,2338,1595,683,646,27,62,557,37,0,0,0,0,37,0,0,37,912,719,114,0,605,193,177,14,0,163,16,0,0,16,33185
10773,46584,4073,11737,13126,11350,6298,4048,2165,1892,228,79,1585,273,258,33,86,139,15,0,0,15,1883,1675,344,53,1278,208,173,87,0,86,35,0,0,35,33186
10774,11263,1923,3134,3248,2161,797,1109,477,429,86,37,306,48,20,0,20,0,28,0,0,28,632,632,55,25,552,0,0,0,0,0,0,0,0,0,33187
10775,15315,2228,4500,5102,2212,1273,1308,899,815,59,15,741,84,84,35,36,13,0,0,0,0,409,382,76,7,299,27,0,0,0,0,27,14,0,13,33189
10776,6708,839,1544,2528,1171,626,575,308,248,19,21,208,60,29,0,0,29,31,0,0,31,267,267,112,13,142,0,0,0,0,0,0,0,0,0,33190
10777,31239,5379,8200,8736,6617,2307,3156,1741,1662,143,105,1414,79,34,23,0,11,45,0,0,45,1415,1316,71,123,1122,99,59,25,0,34,40,0,0,40,33193
10778,5237,1582,1218,1279,651,507,305,164,146,50,0,96,18,0,0,0,0,18,0,0,18,141,127,16,0,111,14,0,0,0,0,14,0,14,0,33194
10779,28427,2666,6975,9602,6632,2552,3183,1721,1562,313,173,1076,159,46,23,0,23,113,80,33,0,1462,1351,310,27,1014,111,101,66,15,20,10,10,0,0,33196
10780,11287,507,1449,2580,3771,2980,353,205,171,26,14,131,34,7,0,0,7,27,0,0,27,148,132,7,42,83,16,16,16,0,0,0,0,0,0,33301
10781,14684,2076,3172,4006,3410,2020,505,170,144,11,19,114,26,4,0,4,0,22,22,0,0,335,300,42,46,212,35,35,0,27,8,0,0,0,0,33304
10782,10053,622,2297,2893,2605,1636,349,204,192,0,19,173,12,12,12,0,0,0,0,0,0,145,145,40,0,105,0,0,0,0,0,0,0,0,0,33305
10783,2895,101,647,822,695,630,153,137,137,97,0,40,0,0,0,0,0,0,0,0,0,16,0,0,0,0,16,16,16,0,0,0,0,0,0,33306
10784,23168,1455,4710,6253,6317,4433,538,296,271,61,24,186,25,25,0,0,25,0,0,0,0,242,214,86,0,128,28,28,28,0,0,0,0,0,0,33308
10785,24308,4322,6553,7687,4042,1704,1581,1001,916,159,117,640,85,54,4,20,30,31,17,0,14,580,490,48,146,296,90,52,52,0,0,38,0,0,38,33309
10786,40958,11091,14792,10409,3117,1549,4097,1808,1490,127,343,1020,318,93,39,9,45,225,53,89,83,2289,1922,336,203,1383,367,292,46,156,90,75,21,31,23,33311
10787,36729,6481,11369,10354,5300,3225,2697,1363,894,174,65,655,469,319,83,66,170,150,0,36,114,1334,1245,302,170,773,89,49,12,9,28,40,0,0,40,33312
10788,35604,7364,12703,10074,3907,1556,3321,1716,1355,129,259,967,361,224,44,110,70,137,0,29,108,1605,1412,296,134,982,193,116,47,0,69,77,0,0,77,33313
10789,14437,2521,4450,4795,1840,831,1526,830,636,30,43,563,194,80,0,15,65,114,0,52,62,696,650,122,38,490,46,34,0,34,0,12,0,0,12,33314
10790,9376,1049,2287,3411,1911,718,291,181,171,63,0,108,10,10,10,0,0,0,0,0,0,110,107,0,49,58,3,2,0,0,2,1,0,0,1,33315
10791,8852,771,1550,2262,2687,1582,266,164,151,53,0,98,13,13,0,0,13,0,0,0,0,102,102,0,42,60,0,0,0,0,0,0,0,0,0,33316
10792,24553,3384,6401,7358,4753,2657,2120,1032,851,278,89,484,181,88,73,0,15,93,31,0,62,1088,918,211,73,634,170,72,55,0,17,98,51,0,47,33317
10793,33245,4601,10965,10126,4589,2964,2423,1151,1058,103,118,837,93,60,60,0,0,33,10,0,23,1272,1125,422,157,546,147,51,0,42,9,96,0,96,0,33319
10794,34256,2559,11907,11598,5894,2298,1800,965,843,301,72,470,122,67,36,0,31,55,40,0,15,835,713,123,124,466,122,102,11,53,38,20,0,0,20,33321
10795,29052,3335,8317,8838,5427,3135,1030,435,407,35,37,335,28,28,0,0,28,0,0,0,0,595,569,96,107,366,26,26,0,17,9,0,0,0,0,33322
10796,13694,1043,3712,4534,2962,1443,777,399,374,107,34,233,25,25,0,14,11,0,0,0,0,378,358,120,25,213,20,20,10,10,0,0,0,0,0,33323
10797,32643,1507,7165,10893,8335,4743,1781,890,787,288,49,450,103,93,43,0,50,10,0,10,0,891,805,168,113,524,86,3,0,3,0,83,51,32,0,33324
10798,20237,2310,5305,5929,4219,2474,1975,929,824,278,91,455,105,16,0,16,0,89,72,0,17,1046,929,273,157,499,117,86,40,46,0,31,0,15,16,33325
10799,21018,943,3479,6038,6517,4041,1711,886,729,146,89,494,157,134,109,0,25,23,0,9,14,825,701,217,9,475,124,104,67,19,18,20,0,0,20,33326
10800,12746,270,977,3163,4551,3785,1342,772,758,91,51,616,14,14,0,14,0,0,0,0,0,570,525,162,0,363,45,23,23,0,0,22,0,22,0,33327
10801,18773,1008,4423,5859,4667,2816,1686,959,811,47,74,690,148,138,96,12,30,10,0,10,0,727,622,152,41,429,105,96,23,0,73,9,0,0,9,33328
10802,9006,448,1743,3192,2069,1554,1108,605,560,79,26,455,45,45,11,0,34,0,0,0,0,503,503,151,35,317,0,0,0,0,0,0,0,0,0,33330
10803,14793,929,2756,4348,4163,2597,1774,1258,1219,503,80,636,39,9,9,0,0,30,0,0,30,516,509,75,75,359,7,0,0,0,0,7,0,0,7,33331
10804,6970,524,857,1884,1896,1809,1147,513,445,61,61,323,68,68,0,0,68,0,0,0,0,634,628,55,0,573,6,0,0,0,0,6,0,0,6,33332
10805,20915,3111,5607,6870,3679,1648,1295,670,591,122,46,423,79,55,55,0,0,24,0,24,0,625,504,83,72,349,121,47,15,32,0,74,20,50,4,33334
10806,22750,2123,6895,7636,4334,1762,1734,825,738,104,62,572,87,87,87,0,0,0,0,0,0,909,752,111,123,518,157,140,54,18,68,17,0,17,0,33351
10807,17617,2424,4950,4428,3623,2192,1505,578,511,54,95,362,67,16,6,6,4,51,0,12,39,927,792,205,120,467,135,51,20,0,31,84,0,0,84,33401
10808,8470,1305,2782,2857,916,610,345,115,83,19,0,64,32,19,0,19,0,13,12,0,1,230,219,57,37,125,11,11,11,0,0,0,0,0,0,33403
10809,17978,3168,5795,5046,2511,1458,1904,972,747,74,171,502,225,137,31,27,79,88,29,0,59,932,787,144,191,452,145,86,80,6,0,59,23,0,36,33404
10810,15271,3864,3831,3731,2475,1370,1081,758,665,119,49,497,93,93,35,13,45,0,0,0,0,323,188,72,34,82,135,35,0,34,1,100,0,0,100,33405
10811,17704,3026,6404,4205,2848,1221,1364,780,526,71,26,429,254,85,28,0,57,169,23,0,146,584,468,63,38,367,116,67,43,23,1,49,0,49,0,33406
10812,18357,4698,5039,4931,2271,1418,1606,798,673,51,79,543,125,81,80,0,1,44,0,0,44,808,641,111,205,325,167,121,71,28,22,46,0,46,0,33407
10813,14545,614,3753,4007,3934,2237,475,215,208,47,51,110,7,7,7,0,0,0,0,0,0,260,260,105,0,155,0,0,0,0,0,0,0,0,0,33408
10814,19959,3590,5997,5716,3026,1630,1523,861,711,123,50,538,150,90,39,0,51,60,9,27,24,662,636,62,52,522,26,26,26,0,0,0,0,0,0,33409
10815,24323,1836,5507,7528,5796,3656,1516,617,553,127,27,399,64,12,12,0,0,52,0,0,52,899,822,256,51,515,77,47,10,31,6,30,0,10,20,33410
10816,44335,4084,12257,15329,7804,4861,3254,1773,1569,391,192,986,204,159,101,0,58,45,2,10,33,1481,1198,378,81,739,283,169,17,17,135,114,32,55,27,33411
10817,9871,665,2392,3271,2062,1481,486,241,241,21,22,198,0,0,0,0,0,0,0,0,0,245,245,64,8,173,0,0,0,0,0,0,0,0,0,33412
10818,9876,1340,3405,2547,1916,668,748,459,306,119,16,171,153,61,61,0,0,92,0,92,0,289,289,80,0,209,0,0,0,0,0,0,0,0,0,33413
10819,34288,2057,7266,11193,8418,5354,3756,1913,1815,272,281,1262,98,95,44,0,51,3,0,0,3,1843,1605,329,117,1159,238,185,120,26,39,53,7,0,46,33414
10820,28897,6528,10329,7855,2937,1248,2523,1261,939,155,55,729,322,267,124,81,62,55,19,28,8,1262,1057,154,49,854,205,111,86,3,22,94,54,27,13,33415
10821,21742,4257,7252,6443,2334,1456,1087,400,281,70,6,205,119,62,12,0,50,57,50,7,0,687,543,134,86,323,144,57,0,30,27,87,0,0,87,33417
10822,28499,1160,5398,8436,7339,6166,1392,808,677,131,106,440,131,131,68,14,49,0,0,0,0,584,552,139,27,386,32,32,19,0,13,0,0,0,0,33418
10823,15364,1672,3987,5633,2831,1241,688,294,294,69,79,146,0,0,0,0,0,0,0,0,0,394,341,137,25,179,53,32,32,0,0,21,0,21,0,33426
10824,26452,2392,7315,8555,5328,2862,2368,1315,1220,326,216,678,95,72,64,0,8,23,0,7,16,1053,951,266,143,542,102,94,94,0,0,8,8,0,0,33428
10825,13175,5018,4128,2438,1052,539,1439,816,511,18,53,440,305,165,40,23,102,140,33,0,107,623,531,37,133,361,92,52,0,0,52,40,0,17,23,33430
10826,11545,508,2307,3303,3202,2225,2477,1156,1091,140,133,818,65,14,14,0,0,51,0,44,7,1321,1306,312,238,756,15,15,15,0,0,0,0,0,0,33431
10827,14447,729,2814,4360,3911,2633,892,537,495,167,92,236,42,10,0,0,10,32,0,32,0,355,342,111,105,126,13,13,13,0,0,0,0,0,0,33432
10828,32430,1687,6828,10149,8178,5588,1594,705,631,163,24,444,74,59,42,0,17,15,15,0,0,889,869,180,7,682,20,20,1,0,19,0,0,0,0,33433
10829,16215,1283,3031,4231,4479,3191,801,408,396,151,32,213,12,12,0,12,0,0,0,0,0,393,345,66,79,200,48,40,26,14,0,8,8,0,0,33434
10830,23374,4384,7075,6968,3177,1770,1934,1019,787,72,270,445,232,114,39,69,6,118,0,10,108,915,829,122,291,416,86,55,0,52,3,31,0,31,0,33435
10831,32571,2727,9616,10550,6462,3216,1266,576,442,114,77,251,134,48,48,0,0,86,28,0,58,690,555,211,12,332,135,60,60,0,0,75,0,66,9,33436
10832,32535,1920,8155,9742,6964,5754,631,365,313,0,83,230,52,48,23,25,0,4,4,0,0,266,202,38,0,164,64,64,64,0,0,0,0,0,0,33437
10833,325,88,172,65,0,0,28,19,19,0,0,19,0,0,0,0,0,0,0,0,0,9,9,0,0,9,0,0,0,0,0,0,0,0,0,33438
10834,11290,3917,3721,2375,918,359,1195,726,529,4,22,503,197,125,30,13,82,72,57,0,15,469,420,60,28,332,49,45,11,0,34,4,0,0,4,33440
10835,19269,3415,6942,5073,2920,919,909,498,410,117,22,271,88,49,28,14,7,39,0,0,39,411,373,86,58,229,38,38,10,0,28,0,0,0,0,33441
10836,23023,2155,7544,6429,4638,2257,446,270,204,26,30,148,66,14,7,0,7,52,0,0,52,176,176,74,6,96,0,0,0,0,0,0,0,0,0,33442
10837,15221,3368,3447,4394,2941,1071,1164,471,413,101,54,258,58,43,38,5,0,15,0,15,0,693,571,156,172,243,122,58,18,40,0,64,19,24,21,33444
10838,23365,3040,5362,6947,5047,2969,954,383,332,96,31,205,51,51,14,37,0,0,0,0,0,571,524,150,37,337,47,12,0,0,12,35,0,0,35,33445
10839,19938,1527,5600,5115,4255,3441,211,82,68,25,0,43,14,14,0,0,14,0,0,0,0,129,129,0,0,129,0,0,0,0,0,0,0,0,0,33446
10840,6750,435,1228,1859,1748,1480,773,262,245,94,38,113,17,17,0,0,17,0,0,0,0,511,511,55,96,360,0,0,0,0,0,0,0,0,0,33449
10841,16294,1318,4567,5267,3290,1852,765,371,326,62,40,224,45,45,19,26,0,0,0,0,0,394,369,143,17,209,25,25,14,11,0,0,0,0,0,33455
10842,35670,3586,7173,9723,10242,4946,2501,1298,1166,479,48,639,132,122,31,39,52,10,10,0,0,1203,1082,461,55,566,121,35,14,0,21,86,21,65,0,33458
10843,21234,7416,5563,4472,2555,1228,1522,1063,817,138,157,522,246,31,31,0,0,215,121,80,14,459,328,34,103,191,131,71,0,16,55,60,43,0,17,33460
10844,25796,7228,8144,6535,2696,1193,1757,967,642,151,90,401,325,91,44,47,0,234,165,35,34,790,687,67,79,541,103,55,0,40,15,48,28,0,20,33461
10845,21640,4142,6444,6152,3144,1758,1394,584,514,33,61,420,70,18,0,0,18,52,0,0,52,810,803,175,125,503,7,7,0,3,4,0,0,0,0,33462
10846,35919,7469,11161,10310,4824,2155,3516,1953,1674,199,386,1089,279,202,110,92,0,77,68,9,0,1563,1351,441,284,626,212,155,108,11,36,57,0,9,48,33463
10847,37012,2765,9397,11626,8585,4639,2778,1341,1246,378,77,791,95,57,21,36,0,38,0,12,26,1437,1153,372,65,716,284,193,158,13,22,91,44,10,37,33467
10848,11375,568,2514,3200,3593,1500,425,275,275,132,15,128,0,0,0,0,0,0,0,0,0,150,137,44,19,74,13,13,13,0,0,0,0,0,0,33469
10849,17082,2027,5729,5677,2579,1070,1773,1036,832,259,13,560,204,198,177,21,0,6,0,0,6,737,638,100,46,492,99,52,46,0,6,47,9,38,0,33470
10850,5352,1313,2399,1110,409,121,283,140,35,16,0,19,105,100,0,100,0,5,0,0,5,143,75,0,0,75,68,0,0,0,0,68,0,68,0,33471
10851,15383,488,4401,4766,3364,2364,761,447,325,36,0,289,122,122,122,0,0,0,0,0,0,314,300,87,44,169,14,14,14,0,0,0,0,0,0,33472
10852,3664,58,504,578,1288,1236,111,111,111,0,0,111,0,0,0,0,0,0,0,0,0,0,0,0,0,0,0,0,0,0,0,0,0,0,0,33473
10853,4417,1906,1273,839,330,69,596,303,198,17,19,162,105,0,0,0,0,105,0,41,64,293,230,26,30,174,63,63,0,0,63,0,0,0,0,33476
10854,11220,339,2268,2931,3392,2290,167,110,74,0,0,74,36,12,12,0,0,24,0,0,24,57,48,0,0,48,9,9,0,0,9,0,0,0,0,33477
10855,8771,482,2593,3011,1868,817,871,553,435,138,16,281,118,52,52,0,0,66,42,9,15,318,238,89,65,84,80,80,38,0,42,0,0,0,0,33478
10856,8885,236,1253,2265,2981,2150,115,31,31,0,8,23,0,0,0,0,0,0,0,0,0,84,84,14,0,70,0,0,0,0,0,0,0,0,0,33480
10857,10245,476,1654,2890,3429,1796,342,167,159,24,40,95,8,0,0,0,0,8,0,8,0,175,141,30,10,101,34,24,14,0,10,10,5,5,0,33483
10858,21772,2084,6824,6221,4120,2523,436,194,176,47,34,95,18,18,0,0,18,0,0,0,0,242,177,11,16,150,65,50,0,17,33,15,15,0,0,33484
10859,15710,618,2693,4668,4695,3036,1049,620,573,80,67,426,47,9,9,0,0,38,38,0,0,429,416,82,33,301,13,13,13,0,0,0,0,0,0,33486
10860,13573,826,2810,3514,4252,2171,637,305,270,84,19,167,35,35,35,0,0,0,0,0,0,332,315,76,9,230,17,17,0,17,0,0,0,0,0,33487
10861,3674,1106,1524,854,117,73,190,119,83,0,8,75,36,11,11,0,0,25,0,0,25,71,59,0,14,45,12,7,0,0,7,5,0,0,5,33493
10862,17261,726,3208,4309,5038,3980,1117,689,621,32,88,501,68,68,68,0,0,0,0,0,0,428,428,26,22,380,0,0,0,0,0,0,0,0,0,33496
10863,10113,398,1897,2694,2950,2174,979,402,379,45,35,299,23,23,7,16,0,0,0,0,0,577,577,158,0,419,0,0,0,0,0,0,0,0,0,33498
10864,54,10,4,9,13,18,0,0,0,0,0,0,0,0,0,0,0,0,0,0,0,0,0,0,0,0,0,0,0,0,0,0,0,0,0,33503
10865,17289,1595,5647,5717,3131,1199,1645,795,682,113,38,531,113,44,19,25,0,69,0,22,47,850,776,144,61,571,74,62,48,0,14,12,12,0,0,33510
10866,34320,2981,9690,12165,6593,2891,2945,1611,1423,248,142,1033,188,134,116,18,0,54,7,0,47,1334,1130,337,43,750,204,200,47,65,88,4,0,0,4,33511
10867,8901,2387,3446,2136,538,394,582,420,262,26,15,221,158,32,0,8,24,126,0,39,87,162,113,23,28,62,49,18,14,0,4,31,31,0,0,33513
10868,1191,279,478,303,113,18,246,124,101,7,23,71,23,15,10,0,5,8,0,8,0,122,106,14,17,75,16,16,5,11,0,0,0,0,0,33514
10869,446,70,306,64,6,0,15,1,1,0,0,1,0,0,0,0,0,0,0,0,0,14,14,0,0,14,0,0,0,0,0,0,0,0,0,33521
10870,11801,2617,4012,3337,1351,484,1112,596,436,127,16,293,160,92,68,24,0,68,0,41,27,516,400,135,32,233,116,62,62,0,0,54,0,0,54,33523
10871,12269,1928,4258,3665,1425,993,1074,650,583,139,48,396,67,34,8,26,0,33,0,0,33,424,392,94,6,292,32,32,21,0,11,0,0,0,0,33525
10872,9700,2842,3342,2320,831,365,760,395,280,11,21,248,115,48,24,0,24,67,0,0,67,365,241,68,30,143,124,52,0,0,52,72,3,12,57,33527
10873,8175,1525,2614,2753,999,284,909,516,322,39,9,274,194,76,8,4,64,118,55,15,48,393,373,20,49,304,20,10,0,0,10,10,0,5,5,33534
10874,3648,717,1300,1167,292,172,130,49,13,5,0,8,36,36,29,7,0,0,0,0,0,81,55,8,20,27,26,0,0,0,0,26,26,0,0,33538
10875,7147,1209,2742,2338,651,207,319,81,70,14,11,45,11,11,11,0,0,0,0,0,0,238,160,0,7,153,78,68,68,0,0,10,0,0,10,33540
10876,16830,2846,7141,4932,1451,460,520,325,305,15,6,284,20,0,0,0,0,20,7,13,0,195,141,17,0,124,54,54,0,0,54,0,0,0,0,33541
10877,16836,2969,7357,4611,1369,530,734,418,253,100,38,115,165,102,86,16,0,63,0,63,0,316,231,113,0,118,85,70,26,0,44,15,15,0,0,33542
10878,14692,830,3253,5322,3491,1796,1058,455,356,142,78,136,99,99,39,60,0,0,0,0,0,603,505,138,18,349,98,96,21,43,32,2,2,0,0,33543
10879,16033,1074,3465,5621,3342,2531,995,527,428,56,18,354,99,69,0,69,0,30,0,0,30,468,302,33,25,244,166,166,166,0,0,0,0,0,0,33544
10880,8212,626,2461,2809,1831,485,959,584,517,76,98,343,67,51,0,0,51,16,16,0,0,375,322,110,21,191,53,30,30,0,0,23,0,0,23,33545
10881,12707,990,2987,3565,3375,1790,1239,752,734,118,10,606,18,18,0,10,8,0,0,0,0,487,429,96,65,268,58,37,22,0,15,21,0,0,21,33547
10882,4102,268,790,1205,1193,646,286,90,90,19,0,71,0,0,0,0,0,0,0,0,0,196,185,24,20,141,11,0,0,0,0,11,0,0,11,33548
10883,10615,1042,2678,3445,2122,1328,1152,695,574,104,12,458,121,83,80,3,0,38,0,0,38,457,396,84,19,293,61,39,14,0,25,22,0,0,22,33549
10884,14034,519,3449,4345,3855,1866,1072,385,342,157,0,185,43,43,0,14,29,0,0,0,0,687,589,225,0,364,98,44,44,0,0,54,0,0,54,33556
10885,14111,554,3034,4455,4105,1963,1332,600,543,130,55,358,57,42,15,10,17,15,15,0,0,732,677,145,35,497,55,26,14,12,0,29,0,0,29,33558
10886,10934,862,2434,3413,2617,1608,692,219,192,75,8,109,27,27,27,0,0,0,0,0,0,473,357,164,27,166,116,85,28,0,57,31,0,0,31,33559
10887,16453,4143,6316,4155,1189,650,1460,865,709,57,48,604,156,72,72,0,0,84,52,8,24,595,498,88,88,322,97,79,37,9,33,18,0,0,18,33563
10888,13164,2558,4691,4112,1161,642,1002,555,474,173,35,266,81,50,38,0,12,31,0,12,19,447,346,104,60,182,101,79,35,44,0,22,9,0,13,33565
10889,13156,2619,4488,3358,1732,959,1623,722,576,68,148,360,146,97,47,30,20,49,49,0,0,901,721,172,91,458,180,172,48,0,124,8,0,0,8,33566
10890,6870,1741,2454,1826,600,249,487,301,199,6,26,167,102,74,33,31,10,28,20,0,8,186,164,5,33,126,22,0,0,0,0,22,22,0,0,33567
10891,16041,1492,4421,5778,3079,1271,1484,743,579,169,47,363,164,97,67,0,30,67,15,0,52,741,594,194,72,328,147,125,33,25,67,22,0,0,22,33569
10892,13996,3590,4389,3866,1385,766,865,543,325,23,20,282,218,170,77,11,82,48,16,20,12,322,244,41,6,197,78,17,17,0,0,61,14,0,47,33570
10893,10836,753,2704,3845,2172,1362,705,370,325,131,20,174,45,45,33,12,0,0,0,0,0,335,314,68,24,222,21,21,21,0,0,0,0,0,0,33572
10894,18677,1283,5451,6037,3529,2377,110,95,9,0,0,9,86,43,0,0,43,43,0,0,43,15,15,10,0,5,0,0,0,0,0,0,0,0,0,33573
10895,3102,320,911,1037,576,258,154,50,40,17,0,23,10,5,5,0,0,5,0,0,5,104,71,39,0,32,33,33,7,26,0,0,0,0,0,33576
10896,25765,2251,7322,8828,5054,2310,2050,1019,792,83,81,628,227,164,143,21,0,63,0,24,39,1031,877,169,68,640,154,130,75,24,31,24,0,0,24,33578
10897,16364,1399,4035,5925,3569,1436,1481,770,595,144,31,420,175,145,6,90,49,30,0,14,16,711,647,190,142,315,64,10,10,0,0,54,7,0,47,33579
10898,16385,2074,5463,5511,2425,912,1347,680,510,43,58,409,170,93,38,28,27,77,13,7,57,667,470,195,7,268,197,83,28,28,27,114,74,0,40,33584
10899,804,68,284,228,218,6,169,128,128,7,0,121,0,0,0,0,0,0,0,0,0,41,40,0,0,40,1,1,0,0,1,0,0,0,0,33585
10900,7401,1315,3172,1904,725,285,601,301,195,29,0,166,106,43,36,7,0,63,21,9,33,300,247,55,32,160,53,21,21,0,0,32,0,0,32,33592
10901,22381,2213,6461,7649,4006,2052,1843,925,855,208,56,591,70,45,36,9,0,25,0,0,25,918,799,183,65,551,119,73,25,0,48,46,46,0,0,33594
10902,19870,818,4100,6634,5444,2874,1816,987,934,302,25,607,53,36,36,0,0,17,0,0,17,829,725,94,60,571,104,94,26,12,56,10,0,10,0,33596
10903,5802,1463,2337,1388,456,158,362,183,168,21,26,121,15,0,0,0,0,15,0,15,0,179,160,14,21,125,19,16,0,0,16,3,0,0,3,33597
10904,7986,2807,1858,1903,982,436,924,430,240,28,30,182,190,158,55,15,88,32,12,6,14,494,311,30,0,281,183,130,43,53,34,53,0,0,53,33598
10905,9212,902,1390,1745,3219,1956,251,101,56,10,16,30,45,6,0,0,6,39,0,4,35,150,150,27,54,69,0,0,0,0,0,0,0,0,0,33602
10906,13799,2308,4601,4011,1851,1028,710,371,240,22,4,214,131,32,0,5,27,99,24,0,75,339,317,12,41,264,22,22,7,0,15,0,0,0,0,33603
10907,25008,4790,8898,6827,3409,1084,1565,860,604,35,81,488,256,182,86,24,72,74,23,17,34,705,607,71,96,440,98,61,14,30,17,37,0,0,37,33604
10908,10998,3609,3939,2330,840,280,931,497,326,9,39,278,171,60,40,12,8,111,8,38,65,434,336,18,142,176,98,70,30,16,24,28,0,0,28,33605
10909,10655,340,1123,2317,3794,3081,2489,1328,1293,357,52,884,35,13,0,0,13,22,0,0,22,1161,1153,258,54,841,8,0,0,0,0,8,0,8,0,33606
10910,16168,3755,5435,3821,2196,961,1276,480,389,7,28,354,91,27,19,0,8,64,5,2,57,796,700,139,75,486,96,90,33,0,57,6,6,0,0,33607
10911,13073,769,2517,3133,4488,2166,698,336,302,40,10,252,34,25,14,11,0,9,0,9,0,362,315,41,10,264,47,47,19,3,25,0,0,0,0,33609
10912,24166,5531,8466,7041,2060,1068,2562,1187,942,144,30,768,245,126,58,23,45,119,13,64,42,1375,1109,131,90,888,266,166,17,20,129,100,0,58,42,33610
10913,23992,1899,5789,6690,5448,4166,640,406,311,12,21,278,95,79,79,0,0,16,0,0,16,234,230,58,17,155,4,0,0,0,0,4,0,0,4,33611
10914,29308,6893,10246,8459,2259,1451,2620,1346,1138,107,121,910,208,156,87,2,67,52,0,0,52,1274,897,91,126,680,377,181,104,64,13,196,33,68,95,33612
10915,18625,3283,5218,4916,3307,1901,1782,926,643,90,127,426,283,246,55,8,183,37,17,20,0,856,729,206,77,446,127,71,19,27,25,56,20,36,0,33613
10916,32869,6604,12759,8763,3253,1490,2630,1675,1184,249,43,892,491,283,198,64,21,208,5,76,127,955,747,114,123,510,208,196,144,0,52,12,12,0,0,33614
10917,31443,4730,10298,9165,5323,1927,2041,847,706,244,124,338,141,130,35,0,95,11,0,11,0,1194,1012,237,89,686,182,120,102,18,0,62,11,37,14,33615
10918,9052,929,2909,2987,1555,672,722,438,331,48,4,279,107,43,0,0,43,64,13,0,51,284,202,62,19,121,82,55,5,0,50,27,0,0,27,33616
10919,26585,3230,8161,7851,4520,2823,2660,1306,1070,139,179,752,236,222,20,122,80,14,0,14,0,1354,1183,170,193,820,171,136,105,0,31,35,0,35,0,33617
10920,17284,1151,3483,4860,4881,2909,1182,715,638,160,45,433,77,8,0,8,0,69,7,62,0,467,414,134,23,257,53,40,40,0,0,13,0,13,0,33618
10921,22429,5731,7920,6047,1919,812,2226,1133,833,96,133,604,300,154,17,27,110,146,8,22,116,1093,905,155,148,602,188,79,52,27,0,109,0,81,28,33619
10922,28,0,4,24,0,0,3228,1335,1335,196,84,1055,0,0,0,0,0,0,0,0,0,1893,1893,495,67,1331,0,0,0,0,0,0,0,0,0,33620
10923,982,19,69,472,296,126,93,59,19,14,0,5,40,40,40,0,0,0,0,0,0,34,24,0,0,24,10,10,10,0,0,0,0,0,0,33621
10924,26678,2135,6487,8688,6210,3158,2256,996,811,139,90,582,185,124,85,13,26,61,0,0,61,1260,1171,267,149,755,89,73,22,0,51,16,16,0,0,33624
10925,16633,1595,4430,4937,3823,1848,1409,785,648,50,87,511,137,23,14,0,9,114,31,0,83,624,494,77,37,380,130,89,6,0,83,41,0,41,0,33625
10926,18055,426,2481,4699,6565,3884,923,409,400,68,51,281,9,9,9,0,0,0,0,0,0,514,432,14,37,381,82,0,0,0,0,82,0,20,62,33626
10927,16733,388,1690,3514,6485,4656,1183,724,713,74,75,564,11,11,11,0,0,0,0,0,0,459,437,63,6,368,22,22,0,0,22,0,0,0,0,33629
10928,13739,2040,4179,4108,2334,1078,794,399,304,35,16,253,95,65,30,35,0,30,15,0,15,395,354,93,5,256,41,22,22,0,0,19,19,0,0,33634
10929,11370,1100,2908,3571,2692,1099,808,398,283,77,22,184,115,103,17,39,47,12,0,0,12,410,368,119,6,243,42,42,42,0,0,0,0,0,0,33635
10930,10031,1179,2739,3146,1791,1176,920,648,505,152,34,319,143,76,76,0,0,67,8,37,22,272,259,41,0,218,13,0,0,0,0,13,0,0,13,33637
10931,36564,1121,5131,9786,11577,8949,2893,1536,1347,93,128,1126,189,124,102,0,22,65,35,0,30,1357,1237,292,30,915,120,100,91,0,9,20,0,0,20,33647
10932,11589,1274,2753,3524,2197,1841,380,175,156,31,15,110,19,19,19,0,0,0,0,0,0,205,118,54,33,31,87,87,60,7,20,0,0,0,0,33701
10933,22681,3222,6670,7085,3973,1731,1019,588,503,84,9,410,85,31,15,0,16,54,0,54,0,431,324,116,34,174,107,69,60,0,9,38,29,9,0,33702
10934,17605,1342,4500,4926,4318,2519,1013,487,427,232,0,195,60,60,39,21,0,0,0,0,0,526,489,135,37,317,37,0,0,0,0,37,0,8,29,33703
10935,12450,856,2001,3362,3661,2570,636,363,342,58,19,265,21,21,0,21,0,0,0,0,0,273,245,29,10,206,28,11,11,0,0,17,0,0,17,33704
10936,18159,2904,5786,4916,2798,1755,1339,666,597,110,67,420,69,31,3,0,28,38,20,18,0,673,520,59,51,410,153,153,34,40,79,0,0,0,0,33705
10937,13580,519,2805,3937,3658,2661,388,192,144,34,15,95,48,23,23,0,0,25,25,0,0,196,190,88,26,76,6,6,6,0,0,0,0,0,0,33706
10938,19602,1783,5643,5928,3919,2329,985,478,392,65,32,295,86,52,52,0,0,34,20,0,14,507,428,53,51,324,79,49,32,17,0,30,0,30,0,33707
10939,12965,1006,3516,4037,3000,1406,506,283,277,69,19,189,6,0,0,0,0,6,6,0,0,223,147,28,9,110,76,22,22,0,0,54,3,29,22,33708
10940,19575,3093,7774,5284,2287,1137,897,417,344,54,38,252,73,36,11,12,13,37,9,0,28,480,375,90,14,271,105,89,9,55,25,16,0,0,16,33709
10941,23647,2412,6926,8543,4001,1765,1375,695,612,149,55,408,83,82,42,0,40,1,0,0,1,680,577,263,0,314,103,64,40,0,24,39,11,0,28,33710
10942,11968,2043,3922,3552,1586,865,1658,958,835,75,30,730,123,56,0,16,40,67,0,5,62,700,634,94,72,468,66,66,30,32,4,0,0,0,0,33711
10943,16138,3013,5646,4162,2344,973,1826,906,740,98,148,494,166,96,67,29,0,70,17,28,25,920,811,117,79,615,109,64,53,11,0,45,0,35,10,33712
10944,21979,3273,7064,7235,3120,1287,1264,518,438,75,51,312,80,20,20,0,0,60,0,49,11,746,569,158,76,335,177,99,99,0,0,78,22,49,7,33713
10945,13795,2944,5499,3767,1210,375,782,405,296,97,14,185,109,104,45,0,59,5,0,0,5,377,312,59,0,253,65,35,23,12,0,30,0,17,13,33714
10946,5994,187,1189,1607,1718,1293,43,31,31,0,14,17,0,0,0,0,0,0,0,0,0,12,12,0,0,12,0,0,0,0,0,0,0,0,0,33715
10947,11324,608,2494,4015,2655,1552,276,57,57,37,10,10,0,0,0,0,0,0,0,0,0,219,153,36,0,117,66,66,44,0,22,0,0,0,0,33716
10948,121,40,20,44,0,17,10,10,0,0,0,0,10,0,0,0,0,10,0,0,10,0,0,0,0,0,0,0,0,0,0,0,0,0,0,33744
10949,16775,3216,5431,5100,2117,911,1081,480,368,65,23,280,112,66,60,0,6,46,0,46,0,601,383,90,0,293,218,142,46,45,51,76,7,0,69,33755
10950,21848,3025,7193,6895,3225,1510,1376,749,633,73,53,507,116,31,31,0,0,85,13,40,32,627,432,70,37,325,195,170,60,35,75,25,12,13,0,33756
10951,12284,1297,4265,3578,1998,1146,1072,527,444,88,21,335,83,73,25,0,48,10,0,10,0,545,485,114,63,308,60,46,24,0,22,14,7,0,7,33759
10952,10977,1902,3254,3666,1307,848,779,449,362,23,18,321,87,34,22,0,12,53,10,15,28,330,237,52,40,145,93,62,56,0,6,31,25,0,6,33760
10953,15120,1198,3692,4590,3708,1932,571,388,349,61,32,256,39,39,39,0,0,0,0,0,0,183,164,102,30,32,19,19,19,0,0,0,0,0,0,33761
10954,5992,771,1430,1573,1381,837,315,159,53,0,0,53,106,8,0,0,8,98,0,0,98,156,148,0,13,135,8,0,0,0,0,8,0,0,8,33762
10955,14913,1780,4691,4730,2546,1166,504,317,224,48,0,176,93,27,0,0,27,66,9,0,57,187,136,63,21,52,51,46,25,0,21,5,0,0,5,33763
10956,20114,1994,6348,6481,3359,1932,792,520,407,103,52,252,113,102,17,45,40,11,0,10,1,272,265,75,12,178,7,7,7,0,0,0,0,0,0,33764
10957,9449,870,3006,3241,1801,531,390,160,144,24,10,110,16,16,0,0,16,0,0,0,0,230,230,121,15,94,0,0,0,0,0,0,0,0,0,33765
10958,7799,560,1890,2089,1818,1442,116,37,31,0,0,31,6,6,6,0,0,0,0,0,0,79,66,0,0,66,13,13,0,0,13,0,0,0,0,33767
10959,19433,2230,6634,5962,3252,1355,909,397,315,95,9,211,82,68,15,53,0,14,14,0,0,512,450,94,61,295,62,42,3,0,39,20,6,3,11,33770
10960,21657,2882,8963,6420,2409,983,705,323,230,2,75,153,93,68,54,1,13,25,15,0,10,382,316,101,35,180,66,36,36,0,0,30,0,0,30,33771
10961,17059,1424,5763,5360,3037,1475,1094,567,516,144,26,346,51,49,24,0,25,2,0,0,2,527,390,71,32,287,137,132,32,43,57,5,0,0,5,33772
10962,13261,1982,4234,4187,2172,686,919,448,423,53,45,325,25,11,11,0,0,14,0,0,14,471,428,192,18,218,43,43,20,19,4,0,0,0,0,33773
10963,13917,1468,4444,4438,2446,1121,740,462,391,81,17,293,71,37,37,0,0,34,0,0,34,278,216,122,13,81,62,37,37,0,0,25,14,11,0,33774
10964,9301,412,2320,3220,2187,1162,722,414,331,56,15,260,83,83,9,21,53,0,0,0,0,308,308,117,30,161,0,0,0,0,0,0,0,0,0,33776
10965,12232,1016,3955,4064,2020,1177,697,280,229,72,22,135,51,51,7,16,28,0,0,0,0,417,353,125,23,205,64,32,11,0,21,32,0,0,32,33777
10966,11125,1492,4304,3104,1521,704,607,351,304,86,33,185,47,15,0,15,0,32,21,11,0,256,201,67,4,130,55,40,25,0,15,15,0,0,15,33778
10967,18533,3519,6962,5560,1767,725,1113,514,412,75,32,305,102,72,72,0,0,30,12,16,2,599,492,156,31,305,107,107,72,0,35,0,0,0,0,33781
10968,16513,2016,5867,5096,2196,1338,1024,619,557,170,15,372,62,22,8,0,14,40,0,0,40,405,403,13,10,380,2,2,2,0,0,0,0,0,0,33782
10969,4893,246,990,1462,1402,793,107,40,0,0,0,0,40,21,21,0,0,19,19,0,0,67,52,0,35,17,15,15,15,0,0,0,0,0,0,33785
10970,1314,68,233,372,395,246,37,27,23,0,0,23,4,4,0,4,0,0,0,0,0,10,10,0,0,10,0,0,0,0,0,0,0,0,0,33786
10971,21026,4970,7828,5439,1847,942,3090,1687,1529,88,198,1243,158,63,39,0,24,95,20,57,18,1403,1153,157,57,939,250,138,65,46,27,112,13,26,73,33801
10972,19157,1888,5541,5127,4241,2360,1291,577,471,85,71,315,106,106,44,42,20,0,0,0,0,714,602,116,26,460,112,112,70,0,42,0,0,0,0,33803
10973,15279,3068,5591,4572,1428,620,1222,591,495,30,142,323,96,46,24,22,0,50,0,0,50,631,527,82,66,379,104,79,47,11,21,25,10,6,9,33805
10974,20404,2237,7720,6539,2692,1216,1523,572,433,110,125,198,139,127,81,23,23,12,0,12,0,951,811,281,64,466,140,84,79,5,0,56,31,0,25,33809
10975,33049,4654,12510,10910,3462,1513,2267,1497,1414,246,225,943,83,69,59,10,0,14,2,12,0,770,576,110,50,416,194,135,46,89,0,59,17,40,2,33810
10976,13699,1452,4736,4399,2273,839,1002,545,409,102,16,291,136,112,72,12,28,24,0,6,18,457,351,81,10,260,106,96,22,0,74,10,10,0,0,33811
10977,8702,529,2722,2287,2300,864,820,424,372,0,20,352,52,52,16,0,36,0,0,0,0,396,345,52,0,293,51,0,0,0,0,51,0,0,51,33812
10978,21443,1216,5349,6231,5699,2948,1601,769,682,162,44,476,87,78,78,0,0,9,0,9,0,832,801,197,45,559,31,24,12,0,12,7,0,0,7,33813
10979,9417,2548,4359,1829,524,157,989,493,240,51,5,184,253,112,11,25,76,141,67,36,38,496,415,6,19,390,81,36,16,0,20,45,0,10,35,33815
10980,19099,4118,7371,4985,1681,944,1427,667,494,97,105,292,173,98,79,6,13,75,0,20,55,760,616,70,43,503,144,66,28,38,0,78,5,34,39,33823
10981,18433,3900,6917,4997,1664,955,1150,520,425,58,11,356,95,7,0,7,0,88,24,21,43,630,508,82,61,365,122,0,0,0,0,122,37,57,28,33825
10982,1878,202,551,689,233,203,256,154,131,25,0,106,23,4,4,0,0,19,0,0,19,102,102,15,0,87,0,0,0,0,0,0,0,0,0,33827
10983,16842,3606,6312,4641,1754,529,1662,940,801,163,27,611,139,95,29,18,48,44,10,0,34,722,677,147,16,514,45,23,11,4,8,22,0,1,21,33830
10984,4913,1855,1883,857,224,94,498,358,243,84,27,132,115,6,6,0,0,109,99,10,0,140,92,3,10,79,48,22,5,0,17,26,0,9,17,33834
10985,13647,2335,4816,4201,1572,723,1075,665,481,173,29,279,184,121,62,0,59,63,37,0,26,410,293,72,22,199,117,7,0,7,0,110,33,31,46,33837
10986,2631,707,919,784,171,50,164,70,50,30,0,20,20,0,0,0,0,20,20,0,0,94,64,0,0,64,30,30,30,0,0,0,0,0,0,33838
10987,1884,457,645,623,112,47,193,121,105,9,3,93,16,16,6,0,10,0,0,0,0,72,72,19,22,31,0,0,0,0,0,0,0,0,0,33839
10988,6100,1654,2522,1354,411,159,439,231,203,15,15,173,28,17,17,0,0,11,0,0,11,208,208,16,0,192,0,0,0,0,0,0,0,0,0,33841
10989,8845,2377,3601,2021,561,285,717,414,236,0,71,165,178,82,0,0,82,96,35,15,46,303,244,0,8,236,59,48,0,0,48,11,0,0,11,33843
10990,22697,6344,8481,5193,1782,897,1531,598,465,7,50,408,133,50,41,0,9,83,17,0,66,933,617,139,43,435,316,208,127,31,50,108,24,5,79,33844
10991,95,31,37,12,5,10,17,10,10,10,0,0,0,0,0,0,0,0,0,0,0,7,7,0,0,7,0,0,0,0,0,0,0,0,0,33847
10992,912,193,431,209,79,0,125,91,87,0,0,87,4,2,0,0,2,2,0,0,2,34,34,32,0,2,0,0,0,0,0,0,0,0,0,33848
10993,481,19,235,227,0,0,70,0,0,0,0,0,0,0,0,0,0,0,0,0,0,70,70,70,0,0,0,0,0,0,0,0,0,0,0,33849
10994,5146,1074,1928,1451,454,239,226,42,19,13,0,6,23,23,0,12,11,0,0,0,0,184,184,54,35,95,0,0,0,0,0,0,0,0,0,33850
10995,601,48,299,184,27,43,36,7,0,0,0,0,7,7,7,0,0,0,0,0,0,29,29,16,0,13,0,0,0,0,0,0,0,0,0,33851
10996,15400,3444,5250,4353,1555,798,827,273,245,4,81,160,28,28,28,0,0,0,0,0,0,554,492,105,14,373,62,62,5,0,57,0,0,0,0,33852
10997,6963,1952,2675,1344,612,380,769,479,410,122,55,233,69,20,11,9,0,49,16,0,33,290,138,41,21,76,152,79,10,13,56,73,6,0,67,33853
10998,108,0,84,0,24,0,0,0,0,0,0,0,0,0,0,0,0,0,0,0,0,0,0,0,0,0,0,0,0,0,0,0,0,0,0,33854
10999,16,8,0,8,0,0,0,0,0,0,0,0,0,0,0,0,0,0,0,0,0,0,0,0,0,0,0,0,0,0,0,0,0,0,0,33855
11000,465,29,171,248,0,17,0,0,0,0,0,0,0,0,0,0,0,0,0,0,0,0,0,0,0,0,0,0,0,0,0,0,0,0,0,33856
11001,1254,286,753,123,82,10,13,13,9,0,0,9,4,4,0,4,0,0,0,0,0,0,0,0,0,0,0,0,0,0,0,0,0,0,0,33857
11002,7235,1304,3131,1798,642,360,554,260,205,34,8,163,55,35,23,0,12,20,0,20,0,294,286,4,59,223,8,8,0,0,8,0,0,0,0,33859
11003,14704,3077,6075,3347,1792,413,1529,788,599,62,59,478,189,111,93,12,6,78,0,36,42,741,523,69,6,448,218,116,62,24,30,102,15,12,75,33860
11004,467,173,163,125,6,0,85,39,39,0,0,39,0,0,0,0,0,0,0,0,0,46,0,0,0,0,46,46,0,46,0,0,0,0,0,33865
11005,328,28,191,46,63,0,18,0,0,0,0,0,0,0,0,0,0,0,0,0,0,18,18,18,0,0,0,0,0,0,0,0,0,0,0,33867
11006,9287,1957,4136,2143,739,312,762,388,337,36,12,289,51,18,3,7,8,33,5,0,28,374,342,27,101,214,32,26,26,0,0,6,0,6,0,33868
11007,15780,3633,5470,4533,1446,698,951,607,343,0,99,244,264,132,52,17,63,132,72,38,22,344,238,34,42,162,106,0,0,0,0,106,0,54,52,33870
11008,11481,1492,4224,3736,1298,731,426,344,344,89,50,205,0,0,0,0,0,0,0,0,0,82,69,23,19,27,13,0,0,0,0,13,0,0,13,33872
11009,8420,2803,2866,1730,782,239,891,430,334,100,17,217,96,40,23,17,0,56,48,0,8,461,316,99,40,177,145,72,13,16,43,73,0,28,45,33873
11010,8173,791,3114,2986,661,621,326,169,169,46,32,91,0,0,0,0,0,0,0,0,0,157,147,86,0,61,10,10,10,0,0,0,0,0,0,33875
11011,3868,697,1612,1147,273,139,196,93,57,0,14,43,36,23,0,0,23,13,0,13,0,103,89,22,6,61,14,0,0,0,0,14,0,0,14,33876
11012,195,68,94,33,0,0,0,0,0,0,0,0,0,0,0,0,0,0,0,0,0,0,0,0,0,0,0,0,0,0,0,0,0,0,0,33877
11013,23649,5881,8655,6409,2075,629,1886,770,502,99,18,385,268,133,20,40,73,135,11,66,58,1116,867,138,72,657,249,168,71,60,37,81,52,0,29,33880
11014,21532,4398,7514,6446,2055,1119,1221,646,558,139,75,344,88,88,43,7,38,0,0,0,0,575,424,31,25,368,151,5,5,0,0,146,0,107,39,33881
11015,21245,2020,6533,7168,3488,2036,957,507,412,55,48,309,95,33,33,0,0,62,0,0,62,450,373,58,31,284,77,65,65,0,0,12,0,0,12,33884
11016,3428,1304,1297,661,108,58,335,142,122,0,19,103,20,13,13,0,0,7,0,0,7,193,140,24,24,92,53,38,0,0,38,15,0,0,15,33890
11017,6384,1107,1818,2056,965,438,401,183,77,32,10,35,106,63,0,0,63,43,0,0,43,218,155,15,0,140,63,40,31,9,0,23,23,0,0,33896
11018,11265,1127,3121,4553,1848,616,641,317,258,10,93,155,59,59,0,9,50,0,0,0,0,324,251,10,0,241,73,73,73,0,0,0,0,0,0,33897
11019,11415,1714,5091,3124,970,516,706,374,136,1,20,115,238,51,51,0,0,187,124,63,0,332,263,73,11,179,69,34,0,25,9,35,10,16,9,33898
11020,13796,2728,3801,4011,2031,1225,956,506,408,32,103,273,98,22,0,17,5,76,73,2,1,450,362,9,12,341,88,4,4,0,0,84,0,0,84,33901
11021,16653,2086,6354,4912,2069,1232,460,291,206,86,0,120,85,85,85,0,0,0,0,0,0,169,137,32,18,87,32,11,11,0,0,21,21,0,0,33903
11022,23511,2105,8263,7332,3838,1973,907,555,474,263,0,211,81,48,19,14,15,33,18,15,0,352,297,64,36,197,55,55,15,0,40,0,0,0,0,33904
11023,21727,6077,7143,5132,2295,1080,1158,719,424,70,57,297,295,145,38,22,85,150,91,0,59,439,342,24,30,288,97,64,32,25,7,33,0,0,33,33905
11024,14487,2646,4399,4204,1969,1269,775,408,332,76,13,243,76,54,21,0,33,22,0,0,22,367,215,20,78,117,152,93,42,9,42,59,9,0,50,33907
11025,28395,1821,7515,8343,6496,4220,667,279,211,0,69,142,68,48,0,30,18,20,0,0,20,388,271,73,68,130,117,44,0,18,26,73,38,21,14,33908
11026,15146,1548,6625,4910,1594,469,1548,824,630,177,36,417,194,116,85,0,31,78,24,24,30,724,499,128,21,350,225,133,110,23,0,92,92,0,0,33909
11027,13190,882,2764,4371,2932,2241,513,158,158,37,19,102,0,0,0,0,0,0,0,0,0,355,328,83,27,218,27,27,27,0,0,0,0,0,0,33912
11028,11930,450,3406,3546,2808,1720,1736,667,602,42,207,353,65,5,0,0,5,60,60,0,0,1069,1046,328,66,652,23,0,0,0,0,23,0,0,23,33913
11029,26968,1799,10390,8853,3708,2218,2397,1353,1212,331,169,712,141,129,97,32,0,12,12,0,0,1044,1017,63,0,954,27,27,27,0,0,0,0,0,0,33914
11030,13987,4194,4756,3114,1292,631,1448,595,384,37,73,274,211,166,166,0,0,45,0,0,45,853,714,111,138,465,139,40,34,6,0,99,15,29,55,33916
11031,24492,3474,10177,6962,2271,1608,983,379,347,81,9,257,32,32,6,0,26,0,0,0,0,604,553,87,59,407,51,51,11,40,0,0,0,0,0,33917
11032,22810,1081,6099,7192,5170,3268,988,378,297,87,59,151,81,81,11,0,70,0,0,0,0,610,552,130,52,370,58,58,38,0,20,0,0,0,0,33919
11033,3832,680,1339,1223,306,284,242,113,92,10,57,25,21,21,21,0,0,0,0,0,0,129,129,19,44,66,0,0,0,0,0,0,0,0,0,33920
11034,1074,32,84,333,439,186,12,0,0,0,0,0,0,0,0,0,0,0,0,0,0,12,0,0,0,0,12,0,0,0,0,12,0,12,0,33921
11035,3534,308,1615,909,405,297,177,167,162,14,0,148,5,5,0,0,5,0,0,0,0,10,10,0,0,10,0,0,0,0,0,0,0,0,0,33922
11036,154,0,45,45,41,23,13,13,13,13,0,0,0,0,0,0,0,0,0,0,0,0,0,0,0,0,0,0,0,0,0,0,0,0,0,33924
11037,15817,1194,3728,4807,3612,2476,528,322,322,90,48,184,0,0,0,0,0,0,0,0,0,206,189,19,0,170,17,17,17,0,0,0,0,0,0,33928
11038,431,247,104,80,0,0,30,30,30,0,0,30,0,0,0,0,0,0,0,0,0,0,0,0,0,0,0,0,0,0,0,0,0,0,0,33930
11039,9318,589,2578,3015,1883,1253,130,80,69,0,0,69,11,11,11,0,0,0,0,0,0,50,50,15,12,23,0,0,0,0,0,0,0,0,0,33931
11040,11856,3820,3921,2884,765,466,909,379,233,0,50,183,146,108,31,72,5,38,11,0,27,530,401,84,75,242,129,42,0,38,4,87,0,47,40,33935
11041,16013,3839,5968,4267,1441,498,745,314,221,9,12,200,93,65,3,0,62,28,16,0,12,431,329,76,15,238,102,50,22,13,15,52,0,38,14,33936
11042,160,56,67,0,0,37,18,18,18,0,0,18,0,0,0,0,0,0,0,0,0,0,0,0,0,0,0,0,0,0,0,0,0,0,0,33944
11043,36,0,0,36,0,0,0,0,0,0,0,0,0,0,0,0,0,0,0,0,0,0,0,0,0,0,0,0,0,0,0,0,0,0,0,33945
11044,1465,102,342,534,256,231,98,26,26,0,0,26,0,0,0,0,0,0,0,0,0,72,72,23,0,49,0,0,0,0,0,0,0,0,0,33946
11045,6983,487,2686,2010,1391,409,285,285,285,0,0,285,0,0,0,0,0,0,0,0,0,0,0,0,0,0,0,0,0,0,0,0,0,0,0,33947
11046,11970,1262,3753,4335,1536,1084,648,303,303,63,16,224,0,0,0,0,0,0,0,0,0,345,274,74,56,144,71,60,45,0,15,11,0,0,11,33948
11047,17573,1110,5257,5666,3299,2241,401,275,264,106,0,158,11,11,11,0,0,0,0,0,0,126,68,0,9,59,58,21,0,0,21,37,16,21,0,33950
11048,22035,3653,7530,7417,2201,1234,1315,696,571,144,59,368,125,86,82,0,4,39,29,0,10,619,485,85,59,341,134,54,54,0,0,80,0,0,80,33952
11049,4320,467,1278,1463,753,359,150,104,45,30,0,15,59,27,0,27,0,32,0,0,32,46,46,12,0,34,0,0,0,0,0,0,0,0,0,33953
11050,7303,946,2599,2211,1019,528,467,234,180,111,29,40,54,36,36,0,0,18,0,0,18,233,207,50,17,140,26,0,0,0,0,26,0,0,26,33954
11051,8104,804,2682,2518,1290,810,351,191,126,0,13,113,65,12,0,0,12,53,6,16,31,160,154,15,0,139,6,6,6,0,0,0,0,0,0,33955
11052,3175,373,991,1187,347,277,30,14,14,14,0,0,0,0,0,0,0,0,0,0,0,16,16,0,0,16,0,0,0,0,0,0,0,0,0,33956
11053,6172,64,793,1476,1956,1883,86,51,51,13,21,17,0,0,0,0,0,0,0,0,0,35,35,11,0,24,0,0,0,0,0,0,0,0,0,33957
11054,885,344,278,145,94,24,16,16,16,0,0,16,0,0,0,0,0,0,0,0,0,0,0,0,0,0,0,0,0,0,0,0,0,0,0,33960
11055,11,0,0,11,0,0,739,311,311,110,16,185,0,0,0,0,0,0,0,0,0,428,428,88,29,311,0,0,0,0,0,0,0,0,0,33965
11056,6431,368,1487,2494,1516,566,304,182,147,23,0,124,35,35,35,0,0,0,0,0,0,122,77,0,0,77,45,45,4,40,1,0,0,0,0,33966
11057,15860,1975,6015,4934,1978,958,1354,832,631,96,23,512,201,153,84,0,69,48,28,0,20,522,514,191,25,298,8,8,0,8,0,0,0,0,0,33967
11058,13837,2306,5223,4267,1418,623,1465,823,709,111,133,465,114,75,64,11,0,39,39,0,0,642,520,41,81,398,122,98,32,0,66,24,0,24,0,33971
11059,8417,1468,3164,2301,964,520,501,308,253,35,14,204,55,39,16,23,0,16,0,16,0,193,193,13,9,171,0,0,0,0,0,0,0,0,0,33972
11060,6312,2068,1926,1670,484,164,728,296,296,0,79,217,0,0,0,0,0,0,0,0,0,432,365,33,7,325,67,67,10,0,57,0,0,0,0,33973
11061,8402,1596,3136,2565,755,350,969,600,492,134,38,320,108,98,85,13,0,10,10,0,0,369,287,61,10,216,82,77,57,6,14,5,0,5,0,33974
11062,8692,1889,3137,2535,875,256,952,411,374,68,72,234,37,37,17,0,20,0,0,0,0,541,524,84,107,333,17,17,0,4,13,0,0,0,0,33976
11063,8862,1164,2700,3000,1171,827,433,209,209,0,98,111,0,0,0,0,0,0,0,0,0,224,191,42,5,144,33,33,10,0,23,0,0,0,0,33980
11064,7842,637,2960,2804,949,492,191,72,60,33,10,17,12,12,12,0,0,0,0,0,0,119,106,7,11,88,13,13,13,0,0,0,0,0,0,33981
11065,7956,1433,2837,2692,642,352,345,180,167,28,91,48,13,8,0,0,8,5,0,0,5,165,122,69,0,53,43,43,0,26,17,0,0,0,0,33982
11066,11149,822,4321,3839,1482,685,655,333,304,72,113,119,29,29,29,0,0,0,0,0,0,322,282,28,27,227,40,18,18,0,0,22,5,0,17,33983
11067,21297,2635,8224,6342,2822,1274,1155,653,551,54,108,389,102,37,22,15,0,65,0,14,51,502,457,18,112,327,45,33,20,13,0,12,12,0,0,33990
11068,11576,1086,4061,3710,1855,864,748,299,287,76,24,187,12,12,0,12,0,0,0,0,0,449,392,128,93,171,57,57,0,0,57,0,0,0,0,33991
11069,14228,1498,4800,5003,1822,1105,1026,473,442,12,35,395,31,31,20,11,0,0,0,0,0,553,523,56,29,438,30,0,0,0,0,30,0,0,30,33993
11070,0,0,0,0,0,0,0,0,0,0,0,0,0,0,0,0,0,0,0,0,0,0,0,0,0,0,0,0,0,0,0,0,0,0,0,34101
11071,8946,676,1420,2598,2408,1844,278,214,210,31,10,169,4,4,0,4,0,0,0,0,0,64,54,29,1,24,10,10,0,0,10,0,0,0,0,34102
11072,10512,756,1942,2842,2808,2164,315,103,103,12,10,81,0,0,0,0,0,0,0,0,0,212,212,19,0,193,0,0,0,0,0,0,0,0,0,34103
11073,18324,2526,5711,5857,2600,1630,945,425,346,97,0,249,79,79,40,39,0,0,0,0,0,520,461,76,85,300,59,59,0,59,0,0,0,0,0,34104
11074,12100,680,2273,3700,3556,1891,538,217,179,56,0,123,38,0,0,0,0,38,38,0,0,321,296,113,0,183,25,25,0,25,0,0,0,0,0,34105
11075,14521,1082,3422,3254,3949,2814,280,155,148,34,61,53,7,0,0,0,0,7,0,0,7,125,125,13,0,112,0,0,0,0,0,0,0,0,0,34108
11076,18698,913,4805,5022,4846,3112,742,353,301,45,16,240,52,51,18,0,33,1,0,0,1,389,389,171,6,212,0,0,0,0,0,0,0,0,0,34109
11077,17960,1084,4772,5286,3847,2971,483,224,204,57,22,125,20,20,0,0,20,0,0,0,0,259,221,92,36,93,38,38,0,0,38,0,0,0,0,34110
11078,20997,2925,6559,6085,3579,1849,868,435,276,35,33,208,159,88,22,30,36,71,0,0,71,433,393,90,24,279,40,40,20,0,20,0,0,0,0,34112
11079,13428,2789,4191,3306,1803,1339,849,326,316,13,81,222,10,10,10,0,0,0,0,0,0,523,317,10,12,295,206,91,26,11,54,115,70,0,45,34113
11080,11749,1725,3965,2832,1689,1538,554,262,262,174,7,81,0,0,0,0,0,0,0,0,0,292,270,88,22,160,22,22,22,0,0,0,0,0,0,34114
11081,21046,6209,7298,4360,2115,1064,1746,972,629,91,166,372,343,178,158,20,0,165,124,0,41,774,585,73,22,490,189,65,53,12,0,124,28,69,27,34116
11082,10271,1614,4404,2449,1110,694,1225,661,555,221,21,313,106,106,40,66,0,0,0,0,0,564,527,175,0,352,37,15,0,0,15,22,0,0,22,34117
11083,17662,842,3652,5101,4841,3226,1118,630,600,145,0,455,30,0,0,0,0,30,0,0,30,488,431,247,0,184,57,57,0,18,39,0,0,0,0,34119
11084,17829,2425,5667,5546,2751,1440,897,410,371,124,30,217,39,0,0,0,0,39,39,0,0,487,446,280,0,166,41,17,0,0,17,24,24,0,0,34120
11085,12293,459,2894,3733,2783,2424,346,119,119,14,0,105,0,0,0,0,0,0,0,0,0,227,227,129,68,30,0,0,0,0,0,0,0,0,0,34134
11086,29700,5381,7402,8264,5461,3192,1310,485,301,47,0,254,184,149,58,65,26,35,0,35,0,825,542,117,47,378,283,101,101,0,0,182,0,0,182,34135
11087,223,52,171,0,0,0,0,0,0,0,0,0,0,0,0,0,0,0,0,0,0,0,0,0,0,0,0,0,0,0,0,0,0,0,0,34137
11088,275,0,127,67,31,50,55,55,55,0,0,55,0,0,0,0,0,0,0,0,0,0,0,0,0,0,0,0,0,0,0,0,0,0,0,34138
11089,345,10,168,93,70,4,21,10,10,3,0,7,0,0,0,0,0,0,0,0,0,11,10,4,0,6,1,1,1,0,0,0,0,0,0,34139
11090,235,48,134,53,0,0,62,62,0,0,0,0,62,62,62,0,0,0,0,0,0,0,0,0,0,0,0,0,0,0,0,0,0,0,0,34140
11091,78,31,47,0,0,0,36,36,24,0,0,24,12,0,0,0,0,12,0,0,12,0,0,0,0,0,0,0,0,0,0,0,0,0,0,34141
11092,13520,8046,3043,1809,391,231,2357,1313,905,97,186,622,408,152,121,7,24,256,106,55,95,1044,789,108,67,614,255,96,15,0,81,159,0,9,150,34142
11093,14281,679,3347,3947,4088,2220,425,247,221,65,0,156,26,7,0,7,0,19,19,0,0,178,144,72,0,72,34,13,0,0,13,21,0,0,21,34145
11094,3356,73,537,989,876,881,78,14,14,0,0,14,0,0,0,0,0,0,0,0,0,64,23,0,0,23,41,41,41,0,0,0,0,0,0,34201
11095,14809,375,2425,4816,4244,2949,1020,533,507,161,73,273,26,26,26,0,0,0,0,0,0,487,487,73,30,384,0,0,0,0,0,0,0,0,0,34202
11096,25119,3838,7453,7557,4100,2171,1681,771,607,83,30,494,164,106,40,34,32,58,6,0,52,910,656,202,62,392,254,134,29,31,74,120,68,43,9,34203
11097,21613,3945,7934,5790,2580,1364,1057,556,419,55,41,323,137,78,63,15,0,59,26,0,33,501,339,54,51,234,162,66,29,37,0,96,38,8,50,34205
11098,21935,4133,8771,6631,1454,946,1072,513,336,46,0,290,177,154,116,38,0,23,0,0,23,559,444,132,14,298,115,89,89,0,0,26,13,0,13,34207
11099,21367,5088,7788,5461,1836,1194,2179,1054,921,172,53,696,133,79,16,8,55,54,4,25,25,1125,859,135,118,606,266,202,97,14,91,64,0,41,23,34208
11100,26110,2391,7643,8260,4627,3189,1255,645,596,138,55,403,49,16,16,0,0,33,33,0,0,610,521,64,104,353,89,22,19,0,3,67,67,0,0,34209
11101,11181,742,3271,3837,1773,1558,840,553,463,99,100,264,90,90,47,0,43,0,0,0,0,287,242,31,17,194,45,0,0,0,0,45,45,0,0,34210
11102,2305,223,396,747,533,406,119,38,27,6,13,8,11,11,11,0,0,0,0,0,0,81,72,22,13,37,9,9,0,0,9,0,0,0,0,34211
11103,10384,594,1730,2660,3184,2216,869,531,446,100,57,289,85,16,16,0,0,69,0,0,69,338,297,100,14,183,41,29,0,29,0,12,0,0,12,34212
11104,593,28,137,115,155,158,17,16,2,0,0,2,14,14,14,0,0,0,0,0,0,1,1,0,1,0,0,0,0,0,0,0,0,0,0,34215
11105,1310,22,400,418,246,224,67,20,20,0,0,20,0,0,0,0,0,0,0,0,0,47,47,0,0,47,0,0,0,0,0,0,0,0,0,34216
11106,4467,136,1112,1554,1004,661,97,24,24,0,0,24,0,0,0,0,0,0,0,0,0,73,73,9,4,60,0,0,0,0,0,0,0,0,0,34217
11107,12943,977,3756,4054,2676,1480,698,400,314,67,6,241,86,30,30,0,0,56,55,0,1,298,213,152,0,61,85,85,30,0,55,0,0,0,0,34219
11108,29534,4998,10870,8327,3569,1770,1901,1110,850,171,67,612,260,121,43,32,46,139,34,18,87,791,659,175,57,427,132,86,78,8,0,46,0,0,46,34221
11109,9024,818,3853,2663,1091,599,201,129,129,0,10,119,0,0,0,0,0,0,0,0,0,72,72,23,0,49,0,0,0,0,0,0,0,0,0,34222
11110,15158,1472,4643,4648,2566,1829,488,238,173,54,23,96,65,19,0,0,19,46,0,0,46,250,214,36,18,160,36,32,0,32,0,4,0,4,0,34223
11111,12902,1500,5330,3954,1415,703,380,190,150,39,19,92,40,28,22,6,0,12,0,0,12,190,177,56,14,107,13,13,0,0,13,0,0,0,0,34224
11112,6395,219,953,1572,2006,1645,80,12,12,0,0,12,0,0,0,0,0,0,0,0,0,68,68,0,0,68,0,0,0,0,0,0,0,0,0,34228
11113,5706,140,1342,1470,1562,1192,330,228,172,61,0,111,56,56,17,20,19,0,0,0,0,102,102,37,0,65,0,0,0,0,0,0,0,0,0,34229
11114,22493,1578,7014,7268,4027,2606,1038,553,429,136,36,257,124,97,21,76,0,27,13,14,0,485,364,117,82,165,121,25,25,0,0,96,58,0,38,34231
11115,24479,2156,8019,8452,3794,2058,1306,687,497,113,12,372,190,122,37,47,38,68,0,57,11,619,523,155,21,347,96,90,71,19,0,6,0,0,6,34232
11116,13702,1066,4151,4160,2649,1676,702,396,296,103,29,164,100,65,25,23,17,35,35,0,0,306,306,172,15,119,0,0,0,0,0,0,0,0,0,34233
11117,14244,2788,5160,3685,1669,942,943,461,377,105,142,130,84,55,21,34,0,29,0,13,16,482,417,94,77,246,65,65,0,43,22,0,0,0,0,34234
11118,10611,845,2938,3019,2202,1607,371,206,206,131,0,75,0,0,0,0,0,0,0,0,0,165,165,56,11,98,0,0,0,0,0,0,0,0,0,34235
11119,9374,537,1906,2263,2676,1992,310,146,119,46,14,59,27,27,27,0,0,0,0,0,0,164,155,26,0,129,9,9,0,9,0,0,0,0,0,34236
11120,12828,1665,4835,3885,1441,1002,813,559,460,38,51,371,99,36,13,0,23,63,0,0,63,254,163,32,7,124,91,55,55,0,0,36,0,0,36,34237
11121,14485,457,3004,3845,3859,3320,349,126,126,0,23,103,0,0,0,0,0,0,0,0,0,223,130,67,0,63,93,93,61,32,0,0,0,0,0,34238
11122,11919,1119,3274,3475,2441,1610,519,334,232,76,49,107,102,102,88,14,0,0,0,0,0,185,147,55,25,67,38,38,38,0,0,0,0,0,0,34239
11123,8744,491,2608,2187,1840,1618,743,380,317,95,55,167,63,63,0,0,63,0,0,0,0,363,309,62,11,236,54,54,43,0,11,0,0,0,0,34240
11124,10294,605,2668,3437,2086,1498,430,257,198,72,8,118,59,34,17,0,17,25,9,8,8,173,173,24,22,127,0,0,0,0,0,0,0,0,0,34241
11125,7445,223,1190,1951,2356,1725,173,128,117,14,0,103,11,11,0,0,11,0,0,0,0,45,45,0,10,35,0,0,0,0,0,0,0,0,0,34242
11126,20210,1032,5493,6063,4699,2923,963,453,424,80,4,340,29,29,11,0,18,0,0,0,0,510,507,69,0,438,3,3,0,3,0,0,0,0,0,34243
11127,3965,715,1789,891,498,72,384,268,234,64,0,170,34,34,34,0,0,0,0,0,0,116,111,58,8,45,5,5,5,0,0,0,0,0,0,34251
11128,20010,6116,8082,3974,1229,609,2156,1162,566,137,14,415,596,212,141,25,46,384,137,69,178,994,773,158,14,601,221,129,0,53,76,92,1,13,78,34266
11129,125,115,10,0,0,0,0,0,0,0,0,0,0,0,0,0,0,0,0,0,0,0,0,0,0,0,0,0,0,0,0,0,0,0,0,34268
11130,3086,448,1114,906,404,214,164,76,76,20,2,54,0,0,0,0,0,0,0,0,0,88,85,0,0,85,3,0,0,0,0,3,0,0,3,34269
11131,13710,966,4476,4172,2471,1625,454,252,178,95,0,83,74,65,3,42,20,9,9,0,0,202,187,55,26,106,15,15,15,0,0,0,0,0,0,34275
11132,16590,863,5070,5346,2672,2639,134,44,35,0,0,35,9,6,0,6,0,3,3,0,0,90,83,30,0,53,7,7,0,1,6,0,0,0,0,34285
11133,13206,1247,5260,4782,1171,746,1596,660,612,90,8,514,48,48,0,14,34,0,0,0,0,936,903,48,74,781,33,33,0,33,0,0,0,0,0,34286
11134,19435,2537,8087,5930,1859,1022,910,425,359,33,0,326,66,51,8,0,43,15,10,0,5,485,356,81,58,217,129,129,25,47,57,0,0,0,0,34287
11135,6939,381,2090,2815,1119,534,775,350,333,29,150,154,17,17,17,0,0,0,0,0,0,425,425,149,94,182,0,0,0,0,0,0,0,0,0,34288
11136,1243,15,402,561,137,128,14,14,14,14,0,0,0,0,0,0,0,0,0,0,0,0,0,0,0,0,0,0,0,0,0,0,0,0,0,34289
11137,2921,176,1205,1106,336,98,216,158,87,52,0,35,71,54,0,54,0,17,17,0,0,58,58,0,0,58,0,0,0,0,0,0,0,0,0,34291
11138,12429,553,3480,3283,2855,2258,211,155,155,71,0,84,0,0,0,0,0,0,0,0,0,56,56,25,0,31,0,0,0,0,0,0,0,0,0,34292
11139,27849,2260,8910,8680,5166,2833,1181,555,487,112,21,354,68,36,0,7,29,32,30,0,2,626,536,202,7,327,90,90,77,0,13,0,0,0,0,34293
11140,11080,2708,4002,2950,1069,351,732,399,332,91,0,241,67,51,51,0,0,16,16,0,0,333,314,158,36,120,19,19,7,0,12,0,0,0,0,34420
11141,7199,1365,2838,1949,629,418,426,120,120,15,11,94,0,0,0,0,0,0,0,0,0,306,287,62,33,192,19,7,7,0,0,12,0,12,0,34428
11142,6107,689,1979,1844,971,624,267,85,66,30,0,36,19,19,19,0,0,0,0,0,0,182,153,29,29,95,29,29,0,29,0,0,0,0,0,34429
11143,5915,981,2414,1794,548,178,510,351,324,41,227,56,27,27,0,0,27,0,0,0,0,159,120,21,17,82,39,29,0,0,29,10,10,0,0,34431
11144,10174,1433,3882,3263,1074,522,392,193,122,18,0,104,71,71,65,0,6,0,0,0,0,199,146,30,0,116,53,53,22,24,7,0,0,0,0,34432
11145,4619,595,2041,1492,330,161,184,125,82,0,11,71,43,43,0,43,0,0,0,0,0,59,16,0,0,16,43,43,0,0,43,0,0,0,0,34433
11146,6122,644,2229,2245,761,243,274,202,187,45,68,74,15,15,0,0,15,0,0,0,0,72,72,14,27,31,0,0,0,0,0,0,0,0,0,34434
11147,5742,946,2278,1700,605,213,329,128,116,38,49,29,12,0,0,0,0,12,0,0,12,201,164,37,16,111,37,13,0,0,13,24,0,0,24,34436
11148,11903,1124,4791,3638,1340,1010,850,461,382,87,11,284,79,60,6,18,36,19,0,0,19,389,371,74,36,261,18,18,18,0,0,0,0,0,0,34442
11149,0,0,0,0,0,0,0,0,0,0,0,0,0,0,0,0,0,0,0,0,0,0,0,0,0,0,0,0,0,0,0,0,0,0,0,34445
11150,14310,2053,4909,4884,1915,549,522,341,254,0,31,223,87,68,33,35,0,19,0,0,19,181,181,56,3,122,0,0,0,0,0,0,0,0,0,34446
11151,8388,1768,3596,2147,558,319,228,102,102,0,57,45,0,0,0,0,0,0,0,0,0,126,63,21,0,42,63,48,0,48,0,15,0,15,0,34448
11152,2195,464,913,565,171,82,165,48,46,11,0,35,2,2,0,0,2,0,0,0,0,117,106,17,15,74,11,0,0,0,0,11,0,0,11,34449
11153,8253,990,3242,2480,976,565,318,157,105,7,41,57,52,51,22,11,18,1,1,0,0,161,124,39,15,70,37,37,24,0,13,0,0,0,0,34450
11154,8600,1278,3480,2826,745,271,401,224,142,0,16,126,82,39,23,16,0,43,0,0,43,177,132,44,7,81,45,0,0,0,0,45,0,0,45,34452
11155,7721,793,2947,2867,491,623,621,327,274,37,14,223,53,53,0,53,0,0,0,0,0,294,281,45,56,180,13,13,0,13,0,0,0,0,0,34453
11156,7980,1425,2947,2262,816,530,415,225,193,0,36,157,32,26,18,8,0,6,0,0,6,190,190,71,14,105,0,0,0,0,0,0,0,0,0,34461
11157,12870,1620,4511,4237,1614,888,558,263,263,16,0,247,0,0,0,0,0,0,0,0,0,295,239,0,56,183,56,6,0,6,0,50,0,50,0,34465
11158,13265,1846,4848,4732,1400,439,723,312,270,102,12,156,42,31,31,0,0,11,0,11,0,411,390,8,11,371,21,16,0,0,16,5,5,0,0,34470
11159,17177,1654,4769,5764,3421,1569,1217,743,645,120,6,519,98,69,53,16,0,29,29,0,0,474,461,169,99,193,13,13,13,0,0,0,0,0,0,34471
11160,17470,3147,6382,5719,1348,874,1305,747,593,53,55,485,154,74,62,12,0,80,43,17,20,558,492,48,66,378,66,0,0,0,0,66,22,44,0,34472
11161,11973,1909,3981,3915,1398,770,1317,662,459,67,45,347,203,203,173,0,30,0,0,0,0,655,545,75,7,463,110,104,70,18,16,6,6,0,0,34473
11162,10292,1220,3390,3312,1317,1053,779,337,272,0,21,251,65,65,65,0,0,0,0,0,0,442,428,197,76,155,14,9,9,0,0,5,0,5,0,34474
11163,8484,1891,3189,2573,563,268,826,474,389,0,7,382,85,44,0,9,35,41,0,0,41,352,225,16,39,170,127,55,0,7,48,72,43,0,29,34475
11164,18297,2214,6579,5827,2699,978,683,348,250,22,7,221,98,22,0,22,0,76,0,76,0,335,335,95,35,205,0,0,0,0,0,0,0,0,0,34476
11165,9009,940,4037,3126,730,176,698,480,426,98,27,301,54,54,13,21,20,0,0,0,0,218,199,34,19,146,19,19,12,0,7,0,0,0,0,34479
11166,12106,975,3837,4152,2060,1082,970,418,360,117,30,213,58,13,13,0,0,45,45,0,0,552,478,135,18,325,74,43,43,0,0,31,0,18,13,34480
11167,15201,2039,4901,4985,1835,1441,179,1,1,0,0,1,0,0,0,0,0,0,0,0,0,178,136,42,0,94,42,19,0,0,19,23,0,9,14,34481
11168,16414,3516,5780,4689,1706,723,1270,579,322,47,44,231,257,55,18,37,0,202,0,177,25,691,632,39,51,542,59,59,59,0,0,0,0,0,0,34482
11169,2215,134,795,793,299,194,104,62,62,0,0,62,0,0,0,0,0,0,0,0,0,42,42,31,0,11,0,0,0,0,0,0,0,0,0,34484
11170,8252,1793,3608,2213,385,253,274,151,126,0,0,126,25,7,7,0,0,18,0,0,18,123,65,12,0,53,58,58,58,0,0,0,0,0,0,34488
11171,22324,2964,8584,6528,2487,1761,854,480,218,8,0,210,262,34,21,13,0,228,146,0,82,374,269,49,9,211,105,32,32,0,0,73,17,38,18,34491
11172,477,32,157,182,57,49,25,6,6,0,6,0,0,0,0,0,0,0,0,0,0,19,19,0,0,19,0,0,0,0,0,0,0,0,0,34498
11173,15262,2564,5808,4364,1625,901,823,349,241,0,48,193,108,66,60,0,6,42,0,31,11,474,362,74,0,288,112,112,0,84,28,0,0,0,0,34601
11174,5428,625,1887,1958,676,282,685,486,478,27,0,451,8,0,0,0,0,8,0,0,8,199,110,19,27,64,89,89,54,35,0,0,0,0,0,34602
11175,7327,1103,2833,2365,642,384,508,320,278,76,63,139,42,42,26,13,3,0,0,0,0,188,154,40,59,55,34,32,7,25,0,2,0,0,2,34604
11176,20381,2781,8122,6415,2092,971,724,369,258,32,53,173,111,81,0,76,5,30,0,0,30,355,291,20,60,211,64,58,58,0,0,6,0,0,6,34606
11177,6369,680,2269,2361,628,431,146,46,46,0,0,46,0,0,0,0,0,0,0,0,0,100,87,15,0,72,13,0,0,0,0,13,13,0,0,34607
11178,22640,2865,9783,7848,1509,635,1370,651,638,76,62,500,13,13,13,0,0,0,0,0,0,719,623,70,85,468,96,42,32,10,0,54,39,15,0,34608
11179,26418,3278,9277,8920,3537,1406,2016,936,846,47,172,627,90,72,42,20,10,18,0,0,18,1080,724,139,154,431,356,147,7,68,72,209,81,0,128,34609
11180,8353,1362,3431,2527,656,377,590,334,292,19,30,243,42,28,0,0,28,14,0,9,5,256,193,21,20,152,63,22,8,0,14,41,28,13,0,34610
11181,14919,1847,5784,4584,1738,966,692,524,453,5,63,385,71,42,0,0,42,29,0,0,29,168,102,7,41,54,66,19,19,0,0,47,17,0,30,34613
11182,4685,817,1629,1483,567,189,463,190,74,0,16,58,116,116,98,0,18,0,0,0,0,273,273,0,43,230,0,0,0,0,0,0,0,0,0,34614
11183,4661,307,1158,1472,1160,564,335,238,150,111,0,39,88,45,0,0,45,43,0,0,43,97,78,41,0,37,19,0,0,0,0,19,0,0,19,34637
11184,13904,935,3209,5020,3162,1578,1305,471,435,58,0,377,36,15,15,0,0,21,0,0,21,834,761,201,86,474,73,16,0,2,14,57,0,0,57,34638
11185,16509,1301,4167,5756,3777,1508,1403,760,657,128,53,476,103,103,90,8,5,0,0,0,0,643,619,222,88,309,24,15,15,0,0,9,0,0,9,34639
11186,17177,2369,7090,4874,1746,1098,685,408,298,0,32,266,110,51,0,27,24,59,0,32,27,277,212,47,21,144,65,29,0,0,29,36,0,0,36,34652
11187,22554,3349,8739,7702,2002,762,1123,706,592,97,91,404,114,57,30,25,2,57,18,0,39,417,347,71,74,202,70,58,21,12,25,12,0,12,0,34653
11188,15745,2171,5381,5334,1939,920,976,513,389,92,73,224,124,63,0,43,20,61,0,61,0,463,351,85,55,211,112,40,15,0,25,72,18,0,54,34654
11189,28149,2131,8669,9624,5461,2264,1677,867,773,169,89,515,94,86,18,0,68,8,0,8,0,810,766,190,103,473,44,24,0,0,24,20,0,0,20,34655
11190,203,81,46,50,0,26,36,13,13,0,13,0,0,0,0,0,0,0,0,0,0,23,0,0,0,0,23,0,0,0,0,23,0,0,23,34661
11191,26652,3848,10328,8812,2638,1026,1313,636,503,47,81,375,133,104,32,33,39,29,16,13,0,677,484,107,31,346,193,178,52,59,67,15,0,0,15,34667
11192,31702,4805,13022,10131,2709,1035,2141,1001,680,116,45,519,321,176,95,69,12,145,0,26,119,1140,964,205,99,660,176,111,88,23,0,65,13,41,11,34668
11193,9241,1440,3389,2973,1106,333,472,197,158,35,39,84,39,26,26,0,0,13,0,0,13,275,263,62,45,156,12,0,0,0,0,12,0,0,12,34669
11194,15008,1259,4289,4808,3154,1498,1212,634,520,141,44,335,114,52,52,0,0,62,9,53,0,578,548,179,141,228,30,30,0,22,8,0,0,0,0,34677
11195,10,0,10,0,0,0,0,0,0,0,0,0,0,0,0,0,0,0,0,0,0,0,0,0,0,0,0,0,0,0,0,0,0,0,0,34679
11196,1100,4,429,242,229,196,20,0,0,0,0,0,0,0,0,0,0,0,0,0,0,20,20,0,0,20,0,0,0,0,0,0,0,0,0,34681
11197,23342,1344,5779,8265,5106,2848,1865,1096,935,137,100,698,161,100,51,22,27,61,0,10,51,769,654,147,19,488,115,115,59,0,56,0,0,0,0,34683
11198,21541,1403,6065,7545,4400,2128,1152,493,334,44,75,215,159,110,26,28,56,49,22,9,18,659,499,204,17,278,160,53,34,0,19,107,88,11,8,34684
11199,12549,370,2850,3889,3492,1948,822,521,500,223,0,277,21,20,0,20,0,1,0,1,0,301,301,44,18,239,0,0,0,0,0,0,0,0,0,34685
11200,6186,265,1645,2132,1525,619,659,421,407,66,0,341,14,4,0,0,4,10,0,0,10,238,219,114,0,105,19,19,19,0,0,0,0,0,0,34688
11201,20296,2174,6632,6637,3270,1583,903,456,364,52,12,300,92,89,41,40,8,3,0,3,0,447,378,100,34,244,69,69,2,0,67,0,0,0,0,34689
11202,9761,1551,4279,2938,623,370,362,215,200,17,0,183,15,15,7,8,0,0,0,0,0,147,91,36,4,51,56,43,43,0,0,13,0,0,13,34690
11203,13967,2365,5122,4302,1599,579,641,326,277,35,42,200,49,49,0,0,49,0,0,0,0,315,229,14,23,192,86,61,0,8,53,25,0,0,25,34691
11204,13566,1090,3370,4161,3176,1769,722,517,435,53,25,357,82,79,24,9,46,3,0,3,0,205,194,76,20,98,11,0,0,0,0,11,0,0,11,34695
11205,29567,2554,8804,9983,5507,2719,1132,532,434,118,17,299,98,80,44,34,2,18,0,0,18,600,503,133,23,347,97,58,45,0,13,39,0,28,11,34698
11206,1955,468,838,504,90,55,128,40,40,10,0,30,0,0,0,0,0,0,0,0,0,88,85,5,30,50,3,3,3,0,0,0,0,0,0,34705
11207,37117,2634,11202,12687,7557,3037,2854,1509,1357,225,200,932,152,135,122,0,13,17,0,0,17,1345,1232,408,324,500,113,104,46,0,58,9,0,0,9,34711
11208,9915,1591,3128,3033,1655,508,620,297,249,42,30,177,48,0,0,0,0,48,0,0,48,323,274,47,70,157,49,15,15,0,0,34,34,0,0,34714
11209,10025,1796,2895,3319,1430,585,697,128,116,17,11,88,12,12,0,12,0,0,0,0,0,569,553,174,63,316,16,16,16,0,0,0,0,0,0,34715
11210,7996,1547,2982,2356,768,343,559,304,254,32,85,137,50,50,6,44,0,0,0,0,0,255,200,54,50,96,55,55,0,12,43,0,0,0,0,34731
11211,2564,210,741,768,665,180,344,179,170,23,0,147,9,9,9,0,0,0,0,0,0,165,138,109,12,17,27,0,0,0,0,27,0,27,0,34734
11212,9650,1996,3447,2807,1044,356,918,513,413,173,25,215,100,61,48,0,13,39,0,0,39,405,330,170,26,134,75,31,0,31,0,44,0,0,44,34736
11213,1970,111,506,787,388,178,45,11,11,9,0,2,0,0,0,0,0,0,0,0,0,34,21,6,0,15,13,13,13,0,0,0,0,0,0,34737
11214,580,125,180,217,45,13,55,44,8,0,0,8,36,36,36,0,0,0,0,0,0,11,11,0,0,11,0,0,0,0,0,0,0,0,0,34739
11215,27050,5475,8979,8981,2652,963,2162,857,606,155,51,400,251,157,126,16,15,94,34,0,60,1305,853,264,118,471,452,230,136,29,65,222,113,33,76,34741
11216,23346,4772,8419,7265,2043,847,3102,1821,1462,210,98,1154,359,241,91,37,113,118,51,67,0,1281,1070,230,40,800,211,186,110,31,45,25,0,0,25,34743
11217,29267,4434,10413,9294,3679,1447,2873,1602,1312,109,52,1151,290,148,78,50,20,142,79,0,63,1271,1114,348,98,668,157,148,72,0,76,9,0,0,9,34744
11218,23239,3894,7595,7541,3165,1044,2235,1248,1152,222,28,902,96,26,10,5,11,70,0,57,13,987,762,92,93,577,225,115,90,0,25,110,0,90,20,34746
11219,8753,397,1765,2450,2743,1398,774,284,265,33,0,232,19,19,0,0,19,0,0,0,0,490,480,144,0,336,10,10,10,0,0,0,0,0,0,34747
11220,31002,3580,10357,10222,3981,2862,1171,436,390,46,149,195,46,45,43,0,2,1,0,0,1,735,501,158,75,268,234,69,16,53,0,165,8,157,0,34748
11221,3002,891,1090,810,168,43,392,158,119,5,68,46,39,39,5,0,34,0,0,0,0,234,234,103,20,111,0,0,0,0,0,0,0,0,0,34753
11222,2228,261,843,557,383,184,276,143,133,36,15,82,10,10,6,4,0,0,0,0,0,133,133,74,0,59,0,0,0,0,0,0,0,0,0,34756
11223,20329,3795,7376,6071,2404,683,1821,994,768,67,76,625,226,143,96,25,22,83,20,26,37,827,746,198,29,519,81,81,0,0,81,0,0,0,0,34758
11224,20092,2871,5646,7048,3169,1358,1723,819,666,77,34,555,153,148,99,49,0,5,0,0,5,904,698,28,75,595,206,102,54,0,48,104,16,85,3,34759
11225,578,96,106,193,110,73,37,31,31,0,5,26,0,0,0,0,0,0,0,0,0,6,6,0,6,0,0,0,0,0,0,0,0,0,0,34760
11226,24984,3748,6714,7902,4213,2407,2172,1035,973,204,123,646,62,62,28,16,18,0,0,0,0,1137,1032,194,95,743,105,94,47,29,18,11,11,0,0,34761
11227,344,51,221,14,0,58,15,15,15,0,0,15,0,0,0,0,0,0,0,0,0,0,0,0,0,0,0,0,0,0,0,0,0,0,0,34762
11228,14625,2184,5809,4819,1283,530,1041,642,455,112,26,317,187,142,81,0,61,45,0,0,45,399,305,38,32,235,94,56,9,20,27,38,0,0,38,34769
11229,8944,995,3297,2677,1157,818,815,352,262,59,13,190,90,76,56,0,20,14,0,14,0,463,445,82,47,316,18,18,18,0,0,0,0,0,0,34771
11230,15120,1332,5419,4943,2319,1107,1646,847,686,76,8,602,161,77,21,38,18,84,29,55,0,799,508,102,5,401,291,290,290,0,0,1,0,0,1,34772
11231,2287,494,837,487,351,118,222,132,132,24,25,83,0,0,0,0,0,0,0,0,0,90,34,0,0,34,56,15,15,0,0,41,0,0,41,34773
11232,14709,3093,5452,4114,1450,600,613,231,163,56,41,66,68,18,9,0,9,50,0,0,50,382,303,13,65,225,79,79,34,20,25,0,0,0,0,34785
11233,19719,565,2373,5334,7998,3449,1308,625,616,98,113,405,9,0,0,0,0,9,9,0,0,683,640,211,17,412,43,43,31,12,0,0,0,0,0,34786
11234,31280,3188,8467,9600,7133,2892,2111,849,801,188,195,418,48,22,22,0,0,26,9,17,0,1262,1064,129,123,812,198,169,138,9,22,29,29,0,0,34787
11235,14223,1491,5832,4821,1335,744,603,354,324,42,69,213,30,12,0,12,0,18,0,0,18,249,191,43,106,42,58,9,9,0,0,49,0,11,38,34788
11236,1010,55,147,468,171,169,12,0,0,0,0,0,0,0,0,0,0,0,0,0,0,12,12,0,0,12,0,0,0,0,0,0,0,0,0,34797
11237,3721,699,1156,1422,281,163,200,102,47,20,0,27,55,14,0,0,14,41,0,0,41,98,90,7,0,83,8,8,0,0,8,0,0,0,0,34945
11238,4351,1165,1313,1205,398,270,278,178,168,23,16,129,10,0,0,0,0,10,0,0,10,100,100,4,21,75,0,0,0,0,0,0,0,0,0,34946
11239,6617,2183,2175,1503,464,292,793,399,338,23,10,305,61,42,6,36,0,19,0,0,19,394,366,35,36,295,28,19,11,8,0,9,0,0,9,34947
11240,5930,279,1014,2197,1402,1038,46,44,41,0,0,41,3,3,3,0,0,0,0,0,0,2,0,0,0,0,2,2,2,0,0,0,0,0,0,34949
11241,9755,3028,3497,2112,813,305,881,448,359,101,15,243,89,55,55,0,0,34,0,29,5,433,363,11,82,270,70,40,0,0,40,30,0,30,0,34950
11242,11454,1452,4359,4022,811,810,526,278,276,76,20,180,2,0,0,0,0,2,0,0,2,248,209,55,72,82,39,21,0,0,21,18,0,0,18,34951
11243,29417,4072,10811,9029,3580,1925,1513,981,877,83,150,644,104,74,17,0,57,30,0,30,0,532,454,144,57,253,78,64,57,0,7,14,3,0,11,34952
11244,38659,4854,13702,11999,5117,2987,3222,1246,1164,172,250,742,82,35,35,0,0,47,0,36,11,1976,1775,361,300,1114,201,130,72,23,35,71,55,0,16,34953
11245,6514,2860,1826,1305,371,152,596,399,352,0,113,239,47,34,34,0,0,13,0,0,13,197,183,0,48,135,14,14,0,0,14,0,0,0,0,34956
11246,18146,1291,5303,6312,3187,2053,830,507,449,115,134,200,58,57,0,57,0,1,0,0,1,323,276,66,11,199,47,47,24,0,23,0,0,0,0,34957
11247,13115,4996,4294,2782,615,428,1312,683,525,44,24,457,158,38,0,0,38,120,0,0,120,629,579,89,18,472,50,19,0,15,4,31,0,0,31,34972
11248,16722,4316,5735,4561,1502,608,1095,559,383,62,24,297,176,114,66,13,35,62,16,0,46,536,409,91,0,318,127,78,0,43,35,49,7,0,42,34974
11249,3245,411,1074,1035,496,229,399,228,172,4,0,168,56,51,51,0,0,5,0,0,5,171,171,22,0,149,0,0,0,0,0,0,0,0,0,34981
11250,18374,3862,6938,5097,1686,791,1190,693,443,57,0,386,250,134,18,34,82,116,0,15,101,497,415,51,0,364,82,33,33,0,0,49,0,0,49,34982
11251,26074,4030,9531,9142,2346,1025,2449,1121,891,103,211,577,230,174,127,37,10,56,0,0,56,1328,1218,125,160,933,110,98,0,35,63,12,12,0,0,34983
11252,9585,1367,3383,3244,1042,549,895,559,456,70,35,351,103,44,44,0,0,59,0,48,11,336,270,54,52,164,66,43,37,6,0,23,0,0,23,34984
11253,19505,1415,5537,7063,3901,1589,1030,628,628,62,195,371,0,0,0,0,0,0,0,0,0,402,264,37,40,187,138,106,22,36,48,32,32,0,0,34986
11254,4392,179,1049,1666,1002,496,181,144,78,0,0,78,66,22,22,0,0,44,0,44,0,37,0,0,0,0,37,37,0,37,0,0,0,0,0,34987
11255,20623,1239,4333,6584,5356,3111,1259,676,631,124,105,402,45,45,0,33,12,0,0,0,0,583,540,178,84,278,43,0,0,0,0,43,43,0,0,34990
11256,12721,1958,3359,4162,2023,1219,671,244,52,8,0,44,192,63,22,0,41,129,123,0,6,427,364,129,76,159,63,62,53,0,9,1,0,0,1,34994
11257,8604,418,1743,2728,2202,1513,281,164,112,32,0,80,52,52,0,50,2,0,0,0,0,117,117,6,6,105,0,0,0,0,0,0,0,0,0,34996
11258,30994,3516,9253,10545,5017,2663,1630,784,615,175,154,286,169,24,9,15,0,145,32,40,73,846,708,169,58,481,138,96,11,63,22,42,13,0,29,34997
11259,6873,716,1771,3023,962,401,310,103,103,28,0,75,0,0,0,0,0,0,0,0,0,207,207,47,0,160,0,0,0,0,0,0,0,0,0,35004
11260,5549,1078,2180,1630,436,225,521,307,285,13,29,243,22,11,11,0,0,11,10,0,1,214,195,24,15,156,19,19,14,0,5,0,0,0,0,35005
11261,2135,502,931,474,165,63,167,88,76,0,0,76,12,0,0,0,0,12,0,9,3,79,59,20,36,3,20,20,20,0,0,0,0,0,0,35006
11262,17680,1941,4430,5959,3738,1612,1494,772,685,165,77,443,87,59,23,30,6,28,15,0,13,722,618,261,97,260,104,57,11,0,46,47,0,0,47,35007
11263,14193,3539,4777,3709,1483,685,813,301,268,28,16,224,33,0,0,0,0,33,0,33,0,512,404,130,26,248,108,53,15,15,23,55,0,0,55,35010
11264,21,11,0,0,10,0,0,0,0,0,0,0,0,0,0,0,0,0,0,0,0,0,0,0,0,0,0,0,0,0,0,0,0,0,0,35013
11265,3964,897,1613,1095,215,144,167,67,58,8,0,50,9,9,0,0,9,0,0,0,0,100,96,9,0,87,4,4,0,0,4,0,0,0,0,35014
11266,11496,1937,4008,3589,1389,573,928,486,384,82,35,267,102,37,30,5,2,65,4,2,59,442,383,88,20,275,59,48,7,15,26,11,3,3,5,35016
11267,1162,218,394,392,88,70,73,48,43,0,4,39,5,0,0,0,0,5,5,0,0,25,25,0,8,17,0,0,0,0,0,0,0,0,0,35019
11268,17406,3986,6558,5323,999,540,1242,679,420,93,24,303,259,53,0,53,0,206,72,30,104,563,426,64,67,295,137,66,36,23,7,71,18,0,53,35020
11269,13919,1152,4306,4725,2670,1066,910,577,452,143,10,299,125,82,51,31,0,43,31,0,12,333,284,41,0,243,49,26,0,0,26,23,0,0,23,35022
11270,17492,2782,6538,6028,1401,743,1413,792,543,96,31,416,249,118,100,18,0,131,77,0,54,621,524,155,10,359,97,97,56,0,41,0,0,0,0,35023
11271,5297,1740,1785,1305,280,187,370,183,135,4,0,131,48,34,22,0,12,14,0,14,0,187,157,17,0,140,30,19,8,0,11,11,0,0,11,35031
11272,41,5,27,9,0,0,3,3,3,0,0,3,0,0,0,0,0,0,0,0,0,0,0,0,0,0,0,0,0,0,0,0,0,0,0,35032
11273,2469,375,1059,769,194,72,164,96,96,13,0,83,0,0,0,0,0,0,0,0,0,68,68,0,0,68,0,0,0,0,0,0,0,0,0,35033
11274,3605,1017,1583,617,388,0,458,357,335,27,0,308,22,8,0,0,8,14,0,0,14,101,101,0,0,101,0,0,0,0,0,0,0,0,0,35034
11275,1007,127,455,238,53,134,118,64,28,28,0,0,36,0,0,0,0,36,36,0,0,54,54,0,0,54,0,0,0,0,0,0,0,0,0,35035
11276,108,48,23,37,0,0,0,0,0,0,0,0,0,0,0,0,0,0,0,0,0,0,0,0,0,0,0,0,0,0,0,0,0,0,0,35036
11277,10399,1331,2683,3221,2359,805,640,309,272,47,22,203,37,37,22,15,0,0,0,0,0,331,278,136,19,123,53,53,27,17,9,0,0,0,0,35040
11278,4066,1031,1559,1053,269,154,338,195,139,0,12,127,56,56,56,0,0,0,0,0,0,143,63,7,0,56,80,80,0,80,0,0,0,0,0,35042
11279,6203,354,1544,1912,1829,564,473,265,256,149,0,107,9,0,0,0,0,9,0,0,9,208,208,86,0,122,0,0,0,0,0,0,0,0,0,35043
11280,5189,1172,1960,1601,235,221,347,190,168,0,0,168,22,0,0,0,0,22,0,22,0,157,157,0,78,79,0,0,0,0,0,0,0,0,0,35044
11281,9801,2439,4011,1884,934,533,704,307,284,36,96,152,23,9,0,0,9,14,0,0,14,397,372,80,39,253,25,2,2,0,0,23,14,0,9,35045
11282,3583,827,1297,970,256,233,201,34,11,0,0,11,23,2,2,0,0,21,0,0,21,167,161,64,0,97,6,6,6,0,0,0,0,0,0,35046
11283,2718,497,872,1050,198,101,192,85,85,23,0,62,0,0,0,0,0,0,0,0,0,107,99,18,4,77,8,0,0,0,0,8,8,0,0,35049
11284,6180,1300,2155,1653,867,205,522,260,149,8,0,141,111,37,29,0,8,74,7,0,67,262,174,86,8,80,88,82,39,43,0,6,6,0,0,35051
11285,163,77,36,34,8,8,0,0,0,0,0,0,0,0,0,0,0,0,0,0,0,0,0,0,0,0,0,0,0,0,0,0,0,0,0,35052
11286,1973,279,686,742,122,144,106,33,33,0,22,11,0,0,0,0,0,0,0,0,0,73,58,0,0,58,15,15,0,0,15,0,0,0,0,35053
11287,3275,576,1007,1163,251,278,149,137,118,0,58,60,19,19,19,0,0,0,0,0,0,12,12,0,12,0,0,0,0,0,0,0,0,0,0,35054
11288,13575,2638,3373,5003,1423,1138,1047,480,359,109,33,217,121,91,63,11,17,30,24,0,6,567,473,161,63,249,94,29,0,0,29,65,0,57,8,35055
11289,8778,2187,2584,2864,685,458,648,369,308,62,24,222,61,61,26,35,0,0,0,0,0,279,216,73,29,114,63,34,8,0,26,29,9,4,16,35057
11290,6287,1200,1868,2021,892,306,650,314,297,124,59,114,17,2,0,2,0,15,0,0,15,336,319,85,3,231,17,2,0,0,2,15,14,0,1,35058
11291,219,19,52,127,21,0,31,31,0,0,0,0,31,0,0,0,0,31,0,0,31,0,0,0,0,0,0,0,0,0,0,0,0,0,0,35060
11292,1094,159,433,312,135,55,85,45,45,0,18,27,0,0,0,0,0,0,0,0,0,40,33,0,0,33,7,0,0,0,0,7,0,7,0,35061
11293,5205,677,1869,1812,445,402,419,143,112,7,15,90,31,13,9,4,0,18,0,0,18,276,276,38,0,238,0,0,0,0,0,0,0,0,0,35062
11294,2657,960,942,659,72,24,222,151,108,0,0,108,43,17,0,0,17,26,0,8,18,71,28,12,0,16,43,12,12,0,0,31,0,17,14,35063
11295,7103,903,2018,2902,813,467,951,477,327,47,21,259,150,85,84,0,1,65,16,0,49,474,412,110,41,261,62,0,0,0,0,62,62,0,0,35064
11296,5567,996,1579,1623,918,451,429,244,157,0,20,137,87,25,25,0,0,62,24,0,38,185,156,23,0,133,29,29,28,0,1,0,0,0,0,35068
11297,290,88,85,32,80,5,0,0,0,0,0,0,0,0,0,0,0,0,0,0,0,0,0,0,0,0,0,0,0,0,0,0,0,0,0,35070
11298,11293,1132,3739,3917,1710,795,926,567,553,181,44,328,14,14,0,14,0,0,0,0,0,359,341,148,43,150,18,18,18,0,0,0,0,0,0,35071
11299,3584,920,1558,837,186,83,256,154,114,2,0,112,40,40,12,28,0,0,0,0,0,102,102,13,0,89,0,0,0,0,0,0,0,0,0,35072
11300,1739,461,782,368,98,30,147,108,100,0,0,100,8,8,8,0,0,0,0,0,0,39,39,29,6,4,0,0,0,0,0,0,0,0,0,35073
11301,70,70,0,0,0,0,0,0,0,0,0,0,0,0,0,0,0,0,0,0,0,0,0,0,0,0,0,0,0,0,0,0,0,0,0,35074
11302,8693,2029,3089,2534,690,351,608,268,241,57,23,161,27,15,11,0,4,12,12,0,0,340,307,63,16,228,33,12,9,0,3,21,0,19,2,35077
11303,1528,328,425,488,201,86,111,75,75,11,0,64,0,0,0,0,0,0,0,0,0,36,36,5,16,15,0,0,0,0,0,0,0,0,0,35078
11304,6348,975,2337,2215,465,356,527,203,170,42,48,80,33,33,0,0,33,0,0,0,0,324,251,61,25,165,73,73,37,0,36,0,0,0,0,35079
11305,9858,510,1480,3244,3557,1067,605,329,301,107,19,175,28,28,10,0,18,0,0,0,0,276,268,129,21,118,8,0,0,0,0,8,8,0,0,35080
11306,0,0,0,0,0,0,0,0,0,0,0,0,0,0,0,0,0,0,0,0,0,0,0,0,0,0,0,0,0,0,0,0,0,0,0,35082
11307,2164,348,743,871,126,76,321,183,166,12,103,51,17,17,11,6,0,0,0,0,0,138,110,11,0,99,28,11,0,0,11,17,17,0,0,35083
11308,5403,1228,2268,1354,367,186,339,191,174,44,6,124,17,0,0,0,0,17,0,4,13,148,145,22,0,123,3,3,0,0,3,0,0,0,0,35085
11309,1122,212,529,307,74,0,132,65,65,51,0,14,0,0,0,0,0,0,0,0,0,67,13,0,0,13,54,0,0,0,0,54,26,0,28,35087
11310,1505,319,676,351,87,72,44,20,12,2,10,0,8,0,0,0,0,8,0,8,0,24,24,0,0,24,0,0,0,0,0,0,0,0,0,35089
11311,1836,267,607,635,261,66,154,77,63,22,6,35,14,0,0,0,0,14,0,0,14,77,77,8,4,65,0,0,0,0,0,0,0,0,0,35091
11312,10312,1657,3580,2841,1448,786,745,466,391,137,52,202,75,22,22,0,0,53,0,0,53,279,200,41,6,153,79,53,7,0,46,26,17,0,9,35094
11313,5840,1132,1970,1921,575,242,253,117,63,0,15,48,54,54,10,44,0,0,0,0,0,136,124,36,23,65,12,0,0,0,0,12,12,0,0,35096
11314,1166,172,371,502,108,13,125,46,34,7,3,24,12,5,5,0,0,7,7,0,0,79,79,18,9,52,0,0,0,0,0,0,0,0,0,35097
11315,1090,290,385,371,23,21,87,76,76,0,33,43,0,0,0,0,0,0,0,0,0,11,11,0,0,11,0,0,0,0,0,0,0,0,0,35098
11316,11480,1048,3334,3977,1993,1128,598,350,294,26,0,268,56,56,19,14,23,0,0,0,0,248,169,45,45,79,79,70,13,0,57,9,0,0,9,35111
11317,411,16,224,99,72,0,9,0,0,0,0,0,0,0,0,0,0,0,0,0,0,9,0,0,0,0,9,9,9,0,0,0,0,0,0,35112
11318,4443,301,963,1417,1119,643,344,193,144,23,37,84,49,38,32,6,0,11,0,0,11,151,151,65,0,86,0,0,0,0,0,0,0,0,0,35114
11319,8825,1665,3002,2319,1050,789,1192,519,452,76,41,335,67,67,53,0,14,0,0,0,0,673,645,235,73,337,28,28,0,0,28,0,0,0,0,35115
11320,2856,352,1047,879,389,189,349,179,124,36,3,85,55,29,0,22,7,26,5,10,11,170,164,67,10,87,6,3,3,0,0,3,0,3,0,35116
11321,3712,351,1408,1176,499,278,173,99,92,16,0,76,7,7,0,7,0,0,0,0,0,74,52,11,8,33,22,22,22,0,0,0,0,0,0,35117
11322,2392,503,946,697,201,45,116,43,38,3,9,26,5,5,0,0,5,0,0,0,0,73,65,19,2,44,8,0,0,0,0,8,4,0,4,35118
11323,51,12,20,19,0,0,0,0,0,0,0,0,0,0,0,0,0,0,0,0,0,0,0,0,0,0,0,0,0,0,0,0,0,0,0,35119
11324,9447,2075,3550,2687,797,338,750,397,255,27,56,172,142,90,90,0,0,52,0,37,15,353,313,47,40,226,40,22,0,22,0,18,0,0,18,35120
11325,10022,2705,3412,2616,768,521,844,621,478,38,41,399,143,110,91,19,0,33,25,0,8,223,198,2,14,182,25,10,0,8,2,15,0,0,15,35121
11326,16164,1131,3409,5492,4047,2085,1046,587,489,104,25,360,98,46,34,12,0,52,52,0,0,459,403,104,73,226,56,56,30,0,26,0,0,0,0,35124
11327,6237,1288,2519,1643,590,197,626,248,189,34,0,155,59,31,31,0,0,28,26,0,2,378,185,51,47,87,193,28,28,0,0,165,13,8,144,35125
11328,15049,1653,4856,5464,2098,978,1061,534,409,76,72,261,125,79,53,26,0,46,22,24,0,527,417,191,7,219,110,88,51,0,37,22,0,12,10,35126
11329,7215,541,2470,2615,1179,410,566,283,185,53,0,132,98,79,65,0,14,19,0,19,0,283,277,68,0,209,6,6,0,6,0,0,0,0,0,35127
11330,6586,911,2046,2327,668,634,240,172,172,4,31,137,0,0,0,0,0,0,0,0,0,68,50,0,0,50,18,17,13,0,4,1,0,0,1,35128
11331,2219,501,817,641,200,60,129,21,12,10,2,0,9,0,0,0,0,9,9,0,0,108,84,66,3,15,24,9,9,0,0,15,0,0,15,35130
11332,3014,692,1201,970,102,49,126,80,74,0,6,68,6,0,0,0,0,6,0,6,0,46,43,13,0,30,3,0,0,0,0,3,0,0,3,35131
11333,2478,385,848,943,226,76,177,33,33,22,0,11,0,0,0,0,0,0,0,0,0,144,110,0,7,103,34,34,34,0,0,0,0,0,0,35133
11334,1316,263,354,349,211,139,105,74,74,7,12,55,0,0,0,0,0,0,0,0,0,31,17,0,3,14,14,10,0,10,0,4,0,0,4,35135
11335,1264,263,521,303,79,98,65,55,51,0,0,51,4,0,0,0,0,4,0,0,4,10,10,10,0,0,0,0,0,0,0,0,0,0,0,35136
11336,116,97,9,10,0,0,0,0,0,0,0,0,0,0,0,0,0,0,0,0,0,0,0,0,0,0,0,0,0,0,0,0,0,0,0,35139
11337,2452,375,944,751,235,147,136,123,45,0,0,45,78,56,56,0,0,22,22,0,0,13,13,0,0,13,0,0,0,0,0,0,0,0,0,35143
11338,8442,1366,3072,2635,973,396,721,402,374,116,25,233,28,0,0,0,0,28,22,0,6,319,252,7,0,245,67,0,0,0,0,67,67,0,0,35146
11339,3792,480,824,1010,1001,477,220,95,85,0,3,82,10,10,3,7,0,0,0,0,0,125,90,33,0,57,35,27,27,0,0,8,0,0,8,35147
11340,2115,473,664,866,66,46,137,80,72,9,5,58,8,0,0,0,0,8,0,0,8,57,53,23,6,24,4,4,4,0,0,0,0,0,0,35148
11341,283,61,163,59,0,0,60,0,0,0,0,0,0,0,0,0,0,0,0,0,0,60,14,0,0,14,46,2,0,0,2,44,0,0,44,35149
11342,13293,2794,5243,3521,1139,596,1063,522,440,144,38,258,82,75,0,11,64,7,0,0,7,541,433,78,26,329,108,37,0,37,0,71,0,22,49,35150
11343,5334,967,2063,1785,303,216,308,110,102,27,0,75,8,3,0,3,0,5,0,5,0,198,152,42,0,110,46,0,0,0,0,46,0,0,46,35151
11344,16765,3746,6381,4437,1316,885,1532,796,680,109,117,454,116,61,0,52,9,55,0,0,55,736,690,169,49,472,46,20,0,0,20,26,0,16,10,35160
11345,2407,410,840,766,244,147,174,99,61,23,8,30,38,32,15,0,17,6,0,0,6,75,66,38,4,24,9,7,3,4,0,2,0,0,2,35171
11346,2313,688,944,494,135,52,187,129,18,0,0,18,111,65,63,2,0,46,46,0,0,58,45,8,6,31,13,2,0,0,2,11,0,0,11,35172
11347,17155,1047,4695,5332,4126,1955,1377,622,585,137,91,357,37,37,0,37,0,0,0,0,0,755,755,75,112,568,0,0,0,0,0,0,0,0,0,35173
11348,3497,415,1175,1257,409,241,327,100,100,29,53,18,0,0,0,0,0,0,0,0,0,227,204,22,18,164,23,23,23,0,0,0,0,0,0,35175
11349,703,208,323,115,7,50,37,25,12,12,0,0,13,0,0,0,0,13,13,0,0,12,12,0,0,12,0,0,0,0,0,0,0,0,0,35176
11350,2507,682,1045,452,298,30,182,114,61,0,0,61,53,32,0,32,0,21,0,0,21,68,60,0,0,60,8,8,0,8,0,0,0,0,0,35178
11351,6246,1045,2212,2035,547,407,313,174,174,56,8,110,0,0,0,0,0,0,0,0,0,139,57,3,11,43,82,27,0,0,27,55,0,28,27,35179
11352,9399,1643,3617,3033,801,305,933,587,460,19,62,379,127,56,14,0,42,71,0,36,35,346,346,83,4,259,0,0,0,0,0,0,0,0,0,35180
11353,326,52,189,79,0,6,30,30,30,0,0,30,0,0,0,0,0,0,0,0,0,0,0,0,0,0,0,0,0,0,0,0,0,0,0,35183
11354,4350,644,1656,1432,415,203,322,174,124,9,0,115,50,15,15,0,0,35,0,7,28,148,148,0,16,132,0,0,0,0,0,0,0,0,0,35184
11355,3164,403,1120,943,507,191,188,109,60,1,0,59,49,49,35,5,9,0,0,0,0,79,75,6,28,41,4,4,4,0,0,0,0,0,0,35186
11356,22,15,0,7,0,0,0,0,0,0,0,0,0,0,0,0,0,0,0,0,0,0,0,0,0,0,0,0,0,0,0,0,0,0,0,35187
11357,1688,320,777,347,162,82,103,80,37,0,0,37,43,43,43,0,0,0,0,0,0,23,23,5,0,18,0,0,0,0,0,0,0,0,0,35188
11358,2576,617,726,617,335,281,169,52,31,0,0,31,21,0,0,0,0,21,0,0,21,117,111,15,0,96,6,6,0,0,6,0,0,0,0,35203
11359,7704,2170,2458,2059,604,413,518,240,240,56,26,158,0,0,0,0,0,0,0,0,0,278,228,31,7,190,50,24,8,0,16,26,0,4,22,35204
11360,12835,1349,2281,3656,2935,2614,1639,579,542,142,11,389,37,17,7,0,10,20,0,20,0,1060,995,286,61,648,65,33,25,8,0,32,0,0,32,35205
11361,11691,2298,3802,3951,1105,535,949,556,419,17,21,381,137,66,13,37,16,71,0,0,71,393,340,27,20,293,53,32,32,0,0,21,14,7,0,35206
11362,5732,1464,2048,1763,329,128,388,217,168,12,8,148,49,38,0,38,0,11,0,11,0,171,145,19,19,107,26,26,21,5,0,0,0,0,0,35207
11363,9581,1677,2883,3594,1006,421,879,460,393,0,103,290,67,6,0,0,6,61,0,0,61,419,317,64,63,190,102,48,0,39,9,54,0,54,0,35208
11364,17571,1321,2938,3971,5297,4044,1626,678,614,126,51,437,64,10,7,3,0,54,53,0,1,948,726,196,16,514,222,190,170,20,0,32,0,0,32,35209
11365,10675,1453,2618,3473,1900,1231,411,279,208,67,14,127,71,49,49,0,0,22,10,0,12,132,124,17,30,77,8,8,8,0,0,0,0,0,0,35210
11366,17945,3156,5493,5834,2208,1254,1607,787,681,0,39,642,106,35,0,0,35,71,21,28,22,820,581,61,32,488,239,127,53,32,42,112,14,18,80,35211
11367,8117,1665,2232,2449,1130,641,476,211,158,21,20,117,53,39,39,0,0,14,0,8,6,265,177,0,35,142,88,31,31,0,0,57,28,0,29,35212
11368,9283,191,501,1331,4016,3244,653,272,261,45,0,216,11,11,11,0,0,0,0,0,0,381,359,36,0,323,22,22,0,22,0,0,0,0,0,35213
11369,13052,1861,3751,4932,1711,797,1176,535,483,40,59,384,52,29,29,0,0,23,0,0,23,641,607,102,71,434,34,34,14,0,20,0,0,0,0,35214
11370,28641,3451,8853,11265,3496,1576,2800,1414,1042,218,120,704,372,265,217,16,32,107,43,14,50,1386,1137,215,152,770,249,136,43,52,41,113,9,0,104,35215
11371,24286,2209,3032,6446,7684,4915,1349,659,552,226,0,326,107,107,40,67,0,0,0,0,0,690,674,146,95,433,16,16,0,0,16,0,0,0,0,35216
11372,8825,1672,3309,2761,712,371,646,331,301,35,58,208,30,0,0,0,0,30,8,0,22,315,262,26,102,134,53,0,0,0,0,53,23,30,0,35217
11373,5011,1053,1734,1750,331,143,409,249,143,3,0,140,106,99,72,11,16,7,0,0,7,160,135,0,3,132,25,25,25,0,0,0,0,0,0,35218
11374,3491,539,1034,1485,338,95,252,50,50,0,0,50,0,0,0,0,0,0,0,0,0,202,181,35,0,146,21,0,0,0,0,21,21,0,0,35221
11375,5821,519,1177,1375,1347,1403,260,178,128,34,8,86,50,0,0,0,0,50,0,40,10,82,82,12,9,61,0,0,0,0,0,0,0,0,0,35222
11376,7481,27,269,1147,3421,2617,425,187,187,0,0,187,0,0,0,0,0,0,0,0,0,238,238,46,0,192,0,0,0,0,0,0,0,0,0,35223
11377,3986,859,1405,1433,193,96,327,187,155,0,10,145,32,32,22,0,10,0,0,0,0,140,130,65,14,51,10,10,0,0,10,0,0,0,0,35224
11378,22130,661,2409,5297,7728,6035,1311,755,712,251,14,447,43,43,29,14,0,0,0,0,0,556,497,158,32,307,59,0,0,0,0,59,0,0,59,35226
11379,6231,970,2146,2276,617,222,724,367,244,0,18,226,123,74,42,0,32,49,0,11,38,357,268,45,0,223,89,31,0,31,0,58,0,24,34,35228
11380,64,0,6,26,32,0,735,183,183,36,1,146,0,0,0,0,0,0,0,0,0,552,552,147,9,396,0,0,0,0,0,0,0,0,0,35229
11381,513,61,75,90,185,102,22,0,0,0,0,0,0,0,0,0,0,0,0,0,0,22,22,22,0,0,0,0,0,0,0,0,0,0,0,35233
11382,4352,1254,1372,1405,220,101,165,64,64,7,0,57,0,0,0,0,0,0,0,0,0,101,90,0,0,90,11,0,0,0,0,11,0,11,0,35234
11383,13896,1362,4138,4970,2422,1004,826,365,331,46,40,245,34,0,0,0,0,34,0,0,34,461,415,59,31,325,46,46,46,0,0,0,0,0,0,35235
11384,33593,1275,3857,8608,12737,7116,2565,1406,1362,363,63,936,44,44,24,20,0,0,0,0,0,1159,1103,286,25,792,56,49,0,0,49,7,0,0,7,35242
11385,11927,326,1037,2577,4917,3070,539,258,217,59,0,158,41,41,41,0,0,0,0,0,0,281,264,60,0,204,17,17,0,0,17,0,0,0,0,35243
11386,21716,681,2577,5657,7661,5140,1520,770,742,239,61,442,28,28,15,0,13,0,0,0,0,750,703,248,0,455,47,0,0,0,0,47,0,23,24,35244
11387,217,62,74,33,9,39,508,265,248,0,12,236,17,17,17,0,0,0,0,0,0,243,243,77,37,129,0,0,0,0,0,0,0,0,0,35254
11388,16371,3408,5749,3848,2017,1349,7396,3268,2961,382,124,2455,307,219,145,9,65,88,56,0,32,4128,3796,664,164,2968,332,298,68,32,198,34,0,13,21,35401
11389,11884,1814,4199,3214,1537,1120,1508,930,779,232,13,534,151,39,20,18,1,112,69,0,43,578,468,115,43,310,110,66,0,66,0,44,0,11,33,35404
11390,25859,2334,6632,9208,4556,3129,2021,1000,937,128,39,770,63,48,48,0,0,15,15,0,0,1021,961,195,9,757,60,27,11,0,16,33,0,0,33,35405
11391,10023,370,1072,1908,3501,3172,563,258,250,15,0,235,8,8,8,0,0,0,0,0,0,305,279,20,0,259,26,18,16,2,0,8,0,0,8,35406
11392,784,202,277,178,67,60,44,26,25,12,0,13,1,0,0,0,0,1,0,0,1,18,18,0,0,18,0,0,0,0,0,0,0,0,0,35441
11393,3305,795,1204,879,295,132,390,211,183,24,3,156,28,11,11,0,0,17,0,0,17,179,173,56,34,83,6,0,0,0,0,6,0,0,6,35442
11394,1124,283,529,168,72,72,85,78,58,0,0,58,20,20,3,17,0,0,0,0,0,7,7,0,0,7,0,0,0,0,0,0,0,0,0,35443
11395,2470,432,962,659,346,71,218,126,102,4,5,93,24,10,5,5,0,14,0,4,10,92,86,16,7,63,6,3,0,3,0,3,0,0,3,35444
11396,1040,236,406,340,49,9,96,68,24,0,0,24,44,0,0,0,0,44,0,0,44,28,19,10,0,9,9,9,0,9,0,0,0,0,0,35446
11397,2366,564,1003,500,198,101,226,138,109,1,32,76,29,29,17,0,12,0,0,0,0,88,68,14,7,47,20,2,2,0,0,18,0,0,18,35447
11398,2400,278,1105,746,158,113,99,62,47,38,4,5,15,15,15,0,0,0,0,0,0,37,37,2,6,29,0,0,0,0,0,0,0,0,0,35452
11399,7197,1347,2507,2171,753,419,724,276,177,41,28,108,99,48,34,10,4,51,0,11,40,448,410,130,0,280,38,27,0,27,0,11,0,0,11,35453
11400,2194,385,851,649,252,57,144,113,113,0,0,113,0,0,0,0,0,0,0,0,0,31,31,0,0,31,0,0,0,0,0,0,0,0,0,35456
11401,83,43,0,40,0,0,0,0,0,0,0,0,0,0,0,0,0,0,0,0,0,0,0,0,0,0,0,0,0,0,0,0,0,0,0,35457
11402,311,13,134,103,61,0,0,0,0,0,0,0,0,0,0,0,0,0,0,0,0,0,0,0,0,0,0,0,0,0,0,0,0,0,0,35458
11403,557,173,194,135,34,21,66,54,35,34,0,1,19,19,19,0,0,0,0,0,0,12,10,0,0,10,2,1,0,0,1,1,1,0,0,35459
11404,217,43,97,53,6,18,34,34,18,0,0,18,16,16,0,16,0,0,0,0,0,0,0,0,0,0,0,0,0,0,0,0,0,0,0,35460
11405,1377,294,583,406,82,12,41,9,9,0,0,9,0,0,0,0,0,0,0,0,0,32,31,0,0,31,1,1,0,0,1,0,0,0,0,35461
11406,3467,835,1186,957,382,107,320,138,121,0,34,87,17,9,0,9,0,8,0,0,8,182,89,18,0,71,93,72,0,0,72,21,0,0,21,35462
11407,1026,140,318,399,94,75,157,10,10,0,0,10,0,0,0,0,0,0,0,0,0,147,147,21,0,126,0,0,0,0,0,0,0,0,0,35463
11408,305,61,142,56,33,13,82,74,69,0,0,69,5,5,5,0,0,0,0,0,0,8,8,0,0,8,0,0,0,0,0,0,0,0,0,35464
11409,3955,828,1747,963,224,193,175,114,114,4,0,110,0,0,0,0,0,0,0,0,0,61,58,10,21,27,3,0,0,0,0,3,0,0,3,35466
11410,117,0,53,55,9,0,0,0,0,0,0,0,0,0,0,0,0,0,0,0,0,0,0,0,0,0,0,0,0,0,0,0,0,0,0,35469
11411,3037,782,1104,658,210,283,605,190,180,50,16,114,10,0,0,0,0,10,0,10,0,415,389,147,154,88,26,26,3,0,23,0,0,0,0,35470
11412,10231,1222,3122,2674,1780,1433,764,141,141,22,22,97,0,0,0,0,0,0,0,0,0,623,570,107,31,432,53,53,0,53,0,0,0,0,0,35473
11413,3956,891,1279,1124,499,163,284,160,132,6,0,126,28,23,23,0,0,5,0,5,0,124,124,10,27,87,0,0,0,0,0,0,0,0,0,35474
11414,9229,822,2868,3059,1579,901,736,386,297,51,32,214,89,89,30,0,59,0,0,0,0,350,319,104,13,202,31,31,31,0,0,0,0,0,0,35475
11415,4826,908,1595,1259,653,411,212,130,58,20,0,38,72,23,23,0,0,49,0,49,0,82,60,26,0,34,22,0,0,0,0,22,0,0,22,35476
11416,92,56,36,0,0,0,27,20,20,0,6,14,0,0,0,0,0,0,0,0,0,7,7,7,0,0,0,0,0,0,0,0,0,0,0,35477
11417,995,145,367,312,117,54,38,38,12,0,12,0,26,26,11,0,15,0,0,0,0,0,0,0,0,0,0,0,0,0,0,0,0,0,0,35480
11418,2579,450,1130,756,178,65,293,164,140,0,7,133,24,7,0,7,0,17,0,0,17,129,100,36,0,64,29,29,14,0,15,0,0,0,0,35481
11419,2667,469,1213,742,197,46,327,182,78,4,0,74,104,10,4,0,6,94,0,40,54,145,145,21,14,110,0,0,0,0,0,0,0,0,0,35490
11420,7149,1296,2439,2433,711,270,718,373,275,53,0,222,98,47,26,15,6,51,0,45,6,345,251,111,31,109,94,94,48,46,0,0,0,0,0,35501
11421,5481,1211,2014,1734,328,194,290,119,57,0,0,57,62,57,10,0,47,5,0,0,5,171,141,34,18,89,30,30,11,0,19,0,0,0,0,35503
11422,9781,2035,3032,3098,965,651,553,320,256,90,43,123,64,64,37,27,0,0,0,0,0,233,188,12,22,154,45,0,0,0,0,45,30,0,15,35504
11423,1915,637,680,388,94,116,68,53,29,0,9,20,24,12,12,0,0,12,0,0,12,15,15,4,11,0,0,0,0,0,0,0,0,0,0,35540
11424,2362,553,591,760,321,137,59,52,52,22,0,30,0,0,0,0,0,0,0,0,0,7,7,3,0,4,0,0,0,0,0,0,0,0,0,35541
11425,929,242,416,202,56,13,88,66,66,15,0,51,0,0,0,0,0,0,0,0,0,22,11,0,0,11,11,11,0,0,11,0,0,0,0,35542
11426,1074,361,425,281,7,0,52,35,13,5,4,4,22,0,0,0,0,22,22,0,0,17,17,0,0,17,0,0,0,0,0,0,0,0,0,35543
11427,749,164,312,203,44,26,25,6,6,0,0,6,0,0,0,0,0,0,0,0,0,19,19,0,0,19,0,0,0,0,0,0,0,0,0,35544
11428,56,25,20,11,0,0,1,0,0,0,0,0,0,0,0,0,0,0,0,0,0,1,1,0,0,1,0,0,0,0,0,0,0,0,0,35545
11429,2613,637,1210,457,261,48,300,172,155,9,14,132,17,17,13,0,4,0,0,0,0,128,91,26,0,65,37,36,32,0,4,1,0,0,1,35546
11430,1281,342,566,302,36,35,218,72,63,15,0,48,9,5,0,5,0,4,0,0,4,146,144,7,0,137,2,2,0,2,0,0,0,0,0,35548
11431,3376,949,1278,866,150,133,202,90,90,28,16,46,0,0,0,0,0,0,0,0,0,112,93,13,30,50,19,9,9,0,0,10,0,0,10,35549
11432,3569,871,1189,1201,178,130,189,54,48,12,15,21,6,0,0,0,0,6,0,0,6,135,77,6,24,47,58,31,22,0,9,27,27,0,0,35550
11433,755,241,262,227,20,5,17,3,3,0,0,3,0,0,0,0,0,0,0,0,0,14,14,10,0,4,0,0,0,0,0,0,0,0,0,35552
11434,3407,775,1249,1111,123,149,85,53,39,7,0,32,14,1,0,0,1,13,0,0,13,32,27,0,0,27,5,1,0,1,0,4,4,0,0,35553
11435,791,227,384,130,26,24,65,35,19,0,0,19,16,16,14,0,2,0,0,0,0,30,26,3,0,23,4,4,0,4,0,0,0,0,0,35554
11436,7064,1745,2643,1568,554,554,437,241,161,2,49,110,80,14,14,0,0,66,0,0,66,196,183,75,7,101,13,0,0,0,0,13,0,13,0,35555
11437,35,0,28,7,0,0,0,0,0,0,0,0,0,0,0,0,0,0,0,0,0,0,0,0,0,0,0,0,0,0,0,0,0,0,0,35559
11438,3235,776,1179,957,215,108,213,62,61,27,0,34,1,1,1,0,0,0,0,0,0,151,132,34,10,88,19,19,19,0,0,0,0,0,0,35563
11439,1462,455,501,406,66,34,173,111,80,4,4,72,31,13,13,0,0,18,15,0,3,62,62,3,23,36,0,0,0,0,0,0,0,0,0,35564
11440,8639,2619,2653,2619,506,242,781,416,368,101,80,187,48,48,24,24,0,0,0,0,0,365,291,74,0,217,74,20,20,0,0,54,0,27,27,35565
11441,7871,1964,2715,2504,431,257,298,170,132,15,11,106,38,12,0,0,12,26,0,0,26,128,128,14,9,105,0,0,0,0,0,0,0,0,0,35570
11442,591,161,215,177,32,6,35,6,6,0,6,0,0,0,0,0,0,0,0,0,0,29,25,19,3,3,4,4,4,0,0,0,0,0,0,35571
11443,784,181,466,98,28,11,85,0,0,0,0,0,0,0,0,0,0,0,0,0,0,85,57,0,0,57,28,28,0,0,28,0,0,0,0,35572
11444,922,147,476,278,6,15,53,12,12,4,0,8,0,0,0,0,0,0,0,0,0,41,41,2,36,3,0,0,0,0,0,0,0,0,0,35574
11445,793,205,310,215,38,25,36,14,14,0,0,14,0,0,0,0,0,0,0,0,0,22,22,0,0,22,0,0,0,0,0,0,0,0,0,35575
11446,2023,428,841,562,103,89,72,26,26,0,4,22,0,0,0,0,0,0,0,0,0,46,46,15,0,31,0,0,0,0,0,0,0,0,0,35576
11447,24,13,5,6,0,0,0,0,0,0,0,0,0,0,0,0,0,0,0,0,0,0,0,0,0,0,0,0,0,0,0,0,0,0,0,35577
11448,3722,1185,1429,943,104,61,316,129,100,0,0,100,29,5,5,0,0,24,0,24,0,187,158,65,8,85,29,10,0,0,10,19,2,0,17,35578
11449,2174,442,1027,587,63,55,145,73,55,20,0,35,18,18,0,0,18,0,0,0,0,72,24,0,0,24,48,44,0,0,44,4,4,0,0,35579
11450,2909,816,1043,769,182,99,132,84,62,40,0,22,22,0,0,0,0,22,0,22,0,48,48,10,2,36,0,0,0,0,0,0,0,0,0,35580
11451,3172,848,987,1059,125,153,215,87,83,51,0,32,4,4,0,0,4,0,0,0,0,128,96,63,0,33,32,0,0,0,0,32,0,7,25,35581
11452,2918,687,1068,795,271,97,134,62,15,0,6,9,47,47,41,0,6,0,0,0,0,72,64,31,0,33,8,8,0,0,8,0,0,0,0,35582
11453,387,97,175,115,0,0,14,5,5,0,0,5,0,0,0,0,0,0,0,0,0,9,5,0,0,5,4,0,0,0,0,4,4,0,0,35584
11454,921,120,273,401,99,28,78,30,17,0,0,17,13,13,0,13,0,0,0,0,0,48,39,0,0,39,9,9,0,0,9,0,0,0,0,35585
11455,3406,981,1096,968,237,124,162,80,52,0,6,46,28,0,0,0,0,28,14,0,14,82,66,0,22,44,16,0,0,0,0,16,0,0,16,35586
11456,871,216,439,191,16,9,114,39,28,7,0,21,11,11,0,11,0,0,0,0,0,75,75,6,0,69,0,0,0,0,0,0,0,0,0,35587
11457,2901,604,1142,835,220,100,326,169,99,10,0,89,70,14,0,6,8,56,4,0,52,157,143,0,0,143,14,0,0,0,0,14,14,0,0,35592
11458,1597,485,443,547,94,28,143,102,64,0,0,64,38,38,0,32,6,0,0,0,0,41,41,2,0,39,0,0,0,0,0,0,0,0,0,35593
11459,5596,1133,1880,1698,464,421,371,210,203,8,29,166,7,7,0,0,7,0,0,0,0,161,122,45,0,77,39,0,0,0,0,39,0,25,14,35594
11460,23063,6117,6939,6010,2659,1338,1650,762,619,131,70,418,143,86,52,0,34,57,14,18,25,888,664,219,106,339,224,111,59,35,17,113,28,72,13,35601
11461,21021,2399,5903,6460,4184,2075,1346,655,609,147,138,324,46,46,16,30,0,0,0,0,0,691,586,153,75,358,105,94,63,24,7,11,0,11,0,35603
11462,1556,251,774,398,89,44,144,69,66,2,0,64,3,3,3,0,0,0,0,0,0,75,71,38,0,33,4,0,0,0,0,4,0,0,4,35610
11463,17622,3912,5965,4683,2174,888,1464,580,424,129,15,280,156,84,29,55,0,72,0,0,72,884,659,132,52,475,225,50,44,0,6,175,47,59,69,35611
11464,15264,2209,4129,4716,2646,1564,994,475,380,77,0,303,95,22,13,0,9,73,48,0,25,519,488,91,0,397,31,15,15,0,0,16,0,16,0,35613
11465,5375,1274,2156,1350,329,266,400,134,120,20,21,79,14,0,0,0,0,14,14,0,0,266,242,43,11,188,24,24,24,0,0,0,0,0,0,35614
11466,0,0,0,0,0,0,0,0,0,0,0,0,0,0,0,0,0,0,0,0,0,0,0,0,0,0,0,0,0,0,0,0,0,0,0,35615
11467,2868,723,989,746,261,149,157,107,97,25,0,72,10,10,0,10,0,0,0,0,0,50,34,8,6,20,16,12,12,0,0,4,0,0,4,35616
11468,1254,298,514,337,93,12,79,34,18,0,0,18,16,16,14,0,2,0,0,0,0,45,41,6,2,33,4,0,0,0,0,4,0,4,0,35618
11469,3462,796,1133,1029,346,158,207,116,56,19,4,33,60,53,52,0,1,7,0,7,0,91,58,0,0,58,33,18,18,0,0,15,0,0,15,35619
11470,5778,1583,2001,1317,599,278,508,256,222,42,19,161,34,19,13,6,0,15,0,0,15,252,142,21,15,106,110,66,0,36,30,44,0,0,44,35620
11471,2001,375,901,478,183,64,106,55,43,12,0,31,12,3,1,2,0,9,9,0,0,51,51,17,13,21,0,0,0,0,0,0,0,0,0,35621
11472,5093,1139,2186,1369,256,143,494,326,210,17,96,97,116,88,60,28,0,28,28,0,0,168,168,28,3,137,0,0,0,0,0,0,0,0,0,35622
11473,21011,3948,6234,5946,3101,1782,2238,1054,956,317,41,598,98,81,80,0,1,17,11,0,6,1184,1097,275,112,710,87,55,46,0,9,32,16,0,16,35630
11474,14279,2571,4729,3758,1869,1352,1278,635,556,167,32,357,79,79,79,0,0,0,0,0,0,643,608,38,169,401,35,35,10,0,25,0,0,0,0,35633
11475,6799,657,2364,1970,1160,648,223,91,91,66,0,25,0,0,0,0,0,0,0,0,0,132,111,3,0,108,21,0,0,0,0,21,10,0,11,35634
11476,16844,2187,5626,5640,2150,1241,1478,822,600,179,11,410,222,162,81,70,11,60,25,9,26,656,529,220,59,250,127,127,69,49,9,0,0,0,0,35640
11477,2060,442,906,522,138,52,122,27,13,10,3,0,14,14,0,0,14,0,0,0,0,95,95,39,0,56,0,0,0,0,0,0,0,0,0,35643
11478,10052,1196,3610,3308,1342,596,858,400,375,71,57,247,25,11,11,0,0,14,0,0,14,458,427,179,28,220,31,31,31,0,0,0,0,0,0,35645
11479,2950,559,1201,865,161,164,257,117,50,5,11,34,67,58,58,0,0,9,9,0,0,140,140,15,0,125,0,0,0,0,0,0,0,0,0,35646
11480,643,96,231,217,58,41,61,36,23,12,0,11,13,7,7,0,0,6,6,0,0,25,25,0,0,25,0,0,0,0,0,0,0,0,0,35647
11481,2410,415,1048,685,143,119,141,62,62,10,0,52,0,0,0,0,0,0,0,0,0,79,79,16,8,55,0,0,0,0,0,0,0,0,0,35648
11482,72,6,4,4,47,11,11,11,11,11,0,0,0,0,0,0,0,0,0,0,0,0,0,0,0,0,0,0,0,0,0,0,0,0,0,35649
11483,10094,2513,3954,2430,810,387,636,324,281,60,18,203,43,25,25,0,0,18,0,0,18,312,275,47,58,170,37,37,0,0,37,0,0,0,0,35650
11484,856,223,233,280,93,27,50,50,50,12,15,23,0,0,0,0,0,0,0,0,0,0,0,0,0,0,0,0,0,0,0,0,0,0,0,35651
11485,5923,960,2411,1691,432,429,303,178,178,14,13,151,0,0,0,0,0,0,0,0,0,125,103,27,0,76,22,19,2,17,0,3,0,0,3,35652
11486,7601,2131,2639,1927,570,334,631,388,228,36,46,146,160,23,23,0,0,137,102,35,0,243,228,101,10,117,15,14,14,0,0,1,0,0,1,35653
11487,5531,1767,1748,1437,421,158,295,174,159,0,0,159,15,8,3,0,5,7,0,0,7,121,112,12,11,89,9,5,5,0,0,4,0,0,4,35654
11488,6071,1253,1935,1738,736,409,535,359,208,0,0,208,151,48,36,12,0,103,31,50,22,176,168,19,15,134,8,8,0,8,0,0,0,0,0,35660
11489,12283,1452,3904,4265,1704,958,1166,602,572,124,27,421,30,30,0,0,30,0,0,0,0,564,505,40,39,426,59,45,45,0,0,14,0,0,14,35661
11490,5360,1190,1476,1960,546,188,329,141,121,40,9,72,20,8,8,0,0,12,0,0,12,188,139,76,0,63,49,49,49,0,0,0,0,0,0,35670
11491,1574,346,420,420,306,82,135,77,26,0,0,26,51,0,0,0,0,51,0,51,0,58,58,36,0,22,0,0,0,0,0,0,0,0,0,35671
11492,3858,614,1475,1046,433,290,379,201,167,30,0,137,34,20,7,13,0,14,0,0,14,178,178,36,47,95,0,0,0,0,0,0,0,0,0,35672
11493,5291,1022,1898,1848,354,169,384,195,181,61,50,70,14,14,0,0,14,0,0,0,0,189,165,37,28,100,24,24,24,0,0,0,0,0,0,35673
11494,12795,2037,4737,3941,1404,676,1014,372,326,58,20,248,46,35,23,0,12,11,0,0,11,642,607,87,16,504,35,8,8,0,0,27,0,23,4,35674
11495,1078,245,489,163,152,29,74,70,35,2,0,33,35,35,35,0,0,0,0,0,0,4,4,0,0,4,0,0,0,0,0,0,0,0,0,35677
11496,3802,738,1306,1234,385,139,279,116,78,19,0,59,38,38,20,16,2,0,0,0,0,163,131,59,0,72,32,12,12,0,0,20,0,0,20,35739
11497,2289,569,1009,526,125,60,172,113,102,7,0,95,11,11,0,11,0,0,0,0,0,59,49,23,9,17,10,0,0,0,0,10,0,10,0,35740
11498,2304,239,491,478,496,600,102,51,0,0,0,0,51,51,51,0,0,0,0,0,0,51,51,46,0,5,0,0,0,0,0,0,0,0,0,35741
11499,2130,744,669,444,189,84,207,151,83,0,0,83,68,37,32,5,0,31,31,0,0,56,53,5,0,48,3,0,0,0,0,3,0,0,3,35744
11500,228,27,152,37,8,4,0,0,0,0,0,0,0,0,0,0,0,0,0,0,0,0,0,0,0,0,0,0,0,0,0,0,0,0,0,35745
11501,603,166,282,61,34,60,69,43,43,0,0,43,0,0,0,0,0,0,0,0,0,26,26,0,0,26,0,0,0,0,0,0,0,0,0,35746
11502,4059,945,1474,1014,418,208,391,235,227,40,2,185,8,3,3,0,0,5,0,3,2,156,117,25,25,67,39,39,19,8,12,0,0,0,0,35747
11503,4487,828,1215,1190,764,490,367,193,186,50,4,132,7,3,3,0,0,4,4,0,0,174,139,15,4,120,35,35,0,0,35,0,0,0,0,35748
11504,13242,761,2810,4262,3757,1652,981,541,465,91,29,345,76,58,27,31,0,18,18,0,0,440,420,160,21,239,20,20,20,0,0,0,0,0,0,35749
11505,8244,1226,2649,2602,1148,619,747,485,384,57,35,292,101,78,78,0,0,23,0,0,23,262,212,71,0,141,50,0,0,0,0,50,50,0,0,35750
11506,188,32,86,65,0,5,73,0,0,0,0,0,0,0,0,0,0,0,0,0,0,73,63,26,0,37,10,10,10,0,0,0,0,0,0,35751
11507,1445,438,453,446,91,17,28,8,8,0,0,8,0,0,0,0,0,0,0,0,0,20,20,0,0,20,0,0,0,0,0,0,0,0,0,35752
11508,3366,847,1201,814,408,96,323,158,158,66,0,92,0,0,0,0,0,0,0,0,0,165,153,59,0,94,12,12,0,0,12,0,0,0,0,35754
11509,407,90,154,120,24,19,6,4,4,0,0,4,0,0,0,0,0,0,0,0,0,2,1,0,0,1,1,1,1,0,0,0,0,0,0,35755
11510,6393,440,1331,1804,1973,845,280,175,167,11,16,140,8,8,8,0,0,0,0,0,0,105,103,36,0,67,2,2,2,0,0,0,0,0,0,35756
11511,9262,394,1730,2980,2807,1351,785,335,296,54,8,234,39,0,0,0,0,39,0,0,39,450,439,126,60,253,11,11,0,11,0,0,0,0,0,35757
11512,28214,1137,3708,7777,9894,5698,2520,1279,1112,118,197,797,167,138,47,70,21,29,0,29,0,1241,1202,366,86,750,39,39,0,11,28,0,0,0,0,35758
11513,4781,261,1288,1627,1052,553,501,269,269,62,17,190,0,0,0,0,0,0,0,0,0,232,232,56,16,160,0,0,0,0,0,0,0,0,0,35759
11514,3642,678,1317,1122,348,177,313,139,120,0,15,105,19,12,6,6,0,7,0,7,0,174,124,34,0,90,50,27,17,10,0,23,0,0,23,35760
11515,7398,1234,2175,2022,1315,652,367,150,113,26,0,87,37,15,0,0,15,22,0,0,22,217,184,57,52,75,33,11,0,0,11,22,14,0,8,35761
11516,9873,538,2000,2338,2950,2047,674,359,327,51,0,276,32,21,17,4,0,11,0,0,11,315,292,32,22,238,23,18,18,0,0,5,5,0,0,35763
11517,422,168,146,50,35,23,48,2,2,0,0,2,0,0,0,0,0,0,0,0,0,46,46,0,0,46,0,0,0,0,0,0,0,0,0,35764
11518,2634,795,640,741,244,214,130,76,71,11,0,60,5,3,3,0,0,2,0,0,2,54,45,24,0,21,9,9,0,9,0,0,0,0,0,35765
11519,121,0,62,21,26,12,15,12,12,12,0,0,0,0,0,0,0,0,0,0,0,3,3,3,0,0,0,0,0,0,0,0,0,0,0,35766
11520,8614,2315,3263,2082,492,462,469,160,151,17,15,119,9,5,5,0,0,4,0,0,4,309,287,29,10,248,22,2,0,2,0,20,0,0,20,35768
11521,6913,1100,2156,1931,967,759,514,336,233,41,18,174,103,59,0,18,41,44,0,0,44,178,164,43,37,84,14,0,0,0,0,14,0,0,14,35769
11522,2395,646,770,814,73,92,211,90,73,22,0,51,17,17,0,17,0,0,0,0,0,121,116,53,0,63,5,5,3,2,0,0,0,0,0,35771
11523,3319,982,1253,752,258,74,327,233,229,78,57,94,4,4,4,0,0,0,0,0,0,94,82,0,5,77,12,12,0,0,12,0,0,0,0,35772
11524,7829,1128,2425,2479,1206,591,700,391,323,58,89,176,68,61,27,0,34,7,7,0,0,309,291,63,51,177,18,18,18,0,0,0,0,0,0,35773
11525,63,7,34,22,0,0,57,33,33,0,0,33,0,0,0,0,0,0,0,0,0,24,17,0,0,17,7,7,0,0,7,0,0,0,0,35774
11526,419,110,233,59,0,17,0,0,0,0,0,0,0,0,0,0,0,0,0,0,0,0,0,0,0,0,0,0,0,0,0,0,0,0,0,35775
11527,2537,656,1117,591,109,64,207,80,66,25,2,39,14,8,8,0,0,6,0,6,0,127,111,57,16,38,16,4,4,0,0,12,12,0,0,35776
11528,16549,1561,2501,4504,4520,3463,757,364,301,103,23,175,63,20,20,0,0,43,0,0,43,393,377,68,59,250,16,16,16,0,0,0,0,0,0,35801
11529,14917,462,2009,4133,4620,3693,1058,504,439,89,57,293,65,42,33,0,9,23,0,23,0,554,462,144,60,258,92,92,74,8,10,0,0,0,0,35802
11530,18944,885,3144,6052,6111,2752,1637,852,766,283,65,418,86,56,56,0,0,30,0,19,11,785,688,151,25,512,97,97,97,0,0,0,0,0,0,35803
11531,14048,3596,4305,4492,1050,605,951,530,409,103,18,288,121,63,50,0,13,58,47,11,0,421,243,83,66,94,178,49,15,8,26,129,49,32,48,35805
11532,12973,816,1735,3546,4136,2740,942,404,362,67,43,252,42,42,14,28,0,0,0,0,0,538,489,113,113,263,49,49,33,0,16,0,0,0,0,35806
11533,627,27,85,373,44,98,217,183,27,2,0,25,156,156,156,0,0,0,0,0,0,34,10,0,0,10,24,24,23,0,1,0,0,0,0,35808
11534,19522,3247,5553,6738,2600,1384,2411,1394,1196,107,239,850,198,62,26,19,17,136,54,28,54,1017,838,175,213,450,179,106,73,0,33,73,19,54,0,35810
11535,17976,1848,5076,5965,3098,1989,1756,914,865,140,238,487,49,49,49,0,0,0,0,0,0,842,762,186,115,461,80,67,49,0,18,13,0,0,13,35811
11536,8013,1529,1862,2947,1181,494,1485,956,754,72,189,493,202,20,8,12,0,182,48,38,96,529,472,107,59,306,57,0,0,0,0,57,45,0,12,35816
11537,4240,143,529,927,1583,1058,137,96,85,0,0,85,11,11,11,0,0,0,0,0,0,41,12,12,0,0,29,29,0,29,0,0,0,0,0,35824
11538,8,0,0,8,0,0,367,109,109,18,21,70,0,0,0,0,0,0,0,0,0,258,258,57,57,144,0,0,0,0,0,0,0,0,0,35896
11539,13740,2267,4422,4485,1564,1002,1082,549,470,78,26,366,79,66,34,0,32,13,8,5,0,533,487,46,25,416,46,34,9,25,0,12,12,0,0,35901
11540,12487,2388,3923,4528,1157,491,1040,417,296,25,59,212,121,92,92,0,0,29,8,0,21,623,463,36,66,361,160,118,10,82,26,42,7,15,20,35903
11541,9366,2136,2945,3185,742,358,448,208,167,0,23,144,41,0,0,0,0,41,19,0,22,240,173,33,0,140,67,0,0,0,0,67,6,5,56,35904
11542,4669,853,1453,1679,461,223,302,184,180,34,25,121,4,4,0,0,4,0,0,0,0,118,110,34,14,62,8,8,0,8,0,0,0,0,0,35905
11543,7093,652,2178,2718,1072,473,405,214,200,59,0,141,14,14,14,0,0,0,0,0,0,191,173,29,0,144,18,8,8,0,0,10,0,10,0,35906
11544,5616,460,1867,2161,654,474,507,377,340,52,14,274,37,17,17,0,0,20,0,0,20,130,118,44,0,74,12,12,12,0,0,0,0,0,0,35907
11545,13327,4294,4243,3442,924,424,941,502,290,87,17,186,212,156,66,57,33,56,9,11,36,439,351,120,30,201,88,52,4,20,28,36,0,0,36,35950
11546,8158,2330,2659,2240,520,409,642,311,215,68,30,117,96,64,20,17,27,32,21,11,0,331,220,72,0,148,111,80,65,15,0,31,0,12,19,35951
11547,5336,1255,2045,1663,294,79,408,210,203,33,3,167,7,0,0,0,0,7,7,0,0,198,141,60,16,65,57,27,12,0,15,30,0,0,30,35952
11548,4480,1065,1548,1227,438,202,393,170,127,20,0,107,43,14,0,0,14,29,0,0,29,223,161,65,42,54,62,49,9,0,40,13,0,6,7,35953
11549,8539,2152,2947,2518,511,411,633,316,238,38,8,192,78,78,71,0,7,0,0,0,0,317,217,67,0,150,100,22,12,4,6,78,39,0,39,35954
11550,5734,1178,2005,1846,485,220,505,233,225,74,0,151,8,5,5,0,0,3,0,0,3,272,272,76,0,196,0,0,0,0,0,0,0,0,0,35956
11551,9682,2341,3339,2760,844,398,1190,648,493,107,24,362,155,139,59,54,26,16,0,7,9,542,504,112,45,347,38,9,9,0,0,29,0,0,29,35957
11552,2179,498,1072,390,189,30,341,240,240,26,0,214,0,0,0,0,0,0,0,0,0,101,101,11,0,90,0,0,0,0,0,0,0,0,0,35958
11553,3307,743,1226,1022,159,157,138,40,38,0,13,25,2,0,0,0,0,2,0,0,2,98,96,9,11,76,2,1,0,1,0,1,0,1,0,35959
11554,7623,1584,2357,2501,680,501,334,184,109,34,1,74,75,21,13,8,0,54,34,0,20,150,150,59,40,51,0,0,0,0,0,0,0,0,0,35960
11555,4525,1973,1448,817,200,87,517,210,174,21,39,114,36,6,6,0,0,30,0,0,30,307,230,0,22,208,77,77,69,0,8,0,0,0,0,35961
11556,5170,1558,1856,1107,321,328,421,244,189,16,13,160,55,23,23,0,0,32,16,4,12,177,172,46,0,126,5,5,0,1,4,0,0,0,0,35962
11557,1121,384,296,318,59,64,42,0,0,0,0,0,0,0,0,0,0,0,0,0,0,42,30,17,0,13,12,0,0,0,0,12,0,0,12,35963
11558,2623,629,1019,698,185,92,146,54,34,21,0,13,20,20,0,0,20,0,0,0,0,92,76,0,0,76,16,9,9,0,0,7,0,0,7,35966
11559,10518,3182,3541,2319,914,562,891,397,342,113,64,165,55,42,13,0,29,13,0,0,13,494,458,182,26,250,36,36,26,10,0,0,0,0,0,35967
11560,2750,767,1099,705,72,107,190,129,117,0,32,85,12,0,0,0,0,12,0,0,12,61,54,21,0,33,7,7,0,0,7,0,0,0,0,35968
11561,3793,1116,1215,1122,179,161,245,106,91,34,7,50,15,12,10,2,0,3,0,0,3,139,134,25,19,90,5,5,0,4,1,0,0,0,0,35971
11562,757,155,197,256,96,53,115,83,62,20,0,42,21,21,0,21,0,0,0,0,0,32,20,15,0,5,12,12,0,12,0,0,0,0,0,35972
11563,2206,657,925,488,78,58,108,39,13,13,0,0,26,26,26,0,0,0,0,0,0,69,69,49,0,20,0,0,0,0,0,0,0,0,0,35973
11564,953,193,465,188,70,37,128,69,22,3,0,19,47,18,10,0,8,29,0,0,29,59,58,2,0,56,1,1,0,1,0,0,0,0,0,35974
11565,801,105,250,392,21,33,35,10,10,0,0,10,0,0,0,0,0,0,0,0,0,25,25,0,0,25,0,0,0,0,0,0,0,0,0,35975
11566,12254,2277,3653,3702,1650,972,645,341,198,32,52,114,143,90,54,19,17,53,0,0,53,304,232,38,41,153,72,62,38,0,24,10,0,1,9,35976
11567,3928,1063,1632,942,191,100,275,181,155,58,0,97,26,8,8,0,0,18,0,0,18,94,86,0,0,86,8,8,8,0,0,0,0,0,0,35978
11568,814,311,373,113,17,0,120,105,105,58,0,47,0,0,0,0,0,0,0,0,0,15,15,0,0,15,0,0,0,0,0,0,0,0,0,35979
11569,3847,1595,1135,807,190,120,322,133,123,7,17,99,10,6,2,0,4,4,0,4,0,189,121,50,31,40,68,47,23,0,24,21,0,17,4,35980
11570,1885,593,647,378,148,119,155,25,25,0,0,25,0,0,0,0,0,0,0,0,0,130,127,7,0,120,3,0,0,0,0,3,0,0,3,35981
11571,2681,495,839,929,248,170,247,128,65,0,0,65,63,63,7,0,56,0,0,0,0,119,111,12,7,92,8,8,8,0,0,0,0,0,0,35983
11572,1516,219,511,504,205,77,86,46,33,0,3,30,13,2,2,0,0,11,11,0,0,40,40,0,6,34,0,0,0,0,0,0,0,0,0,35984
11573,4920,1056,1749,1609,283,223,313,146,124,36,6,82,22,22,22,0,0,0,0,0,0,167,134,17,0,117,33,3,0,0,3,30,0,14,16,35986
11574,1832,345,809,480,147,51,148,77,46,4,9,33,31,31,0,31,0,0,0,0,0,71,17,4,0,13,54,54,54,0,0,0,0,0,0,35987
11575,1357,297,658,321,53,28,132,78,78,20,0,58,0,0,0,0,0,0,0,0,0,54,54,0,0,54,0,0,0,0,0,0,0,0,0,35988
11576,2262,612,691,536,283,140,116,48,45,1,8,36,3,3,0,3,0,0,0,0,0,68,51,17,0,34,17,8,0,0,8,9,3,0,6,35989
11577,28,6,14,8,0,0,0,0,0,0,0,0,0,0,0,0,0,0,0,0,0,0,0,0,0,0,0,0,0,0,0,0,0,0,0,35990
11578,1468,487,464,438,44,35,43,33,33,6,8,19,0,0,0,0,0,0,0,0,0,10,3,0,0,3,7,7,0,7,0,0,0,0,0,36003
11579,1235,259,590,300,42,44,5,5,0,0,0,0,5,5,0,5,0,0,0,0,0,0,0,0,0,0,0,0,0,0,0,0,0,0,0,36005
11580,1022,284,360,283,71,24,130,61,61,0,0,61,0,0,0,0,0,0,0,0,0,69,69,17,0,52,0,0,0,0,0,0,0,0,0,36006
11581,1922,477,664,466,206,109,105,32,32,3,0,29,0,0,0,0,0,0,0,0,0,73,70,8,0,62,3,3,0,3,0,0,0,0,0,36009
11582,3217,847,1189,803,299,79,295,177,132,6,24,102,45,31,31,0,0,14,4,0,10,118,114,14,4,96,4,0,0,0,0,4,0,0,4,36010
11583,363,8,48,65,198,44,14,14,14,0,0,14,0,0,0,0,0,0,0,0,0,0,0,0,0,0,0,0,0,0,0,0,0,0,0,36013
11584,3747,1294,1223,894,207,129,222,150,83,0,0,83,67,9,0,0,9,58,0,0,58,72,72,5,16,51,0,0,0,0,0,0,0,0,0,36016
11585,2456,888,764,595,157,52,80,58,27,4,0,23,31,5,5,0,0,26,0,8,18,22,17,8,0,9,5,0,0,0,0,5,0,0,5,36017
11586,719,114,294,195,78,38,62,26,26,8,0,18,0,0,0,0,0,0,0,0,0,36,31,0,4,27,5,5,5,0,0,0,0,0,0,36020
11587,7652,682,2666,2832,1053,419,607,297,208,43,47,118,89,79,49,5,25,10,0,0,10,310,301,60,69,172,9,9,0,0,9,0,0,0,0,36022
11588,3735,378,1544,1064,376,373,195,98,78,11,17,50,20,20,4,10,6,0,0,0,0,97,97,24,0,73,0,0,0,0,0,0,0,0,0,36024
11589,4883,1287,1917,1212,369,98,248,204,90,4,31,55,114,38,0,5,33,76,0,16,60,44,44,0,0,44,0,0,0,0,0,0,0,0,0,36025
11590,755,96,292,120,131,116,0,0,0,0,0,0,0,0,0,0,0,0,0,0,0,0,0,0,0,0,0,0,0,0,0,0,0,0,0,36026
11591,10745,2067,3722,3210,1016,730,749,340,282,26,28,228,58,45,24,1,20,13,0,0,13,409,375,88,36,251,34,25,17,0,8,9,0,0,9,36027
11592,1380,281,549,394,113,43,137,133,123,86,0,37,10,0,0,0,0,10,10,0,0,4,4,0,0,4,0,0,0,0,0,0,0,0,0,36028
11593,562,124,150,125,47,116,47,47,47,0,0,47,0,0,0,0,0,0,0,0,0,0,0,0,0,0,0,0,0,0,0,0,0,0,0,36029
11594,265,48,105,71,31,10,36,24,24,8,0,16,0,0,0,0,0,0,0,0,0,12,7,7,0,0,5,5,0,5,0,0,0,0,0,36030
11595,28,0,28,0,0,0,0,0,0,0,0,0,0,0,0,0,0,0,0,0,0,0,0,0,0,0,0,0,0,0,0,0,0,0,0,36031
11596,1434,418,499,286,203,28,186,96,73,0,22,51,23,16,16,0,0,7,0,0,7,90,74,48,0,26,16,8,8,0,0,8,0,0,8,36032
11597,2995,748,1155,840,157,95,141,73,48,5,0,43,25,7,0,7,0,18,0,11,7,68,53,5,0,48,15,15,0,0,15,0,0,0,0,36033
11598,582,74,267,157,41,43,31,28,25,0,11,14,3,0,0,0,0,3,0,0,3,3,0,0,0,0,3,3,0,0,3,0,0,0,0,36034
11599,1243,192,523,320,111,97,50,22,22,5,0,17,0,0,0,0,0,0,0,0,0,28,28,0,7,21,0,0,0,0,0,0,0,0,0,36035
11600,1329,261,557,404,93,14,100,35,35,10,0,25,0,0,0,0,0,0,0,0,0,65,57,17,6,34,8,8,8,0,0,0,0,0,0,36036
11601,9191,2057,3252,2336,922,624,611,378,305,38,51,216,73,45,39,0,6,28,0,0,28,233,186,34,15,137,47,41,13,28,0,6,0,6,0,36037
11602,95,5,55,12,23,0,2,0,0,0,0,0,0,0,0,0,0,0,0,0,0,2,2,0,0,2,0,0,0,0,0,0,0,0,0,36038
11603,130,17,83,30,0,0,20,8,8,0,0,8,0,0,0,0,0,0,0,0,0,12,12,0,12,0,0,0,0,0,0,0,0,0,0,36039
11604,2499,862,984,423,118,112,194,94,74,0,7,67,20,4,0,4,0,16,0,0,16,100,88,11,5,72,12,10,0,10,0,2,0,0,2,36040
11605,707,115,257,210,88,37,81,77,21,9,0,12,56,56,56,0,0,0,0,0,0,4,4,4,0,0,0,0,0,0,0,0,0,0,0,36041
11606,916,207,352,284,49,24,61,42,42,0,0,42,0,0,0,0,0,0,0,0,0,19,13,13,0,0,6,6,0,0,6,0,0,0,0,36042
11607,2291,373,790,634,277,217,200,90,54,20,13,21,36,36,36,0,0,0,0,0,0,110,78,40,0,38,32,10,0,0,10,22,0,22,0,36043
11608,1103,289,457,253,41,63,137,94,94,0,0,94,0,0,0,0,0,0,0,0,0,43,43,15,0,28,0,0,0,0,0,0,0,0,0,36046
11609,935,189,324,293,105,24,65,27,27,0,0,27,0,0,0,0,0,0,0,0,0,38,38,0,0,38,0,0,0,0,0,0,0,0,0,36047
11610,919,291,315,227,41,45,95,53,53,1,0,52,0,0,0,0,0,0,0,0,0,42,4,0,0,4,38,7,0,0,7,31,0,0,31,36048
11611,3815,916,1428,957,323,191,352,183,153,4,21,128,30,2,0,0,2,28,0,17,11,169,120,25,0,95,49,17,9,0,8,32,0,32,0,36049
11612,1541,335,748,297,8,153,122,50,50,0,32,18,0,0,0,0,0,0,0,0,0,72,70,0,0,70,2,2,0,0,2,0,0,0,0,36051
11613,823,128,94,362,137,102,31,12,12,0,0,12,0,0,0,0,0,0,0,0,0,19,19,0,0,19,0,0,0,0,0,0,0,0,0,36052
11614,1530,593,527,261,102,47,77,45,45,0,0,45,0,0,0,0,0,0,0,0,0,32,32,0,0,32,0,0,0,0,0,0,0,0,0,36053
11615,9360,921,3263,3055,1456,665,987,469,433,154,50,229,36,36,0,17,19,0,0,0,0,518,395,149,50,196,123,77,13,56,8,46,0,13,33,36054
11616,4937,312,742,1272,1552,1059,465,203,203,16,21,166,0,0,0,0,0,0,0,0,0,262,185,0,0,185,77,77,0,0,77,0,0,0,0,36064
11617,12046,703,3552,3748,2856,1187,1109,650,547,120,50,377,103,98,46,0,52,5,0,5,0,459,365,108,39,218,94,94,77,8,9,0,0,0,0,36066
11618,17421,2929,6085,5440,1748,1219,1628,678,578,110,121,347,100,81,22,28,31,19,0,0,19,950,766,112,149,505,184,112,88,4,20,72,17,51,4,36067
11619,1236,397,417,235,147,40,76,12,12,9,0,3,0,0,0,0,0,0,0,0,0,64,58,9,0,49,6,6,6,0,0,0,0,0,0,36069
11620,622,164,319,105,16,18,2,2,2,0,0,2,0,0,0,0,0,0,0,0,0,0,0,0,0,0,0,0,0,0,0,0,0,0,0,36071
11621,1584,254,643,429,181,77,74,41,33,11,14,8,8,7,7,0,0,1,0,0,1,33,33,4,0,29,0,0,0,0,0,0,0,0,0,36075
11622,9018,1318,3193,2787,1067,653,712,466,391,44,127,220,75,31,20,0,11,44,12,0,32,246,155,19,45,91,91,91,30,0,61,0,0,0,0,36078
11623,5861,1166,1928,1470,862,435,461,288,236,21,4,211,52,35,29,4,2,17,0,17,0,173,165,56,6,103,8,5,3,0,2,3,3,0,0,36079
11624,1385,157,532,435,171,90,166,75,75,0,30,45,0,0,0,0,0,0,0,0,0,91,83,28,0,55,8,8,0,8,0,0,0,0,0,36080
11625,9030,1472,3197,1766,1519,1076,1364,603,587,96,25,466,16,2,0,0,2,14,0,0,14,761,687,161,118,408,74,74,8,0,66,0,0,0,0,36081
11626,37,0,0,0,20,17,612,235,235,31,31,173,0,0,0,0,0,0,0,0,0,377,377,80,49,248,0,0,0,0,0,0,0,0,0,36082
11627,5727,1142,1486,1931,550,618,525,324,290,49,31,210,34,24,22,2,0,10,0,0,10,201,157,40,36,81,44,25,13,0,12,19,0,14,5,36083
11628,2116,284,470,684,333,345,1046,386,378,83,59,236,8,8,8,0,0,0,0,0,0,660,648,112,112,424,12,12,0,12,0,0,0,0,0,36088
11629,5565,1964,1777,1177,240,407,271,134,95,0,0,95,39,39,0,0,39,0,0,0,0,137,120,15,0,105,17,17,17,0,0,0,0,0,0,36089
11630,2732,821,1133,449,244,85,261,108,86,0,0,86,22,0,0,0,0,22,22,0,0,153,125,6,0,119,28,28,0,20,8,0,0,0,0,36091
11631,13998,2562,5140,4212,1319,765,972,494,410,53,30,327,84,84,67,17,0,0,0,0,0,478,415,52,131,232,63,45,45,0,0,18,18,0,0,36092
11632,6945,457,1593,2433,1630,832,718,389,379,107,26,246,10,10,10,0,0,0,0,0,0,329,312,81,44,187,17,17,0,0,17,0,0,0,0,36093
11633,5108,1725,1163,1241,572,407,1281,592,526,77,41,408,66,44,2,11,31,22,0,22,0,689,643,83,33,527,46,40,21,0,19,6,6,0,0,36104
11634,8027,1980,2678,2079,854,436,609,405,293,33,0,260,112,21,0,21,0,91,42,11,38,204,196,28,43,125,8,8,0,0,8,0,0,0,0,36105
11635,9636,659,1451,2806,2712,2008,1045,541,519,76,24,419,22,3,2,0,1,19,0,19,0,504,443,93,26,324,61,58,55,3,0,3,0,0,3,36106
11636,5282,1459,1863,1183,531,246,413,237,85,22,0,63,152,0,0,0,0,152,126,0,26,176,157,7,24,126,19,0,0,0,0,19,0,0,19,36107
11637,12924,4020,4084,3095,1175,550,1440,664,472,26,50,396,192,65,15,26,24,127,0,28,99,776,585,120,172,293,191,53,17,6,30,138,2,52,84,36108
11638,17050,1377,5245,5608,3023,1797,1095,563,517,70,27,420,46,46,40,6,0,0,0,0,0,532,399,70,15,314,133,119,81,38,0,14,0,14,0,36109
11639,8101,2166,2986,1974,685,290,519,347,291,26,40,225,56,17,17,0,0,39,12,19,8,172,122,22,18,82,50,17,14,0,3,33,9,0,24,36110
11640,8120,840,1752,2052,1996,1480,546,261,212,47,8,157,49,35,0,19,16,14,0,0,14,285,242,36,14,192,43,13,13,0,0,30,0,0,30,36111
11641,43,7,11,13,12,0,91,37,9,9,0,0,28,28,28,0,0,0,0,0,0,54,14,14,0,0,40,40,29,0,11,0,0,0,0,36112
11642,1137,118,431,369,81,138,41,22,9,2,3,4,13,13,13,0,0,0,0,0,0,19,18,7,0,11,1,1,1,0,0,0,0,0,0,36113
11643,290,5,26,197,17,45,29,21,0,0,0,0,21,21,21,0,0,0,0,0,0,8,5,0,0,5,3,3,0,3,0,0,0,0,0,36115
11644,27201,3191,7919,8043,5142,2906,2673,1278,1082,247,23,812,196,39,37,0,2,157,35,54,68,1395,1039,212,67,760,356,199,50,8,141,157,0,28,129,36116
11645,33188,2201,6373,9508,9224,5882,2982,1602,1434,439,12,983,168,73,72,0,1,95,0,11,84,1380,1314,276,14,1024,66,48,43,5,0,18,18,0,0,36117
11646,12893,4337,4639,3224,456,237,1093,600,512,48,114,350,88,16,0,6,10,72,0,18,54,493,395,65,126,204,98,48,32,10,6,50,5,0,45,36201
11647,12822,2361,4182,3688,1829,762,957,545,429,143,27,259,116,81,42,15,24,35,0,30,5,412,397,147,37,213,15,15,0,0,15,0,0,0,0,36203
11648,366,31,77,123,94,41,1,0,0,0,0,0,0,0,0,0,0,0,0,0,0,1,0,0,0,0,1,1,1,0,0,0,0,0,0,36205
11649,7671,1356,2670,2570,750,325,637,431,359,61,91,207,72,42,37,5,0,30,30,0,0,206,187,46,35,106,19,19,0,19,0,0,0,0,0,36206
11650,14068,2233,3934,4414,2049,1438,624,309,273,40,44,189,36,26,15,0,11,10,10,0,0,315,244,25,24,195,71,56,8,48,0,15,0,0,15,36207
11651,3445,483,1302,1067,436,157,323,104,70,13,0,57,34,34,12,22,0,0,0,0,0,219,202,50,20,132,17,17,7,0,10,0,0,0,0,36250
11652,3565,835,1293,1185,137,115,234,154,100,7,0,93,54,13,13,0,0,41,0,35,6,80,53,15,0,38,27,11,0,0,11,16,0,0,16,36251
11653,569,201,153,183,26,6,30,14,14,4,0,10,0,0,0,0,0,0,0,0,0,16,16,9,0,7,0,0,0,0,0,0,0,0,0,36255
11654,1255,261,561,284,92,57,132,47,47,4,9,34,0,0,0,0,0,0,0,0,0,85,60,21,0,39,25,0,0,0,0,25,0,25,0,36256
11655,888,268,239,341,15,25,21,9,9,0,0,9,0,0,0,0,0,0,0,0,0,12,12,0,0,12,0,0,0,0,0,0,0,0,0,36258
11656,2843,663,1200,701,148,131,217,103,65,14,0,51,38,38,0,38,0,0,0,0,0,114,114,107,0,7,0,0,0,0,0,0,0,0,0,36260
11657,874,195,372,243,53,11,111,67,47,3,0,44,20,0,0,0,0,20,0,0,20,44,44,0,6,38,0,0,0,0,0,0,0,0,0,36262
11658,519,151,168,107,71,22,54,54,39,0,0,39,15,0,0,0,0,15,0,0,15,0,0,0,0,0,0,0,0,0,0,0,0,0,0,36263
11659,5980,1518,2369,1574,247,272,421,191,155,22,19,114,36,11,11,0,0,25,0,18,7,230,199,54,34,111,31,17,8,0,9,14,0,14,0,36264
11660,12352,2877,3479,3282,1586,1128,2089,966,832,139,131,562,134,75,22,0,53,59,0,36,23,1123,956,184,196,576,167,121,10,67,44,46,0,26,20,36265
11661,4396,926,1685,1282,342,161,306,178,168,36,25,107,10,0,0,0,0,10,10,0,0,128,66,11,27,28,62,28,21,0,7,34,0,0,34,36266
11662,21,10,11,0,0,0,0,0,0,0,0,0,0,0,0,0,0,0,0,0,0,0,0,0,0,0,0,0,0,0,0,0,0,0,0,36267
11663,3412,819,1100,1045,204,244,254,110,85,9,9,67,25,0,0,0,0,25,25,0,0,144,113,31,21,61,31,31,31,0,0,0,0,0,0,36268
11664,768,278,272,158,60,0,42,28,28,0,0,28,0,0,0,0,0,0,0,0,0,14,14,0,0,14,0,0,0,0,0,0,0,0,0,36269
11665,4046,796,1588,1262,267,133,260,167,158,0,20,138,9,9,2,0,7,0,0,0,0,93,69,7,0,62,24,22,0,13,9,2,0,0,2,36271
11666,8711,2008,3192,2624,588,299,665,381,187,47,0,140,194,83,83,0,0,111,7,75,29,284,230,64,8,158,54,11,0,8,3,43,0,34,9,36272
11667,2483,403,1071,721,120,168,228,80,80,31,7,42,0,0,0,0,0,0,0,0,0,148,115,21,9,85,33,28,0,0,28,5,0,0,5,36273
11668,7438,1966,2581,2218,441,232,572,193,116,17,0,99,77,41,41,0,0,36,0,0,36,379,306,30,0,276,73,61,8,13,40,12,0,12,0,36274
11669,1414,309,558,323,163,61,238,133,117,0,8,109,16,0,0,0,0,16,0,0,16,105,92,9,7,76,13,13,13,0,0,0,0,0,0,36276
11670,3470,518,1024,1389,383,156,181,51,36,12,4,20,15,15,5,4,6,0,0,0,0,130,126,7,25,94,4,4,4,0,0,0,0,0,0,36277
11671,2957,765,984,701,287,220,224,151,145,26,11,108,6,0,0,0,0,6,0,0,6,73,67,7,0,60,6,0,0,0,0,6,6,0,0,36278
11672,1937,304,691,664,156,122,96,52,46,18,0,28,6,6,0,0,6,0,0,0,0,44,44,0,0,44,0,0,0,0,0,0,0,0,0,36279
11673,2753,818,1281,453,133,68,217,69,40,0,0,40,29,29,29,0,0,0,0,0,0,148,131,16,0,115,17,11,0,11,0,6,0,0,6,36280
11674,24583,4258,9286,7304,2485,1250,1952,1026,834,135,66,633,192,133,87,23,23,59,17,6,36,926,748,280,46,422,178,126,37,49,40,52,15,13,24,36301
11675,20200,3561,6026,6003,2838,1772,1719,858,674,124,77,473,184,120,60,40,20,64,12,7,45,861,728,169,44,515,133,107,49,20,38,26,6,9,11,36303
11676,10140,838,2238,3667,2142,1255,686,371,330,54,6,270,41,17,3,14,0,24,0,0,24,315,271,67,11,193,44,37,27,0,10,7,0,0,7,36305
11677,4986,1304,1773,1326,363,220,268,94,94,11,0,83,0,0,0,0,0,0,0,0,0,174,137,2,0,135,37,14,6,0,8,23,0,2,21,36310
11678,1892,590,558,504,146,94,170,71,59,9,0,50,12,12,0,9,3,0,0,0,0,99,99,4,2,93,0,0,0,0,0,0,0,0,0,36311
11679,4426,766,1788,1198,489,185,275,126,119,20,8,91,7,3,3,0,0,4,4,0,0,149,131,16,2,113,18,10,4,3,3,8,8,0,0,36312
11680,250,4,93,130,0,23,0,0,0,0,0,0,0,0,0,0,0,0,0,0,0,0,0,0,0,0,0,0,0,0,0,0,0,0,0,36313
11681,346,68,182,53,24,19,2,2,2,2,0,0,0,0,0,0,0,0,0,0,0,0,0,0,0,0,0,0,0,0,0,0,0,0,0,36314
11682,941,158,312,286,134,51,122,59,35,0,0,35,24,10,4,0,6,14,0,0,14,63,60,19,0,41,3,3,0,0,3,0,0,0,0,36316
11683,231,85,37,72,9,28,8,0,0,0,0,0,0,0,0,0,0,0,0,0,0,8,8,0,0,8,0,0,0,0,0,0,0,0,0,36317
11684,897,247,285,247,53,65,44,8,8,0,0,8,0,0,0,0,0,0,0,0,0,36,26,0,0,26,10,2,0,2,0,8,0,0,8,36318
11685,1732,376,680,507,120,49,77,48,48,0,12,36,0,0,0,0,0,0,0,0,0,29,29,9,0,20,0,0,0,0,0,0,0,0,0,36319
11686,2539,496,1012,777,146,108,205,91,64,18,4,42,27,16,2,2,12,11,0,0,11,114,93,20,0,73,21,1,1,0,0,20,0,0,20,36320
11687,1032,195,399,321,64,53,78,55,45,13,2,30,10,8,3,0,5,2,2,0,0,23,23,9,6,8,0,0,0,0,0,0,0,0,0,36321
11688,5871,901,1891,2301,437,341,435,244,181,29,10,142,63,43,2,37,4,20,17,0,3,191,185,25,12,148,6,0,0,0,0,6,6,0,0,36322
11689,6085,1435,1979,1723,552,396,404,262,225,9,15,201,37,17,1,14,2,20,4,0,16,142,116,20,8,88,26,15,3,12,0,11,3,8,0,36323
11690,23049,3143,6050,7551,4057,2248,1941,947,789,85,91,613,158,107,22,36,49,51,37,11,3,994,906,285,27,594,88,71,12,34,25,17,8,5,4,36330
11691,4347,772,1690,1464,333,88,157,54,37,23,14,0,17,17,17,0,0,0,0,0,0,103,103,22,19,62,0,0,0,0,0,0,0,0,0,36340
11692,1042,288,431,229,57,37,77,34,30,3,0,27,4,0,0,0,0,4,0,0,4,43,43,2,0,41,0,0,0,0,0,0,0,0,0,36343
11693,3898,993,1384,1145,286,90,236,172,161,32,0,129,11,0,0,0,0,11,0,0,11,64,59,27,0,32,5,0,0,0,0,5,0,0,5,36344
11694,5334,617,1756,1705,745,511,479,261,258,82,14,162,3,3,3,0,0,0,0,0,0,218,213,82,10,121,5,0,0,0,0,5,0,0,5,36345
11695,900,221,345,221,51,62,39,14,14,0,0,14,0,0,0,0,0,0,0,0,0,25,25,14,2,9,0,0,0,0,0,0,0,0,0,36346
11696,4575,890,1357,1564,531,233,422,226,217,42,12,163,9,9,0,9,0,0,0,0,0,196,171,79,13,79,25,21,2,8,11,4,0,0,4,36350
11697,2666,612,976,728,219,131,140,98,98,11,3,84,0,0,0,0,0,0,0,0,0,42,27,0,2,25,15,1,0,1,0,14,0,4,10,36351
11698,3669,412,1528,1238,323,168,215,119,118,17,40,61,1,1,0,0,1,0,0,0,0,96,90,32,9,49,6,6,6,0,0,0,0,0,0,36352
11699,1308,337,535,293,80,63,74,24,24,7,2,15,0,0,0,0,0,0,0,0,0,50,42,2,0,40,8,8,8,0,0,0,0,0,0,36353
11700,14038,2350,4413,4695,1736,844,1089,543,491,106,3,382,52,43,26,17,0,9,2,1,6,546,441,159,25,257,105,85,8,22,55,20,0,0,20,36360
11701,1957,50,206,1153,455,93,401,255,71,20,0,51,184,184,184,0,0,0,0,0,0,146,120,0,47,73,26,26,26,0,0,0,0,0,0,36362
11702,688,175,307,169,26,11,41,31,24,12,0,12,7,7,0,0,7,0,0,0,0,10,10,0,0,10,0,0,0,0,0,0,0,0,0,36370
11703,411,34,148,160,60,9,39,9,9,5,0,4,0,0,0,0,0,0,0,0,0,30,22,0,0,22,8,8,7,0,1,0,0,0,0,36371
11704,472,75,212,144,6,35,24,0,0,0,0,0,0,0,0,0,0,0,0,0,0,24,24,0,0,24,0,0,0,0,0,0,0,0,0,36373
11705,692,89,258,192,100,53,62,21,21,7,0,14,0,0,0,0,0,0,0,0,0,41,28,0,8,20,13,13,0,0,13,0,0,0,0,36374
11706,4977,928,2165,1277,409,198,451,219,175,108,10,57,44,44,34,0,10,0,0,0,0,232,209,62,3,144,23,23,23,0,0,0,0,0,0,36375
11707,1577,381,669,408,79,40,121,64,46,16,11,19,18,11,11,0,0,7,0,0,7,57,57,13,2,42,0,0,0,0,0,0,0,0,0,36376
11708,5092,1178,2360,1107,229,218,253,112,106,0,0,106,6,0,0,0,0,6,0,6,0,141,75,0,9,66,66,32,0,32,0,34,0,34,0,36401
11709,7063,1298,2382,2021,900,462,630,352,296,59,0,237,56,39,39,0,0,17,0,17,0,278,266,63,13,190,12,12,0,12,0,0,0,0,0,36420
11710,6285,1362,2012,1890,628,393,380,241,205,17,15,173,36,14,3,0,11,22,0,0,22,139,88,21,5,62,51,41,0,0,41,10,4,0,6,36421
11711,713,108,307,180,106,12,104,77,56,0,3,53,21,21,0,0,21,0,0,0,0,27,27,0,0,27,0,0,0,0,0,0,0,0,0,36425
11712,10768,2053,4095,3103,921,596,944,450,417,50,25,342,33,10,10,0,0,23,0,12,11,494,426,43,4,379,68,20,0,8,12,48,0,48,0,36426
11713,1643,470,573,507,78,15,178,88,88,23,7,58,0,0,0,0,0,0,0,0,0,90,76,9,4,63,14,0,0,0,0,14,0,14,0,36432
11714,396,90,158,148,0,0,49,18,18,7,0,11,0,0,0,0,0,0,0,0,0,31,31,0,0,31,0,0,0,0,0,0,0,0,0,36435
11715,275,75,59,117,24,0,25,20,20,0,0,20,0,0,0,0,0,0,0,0,0,5,0,0,0,0,5,0,0,0,0,5,0,5,0,36436
11716,238,37,67,64,42,28,9,9,9,2,0,7,0,0,0,0,0,0,0,0,0,0,0,0,0,0,0,0,0,0,0,0,0,0,0,36439
11717,2458,521,892,650,347,48,104,24,14,6,0,8,10,10,7,0,3,0,0,0,0,80,76,3,21,52,4,4,0,4,0,0,0,0,0,36441
11718,2960,651,1036,1048,179,46,253,102,71,14,0,57,31,0,0,0,0,31,0,10,21,151,151,59,0,92,0,0,0,0,0,0,0,0,0,36442
11719,542,204,301,37,0,0,71,19,16,0,0,16,3,3,3,0,0,0,0,0,0,52,52,0,13,39,0,0,0,0,0,0,0,0,0,36444
11720,3545,1113,1300,828,221,83,210,139,125,14,9,102,14,14,7,7,0,0,0,0,0,71,71,4,0,67,0,0,0,0,0,0,0,0,0,36445
11721,291,95,112,64,12,8,6,2,2,2,0,0,0,0,0,0,0,0,0,0,0,4,4,0,0,4,0,0,0,0,0,0,0,0,0,36446
11722,3216,582,1465,791,209,169,161,60,44,3,0,41,16,16,0,16,0,0,0,0,0,101,101,35,17,49,0,0,0,0,0,0,0,0,0,36451
11723,1691,534,621,391,125,20,83,61,61,5,11,45,0,0,0,0,0,0,0,0,0,22,22,0,0,22,0,0,0,0,0,0,0,0,0,36453
11724,17,0,11,0,0,6,0,0,0,0,0,0,0,0,0,0,0,0,0,0,0,0,0,0,0,0,0,0,0,0,0,0,0,0,0,36454
11725,292,32,124,98,8,30,50,50,50,0,0,50,0,0,0,0,0,0,0,0,0,0,0,0,0,0,0,0,0,0,0,0,0,0,0,36455
11726,1367,443,531,291,73,29,58,46,39,0,0,39,7,3,0,0,3,4,0,0,4,12,12,0,0,12,0,0,0,0,0,0,0,0,0,36456
11727,7255,1454,2669,2248,671,213,742,427,384,7,0,377,43,40,27,0,13,3,0,0,3,315,236,41,28,167,79,39,21,0,18,40,40,0,0,36460
11728,7075,1758,2376,2185,484,272,512,242,188,6,26,156,54,0,0,0,0,54,29,17,8,270,189,35,0,154,81,43,21,20,2,38,0,0,38,36467
11729,102,22,80,0,0,0,0,0,0,0,0,0,0,0,0,0,0,0,0,0,0,0,0,0,0,0,0,0,0,0,0,0,0,0,0,36470
11730,658,117,324,185,27,5,105,16,16,0,0,16,0,0,0,0,0,0,0,0,0,89,85,0,0,85,4,4,0,4,0,0,0,0,0,36471
11731,129,40,89,0,0,0,35,18,0,0,0,0,18,18,18,0,0,0,0,0,0,17,17,0,0,17,0,0,0,0,0,0,0,0,0,36473
11732,2089,456,804,589,147,93,173,49,44,0,0,44,5,5,5,0,0,0,0,0,0,124,97,71,0,26,27,27,17,0,10,0,0,0,0,36474
11733,1525,199,783,397,62,84,140,116,68,0,20,48,48,2,2,0,0,46,0,35,11,24,24,0,0,24,0,0,0,0,0,0,0,0,0,36475
11734,37,19,10,3,3,2,19,15,15,0,0,15,0,0,0,0,0,0,0,0,0,4,4,4,0,0,0,0,0,0,0,0,0,0,0,36476
11735,2903,793,1084,775,211,40,228,102,83,2,2,79,19,19,7,0,12,0,0,0,0,126,108,23,0,85,18,0,0,0,0,18,0,18,0,36477
11736,1285,344,559,322,48,12,46,40,40,0,0,40,0,0,0,0,0,0,0,0,0,6,6,6,0,0,0,0,0,0,0,0,0,0,0,36480
11737,194,39,120,23,12,0,13,3,3,0,0,3,0,0,0,0,0,0,0,0,0,10,10,0,0,10,0,0,0,0,0,0,0,0,0,36481
11738,769,205,303,201,60,0,46,46,21,0,0,21,25,0,0,0,0,25,0,0,25,0,0,0,0,0,0,0,0,0,0,0,0,0,0,36482
11739,234,40,107,58,16,13,0,0,0,0,0,0,0,0,0,0,0,0,0,0,0,0,0,0,0,0,0,0,0,0,0,0,0,0,0,36483
11740,13428,3710,4642,3683,931,462,1004,613,363,63,57,243,250,145,24,79,42,105,15,35,55,391,362,41,0,321,29,29,0,29,0,0,0,0,0,36502
11741,976,199,472,239,33,33,69,35,21,0,0,21,14,14,14,0,0,0,0,0,0,34,34,0,0,34,0,0,0,0,0,0,0,0,0,36505
11742,12206,2256,4317,3833,1261,539,1219,683,579,244,24,311,104,87,30,31,26,17,0,0,17,536,498,117,62,319,38,19,19,0,0,19,0,0,19,36507
11743,1359,548,442,261,100,8,99,41,29,0,0,29,12,12,0,0,12,0,0,0,0,58,45,0,0,45,13,6,6,0,0,7,0,0,7,36509
11744,570,0,251,306,13,0,171,0,0,0,0,0,0,0,0,0,0,0,0,0,0,171,89,7,82,0,82,0,0,0,0,82,0,82,0,36511
11745,0,0,0,0,0,0,0,0,0,0,0,0,0,0,0,0,0,0,0,0,0,0,0,0,0,0,0,0,0,0,0,0,0,0,0,36512
11746,270,26,180,64,0,0,59,28,28,0,0,28,0,0,0,0,0,0,0,0,0,31,31,0,31,0,0,0,0,0,0,0,0,0,0,36513
11747,1780,349,743,355,217,116,65,28,24,0,0,24,4,0,0,0,0,4,0,0,4,37,37,0,5,32,0,0,0,0,0,0,0,0,0,36518
11748,3634,690,1574,1020,277,73,324,85,50,12,24,14,35,24,21,3,0,11,0,11,0,239,210,39,0,171,29,29,0,29,0,0,0,0,0,36521
11749,4237,1111,1819,967,232,108,246,121,65,8,0,57,56,56,48,0,8,0,0,0,0,125,114,20,9,85,11,0,0,0,0,11,11,0,0,36522
11750,1498,531,414,346,118,89,82,31,25,0,0,25,6,6,6,0,0,0,0,0,0,51,35,0,0,35,16,16,0,0,16,0,0,0,0,36523
11751,967,214,518,126,90,19,70,44,42,2,0,40,2,2,2,0,0,0,0,0,0,26,25,0,0,25,1,1,1,0,0,0,0,0,0,36524
11752,1153,230,397,399,111,16,146,110,108,12,8,88,2,2,2,0,0,0,0,0,0,36,28,0,0,28,8,2,0,2,0,6,6,0,0,36525
11753,20330,1006,4422,6731,5578,2593,1676,846,753,189,30,534,93,51,23,0,28,42,0,0,42,830,764,200,30,534,66,39,39,0,0,27,0,0,27,36526
11754,8616,370,1671,2150,3190,1235,615,361,321,89,0,232,40,13,13,0,0,27,0,0,27,254,246,91,13,142,8,8,0,0,8,0,0,0,0,36527
11755,986,54,293,381,155,103,25,10,10,3,0,7,0,0,0,0,0,0,0,0,0,15,15,0,0,15,0,0,0,0,0,0,0,0,0,36528
11756,298,23,199,39,12,25,81,68,27,0,20,7,41,20,20,0,0,21,10,0,11,13,13,0,0,13,0,0,0,0,0,0,0,0,0,36529
11757,4978,701,1742,1579,652,304,367,316,273,103,3,167,43,39,34,5,0,4,4,0,0,51,44,3,17,24,7,7,4,0,3,0,0,0,0,36530
11758,20729,1604,4904,6131,5154,2936,1337,522,502,111,43,348,20,17,9,0,8,3,0,0,3,815,668,132,14,522,147,126,38,88,0,21,0,0,21,36532
11759,18036,2485,6120,6413,1962,1056,1311,710,575,326,27,222,135,71,44,27,0,64,0,64,0,601,362,236,39,87,239,174,109,0,65,65,0,0,65,36535
11760,258,173,59,11,7,8,1,1,1,0,0,1,0,0,0,0,0,0,0,0,0,0,0,0,0,0,0,0,0,0,0,0,0,0,0,36538
11761,519,121,356,38,4,0,100,60,49,7,0,42,11,0,0,0,0,11,11,0,0,40,20,20,0,0,20,20,0,0,20,0,0,0,0,36539
11762,442,137,218,87,0,0,65,30,30,0,0,30,0,0,0,0,0,0,0,0,0,35,35,0,0,35,0,0,0,0,0,0,0,0,0,36540
11763,10174,2349,3725,3055,711,334,833,357,269,40,83,146,88,39,0,39,0,49,34,15,0,476,368,98,42,228,108,16,0,16,0,92,26,66,0,36541
11764,9217,714,2673,3083,1928,819,462,265,223,156,27,40,42,0,0,0,0,42,0,12,30,197,112,68,0,44,85,85,58,0,27,0,0,0,0,36542
11765,60,0,31,29,0,0,0,0,0,0,0,0,0,0,0,0,0,0,0,0,0,0,0,0,0,0,0,0,0,0,0,0,0,0,0,36543
11766,7034,2043,2737,1916,214,124,511,219,167,96,30,41,52,6,6,0,0,46,0,10,36,292,177,17,0,160,115,93,36,43,14,22,22,0,0,36544
11767,6658,1390,2802,1662,502,302,637,353,255,64,20,171,98,77,25,0,52,21,0,21,0,284,211,30,47,134,73,57,11,24,22,16,0,0,16,36545
11768,834,78,353,247,130,26,37,31,17,0,11,6,14,14,7,7,0,0,0,0,0,6,6,0,0,6,0,0,0,0,0,0,0,0,0,36548
11769,4068,285,1261,1573,571,378,0,0,0,0,0,0,0,0,0,0,0,0,0,0,0,0,0,0,0,0,0,0,0,0,0,0,0,0,0,36549
11770,75,10,46,19,0,0,0,0,0,0,0,0,0,0,0,0,0,0,0,0,0,0,0,0,0,0,0,0,0,0,0,0,0,0,0,36550
11771,5528,883,2057,1743,658,187,337,249,249,58,86,105,0,0,0,0,0,0,0,0,0,88,88,32,7,49,0,0,0,0,0,0,0,0,0,36551
11772,2214,525,1017,537,95,40,172,93,67,0,27,40,26,26,7,19,0,0,0,0,0,79,27,21,2,4,52,37,16,16,5,15,0,0,15,36553
11773,646,66,122,242,147,69,36,10,5,5,0,0,5,5,5,0,0,0,0,0,0,26,26,0,0,26,0,0,0,0,0,0,0,0,0,36555
11774,102,0,91,11,0,0,0,0,0,0,0,0,0,0,0,0,0,0,0,0,0,0,0,0,0,0,0,0,0,0,0,0,0,0,0,36556
11775,2637,458,1205,749,98,127,332,123,84,2,0,82,39,23,0,23,0,16,0,0,16,209,188,0,17,171,21,17,3,14,0,4,0,0,4,36558
11776,137,0,19,12,62,44,0,0,0,0,0,0,0,0,0,0,0,0,0,0,0,0,0,0,0,0,0,0,0,0,0,0,0,0,0,36559
11777,2379,606,1100,554,78,41,136,52,49,10,4,35,3,3,0,0,3,0,0,0,0,84,84,0,0,84,0,0,0,0,0,0,0,0,0,36560
11778,4830,300,1072,1736,1101,621,237,115,81,35,12,34,34,9,9,0,0,25,25,0,0,122,122,28,31,63,0,0,0,0,0,0,0,0,0,36561
11779,991,231,535,173,52,0,82,57,57,5,0,52,0,0,0,0,0,0,0,0,0,25,25,0,0,25,0,0,0,0,0,0,0,0,0,36562
11780,16,0,0,8,8,0,0,0,0,0,0,0,0,0,0,0,0,0,0,0,0,0,0,0,0,0,0,0,0,0,0,0,0,0,0,36564
11781,8656,1694,3028,2810,758,366,720,432,355,52,56,247,77,77,35,21,21,0,0,0,0,288,278,128,16,134,10,10,10,0,0,0,0,0,0,36567
11782,143,31,69,0,43,0,0,0,0,0,0,0,0,0,0,0,0,0,0,0,0,0,0,0,0,0,0,0,0,0,0,0,0,0,0,36568
11783,703,23,422,183,45,30,40,8,8,0,0,8,0,0,0,0,0,0,0,0,0,32,32,0,0,32,0,0,0,0,0,0,0,0,0,36569
11784,10343,1625,4173,2809,1202,534,613,363,306,61,8,237,57,50,32,18,0,7,0,0,7,250,200,40,0,160,50,30,21,0,9,20,0,0,20,36571
11785,4529,415,1880,1537,425,272,289,194,141,25,24,92,53,53,0,11,42,0,0,0,0,95,95,17,0,78,0,0,0,0,0,0,0,0,0,36572
11786,956,143,414,327,26,46,191,66,66,0,0,66,0,0,0,0,0,0,0,0,0,125,109,14,36,59,16,16,0,0,16,0,0,0,0,36574
11787,12340,1862,4914,3653,1422,489,1082,567,467,38,18,411,100,68,68,0,0,32,0,28,4,515,413,160,44,209,102,53,28,25,0,49,0,49,0,36575
11788,2744,184,948,937,481,194,238,156,53,0,19,34,103,18,0,16,2,85,0,85,0,82,82,79,0,3,0,0,0,0,0,0,0,0,0,36576
11789,1025,130,436,263,170,26,65,46,46,0,0,46,0,0,0,0,0,0,0,0,0,19,19,11,0,8,0,0,0,0,0,0,0,0,0,36578
11790,1022,183,221,320,87,211,118,69,69,0,0,69,0,0,0,0,0,0,0,0,0,49,49,49,0,0,0,0,0,0,0,0,0,0,0,36579
11791,4370,945,1600,1329,377,119,266,118,46,0,0,46,72,66,24,0,42,6,0,6,0,148,56,13,0,43,92,73,20,0,53,19,19,0,0,36580
11792,163,0,112,13,22,16,95,95,95,0,80,15,0,0,0,0,0,0,0,0,0,0,0,0,0,0,0,0,0,0,0,0,0,0,0,36581
11793,16289,3256,6003,5070,1345,615,1628,864,714,45,39,630,150,92,64,28,0,58,29,15,14,764,558,108,26,424,206,120,31,20,69,86,25,0,61,36582
11794,497,225,203,62,7,0,13,13,13,0,0,13,0,0,0,0,0,0,0,0,0,0,0,0,0,0,0,0,0,0,0,0,0,0,0,36583
11795,597,159,257,130,39,12,26,6,0,0,0,0,6,6,0,0,6,0,0,0,0,20,20,0,0,20,0,0,0,0,0,0,0,0,0,36584
11796,727,112,382,179,46,8,67,50,50,0,4,46,0,0,0,0,0,0,0,0,0,17,10,0,10,0,7,7,0,7,0,0,0,0,0,36585
11797,7445,1876,2800,1890,772,107,761,342,153,25,65,63,189,15,0,15,0,174,0,113,61,419,353,62,49,242,66,43,43,0,0,23,0,11,12,36587
11798,0,0,0,0,0,0,0,0,0,0,0,0,0,0,0,0,0,0,0,0,0,0,0,0,0,0,0,0,0,0,0,0,0,0,0,36590
11799,575,99,124,167,108,77,12,0,0,0,0,0,0,0,0,0,0,0,0,0,0,12,12,0,0,12,0,0,0,0,0,0,0,0,0,36602
11800,7801,2274,2573,2262,461,231,453,305,199,25,15,159,106,31,20,0,11,75,0,0,75,148,104,3,12,89,44,32,22,0,10,12,0,0,12,36603
11801,7087,816,1658,1921,1623,1069,479,223,157,46,36,75,66,16,12,0,4,50,0,0,50,256,190,27,0,163,66,10,0,10,0,56,24,0,32,36604
11802,17862,3659,6786,5460,1385,572,1972,1152,917,71,67,779,235,135,25,76,34,100,10,0,90,820,604,143,43,418,216,97,31,35,31,119,33,5,81,36605
11803,12529,1455,3475,4648,1952,999,1106,512,304,68,80,156,208,80,12,4,64,128,35,53,40,594,536,38,75,423,58,58,5,53,0,0,0,0,0,36606
11804,5014,935,1678,1181,795,425,397,184,114,17,0,97,70,54,0,52,2,16,0,0,16,213,165,34,43,88,48,48,17,18,13,0,0,0,0,36607
11805,23053,2159,5408,7000,5495,2991,2153,885,792,124,85,583,93,25,16,6,3,68,0,19,49,1268,1117,297,78,742,151,81,30,26,25,70,0,70,0,36608
11806,14635,1081,4124,4853,3107,1470,1256,490,413,25,13,375,77,72,61,11,0,5,0,0,5,766,594,327,41,226,172,28,19,9,0,144,0,0,144,36609
11807,7923,2276,3055,2011,410,171,778,353,290,23,29,238,63,5,5,0,0,58,0,5,53,425,335,28,14,293,90,90,32,12,46,0,0,0,0,36610
11808,3797,741,1420,1143,288,205,360,165,138,52,27,59,27,0,0,0,0,27,0,0,27,195,141,34,0,107,54,48,0,4,44,6,0,0,6,36611
11809,3103,736,1209,893,144,121,434,187,187,37,15,135,0,0,0,0,0,0,0,0,0,247,225,14,7,204,22,22,0,0,22,0,0,0,0,36612
11810,8678,1613,3512,2495,628,430,809,453,378,27,43,308,75,43,19,24,0,32,0,0,32,356,278,74,8,196,78,33,0,0,33,45,0,45,0,36613
11811,234,45,68,109,12,0,0,0,0,0,0,0,0,0,0,0,0,0,0,0,0,0,0,0,0,0,0,0,0,0,0,0,0,0,0,36615
11812,0,0,0,0,0,0,0,0,0,0,0,0,0,0,0,0,0,0,0,0,0,0,0,0,0,0,0,0,0,0,0,0,0,0,0,36616
11813,8774,2079,2814,2924,584,373,851,604,396,41,32,323,208,98,23,21,54,110,0,28,82,247,247,44,50,153,0,0,0,0,0,0,0,0,0,36617
11814,10756,1096,3865,3646,1577,572,1194,593,454,65,40,349,139,133,18,27,88,6,0,0,6,601,474,75,41,358,127,0,0,0,0,127,22,39,66,36618
11815,10375,1745,3710,3140,1280,500,635,336,297,54,10,233,39,13,4,8,1,26,0,10,16,299,182,67,0,115,117,75,58,17,0,42,15,0,27,36619
11816,16,0,1,6,9,0,267,122,122,16,31,75,0,0,0,0,0,0,0,0,0,145,145,7,18,120,0,0,0,0,0,0,0,0,0,36688
11817,12675,1093,3411,4121,2547,1503,731,365,281,85,0,196,84,76,36,13,27,8,0,0,8,366,317,94,37,186,49,49,49,0,0,0,0,0,0,36693
11818,30672,2058,7350,9652,7248,4364,2637,1359,1196,262,111,823,163,83,44,26,13,80,65,0,15,1278,1047,294,59,694,231,167,153,14,0,64,18,16,30,36695
11819,15215,2704,5170,4460,1744,1137,1085,491,380,78,36,266,111,95,84,0,11,16,0,16,0,594,529,30,107,392,65,59,10,32,17,6,0,0,6,36701
11820,8672,2359,3191,2391,485,246,905,351,311,12,39,260,40,21,0,13,8,19,13,0,6,554,511,36,100,375,43,30,0,30,0,13,0,13,0,36703
11821,352,212,90,21,29,0,40,32,4,0,4,0,28,28,0,0,28,0,0,0,0,8,8,0,0,8,0,0,0,0,0,0,0,0,0,36720
11822,412,84,171,132,25,0,54,54,25,0,0,25,29,29,0,0,29,0,0,0,0,0,0,0,0,0,0,0,0,0,0,0,0,0,0,36722
11823,88,45,15,14,14,0,11,4,4,0,0,4,0,0,0,0,0,0,0,0,0,7,0,0,0,0,7,0,0,0,0,7,7,0,0,36723
11824,3396,745,1531,713,301,106,450,192,157,40,0,117,35,7,0,0,7,28,10,0,18,258,200,0,7,193,58,39,0,0,39,19,0,19,0,36726
11825,91,23,51,17,0,0,0,0,0,0,0,0,0,0,0,0,0,0,0,0,0,0,0,0,0,0,0,0,0,0,0,0,0,0,0,36727
11826,299,140,97,14,48,0,12,6,6,0,0,6,0,0,0,0,0,0,0,0,0,6,6,0,0,6,0,0,0,0,0,0,0,0,0,36728
11827,5053,584,1804,1437,684,544,418,198,123,25,0,98,75,75,35,25,15,0,0,0,0,220,220,69,0,151,0,0,0,0,0,0,0,0,0,36732
11828,1123,423,498,154,42,6,143,91,42,0,0,42,49,49,29,20,0,0,0,0,0,52,52,11,0,41,0,0,0,0,0,0,0,0,0,36736
11829,636,64,281,143,107,41,71,60,53,0,0,53,7,0,0,0,0,7,0,0,7,11,11,0,0,11,0,0,0,0,0,0,0,0,0,36738
11830,1035,237,497,197,66,38,165,33,33,0,26,7,0,0,0,0,0,0,0,0,0,132,132,0,40,92,0,0,0,0,0,0,0,0,0,36740
11831,1181,221,504,330,62,64,131,20,20,10,0,10,0,0,0,0,0,0,0,0,0,111,111,8,14,89,0,0,0,0,0,0,0,0,0,36742
11832,4773,1073,2102,1124,342,132,433,205,154,36,6,112,51,27,27,0,0,24,0,0,24,228,226,110,28,88,2,2,0,0,2,0,0,0,0,36744
11833,2334,358,855,673,334,114,110,81,76,21,6,49,5,0,0,0,0,5,0,0,5,29,20,0,0,20,9,9,0,9,0,0,0,0,0,36748
11834,706,150,208,303,32,13,65,0,0,0,0,0,0,0,0,0,0,0,0,0,0,65,47,0,14,33,18,18,0,0,18,0,0,0,0,36749
11835,1981,505,835,501,53,87,209,137,123,4,9,110,14,14,8,6,0,0,0,0,0,72,72,31,7,34,0,0,0,0,0,0,0,0,0,36750
11836,521,219,219,71,12,0,42,15,7,0,0,7,8,8,0,0,8,0,0,0,0,27,27,0,9,18,0,0,0,0,0,0,0,0,0,36751
11837,1156,250,285,266,294,61,207,104,83,0,11,72,21,21,4,0,17,0,0,0,0,103,103,5,0,98,0,0,0,0,0,0,0,0,0,36752
11838,42,32,10,0,0,0,0,0,0,0,0,0,0,0,0,0,0,0,0,0,0,0,0,0,0,0,0,0,0,0,0,0,0,0,0,36753
11839,347,35,240,61,0,11,15,15,14,4,0,10,1,1,0,0,1,0,0,0,0,0,0,0,0,0,0,0,0,0,0,0,0,0,0,36754
11840,4017,1065,1584,913,249,206,706,314,205,17,11,177,109,29,15,0,14,80,0,0,80,392,267,65,0,202,125,70,0,0,70,55,0,0,55,36756
11841,1182,362,539,171,70,40,101,80,80,10,0,70,0,0,0,0,0,0,0,0,0,21,21,0,15,6,0,0,0,0,0,0,0,0,0,36758
11842,973,340,340,207,74,12,51,38,38,0,0,38,0,0,0,0,0,0,0,0,0,13,1,0,0,1,12,0,0,0,0,12,0,0,12,36759
11843,739,149,406,102,56,26,28,22,22,0,0,22,0,0,0,0,0,0,0,0,0,6,0,0,0,0,6,6,0,0,6,0,0,0,0,36761
11844,146,40,56,23,25,2,11,4,4,0,2,2,0,0,0,0,0,0,0,0,0,7,7,0,0,7,0,0,0,0,0,0,0,0,0,36763
11845,1015,302,496,131,75,11,64,18,11,0,1,10,7,7,0,7,0,0,0,0,0,46,8,6,0,2,38,0,0,0,0,38,38,0,0,36765
11846,22,0,4,0,16,2,4,0,0,0,0,0,0,0,0,0,0,0,0,0,0,4,4,4,0,0,0,0,0,0,0,0,0,0,0,36766
11847,1080,313,419,249,61,38,143,51,51,0,29,22,0,0,0,0,0,0,0,0,0,92,76,0,16,60,16,0,0,0,0,16,0,16,0,36767
11848,623,136,338,101,37,11,43,5,5,0,0,5,0,0,0,0,0,0,0,0,0,38,38,0,7,31,0,0,0,0,0,0,0,0,0,36768
11849,1688,227,773,480,134,74,117,34,34,0,9,25,0,0,0,0,0,0,0,0,0,83,68,0,0,68,15,15,0,13,2,0,0,0,0,36769
11850,633,259,214,125,35,0,98,31,31,0,0,31,0,0,0,0,0,0,0,0,0,67,67,0,0,67,0,0,0,0,0,0,0,0,0,36773
11851,568,192,266,69,36,5,33,18,9,0,0,9,9,9,0,0,9,0,0,0,0,15,9,9,0,0,6,6,0,0,6,0,0,0,0,36775
11852,948,233,439,181,67,28,99,63,20,0,0,20,43,43,0,35,8,0,0,0,0,36,36,0,15,21,0,0,0,0,0,0,0,0,0,36776
11853,2008,236,921,602,204,45,201,134,103,6,0,97,31,31,31,0,0,0,0,0,0,67,67,2,44,21,0,0,0,0,0,0,0,0,0,36782
11854,519,97,251,111,38,22,29,26,10,0,0,10,16,16,16,0,0,0,0,0,0,3,2,0,0,2,1,1,0,1,0,0,0,0,0,36783
11855,5305,1185,1880,1529,408,303,412,192,166,4,6,156,26,0,0,0,0,26,6,0,20,220,220,34,0,186,0,0,0,0,0,0,0,0,0,36784
11856,1065,198,379,359,102,27,51,22,22,0,0,22,0,0,0,0,0,0,0,0,0,29,18,0,0,18,11,11,11,0,0,0,0,0,0,36785
11857,1894,726,617,326,165,60,225,149,131,21,13,97,18,18,13,0,5,0,0,0,0,76,60,0,19,41,16,0,0,0,0,16,0,16,0,36786
11858,61,10,30,11,10,0,0,0,0,0,0,0,0,0,0,0,0,0,0,0,0,0,0,0,0,0,0,0,0,0,0,0,0,0,0,36790
11859,825,133,444,248,0,0,107,74,26,0,0,26,48,48,48,0,0,0,0,0,0,33,0,0,0,0,33,33,0,0,33,0,0,0,0,36792
11860,510,139,229,117,14,11,0,0,0,0,0,0,0,0,0,0,0,0,0,0,0,0,0,0,0,0,0,0,0,0,0,0,0,0,0,36793
11861,15457,2976,4242,4302,2420,1517,1350,815,745,164,35,546,70,64,38,8,18,6,0,0,6,535,443,94,62,287,92,24,6,3,15,68,18,7,43,36801
11862,11980,1932,4632,3299,1170,947,849,383,293,133,0,160,90,31,12,0,19,59,41,0,18,466,435,91,44,300,31,8,0,0,8,23,0,23,0,36804
11863,19308,1152,2669,3789,5983,5715,2376,1434,1265,151,118,996,169,169,153,16,0,0,0,0,0,942,895,96,79,720,47,10,10,0,0,37,0,6,31,36830
11864,8499,1072,1555,2222,1985,1665,2644,1554,1449,300,23,1126,105,85,42,0,43,20,11,9,0,1090,968,270,49,649,122,97,59,18,20,25,0,23,2,36832
11865,0,0,0,0,0,0,2454,675,675,28,39,608,0,0,0,0,0,0,0,0,0,1779,1779,126,79,1574,0,0,0,0,0,0,0,0,0,36849
11866,1817,409,758,445,146,59,166,84,54,12,0,42,30,26,19,0,7,4,0,4,0,82,77,17,3,57,5,5,0,0,5,0,0,0,0,36850
11867,1422,337,465,483,93,44,91,55,3,3,0,0,52,41,0,41,0,11,11,0,0,36,36,0,27,9,0,0,0,0,0,0,0,0,0,36852
11868,6326,1183,1946,1593,880,724,390,194,161,7,30,124,33,0,0,0,0,33,0,15,18,196,116,20,36,60,80,19,15,4,0,61,22,0,39,36853
11869,10118,2074,3465,3042,1166,371,727,413,281,93,13,175,132,87,36,9,42,45,36,0,9,314,264,81,0,183,50,11,0,0,11,39,13,13,13,36854
11870,1253,393,536,224,57,43,35,10,3,0,0,3,7,7,0,7,0,0,0,0,0,25,25,0,0,25,0,0,0,0,0,0,0,0,0,36855
11871,3315,536,697,1313,613,156,143,57,57,0,0,57,0,0,0,0,0,0,0,0,0,86,71,0,0,71,15,15,0,0,15,0,0,0,0,36856
11872,355,55,166,42,74,18,11,11,11,11,0,0,0,0,0,0,0,0,0,0,0,0,0,0,0,0,0,0,0,0,0,0,0,0,0,36858
11873,38,0,5,0,13,20,0,0,0,0,0,0,0,0,0,0,0,0,0,0,0,0,0,0,0,0,0,0,0,0,0,0,0,0,0,36859
11874,937,363,347,165,62,0,86,70,46,24,0,22,24,24,0,22,2,0,0,0,0,16,3,0,0,3,13,0,0,0,0,13,0,0,13,36860
11875,2294,446,822,706,235,85,144,98,83,7,0,76,15,15,0,15,0,0,0,0,0,46,35,4,0,31,11,0,0,0,0,11,0,11,0,36861
11876,4538,1224,1534,1134,424,222,224,103,97,0,0,97,6,3,0,0,3,3,0,0,3,121,104,17,19,68,17,17,0,17,0,0,0,0,0,36862
11877,8266,2126,2958,2370,524,288,681,440,235,56,7,172,205,111,9,102,0,94,49,0,45,241,129,4,9,116,112,98,14,61,23,14,0,0,14,36863
11878,20,0,19,0,1,0,0,0,0,0,0,0,0,0,0,0,0,0,0,0,0,0,0,0,0,0,0,0,0,0,0,0,0,0,0,36865
11879,2503,526,919,702,268,88,179,120,111,14,52,45,9,6,6,0,0,3,0,3,0,59,59,5,0,54,0,0,0,0,0,0,0,0,0,36866
11880,13839,2073,3990,4778,2014,984,1348,701,556,136,41,379,145,69,23,19,27,76,58,18,0,647,542,67,101,374,105,44,7,8,29,61,0,0,61,36867
11881,12363,2793,4070,3918,1068,514,1028,561,404,6,54,344,157,29,0,19,10,128,0,0,128,467,317,32,77,208,150,91,78,13,0,59,0,9,50,36869
11882,11221,1380,3572,3800,1663,806,833,436,352,26,24,302,84,41,23,0,18,43,0,21,22,397,324,65,3,256,73,46,11,9,26,27,0,13,14,36870
11883,942,207,366,324,21,24,0,0,0,0,0,0,0,0,0,0,0,0,0,0,0,0,0,0,0,0,0,0,0,0,0,0,0,0,0,36871
11884,5953,1274,2286,1666,452,275,355,205,124,37,36,51,81,0,0,0,0,81,0,75,6,150,119,51,44,24,31,31,0,0,31,0,0,0,0,36874
11885,3513,584,1348,1128,319,134,361,128,103,48,0,55,25,25,0,9,16,0,0,0,0,233,222,72,8,142,11,11,11,0,0,0,0,0,0,36875
11886,7662,1121,2649,2695,922,275,583,237,237,71,12,154,0,0,0,0,0,0,0,0,0,346,295,34,19,242,51,0,0,0,0,51,0,51,0,36877
11887,1735,362,497,351,283,242,101,29,29,0,0,29,0,0,0,0,0,0,0,0,0,72,72,18,0,54,0,0,0,0,0,0,0,0,0,36879
11888,306,63,111,124,8,0,0,0,0,0,0,0,0,0,0,0,0,0,0,0,0,0,0,0,0,0,0,0,0,0,0,0,0,0,0,36901
11889,2861,575,867,889,374,156,297,111,87,10,0,77,24,9,0,3,6,15,0,15,0,186,166,0,66,100,20,20,20,0,0,0,0,0,0,36904
11890,1319,273,646,222,148,30,162,47,33,4,0,29,14,11,0,11,0,3,0,3,0,115,115,0,91,24,0,0,0,0,0,0,0,0,0,36907
11891,1629,377,627,497,83,45,215,165,165,98,0,67,0,0,0,0,0,0,0,0,0,50,50,7,0,43,0,0,0,0,0,0,0,0,0,36908
11892,26,26,0,0,0,0,0,0,0,0,0,0,0,0,0,0,0,0,0,0,0,0,0,0,0,0,0,0,0,0,0,0,0,0,0,36910
11893,1214,333,488,311,65,17,92,53,47,0,0,47,6,0,0,0,0,6,0,0,6,39,39,1,2,36,0,0,0,0,0,0,0,0,0,36912
11894,118,84,24,10,0,0,0,0,0,0,0,0,0,0,0,0,0,0,0,0,0,0,0,0,0,0,0,0,0,0,0,0,0,0,0,36913
11895,402,94,223,39,16,30,0,0,0,0,0,0,0,0,0,0,0,0,0,0,0,0,0,0,0,0,0,0,0,0,0,0,0,0,0,36915
11896,436,96,194,106,37,3,26,22,21,10,0,11,1,1,1,0,0,0,0,0,0,4,4,0,0,4,0,0,0,0,0,0,0,0,0,36916
11897,1437,355,640,323,69,50,83,32,28,12,2,14,4,1,0,1,0,3,0,0,3,51,51,3,0,48,0,0,0,0,0,0,0,0,0,36919
11898,904,251,375,200,41,37,16,3,3,0,0,3,0,0,0,0,0,0,0,0,0,13,13,4,0,9,0,0,0,0,0,0,0,0,0,36921
11899,432,146,132,104,21,29,91,76,30,0,22,8,46,18,18,0,0,28,0,28,0,15,15,0,0,15,0,0,0,0,0,0,0,0,0,36922
11900,2334,531,832,567,248,156,98,80,74,0,37,37,6,0,0,0,0,6,6,0,0,18,10,4,0,6,8,8,0,4,4,0,0,0,0,36925
11901,3589,282,821,1133,872,481,328,230,218,14,11,193,12,10,3,0,7,2,0,0,2,98,95,6,0,89,3,3,3,0,0,0,0,0,0,37010
11902,1717,259,930,443,59,26,100,45,43,0,8,35,2,2,2,0,0,0,0,0,0,55,55,2,12,41,0,0,0,0,0,0,0,0,0,37012
11903,52709,5697,13529,17032,11948,4503,4098,2062,1597,390,217,990,465,404,272,99,33,61,32,0,29,2036,1603,501,95,1007,433,405,190,191,24,28,2,9,17,37013
11904,1529,104,508,423,339,155,53,28,28,15,0,13,0,0,0,0,0,0,0,0,0,25,25,0,7,18,0,0,0,0,0,0,0,0,0,37014
11905,11948,2198,4862,3074,1400,414,875,386,311,58,45,208,75,71,51,20,0,4,0,4,0,489,409,79,33,297,80,59,44,0,15,21,21,0,0,37015
11906,792,112,344,273,48,15,144,55,55,29,9,17,0,0,0,0,0,0,0,0,0,89,89,0,0,89,0,0,0,0,0,0,0,0,0,37016
11907,1082,140,519,271,70,82,57,30,25,0,0,25,5,5,5,0,0,0,0,0,0,27,22,4,14,4,5,5,0,0,5,0,0,0,0,37018
11908,534,103,258,88,58,27,42,28,20,0,0,20,8,8,8,0,0,0,0,0,0,14,14,0,8,6,0,0,0,0,0,0,0,0,0,37019
11909,3291,341,1319,895,473,263,304,147,137,31,0,106,10,10,10,0,0,0,0,0,0,157,135,42,0,93,22,22,0,1,21,0,0,0,0,37020
11910,4472,1107,1835,1156,237,137,231,135,48,0,13,35,87,87,23,64,0,0,0,0,0,96,89,17,0,72,7,0,0,0,0,7,0,0,7,37022
11911,1098,202,400,432,26,38,106,55,40,29,11,0,15,15,0,0,15,0,0,0,0,51,51,19,0,32,0,0,0,0,0,0,0,0,0,37023
11912,3911,873,1804,806,330,98,302,159,72,22,19,31,87,87,68,19,0,0,0,0,0,143,123,0,26,97,20,0,0,0,0,20,0,0,20,37025
11913,1473,470,547,367,89,0,118,64,43,10,0,33,21,21,0,21,0,0,0,0,0,54,54,0,0,54,0,0,0,0,0,0,0,0,0,37026
11914,33932,743,3423,7202,13960,8604,3218,1628,1546,313,53,1180,82,66,35,0,31,16,0,0,16,1590,1490,512,31,947,100,100,78,22,0,0,0,0,0,37027
11915,454,58,110,227,28,31,0,0,0,0,0,0,0,0,0,0,0,0,0,0,0,0,0,0,0,0,0,0,0,0,0,0,0,0,0,37028
11916,3642,354,1251,1128,488,421,163,64,56,15,5,36,8,8,8,0,0,0,0,0,0,99,95,33,0,62,4,4,4,0,0,0,0,0,0,37029
11917,4676,1019,1995,1151,368,143,305,120,97,3,45,49,23,23,5,3,15,0,0,0,0,185,137,4,15,118,48,48,19,18,11,0,0,0,0,37030
11918,2731,393,1142,817,271,108,222,149,111,0,58,53,38,38,0,38,0,0,0,0,0,73,43,0,0,43,30,30,30,0,0,0,0,0,0,37031
11919,3058,493,1347,689,256,273,162,28,6,4,0,2,22,20,3,0,17,2,0,0,2,134,89,14,0,75,45,0,0,0,0,45,0,9,36,37032
11920,5669,1146,2095,1365,624,439,459,252,252,22,58,172,0,0,0,0,0,0,0,0,0,207,155,0,5,150,52,52,0,0,52,0,0,0,0,37033
11921,4757,603,1934,1345,680,195,371,160,119,13,28,78,41,41,23,18,0,0,0,0,0,211,184,61,0,123,27,27,27,0,0,0,0,0,0,37034
11922,2197,463,953,401,245,135,271,177,135,0,27,108,42,33,33,0,0,9,0,9,0,94,94,10,32,52,0,0,0,0,0,0,0,0,0,37035
11923,3735,867,1742,733,268,125,265,165,79,37,0,42,86,86,38,48,0,0,0,0,0,100,65,18,10,37,35,32,2,19,11,3,0,3,0,37036
11924,3860,279,1403,1370,563,245,440,151,121,26,0,95,30,30,30,0,0,0,0,0,0,289,272,84,0,188,17,8,8,0,0,9,0,9,0,37037
11925,26021,2991,7749,9218,4049,2014,3100,1422,947,261,141,545,475,432,139,131,162,43,5,4,34,1678,1406,346,55,1005,272,255,220,22,13,17,9,0,8,37040
11926,38723,3508,12613,15476,5389,1737,3520,1678,1282,156,139,987,396,384,101,235,48,12,12,0,0,1842,1428,355,147,926,414,330,109,86,135,84,41,23,20,37042
11927,28381,1940,8600,8923,5744,3174,2084,1044,921,195,41,685,123,119,18,70,31,4,0,0,4,1040,913,318,43,552,127,127,63,0,64,0,0,0,0,37043
11928,2937,416,1024,834,455,208,284,131,72,25,0,47,59,59,26,0,33,0,0,0,0,153,153,53,0,100,0,0,0,0,0,0,0,0,0,37046
11929,1624,284,617,539,124,60,117,40,40,8,2,30,0,0,0,0,0,0,0,0,0,77,71,7,9,55,6,6,3,3,0,0,0,0,0,37047
11930,4285,480,1601,1268,603,333,528,212,210,21,17,172,2,2,2,0,0,0,0,0,0,316,278,56,0,222,38,38,11,27,0,0,0,0,0,37048
11931,2052,338,775,656,191,92,129,34,24,7,0,17,10,10,10,0,0,0,0,0,0,95,93,6,3,84,2,2,2,0,0,0,0,0,0,37049
11932,1284,216,510,356,135,67,179,120,102,27,0,75,18,18,0,0,18,0,0,0,0,59,45,4,0,41,14,14,14,0,0,0,0,0,0,37050
11933,2647,497,1093,696,296,65,133,81,63,12,0,51,18,18,0,18,0,0,0,0,0,52,44,21,1,22,8,8,8,0,0,0,0,0,0,37051
11934,1745,297,862,416,78,92,106,94,82,25,29,28,12,12,12,0,0,0,0,0,0,12,12,0,0,12,0,0,0,0,0,0,0,0,0,37052
11935,18709,2641,8586,4762,1676,1044,1412,649,526,116,44,366,123,80,15,6,59,43,43,0,0,763,731,219,45,467,32,19,15,0,4,13,0,6,7,37055
11936,764,164,344,194,62,0,137,71,71,45,0,26,0,0,0,0,0,0,0,0,0,66,66,14,17,35,0,0,0,0,0,0,0,0,0,37057
11937,5142,789,2213,1402,444,294,324,173,161,31,22,108,12,12,7,4,1,0,0,0,0,151,141,70,25,46,10,10,7,3,0,0,0,0,0,37058
11938,879,159,455,156,70,39,120,62,37,26,0,11,25,17,0,0,17,8,8,0,0,58,13,0,3,10,45,45,0,0,45,0,0,0,0,37059
11939,1713,400,671,350,252,40,50,20,9,2,0,7,11,11,11,0,0,0,0,0,0,30,11,0,0,11,19,16,16,0,0,3,0,0,3,37060
11940,3461,717,1596,795,275,78,277,135,104,21,0,83,31,31,0,19,12,0,0,0,0,142,136,15,0,121,6,4,0,0,4,2,0,2,0,37061
11941,7100,963,2353,1937,1304,543,386,204,194,74,0,120,10,0,0,0,0,10,0,10,0,182,168,64,22,82,14,14,14,0,0,0,0,0,0,37062
11942,33920,3060,5987,8528,11285,5060,2445,1329,1090,451,56,583,239,224,160,15,49,15,0,0,15,1116,1024,298,95,631,92,59,59,0,0,33,0,0,33,37064
11943,29456,4256,9083,9802,4325,1990,1808,1082,855,291,115,449,227,132,87,20,25,95,9,0,86,726,697,246,27,424,29,29,25,0,4,0,0,0,0,37066
11944,16159,388,2262,3600,6113,3796,1179,441,441,198,0,243,0,0,0,0,0,0,0,0,0,738,708,183,23,502,30,15,15,0,0,15,0,0,15,37067
11945,12231,220,1121,3018,5072,2800,1363,871,778,61,50,667,93,93,78,15,0,0,0,0,0,492,468,210,13,245,24,24,0,0,24,0,0,0,0,37069
11946,21170,3408,6694,5898,3317,1853,1478,775,618,235,34,349,157,137,121,0,16,20,5,0,15,703,576,132,72,372,127,68,21,47,0,59,0,24,35,37072
11947,9022,1062,3786,2567,1138,469,907,540,503,180,106,217,37,37,22,0,15,0,0,0,0,367,318,90,3,225,49,46,30,0,16,3,0,0,3,37073
11948,4616,1002,2224,848,240,302,452,233,210,63,19,128,23,8,0,8,0,15,15,0,0,219,185,33,43,109,34,33,17,0,16,1,0,0,1,37074
11949,40195,2979,11775,12635,8518,4288,3272,1497,1193,212,121,860,304,253,201,52,0,51,12,0,39,1775,1612,384,133,1095,163,163,138,10,15,0,0,0,0,37075
11950,25979,2300,7145,8552,5299,2683,1515,709,478,144,52,282,231,213,104,16,93,18,18,0,0,806,574,243,69,262,232,180,136,31,13,52,0,52,0,37076
11951,482,83,189,163,19,28,13,0,0,0,0,0,0,0,0,0,0,0,0,0,0,13,13,0,0,13,0,0,0,0,0,0,0,0,0,37078
11952,1404,194,598,439,88,85,101,50,50,15,0,35,0,0,0,0,0,0,0,0,0,51,51,0,0,51,0,0,0,0,0,0,0,0,0,37079
11953,5843,723,2419,1564,831,306,320,204,124,0,0,124,80,80,59,0,21,0,0,0,0,116,116,26,0,90,0,0,0,0,0,0,0,0,0,37080
11954,4306,337,1326,1635,717,291,223,103,103,10,3,90,0,0,0,0,0,0,0,0,0,120,120,59,0,61,0,0,0,0,0,0,0,0,0,37082
11955,9403,2140,4122,2285,471,385,617,360,306,76,36,194,54,0,0,0,0,54,23,0,31,257,194,33,31,130,63,28,28,0,0,35,0,0,35,37083
11956,2874,386,1032,722,590,144,258,103,103,0,0,103,0,0,0,0,0,0,0,0,0,155,140,51,14,75,15,0,0,0,0,15,0,0,15,37085
11957,19123,2825,7032,5985,2441,840,1727,1066,858,179,22,657,208,155,41,38,76,53,14,39,0,661,581,123,135,323,80,43,34,0,9,37,0,24,13,37086
11958,28107,4527,10928,6480,4061,2111,2191,1332,1143,249,209,685,189,170,131,34,5,19,0,0,19,859,738,285,42,411,121,97,97,0,0,24,16,0,8,37087
11959,9275,1303,3686,2509,1218,559,648,367,334,43,39,252,33,33,0,0,33,0,0,0,0,281,228,91,0,137,53,53,0,0,53,0,0,0,0,37090
11960,14076,2977,5684,3683,1222,510,1137,547,456,137,54,265,91,91,48,42,1,0,0,0,0,590,444,64,60,320,146,128,58,23,47,18,0,0,18,37091
11961,1198,200,611,160,179,48,56,33,33,1,0,32,0,0,0,0,0,0,0,0,0,23,22,1,0,21,1,0,0,0,0,1,0,1,0,37095
11962,3969,762,1816,815,395,181,254,125,101,11,1,89,24,17,0,0,17,7,7,0,0,129,129,22,17,90,0,0,0,0,0,0,0,0,0,37096
11963,1517,428,624,283,158,24,94,51,46,0,4,42,5,0,0,0,0,5,0,5,0,43,22,19,1,2,21,21,7,14,0,0,0,0,0,37097
11964,3062,711,1439,703,186,23,310,178,124,51,0,73,54,54,0,54,0,0,0,0,0,132,76,39,0,37,56,56,0,0,56,0,0,0,0,37098
11965,4336,933,1744,1165,367,127,330,221,145,53,14,78,76,31,0,31,0,45,0,41,4,109,109,40,0,69,0,0,0,0,0,0,0,0,0,37101
11966,22538,5545,9667,4726,1568,1032,1490,869,700,117,31,552,169,101,44,41,16,68,55,13,0,621,543,101,72,370,78,78,75,0,3,0,0,0,0,37110
11967,25071,4415,9028,7375,2815,1438,1753,965,636,91,52,493,329,207,142,35,30,122,20,20,82,788,617,57,118,442,171,146,108,10,28,25,0,25,0,37115
11968,961,93,212,306,300,50,167,71,40,6,0,34,31,31,0,0,31,0,0,0,0,96,96,17,37,42,0,0,0,0,0,0,0,0,0,37118
11969,32435,2241,8858,11073,7247,3016,2490,1177,1054,333,58,663,123,108,86,14,8,15,15,0,0,1313,1089,336,71,682,224,215,204,0,11,9,9,0,0,37122
11970,10302,1003,3025,3068,2156,1050,756,382,324,19,58,247,58,58,49,0,9,0,0,0,0,374,337,85,9,243,37,37,10,21,6,0,0,0,0,37127
11971,26148,1503,6055,8778,6942,2870,1677,894,772,106,175,491,122,81,27,54,0,41,0,0,41,783,645,165,58,422,138,138,90,0,48,0,0,0,0,37128
11972,32939,3199,8945,10204,7517,3074,2359,1221,969,219,74,676,252,186,86,49,51,66,0,8,58,1138,1021,363,97,561,117,58,16,14,28,59,21,0,38,37129
11973,29341,3721,8137,9132,5349,3002,3173,1581,1320,369,169,782,261,261,121,88,52,0,0,0,0,1592,1350,454,134,762,242,229,171,8,50,13,0,13,0,37130
11974,40,0,10,10,20,0,1871,843,843,237,64,542,0,0,0,0,0,0,0,0,0,1028,1028,118,119,791,0,0,0,0,0,0,0,0,0,37132
11975,1948,196,961,457,267,67,159,94,84,0,6,78,10,8,8,0,0,2,0,0,2,65,58,5,0,53,7,7,0,0,7,0,0,0,0,37134
11976,5895,186,1331,1416,2059,903,685,384,342,24,46,272,42,42,42,0,0,0,0,0,0,301,160,27,1,132,141,71,71,0,0,70,0,0,70,37135
11977,2170,663,808,521,107,71,157,90,86,0,4,82,4,0,0,0,0,4,0,4,0,67,58,0,0,58,9,9,0,0,9,0,0,0,0,37137
11978,15876,1773,4442,5170,3326,1165,870,453,441,145,46,250,12,0,0,0,0,12,0,12,0,417,379,120,14,245,38,38,38,0,0,0,0,0,0,37138
11979,1222,488,554,172,8,0,10,10,0,0,0,0,10,0,0,0,0,10,0,0,10,0,0,0,0,0,0,0,0,0,0,0,0,0,0,37140
11980,792,153,346,149,120,24,59,25,8,0,0,8,17,17,8,9,0,0,0,0,0,34,12,7,0,5,22,22,4,0,18,0,0,0,0,37141
11981,1445,266,774,309,65,31,128,115,33,0,0,33,82,40,40,0,0,42,42,0,0,13,13,0,13,0,0,0,0,0,0,0,0,0,0,37142
11982,2805,611,747,716,570,161,187,93,82,6,0,76,11,11,11,0,0,0,0,0,0,94,70,14,0,56,24,24,0,24,0,0,0,0,0,37143
11983,2523,638,1136,474,153,122,153,100,49,23,7,19,51,51,43,0,8,0,0,0,0,53,47,0,7,40,6,6,2,0,4,0,0,0,0,37144
11984,1488,283,708,400,59,38,99,72,63,5,13,45,9,9,9,0,0,0,0,0,0,27,27,0,7,20,0,0,0,0,0,0,0,0,0,37145
11985,4684,620,1617,1193,960,294,379,223,177,87,0,90,46,46,12,34,0,0,0,0,0,156,104,42,0,62,52,52,15,37,0,0,0,0,0,37146
11986,14701,2591,5406,4721,1395,588,1104,668,606,169,34,403,62,24,24,0,0,38,20,18,0,436,371,66,22,283,65,63,19,11,33,2,0,0,2,37148
11987,1650,235,680,312,328,95,117,63,63,15,0,48,0,0,0,0,0,0,0,0,0,54,29,7,0,22,25,25,25,0,0,0,0,0,0,37149
11988,3211,940,1420,512,172,167,306,195,127,56,16,55,68,0,0,0,0,68,0,68,0,111,108,13,0,95,3,0,0,0,0,3,3,0,0,37150
11989,340,47,153,68,33,39,43,36,36,0,0,36,0,0,0,0,0,0,0,0,0,7,0,0,0,0,7,7,7,0,0,0,0,0,0,37151
11990,3666,356,1132,1213,821,144,319,166,122,17,16,89,44,25,25,0,0,19,0,0,19,153,138,27,0,111,15,15,15,0,0,0,0,0,0,37153
11991,20766,5075,8796,4878,1403,614,1710,873,628,67,66,495,245,205,101,36,68,40,0,16,24,837,646,199,37,410,191,178,100,28,50,13,0,13,0,37160
11992,37,13,16,5,3,0,1,0,0,0,0,0,0,0,0,0,0,0,0,0,0,1,1,0,0,1,0,0,0,0,0,0,0,0,0,37165
11993,9261,2493,3512,2016,874,366,604,329,210,17,13,180,119,102,14,38,50,17,0,17,0,275,249,51,11,187,26,26,20,0,6,0,0,0,0,37166
11994,32316,3222,11051,10394,5877,1772,2800,1399,1090,331,145,614,309,235,133,30,72,74,15,18,41,1401,1247,338,63,846,154,99,11,24,64,55,37,18,0,37167
11995,449,107,284,42,0,16,0,0,0,0,0,0,0,0,0,0,0,0,0,0,0,0,0,0,0,0,0,0,0,0,0,0,0,0,0,37171
11996,18792,3206,7876,4987,1897,826,1477,871,653,75,85,493,218,203,92,0,111,15,9,0,6,606,444,153,32,259,162,111,63,31,17,51,20,31,0,37172
11997,18232,992,4957,6065,4511,1707,990,406,340,157,24,159,66,43,0,43,0,23,23,0,0,584,411,95,0,316,173,163,34,0,129,10,0,0,10,37174
11998,903,168,427,289,13,6,39,6,6,0,0,6,0,0,0,0,0,0,0,0,0,33,0,0,0,0,33,33,0,0,33,0,0,0,0,37175
11999,1538,253,744,377,100,64,91,63,53,0,0,53,10,10,4,0,6,0,0,0,0,28,24,9,2,13,4,4,0,0,4,0,0,0,0,37178
12000,6663,412,1536,1699,2188,828,489,355,355,170,26,159,0,0,0,0,0,0,0,0,0,134,134,69,11,54,0,0,0,0,0,0,0,0,0,37179
12001,2100,427,1011,447,128,87,120,39,39,21,0,18,0,0,0,0,0,0,0,0,0,81,67,9,0,58,14,14,0,14,0,0,0,0,0,37180
12002,1085,312,422,249,26,76,52,24,22,3,0,19,2,2,0,0,2,0,0,0,0,28,21,1,0,20,7,7,0,0,7,0,0,0,0,37181
12003,2371,429,1054,531,292,65,123,53,49,2,8,39,4,4,4,0,0,0,0,0,0,70,67,10,0,57,3,3,0,0,3,0,0,0,0,37183
12004,4429,864,1830,1183,411,141,296,152,119,21,0,98,33,33,20,13,0,0,0,0,0,144,122,32,0,90,22,0,0,0,0,22,0,22,0,37184
12005,6196,830,2857,1752,538,219,449,192,155,0,14,141,37,37,37,0,0,0,0,0,0,257,241,22,16,203,16,16,0,16,0,0,0,0,0,37185
12006,5790,1652,2713,1070,198,157,467,225,193,23,7,163,32,24,0,9,15,8,0,0,8,242,201,7,47,147,41,8,0,0,8,33,15,9,9,37186
12007,4548,846,2078,1196,314,114,560,395,364,33,47,284,31,31,12,0,19,0,0,0,0,165,148,56,20,72,17,17,0,0,17,0,0,0,0,37187
12008,9280,939,2968,3410,1460,503,796,320,277,65,5,207,43,43,43,0,0,0,0,0,0,476,453,141,43,269,23,23,23,0,0,0,0,0,0,37188
12009,2271,485,719,490,301,276,56,14,6,0,0,6,8,8,0,8,0,0,0,0,0,42,42,0,0,42,0,0,0,0,0,0,0,0,0,37189
12010,6388,1491,2691,1338,646,222,435,231,169,47,17,105,62,62,0,27,35,0,0,0,0,204,173,47,0,126,31,31,18,0,13,0,0,0,0,37190
12011,3036,280,1026,1208,365,157,253,94,84,0,0,84,10,10,0,0,10,0,0,0,0,159,159,85,33,41,0,0,0,0,0,0,0,0,0,37191
12012,1576,282,361,272,462,199,104,104,27,0,0,27,77,21,0,0,21,56,0,0,56,0,0,0,0,0,0,0,0,0,0,0,0,0,0,37201
12013,7414,1123,1759,1395,1860,1277,317,203,162,61,15,86,41,20,12,0,8,21,0,5,16,114,106,11,9,86,8,8,8,0,0,0,0,0,0,37203
12014,8680,414,1122,1783,3121,2240,1149,486,478,82,91,305,8,3,3,0,0,5,0,0,5,663,663,258,9,396,0,0,0,0,0,0,0,0,0,37204
12015,17463,465,1439,3339,6512,5708,1006,512,508,48,28,432,4,0,0,0,0,4,0,0,4,494,494,93,50,351,0,0,0,0,0,0,0,0,0,37205
12016,16588,2622,4364,3823,3633,2146,1339,709,588,141,64,383,121,69,30,34,5,52,0,0,52,630,475,65,0,410,155,144,99,42,3,11,0,0,11,37206
12017,21335,4629,6381,6716,2330,1279,1813,939,831,105,60,666,108,59,29,30,0,49,0,40,9,874,787,224,68,495,87,58,12,37,9,29,29,0,0,37207
12018,9385,2007,2937,2435,1230,776,1252,648,497,43,92,362,151,137,52,54,31,14,0,14,0,604,540,117,48,375,64,58,16,5,37,6,0,0,6,37208
12019,24300,4871,5951,5259,5218,3001,2428,940,783,66,15,702,157,109,70,8,31,48,32,0,16,1488,1352,328,84,940,136,91,76,10,5,45,0,0,45,37209
12020,8805,2362,2991,2001,1020,431,879,357,224,74,34,116,133,43,25,0,18,90,33,0,57,522,381,115,19,247,141,73,47,26,0,68,0,0,68,37210
12021,51059,10205,12514,12568,10565,5207,2786,1524,1092,180,86,826,432,229,89,56,84,203,94,7,102,1262,1123,161,158,804,139,97,59,27,11,42,3,28,11,37211
12022,9061,510,881,1138,3404,3128,3212,1527,1522,366,145,1011,5,0,0,0,0,5,0,0,5,1685,1645,525,39,1081,40,24,7,0,17,16,0,0,16,37212
12023,129,59,37,20,13,0,13,10,8,0,0,8,2,0,0,0,0,2,0,0,2,3,1,0,0,1,2,0,0,0,0,2,0,0,2,37213
12024,21559,2149,5777,6316,5222,2095,1291,801,728,283,55,390,73,73,18,6,49,0,0,0,0,490,331,59,47,225,159,137,88,30,19,22,0,22,0,37214
12025,15903,214,1227,2566,6062,5834,644,433,405,73,12,320,28,28,17,0,11,0,0,0,0,211,211,39,0,172,0,0,0,0,0,0,0,0,0,37215
12026,13360,2255,3929,3422,2676,1078,624,312,239,78,11,150,73,54,20,34,0,19,11,0,8,312,197,45,15,137,115,21,21,0,0,94,67,13,14,37216
12027,19171,3394,5221,5284,3757,1515,1130,541,348,36,31,281,193,142,109,33,0,51,19,0,32,589,485,167,122,196,104,84,50,0,34,20,0,12,8,37217
12028,10404,2110,3032,2922,1270,1070,721,359,289,22,100,167,70,11,5,0,6,59,0,12,47,362,272,80,0,192,90,55,18,0,37,35,0,0,35,37218
12029,1102,44,113,333,380,232,17,8,8,0,0,8,0,0,0,0,0,0,0,0,0,9,9,9,0,0,0,0,0,0,0,0,0,0,0,37219
12030,4241,47,634,556,1699,1305,170,101,93,26,0,67,8,8,0,0,8,0,0,0,0,69,69,0,0,69,0,0,0,0,0,0,0,0,0,37220
12031,27991,1205,4337,7513,9132,5804,1456,628,492,110,94,288,136,136,43,0,93,0,0,0,0,828,795,228,58,509,33,33,13,20,0,0,0,0,0,37221
12032,796,80,187,212,151,166,86,14,4,2,0,2,10,10,0,0,10,0,0,0,0,72,68,5,0,63,4,4,0,0,4,0,0,0,0,37228
12033,14,0,0,8,6,0,306,171,171,36,14,121,0,0,0,0,0,0,0,0,0,135,135,21,0,114,0,0,0,0,0,0,0,0,0,37240
12034,0,0,0,0,0,0,0,0,0,0,0,0,0,0,0,0,0,0,0,0,0,0,0,0,0,0,0,0,0,0,0,0,0,0,0,37243
12035,0,0,0,0,0,0,0,0,0,0,0,0,0,0,0,0,0,0,0,0,0,0,0,0,0,0,0,0,0,0,0,0,0,0,0,37246
12036,982,300,505,126,42,9,66,41,26,5,0,21,15,7,7,0,0,8,4,0,4,25,14,6,8,0,11,11,11,0,0,0,0,0,0,37301
12037,2419,210,608,808,465,328,248,130,130,37,0,93,0,0,0,0,0,0,0,0,0,118,118,40,0,78,0,0,0,0,0,0,0,0,0,37302
12038,17212,3027,7012,4044,2024,1105,1583,649,470,133,53,284,179,143,114,3,26,36,0,0,36,934,741,237,44,460,193,127,32,0,95,66,0,0,66,37303
12039,693,336,257,52,42,6,80,53,32,0,0,32,21,18,8,0,10,3,0,0,3,27,19,0,1,18,8,8,0,0,8,0,0,0,0,37305
12040,1763,364,857,324,108,110,209,133,124,24,37,63,9,9,9,0,0,0,0,0,0,76,63,27,10,26,13,13,6,0,7,0,0,0,0,37306
12041,3705,828,1497,860,307,213,116,70,65,3,9,53,5,5,0,5,0,0,0,0,0,46,39,5,8,26,7,3,3,0,0,4,0,0,4,37307
12042,1698,475,630,462,122,9,126,48,48,15,12,21,0,0,0,0,0,0,0,0,0,78,74,4,0,70,4,4,0,0,4,0,0,0,0,37308
12043,1367,272,471,529,46,49,246,104,102,31,1,70,2,0,0,0,0,2,2,0,0,142,107,3,21,83,35,35,4,25,6,0,0,0,0,37309
12044,2661,413,1012,970,136,130,261,78,49,8,0,41,29,29,29,0,0,0,0,0,0,183,140,52,6,82,43,43,43,0,0,0,0,0,0,37310
12045,16370,3613,5350,4661,1798,948,2127,781,674,117,78,479,107,54,39,0,15,53,28,8,17,1346,1230,374,128,728,116,106,32,22,52,10,0,2,8,37311
12046,22264,2259,6273,7650,3708,2374,1552,833,712,84,45,583,121,121,62,27,32,0,0,0,0,719,600,164,31,405,119,112,11,8,93,7,0,0,7,37312
12047,935,327,353,144,59,52,38,16,16,7,0,9,0,0,0,0,0,0,0,0,0,22,11,0,0,11,11,0,0,0,0,11,0,0,11,37313
12048,54,0,8,2,0,44,616,272,272,138,0,134,0,0,0,0,0,0,0,0,0,344,344,169,30,145,0,0,0,0,0,0,0,0,0,37315
12049,2045,208,810,714,252,61,187,96,63,7,0,56,33,33,33,0,0,0,0,0,0,91,91,7,17,67,0,0,0,0,0,0,0,0,0,37317
12050,1061,222,457,281,73,28,53,37,30,7,0,23,7,7,7,0,0,0,0,0,0,16,0,0,0,0,16,13,0,13,0,3,0,0,3,37318
12051,12469,2935,4851,3048,1204,431,1174,607,479,118,24,337,128,76,53,0,23,52,0,39,13,567,433,76,99,258,134,119,67,52,0,15,0,0,15,37321
12052,5157,1247,2099,1405,267,139,202,91,69,9,5,55,22,22,22,0,0,0,0,0,0,111,106,32,7,67,5,5,5,0,0,0,0,0,0,37322
12053,21115,4641,8142,5768,1732,832,1306,726,570,178,45,347,156,146,38,88,20,10,0,0,10,580,516,135,28,353,64,46,31,6,9,18,0,18,0,37323
12054,3574,860,1476,839,261,138,272,179,176,11,32,133,3,3,0,3,0,0,0,0,0,93,86,10,0,76,7,7,7,0,0,0,0,0,0,37324
12055,1067,143,515,283,108,18,103,75,75,20,0,55,0,0,0,0,0,0,0,0,0,28,28,0,8,20,0,0,0,0,0,0,0,0,0,37325
12056,401,141,130,101,22,7,8,3,3,0,0,3,0,0,0,0,0,0,0,0,0,5,0,0,0,0,5,5,0,5,0,0,0,0,0,37326
12057,8019,1741,3176,2104,486,512,692,305,234,40,10,184,71,71,37,23,11,0,0,0,0,387,273,68,48,157,114,74,38,36,0,40,0,21,19,37327
12058,818,197,322,143,66,90,26,16,16,0,0,16,0,0,0,0,0,0,0,0,0,10,10,0,0,10,0,0,0,0,0,0,0,0,0,37328
12059,4365,1108,1772,990,303,192,335,171,114,22,50,42,57,19,2,0,17,38,0,0,38,164,148,61,0,87,16,16,4,0,12,0,0,0,0,37329
12060,5256,932,2022,1576,469,257,417,202,178,16,24,138,24,24,10,6,8,0,0,0,0,215,201,45,0,156,14,14,14,0,0,0,0,0,0,37330
12061,5651,1107,2170,1706,491,177,287,181,141,9,27,105,40,0,0,0,0,40,0,40,0,106,106,39,0,67,0,0,0,0,0,0,0,0,0,37331
12062,1860,544,774,375,77,90,157,68,59,22,0,37,9,9,0,9,0,0,0,0,0,89,60,0,0,60,29,29,11,0,18,0,0,0,0,37332
12063,432,125,199,90,18,0,43,43,43,40,0,3,0,0,0,0,0,0,0,0,0,0,0,0,0,0,0,0,0,0,0,0,0,0,0,37333
12064,14591,2827,5530,3757,1688,789,1019,540,410,33,46,331,130,106,58,18,30,24,0,14,10,479,432,138,34,260,47,26,24,0,2,21,10,0,11,37334
12065,1919,486,822,460,112,39,188,111,86,0,47,39,25,0,0,0,0,25,25,0,0,77,35,22,0,13,42,42,0,42,0,0,0,0,0,37335
12066,3444,618,1411,1099,232,84,326,133,111,67,0,44,22,22,22,0,0,0,0,0,0,193,163,109,6,48,30,0,0,0,0,30,0,0,30,37336
12067,819,412,288,115,4,0,44,32,26,0,8,18,6,0,0,0,0,6,0,6,0,12,12,12,0,0,0,0,0,0,0,0,0,0,0,37337
12068,1985,482,923,472,103,5,81,36,35,13,1,21,1,1,1,0,0,0,0,0,0,45,21,0,2,19,24,24,7,10,7,0,0,0,0,37338
12069,1179,361,494,235,47,42,126,78,73,18,0,55,5,5,5,0,0,0,0,0,0,48,43,11,0,32,5,5,5,0,0,0,0,0,0,37339
12070,377,74,139,120,36,8,10,0,0,0,0,0,0,0,0,0,0,0,0,0,0,10,10,0,10,0,0,0,0,0,0,0,0,0,0,37340
12071,9797,1115,3177,3613,1301,591,692,291,277,11,29,237,14,0,0,0,0,14,14,0,0,401,362,112,25,225,39,39,19,0,20,0,0,0,0,37341
12072,2072,489,848,360,259,116,142,63,63,0,0,63,0,0,0,0,0,0,0,0,0,79,79,14,0,65,0,0,0,0,0,0,0,0,0,37342
12073,30251,3258,8063,10147,5731,3052,1845,971,819,269,27,523,152,103,27,45,31,49,0,0,49,874,650,328,29,293,224,139,103,36,0,85,10,17,58,37343
12074,1620,599,655,256,91,19,77,34,26,7,0,19,8,5,4,0,1,3,0,3,0,43,34,7,0,27,9,5,0,5,0,4,0,0,4,37345
12075,4931,903,1927,1255,521,325,455,261,140,21,0,119,121,90,69,17,4,31,0,11,20,194,131,9,7,115,63,63,9,0,54,0,0,0,0,37347
12076,922,146,492,207,67,10,99,21,21,3,0,18,0,0,0,0,0,0,0,0,0,78,65,34,0,31,13,13,13,0,0,0,0,0,0,37348
12077,1280,10,56,186,606,422,90,34,34,0,6,28,0,0,0,0,0,0,0,0,0,56,56,16,0,40,0,0,0,0,0,0,0,0,0,37350
12078,425,111,215,88,11,0,15,0,0,0,0,0,0,0,0,0,0,0,0,0,0,15,11,11,0,0,4,0,0,0,0,4,0,4,0,37351
12079,2185,369,897,593,238,88,265,106,80,31,0,49,26,26,26,0,0,0,0,0,0,159,131,63,68,0,28,28,28,0,0,0,0,0,0,37352
12080,3221,744,1147,721,364,245,359,179,133,46,0,87,46,12,0,0,12,34,0,34,0,180,151,49,0,102,29,0,0,0,0,29,0,29,0,37353
12081,11476,2271,4672,3493,696,344,588,267,189,88,33,68,78,62,12,43,7,16,16,0,0,321,227,21,8,198,94,92,25,38,29,2,0,0,2,37354
12082,17298,3429,6829,4117,1941,982,1373,727,599,198,39,362,128,109,37,28,44,19,0,0,19,646,500,160,76,264,146,146,106,0,40,0,0,0,0,37355
12083,1646,344,610,313,245,134,104,12,5,0,0,5,7,0,0,0,0,7,0,0,7,92,76,23,0,53,16,7,7,0,0,9,0,9,0,37356
12084,3529,768,1445,681,453,182,225,139,104,0,0,104,35,29,29,0,0,6,0,6,0,86,47,20,23,4,39,39,0,0,39,0,0,0,0,37357
12085,525,76,208,162,46,33,56,48,48,16,0,32,0,0,0,0,0,0,0,0,0,8,8,0,0,8,0,0,0,0,0,0,0,0,0,37359
12086,1240,236,449,230,171,154,102,36,32,0,12,20,4,0,0,0,0,4,0,4,0,66,66,27,0,39,0,0,0,0,0,0,0,0,0,37360
12087,1153,314,460,185,89,105,114,36,36,0,21,15,0,0,0,0,0,0,0,0,0,78,78,0,0,78,0,0,0,0,0,0,0,0,0,37361
12088,1968,598,778,542,24,26,209,137,121,31,0,90,16,16,16,0,0,0,0,0,0,72,44,4,0,40,28,15,0,0,15,13,13,0,0,37362
12089,22813,2365,5042,7805,4765,2836,1529,694,581,184,30,367,113,86,64,0,22,27,8,0,19,835,808,370,99,339,27,27,27,0,0,0,0,0,0,37363
12090,950,272,501,155,22,0,101,64,59,19,6,34,5,5,5,0,0,0,0,0,0,37,30,12,5,13,7,7,0,0,7,0,0,0,0,37365
12091,637,91,346,124,61,15,21,0,0,0,0,0,0,0,0,0,0,0,0,0,0,21,17,10,0,7,4,4,4,0,0,0,0,0,0,37366
12092,7096,1788,3103,1437,469,299,465,271,198,44,8,146,73,19,0,0,19,54,0,31,23,194,163,34,14,115,31,24,11,0,13,7,0,0,7,37367
12093,505,210,181,63,47,4,0,0,0,0,0,0,0,0,0,0,0,0,0,0,0,0,0,0,0,0,0,0,0,0,0,0,0,0,0,37369
12094,3474,688,1583,889,248,66,180,49,36,16,0,20,13,13,0,13,0,0,0,0,0,131,97,35,20,42,34,34,0,0,34,0,0,0,0,37370
12095,2171,288,1114,657,90,22,273,202,175,49,7,119,27,27,27,0,0,0,0,0,0,71,71,12,23,36,0,0,0,0,0,0,0,0,0,37373
12096,1242,313,517,296,116,0,89,55,55,17,0,38,0,0,0,0,0,0,0,0,0,34,34,0,0,34,0,0,0,0,0,0,0,0,0,37374
12097,1908,161,459,270,384,634,805,409,409,84,48,277,0,0,0,0,0,0,0,0,0,396,396,94,25,277,0,0,0,0,0,0,0,0,0,37375
12098,348,132,146,70,0,0,35,35,11,0,0,11,24,24,24,0,0,0,0,0,0,0,0,0,0,0,0,0,0,0,0,0,0,0,0,37376
12099,10673,699,1773,2561,3350,2290,689,326,274,85,0,189,52,42,28,0,14,10,10,0,0,363,335,60,9,266,28,28,28,0,0,0,0,0,0,37377
12100,19076,2831,6681,5979,2394,1191,961,530,454,167,45,242,76,62,16,36,10,14,0,0,14,431,406,205,22,179,25,25,8,17,0,0,0,0,0,37379
12101,4311,943,1494,1213,437,224,319,174,145,24,0,121,29,18,0,0,18,11,6,0,5,145,117,24,1,92,28,28,4,24,0,0,0,0,0,37380
12102,6813,1234,2733,1955,520,371,394,200,113,0,12,101,87,63,49,5,9,24,0,24,0,194,94,0,10,84,100,86,0,0,86,14,0,0,14,37381
12103,5811,1359,2371,1381,427,273,495,319,291,83,16,192,28,28,6,22,0,0,0,0,0,176,160,64,0,96,16,0,0,0,0,16,0,11,5,37385
12104,2734,811,1024,561,162,176,147,78,65,13,30,22,13,8,8,0,0,5,0,0,5,69,60,42,0,18,9,9,2,0,7,0,0,0,0,37387
12105,17688,2467,6326,5243,2086,1566,1408,662,604,216,40,348,58,35,35,0,0,23,10,13,0,746,659,238,50,371,87,57,7,30,20,30,0,0,30,37388
12106,893,217,397,244,26,9,28,23,20,0,0,20,3,3,3,0,0,0,0,0,0,5,0,0,0,0,5,0,0,0,0,5,5,0,0,37391
12107,54,23,17,14,0,0,0,0,0,0,0,0,0,0,0,0,0,0,0,0,0,0,0,0,0,0,0,0,0,0,0,0,0,0,0,37394
12108,152,93,13,0,0,46,0,0,0,0,0,0,0,0,0,0,0,0,0,0,0,0,0,0,0,0,0,0,0,0,0,0,0,0,0,37396
12109,7630,2121,3004,1837,369,299,346,153,117,26,13,78,36,36,36,0,0,0,0,0,0,193,176,14,0,162,17,17,3,0,14,0,0,0,0,37397
12110,9994,2071,3267,2717,1318,621,602,261,224,31,7,186,37,37,6,0,31,0,0,0,0,341,248,50,6,192,93,93,16,67,10,0,0,0,0,37398
12111,2526,726,951,558,193,98,147,88,31,15,12,4,57,48,0,11,37,9,0,0,9,59,25,0,0,25,34,34,34,0,0,0,0,0,0,37402
12112,1747,160,392,295,569,331,1886,828,821,202,81,538,7,0,0,0,0,7,0,0,7,1058,1047,324,75,648,11,11,0,0,11,0,0,0,0,37403
12113,7943,1970,2665,2013,915,380,694,408,282,66,19,197,126,9,9,0,0,117,36,27,54,286,248,83,6,159,38,38,24,0,14,0,0,0,0,37404
12114,10844,1189,2210,2762,2765,1918,629,401,386,98,53,235,15,14,14,0,0,1,0,0,1,228,219,72,0,147,9,9,9,0,0,0,0,0,0,37405
12115,8673,2108,3349,2557,391,268,819,340,272,26,57,189,68,51,8,16,27,17,0,13,4,479,403,17,48,338,76,48,20,20,8,28,0,28,0,37406
12116,5288,2226,1671,1145,229,17,557,212,140,17,0,123,72,43,25,0,18,29,0,0,29,345,170,49,30,91,175,62,10,0,52,113,20,0,93,37407
12117,1001,330,284,153,146,88,143,72,49,0,0,49,23,23,23,0,0,0,0,0,0,71,61,8,34,19,10,10,10,0,0,0,0,0,0,37408
12118,2082,206,480,729,482,185,96,88,86,0,0,86,2,0,0,0,0,2,0,0,2,8,8,0,8,0,0,0,0,0,0,0,0,0,0,37409
12119,2193,644,816,639,83,11,347,243,197,0,57,140,46,30,0,30,0,16,0,0,16,104,79,58,0,21,25,25,0,0,25,0,0,0,0,37410
12120,12418,1915,3552,4021,1812,1118,655,335,221,53,25,143,114,97,55,42,0,17,0,0,17,320,257,93,30,134,63,63,30,20,13,0,0,0,0,37411
12121,14914,2113,4771,5076,2178,776,914,427,334,136,23,175,93,74,74,0,0,19,0,0,19,487,394,146,8,240,93,76,39,37,0,17,17,0,0,37412
12122,16755,1761,4584,5527,3331,1552,837,352,266,67,57,142,86,50,33,10,7,36,17,6,13,485,375,141,18,216,110,44,28,0,16,66,0,35,31,37415
12123,10302,1257,3165,3781,1348,751,811,308,261,41,37,183,47,13,0,0,13,34,0,0,34,503,482,233,58,191,21,21,20,0,1,0,0,0,0,37416
12124,4556,715,1295,1298,764,484,274,97,95,0,9,86,2,0,0,0,0,2,0,0,2,177,177,20,0,157,0,0,0,0,0,0,0,0,0,37419
12125,33382,3580,7652,10725,7324,4101,1971,946,726,232,63,431,220,187,150,35,2,33,0,0,33,1025,871,325,0,546,154,149,69,0,80,5,0,0,5,37421
12126,25753,3841,7613,7208,4294,2797,1636,728,527,180,4,343,201,143,124,15,4,58,1,0,57,908,817,227,60,530,91,73,30,0,43,18,0,0,18,37601
12127,22831,2825,5810,6049,4714,3433,1786,1010,908,284,73,551,102,61,50,11,0,41,30,0,11,776,656,268,38,350,120,71,48,0,23,49,8,0,41,37604
12128,58,0,0,12,21,25,1010,333,333,108,21,204,0,0,0,0,0,0,0,0,0,677,677,260,34,383,0,0,0,0,0,0,0,0,0,37614
12129,13603,1260,3645,4034,2986,1678,958,480,379,114,0,265,101,101,78,9,14,0,0,0,0,478,466,93,68,305,12,12,0,0,12,0,0,0,0,37615
12130,3385,525,1523,897,339,101,291,136,119,13,0,106,17,0,0,0,0,17,0,0,17,155,138,16,0,122,17,17,17,0,0,0,0,0,0,37616
12131,10136,1684,3879,2634,1239,700,853,338,260,87,29,144,78,52,13,16,23,26,0,0,26,515,472,199,18,255,43,6,0,6,0,37,30,0,7,37617
12132,9490,1528,3837,2483,1039,603,551,372,368,67,105,196,4,4,0,0,4,0,0,0,0,179,170,104,22,44,9,9,8,0,1,0,0,0,0,37618
12133,27714,5899,9514,7566,3188,1547,2024,988,792,186,67,539,196,143,67,47,29,53,45,8,0,1036,793,186,32,575,243,160,69,0,91,83,10,7,66,37620
12134,2387,688,1019,458,135,87,86,66,57,12,9,36,9,9,0,9,0,0,0,0,0,20,4,0,0,4,16,16,0,16,0,0,0,0,0,37640
12135,5929,1257,2672,1234,494,272,379,96,96,21,16,59,0,0,0,0,0,0,0,0,0,283,248,97,0,151,35,35,14,0,21,0,0,0,0,37641
12136,10164,1550,4299,3095,962,258,760,336,228,67,0,161,108,78,41,37,0,30,0,0,30,424,385,107,0,278,39,39,0,26,13,0,0,0,0,37642
12137,24495,4741,9565,6370,2434,1385,1378,811,703,286,19,398,108,73,60,9,4,35,0,0,35,567,427,168,29,230,140,140,47,0,93,0,0,0,0,37643
12138,3787,498,1546,1169,461,113,216,111,84,48,0,36,27,13,13,0,0,14,0,0,14,105,74,23,0,51,31,31,31,0,0,0,0,0,0,37645
12139,8981,2224,3714,2151,519,373,497,188,178,37,0,141,10,10,0,0,10,0,0,0,0,309,289,96,0,193,20,20,0,0,20,0,0,0,0,37650
12140,3041,409,1354,784,341,153,161,23,23,13,0,10,0,0,0,0,0,0,0,0,0,138,122,18,3,101,16,16,7,9,0,0,0,0,0,37656
12141,827,267,366,123,55,16,18,8,0,0,0,0,8,8,0,0,8,0,0,0,0,10,10,0,0,10,0,0,0,0,0,0,0,0,0,37657
12142,3141,760,1344,685,231,121,137,21,11,4,0,7,10,10,0,10,0,0,0,0,0,116,104,19,0,85,12,12,12,0,0,0,0,0,0,37658
12143,19838,2717,6837,5534,2956,1794,1115,452,376,195,0,181,76,31,21,10,0,45,0,0,45,663,495,202,12,281,168,118,52,0,66,50,0,0,50,37659
12144,28942,4666,10939,8044,3064,2229,1578,858,628,71,178,379,230,188,71,39,78,42,26,14,2,720,587,182,33,372,133,65,28,22,15,68,10,24,34,37660
12145,10630,646,3072,3418,2337,1157,755,363,360,69,32,259,3,3,0,0,3,0,0,0,0,392,296,40,0,256,96,96,12,0,84,0,0,0,0,37663
12146,18854,1929,6204,5557,3234,1930,1371,874,640,138,40,462,234,213,114,51,48,21,0,0,21,497,419,141,60,218,78,65,54,11,0,13,0,0,13,37664
12147,3889,812,1794,906,265,112,172,59,59,0,16,43,0,0,0,0,0,0,0,0,0,113,113,74,8,31,0,0,0,0,0,0,0,0,0,37665
12148,485,148,194,85,45,13,16,0,0,0,0,0,0,0,0,0,0,0,0,0,0,16,16,16,0,0,0,0,0,0,0,0,0,0,0,37680
12149,4001,977,1480,798,585,161,228,151,136,22,0,114,15,15,0,14,1,0,0,0,0,77,77,0,0,77,0,0,0,0,0,0,0,0,0,37681
12150,17,0,7,0,0,10,330,111,111,40,3,68,0,0,0,0,0,0,0,0,0,219,219,64,0,155,0,0,0,0,0,0,0,0,0,37682
12151,10147,2877,4477,1929,628,236,585,380,245,26,13,206,135,96,38,58,0,39,0,0,39,205,135,25,19,91,70,70,53,17,0,0,0,0,0,37683
12152,5661,819,1909,1639,976,318,332,202,176,77,17,82,26,2,2,0,0,24,24,0,0,130,99,27,11,61,31,31,31,0,0,0,0,0,0,37686
12153,3483,967,1419,726,233,138,231,148,126,9,0,117,22,9,0,0,9,13,13,0,0,83,78,23,0,55,5,5,5,0,0,0,0,0,0,37687
12154,695,155,282,180,53,25,64,18,7,0,0,7,11,11,0,11,0,0,0,0,0,46,25,0,0,25,21,21,8,13,0,0,0,0,0,37688
12155,2779,534,1166,644,209,226,144,78,63,0,0,63,15,15,15,0,0,0,0,0,0,66,52,20,0,32,14,14,6,8,0,0,0,0,0,37690
12156,472,96,119,163,55,39,35,23,0,0,0,0,23,0,0,0,0,23,0,0,23,12,0,0,0,0,12,12,0,0,12,0,0,0,0,37691
12157,3538,676,1190,863,436,373,222,158,158,64,16,78,0,0,0,0,0,0,0,0,0,64,53,0,0,53,11,11,0,0,11,0,0,0,0,37692
12158,1370,286,562,378,101,43,102,95,66,45,0,21,29,29,28,0,1,0,0,0,0,7,7,2,0,5,0,0,0,0,0,0,0,0,0,37694
12159,5002,767,1526,1700,664,345,345,257,239,77,0,162,18,18,18,0,0,0,0,0,0,88,65,36,0,29,23,23,8,0,15,0,0,0,0,37701
12160,3030,511,1149,809,366,195,172,107,107,0,13,94,0,0,0,0,0,0,0,0,0,65,44,18,0,26,21,21,0,0,21,0,0,0,0,37705
12161,4498,1139,1849,966,373,171,496,257,221,81,25,115,36,36,13,23,0,0,0,0,0,239,226,70,9,147,13,9,9,0,0,4,0,0,4,37708
12162,2592,633,1180,498,193,88,177,114,83,18,15,50,31,31,22,9,0,0,0,0,0,63,49,3,10,36,14,10,0,0,10,4,0,4,0,37709
12163,716,154,450,112,0,0,72,37,8,0,0,8,29,0,0,0,0,29,0,0,29,35,33,21,0,12,2,2,0,0,2,0,0,0,0,37710
12164,3562,770,1666,846,195,85,302,142,92,4,0,88,50,50,11,0,39,0,0,0,0,160,121,23,71,27,39,39,25,14,0,0,0,0,0,37711
12165,990,127,495,220,101,47,29,9,9,0,0,9,0,0,0,0,0,0,0,0,0,20,20,0,0,20,0,0,0,0,0,0,0,0,0,37713
12166,3405,908,1371,763,225,138,327,95,81,5,24,52,14,14,6,8,0,0,0,0,0,232,170,0,0,170,62,0,0,0,0,62,44,0,18,37714
12167,472,197,219,41,10,5,45,31,27,0,0,27,4,4,0,0,4,0,0,0,0,14,10,6,0,4,4,4,0,4,0,0,0,0,0,37715
12168,18273,2981,6986,5197,1954,1155,1188,569,425,108,76,241,144,120,89,24,7,24,0,8,16,619,467,117,43,307,152,128,96,0,32,24,0,0,24,37716
12169,115,8,67,24,16,0,0,0,0,0,0,0,0,0,0,0,0,0,0,0,0,0,0,0,0,0,0,0,0,0,0,0,0,0,0,37719
12170,9124,1318,3658,2641,1021,486,567,296,209,45,51,113,87,52,50,0,2,35,16,19,0,271,227,52,2,173,44,44,23,19,2,0,0,0,0,37721
12171,4722,1013,2152,1008,306,243,257,96,55,9,0,46,41,22,0,0,22,19,19,0,0,161,81,0,29,52,80,80,64,16,0,0,0,0,0,37722
12172,681,194,314,95,65,13,67,38,27,0,0,27,11,11,4,2,5,0,0,0,0,29,27,16,7,4,2,0,0,0,0,2,0,0,2,37723
12173,1728,438,636,399,177,78,128,89,65,0,4,61,24,24,0,0,24,0,0,0,0,39,39,15,13,11,0,0,0,0,0,0,0,0,0,37724
12174,11513,2038,4625,3438,887,525,924,541,424,139,0,285,117,57,37,9,11,60,32,6,22,383,257,124,0,133,126,107,102,5,0,19,0,0,19,37725
12175,1141,358,502,193,54,34,14,10,0,0,0,0,10,0,0,0,0,10,0,0,10,4,4,0,0,4,0,0,0,0,0,0,0,0,0,37726
12176,1638,451,707,304,116,60,115,61,36,0,0,36,25,25,0,25,0,0,0,0,0,54,54,4,9,41,0,0,0,0,0,0,0,0,0,37727
12177,1053,318,588,78,43,26,67,58,51,7,0,44,7,7,7,0,0,0,0,0,0,9,0,0,0,0,9,9,9,0,0,0,0,0,0,37729
12178,43,40,0,3,0,0,0,0,0,0,0,0,0,0,0,0,0,0,0,0,0,0,0,0,0,0,0,0,0,0,0,0,0,0,0,37730
12179,601,80,328,161,32,0,9,9,9,0,0,9,0,0,0,0,0,0,0,0,0,0,0,0,0,0,0,0,0,0,0,0,0,0,0,37731
12180,57,9,37,11,0,0,0,0,0,0,0,0,0,0,0,0,0,0,0,0,0,0,0,0,0,0,0,0,0,0,0,0,0,0,0,37732
12181,20,0,0,0,10,10,0,0,0,0,0,0,0,0,0,0,0,0,0,0,0,0,0,0,0,0,0,0,0,0,0,0,0,0,0,37733
12182,3999,611,1676,1073,422,217,293,184,135,46,37,52,49,25,25,0,0,24,0,17,7,109,77,5,10,62,32,18,0,0,18,14,0,0,14,37737
12183,4432,723,1353,1412,617,327,128,56,37,17,0,20,19,0,0,0,0,19,19,0,0,72,70,27,1,42,2,2,0,2,0,0,0,0,0,37738
12184,4431,566,1976,1103,503,283,321,157,83,38,6,39,74,72,7,0,65,2,2,0,0,164,162,10,4,148,2,2,2,0,0,0,0,0,0,37742
12185,19354,3883,7642,4750,1809,1270,1374,677,541,168,53,320,136,116,82,17,17,20,0,0,20,697,434,179,28,227,263,155,31,85,39,108,108,0,0,37743
12186,12142,2349,4698,2797,1493,805,919,562,447,102,17,328,115,115,71,8,36,0,0,0,0,357,271,67,61,143,86,86,25,0,61,0,0,0,0,37745
12187,12745,2552,5165,3475,1053,500,928,418,353,68,36,249,65,26,0,26,0,39,18,0,21,510,432,161,25,246,78,52,39,13,0,26,26,0,0,37748
12188,4555,953,1674,977,653,298,308,224,208,42,12,154,16,16,0,16,0,0,0,0,0,84,84,4,0,80,0,0,0,0,0,0,0,0,0,37752
12189,588,157,293,121,17,0,62,23,23,0,0,23,0,0,0,0,0,0,0,0,0,39,8,0,0,8,31,31,31,0,0,0,0,0,0,37753
12190,3340,714,1216,1039,274,97,253,100,100,42,14,44,0,0,0,0,0,0,0,0,0,153,153,87,47,19,0,0,0,0,0,0,0,0,0,37754
12191,2113,579,933,402,109,90,162,38,20,0,0,20,18,18,18,0,0,0,0,0,0,124,97,0,26,71,27,27,14,0,13,0,0,0,0,37755
12192,2257,741,1041,322,104,49,51,32,32,3,0,29,0,0,0,0,0,0,0,0,0,19,19,0,0,19,0,0,0,0,0,0,0,0,0,37756
12193,6419,1614,2669,1512,422,202,443,251,176,105,0,71,75,75,13,51,11,0,0,0,0,192,164,20,25,119,28,12,12,0,0,16,0,0,16,37757
12194,8816,1295,3023,2567,1202,729,1186,587,567,38,137,392,20,20,6,3,11,0,0,0,0,599,542,202,19,321,57,57,21,0,36,0,0,0,0,37760
12195,2116,740,864,299,136,77,98,46,27,11,0,16,19,5,5,0,0,14,0,10,4,52,48,17,0,31,4,0,0,0,0,4,0,0,4,37762
12196,11458,1196,4091,3776,1502,893,623,321,281,83,0,198,40,40,39,0,1,0,0,0,0,302,205,28,51,126,97,97,14,62,21,0,0,0,0,37763
12197,6402,983,2724,2046,410,239,632,255,199,56,51,92,56,56,19,37,0,0,0,0,0,377,344,219,15,110,33,33,0,33,0,0,0,0,0,37764
12198,334,95,191,34,14,0,38,7,7,0,0,7,0,0,0,0,0,0,0,0,0,31,31,0,22,9,0,0,0,0,0,0,0,0,0,37765
12199,13169,4099,5281,2519,864,406,1055,516,386,53,16,317,130,123,99,24,0,7,1,0,6,539,424,84,29,311,115,68,52,0,16,47,21,6,20,37766
12200,4203,1268,1993,801,98,43,263,175,110,9,17,84,65,65,17,0,48,0,0,0,0,88,88,40,19,29,0,0,0,0,0,0,0,0,0,37769
12201,2016,431,1137,354,45,49,121,58,30,18,0,12,28,28,28,0,0,0,0,0,0,63,56,19,0,37,7,7,7,0,0,0,0,0,0,37770
12202,10289,2232,3768,2979,913,397,996,496,394,46,20,328,102,102,56,46,0,0,0,0,0,500,356,42,28,286,144,132,36,37,59,12,12,0,0,37771
12203,8305,936,2226,2636,1658,849,507,269,269,54,58,157,0,0,0,0,0,0,0,0,0,238,224,56,28,140,14,14,14,0,0,0,0,0,0,37772
12204,14669,1776,4637,3644,2939,1673,650,263,167,22,20,125,96,69,15,0,54,27,27,0,0,387,359,143,7,209,28,28,17,0,11,0,0,0,0,37774
12205,7878,1026,2289,2625,1368,570,477,156,146,10,0,136,10,10,8,0,2,0,0,0,0,321,264,139,10,115,57,26,26,0,0,31,31,0,0,37777
12206,3077,813,1428,708,67,61,292,145,116,10,0,106,29,29,0,25,4,0,0,0,0,147,118,37,0,81,29,29,7,0,22,0,0,0,0,37779
12207,17540,2650,6577,5406,1736,1171,999,555,519,132,57,330,36,27,27,0,0,9,9,0,0,444,336,151,21,164,108,108,42,0,66,0,0,0,0,37801
12208,22150,2545,7651,6277,3444,2233,1790,867,712,221,14,477,155,155,59,63,33,0,0,0,0,923,717,251,56,410,206,48,48,0,0,158,0,54,104,37803
12209,16567,1876,5849,5062,2560,1220,1468,665,536,126,109,301,129,106,80,0,26,23,0,11,12,803,719,237,53,429,84,61,34,17,10,23,23,0,0,37804
12210,1898,436,877,421,146,18,111,45,45,0,31,14,0,0,0,0,0,0,0,0,0,66,49,30,0,19,17,17,0,0,17,0,0,0,0,37806
12211,6376,1842,2825,1137,396,176,485,295,247,35,0,212,48,48,25,16,7,0,0,0,0,190,155,31,16,108,35,27,27,0,0,8,8,0,0,37807
12212,1560,327,715,323,130,65,130,70,70,20,0,50,0,0,0,0,0,0,0,0,0,60,12,0,12,0,48,48,48,0,0,0,0,0,0,37809
12213,1428,315,614,295,107,97,111,69,69,0,21,48,0,0,0,0,0,0,0,0,0,42,42,17,0,25,0,0,0,0,0,0,0,0,0,37810
12214,2664,688,1070,602,237,67,223,76,74,0,54,20,2,0,0,0,0,2,0,0,2,147,126,14,73,39,21,21,21,0,0,0,0,0,0,37811
12215,12049,2768,4852,2860,1088,481,863,413,388,179,14,195,25,0,0,0,0,25,6,19,0,450,359,54,21,284,91,58,31,0,27,33,5,17,11,37813
12216,22810,4465,8373,5833,2498,1641,1573,873,774,205,113,456,99,93,71,18,4,6,0,0,6,700,580,169,53,358,120,120,58,40,22,0,0,0,0,37814
12217,3537,905,1465,821,284,62,258,143,135,17,12,106,8,0,0,0,0,8,0,0,8,115,100,53,16,31,15,8,8,0,0,7,7,0,0,37818
12218,486,150,207,92,32,5,14,14,14,0,0,14,0,0,0,0,0,0,0,0,0,0,0,0,0,0,0,0,0,0,0,0,0,0,0,37819
12219,5089,1048,2262,1346,286,147,356,212,146,21,0,125,66,59,29,30,0,7,0,7,0,144,114,13,0,101,30,30,30,0,0,0,0,0,0,37820
12220,15698,3881,7077,3495,668,577,904,527,422,185,0,237,105,65,23,31,11,40,40,0,0,377,313,150,28,135,64,52,16,0,36,12,0,0,12,37821
12221,6094,1581,2681,1200,429,203,399,209,177,43,22,112,32,32,25,0,7,0,0,0,0,190,113,22,11,80,77,77,77,0,0,0,0,0,0,37825
12222,3221,736,1462,708,288,27,203,151,93,32,3,58,58,56,56,0,0,2,0,0,2,52,52,32,3,17,0,0,0,0,0,0,0,0,0,37826
12223,1304,24,245,291,345,399,55,41,41,11,0,30,0,0,0,0,0,0,0,0,0,14,6,2,0,4,8,8,0,3,5,0,0,0,0,37828
12224,1408,180,738,333,87,70,164,45,44,0,5,39,1,1,1,0,0,0,0,0,0,119,26,0,0,26,93,37,37,0,0,56,0,0,56,37829
12225,20821,1864,4602,5784,4360,4211,1431,723,614,200,0,414,109,109,41,12,56,0,0,0,0,708,649,205,32,412,59,36,28,0,8,23,0,8,15,37830
12226,7109,1383,3487,1457,548,234,484,310,248,137,15,96,62,62,46,0,16,0,0,0,0,174,161,8,0,153,13,13,13,0,0,0,0,0,0,37840
12227,6423,1292,2559,1669,509,394,572,279,262,74,73,115,17,17,0,0,17,0,0,0,0,293,281,121,0,160,12,12,12,0,0,0,0,0,0,37841
12228,2723,467,1359,546,238,113,304,168,95,24,12,59,73,73,33,0,40,0,0,0,0,136,128,45,0,83,8,8,0,0,8,0,0,0,0,37843
12229,384,58,240,86,0,0,17,17,17,0,0,17,0,0,0,0,0,0,0,0,0,0,0,0,0,0,0,0,0,0,0,0,0,0,0,37845
12230,3753,1279,1518,770,127,59,479,219,123,7,34,82,96,96,46,20,30,0,0,0,0,260,131,31,0,100,129,78,78,0,0,51,51,0,0,37846
12231,1631,556,842,141,62,30,150,62,46,8,0,38,16,16,16,0,0,0,0,0,0,88,69,0,20,49,19,19,7,0,12,0,0,0,0,37847
12232,250,122,91,37,0,0,0,0,0,0,0,0,0,0,0,0,0,0,0,0,0,0,0,0,0,0,0,0,0,0,0,0,0,0,0,37848
12233,16640,1990,5505,5724,2400,1021,1712,858,676,155,43,478,182,89,76,0,13,93,0,32,61,854,790,317,116,357,64,48,7,41,0,16,16,0,0,37849
12234,6,6,0,0,0,0,0,0,0,0,0,0,0,0,0,0,0,0,0,0,0,0,0,0,0,0,0,0,0,0,0,0,0,0,0,37851
12235,1775,483,906,303,34,49,119,56,46,0,17,29,10,10,0,0,10,0,0,0,0,63,47,7,0,40,16,16,16,0,0,0,0,0,0,37852
12236,2795,562,1229,541,273,190,115,65,25,9,3,13,40,25,13,12,0,15,15,0,0,50,35,23,0,12,15,15,3,0,12,0,0,0,0,37853
12237,8891,1900,3580,2567,602,242,551,333,316,47,66,203,17,17,9,0,8,0,0,0,0,218,172,51,0,121,46,20,20,0,0,26,0,0,26,37854
12238,14630,3278,6630,3194,1063,465,942,521,421,101,4,316,100,100,51,45,4,0,0,0,0,421,350,140,27,183,71,56,44,0,12,15,0,0,15,37857
12239,3150,553,1455,822,230,90,254,143,109,42,8,59,34,34,34,0,0,0,0,0,0,111,96,28,0,68,15,15,0,0,15,0,0,0,0,37860
12240,5973,1459,2595,1275,418,226,366,194,149,4,0,145,45,45,5,7,33,0,0,0,0,172,146,86,0,60,26,20,20,0,0,6,0,0,6,37861
12241,15225,2984,5377,4292,1696,876,1141,616,379,144,35,200,237,91,53,19,19,146,63,77,6,525,417,222,42,153,108,77,77,0,0,31,0,7,24,37862
12242,4591,1060,1977,948,324,282,265,116,77,13,14,50,39,39,39,0,0,0,0,0,0,149,149,27,60,62,0,0,0,0,0,0,0,0,0,37863
12243,14896,2035,5645,4801,1559,856,1131,698,561,245,97,219,137,95,85,10,0,42,29,0,13,433,295,87,18,190,138,56,34,0,22,82,22,0,60,37865
12244,1158,244,562,195,103,54,104,28,28,0,0,28,0,0,0,0,0,0,0,0,0,76,67,24,0,43,9,9,0,0,9,0,0,0,0,37866
12245,3592,960,1625,656,180,171,201,147,143,12,0,131,4,0,0,0,0,4,0,0,4,54,41,0,14,27,13,13,0,0,13,0,0,0,0,37869
12246,3262,837,1389,681,205,150,171,69,69,0,0,69,0,0,0,0,0,0,0,0,0,102,102,26,21,55,0,0,0,0,0,0,0,0,0,37870
12247,5915,1385,2179,1635,433,283,430,253,118,85,0,33,135,135,135,0,0,0,0,0,0,177,83,45,0,38,94,85,67,18,0,9,0,9,0,37871
12248,1222,186,575,320,110,31,87,52,52,0,0,52,0,0,0,0,0,0,0,0,0,35,35,6,3,26,0,0,0,0,0,0,0,0,0,37872
12249,3047,694,1245,653,329,126,188,119,88,6,19,63,31,31,31,0,0,0,0,0,0,69,30,4,11,15,39,9,9,0,0,30,0,25,5,37873
12250,9598,2352,4132,2078,699,337,599,371,328,54,19,255,43,43,0,0,43,0,0,0,0,228,168,26,68,74,60,60,60,0,0,0,0,0,0,37874
12251,19936,3357,7937,5789,1789,1064,1436,851,717,207,24,486,134,134,80,54,0,0,0,0,0,585,489,246,17,226,96,63,32,12,19,33,25,0,8,37876
12252,5677,1033,2198,1410,582,454,275,165,155,21,7,127,10,10,0,0,10,0,0,0,0,110,110,45,0,65,0,0,0,0,0,0,0,0,0,37877
12253,403,52,174,111,66,0,55,22,5,0,0,5,17,17,12,5,0,0,0,0,0,33,33,0,0,33,0,0,0,0,0,0,0,0,0,37878
12254,7613,2038,3229,1408,496,442,696,253,218,58,48,112,35,35,27,8,0,0,0,0,0,443,413,44,22,347,30,30,14,0,16,0,0,0,0,37879
12255,3220,850,1221,867,149,133,137,119,119,8,0,111,0,0,0,0,0,0,0,0,0,18,18,4,0,14,0,0,0,0,0,0,0,0,0,37880
12256,1584,516,638,360,60,10,93,26,11,0,0,11,15,15,0,15,0,0,0,0,0,67,59,21,0,38,8,8,8,0,0,0,0,0,0,37881
12257,2309,369,876,636,271,157,50,3,3,0,0,3,0,0,0,0,0,0,0,0,0,47,1,0,0,1,46,46,46,0,0,0,0,0,0,37882
12258,3496,673,1171,979,348,325,254,118,77,4,0,73,41,41,18,23,0,0,0,0,0,136,120,38,0,82,16,16,16,0,0,0,0,0,0,37885
12259,3195,485,1510,729,240,231,246,128,128,0,95,33,0,0,0,0,0,0,0,0,0,118,118,56,0,62,0,0,0,0,0,0,0,0,0,37886
12260,5755,1361,2896,1105,270,123,225,76,21,11,0,10,55,55,28,8,19,0,0,0,0,149,129,69,2,58,20,20,20,0,0,0,0,0,0,37887
12261,2017,628,825,394,111,59,104,42,37,18,0,19,5,5,5,0,0,0,0,0,0,62,62,12,0,50,0,0,0,0,0,0,0,0,0,37888
12262,4621,1022,1852,1299,220,228,399,185,130,67,3,60,55,27,27,0,0,28,28,0,0,214,179,22,57,100,35,35,12,23,0,0,0,0,0,37890
12263,2297,458,1270,402,111,56,68,23,23,9,0,14,0,0,0,0,0,0,0,0,0,45,29,0,0,29,16,16,16,0,0,0,0,0,0,37891
12264,1374,339,657,239,78,61,103,56,16,0,0,16,40,40,22,0,18,0,0,0,0,47,42,4,0,38,5,0,0,0,0,5,0,5,0,37892
12265,1367,140,226,228,321,452,3,3,0,0,0,0,3,3,0,0,3,0,0,0,0,0,0,0,0,0,0,0,0,0,0,0,0,0,0,37902
12266,10267,978,2001,2636,2601,2051,470,309,126,7,0,119,183,83,23,0,60,100,17,28,55,161,103,30,0,73,58,58,0,17,41,0,0,0,0,37909
12267,14255,1398,3969,5157,2823,908,563,398,282,28,16,238,116,96,76,0,20,20,0,0,20,165,88,28,0,60,77,15,12,3,0,62,49,13,0,37912
12268,14277,2431,4864,4300,1813,869,1288,679,585,141,31,413,94,94,37,57,0,0,0,0,0,609,506,105,59,342,103,92,35,42,15,11,0,11,0,37914
12269,3407,643,1340,981,250,193,291,214,178,40,0,138,36,36,0,36,0,0,0,0,0,77,12,0,0,12,65,22,0,0,22,43,0,22,21,37915
12270,1564,141,317,243,448,415,4153,1688,1688,314,6,1368,0,0,0,0,0,0,0,0,0,2465,2456,561,32,1863,9,9,0,0,9,0,0,0,0,37916
12271,18290,2912,5224,6170,2586,1398,818,349,272,25,0,247,77,48,0,0,48,29,6,5,18,469,364,37,60,267,105,97,42,0,55,8,0,0,8,37917
12272,30021,3602,9337,9417,5020,2645,2265,1364,967,180,58,729,397,352,145,129,78,45,0,6,39,901,741,271,42,428,160,154,87,43,24,6,0,0,6,37918
12273,19850,1941,3415,4154,5309,5031,1363,607,449,116,9,324,158,147,147,0,0,11,7,0,4,756,570,250,18,302,186,99,99,0,0,87,52,18,17,37919
12274,25897,2999,7482,7968,4917,2531,1543,779,640,150,53,437,139,121,67,32,22,18,0,11,7,764,577,185,20,372,187,163,64,71,28,24,0,0,24,37920
12275,19108,2077,5875,6329,3453,1374,1437,678,649,152,78,419,29,26,26,0,0,3,0,0,3,759,601,259,42,300,158,90,9,27,54,68,0,25,43,37921
12276,21896,541,3029,5358,7676,5292,1978,1186,1186,259,60,867,0,0,0,0,0,0,0,0,0,792,792,282,0,510,0,0,0,0,0,0,0,0,0,37922
12277,18802,980,3677,5864,5455,2826,1292,836,512,170,159,183,324,165,37,0,128,159,109,0,50,456,298,130,14,154,158,56,41,0,15,102,64,0,38,37923
12278,8141,935,2857,2475,1473,401,451,268,203,25,13,165,65,17,0,0,17,48,12,30,6,183,114,0,0,114,69,35,8,0,27,34,0,0,34,37924
12279,17444,1448,4245,5159,4167,2425,1105,650,573,152,0,421,77,48,20,13,15,29,0,13,16,455,394,188,21,185,61,61,39,0,22,0,0,0,0,37931
12280,9754,652,1971,2745,2724,1662,741,401,320,152,22,146,81,9,0,9,0,72,0,0,72,340,340,136,50,154,0,0,0,0,0,0,0,0,0,37932
12281,16608,472,2384,4264,5471,4017,1759,981,856,271,55,530,125,90,55,35,0,35,0,0,35,778,670,174,43,453,108,71,65,6,0,37,0,0,37,37934
12282,11943,1011,4054,3651,2160,1067,936,446,426,182,19,225,20,20,6,0,14,0,0,0,0,490,481,161,14,306,9,9,9,0,0,0,0,0,0,37938
12283,3064,761,1286,747,197,73,259,134,79,15,3,61,55,55,40,0,15,0,0,0,0,125,84,35,19,30,41,41,41,0,0,0,0,0,0,38001
12284,24628,1400,5631,8340,6197,3060,2585,1489,1443,467,19,957,46,46,26,14,6,0,0,0,0,1096,992,297,35,660,104,104,49,40,15,0,0,0,0,38002
12285,6661,381,2147,2671,951,511,789,331,187,69,40,78,144,144,43,101,0,0,0,0,0,458,374,24,135,215,84,84,66,18,0,0,0,0,0,38004
12286,3810,917,1422,948,394,129,328,178,145,31,6,108,33,33,6,27,0,0,0,0,0,150,121,58,0,63,29,12,12,0,0,17,10,7,0,38006
12287,36,10,11,15,0,0,11,0,0,0,0,0,0,0,0,0,0,0,0,0,0,11,11,0,11,0,0,0,0,0,0,0,0,0,0,38007
12288,6515,1576,2612,1440,404,483,509,333,285,37,89,159,48,45,11,10,24,3,0,0,3,176,164,22,0,142,12,11,11,0,0,1,0,0,1,38008
12289,5950,681,2327,1954,572,416,584,282,233,22,27,184,49,49,14,17,18,0,0,0,0,302,267,87,13,167,35,16,16,0,0,19,14,0,5,38011
12290,9599,2239,4108,2079,734,439,758,348,310,27,11,272,38,33,33,0,0,5,0,0,5,410,340,48,23,269,70,70,0,34,36,0,0,0,0,38012
12291,1777,417,770,426,100,64,136,100,77,19,6,52,23,3,0,3,0,20,0,0,20,36,30,22,0,8,6,0,0,0,0,6,0,6,0,38015
12292,28576,1341,5024,10393,7637,4181,2125,936,895,210,27,658,41,41,5,0,36,0,0,0,0,1189,1083,346,118,619,106,90,72,0,18,16,0,0,16,38016
12293,31263,1372,5592,8520,10225,5554,3171,1683,1490,487,188,815,193,166,48,94,24,27,27,0,0,1488,1448,419,81,948,40,36,13,20,3,4,0,0,4,38017
12294,23796,1356,4538,7721,6981,3200,1740,958,781,241,63,477,177,111,104,0,7,66,14,0,52,782,690,83,9,598,92,80,21,59,0,12,12,0,0,38018
12295,10421,2318,4062,2849,815,377,1161,717,601,125,0,476,116,87,44,14,29,29,0,0,29,444,339,130,14,195,105,67,67,0,0,38,38,0,0,38019
12296,156,33,37,7,39,40,0,0,0,0,0,0,0,0,0,0,0,0,0,0,0,0,0,0,0,0,0,0,0,0,0,0,0,0,0,38021
12297,4137,465,1643,1360,518,151,500,178,92,0,0,92,86,0,0,0,0,86,15,19,52,322,322,33,56,233,0,0,0,0,0,0,0,0,0,38023
12298,18694,2915,7406,4492,2284,1597,1694,942,723,65,80,578,219,197,77,68,52,22,0,0,22,752,654,241,37,376,98,89,67,22,0,9,0,0,9,38024
12299,5125,379,1373,1440,1131,802,334,146,131,15,14,102,15,15,15,0,0,0,0,0,0,188,188,110,7,71,0,0,0,0,0,0,0,0,0,38028
12300,0,0,0,0,0,0,0,0,0,0,0,0,0,0,0,0,0,0,0,0,0,0,0,0,0,0,0,0,0,0,0,0,0,0,0,38029
12301,555,105,364,32,10,44,22,4,4,4,0,0,0,0,0,0,0,0,0,0,0,18,18,18,0,0,0,0,0,0,0,0,0,0,0,38030
12302,2013,475,950,441,89,58,132,54,44,4,0,40,10,8,8,0,0,2,0,0,2,78,68,22,0,46,10,10,0,0,10,0,0,0,0,38034
12303,344,125,152,51,16,0,22,0,0,0,0,0,0,0,0,0,0,0,0,0,0,22,15,7,0,8,7,7,0,7,0,0,0,0,0,38036
12304,1277,297,517,361,77,25,130,59,43,0,0,43,16,16,7,0,9,0,0,0,0,71,25,0,0,25,46,46,36,0,10,0,0,0,0,38037
12305,868,155,449,174,62,28,190,112,53,0,9,44,59,55,55,0,0,4,0,0,4,78,40,4,26,10,38,38,8,30,0,0,0,0,0,38039
12306,3507,764,1541,856,219,127,234,164,129,11,0,118,35,14,3,11,0,21,0,21,0,70,62,51,5,6,8,8,0,8,0,0,0,0,0,38040
12307,3732,1361,1531,658,111,71,165,121,53,0,4,49,68,28,0,13,15,40,0,0,40,44,28,0,0,28,16,16,16,0,0,0,0,0,0,38041
12308,685,177,311,138,46,13,56,16,16,0,0,16,0,0,0,0,0,0,0,0,0,40,40,0,0,40,0,0,0,0,0,0,0,0,0,38042
12309,434,80,157,137,29,31,3,0,0,0,0,0,0,0,0,0,0,0,0,0,0,3,3,0,0,3,0,0,0,0,0,0,0,0,0,38044
12310,37,7,7,10,9,4,0,0,0,0,0,0,0,0,0,0,0,0,0,0,0,0,0,0,0,0,0,0,0,0,0,0,0,0,0,38046
12311,28,0,17,11,0,0,0,0,0,0,0,0,0,0,0,0,0,0,0,0,0,0,0,0,0,0,0,0,0,0,0,0,0,0,0,38047
12312,3162,678,1416,766,212,90,230,103,91,5,0,86,12,12,4,3,5,0,0,0,0,127,110,19,0,91,17,17,9,0,8,0,0,0,0,38049
12313,301,80,161,44,9,7,23,6,4,0,0,4,2,0,0,0,0,2,0,0,2,17,2,0,2,0,15,15,0,0,15,0,0,0,0,38050
12314,2776,472,1206,764,177,157,311,122,122,36,0,86,0,0,0,0,0,0,0,0,0,189,146,14,27,105,43,39,9,30,0,4,0,0,4,38052
12315,18625,2243,6917,6316,1996,1153,1452,720,605,70,167,368,115,102,89,0,13,13,0,12,1,732,665,135,93,437,67,67,37,30,0,0,0,0,0,38053
12316,124,0,21,24,29,50,18,15,0,0,0,0,15,15,15,0,0,0,0,0,0,3,3,0,0,3,0,0,0,0,0,0,0,0,0,38054
12317,2464,400,1045,622,255,142,219,97,35,26,0,9,62,39,28,9,2,23,0,0,23,122,115,15,3,97,7,7,2,5,0,0,0,0,0,38057
12318,5906,736,2067,2211,629,263,373,176,139,39,0,100,37,13,0,13,0,24,0,0,24,197,197,63,35,99,0,0,0,0,0,0,0,0,0,38058
12319,4947,820,2216,1316,400,195,350,184,160,51,0,109,24,10,10,0,0,14,0,14,0,166,147,64,12,71,19,19,19,0,0,0,0,0,0,38059
12320,7122,659,2210,2369,1401,483,412,270,224,70,0,154,46,46,32,14,0,0,0,0,0,142,65,12,0,53,77,77,44,0,33,0,0,0,0,38060
12321,605,75,317,186,14,13,18,18,18,12,0,6,0,0,0,0,0,0,0,0,0,0,0,0,0,0,0,0,0,0,0,0,0,0,0,38061
12322,10958,2538,4835,2167,1014,404,859,413,333,45,18,270,80,53,0,9,44,27,0,0,27,446,388,62,50,276,58,52,4,27,21,6,0,0,6,38063
12323,1995,291,684,566,373,81,92,44,44,0,29,15,0,0,0,0,0,0,0,0,0,48,35,14,12,9,13,1,1,0,0,12,0,0,12,38066
12324,936,163,390,336,30,17,92,48,48,2,26,20,0,0,0,0,0,0,0,0,0,44,44,27,0,17,0,0,0,0,0,0,0,0,0,38067
12325,7237,1491,3000,1725,694,327,507,226,142,16,0,126,84,55,0,15,40,29,14,0,15,281,261,65,8,188,20,20,0,11,9,0,0,0,0,38068
12326,1429,368,622,314,74,51,216,156,91,17,1,73,65,20,20,0,0,45,0,0,45,60,58,34,6,18,2,0,0,0,0,2,0,2,0,38069
12327,75,66,9,0,0,0,0,0,0,0,0,0,0,0,0,0,0,0,0,0,0,0,0,0,0,0,0,0,0,0,0,0,0,0,0,38070
12328,5273,1851,2067,1037,250,68,125,62,49,0,27,22,13,5,0,0,5,8,0,0,8,63,32,3,0,29,31,31,31,0,0,0,0,0,0,38075
12329,748,194,227,123,135,69,63,6,3,0,0,3,3,3,0,3,0,0,0,0,0,57,42,0,0,42,15,0,0,0,0,15,0,0,15,38076
12330,93,14,49,30,0,0,0,0,0,0,0,0,0,0,0,0,0,0,0,0,0,0,0,0,0,0,0,0,0,0,0,0,0,0,0,38077
12331,4098,1164,1832,803,237,62,115,115,69,0,3,66,46,33,0,4,29,13,6,0,7,0,0,0,0,0,0,0,0,0,0,0,0,0,0,38079
12332,1772,609,695,358,51,59,214,94,65,0,0,65,29,18,7,0,11,11,5,4,2,120,86,10,0,76,34,27,2,10,15,7,0,4,3,38080
12333,9643,895,1173,1458,3278,2839,201,195,43,26,0,17,152,23,0,0,23,129,0,0,129,6,6,0,0,6,0,0,0,0,0,0,0,0,0,38103
12334,17023,1492,3480,4506,4483,3062,703,367,294,58,15,221,73,73,11,37,25,0,0,0,0,336,286,79,27,180,50,31,24,0,7,19,0,0,19,38104
12335,4288,1144,1420,987,359,378,466,273,236,63,0,173,37,11,0,11,0,26,0,16,10,193,121,12,0,109,72,62,0,51,11,10,0,0,10,38105
12336,15941,4030,6328,4032,946,605,1548,805,595,78,73,444,210,160,24,16,120,50,1,5,44,743,547,39,93,415,196,139,41,36,62,57,0,0,57,38106
12337,11374,2590,3539,2951,1412,882,916,369,304,39,50,215,65,36,0,36,0,29,0,19,10,547,477,114,85,278,70,55,18,1,36,15,15,0,0,38107
12338,11659,3850,4535,2665,426,183,1375,896,688,44,51,593,208,58,0,44,14,150,45,38,67,479,438,39,62,337,41,41,0,41,0,0,0,0,0,38108
12339,30339,7319,10810,9134,2191,885,3119,1771,1392,252,119,1021,379,269,84,63,122,110,0,55,55,1348,1192,181,150,861,156,76,39,16,21,80,13,35,32,38109
12340,26986,4715,6195,7394,5115,3567,3287,1411,1160,269,134,757,251,182,96,31,55,69,31,0,38,1876,1711,367,273,1071,165,140,52,38,50,25,25,0,0,38111
12341,10485,2086,2964,2356,1646,1433,1450,649,581,139,38,404,68,45,19,15,11,23,15,0,8,801,756,235,111,410,45,45,39,6,0,0,0,0,0,38112
12342,18875,5095,6820,5094,1099,767,1512,834,571,0,69,502,263,137,90,21,26,126,0,102,24,678,486,102,57,327,192,105,23,14,68,87,0,0,87,38114
12343,23397,3929,7994,7964,2424,1086,2452,1355,899,140,38,721,456,334,169,77,88,122,37,16,69,1097,844,137,72,635,253,195,0,108,87,58,0,58,0,38115
12344,24937,3688,8450,8813,2440,1546,2817,1386,1072,65,82,925,314,285,115,61,109,29,0,0,29,1431,1148,107,156,885,283,246,44,38,164,37,0,0,37,38116
12345,19143,1154,3454,5289,5539,3707,669,328,312,42,0,270,16,16,15,1,0,0,0,0,0,341,300,53,24,223,41,41,34,7,0,0,0,0,0,38117
12346,23273,5680,8673,6943,1424,553,3061,1480,1080,141,106,833,400,190,131,14,45,210,38,89,83,1581,1140,110,100,930,441,291,54,24,213,150,8,0,142,38118
12347,15974,766,3334,4548,4798,2528,889,525,345,72,10,263,180,125,94,31,0,55,55,0,0,364,310,74,27,209,54,33,0,33,0,21,0,0,21,38119
12348,10037,232,1068,2326,3330,3081,593,356,307,38,13,256,49,49,49,0,0,0,0,0,0,237,237,35,39,163,0,0,0,0,0,0,0,0,0,38120
12349,16058,4225,5044,3956,1836,997,1337,845,652,19,16,617,193,89,89,0,0,104,50,0,54,492,297,77,69,151,195,28,0,0,28,167,0,0,167,38122
12350,23708,1947,5531,8495,4824,2911,2510,1383,1159,167,109,883,224,144,62,33,49,80,41,8,31,1127,1016,279,53,684,111,111,0,51,60,0,0,0,0,38125
12351,3320,1293,942,901,86,98,670,203,166,24,15,127,37,23,0,6,17,14,0,14,0,467,358,103,34,221,109,109,15,22,72,0,0,0,0,38126
12352,24702,6239,10122,6440,1393,508,3353,1564,1197,52,125,1020,367,275,0,69,206,92,34,33,25,1789,1272,295,119,858,517,441,199,180,62,76,0,32,44,38127
12353,25441,4709,8770,8576,2170,1216,3363,1727,1317,148,67,1102,410,222,125,48,49,188,57,48,83,1636,1337,291,157,889,299,273,224,10,39,26,0,0,26,38128
12354,0,0,0,0,0,0,0,0,0,0,0,0,0,0,0,0,0,0,0,0,0,0,0,0,0,0,0,0,0,0,0,0,0,0,0,38131
12355,0,0,0,0,0,0,0,0,0,0,0,0,0,0,0,0,0,0,0,0,0,0,0,0,0,0,0,0,0,0,0,0,0,0,0,38132
12356,13300,1280,3730,4424,2787,1079,1233,636,563,76,58,429,73,20,20,0,0,53,0,0,53,597,531,125,11,395,66,59,46,0,13,7,0,0,7,38133
12357,28404,3822,8358,9594,4419,2211,2167,869,653,288,52,313,216,83,59,0,24,133,26,9,98,1298,1170,288,111,771,128,99,37,22,40,29,0,29,0,38134
12358,19375,1515,4575,6476,4562,2247,1479,656,562,117,35,410,94,73,66,7,0,21,21,0,0,823,738,171,73,494,85,76,43,0,33,9,0,0,9,38135
12359,17667,529,2085,4257,6235,4561,1208,601,580,113,33,434,21,21,0,21,0,0,0,0,0,607,590,156,0,434,17,17,17,0,0,0,0,0,0,38138
12360,10628,255,751,2427,4270,2925,1344,676,661,105,54,502,15,15,0,15,0,0,0,0,0,668,635,152,15,468,33,33,33,0,0,0,0,0,0,38139
12361,13524,1162,3823,6043,1552,944,1438,801,721,222,65,434,80,80,41,10,29,0,0,0,0,637,576,120,29,427,61,61,0,0,61,0,0,0,0,38141
12362,23,0,0,8,15,0,442,44,44,12,1,31,0,0,0,0,0,0,0,0,0,398,398,128,74,196,0,0,0,0,0,0,0,0,0,38152
12363,6600,1096,2514,1532,840,618,553,464,442,62,32,348,22,22,11,11,0,0,0,0,0,89,83,4,22,57,6,6,6,0,0,0,0,0,0,38201
12364,1341,335,599,307,45,55,77,32,28,0,18,10,4,4,4,0,0,0,0,0,0,45,31,19,0,12,14,14,14,0,0,0,0,0,0,38220
12365,2482,525,1158,500,225,74,184,79,61,15,2,44,18,18,0,0,18,0,0,0,0,105,102,18,9,75,3,3,0,3,0,0,0,0,0,38221
12366,2125,288,941,568,203,125,71,24,22,1,0,21,2,2,2,0,0,0,0,0,0,47,47,14,0,33,0,0,0,0,0,0,0,0,0,38222
12367,637,125,312,114,74,12,75,48,32,3,0,29,16,0,0,0,0,16,6,0,10,27,16,14,0,2,11,6,0,0,6,5,5,0,0,38224
12368,4420,807,1991,821,567,234,419,214,194,11,51,132,20,20,20,0,0,0,0,0,0,205,205,44,15,146,0,0,0,0,0,0,0,0,0,38225
12369,117,32,74,6,5,0,0,0,0,0,0,0,0,0,0,0,0,0,0,0,0,0,0,0,0,0,0,0,0,0,0,0,0,0,0,38226
12370,2011,490,879,353,172,117,163,114,81,22,7,52,33,33,0,33,0,0,0,0,0,49,47,15,5,27,2,0,0,0,0,2,0,2,0,38229
12371,2456,440,1033,585,256,142,146,51,38,11,2,25,13,13,13,0,0,0,0,0,0,95,83,24,0,59,12,12,0,0,12,0,0,0,0,38230
12372,1231,261,591,229,114,36,254,85,52,0,28,24,33,0,0,0,0,33,33,0,0,169,126,23,0,103,43,29,0,0,29,14,0,14,0,38231
12373,1364,359,526,354,58,67,38,19,11,0,0,11,8,0,0,0,0,8,0,8,0,19,6,0,0,6,13,11,11,0,0,2,0,2,0,38232
12374,1907,371,898,415,169,54,172,107,90,2,0,88,17,17,13,0,4,0,0,0,0,65,51,5,1,45,14,4,4,0,0,10,0,0,10,38233
12375,142,20,43,57,15,7,6,2,2,0,0,2,0,0,0,0,0,0,0,0,0,4,4,0,0,4,0,0,0,0,0,0,0,0,0,38235
12376,439,91,214,54,43,37,0,0,0,0,0,0,0,0,0,0,0,0,0,0,0,0,0,0,0,0,0,0,0,0,0,0,0,0,0,38236
12377,9072,1005,3040,2673,1667,687,1772,793,753,87,120,546,40,20,20,0,0,20,0,7,13,979,910,150,112,648,69,5,5,0,0,64,0,0,64,38237
12378,1661,374,766,346,131,44,157,85,65,4,0,61,20,20,12,0,8,0,0,0,0,72,51,13,0,38,21,21,0,0,21,0,0,0,0,38240
12379,773,208,295,180,81,9,1,1,0,0,0,0,1,1,0,1,0,0,0,0,0,0,0,0,0,0,0,0,0,0,0,0,0,0,0,38241
12380,13867,2492,5963,2972,1250,1190,786,416,210,0,54,156,206,155,14,83,58,51,12,29,10,370,262,77,66,119,108,94,14,43,37,14,0,14,0,38242
12381,2066,426,963,470,105,102,51,39,39,6,12,21,0,0,0,0,0,0,0,0,0,12,10,0,0,10,2,2,2,0,0,0,0,0,0,38251
12382,950,239,322,269,90,30,62,27,18,12,5,1,9,9,2,5,2,0,0,0,0,35,28,13,0,15,7,7,3,0,4,0,0,0,0,38253
12383,46,35,8,3,0,0,0,0,0,0,0,0,0,0,0,0,0,0,0,0,0,0,0,0,0,0,0,0,0,0,0,0,0,0,0,38254
12384,1721,330,759,395,186,51,89,44,41,2,5,34,3,3,0,3,0,0,0,0,0,45,45,28,0,17,0,0,0,0,0,0,0,0,0,38255
12385,2426,347,961,726,242,150,52,35,35,10,0,25,0,0,0,0,0,0,0,0,0,17,7,0,0,7,10,0,0,0,0,10,10,0,0,38256
12386,3169,511,1272,901,306,179,124,47,36,16,5,15,11,3,3,0,0,8,0,0,8,77,41,19,0,22,36,36,36,0,0,0,0,0,0,38257
12387,965,207,401,229,109,19,64,9,9,0,3,6,0,0,0,0,0,0,0,0,0,55,49,40,0,9,6,6,6,0,0,0,0,0,0,38258
12388,640,124,203,254,43,16,45,30,30,4,9,17,0,0,0,0,0,0,0,0,0,15,5,0,0,5,10,10,0,0,10,0,0,0,0,38259
12389,2432,421,1067,685,123,136,228,116,97,7,8,82,19,12,0,4,8,7,7,0,0,112,88,0,5,83,24,20,0,20,0,4,0,0,4,38260
12390,11428,2278,4481,2739,1109,821,712,299,169,33,30,106,130,86,66,13,7,44,18,0,26,413,345,71,88,186,68,66,0,49,17,2,0,0,2,38261
12391,23095,4697,9041,5841,2310,1206,2394,1335,1071,94,123,854,264,209,63,83,63,55,0,38,17,1059,967,196,93,678,92,74,47,17,10,18,0,18,0,38301
12392,32513,3078,9294,9338,6844,3959,3620,1638,1557,338,67,1152,81,69,39,22,8,12,12,0,0,1982,1850,681,143,1026,132,119,63,28,28,13,0,13,0,38305
12393,4360,1173,1675,991,357,164,216,99,70,8,31,31,29,17,0,14,3,12,12,0,0,117,83,4,0,79,34,13,6,7,0,21,21,0,0,38310
12394,691,64,288,159,65,115,21,14,14,0,0,14,0,0,0,0,0,0,0,0,0,7,7,0,0,7,0,0,0,0,0,0,0,0,0,38311
12395,2246,493,825,690,160,78,148,100,78,18,14,46,22,22,0,22,0,0,0,0,0,48,48,0,0,48,0,0,0,0,0,0,0,0,0,38313
12396,2519,491,1201,541,207,79,205,102,73,9,0,64,29,17,0,2,15,12,0,12,0,103,101,17,7,77,2,2,0,2,0,0,0,0,0,38315
12397,2432,445,1070,582,193,142,192,150,119,4,0,115,31,4,4,0,0,27,27,0,0,42,38,14,0,24,4,4,4,0,0,0,0,0,0,38316
12398,1856,470,754,406,162,64,238,132,107,16,3,88,25,4,4,0,0,21,21,0,0,106,90,31,0,59,16,8,0,8,0,8,0,0,8,38317
12399,307,96,97,85,17,12,21,6,0,0,0,0,6,6,0,0,6,0,0,0,0,15,0,0,0,0,15,15,0,0,15,0,0,0,0,38318
12400,7580,1622,3324,1812,454,368,561,289,240,48,46,146,49,49,35,2,12,0,0,0,0,272,224,85,30,109,48,48,40,0,8,0,0,0,0,38320
12401,1793,305,792,509,154,33,110,49,34,25,0,9,15,15,0,15,0,0,0,0,0,61,54,32,0,22,7,7,7,0,0,0,0,0,0,38321
12402,1938,213,842,566,211,106,53,48,20,9,0,11,28,28,28,0,0,0,0,0,0,5,5,0,0,5,0,0,0,0,0,0,0,0,0,38326
12403,320,98,128,86,8,0,27,23,3,0,0,3,20,10,7,3,0,10,3,0,7,4,4,0,0,4,0,0,0,0,0,0,0,0,0,38327
12404,494,119,188,137,31,19,31,0,0,0,0,0,0,0,0,0,0,0,0,0,0,31,31,19,0,12,0,0,0,0,0,0,0,0,0,38328
12405,2422,489,1107,565,166,95,183,121,116,26,0,90,5,5,0,0,5,0,0,0,0,62,43,0,0,43,19,19,16,0,3,0,0,0,0,38329
12406,3025,539,1223,873,296,94,282,164,98,9,0,89,66,63,0,22,41,3,0,3,0,118,110,39,13,58,8,8,8,0,0,0,0,0,0,38330
12407,1096,256,461,263,49,67,35,11,10,0,0,10,1,0,0,0,0,1,0,1,0,24,24,23,0,1,0,0,0,0,0,0,0,0,0,38332
12408,453,110,258,59,19,7,4,4,4,0,0,4,0,0,0,0,0,0,0,0,0,0,0,0,0,0,0,0,0,0,0,0,0,0,0,38333
12409,1299,315,577,247,78,82,30,10,10,0,1,9,0,0,0,0,0,0,0,0,0,20,17,0,0,17,3,0,0,0,0,3,0,0,3,38334
12410,902,167,431,188,63,53,76,62,48,2,4,42,14,14,10,4,0,0,0,0,0,14,14,3,0,11,0,0,0,0,0,0,0,0,0,38337
12411,390,42,220,90,16,22,19,3,3,0,0,3,0,0,0,0,0,0,0,0,0,16,16,0,0,16,0,0,0,0,0,0,0,0,0,38339
12412,8093,1397,2786,2529,740,641,1336,710,514,83,85,346,196,194,102,92,0,2,0,2,0,626,533,130,12,391,93,93,42,41,10,0,0,0,0,38340
12413,1787,389,666,520,116,96,41,22,17,0,0,17,5,5,5,0,0,0,0,0,0,19,19,0,0,19,0,0,0,0,0,0,0,0,0,38341
12414,924,291,410,136,59,28,122,81,50,0,2,48,31,31,0,0,31,0,0,0,0,41,41,5,0,36,0,0,0,0,0,0,0,0,0,38342
12415,11238,1982,4093,3414,1077,672,428,244,224,14,42,168,20,20,0,20,0,0,0,0,0,184,156,24,20,112,28,28,4,0,24,0,0,0,0,38343
12416,6101,1510,2388,1517,444,242,480,273,241,43,6,192,32,12,7,5,0,20,10,0,10,207,143,96,3,44,64,64,0,17,47,0,0,0,0,38344
12417,1353,235,609,302,207,0,169,52,42,0,0,42,10,10,0,10,0,0,0,0,0,117,99,99,0,0,18,18,18,0,0,0,0,0,0,38345
12418,93,60,10,23,0,0,0,0,0,0,0,0,0,0,0,0,0,0,0,0,0,0,0,0,0,0,0,0,0,0,0,0,0,0,0,38347
12419,860,108,326,238,96,92,66,31,19,19,0,0,12,12,0,0,12,0,0,0,0,35,10,0,0,10,25,0,0,0,0,25,0,0,25,38348
12420,12181,2072,5018,3389,984,718,936,616,562,108,13,441,54,0,0,0,0,54,0,36,18,320,306,63,11,232,14,14,0,14,0,0,0,0,0,38351
12421,331,54,159,107,11,0,20,20,10,0,0,10,10,10,10,0,0,0,0,0,0,0,0,0,0,0,0,0,0,0,0,0,0,0,0,38352
12422,3484,260,989,1062,819,354,251,102,58,13,0,45,44,44,44,0,0,0,0,0,0,149,138,7,0,131,11,6,6,0,0,5,0,5,0,38355
12423,1600,305,571,442,201,81,91,53,53,2,0,51,0,0,0,0,0,0,0,0,0,38,38,0,0,38,0,0,0,0,0,0,0,0,0,38356
12424,2122,573,913,476,131,29,95,17,17,4,5,8,0,0,0,0,0,0,0,0,0,78,44,8,0,36,34,26,0,26,0,8,0,0,8,38357
12425,7584,1015,2748,2235,1159,427,747,281,205,0,53,152,76,66,44,22,0,10,0,0,10,466,400,20,81,299,66,66,20,0,46,0,0,0,0,38358
12426,277,70,158,37,7,5,17,1,1,1,0,0,0,0,0,0,0,0,0,0,0,16,16,14,0,2,0,0,0,0,0,0,0,0,0,38359
12427,637,135,258,173,57,14,38,30,19,0,9,10,11,11,0,0,11,0,0,0,0,8,8,0,0,8,0,0,0,0,0,0,0,0,0,38361
12428,750,44,301,297,93,15,23,4,4,4,0,0,0,0,0,0,0,0,0,0,0,19,19,0,19,0,0,0,0,0,0,0,0,0,0,38362
12429,3926,954,1510,946,297,219,255,124,77,10,0,67,47,42,5,18,19,5,5,0,0,131,115,50,30,35,16,0,0,0,0,16,0,16,0,38363
12430,0,0,0,0,0,0,0,0,0,0,0,0,0,0,0,0,0,0,0,0,0,0,0,0,0,0,0,0,0,0,0,0,0,0,0,38365
12431,1476,214,755,284,79,144,94,21,21,0,0,21,0,0,0,0,0,0,0,0,0,73,73,19,0,54,0,0,0,0,0,0,0,0,0,38366
12432,1879,289,816,559,169,46,127,43,41,17,0,24,2,2,0,2,0,0,0,0,0,84,69,13,0,56,15,15,15,0,0,0,0,0,0,38367
12433,1123,388,489,174,45,27,16,6,6,0,0,6,0,0,0,0,0,0,0,0,0,10,10,0,0,10,0,0,0,0,0,0,0,0,0,38368
12434,1206,243,552,273,112,26,89,15,0,0,0,0,15,5,0,5,0,10,10,0,0,74,51,6,5,40,23,5,0,0,5,18,0,0,18,38369
12435,454,169,192,77,14,2,11,5,5,0,0,5,0,0,0,0,0,0,0,0,0,6,6,0,6,0,0,0,0,0,0,0,0,0,0,38370
12436,915,187,468,194,43,23,88,3,3,0,0,3,0,0,0,0,0,0,0,0,0,85,75,1,0,74,10,10,10,0,0,0,0,0,0,38371
12437,12113,2878,5345,2401,842,647,950,535,465,94,137,234,70,34,22,12,0,36,0,15,21,415,359,193,78,88,56,42,11,31,0,14,0,0,14,38372
12438,1412,248,575,441,86,62,50,17,12,4,0,8,5,3,0,3,0,2,0,0,2,33,27,0,0,27,6,3,0,0,3,3,0,3,0,38374
12439,6589,1528,2783,1497,561,220,561,333,214,58,35,121,119,78,67,11,0,41,0,41,0,228,226,2,104,120,2,2,0,0,2,0,0,0,0,38375
12440,137,16,72,49,0,0,8,8,0,0,0,0,8,8,0,0,8,0,0,0,0,0,0,0,0,0,0,0,0,0,0,0,0,0,0,38376
12441,912,131,447,205,113,16,40,9,9,1,4,4,0,0,0,0,0,0,0,0,0,31,29,14,11,4,2,2,0,2,0,0,0,0,0,38379
12442,557,136,302,50,47,22,34,14,14,14,0,0,0,0,0,0,0,0,0,0,0,20,20,0,4,16,0,0,0,0,0,0,0,0,0,38380
12443,1121,312,516,232,26,35,13,8,6,0,0,6,2,2,0,2,0,0,0,0,0,5,5,4,0,1,0,0,0,0,0,0,0,0,0,38381
12444,6452,1511,2650,1514,570,207,491,303,295,37,0,258,8,8,8,0,0,0,0,0,0,188,128,60,13,55,60,60,5,55,0,0,0,0,0,38382
12445,278,10,121,54,47,46,19,12,12,0,0,12,0,0,0,0,0,0,0,0,0,7,0,0,0,0,7,7,0,7,0,0,0,0,0,38387
12446,1190,331,487,233,108,31,48,15,14,1,11,2,1,1,0,0,1,0,0,0,0,33,7,0,0,7,26,2,0,0,2,24,11,0,13,38388
12447,685,162,289,170,53,11,27,0,0,0,0,0,0,0,0,0,0,0,0,0,0,27,27,15,0,12,0,0,0,0,0,0,0,0,0,38390
12448,914,136,295,399,64,20,69,39,39,0,17,22,0,0,0,0,0,0,0,0,0,30,30,11,16,3,0,0,0,0,0,0,0,0,0,38391
12449,394,96,158,122,18,0,52,28,28,4,0,24,0,0,0,0,0,0,0,0,0,24,24,8,0,16,0,0,0,0,0,0,0,0,0,38392
12450,36492,5470,13701,10985,4188,2148,2535,1314,1089,153,229,707,225,162,112,43,7,63,0,31,32,1221,952,272,74,606,269,208,172,30,6,61,14,12,35,38401
12451,2929,890,1372,562,84,21,100,77,65,18,0,47,12,12,0,0,12,0,0,0,0,23,19,2,0,17,4,4,0,0,4,0,0,0,0,38425
12452,2093,479,941,494,143,36,93,58,58,6,0,52,0,0,0,0,0,0,0,0,0,35,30,4,2,24,5,0,0,0,0,5,0,5,0,38449
12453,1790,498,690,532,35,35,208,128,122,0,19,103,6,6,0,0,6,0,0,0,0,80,40,0,0,40,40,40,40,0,0,0,0,0,0,38450
12454,3344,541,1559,991,182,71,376,179,179,15,0,164,0,0,0,0,0,0,0,0,0,197,197,135,0,62,0,0,0,0,0,0,0,0,0,38451
12455,697,176,288,170,24,39,42,22,10,10,0,0,12,0,0,0,0,12,12,0,0,20,20,7,0,13,0,0,0,0,0,0,0,0,0,38452
12456,275,50,119,56,38,12,7,7,7,7,0,0,0,0,0,0,0,0,0,0,0,0,0,0,0,0,0,0,0,0,0,0,0,0,0,38453
12457,918,240,337,194,105,42,11,0,0,0,0,0,0,0,0,0,0,0,0,0,0,11,0,0,0,0,11,0,0,0,0,11,0,0,11,38454
12458,98,20,29,24,23,2,0,0,0,0,0,0,0,0,0,0,0,0,0,0,0,0,0,0,0,0,0,0,0,0,0,0,0,0,0,38455
12459,2612,630,1224,593,97,68,183,91,24,6,0,18,67,0,0,0,0,67,67,0,0,92,39,26,0,13,53,0,0,0,0,53,10,0,43,38456
12460,530,66,238,140,60,26,38,9,9,0,9,0,0,0,0,0,0,0,0,0,0,29,29,7,0,22,0,0,0,0,0,0,0,0,0,38457
12461,357,62,146,73,47,29,0,0,0,0,0,0,0,0,0,0,0,0,0,0,0,0,0,0,0,0,0,0,0,0,0,0,0,0,0,38459
12462,903,140,389,308,50,16,72,53,45,8,25,12,8,8,8,0,0,0,0,0,0,19,19,19,0,0,0,0,0,0,0,0,0,0,0,38460
12463,940,209,339,337,51,4,84,66,49,20,0,29,17,0,0,0,0,17,0,0,17,18,18,0,9,9,0,0,0,0,0,0,0,0,0,38461
12464,6926,1582,2876,1688,532,248,604,296,193,11,37,145,103,98,52,23,23,5,0,0,5,308,256,91,11,154,52,52,0,33,19,0,0,0,0,38462
12465,1922,433,830,437,101,121,127,77,29,0,13,16,48,32,0,32,0,16,4,0,12,50,43,25,4,14,7,1,1,0,0,6,0,0,6,38463
12466,14974,3061,6060,3816,1280,757,1165,578,403,72,65,266,175,107,33,64,10,68,42,0,26,587,463,195,50,218,124,80,38,17,25,44,20,0,24,38464
12467,3619,693,1739,754,257,176,220,131,116,16,25,75,15,15,15,0,0,0,0,0,0,89,60,25,0,35,29,29,19,10,0,0,0,0,0,38468
12468,2684,661,1119,556,245,103,169,99,79,23,2,54,20,16,16,0,0,4,0,4,0,70,58,16,11,31,12,12,10,2,0,0,0,0,0,38469
12469,401,119,230,52,0,0,25,0,0,0,0,0,0,0,0,0,0,0,0,0,0,25,9,0,9,0,16,16,0,0,16,0,0,0,0,38471
12470,2000,259,911,497,215,118,81,34,34,0,19,15,0,0,0,0,0,0,0,0,0,47,33,0,0,33,14,14,4,3,7,0,0,0,0,38472
12471,652,126,289,160,55,22,48,14,8,0,8,0,6,6,6,0,0,0,0,0,0,34,32,7,0,25,2,2,0,0,2,0,0,0,0,38473
12472,5640,1100,2578,1327,431,204,500,364,312,95,0,217,52,52,52,0,0,0,0,0,0,136,100,0,16,84,36,15,0,0,15,21,21,0,0,38474
12473,434,149,175,73,19,18,75,23,10,0,0,10,13,0,0,0,0,13,13,0,0,52,34,17,0,17,18,0,0,0,0,18,0,0,18,38475
12474,774,125,290,240,90,29,11,11,11,0,0,11,0,0,0,0,0,0,0,0,0,0,0,0,0,0,0,0,0,0,0,0,0,0,0,38476
12475,2122,431,987,471,166,67,132,61,43,26,6,11,18,18,18,0,0,0,0,0,0,71,61,0,4,57,10,10,6,4,0,0,0,0,0,38477
12476,12141,2459,4691,3019,1185,787,1141,600,549,71,76,402,51,31,13,0,18,20,0,6,14,541,468,72,27,369,73,47,47,0,0,26,0,0,26,38478
12477,680,160,331,159,22,8,10,5,2,0,0,2,3,0,0,0,0,3,0,2,1,5,5,0,0,5,0,0,0,0,0,0,0,0,0,38481
12478,1080,190,472,278,126,14,86,36,29,0,0,29,7,7,0,7,0,0,0,0,0,50,45,45,0,0,5,5,0,5,0,0,0,0,0,38482
12479,3823,696,1647,1016,300,164,300,185,154,10,30,114,31,20,0,5,15,11,11,0,0,115,115,27,0,88,0,0,0,0,0,0,0,0,0,38483
12480,5048,1041,2402,1100,345,160,188,73,73,8,2,63,0,0,0,0,0,0,0,0,0,115,53,6,0,47,62,62,62,0,0,0,0,0,0,38485
12481,591,161,275,108,35,12,16,9,5,0,0,5,4,4,0,4,0,0,0,0,0,7,7,0,0,7,0,0,0,0,0,0,0,0,0,38486
12482,444,96,171,144,18,15,87,57,32,10,0,22,25,7,0,0,7,18,18,0,0,30,30,8,0,22,0,0,0,0,0,0,0,0,0,38487
12483,1739,267,663,452,223,134,145,79,63,20,0,43,16,0,0,0,0,16,16,0,0,66,66,16,18,32,0,0,0,0,0,0,0,0,0,38488
12484,23442,3698,8542,5604,3344,2254,2166,1101,839,183,25,631,262,257,139,108,10,5,0,0,5,1065,923,192,80,651,142,89,29,22,38,53,25,0,28,38501
12485,830,291,315,63,97,64,49,0,0,0,0,0,0,0,0,0,0,0,0,0,0,49,49,49,0,0,0,0,0,0,0,0,0,0,0,38504
12486,0,0,0,0,0,0,1274,740,740,0,62,678,0,0,0,0,0,0,0,0,0,534,534,11,38,485,0,0,0,0,0,0,0,0,0,38505
12487,18248,2942,6757,4055,3023,1471,961,516,443,146,51,246,73,27,4,8,15,46,0,0,46,445,418,88,0,330,27,27,14,13,0,0,0,0,0,38506
12488,1112,300,462,246,47,57,70,37,19,0,19,0,18,10,0,0,10,8,0,0,8,33,33,4,0,29,0,0,0,0,0,0,0,0,0,38541
12489,26,0,17,9,0,0,0,0,0,0,0,0,0,0,0,0,0,0,0,0,0,0,0,0,0,0,0,0,0,0,0,0,0,0,0,38542
12490,357,75,184,64,34,0,12,6,6,0,0,6,0,0,0,0,0,0,0,0,0,6,6,0,0,6,0,0,0,0,0,0,0,0,0,38543
12491,4743,1069,2085,1007,376,206,419,160,146,38,0,108,14,9,2,7,0,5,5,0,0,259,161,64,8,89,98,81,40,39,2,17,0,5,12,38544
12492,832,183,377,175,47,50,95,71,71,6,6,59,0,0,0,0,0,0,0,0,0,24,24,0,10,14,0,0,0,0,0,0,0,0,0,38545
12493,1178,181,578,237,120,62,88,41,34,0,0,34,7,7,0,7,0,0,0,0,0,47,38,9,0,29,9,9,0,0,9,0,0,0,0,38547
12494,394,93,200,81,20,0,36,26,22,0,12,10,4,4,0,4,0,0,0,0,0,10,10,0,0,10,0,0,0,0,0,0,0,0,0,38548
12495,2813,651,1139,652,167,204,113,56,53,8,0,45,3,3,2,1,0,0,0,0,0,57,48,5,2,41,9,9,0,0,9,0,0,0,0,38549
12496,2877,766,1209,499,186,217,118,61,36,7,18,11,25,8,0,0,8,17,0,0,17,57,57,7,0,50,0,0,0,0,0,0,0,0,0,38551
12497,311,105,131,24,22,29,119,78,65,28,6,31,13,13,7,0,6,0,0,0,0,41,41,5,0,36,0,0,0,0,0,0,0,0,0,38552
12498,1744,434,756,288,175,91,141,80,60,0,0,60,20,20,20,0,0,0,0,0,0,61,52,17,0,35,9,9,0,9,0,0,0,0,0,38553
12499,676,244,291,120,21,0,25,25,25,9,8,8,0,0,0,0,0,0,0,0,0,0,0,0,0,0,0,0,0,0,0,0,0,0,0,38554
12500,13539,2830,4477,3793,1634,805,1045,447,369,76,86,207,78,43,0,35,8,35,0,0,35,598,449,147,15,287,149,149,58,0,91,0,0,0,0,38555
12501,8348,2370,3700,1413,632,233,569,329,266,24,39,203,63,63,42,0,21,0,0,0,0,240,204,66,8,130,36,28,23,5,0,8,8,0,0,38556
12502,6938,280,2043,2183,1350,1082,81,24,24,0,0,24,0,0,0,0,0,0,0,0,0,57,25,25,0,0,32,32,21,0,11,0,0,0,0,38558
12503,965,202,544,143,45,31,109,45,36,0,5,31,9,9,2,7,0,0,0,0,0,64,44,17,0,27,20,20,20,0,0,0,0,0,0,38559
12504,893,143,504,163,56,27,85,65,61,6,0,55,4,0,0,0,0,4,0,0,4,20,20,6,0,14,0,0,0,0,0,0,0,0,0,38560
12505,4597,1383,2078,739,226,171,304,105,68,0,4,64,37,37,37,0,0,0,0,0,0,199,138,0,0,138,61,61,22,0,39,0,0,0,0,38562
12506,1688,363,774,369,127,55,128,61,52,7,0,45,9,3,0,3,0,6,6,0,0,67,64,0,14,50,3,0,0,0,0,3,0,0,3,38563
12507,306,91,144,44,27,0,4,4,0,0,0,0,4,4,0,0,4,0,0,0,0,0,0,0,0,0,0,0,0,0,0,0,0,0,0,38564
12508,842,203,442,163,10,24,84,31,31,0,0,31,0,0,0,0,0,0,0,0,0,53,53,0,0,53,0,0,0,0,0,0,0,0,0,38565
12509,673,70,284,199,39,81,40,0,0,0,0,0,0,0,0,0,0,0,0,0,0,40,10,0,0,10,30,0,0,0,0,30,30,0,0,38567
12510,1732,426,910,223,89,84,123,55,18,0,0,18,37,37,37,0,0,0,0,0,0,68,68,0,8,60,0,0,0,0,0,0,0,0,0,38568
12511,228,34,90,50,31,23,30,14,14,0,0,14,0,0,0,0,0,0,0,0,0,16,16,0,0,16,0,0,0,0,0,0,0,0,0,38569
12512,6742,1671,2510,1526,635,400,415,267,236,51,47,138,31,31,23,0,8,0,0,0,0,148,118,29,14,75,30,30,10,13,7,0,0,0,0,38570
12513,9826,2240,4298,2005,815,468,431,273,201,18,23,160,72,60,18,42,0,12,0,0,12,158,149,59,5,85,9,9,0,9,0,0,0,0,0,38571
12514,7759,1447,3523,1968,522,299,453,297,195,57,31,107,102,102,12,0,90,0,0,0,0,156,123,29,7,87,33,33,0,25,8,0,0,0,0,38572
12515,1489,341,703,349,55,41,235,30,30,17,0,13,0,0,0,0,0,0,0,0,0,205,136,57,0,79,69,69,29,0,40,0,0,0,0,38573
12516,5995,1656,2574,1313,322,130,261,176,155,37,5,113,21,21,4,0,17,0,0,0,0,85,43,5,5,33,42,28,9,19,0,14,0,0,14,38574
12517,865,251,349,123,31,111,121,18,18,0,0,18,0,0,0,0,0,0,0,0,0,103,82,39,0,43,21,0,0,0,0,21,0,0,21,38575
12518,706,96,305,139,74,92,16,16,16,0,0,16,0,0,0,0,0,0,0,0,0,0,0,0,0,0,0,0,0,0,0,0,0,0,0,38577
12519,134,32,38,20,8,36,0,0,0,0,0,0,0,0,0,0,0,0,0,0,0,0,0,0,0,0,0,0,0,0,0,0,0,0,0,38578
12520,692,240,370,63,12,7,98,40,26,0,0,26,14,14,0,14,0,0,0,0,0,58,54,0,0,54,4,0,0,0,0,4,0,0,4,38579
12521,1164,190,456,365,98,55,146,72,47,20,0,27,25,25,0,0,25,0,0,0,0,74,74,0,0,74,0,0,0,0,0,0,0,0,0,38580
12522,2895,414,1543,586,185,167,223,129,71,35,0,36,58,30,5,0,25,28,16,0,12,94,94,5,0,89,0,0,0,0,0,0,0,0,0,38581
12523,1066,178,444,213,106,125,83,43,43,8,35,0,0,0,0,0,0,0,0,0,0,40,40,0,0,40,0,0,0,0,0,0,0,0,0,38582
12524,16773,3520,7819,3472,1124,838,1074,563,433,94,46,293,130,103,59,0,44,27,0,18,9,511,441,81,118,242,70,57,0,36,21,13,0,13,0,38583
12525,2633,623,1361,427,118,104,157,64,56,2,5,49,8,8,0,8,0,0,0,0,0,93,54,6,16,32,39,18,0,0,18,21,0,0,21,38585
12526,913,177,486,160,82,8,13,13,13,0,0,13,0,0,0,0,0,0,0,0,0,0,0,0,0,0,0,0,0,0,0,0,0,0,0,38587
12527,714,126,347,92,118,31,15,0,0,0,0,0,0,0,0,0,0,0,0,0,0,15,7,0,0,7,8,8,8,0,0,0,0,0,0,38588
12528,148,84,30,34,0,0,31,31,31,0,0,31,0,0,0,0,0,0,0,0,0,0,0,0,0,0,0,0,0,0,0,0,0,0,0,38589
12529,2071,729,651,478,154,59,133,44,39,38,0,1,5,3,0,0,3,2,0,0,2,89,89,23,0,66,0,0,0,0,0,0,0,0,0,38601
12530,2263,641,662,671,154,135,144,45,45,2,0,43,0,0,0,0,0,0,0,0,0,99,99,11,11,77,0,0,0,0,0,0,0,0,0,38603
12531,9369,2335,2583,2646,1340,465,982,456,290,26,20,244,166,77,17,0,60,89,0,0,89,526,375,99,70,206,151,41,0,0,41,110,14,0,96,38606
12532,2242,680,715,620,166,61,339,154,138,23,17,98,16,5,4,0,1,11,11,0,0,185,167,56,32,79,18,18,3,0,15,0,0,0,0,38610
12533,10712,2694,3901,3089,835,193,761,371,227,23,29,175,144,77,20,57,0,67,0,31,36,390,338,67,41,230,52,0,0,0,0,52,3,0,49,38611
12534,11812,2595,3276,3784,1527,630,1163,618,492,47,51,394,126,120,31,39,50,6,0,0,6,545,395,22,40,333,150,68,27,25,16,82,10,25,47,38614
12535,570,160,214,147,26,23,68,32,28,0,0,28,4,0,0,0,0,4,0,0,4,36,30,2,0,28,6,3,0,3,0,3,0,0,3,38617
12536,7772,1735,2721,2477,651,188,470,298,277,72,68,137,21,0,0,0,0,21,4,8,9,172,117,61,0,56,55,10,10,0,0,45,0,0,45,38618
12537,4192,1345,1732,916,130,69,90,78,69,7,0,62,9,0,0,0,0,9,9,0,0,12,12,0,0,12,0,0,0,0,0,0,0,0,0,38619
12538,2726,709,903,786,218,110,143,117,61,1,27,33,56,44,0,44,0,12,10,2,0,26,26,4,0,22,0,0,0,0,0,0,0,0,0,38620
12539,1046,348,284,306,68,40,156,90,44,0,0,44,46,0,0,0,0,46,0,0,46,66,33,0,0,33,33,0,0,0,0,33,0,0,33,38621
12540,377,122,120,130,0,5,21,15,3,0,0,3,12,12,12,0,0,0,0,0,0,6,2,0,0,2,4,0,0,0,0,4,0,4,0,38622
12541,174,34,62,61,17,0,0,0,0,0,0,0,0,0,0,0,0,0,0,0,0,0,0,0,0,0,0,0,0,0,0,0,0,0,0,38623
12542,593,100,207,171,30,85,27,4,4,0,1,3,0,0,0,0,0,0,0,0,0,23,23,0,0,23,0,0,0,0,0,0,0,0,0,38625
12543,744,261,179,119,159,26,128,118,118,0,0,118,0,0,0,0,0,0,0,0,0,10,10,0,0,10,0,0,0,0,0,0,0,0,0,38626
12544,683,157,262,89,142,33,64,32,32,0,0,32,0,0,0,0,0,0,0,0,0,32,32,0,0,32,0,0,0,0,0,0,0,0,0,38627
12545,1497,437,577,353,73,57,229,190,106,0,4,102,84,49,0,49,0,35,0,0,35,39,39,35,0,4,0,0,0,0,0,0,0,0,0,38629
12546,148,35,52,53,8,0,21,21,21,0,0,21,0,0,0,0,0,0,0,0,0,0,0,0,0,0,0,0,0,0,0,0,0,0,0,38630
12547,585,173,135,216,42,19,43,27,27,0,0,27,0,0,0,0,0,0,0,0,0,16,16,0,0,16,0,0,0,0,0,0,0,0,0,38631
12548,16938,1681,4776,6228,3035,1218,1459,623,527,124,42,361,96,81,48,18,15,15,0,0,15,836,738,176,15,547,98,76,65,0,11,22,22,0,0,38632
12549,1735,459,693,471,98,14,260,92,42,0,33,9,50,42,0,33,9,8,0,0,8,168,148,22,0,126,20,20,0,0,20,0,0,0,0,38633
12550,11126,2999,4181,2437,1197,312,939,315,283,17,49,217,32,32,0,32,0,0,0,0,0,624,553,37,156,360,71,71,31,40,0,0,0,0,0,38635
12551,15779,2726,5295,5828,1458,472,1768,1027,758,118,79,561,269,211,46,52,113,58,38,0,20,741,564,134,38,392,177,126,0,78,48,51,0,30,21,38637
12552,631,202,132,260,37,0,102,53,48,0,4,44,5,0,0,0,0,5,0,5,0,49,49,0,0,49,0,0,0,0,0,0,0,0,0,38639
12553,1931,183,870,624,207,47,123,44,43,23,0,20,1,0,0,0,0,1,0,0,1,79,79,19,0,60,0,0,0,0,0,0,0,0,0,38641
12554,1354,243,716,339,56,0,96,47,47,0,0,47,0,0,0,0,0,0,0,0,0,49,49,0,10,39,0,0,0,0,0,0,0,0,0,38642
12555,1428,480,364,446,118,20,150,43,43,0,8,35,0,0,0,0,0,0,0,0,0,107,100,0,0,100,7,7,0,0,7,0,0,0,0,38643
12556,143,44,16,32,51,0,58,44,44,0,0,44,0,0,0,0,0,0,0,0,0,14,14,0,0,14,0,0,0,0,0,0,0,0,0,38644
12557,1061,252,227,400,135,47,216,86,86,0,0,86,0,0,0,0,0,0,0,0,0,130,124,43,0,81,6,0,0,0,0,6,0,0,6,38645
12558,2257,643,554,598,311,151,179,99,41,2,8,31,58,0,0,0,0,58,0,0,58,80,67,7,0,60,13,0,0,0,0,13,0,0,13,38646
12559,869,346,271,138,53,61,48,5,5,0,0,5,0,0,0,0,0,0,0,0,0,43,43,0,0,43,0,0,0,0,0,0,0,0,0,38647
12560,2560,586,980,743,202,49,219,65,43,0,27,16,22,9,0,0,9,13,0,13,0,154,125,30,0,95,29,29,0,29,0,0,0,0,0,38650
12561,4888,707,1593,1747,583,258,367,195,178,16,47,115,17,0,0,0,0,17,0,0,17,172,172,64,28,80,0,0,0,0,0,0,0,0,0,38651
12562,10745,2632,3272,3112,1049,680,689,328,302,28,31,243,26,22,0,22,0,4,4,0,0,361,342,69,10,263,19,9,0,9,0,10,0,0,10,38652
12563,30909,2562,9439,10481,5855,2572,2822,1374,1146,304,98,744,228,154,80,74,0,74,34,0,40,1448,1295,342,217,736,153,73,0,56,17,80,0,10,70,38654
12564,21559,2045,4164,5950,5139,4261,2288,1043,996,301,76,619,47,13,0,0,13,34,7,0,27,1245,1192,386,40,766,53,53,0,0,53,0,0,0,0,38655
12565,1221,186,431,398,130,76,13,2,0,0,0,0,2,2,2,0,0,0,0,0,0,11,11,5,6,0,0,0,0,0,0,0,0,0,0,38658
12566,1548,468,625,370,37,48,84,20,17,0,0,17,3,1,0,1,0,2,0,2,0,64,62,0,0,62,2,2,0,2,0,0,0,0,0,38659
12567,1356,240,622,335,125,34,179,108,108,0,0,108,0,0,0,0,0,0,0,0,0,71,71,0,71,0,0,0,0,0,0,0,0,0,0,38661
12568,7611,1465,2838,2330,494,484,469,264,243,64,49,130,21,21,12,9,0,0,0,0,0,205,149,10,27,112,56,44,44,0,0,12,0,0,12,38663
12569,2044,231,465,922,306,120,195,109,75,0,5,70,34,0,0,0,0,34,13,0,21,86,86,0,0,86,0,0,0,0,0,0,0,0,0,38664
12570,1467,288,519,552,70,38,145,81,76,0,0,76,5,0,0,0,0,5,0,5,0,64,64,0,0,64,0,0,0,0,0,0,0,0,0,38665
12571,4475,1037,1555,1413,384,86,371,254,252,0,0,252,2,2,0,2,0,0,0,0,0,117,109,39,18,52,8,8,0,0,8,0,0,0,0,38666
12572,9119,1699,2504,3047,1194,675,1217,583,516,81,14,421,67,17,17,0,0,50,0,18,32,634,616,157,40,419,18,12,0,12,0,6,0,0,6,38668
12573,667,257,154,167,84,5,72,38,25,0,0,25,13,13,0,8,5,0,0,0,0,34,34,0,0,34,0,0,0,0,0,0,0,0,0,38670
12574,22393,2875,6970,8715,2935,898,1797,1028,812,139,94,579,216,181,96,76,9,35,35,0,0,769,724,287,111,326,45,19,19,0,0,26,0,0,26,38671
12575,7687,443,1676,3019,1694,855,450,141,141,41,32,68,0,0,0,0,0,0,0,0,0,309,309,89,32,188,0,0,0,0,0,0,0,0,0,38672
12576,445,45,163,200,25,12,60,0,0,0,0,0,0,0,0,0,0,0,0,0,0,60,60,0,24,36,0,0,0,0,0,0,0,0,0,38673
12577,737,209,281,217,30,0,25,15,15,15,0,0,0,0,0,0,0,0,0,0,0,10,10,0,0,10,0,0,0,0,0,0,0,0,0,38674
12578,3952,1062,1381,1003,389,117,268,83,55,0,8,47,28,7,0,0,7,21,0,0,21,185,107,0,0,107,78,78,54,0,24,0,0,0,0,38676
12579,166,33,0,14,14,105,3526,1810,1810,134,80,1596,0,0,0,0,0,0,0,0,0,1716,1716,212,155,1349,0,0,0,0,0,0,0,0,0,38677
12580,3337,559,1071,1241,331,135,225,199,149,6,20,123,50,1,0,0,1,49,0,35,14,26,24,18,0,6,2,2,0,2,0,0,0,0,0,38680
12581,3473,1123,1204,892,187,67,240,116,106,2,0,104,10,10,10,0,0,0,0,0,0,124,98,0,8,90,26,11,11,0,0,15,15,0,0,38683
12582,626,149,309,93,23,52,86,13,13,0,0,13,0,0,0,0,0,0,0,0,0,73,73,15,0,58,0,0,0,0,0,0,0,0,0,38685
12583,15445,3619,4192,4513,2172,949,1282,693,516,6,75,435,177,109,0,97,12,68,0,49,19,589,512,50,95,367,77,65,16,19,30,12,0,0,12,38701
12584,0,0,0,0,0,0,0,0,0,0,0,0,0,0,0,0,0,0,0,0,0,0,0,0,0,0,0,0,0,0,0,0,0,0,0,38702
12585,8284,2101,2685,2248,806,444,740,305,232,9,82,141,73,40,0,30,10,33,0,28,5,435,367,0,141,226,68,40,0,8,32,28,0,12,16,38703
12586,6,0,6,0,0,0,0,0,0,0,0,0,0,0,0,0,0,0,0,0,0,0,0,0,0,0,0,0,0,0,0,0,0,0,0,38704
12587,414,125,159,104,26,0,35,12,4,0,0,4,8,8,0,4,4,0,0,0,0,23,23,0,0,23,0,0,0,0,0,0,0,0,0,38720
12588,653,111,151,176,168,47,89,45,32,0,8,24,13,11,11,0,0,2,0,0,2,44,44,0,10,34,0,0,0,0,0,0,0,0,0,38721
12589,337,104,66,115,28,24,31,20,20,4,0,16,0,0,0,0,0,0,0,0,0,11,7,0,2,5,4,4,0,4,0,0,0,0,0,38722
12590,5,0,5,0,0,0,0,0,0,0,0,0,0,0,0,0,0,0,0,0,0,0,0,0,0,0,0,0,0,0,0,0,0,0,0,38723
12591,531,256,83,106,45,41,30,14,14,0,0,14,0,0,0,0,0,0,0,0,0,16,10,4,0,6,6,6,0,2,4,0,0,0,0,38725
12592,233,39,94,92,5,3,24,15,11,0,0,11,4,2,0,2,0,2,0,2,0,9,7,0,0,7,2,2,0,2,0,0,0,0,0,38726
12593,1105,253,330,317,156,49,111,45,22,0,7,15,23,23,23,0,0,0,0,0,0,66,28,23,0,5,38,5,0,0,5,33,0,7,26,38730
12594,101,0,0,64,0,37,0,0,0,0,0,0,0,0,0,0,0,0,0,0,0,0,0,0,0,0,0,0,0,0,0,0,0,0,0,38731
12595,11023,2225,2774,3086,1822,1116,1305,661,462,110,26,326,199,138,18,14,106,61,13,0,48,644,544,129,47,368,100,65,0,31,34,35,0,35,0,38732
12596,250,34,47,140,26,3,21,18,12,0,0,12,6,6,0,0,6,0,0,0,0,3,3,0,0,3,0,0,0,0,0,0,0,0,0,38736
12597,2518,901,787,629,151,50,157,105,79,5,0,74,26,20,20,0,0,6,0,6,0,52,47,14,0,33,5,5,5,0,0,0,0,0,0,38737
12598,2489,981,917,554,32,5,0,0,0,0,0,0,0,0,0,0,0,0,0,0,0,0,0,0,0,0,0,0,0,0,0,0,0,0,0,38738
12599,284,92,88,62,31,11,2,2,0,0,0,0,2,2,0,2,0,0,0,0,0,0,0,0,0,0,0,0,0,0,0,0,0,0,0,38740
12600,514,149,158,141,66,0,108,27,0,0,0,0,27,0,0,0,0,27,0,0,27,81,81,0,0,81,0,0,0,0,0,0,0,0,0,38744
12601,87,56,10,18,3,0,0,0,0,0,0,0,0,0,0,0,0,0,0,0,0,0,0,0,0,0,0,0,0,0,0,0,0,0,0,38745
12602,412,225,102,57,9,19,26,12,12,7,5,0,0,0,0,0,0,0,0,0,0,14,14,0,0,14,0,0,0,0,0,0,0,0,0,38746
12603,2504,658,859,535,324,128,377,241,211,41,70,100,30,22,0,5,17,8,0,8,0,136,122,0,6,116,14,14,14,0,0,0,0,0,0,38748
12604,16,0,7,9,0,0,0,0,0,0,0,0,0,0,0,0,0,0,0,0,0,0,0,0,0,0,0,0,0,0,0,0,0,0,0,38749
12605,7077,1669,1889,2200,740,579,880,452,349,71,11,267,103,90,12,78,0,13,13,0,0,428,365,47,8,310,63,40,3,20,17,23,6,17,0,38751
12606,818,256,192,235,100,35,45,18,18,0,8,10,0,0,0,0,0,0,0,0,0,27,27,2,6,19,0,0,0,0,0,0,0,0,0,38753
12607,1077,467,274,240,76,20,93,31,22,0,6,16,9,3,0,0,3,6,0,0,6,62,62,0,2,60,0,0,0,0,0,0,0,0,0,38754
12608,4204,1029,1095,1139,706,235,487,247,216,0,8,208,31,15,0,14,1,16,0,12,4,240,183,17,17,149,57,42,0,0,42,15,0,0,15,38756
12609,767,140,243,151,131,102,67,19,19,0,0,19,0,0,0,0,0,0,0,0,0,48,44,13,2,29,4,4,4,0,0,0,0,0,0,38759
12610,570,163,191,153,54,9,83,42,35,0,6,29,7,7,0,0,7,0,0,0,0,41,41,0,23,18,0,0,0,0,0,0,0,0,0,38760
12611,1374,445,407,416,64,42,324,172,142,17,7,118,30,16,0,16,0,14,0,14,0,152,144,34,22,88,8,0,0,0,0,8,0,8,0,38761
12612,1427,307,323,463,181,153,154,49,49,0,0,49,0,0,0,0,0,0,0,0,0,105,99,9,9,81,6,6,0,6,0,0,0,0,0,38762
12613,242,66,108,59,9,0,25,19,19,0,0,19,0,0,0,0,0,0,0,0,0,6,6,0,0,6,0,0,0,0,0,0,0,0,0,38764
12614,16,0,16,0,0,0,0,0,0,0,0,0,0,0,0,0,0,0,0,0,0,0,0,0,0,0,0,0,0,0,0,0,0,0,0,38765
12615,80,49,0,23,8,0,16,16,16,0,0,16,0,0,0,0,0,0,0,0,0,0,0,0,0,0,0,0,0,0,0,0,0,0,0,38767
12616,90,0,43,47,0,0,0,0,0,0,0,0,0,0,0,0,0,0,0,0,0,0,0,0,0,0,0,0,0,0,0,0,0,0,0,38768
12617,1531,481,465,413,146,26,137,44,42,0,4,38,2,0,0,0,0,2,0,0,2,93,67,4,6,57,26,15,2,0,13,11,0,0,11,38769
12618,1977,701,325,566,217,168,82,12,12,0,0,12,0,0,0,0,0,0,0,0,0,70,59,0,0,59,11,11,0,0,11,0,0,0,0,38771
12619,145,68,35,21,21,0,3,0,0,0,0,0,0,0,0,0,0,0,0,0,0,3,0,0,0,0,3,3,0,3,0,0,0,0,0,38772
12620,2458,775,682,734,253,14,302,183,171,4,6,161,12,12,0,0,12,0,0,0,0,119,106,13,0,93,13,13,0,6,7,0,0,0,0,38773
12621,1521,611,310,341,195,64,162,93,93,0,0,93,0,0,0,0,0,0,0,0,0,69,49,0,0,49,20,20,0,0,20,0,0,0,0,38774
12622,966,393,229,256,62,26,67,32,18,0,0,18,14,0,0,0,0,14,0,0,14,35,27,3,10,14,8,3,0,3,0,5,5,0,0,38778
12623,164,56,44,54,10,0,0,0,0,0,0,0,0,0,0,0,0,0,0,0,0,0,0,0,0,0,0,0,0,0,0,0,0,0,0,38781
12624,18382,2799,5438,5975,2641,1529,1818,934,679,103,57,519,255,113,48,0,65,142,9,78,55,884,756,113,21,622,128,110,101,0,9,18,0,0,18,38801
12625,12050,1727,3360,3484,2219,1260,1048,591,410,135,41,234,181,87,46,0,41,94,0,0,94,457,332,127,0,205,125,54,0,18,36,71,0,0,71,38804
12626,8475,1744,2983,2597,742,409,747,358,299,39,39,221,59,58,33,10,15,1,0,0,1,389,296,88,11,197,93,70,34,32,4,23,0,23,0,38821
12627,5883,1681,1955,1514,411,322,297,144,100,0,16,84,44,0,0,0,0,44,17,0,27,153,131,12,0,119,22,7,3,0,4,15,15,0,0,38824
12628,3136,559,812,1118,376,271,272,140,135,28,24,83,5,0,0,0,0,5,0,0,5,132,132,68,0,64,0,0,0,0,0,0,0,0,0,38826
12629,1554,375,643,407,70,59,180,93,81,24,0,57,12,0,0,0,0,12,0,0,12,87,63,10,4,49,24,20,0,0,20,4,4,0,0,38827
12630,3080,709,1209,834,202,126,258,157,144,63,13,68,13,0,0,0,0,13,13,0,0,101,60,18,0,42,41,41,0,0,41,0,0,0,0,38828
12631,11674,2944,4122,3224,853,531,1427,815,721,128,51,542,94,34,0,21,13,60,0,0,60,612,523,78,19,426,89,84,1,64,19,5,0,0,5,38829
12632,2098,620,827,550,69,32,138,59,26,0,0,26,33,9,2,7,0,24,20,2,2,79,56,4,13,39,23,23,11,0,12,0,0,0,0,38833
12633,19980,3956,6827,5408,2611,1178,1588,860,616,266,54,296,244,153,118,23,12,91,44,47,0,728,647,287,36,324,81,27,13,0,14,54,0,9,45,38834
12634,987,226,391,251,95,24,29,15,15,7,0,8,0,0,0,0,0,0,0,0,0,14,14,0,0,14,0,0,0,0,0,0,0,0,0,38838
12635,1665,333,636,569,86,41,202,158,127,95,6,26,31,12,12,0,0,19,19,0,0,44,23,2,0,21,21,0,0,0,0,21,0,0,21,38841
12636,7449,1744,2135,2373,708,489,1038,527,418,92,21,305,109,106,12,24,70,3,0,0,3,511,468,74,41,353,43,0,0,0,0,43,0,0,43,38843
12637,139,28,79,32,0,0,6,6,4,0,0,4,2,2,2,0,0,0,0,0,0,0,0,0,0,0,0,0,0,0,0,0,0,0,0,38844
12638,1742,359,667,503,161,52,105,78,62,18,0,44,16,16,6,0,10,0,0,0,0,27,27,0,0,27,0,0,0,0,0,0,0,0,0,38846
12639,2141,458,803,617,214,49,300,192,145,9,0,136,47,31,3,28,0,16,0,0,16,108,77,28,0,49,31,0,0,0,0,31,0,0,31,38847
12640,493,116,255,82,23,17,35,26,0,0,0,0,26,26,26,0,0,0,0,0,0,9,9,0,0,9,0,0,0,0,0,0,0,0,0,38848
12641,3916,1035,1110,1059,445,267,215,102,49,0,0,49,53,53,26,0,27,0,0,0,0,113,82,20,7,55,31,2,2,0,0,29,0,0,29,38849
12642,1816,497,685,521,66,47,101,67,34,0,0,34,33,19,0,8,11,14,0,4,10,34,20,8,0,12,14,14,1,6,7,0,0,0,0,38850
12643,5390,1513,1873,1332,488,184,515,210,154,31,5,118,56,56,55,0,1,0,0,0,0,305,237,54,70,113,68,17,10,0,7,51,0,12,39,38851
12644,6643,1502,2299,1934,535,373,321,184,159,32,17,110,25,18,8,10,0,7,7,0,0,137,124,26,21,77,13,0,0,0,0,13,13,0,0,38852
12645,3036,687,998,863,273,215,318,161,143,16,0,127,18,18,11,0,7,0,0,0,0,157,142,45,5,92,15,15,6,0,9,0,0,0,0,38855
12646,1248,327,340,484,56,41,137,70,45,26,0,19,25,0,0,0,0,25,25,0,0,67,31,31,0,0,36,1,1,0,0,35,0,0,35,38856
12647,2130,483,543,855,159,90,251,176,124,107,0,17,52,52,52,0,0,0,0,0,0,75,75,58,17,0,0,0,0,0,0,0,0,0,0,38857
12648,5203,1263,2012,1383,336,209,411,236,150,5,8,137,86,79,19,37,23,7,0,0,7,175,143,64,5,74,32,8,0,0,8,24,0,9,15,38858
12649,365,148,67,118,0,32,39,18,0,0,0,0,18,0,0,0,0,18,0,0,18,21,21,0,0,21,0,0,0,0,0,0,0,0,0,38859
12650,3854,1150,1396,1012,215,81,243,100,78,0,0,78,22,13,13,0,0,9,0,0,9,143,128,47,0,81,15,8,0,0,8,7,0,0,7,38860
12651,1635,455,383,603,149,45,59,32,27,5,0,22,5,0,0,0,0,5,0,0,5,27,23,13,0,10,4,0,0,0,0,4,0,0,4,38862
12652,12996,3037,4692,3373,1418,476,1099,623,474,155,48,271,149,98,21,0,77,51,39,9,3,476,366,129,22,215,110,88,88,0,0,22,0,0,22,38863
12653,1010,234,409,296,54,17,200,98,98,15,0,83,0,0,0,0,0,0,0,0,0,102,71,16,0,55,31,0,0,0,0,31,20,0,11,38864
12654,3058,744,1179,759,270,106,94,34,34,13,3,18,0,0,0,0,0,0,0,0,0,60,41,18,0,23,19,13,13,0,0,6,0,0,6,38865
12655,8182,1115,2024,3178,1338,527,507,220,120,19,0,101,100,76,47,29,0,24,24,0,0,287,248,78,19,151,39,39,0,24,15,0,0,0,0,38866
12656,3220,679,1063,1174,221,83,247,112,112,26,25,61,0,0,0,0,0,0,0,0,0,135,120,29,18,73,15,0,0,0,0,15,0,13,2,38868
12657,206,60,76,65,2,3,19,7,7,0,0,7,0,0,0,0,0,0,0,0,0,12,0,0,0,0,12,12,6,6,0,0,0,0,0,38869
12658,1793,302,767,524,107,93,117,73,64,9,4,51,9,9,0,2,7,0,0,0,0,44,33,7,0,26,11,11,2,0,9,0,0,0,0,38870
12659,1346,293,504,398,84,67,97,66,63,27,0,36,3,3,3,0,0,0,0,0,0,31,31,10,0,21,0,0,0,0,0,0,0,0,0,38871
12660,1921,522,764,541,47,47,109,46,44,12,3,29,2,0,0,0,0,2,1,1,0,63,63,0,0,63,0,0,0,0,0,0,0,0,0,38873
12661,1146,334,494,216,90,12,103,16,14,0,0,14,2,2,0,0,2,0,0,0,0,87,85,35,4,46,2,2,0,2,0,0,0,0,0,38876
12662,1801,646,565,407,110,73,80,36,25,1,4,20,11,2,2,0,0,9,5,3,1,44,44,0,0,44,0,0,0,0,0,0,0,0,0,38878
12663,279,83,75,121,0,0,73,33,33,0,0,33,0,0,0,0,0,0,0,0,0,40,40,0,0,40,0,0,0,0,0,0,0,0,0,38879
12664,11888,2605,3697,3754,1224,608,1199,640,491,130,66,295,149,104,80,0,24,45,0,13,32,559,448,48,23,377,111,111,97,0,14,0,0,0,0,38901
12665,310,90,73,131,16,0,7,7,0,0,0,0,7,0,0,0,0,7,0,0,7,0,0,0,0,0,0,0,0,0,0,0,0,0,0,38913
12666,291,75,148,68,0,0,43,27,27,0,0,27,0,0,0,0,0,0,0,0,0,16,16,0,0,16,0,0,0,0,0,0,0,0,0,38914
12667,2720,769,831,837,218,65,159,102,91,12,0,79,11,6,6,0,0,5,2,0,3,57,57,10,0,47,0,0,0,0,0,0,0,0,0,38915
12668,3367,1096,1085,846,245,95,288,136,116,24,0,92,20,0,0,0,0,20,0,14,6,152,133,32,48,53,19,13,9,4,0,6,0,6,0,38916
12669,2143,353,779,664,210,137,98,18,12,0,0,12,6,0,0,0,0,6,0,0,6,80,80,1,14,65,0,0,0,0,0,0,0,0,0,38917
12670,530,135,136,182,62,15,0,0,0,0,0,0,0,0,0,0,0,0,0,0,0,0,0,0,0,0,0,0,0,0,0,0,0,0,0,38920
12671,2876,980,902,716,156,122,281,224,216,12,0,204,8,0,0,0,0,8,0,7,1,57,56,12,8,36,1,1,0,0,1,0,0,0,0,38921
12672,2678,619,998,781,150,130,181,59,59,14,0,45,0,0,0,0,0,0,0,0,0,122,72,7,0,65,50,50,25,0,25,0,0,0,0,38922
12673,1039,333,446,249,0,11,454,306,306,0,0,306,0,0,0,0,0,0,0,0,0,148,79,0,79,0,69,0,0,0,0,69,0,0,69,38923
12674,400,133,113,95,50,9,60,32,20,0,0,20,12,12,0,12,0,0,0,0,0,28,28,12,3,13,0,0,0,0,0,0,0,0,0,38924
12675,1549,385,617,425,105,17,227,89,68,17,0,51,21,5,0,5,0,16,16,0,0,138,81,6,9,66,57,57,18,0,39,0,0,0,0,38925
12676,775,200,349,151,48,27,28,28,28,0,0,28,0,0,0,0,0,0,0,0,0,0,0,0,0,0,0,0,0,0,0,0,0,0,0,38927
12677,144,48,50,46,0,0,28,8,8,0,0,8,0,0,0,0,0,0,0,0,0,20,16,0,0,16,4,0,0,0,0,4,0,0,4,38928
12678,892,199,157,356,142,38,54,0,0,0,0,0,0,0,0,0,0,0,0,0,0,54,54,0,0,54,0,0,0,0,0,0,0,0,0,38929
12679,16357,4260,4925,4036,2168,968,1602,929,818,56,119,643,111,62,0,22,40,49,0,11,38,673,600,54,22,524,73,35,4,31,0,38,0,0,38,38930
12680,1200,197,506,429,17,51,0,0,0,0,0,0,0,0,0,0,0,0,0,0,0,0,0,0,0,0,0,0,0,0,0,0,0,0,0,38940
12681,2452,617,670,594,251,320,665,358,350,43,147,160,8,8,0,0,8,0,0,0,0,307,300,0,52,248,7,7,0,0,7,0,0,0,0,38941
12682,251,0,37,129,85,0,0,0,0,0,0,0,0,0,0,0,0,0,0,0,0,0,0,0,0,0,0,0,0,0,0,0,0,0,0,38943
12683,284,30,82,108,33,31,66,32,18,0,0,18,14,14,0,0,14,0,0,0,0,34,34,0,0,34,0,0,0,0,0,0,0,0,0,38944
12684,14,0,14,0,0,0,0,0,0,0,0,0,0,0,0,0,0,0,0,0,0,0,0,0,0,0,0,0,0,0,0,0,0,0,0,38945
12685,169,36,78,43,3,9,18,6,6,0,0,6,0,0,0,0,0,0,0,0,0,12,12,0,12,0,0,0,0,0,0,0,0,0,0,38946
12686,435,85,138,136,57,19,8,0,0,0,0,0,0,0,0,0,0,0,0,0,0,8,8,0,0,8,0,0,0,0,0,0,0,0,0,38947
12687,1226,370,443,301,46,66,83,52,52,0,0,52,0,0,0,0,0,0,0,0,0,31,23,0,0,23,8,0,0,0,0,8,0,8,0,38948
12688,64,2,33,29,0,0,0,0,0,0,0,0,0,0,0,0,0,0,0,0,0,0,0,0,0,0,0,0,0,0,0,0,0,0,0,38949
12689,159,5,59,95,0,0,0,0,0,0,0,0,0,0,0,0,0,0,0,0,0,0,0,0,0,0,0,0,0,0,0,0,0,0,0,38950
12690,1026,400,282,294,37,13,75,20,17,0,0,17,3,3,0,0,3,0,0,0,0,55,22,14,0,8,33,33,0,0,33,0,0,0,0,38951
12691,366,120,98,114,27,7,39,28,28,0,4,24,0,0,0,0,0,0,0,0,0,11,11,6,1,4,0,0,0,0,0,0,0,0,0,38952
12692,547,106,178,99,34,130,198,198,177,16,0,161,21,21,21,0,0,0,0,0,0,0,0,0,0,0,0,0,0,0,0,0,0,0,0,38953
12693,792,261,259,183,74,15,12,0,0,0,0,0,0,0,0,0,0,0,0,0,0,12,12,0,0,12,0,0,0,0,0,0,0,0,0,38954
12694,370,113,87,129,21,20,54,18,18,0,0,18,0,0,0,0,0,0,0,0,0,36,25,0,0,25,11,11,0,0,11,0,0,0,0,38957
12695,29,12,17,0,0,0,0,0,0,0,0,0,0,0,0,0,0,0,0,0,0,0,0,0,0,0,0,0,0,0,0,0,0,0,0,38958
12696,423,159,197,30,17,20,65,0,0,0,0,0,0,0,0,0,0,0,0,0,0,65,65,0,0,65,0,0,0,0,0,0,0,0,0,38961
12697,77,0,22,36,19,0,0,0,0,0,0,0,0,0,0,0,0,0,0,0,0,0,0,0,0,0,0,0,0,0,0,0,0,0,0,38962
12698,3831,1577,1161,926,84,83,264,101,20,0,0,20,81,28,0,5,23,53,0,0,53,163,117,13,0,104,46,46,0,33,13,0,0,0,0,38963
12699,187,87,47,44,9,0,38,10,10,0,0,10,0,0,0,0,0,0,0,0,0,28,28,0,0,28,0,0,0,0,0,0,0,0,0,38964
12700,6032,1213,2038,2034,370,377,413,281,128,17,36,75,153,44,15,0,29,109,0,0,109,132,126,18,20,88,6,0,0,0,0,6,0,0,6,38965
12701,568,165,121,156,115,11,32,0,0,0,0,0,0,0,0,0,0,0,0,0,0,32,23,0,0,23,9,0,0,0,0,9,0,0,9,38966
12702,4627,1193,1448,1303,523,160,481,215,162,17,26,119,53,53,0,0,53,0,0,0,0,266,143,14,32,97,123,65,0,65,0,58,17,0,41,38967
12703,3911,1311,1184,1036,257,123,344,131,120,0,23,97,11,5,5,0,0,6,6,0,0,213,187,22,23,142,26,15,8,0,7,11,0,0,11,39038
12704,1459,308,578,375,156,42,82,49,33,28,0,5,16,0,0,0,0,16,0,0,16,33,33,0,0,33,0,0,0,0,0,0,0,0,0,39039
12705,2634,741,1032,627,174,60,137,83,82,1,6,75,1,1,1,0,0,0,0,0,0,54,41,24,16,1,13,13,13,0,0,0,0,0,0,39040
12706,2873,734,813,906,220,200,241,88,73,0,0,73,15,0,0,0,0,15,0,15,0,153,130,44,14,72,23,10,0,0,10,13,13,0,0,39041
12707,23264,2019,6201,7833,4942,2269,1708,756,591,127,67,397,165,57,29,5,23,108,0,0,108,952,894,284,16,594,58,27,3,0,24,31,0,0,31,39042
12708,2650,590,969,629,341,121,153,98,74,12,5,57,24,15,15,0,0,9,0,0,9,55,23,0,0,23,32,30,30,0,0,2,2,0,0,39044
12709,787,245,260,180,75,27,28,24,24,0,0,24,0,0,0,0,0,0,0,0,0,4,4,0,4,0,0,0,0,0,0,0,0,0,0,39045
12710,16789,3833,3831,5150,2381,1594,1793,778,642,58,8,576,136,124,27,10,87,12,0,0,12,1015,849,84,42,723,166,119,37,13,69,47,0,0,47,39046
12711,25442,1196,4647,8370,7421,3808,1824,802,703,197,50,456,99,47,16,14,17,52,0,0,52,1022,924,289,46,589,98,38,8,16,14,60,21,10,29,39047
12712,10513,2587,3930,2951,775,270,938,383,254,0,12,242,129,86,58,14,14,43,7,0,36,555,368,42,50,276,187,80,56,24,0,107,36,0,71,39051
12713,313,104,91,54,64,0,21,21,17,0,0,17,4,0,0,0,0,4,0,0,4,0,0,0,0,0,0,0,0,0,0,0,0,0,0,39054
12714,16632,1399,2913,5275,4240,2805,1668,788,711,134,56,521,77,45,0,45,0,32,14,0,18,880,833,281,32,520,47,25,16,9,0,22,0,0,22,39056
12715,1227,272,484,391,67,13,103,82,56,0,0,56,26,16,0,16,0,10,0,0,10,21,21,0,0,21,0,0,0,0,0,0,0,0,0,39057
12716,7870,1835,2793,2322,670,250,663,458,356,50,42,264,102,32,0,13,19,70,0,0,70,205,166,58,67,41,39,39,22,0,17,0,0,0,0,39059
12717,78,0,0,24,37,17,43,0,0,0,0,0,0,0,0,0,0,0,0,0,0,43,43,0,0,43,0,0,0,0,0,0,0,0,0,39061
12718,314,55,147,84,24,4,27,0,0,0,0,0,0,0,0,0,0,0,0,0,0,27,17,3,2,12,10,10,0,10,0,0,0,0,0,39062
12719,1934,619,533,516,162,104,139,76,68,10,0,58,8,8,0,0,8,0,0,0,0,63,55,1,9,45,8,0,0,0,0,8,0,0,8,39063
12720,3128,569,698,1218,511,132,253,165,146,24,7,115,19,0,0,0,0,19,19,0,0,88,88,29,0,59,0,0,0,0,0,0,0,0,0,39066
12721,1054,243,462,320,16,13,49,38,23,6,6,11,15,10,0,10,0,5,0,5,0,11,11,0,0,11,0,0,0,0,0,0,0,0,0,39067
12722,4069,918,1550,849,443,309,462,151,108,21,0,87,43,23,0,14,9,20,0,0,20,311,241,0,0,241,70,63,0,26,37,7,0,0,7,39069
12723,3599,767,772,998,608,454,373,241,220,18,0,202,21,14,0,3,11,7,0,0,7,132,75,14,10,51,57,44,0,44,0,13,0,9,4,39071
12724,13347,2068,5090,4217,1253,719,987,606,495,88,16,391,111,82,9,35,38,29,0,29,0,381,257,100,16,141,124,61,34,16,11,63,13,0,50,39073
12725,9264,2804,2912,2441,821,286,841,460,380,72,26,282,80,27,0,4,23,53,11,34,8,381,324,47,49,228,57,30,14,0,16,27,0,22,5,39074
12726,694,201,324,130,34,5,37,11,11,0,0,11,0,0,0,0,0,0,0,0,0,26,4,0,0,4,22,22,22,0,0,0,0,0,0,39078
12727,1055,315,305,292,99,44,296,128,122,34,17,71,6,0,0,0,0,6,0,0,6,168,164,17,27,120,4,0,0,0,0,4,0,0,4,39079
12728,713,178,205,284,34,12,49,38,7,0,0,7,31,20,0,0,20,11,0,0,11,11,11,0,0,11,0,0,0,0,0,0,0,0,0,39082
12729,6773,1230,2241,2463,629,210,793,323,291,0,29,262,32,10,0,10,0,22,12,0,10,470,351,12,0,339,119,39,0,0,39,80,0,0,80,39083
12730,1305,115,310,605,136,139,200,83,0,0,0,0,83,83,83,0,0,0,0,0,0,117,117,0,0,117,0,0,0,0,0,0,0,0,0,39086
12731,140,35,38,14,53,0,24,24,24,24,0,0,0,0,0,0,0,0,0,0,0,0,0,0,0,0,0,0,0,0,0,0,0,0,0,39088
12732,8690,2337,2252,2445,980,676,935,449,393,23,20,350,56,0,0,0,0,56,37,11,8,486,390,28,70,292,96,84,0,49,35,12,0,0,12,39090
12733,2078,377,952,656,82,11,233,116,95,4,0,91,21,0,0,0,0,21,0,0,21,117,115,54,7,54,2,2,0,2,0,0,0,0,0,39092
12734,2651,729,850,808,192,72,171,74,42,3,0,39,32,27,16,10,1,5,5,0,0,97,97,22,35,40,0,0,0,0,0,0,0,0,0,39094
12735,4860,1111,1802,1295,417,235,447,259,247,44,11,192,12,12,0,0,12,0,0,0,0,188,149,0,16,133,39,39,0,0,39,0,0,0,0,39095
12736,724,155,272,122,97,78,300,193,193,13,28,152,0,0,0,0,0,0,0,0,0,107,107,0,4,103,0,0,0,0,0,0,0,0,0,39096
12737,429,162,143,82,30,12,48,14,14,0,0,14,0,0,0,0,0,0,0,0,0,34,34,0,0,34,0,0,0,0,0,0,0,0,0,39097
12738,1361,348,513,361,96,43,42,18,14,0,0,14,4,0,0,0,0,4,0,0,4,24,24,0,0,24,0,0,0,0,0,0,0,0,0,39108
12739,24592,718,2704,5662,9411,6097,1988,924,820,243,56,521,104,89,79,0,10,15,15,0,0,1064,1013,171,42,800,51,51,51,0,0,0,0,0,0,39110
12740,5870,1189,2213,1483,673,312,723,483,241,40,14,187,242,155,0,104,51,87,10,0,77,240,158,54,0,104,82,44,14,0,30,38,0,0,38,39111
12741,446,204,126,85,17,14,51,38,18,3,0,15,20,0,0,0,0,20,0,0,20,13,4,0,0,4,9,9,9,0,0,0,0,0,0,39113
12742,6736,1326,2104,2192,684,430,518,230,173,4,4,165,57,42,0,0,42,15,0,0,15,288,225,39,0,186,63,42,13,29,0,21,18,0,3,39114
12743,51,46,5,0,0,0,0,0,0,0,0,0,0,0,0,0,0,0,0,0,0,0,0,0,0,0,0,0,0,0,0,0,0,0,0,39115
12744,1737,361,831,386,85,74,113,58,38,0,0,38,20,16,11,5,0,4,0,0,4,55,55,0,0,55,0,0,0,0,0,0,0,0,0,39116
12745,6782,1756,2707,1569,446,304,569,254,195,13,22,160,59,28,0,0,28,31,17,10,4,315,197,62,5,130,118,67,27,40,0,51,47,0,4,39117
12746,3736,679,1412,1110,296,239,360,238,218,46,88,84,20,0,0,0,0,20,0,0,20,122,65,0,6,59,57,57,0,57,0,0,0,0,0,39119
12747,22541,4693,7556,6252,2486,1554,1682,856,583,74,89,420,273,160,21,22,117,113,7,0,106,826,741,80,46,615,85,79,35,4,40,6,0,0,6,39120
12748,1405,237,569,384,156,59,174,46,46,0,0,46,0,0,0,0,0,0,0,0,0,128,124,0,2,122,4,0,0,0,0,4,0,0,4,39140
12749,595,116,204,217,52,6,37,12,12,0,0,12,0,0,0,0,0,0,0,0,0,25,25,0,0,25,0,0,0,0,0,0,0,0,0,39144
12750,3644,864,1247,991,344,198,390,192,171,78,7,86,21,0,0,0,0,21,0,0,21,198,188,83,40,65,10,8,8,0,0,2,0,0,2,39145
12751,1563,427,494,452,100,90,144,70,70,9,7,54,0,0,0,0,0,0,0,0,0,74,74,0,24,50,0,0,0,0,0,0,0,0,0,39146
12752,979,310,373,152,111,33,142,107,107,0,0,107,0,0,0,0,0,0,0,0,0,35,0,0,0,0,35,35,0,35,0,0,0,0,0,39149
12753,3384,717,1060,968,354,285,424,172,164,51,0,113,8,7,7,0,0,1,0,0,1,252,187,0,12,175,65,65,0,0,65,0,0,0,0,39150
12754,701,170,266,132,128,5,154,44,44,0,0,44,0,0,0,0,0,0,0,0,0,110,72,19,16,37,38,38,0,0,38,0,0,0,0,39152
12755,2459,418,1076,656,167,142,158,105,91,8,0,83,14,14,0,0,14,0,0,0,0,53,46,10,0,36,7,7,0,0,7,0,0,0,0,39153
12756,6516,705,1390,2463,1103,855,1088,728,647,37,77,533,81,11,0,0,11,70,0,0,70,360,360,35,64,261,0,0,0,0,0,0,0,0,0,39154
12757,164,18,79,40,27,0,0,0,0,0,0,0,0,0,0,0,0,0,0,0,0,0,0,0,0,0,0,0,0,0,0,0,0,0,0,39156
12758,16920,1106,2641,4931,4708,3534,1097,688,598,138,18,442,90,40,8,0,32,50,6,0,44,409,368,108,22,238,41,6,0,0,6,35,0,0,35,39157
12759,2289,589,851,544,215,90,107,46,20,8,0,12,26,9,0,9,0,17,0,0,17,61,55,22,13,20,6,0,0,0,0,6,0,0,6,39159
12760,1989,720,587,486,120,76,157,101,84,17,0,67,17,1,1,0,0,16,16,0,0,56,56,9,33,14,0,0,0,0,0,0,0,0,0,39160
12761,65,22,31,12,0,0,0,0,0,0,0,0,0,0,0,0,0,0,0,0,0,0,0,0,0,0,0,0,0,0,0,0,0,0,0,39162
12762,321,81,73,86,50,31,22,15,7,2,0,5,8,8,8,0,0,0,0,0,0,7,0,0,0,0,7,7,0,0,7,0,0,0,0,39166
12763,0,0,0,0,0,0,0,0,0,0,0,0,0,0,0,0,0,0,0,0,0,0,0,0,0,0,0,0,0,0,0,0,0,0,0,39167
12764,4445,797,1865,1212,473,98,254,79,68,5,0,63,11,11,0,0,11,0,0,0,0,175,153,28,5,120,22,9,0,0,9,13,0,0,13,39168
12765,1759,683,628,280,109,59,191,120,120,0,64,56,0,0,0,0,0,0,0,0,0,71,44,5,0,39,27,20,6,3,11,7,0,0,7,39169
12766,6642,655,2196,2331,916,544,588,230,188,13,9,166,42,42,9,33,0,0,0,0,0,358,333,132,17,184,25,25,0,25,0,0,0,0,0,39170
12767,83,36,0,38,9,0,288,90,61,7,0,54,29,0,0,0,0,29,0,0,29,198,198,68,20,110,0,0,0,0,0,0,0,0,0,39174
12768,2831,666,622,1079,206,258,232,149,138,10,11,117,11,11,11,0,0,0,0,0,0,83,76,8,0,68,7,4,0,4,0,3,0,0,3,39175
12769,1414,451,575,278,89,21,154,145,126,25,0,101,19,11,11,0,0,8,0,0,8,9,6,0,6,0,3,0,0,0,0,3,0,0,3,39176
12770,59,16,23,16,0,4,0,0,0,0,0,0,0,0,0,0,0,0,0,0,0,0,0,0,0,0,0,0,0,0,0,0,0,0,0,39177
12771,623,179,223,152,63,6,19,9,9,0,0,9,0,0,0,0,0,0,0,0,0,10,10,0,0,10,0,0,0,0,0,0,0,0,0,39179
12772,22069,3874,5943,7193,3115,1944,1698,903,709,138,65,506,194,62,21,0,41,132,0,7,125,795,624,76,0,548,171,91,32,0,59,80,6,5,69,39180
12773,9686,1407,2973,2523,1758,1025,767,404,271,43,0,228,133,133,63,23,47,0,0,0,0,363,260,8,12,240,103,52,26,7,19,51,11,0,40,39183
12774,2503,657,877,738,218,13,379,311,87,34,0,53,224,91,18,0,73,133,0,0,133,68,68,0,0,68,0,0,0,0,0,0,0,0,0,39189
12775,4655,856,1491,1505,436,367,530,353,319,83,0,236,34,34,1,0,33,0,0,0,0,177,159,22,27,110,18,18,12,0,6,0,0,0,0,39191
12776,986,351,299,239,62,35,68,29,13,0,0,13,16,16,16,0,0,0,0,0,0,39,37,18,0,19,2,2,2,0,0,0,0,0,0,39192
12777,960,423,291,161,73,12,12,11,2,0,0,2,9,9,0,0,9,0,0,0,0,1,1,0,1,0,0,0,0,0,0,0,0,0,0,39193
12778,13787,3518,4808,3751,1156,554,1314,673,456,29,194,233,217,131,59,22,50,86,0,23,63,641,488,59,60,369,153,40,0,34,6,113,13,39,61,39194
12779,367,30,127,48,90,72,26,26,13,0,0,13,13,0,0,0,0,13,0,0,13,0,0,0,0,0,0,0,0,0,0,0,0,0,0,39201
12780,5582,427,1030,1568,1442,1115,867,318,305,35,25,245,13,0,0,0,0,13,0,0,13,549,520,74,84,362,29,23,0,0,23,6,6,0,0,39202
12781,3599,1188,975,940,385,111,833,351,326,29,54,243,25,10,0,0,10,15,0,6,9,482,477,38,53,386,5,0,0,0,0,5,0,0,5,39203
12782,10822,2217,3638,3491,994,482,1336,613,543,60,22,461,70,58,0,37,21,12,0,7,5,723,556,96,121,339,167,46,0,13,33,121,23,9,89,39204
12783,15953,2047,3795,5676,2516,1919,1264,774,647,81,32,534,127,18,7,0,11,109,24,5,80,490,426,70,0,356,64,38,8,30,0,26,0,26,0,39206
12784,19861,3019,7222,6503,1960,1157,1412,756,586,108,134,344,170,20,7,0,13,150,27,11,112,656,515,62,0,453,141,50,14,15,21,91,0,42,49,39208
12785,17124,3883,5789,4743,1807,902,1897,917,673,66,124,483,244,162,58,17,87,82,15,21,46,980,838,144,84,610,142,89,43,8,38,53,0,4,49,39209
12786,16649,947,2044,4533,5237,3888,906,293,271,49,29,193,22,22,6,16,0,0,0,0,0,613,536,51,0,485,77,57,57,0,0,20,0,0,20,39211
12787,19144,2582,5543,7264,2626,1129,2624,1339,1180,315,210,655,159,70,50,12,8,89,0,17,72,1285,1111,197,237,677,174,64,0,64,0,110,0,31,79,39212
12788,14992,4004,4383,4506,1296,803,1096,579,469,15,100,354,110,22,6,0,16,88,1,42,45,517,458,92,13,353,59,30,27,3,0,29,0,0,29,39213
12789,2288,116,604,560,508,500,42,22,22,4,0,18,0,0,0,0,0,0,0,0,0,20,0,0,0,0,20,20,0,20,0,0,0,0,0,39216
12790,15,0,0,9,0,6,343,122,122,3,9,110,0,0,0,0,0,0,0,0,0,221,221,21,11,189,0,0,0,0,0,0,0,0,0,39217
12791,4666,621,1636,1552,580,277,308,212,116,10,17,89,96,78,70,0,8,18,18,0,0,96,88,10,11,67,8,8,8,0,0,0,0,0,0,39218
12792,4616,311,672,1480,1237,916,250,110,93,56,5,32,17,17,17,0,0,0,0,0,0,140,135,40,0,95,5,5,0,0,5,0,0,0,0,39232
12793,0,0,0,0,0,0,0,0,0,0,0,0,0,0,0,0,0,0,0,0,0,0,0,0,0,0,0,0,0,0,0,0,0,0,0,39269
12794,7954,670,1840,3315,1369,760,844,410,311,34,0,277,99,29,0,29,0,70,30,40,0,434,403,107,9,287,31,22,22,0,0,9,0,9,0,39272
12795,17115,3296,5953,5540,1647,679,1383,666,552,34,32,486,114,66,23,23,20,48,0,3,45,717,659,52,123,484,58,0,0,0,0,58,25,10,23,39301
12796,13765,957,2939,5263,2987,1619,1256,587,461,154,0,307,126,113,75,26,12,13,0,0,13,669,597,185,93,319,72,72,0,27,45,0,0,0,0,39305
12797,12231,2826,4069,4061,795,480,1091,589,512,57,89,366,77,15,0,3,12,62,0,13,49,502,448,89,56,303,54,10,0,10,0,44,3,0,41,39307
12798,91,0,7,68,15,1,138,96,0,0,0,0,96,96,88,0,8,0,0,0,0,42,6,6,0,0,36,36,36,0,0,0,0,0,0,39309
12799,1438,148,601,454,182,53,137,34,34,0,0,34,0,0,0,0,0,0,0,0,0,103,55,12,0,43,48,0,0,0,0,48,29,0,19,39320
12800,1249,327,476,387,39,20,12,12,0,0,0,0,12,12,12,0,0,0,0,0,0,0,0,0,0,0,0,0,0,0,0,0,0,0,0,39322
12801,808,122,223,388,40,35,17,10,9,2,7,0,1,1,0,1,0,0,0,0,0,7,7,3,0,4,0,0,0,0,0,0,0,0,0,39323
12802,4192,444,1218,1539,655,336,319,173,173,44,0,129,0,0,0,0,0,0,0,0,0,146,138,6,0,132,8,8,0,0,8,0,0,0,0,39325
12803,795,229,256,162,134,14,15,15,15,0,0,15,0,0,0,0,0,0,0,0,0,0,0,0,0,0,0,0,0,0,0,0,0,0,0,39326
12804,2411,263,554,983,309,302,609,327,288,74,18,196,39,22,22,0,0,17,0,10,7,282,268,108,23,137,14,14,0,14,0,0,0,0,0,39327
12805,3375,705,1192,1116,300,62,271,122,112,0,0,112,10,0,0,0,0,10,0,10,0,149,149,0,77,72,0,0,0,0,0,0,0,0,0,39328
12806,1818,341,688,531,174,84,166,125,125,0,2,123,0,0,0,0,0,0,0,0,0,41,41,15,4,22,0,0,0,0,0,0,0,0,0,39330
12807,1245,179,397,470,127,72,90,88,88,7,0,81,0,0,0,0,0,0,0,0,0,2,2,2,0,0,0,0,0,0,0,0,0,0,0,39332
12808,2295,307,957,704,158,169,301,90,49,0,0,49,41,41,0,0,41,0,0,0,0,211,186,0,18,168,25,25,25,0,0,0,0,0,0,39335
12809,828,190,159,394,34,51,47,8,8,0,0,8,0,0,0,0,0,0,0,0,0,39,8,0,0,8,31,31,31,0,0,0,0,0,0,39336
12810,1413,341,478,458,87,49,61,34,34,0,0,34,0,0,0,0,0,0,0,0,0,27,27,0,0,27,0,0,0,0,0,0,0,0,0,39337
12811,2264,604,866,557,223,14,215,128,80,17,0,63,48,12,2,0,10,36,36,0,0,87,58,0,0,58,29,26,26,0,0,3,0,3,0,39338
12812,10441,2006,3625,3124,1221,465,720,404,325,54,36,235,79,47,20,5,22,32,0,13,19,316,247,41,0,206,69,54,23,31,0,15,0,0,15,39339
12813,4194,1511,1314,889,294,186,443,241,169,27,20,122,72,49,19,30,0,23,23,0,0,202,175,38,14,123,27,24,0,24,0,3,3,0,0,39341
12814,1004,107,298,481,85,33,48,36,36,6,0,30,0,0,0,0,0,0,0,0,0,12,10,8,0,2,2,2,0,0,2,0,0,0,0,39342
12815,4121,654,1708,1183,470,106,281,93,70,14,3,53,23,13,0,0,13,10,0,0,10,188,179,28,26,125,9,9,0,6,3,0,0,0,0,39345
12816,1612,354,541,480,112,125,87,68,39,0,0,39,29,18,0,0,18,11,11,0,0,19,19,12,0,7,0,0,0,0,0,0,0,0,0,39346
12817,1213,174,464,480,63,32,30,9,7,0,0,7,2,2,2,0,0,0,0,0,0,21,21,0,0,21,0,0,0,0,0,0,0,0,0,39347
12818,455,25,240,104,64,22,7,0,0,0,0,0,0,0,0,0,0,0,0,0,0,7,0,0,0,0,7,7,7,0,0,0,0,0,0,39348
12819,15817,3666,5064,5056,1267,764,1374,640,505,82,39,384,135,43,0,43,0,92,0,48,44,734,660,58,78,524,74,51,9,32,10,23,21,0,2,39350
12820,518,119,195,157,47,0,11,11,0,0,0,0,11,11,0,11,0,0,0,0,0,0,0,0,0,0,0,0,0,0,0,0,0,0,0,39352
12821,903,234,300,294,32,43,46,46,46,0,0,46,0,0,0,0,0,0,0,0,0,0,0,0,0,0,0,0,0,0,0,0,0,0,0,39354
12822,4714,1192,1538,1377,483,124,235,127,100,58,0,42,27,15,15,0,0,12,0,0,12,108,58,25,0,33,50,30,0,9,21,20,0,20,0,39355
12823,428,114,124,138,0,52,10,0,0,0,0,0,0,0,0,0,0,0,0,0,0,10,10,0,0,10,0,0,0,0,0,0,0,0,0,39356
12824,829,257,199,304,35,34,260,123,123,27,41,55,0,0,0,0,0,0,0,0,0,137,137,0,0,137,0,0,0,0,0,0,0,0,0,39358
12825,167,30,39,63,23,12,6,2,2,0,0,2,0,0,0,0,0,0,0,0,0,4,4,0,0,4,0,0,0,0,0,0,0,0,0,39359
12826,2770,820,1044,699,172,35,310,149,149,16,0,133,0,0,0,0,0,0,0,0,0,161,151,0,43,108,10,0,0,0,0,10,0,0,10,39360
12827,1417,433,471,350,52,111,39,19,19,0,0,19,0,0,0,0,0,0,0,0,0,20,20,0,14,6,0,0,0,0,0,0,0,0,0,39361
12828,1610,407,575,526,56,46,151,108,108,7,21,80,0,0,0,0,0,0,0,0,0,43,43,28,0,15,0,0,0,0,0,0,0,0,0,39362
12829,1102,432,290,291,61,28,36,20,20,5,2,13,0,0,0,0,0,0,0,0,0,16,12,0,0,12,4,0,0,0,0,4,0,4,0,39363
12830,2148,453,461,1003,195,36,281,147,147,37,0,110,0,0,0,0,0,0,0,0,0,134,134,0,31,103,0,0,0,0,0,0,0,0,0,39364
12831,4716,981,1404,1717,352,262,493,272,225,40,0,185,47,47,34,0,13,0,0,0,0,221,212,39,0,173,9,0,0,0,0,9,0,0,9,39365
12832,624,170,258,113,38,45,88,67,67,0,0,67,0,0,0,0,0,0,0,0,0,21,21,0,0,21,0,0,0,0,0,0,0,0,0,39366
12833,9630,2495,3777,2265,595,498,702,294,155,16,0,139,139,99,45,0,54,40,0,13,27,408,337,56,0,281,71,16,0,0,16,55,0,0,55,39367
12834,25670,4981,7160,7514,3579,2436,2568,1193,982,291,109,582,211,108,47,20,41,103,26,16,61,1375,1209,232,225,752,166,83,60,18,5,83,0,26,57,39401
12835,25241,1354,4489,7878,7367,4153,1728,764,707,43,29,635,57,57,47,0,10,0,0,0,0,964,892,194,42,656,72,72,17,0,55,0,0,0,0,39402
12836,26,0,0,21,5,0,1224,344,344,62,97,185,0,0,0,0,0,0,0,0,0,880,880,311,120,449,0,0,0,0,0,0,0,0,0,39406
12837,2403,645,923,483,231,121,38,38,38,0,0,38,0,0,0,0,0,0,0,0,0,0,0,0,0,0,0,0,0,0,0,0,0,0,0,39421
12838,3307,781,1105,1126,174,121,401,167,133,0,0,133,34,29,14,0,15,5,0,0,5,234,125,13,0,112,109,30,10,0,20,79,0,23,56,39422
12839,1725,306,768,567,66,18,201,112,108,32,19,57,4,4,4,0,0,0,0,0,0,89,66,7,15,44,23,23,0,23,0,0,0,0,0,39423
12840,1236,218,398,503,76,41,19,0,0,0,0,0,0,0,0,0,0,0,0,0,0,19,19,19,0,0,0,0,0,0,0,0,0,0,0,39425
12841,10437,1448,3573,3772,1183,461,1169,642,504,82,27,395,138,96,33,44,19,42,0,12,30,527,403,38,61,304,124,124,57,0,67,0,0,0,0,39426
12842,973,244,312,186,109,122,41,41,41,0,0,41,0,0,0,0,0,0,0,0,0,0,0,0,0,0,0,0,0,0,0,0,0,0,0,39427
12843,6257,1747,1932,1781,535,262,483,271,222,81,36,105,49,40,39,0,1,9,9,0,0,212,212,19,18,175,0,0,0,0,0,0,0,0,0,39428
12844,11686,2773,3863,3269,1201,580,844,408,287,0,0,287,121,32,4,21,7,89,18,24,47,436,346,21,0,325,90,86,32,0,54,4,0,0,4,39429
12845,8601,2221,2005,2668,984,723,916,430,348,75,40,233,82,51,0,0,51,31,0,0,31,486,425,72,53,300,61,8,0,8,0,53,0,0,53,39437
12846,3133,722,1034,994,283,100,263,160,131,0,0,131,29,29,18,0,11,0,0,0,0,103,99,42,0,57,4,0,0,0,0,4,0,4,0,39439
12847,12860,3310,3334,4075,1279,862,1238,559,311,60,0,251,248,188,11,119,58,60,37,0,23,679,441,14,43,384,238,69,22,24,23,169,25,28,116,39440
12848,15036,2215,4841,5234,1666,1080,1106,534,452,71,0,381,82,68,27,0,41,14,0,0,14,572,537,149,0,388,35,15,0,0,15,20,0,20,0,39443
12849,5590,1698,2066,1344,262,220,172,135,95,49,0,46,40,13,0,0,13,27,0,0,27,37,37,26,0,11,0,0,0,0,0,0,0,0,0,39451
12850,17641,2771,7663,5213,1415,579,1609,1007,731,280,50,401,276,234,115,22,97,42,17,0,25,602,475,49,36,390,127,96,45,8,43,31,0,0,31,39452
12851,6369,1550,2248,1851,508,212,615,438,317,1,0,316,121,58,48,10,0,63,0,9,54,177,172,37,59,76,5,0,0,0,0,5,0,0,5,39455
12852,746,140,413,160,23,10,88,59,50,0,0,50,9,9,9,0,0,0,0,0,0,29,20,0,0,20,9,0,0,0,0,9,9,0,0,39456
12853,2287,553,667,763,230,74,194,52,52,23,0,29,0,0,0,0,0,0,0,0,0,142,113,0,0,113,29,0,0,0,0,29,0,0,29,39459
12854,319,6,225,73,0,15,41,0,0,0,0,0,0,0,0,0,0,0,0,0,0,41,41,0,0,41,0,0,0,0,0,0,0,0,0,39461
12855,889,168,388,300,33,0,71,36,14,9,0,5,22,22,0,19,3,0,0,0,0,35,23,3,18,2,12,12,3,9,0,0,0,0,0,39462
12856,1684,400,565,567,128,24,105,53,53,0,0,53,0,0,0,0,0,0,0,0,0,52,52,0,0,52,0,0,0,0,0,0,0,0,0,39464
12857,13668,1768,4322,4080,2305,1193,1039,528,447,96,65,286,81,56,56,0,0,25,0,0,25,511,435,105,21,309,76,76,33,26,17,0,0,0,0,39465
12858,19355,3569,6939,6389,1667,791,1641,737,652,56,77,519,85,20,20,0,0,65,33,32,0,904,668,230,55,383,236,168,32,55,81,68,9,30,29,39466
12859,8686,1696,2657,3286,624,423,782,402,377,83,0,294,25,7,4,0,3,18,12,0,6,380,326,54,17,255,54,54,0,40,14,0,0,0,0,39470
12860,3911,948,1302,1239,341,81,418,206,196,14,11,171,10,0,0,0,0,10,0,0,10,212,107,68,26,13,105,85,79,0,6,20,0,0,20,39474
12861,7910,889,2542,2880,1103,496,1029,596,475,106,51,318,121,74,58,0,16,47,0,0,47,433,343,154,0,189,90,40,40,0,0,50,0,0,50,39475
12862,4721,896,1612,1655,411,147,360,207,187,17,5,165,20,11,0,0,11,9,0,0,9,153,114,28,7,79,39,27,0,27,0,12,0,0,12,39476
12863,471,94,201,106,47,23,29,0,0,0,0,0,0,0,0,0,0,0,0,0,0,29,23,0,0,23,6,0,0,0,0,6,0,0,6,39477
12864,1316,299,392,417,104,104,90,66,55,7,47,1,11,10,0,0,10,1,0,0,1,24,24,0,4,20,0,0,0,0,0,0,0,0,0,39478
12865,3576,889,1295,801,359,232,314,165,165,0,0,165,0,0,0,0,0,0,0,0,0,149,146,38,0,108,3,3,3,0,0,0,0,0,0,39479
12866,2110,366,611,825,174,134,301,208,208,103,0,105,0,0,0,0,0,0,0,0,0,93,79,25,0,54,14,0,0,0,0,14,0,14,0,39480
12867,1191,335,487,201,100,68,23,0,0,0,0,0,0,0,0,0,0,0,0,0,0,23,23,5,10,8,0,0,0,0,0,0,0,0,0,39481
12868,5636,803,1775,1918,766,374,477,200,187,78,32,77,13,13,9,0,4,0,0,0,0,277,251,15,15,221,26,26,0,26,0,0,0,0,0,39482
12869,3863,1332,1402,835,205,89,331,144,129,44,0,85,15,0,0,0,0,15,0,15,0,187,127,13,29,85,60,25,0,0,25,35,35,0,0,39483
12870,12870,3047,4154,4070,1093,506,1355,688,379,144,32,203,309,210,129,47,34,99,34,44,21,667,391,51,74,266,276,186,131,28,27,90,28,24,38,39501
12871,31104,3917,9249,11454,3973,2511,2690,1712,1336,313,113,910,376,269,148,72,49,107,44,45,18,978,893,156,112,625,85,78,0,0,78,7,0,0,7,39503
12872,11172,1272,2936,3839,2050,1075,876,542,470,131,19,320,72,19,15,4,0,53,0,0,53,334,265,57,10,198,69,34,0,0,34,35,0,0,35,39507
12873,10232,1666,3201,3350,1406,609,796,384,340,46,41,253,44,28,7,13,8,16,0,0,16,412,338,0,0,338,74,52,0,52,0,22,0,12,10,39520
12874,6610,207,1317,2191,1733,1162,197,104,84,63,0,21,20,18,12,6,0,2,0,0,2,93,93,21,0,72,0,0,0,0,0,0,0,0,0,39525
12875,5649,1226,1682,1584,784,373,489,265,169,38,6,125,96,29,6,0,23,67,42,8,17,224,173,46,34,93,51,12,0,12,0,39,0,0,39,39530
12876,11530,1499,2973,4390,1684,984,826,411,285,82,22,181,126,84,71,0,13,42,0,19,23,415,347,65,8,274,68,60,9,18,33,8,8,0,0,39531
12877,23335,2884,7192,8445,2768,2046,2097,1128,920,93,59,768,208,147,133,0,14,61,0,35,26,969,780,329,119,332,189,124,68,56,0,65,42,0,23,39532
12878,557,0,10,385,137,25,703,575,373,373,0,0,202,202,202,0,0,0,0,0,0,128,78,78,0,0,50,50,50,0,0,0,0,0,0,39534
12879,5397,838,1756,2105,430,268,465,148,124,0,20,104,24,24,0,15,9,0,0,0,0,317,218,51,18,149,99,99,64,0,35,0,0,0,0,39540
12880,10807,1227,3875,3765,1222,718,972,518,409,21,0,388,109,31,31,0,0,78,28,0,50,454,395,100,47,248,59,59,59,0,0,0,0,0,0,39553
12881,4726,876,1773,1570,331,176,596,330,246,73,0,173,84,53,44,9,0,31,0,7,24,266,225,0,38,187,41,41,0,0,41,0,0,0,0,39556
12882,11298,1384,2702,4425,1729,1058,895,299,261,36,14,211,38,20,20,0,0,18,0,0,18,596,468,213,0,255,128,114,114,0,0,14,0,0,14,39560
12883,1460,92,402,779,157,30,103,58,58,58,0,0,0,0,0,0,0,0,0,0,0,45,0,0,0,0,45,45,0,45,0,0,0,0,0,39561
12884,11847,2020,4815,3775,747,490,844,330,253,43,46,164,77,54,34,20,0,23,0,0,23,514,475,136,41,298,39,13,0,0,13,26,0,0,26,39562
12885,9815,1753,3712,3048,927,375,755,307,223,59,37,127,84,29,7,8,14,55,8,0,47,448,414,7,104,303,34,19,19,0,0,15,0,0,15,39563
12886,25297,2220,5789,9344,4404,3540,1847,950,895,321,56,518,55,16,0,0,16,39,0,0,39,897,786,226,83,477,111,111,28,0,83,0,0,0,0,39564
12887,12019,2050,4015,4254,1281,419,1010,561,378,32,20,326,183,183,126,0,57,0,0,0,0,449,382,57,71,254,67,53,0,0,53,14,0,0,14,39565
12888,7471,1105,2240,2492,1143,491,514,204,152,43,0,109,52,30,0,0,30,22,0,0,22,310,295,56,0,239,15,15,0,11,4,0,0,0,0,39567
12889,9122,1411,2681,2951,1066,1013,589,264,243,97,4,142,21,21,9,12,0,0,0,0,0,325,254,112,0,142,71,71,35,18,18,0,0,0,0,39571
12890,960,232,443,219,38,28,77,30,4,0,0,4,26,26,26,0,0,0,0,0,0,47,31,0,6,25,16,16,0,16,0,0,0,0,0,39572
12891,5199,796,1725,1835,585,258,625,303,257,79,0,178,46,29,9,20,0,17,0,0,17,322,308,57,0,251,14,0,0,0,0,14,0,0,14,39573
12892,8183,1282,3043,2828,617,413,769,341,274,38,0,236,67,15,0,0,15,52,0,39,13,428,296,59,20,217,132,90,67,0,23,42,42,0,0,39574
12893,3890,580,1355,1327,409,219,285,171,134,33,11,90,37,37,10,0,27,0,0,0,0,114,114,0,42,72,0,0,0,0,0,0,0,0,0,39576
12894,7112,1326,2221,2641,588,336,636,316,240,20,29,191,76,65,12,0,53,11,0,0,11,320,294,20,22,252,26,26,20,6,0,0,0,0,0,39577
12895,7019,1131,2510,2330,852,196,866,454,365,88,0,277,89,38,38,0,0,51,19,22,10,412,412,64,26,322,0,0,0,0,0,0,0,0,0,39581
12896,15468,2654,4915,4898,1822,1179,1103,661,535,32,75,428,126,86,55,0,31,40,0,0,40,442,433,97,5,331,9,9,0,0,9,0,0,0,0,39601
12897,4377,656,1809,1426,175,311,468,170,151,31,0,120,19,19,0,0,19,0,0,0,0,298,298,58,0,240,0,0,0,0,0,0,0,0,0,39629
12898,799,142,331,201,107,18,126,53,22,6,0,16,31,31,31,0,0,0,0,0,0,73,45,0,10,35,28,0,0,0,0,28,0,0,28,39630
12899,2432,633,830,488,296,185,109,7,7,0,0,7,0,0,0,0,0,0,0,0,0,102,102,14,0,88,0,0,0,0,0,0,0,0,0,39631
12900,842,280,288,239,33,2,58,26,26,0,0,26,0,0,0,0,0,0,0,0,0,32,29,0,0,29,3,3,0,0,3,0,0,0,0,39633
12901,111,0,66,45,0,0,0,0,0,0,0,0,0,0,0,0,0,0,0,0,0,0,0,0,0,0,0,0,0,0,0,0,0,0,0,39635
12902,2053,661,711,487,163,31,133,33,33,0,0,33,0,0,0,0,0,0,0,0,0,100,33,0,0,33,67,31,31,0,0,36,0,0,36,39638
12903,3038,592,1218,863,258,107,152,67,67,4,9,54,0,0,0,0,0,0,0,0,0,85,72,0,0,72,13,0,0,0,0,13,0,0,13,39641
12904,781,187,318,171,82,23,99,61,52,0,0,52,9,9,0,9,0,0,0,0,0,38,38,0,0,38,0,0,0,0,0,0,0,0,0,39643
12905,3663,629,1555,1031,160,288,193,177,89,22,0,67,88,48,0,0,48,40,0,24,16,16,10,0,0,10,6,0,0,0,0,6,6,0,0,39645
12906,673,45,336,221,71,0,49,44,44,0,1,43,0,0,0,0,0,0,0,0,0,5,5,2,3,0,0,0,0,0,0,0,0,0,0,39647
12907,14152,3320,4380,4078,1436,938,1206,690,515,36,16,463,175,125,7,5,113,50,0,0,50,516,439,154,24,261,77,77,35,0,42,0,0,0,0,39648
12908,5054,1170,1758,1609,328,189,458,250,189,4,0,185,61,15,6,0,9,46,3,0,43,208,158,36,12,110,50,3,0,0,3,47,26,16,5,39652
12909,2006,346,640,733,182,105,91,34,29,0,0,29,5,5,5,0,0,0,0,0,0,57,26,0,23,3,31,4,4,0,0,27,0,0,27,39653
12910,3502,639,1187,1120,414,142,293,181,143,36,21,86,38,9,6,3,0,29,9,0,20,112,68,0,11,57,44,21,0,0,21,23,0,0,23,39654
12911,834,137,454,192,41,10,42,42,36,0,0,36,6,6,0,6,0,0,0,0,0,0,0,0,0,0,0,0,0,0,0,0,0,0,0,39656
12912,1126,279,415,292,83,57,132,108,45,0,0,45,63,9,9,0,0,54,0,3,51,24,24,21,1,2,0,0,0,0,0,0,0,0,0,39657
12913,1858,510,862,383,65,38,83,47,43,6,0,37,4,4,0,0,4,0,0,0,0,36,36,0,0,36,0,0,0,0,0,0,0,0,0,39661
12914,803,116,362,166,101,58,30,15,15,0,0,15,0,0,0,0,0,0,0,0,0,15,15,15,0,0,0,0,0,0,0,0,0,0,0,39662
12915,2023,339,786,686,151,61,149,90,19,0,0,19,71,34,0,0,34,37,0,0,37,59,59,0,19,40,0,0,0,0,0,0,0,0,0,39663
12916,1581,534,558,370,96,23,38,18,18,12,0,6,0,0,0,0,0,0,0,0,0,20,20,0,0,20,0,0,0,0,0,0,0,0,0,39664
12917,883,194,307,314,60,8,55,36,36,0,0,36,0,0,0,0,0,0,0,0,0,19,19,0,0,19,0,0,0,0,0,0,0,0,0,39665
12918,6314,1097,1852,2275,699,391,705,249,185,14,19,152,64,0,0,0,0,64,6,21,37,456,366,72,24,270,90,57,0,10,47,33,0,0,33,39666
12919,8308,2126,3188,1980,644,370,992,477,449,128,46,275,28,28,0,0,28,0,0,0,0,515,510,73,5,432,5,0,0,0,0,5,0,0,5,39667
12920,193,19,83,51,13,27,0,0,0,0,0,0,0,0,0,0,0,0,0,0,0,0,0,0,0,0,0,0,0,0,0,0,0,0,0,39668
12921,4033,1097,1605,901,307,123,278,137,75,0,0,75,62,34,0,34,0,28,0,15,13,141,94,10,3,81,47,32,9,23,0,15,0,0,15,39669
12922,8971,2292,2655,2184,1105,735,826,359,272,46,33,193,87,15,0,0,15,72,0,0,72,467,385,70,86,229,82,34,0,8,26,48,19,4,25,39701
12923,14338,2427,4822,4870,1424,795,1245,556,407,115,65,227,149,111,26,79,6,38,0,12,26,689,617,156,121,340,72,53,28,0,25,19,0,0,19,39702
12924,9203,950,2266,2798,2043,1146,711,337,271,62,21,188,66,41,24,17,0,25,0,0,25,374,358,70,69,219,16,16,0,14,2,0,0,0,0,39705
12925,7812,2091,2630,1918,686,487,595,318,192,32,0,160,126,64,21,17,26,62,0,0,62,277,232,27,28,177,45,6,0,0,6,39,0,0,39,39730
12926,2679,483,1019,788,244,145,229,115,93,6,15,72,22,17,0,17,0,5,0,0,5,114,98,32,26,40,16,4,0,0,4,12,0,0,12,39735
12927,142,44,53,39,6,0,11,4,4,0,0,4,0,0,0,0,0,0,0,0,0,7,7,0,6,1,0,0,0,0,0,0,0,0,0,39736
12928,321,14,152,93,50,12,17,10,10,0,0,10,0,0,0,0,0,0,0,0,0,7,0,0,0,0,7,7,7,0,0,0,0,0,0,39737
12929,1741,619,508,437,125,52,183,64,51,0,16,35,13,13,13,0,0,0,0,0,0,119,119,0,0,119,0,0,0,0,0,0,0,0,0,39739
12930,3494,560,1139,1254,353,188,209,57,57,0,3,54,0,0,0,0,0,0,0,0,0,152,148,35,19,94,4,0,0,0,0,4,0,0,4,39740
12931,950,173,419,242,57,59,27,9,9,0,2,7,0,0,0,0,0,0,0,0,0,18,18,15,0,3,0,0,0,0,0,0,0,0,0,39741
12932,982,285,377,211,95,14,141,90,46,0,7,39,44,40,0,40,0,4,0,4,0,51,45,2,13,30,6,6,0,6,0,0,0,0,0,39743
12933,3710,728,1142,1041,535,264,342,137,102,23,18,61,35,35,7,28,0,0,0,0,0,205,177,89,0,88,28,3,0,0,3,25,0,0,25,39744
12934,516,91,155,174,68,28,42,37,8,0,0,8,29,0,0,0,0,29,29,0,0,5,5,3,0,2,0,0,0,0,0,0,0,0,0,39745
12935,2115,345,904,553,246,67,150,106,78,6,0,72,28,28,0,0,28,0,0,0,0,44,44,8,8,28,0,0,0,0,0,0,0,0,0,39746
12936,1383,407,505,323,104,44,96,54,27,0,0,27,27,23,9,0,14,4,0,4,0,42,42,0,0,42,0,0,0,0,0,0,0,0,0,39747
12937,2023,529,563,509,154,268,151,69,58,0,15,43,11,0,0,0,0,11,0,5,6,82,72,16,2,54,10,0,0,0,0,10,0,0,10,39750
12938,1011,225,382,303,55,46,59,22,22,0,0,22,0,0,0,0,0,0,0,0,0,37,17,0,0,17,20,0,0,0,0,20,0,20,0,39751
12939,1809,321,569,675,172,72,75,39,30,0,2,28,9,0,0,0,0,9,5,4,0,36,32,2,11,19,4,4,0,4,0,0,0,0,0,39752
12940,567,130,184,146,56,51,52,44,44,4,0,40,0,0,0,0,0,0,0,0,0,8,8,0,0,8,0,0,0,0,0,0,0,0,0,39755
12941,1463,441,429,355,195,43,221,68,51,0,0,51,17,0,0,0,0,17,0,0,17,153,134,8,0,126,19,19,0,0,19,0,0,0,0,39756
12942,22106,2910,3939,5389,4937,4931,2933,1547,1469,295,111,1063,78,68,0,32,36,10,0,0,10,1386,1342,297,259,786,44,26,0,17,9,18,0,0,18,39759
12943,0,0,0,0,0,0,0,0,0,0,0,0,0,0,0,0,0,0,0,0,0,0,0,0,0,0,0,0,0,0,0,0,0,0,0,39760
12944,37,24,3,10,0,0,1442,626,626,65,151,410,0,0,0,0,0,0,0,0,0,816,816,127,164,525,0,0,0,0,0,0,0,0,0,39762
12945,1777,484,545,397,325,26,103,49,49,21,0,28,0,0,0,0,0,0,0,0,0,54,54,0,0,54,0,0,0,0,0,0,0,0,0,39766
12946,474,116,172,146,27,13,15,0,0,0,0,0,0,0,0,0,0,0,0,0,0,15,0,0,0,0,15,15,0,0,15,0,0,0,0,39767
12947,1389,226,448,441,218,56,94,51,45,0,0,45,6,0,0,0,0,6,0,6,0,43,43,0,0,43,0,0,0,0,0,0,0,0,0,39769
12948,83,10,15,35,19,4,12,0,0,0,0,0,0,0,0,0,0,0,0,0,0,12,4,2,0,2,8,8,8,0,0,0,0,0,0,39771
12949,1054,267,345,374,11,57,57,23,23,7,0,16,0,0,0,0,0,0,0,0,0,34,31,0,12,19,3,3,0,0,3,0,0,0,0,39772
12950,11016,2259,3466,3244,1449,598,782,427,327,38,81,208,100,37,30,0,7,63,14,35,14,355,271,23,61,187,84,36,0,0,36,48,37,11,0,39773
12951,988,220,399,292,55,22,52,9,9,0,0,9,0,0,0,0,0,0,0,0,0,43,43,0,6,37,0,0,0,0,0,0,0,0,0,39776
12952,1248,359,397,372,86,34,123,79,57,0,17,40,22,12,0,1,11,10,0,0,10,44,38,0,0,38,6,6,1,1,4,0,0,0,0,39813
12953,1074,314,461,199,75,25,142,56,56,0,0,56,0,0,0,0,0,0,0,0,0,86,67,5,0,62,19,0,0,0,0,19,0,0,19,39815
12954,7416,1758,2532,2455,430,241,735,302,244,50,15,179,58,0,0,0,0,58,0,8,50,433,401,101,0,300,32,15,7,0,8,17,0,0,17,39817
12955,7133,1372,2083,2133,932,613,559,305,276,51,0,225,29,29,12,0,17,0,0,0,0,254,203,36,27,140,51,39,30,9,0,12,0,0,12,39819
12956,5698,1256,2037,1548,469,388,524,265,240,59,0,181,25,18,0,0,18,7,0,0,7,259,252,31,0,221,7,1,1,0,0,6,0,0,6,39823
12957,269,45,143,58,13,10,11,3,3,3,0,0,0,0,0,0,0,0,0,0,0,8,8,0,0,8,0,0,0,0,0,0,0,0,0,39824
12958,845,158,366,260,36,25,70,65,45,0,0,45,20,0,0,0,0,20,0,0,20,5,5,0,0,5,0,0,0,0,0,0,0,0,0,39825
12959,401,192,84,77,13,35,50,50,18,0,0,18,32,15,15,0,0,17,0,17,0,0,0,0,0,0,0,0,0,0,0,0,0,0,0,39826
12960,2580,684,1026,595,179,96,330,215,140,69,0,71,75,58,58,0,0,17,0,0,17,115,115,7,7,101,0,0,0,0,0,0,0,0,0,39827
12961,10075,3066,3861,2070,667,411,836,414,193,2,7,184,221,43,0,43,0,178,77,38,63,422,305,22,52,231,117,73,39,34,0,44,36,0,8,39828
12962,1443,281,375,554,131,102,98,54,54,0,0,54,0,0,0,0,0,0,0,0,0,44,44,3,0,41,0,0,0,0,0,0,0,0,0,39834
12963,457,159,140,44,19,95,47,43,43,18,0,25,0,0,0,0,0,0,0,0,0,4,4,0,0,4,0,0,0,0,0,0,0,0,0,39836
12964,4162,773,1733,1235,234,187,290,165,124,10,0,114,41,0,0,0,0,41,33,0,8,125,87,23,8,56,38,31,0,0,31,7,0,0,7,39837
12965,3829,991,1251,847,368,372,292,123,92,14,2,76,31,0,0,0,0,31,0,9,22,169,111,0,0,111,58,58,0,39,19,0,0,0,0,39840
12966,400,96,182,75,27,20,64,32,29,0,0,29,3,0,0,0,0,3,0,0,3,32,10,0,0,10,22,22,0,0,22,0,0,0,0,39841
12967,5266,1807,1861,1179,281,138,377,133,112,4,0,108,21,7,7,0,0,14,0,0,14,244,229,42,28,159,15,7,7,0,0,8,0,0,8,39842
12968,5462,997,2244,1566,420,235,441,196,152,43,0,109,44,44,18,11,15,0,0,0,0,245,215,84,3,128,30,10,0,0,10,20,0,0,20,39845
12969,1143,295,310,311,142,85,63,15,15,0,0,15,0,0,0,0,0,0,0,0,0,48,44,4,0,40,4,4,0,4,0,0,0,0,0,39846
12970,1453,357,562,436,41,57,102,76,46,0,6,40,30,23,0,0,23,7,0,0,7,26,26,5,0,21,0,0,0,0,0,0,0,0,0,39851
12971,1583,434,668,418,51,12,142,65,38,14,0,24,27,27,0,0,27,0,0,0,0,77,74,11,0,63,3,3,3,0,0,0,0,0,0,39854
12972,820,219,266,209,83,43,59,7,7,0,0,7,0,0,0,0,0,0,0,0,0,52,31,1,0,30,21,21,0,21,0,0,0,0,0,39859
12973,685,166,315,153,28,23,49,2,2,0,0,2,0,0,0,0,0,0,0,0,0,47,35,0,0,35,12,12,12,0,0,0,0,0,0,39861
12974,799,162,285,249,71,32,54,23,23,0,1,22,0,0,0,0,0,0,0,0,0,31,31,2,0,29,0,0,0,0,0,0,0,0,0,39862
12975,2082,773,873,302,95,39,293,80,80,39,0,41,0,0,0,0,0,0,0,0,0,213,79,72,0,7,134,106,106,0,0,28,22,3,3,39866
12976,306,118,32,145,11,0,22,22,22,0,0,22,0,0,0,0,0,0,0,0,0,0,0,0,0,0,0,0,0,0,0,0,0,0,0,39867
12977,1502,391,626,299,126,60,168,125,104,0,0,104,21,0,0,0,0,21,14,3,4,43,43,0,0,43,0,0,0,0,0,0,0,0,0,39870
12978,317,96,138,57,19,7,23,22,22,0,0,22,0,0,0,0,0,0,0,0,0,1,0,0,0,0,1,1,1,0,0,0,0,0,0,39877
12979,83,14,25,36,7,1,0,0,0,0,0,0,0,0,0,0,0,0,0,0,0,0,0,0,0,0,0,0,0,0,0,0,0,0,0,39885
12980,1070,272,451,274,36,37,76,39,39,0,17,22,0,0,0,0,0,0,0,0,0,37,35,0,16,19,2,0,0,0,0,2,2,0,0,39886
12981,2309,460,929,622,153,145,159,46,35,0,0,35,11,11,0,11,0,0,0,0,0,113,64,29,0,35,49,0,0,0,0,49,0,0,49,39897
12982,1461,253,532,456,131,89,147,74,51,14,0,37,23,0,0,0,0,23,23,0,0,73,73,11,0,62,0,0,0,0,0,0,0,0,0,40003
12983,18666,2192,7800,5386,2007,1281,1588,867,572,94,21,457,295,226,161,65,0,69,0,0,69,721,642,106,44,492,79,47,0,47,0,32,0,0,32,40004
12984,3321,587,1403,765,359,207,147,43,43,0,0,43,0,0,0,0,0,0,0,0,0,104,75,0,33,42,29,29,0,22,7,0,0,0,0,40006
12985,52,5,19,18,10,0,8,8,8,0,0,8,0,0,0,0,0,0,0,0,0,0,0,0,0,0,0,0,0,0,0,0,0,0,0,40007
12986,2496,482,1086,554,194,180,194,129,126,11,18,97,3,3,3,0,0,0,0,0,0,65,53,18,10,25,12,12,12,0,0,0,0,0,0,40008
12987,1011,216,460,207,102,26,33,25,25,6,0,19,0,0,0,0,0,0,0,0,0,8,8,0,0,8,0,0,0,0,0,0,0,0,0,40009
12988,342,0,71,138,117,16,11,11,11,11,0,0,0,0,0,0,0,0,0,0,0,0,0,0,0,0,0,0,0,0,0,0,0,0,0,40010
12989,1388,161,679,365,117,66,125,51,37,9,0,28,14,14,14,0,0,0,0,0,0,74,50,41,0,9,24,24,10,0,14,0,0,0,0,40011
12990,447,60,288,76,23,0,6,6,6,6,0,0,0,0,0,0,0,0,0,0,0,0,0,0,0,0,0,0,0,0,0,0,0,0,0,40012
12991,3711,413,1652,1018,352,276,297,163,156,39,0,117,7,7,0,0,7,0,0,0,0,134,134,10,13,111,0,0,0,0,0,0,0,0,0,40013
12992,12881,937,2910,2993,3553,2488,1123,575,522,101,52,369,53,41,25,0,16,12,0,0,12,548,489,234,45,210,59,50,6,44,0,9,9,0,0,40014
12993,2326,635,1017,404,119,151,177,104,68,7,13,48,36,19,19,0,0,17,0,17,0,73,43,14,0,29,30,8,8,0,0,22,0,22,0,40019
12994,75,18,31,18,2,6,18,0,0,0,0,0,0,0,0,0,0,0,0,0,0,18,18,13,0,5,0,0,0,0,0,0,0,0,0,40020
12995,577,54,227,128,118,50,40,32,12,4,0,8,20,20,20,0,0,0,0,0,0,8,8,0,0,8,0,0,0,0,0,0,0,0,0,40022
12996,2953,155,792,724,887,395,341,206,192,71,73,48,14,14,14,0,0,0,0,0,0,135,135,33,0,102,0,0,0,0,0,0,0,0,0,40023
12997,74,0,11,8,31,24,0,0,0,0,0,0,0,0,0,0,0,0,0,0,0,0,0,0,0,0,0,0,0,0,0,0,0,0,0,40025
12998,3386,75,438,1096,1108,669,425,181,153,39,16,98,28,17,15,0,2,11,0,0,11,244,244,114,2,128,0,0,0,0,0,0,0,0,0,40026
12999,16153,2147,4770,5407,2447,1382,987,577,489,188,39,262,88,61,8,34,19,27,0,0,27,410,335,114,47,174,75,66,19,42,5,9,0,9,0,40031
13000,8220,1497,3523,1931,725,544,773,458,391,98,23,270,67,44,35,8,1,23,0,0,23,315,246,113,44,89,69,69,56,0,13,0,0,0,0,40033
13001,165,91,36,10,11,17,1,0,0,0,0,0,0,0,0,0,0,0,0,0,0,1,0,0,0,0,1,1,0,0,1,0,0,0,0,40036
13002,1838,339,926,465,53,55,153,127,103,15,2,86,24,24,0,12,12,0,0,0,0,26,26,0,0,26,0,0,0,0,0,0,0,0,0,40037
13003,313,32,151,92,25,13,27,14,10,0,0,10,4,4,0,4,0,0,0,0,0,13,5,0,5,0,8,8,0,0,8,0,0,0,0,40040
13004,323,66,198,33,10,16,0,0,0,0,0,0,0,0,0,0,0,0,0,0,0,0,0,0,0,0,0,0,0,0,0,0,0,0,0,40041
13005,2439,294,1100,665,296,84,298,223,205,38,0,167,18,0,0,0,0,18,0,0,18,75,75,6,15,54,0,0,0,0,0,0,0,0,0,40045
13006,1460,153,626,563,87,31,79,38,27,7,0,20,11,11,11,0,0,0,0,0,0,41,41,8,0,33,0,0,0,0,0,0,0,0,0,40046
13007,12586,1189,4776,4323,1420,878,1059,573,432,130,0,302,141,117,76,36,5,24,10,0,14,486,442,151,103,188,44,44,8,7,29,0,0,0,0,40047
13008,90,11,5,0,11,63,0,0,0,0,0,0,0,0,0,0,0,0,0,0,0,0,0,0,0,0,0,0,0,0,0,0,0,0,0,40048
13009,109,28,4,0,27,50,0,0,0,0,0,0,0,0,0,0,0,0,0,0,0,0,0,0,0,0,0,0,0,0,0,0,0,0,0,40049
13010,1052,202,496,191,96,67,73,39,28,15,0,13,11,11,0,2,9,0,0,0,0,34,21,5,4,12,13,13,0,5,8,0,0,0,0,40050
13011,2999,506,1472,737,192,92,176,98,84,37,0,47,14,5,2,3,0,9,0,9,0,78,71,40,3,28,7,7,4,0,3,0,0,0,0,40051
13012,272,75,120,57,15,5,78,33,27,7,0,20,6,6,6,0,0,0,0,0,0,45,39,0,39,0,6,6,0,0,6,0,0,0,0,40052
13013,1391,140,592,522,91,46,167,68,68,38,0,30,0,0,0,0,0,0,0,0,0,99,35,5,0,30,64,0,0,0,0,64,0,0,64,40055
13014,2330,218,677,708,463,264,189,117,103,26,25,52,14,14,14,0,0,0,0,0,0,72,72,21,3,48,0,0,0,0,0,0,0,0,0,40056
13015,2588,508,1133,580,272,95,188,113,99,5,0,94,14,6,6,0,0,8,0,8,0,75,59,42,11,6,16,16,12,4,0,0,0,0,0,40057
13016,78,14,33,11,9,11,0,0,0,0,0,0,0,0,0,0,0,0,0,0,0,0,0,0,0,0,0,0,0,0,0,0,0,0,0,40058
13017,11950,345,917,2586,4549,3553,976,478,451,103,32,316,27,27,27,0,0,0,0,0,0,498,487,148,0,339,11,11,0,0,11,0,0,0,0,40059
13018,818,128,455,179,36,20,37,5,5,0,0,5,0,0,0,0,0,0,0,0,0,32,12,0,5,7,20,20,0,0,20,0,0,0,0,40060
13019,345,34,231,35,31,14,14,14,0,0,0,0,14,0,0,0,0,14,0,0,14,0,0,0,0,0,0,0,0,0,0,0,0,0,0,40062
13020,642,72,409,152,0,9,19,19,0,0,0,0,19,0,0,0,0,19,0,0,19,0,0,0,0,0,0,0,0,0,0,0,0,0,0,40063
13021,19023,3117,5810,5703,2794,1599,1509,887,603,108,94,401,284,81,79,0,2,203,153,38,12,622,558,161,44,353,64,64,46,0,18,0,0,0,0,40065
13022,3565,371,939,988,703,564,436,197,139,12,4,123,58,48,33,0,15,10,0,0,10,239,195,63,35,97,44,7,0,0,7,37,18,0,19,40067
13023,1529,320,609,378,106,116,66,26,26,7,0,19,0,0,0,0,0,0,0,0,0,40,40,13,0,27,0,0,0,0,0,0,0,0,0,40068
13024,5439,982,2284,1174,444,555,658,361,246,26,41,179,115,78,60,18,0,37,0,0,37,297,291,156,3,132,6,6,6,0,0,0,0,0,0,40069
13025,359,98,155,89,0,17,48,31,31,12,0,19,0,0,0,0,0,0,0,0,0,17,17,0,0,17,0,0,0,0,0,0,0,0,0,40070
13026,9765,1235,3569,3321,1029,611,900,466,413,154,18,241,53,21,21,0,0,32,9,23,0,434,416,185,16,215,18,18,0,0,18,0,0,0,0,40071
13027,858,144,446,176,65,27,32,24,4,0,4,0,20,4,0,0,4,16,8,0,8,8,8,0,0,8,0,0,0,0,0,0,0,0,0,40075
13028,1596,199,645,544,122,86,67,41,31,0,1,30,10,10,10,0,0,0,0,0,0,26,26,19,2,5,0,0,0,0,0,0,0,0,0,40076
13029,356,16,132,135,62,11,21,21,21,10,0,11,0,0,0,0,0,0,0,0,0,0,0,0,0,0,0,0,0,0,0,0,0,0,0,40077
13030,1602,404,692,382,72,52,112,72,56,11,0,45,16,9,9,0,0,7,0,0,7,40,40,19,0,21,0,0,0,0,0,0,0,0,0,40078
13031,934,208,372,279,55,20,61,39,39,0,0,39,0,0,0,0,0,0,0,0,0,22,22,22,0,0,0,0,0,0,0,0,0,0,0,40104
13032,1497,270,694,345,116,72,115,43,16,6,0,10,27,27,27,0,0,0,0,0,0,72,72,72,0,0,0,0,0,0,0,0,0,0,0,40107
13033,7795,980,3152,2453,528,682,595,322,206,55,68,83,116,108,74,6,28,8,8,0,0,273,187,42,60,85,86,86,9,0,77,0,0,0,0,40108
13034,1683,305,799,391,129,59,73,37,37,0,0,37,0,0,0,0,0,0,0,0,0,36,36,7,0,29,0,0,0,0,0,0,0,0,0,40109
13035,16,16,0,0,0,0,0,0,0,0,0,0,0,0,0,0,0,0,0,0,0,0,0,0,0,0,0,0,0,0,0,0,0,0,0,40110
13036,1206,360,462,348,21,15,94,61,61,14,0,47,0,0,0,0,0,0,0,0,0,33,30,3,1,26,3,3,0,0,3,0,0,0,0,40111
13037,529,162,191,144,17,15,57,0,0,0,0,0,0,0,0,0,0,0,0,0,0,57,57,0,0,57,0,0,0,0,0,0,0,0,0,40115
13038,1672,195,625,683,82,87,197,140,129,13,0,116,11,11,0,11,0,0,0,0,0,57,57,0,0,57,0,0,0,0,0,0,0,0,0,40117
13039,6047,1618,2626,1440,254,109,529,302,243,45,54,144,59,50,33,0,17,9,9,0,0,227,167,45,6,116,60,34,34,0,0,26,0,0,26,40118
13040,1457,309,732,257,97,62,23,23,23,10,6,7,0,0,0,0,0,0,0,0,0,0,0,0,0,0,0,0,0,0,0,0,0,0,0,40119
13041,4540,180,852,2435,705,368,1028,827,411,241,25,145,416,416,416,0,0,0,0,0,0,201,170,66,27,77,31,21,15,0,6,10,9,0,1,40121
13042,233,40,114,46,33,0,0,0,0,0,0,0,0,0,0,0,0,0,0,0,0,0,0,0,0,0,0,0,0,0,0,0,0,0,0,40140
13043,1575,343,628,449,101,54,72,33,33,0,0,33,0,0,0,0,0,0,0,0,0,39,39,0,0,39,0,0,0,0,0,0,0,0,0,40142
13044,4554,956,1875,1145,270,308,364,194,66,34,0,32,128,46,0,42,4,82,0,82,0,170,133,16,18,99,37,36,36,0,0,1,1,0,0,40143
13045,1210,375,580,206,26,23,90,41,21,0,0,21,20,20,20,0,0,0,0,0,0,49,36,20,0,16,13,0,0,0,0,13,0,0,13,40144
13046,565,229,191,85,32,28,59,33,33,0,0,33,0,0,0,0,0,0,0,0,0,26,21,0,15,6,5,5,5,0,0,0,0,0,0,40145
13047,2795,541,1333,715,138,68,168,58,30,0,15,15,28,0,0,0,0,28,0,0,28,110,59,11,0,48,51,18,9,0,9,33,23,0,10,40146
13048,2769,484,1432,693,118,42,184,67,51,11,0,40,16,16,11,3,2,0,0,0,0,117,110,34,13,63,7,7,0,7,0,0,0,0,0,40150
13049,376,34,243,82,0,17,6,0,0,0,0,0,0,0,0,0,0,0,0,0,0,6,6,0,6,0,0,0,0,0,0,0,0,0,0,40152
13050,678,151,273,219,23,12,70,35,26,0,0,26,9,9,4,5,0,0,0,0,0,35,22,6,0,16,13,13,0,0,13,0,0,0,0,40155
13051,565,163,270,122,10,0,77,40,40,11,0,29,0,0,0,0,0,0,0,0,0,37,37,37,0,0,0,0,0,0,0,0,0,0,0,40157
13052,14538,1745,4682,5882,1325,904,968,410,320,90,21,209,90,73,64,9,0,17,0,10,7,558,368,83,39,246,190,145,50,6,89,45,0,25,20,40160
13053,86,0,67,19,0,0,0,0,0,0,0,0,0,0,0,0,0,0,0,0,0,0,0,0,0,0,0,0,0,0,0,0,0,0,0,40161
13054,4114,423,1304,1542,564,281,149,43,26,0,11,15,17,17,17,0,0,0,0,0,0,106,98,30,0,68,8,8,8,0,0,0,0,0,0,40162
13055,22878,4034,9517,6564,1718,1045,2135,1069,892,150,42,700,177,154,116,17,21,23,6,17,0,1066,892,271,166,455,174,117,83,19,15,57,0,51,6,40165
13056,216,90,94,32,0,0,0,0,0,0,0,0,0,0,0,0,0,0,0,0,0,0,0,0,0,0,0,0,0,0,0,0,0,0,0,40170
13057,210,39,117,54,0,0,0,0,0,0,0,0,0,0,0,0,0,0,0,0,0,0,0,0,0,0,0,0,0,0,0,0,0,0,0,40171
13058,9122,1027,3215,3122,1083,675,363,177,121,17,57,47,56,56,43,13,0,0,0,0,0,186,179,30,27,122,7,0,0,0,0,7,0,0,7,40175
13059,639,108,289,137,70,35,25,12,12,0,12,0,0,0,0,0,0,0,0,0,0,13,13,13,0,0,0,0,0,0,0,0,0,0,0,40176
13060,1072,272,452,260,65,23,84,49,31,13,0,18,18,15,12,0,3,3,0,0,3,35,19,0,0,19,16,13,5,8,0,3,0,0,3,40177
13061,292,62,102,62,47,19,0,0,0,0,0,0,0,0,0,0,0,0,0,0,0,0,0,0,0,0,0,0,0,0,0,0,0,0,0,40178
13062,4766,874,1732,1300,406,454,377,225,97,0,0,97,128,75,26,0,49,53,0,0,53,152,135,12,0,123,17,17,17,0,0,0,0,0,0,40202
13063,12043,3312,3599,3586,855,691,830,512,351,98,28,225,161,105,34,16,55,56,19,14,23,318,297,87,29,181,21,21,21,0,0,0,0,0,0,40203
13064,11185,831,2124,2813,2780,2637,466,252,205,80,21,104,47,44,44,0,0,3,0,0,3,214,162,64,0,98,52,36,0,0,36,16,0,0,16,40204
13065,17405,615,2067,4295,5411,5017,1255,612,547,133,22,392,65,42,6,25,11,23,12,0,11,643,632,298,29,305,11,8,8,0,0,3,0,0,3,40205
13066,14102,1048,2343,3716,3671,3324,608,352,322,50,43,229,30,30,30,0,0,0,0,0,0,256,198,70,33,95,58,37,15,0,22,21,9,5,7,40206
13067,21745,737,2850,4954,7492,5712,956,449,397,84,28,285,52,48,38,4,6,4,0,0,4,507,471,167,22,282,36,36,6,7,23,0,0,0,0,40207
13068,7134,1383,1959,2172,840,780,2474,1097,1028,279,63,686,69,43,6,0,37,26,0,20,6,1377,1328,538,76,714,49,49,49,0,0,0,0,0,0,40208
13069,438,185,93,108,35,17,0,0,0,0,0,0,0,0,0,0,0,0,0,0,0,0,0,0,0,0,0,0,0,0,0,0,0,0,0,40209
13070,9250,2238,2908,3364,527,213,797,451,363,68,27,268,88,42,23,19,0,46,0,5,41,346,219,48,7,164,127,105,50,55,0,22,0,0,22,40210
13071,13866,2941,4606,4942,937,440,1320,605,457,62,44,351,148,95,45,50,0,53,0,34,19,715,623,115,54,454,92,61,33,9,19,31,10,0,21,40211
13072,11577,2870,4409,3445,478,375,1183,761,563,77,76,410,198,126,14,29,83,72,10,19,43,422,358,68,65,225,64,21,6,15,0,43,6,8,29,40212
13073,10922,1743,4014,3224,1215,726,612,325,234,94,40,100,91,46,25,8,13,45,29,8,8,287,230,25,101,104,57,10,10,0,0,47,0,17,30,40213
13074,31032,5785,10823,9456,3190,1778,2393,1267,1034,225,108,701,233,173,76,49,48,60,39,15,6,1126,757,247,97,413,369,217,19,198,0,152,20,63,69,40214
13075,13789,3340,5499,3978,671,301,1246,663,541,58,26,457,122,49,16,13,20,73,13,59,1,583,449,72,37,340,134,39,36,3,0,95,25,23,47,40215
13076,27373,4556,10480,9103,1985,1249,2224,1366,1206,239,83,884,160,99,69,30,0,61,0,43,18,858,709,264,22,423,149,103,26,40,37,46,20,0,26,40216
13077,9175,1091,2438,2658,1667,1321,558,373,264,59,0,205,109,54,54,0,0,55,0,0,55,185,174,140,2,32,11,11,5,6,0,0,0,0,0,40217
13078,19877,2247,6085,6683,3170,1692,1308,613,489,136,57,296,124,124,66,30,28,0,0,0,0,695,656,195,84,377,39,27,13,1,13,12,12,0,0,40218
13079,25930,4788,9821,7747,2397,1177,2024,1030,724,132,133,459,306,271,168,59,44,35,35,0,0,994,790,335,100,355,204,204,59,66,79,0,0,0,0,40219
13080,24172,1775,5887,7443,5522,3545,1345,660,557,131,70,356,103,103,77,0,26,0,0,0,0,685,610,204,72,334,75,62,40,18,4,13,0,0,13,40220
13081,16171,668,2674,4527,5252,3050,652,356,302,71,54,177,54,45,45,0,0,9,0,0,9,296,265,127,0,138,31,31,30,0,1,0,0,0,0,40222
13082,15251,528,2370,4085,4695,3573,959,491,468,185,3,280,23,19,2,0,17,4,0,0,4,468,424,147,22,255,44,36,0,1,35,8,0,0,8,40223
13083,10586,1013,2925,3532,2091,1025,1007,476,427,69,48,310,49,36,7,29,0,13,0,0,13,531,513,168,7,338,18,18,18,0,0,0,0,0,0,40228
13084,23182,3265,9024,7793,2044,1056,1806,1024,667,182,114,371,357,201,121,37,43,156,101,43,12,782,646,238,49,359,136,122,76,4,42,14,0,7,7,40229
13085,0,0,0,0,0,0,0,0,0,0,0,0,0,0,0,0,0,0,0,0,0,0,0,0,0,0,0,0,0,0,0,0,0,0,0,40231
13086,20948,626,2787,5362,6998,5175,1437,737,689,203,52,434,48,47,43,4,0,1,0,0,1,700,611,237,7,367,89,89,69,4,16,0,0,0,0,40241
13087,7714,352,1473,2266,2261,1362,469,289,266,136,26,104,23,11,9,2,0,12,12,0,0,180,151,56,4,91,29,20,20,0,0,9,0,0,9,40242
13088,7985,385,1625,2556,2137,1282,316,173,136,16,5,115,37,37,0,37,0,0,0,0,0,143,143,56,14,73,0,0,0,0,0,0,0,0,0,40243
13089,20775,767,3149,5312,6779,4768,1239,654,618,319,24,275,36,25,21,4,0,11,0,0,11,585,561,178,10,373,24,24,16,0,8,0,0,0,0,40245
13090,18096,2433,8175,5738,1292,458,1397,618,459,100,42,317,159,100,65,8,27,59,32,0,27,779,550,169,0,381,229,131,121,10,0,98,16,0,82,40258
13091,25506,3791,10564,8186,1784,1181,1799,657,461,87,79,295,196,185,118,44,23,11,0,11,0,1142,980,218,97,665,162,91,55,0,36,71,11,13,47,40272
13092,207,0,0,93,101,13,158,125,125,70,0,55,0,0,0,0,0,0,0,0,0,33,33,11,0,22,0,0,0,0,0,0,0,0,0,40280
13093,23571,1549,6726,8484,4595,2217,1313,669,568,151,73,344,101,84,64,20,0,17,1,0,16,644,567,257,53,257,77,77,77,0,0,0,0,0,0,40291
13094,26744,2022,6673,8612,5979,3458,1533,863,669,209,52,408,194,66,51,0,15,128,52,0,76,670,562,186,47,329,108,92,92,0,0,16,0,3,13,40299
13095,430,106,200,89,32,3,21,12,3,0,3,0,9,9,0,0,9,0,0,0,0,9,4,0,0,4,5,5,5,0,0,0,0,0,0,40310
13096,5041,991,1923,1425,423,279,385,220,158,43,8,107,62,30,0,6,24,32,23,0,9,165,106,13,7,86,59,59,44,0,15,0,0,0,0,40311
13097,4343,1439,1738,835,135,196,247,134,107,5,20,82,27,23,2,0,21,4,0,0,4,113,88,43,14,31,25,25,25,0,0,0,0,0,0,40312
13098,2116,476,829,472,140,199,186,81,81,55,0,26,0,0,0,0,0,0,0,0,0,105,105,85,0,20,0,0,0,0,0,0,0,0,0,40313
13099,157,58,61,0,21,17,28,11,11,0,0,11,0,0,0,0,0,0,0,0,0,17,17,0,0,17,0,0,0,0,0,0,0,0,0,40316
13100,2214,740,739,512,124,99,227,87,46,18,6,22,41,32,5,7,20,9,9,0,0,140,106,31,24,51,34,33,21,12,0,1,1,0,0,40322
13101,26996,3235,8301,7693,4674,3093,2427,1110,951,292,51,608,159,109,88,0,21,50,12,11,27,1317,1103,456,91,556,214,161,78,83,0,53,26,0,27,40324
13102,749,121,358,233,21,16,30,0,0,0,0,0,0,0,0,0,0,0,0,0,0,30,30,14,0,16,0,0,0,0,0,0,0,0,0,40328
13103,13058,2176,4960,3533,1303,1086,1018,616,554,346,45,163,62,34,30,4,0,28,26,0,2,402,376,98,99,179,26,26,8,0,18,0,0,0,0,40330
13104,41,41,0,0,0,0,18,9,0,0,0,0,9,9,0,0,9,0,0,0,0,9,9,0,0,9,0,0,0,0,0,0,0,0,0,40334
13105,9191,2518,4220,1686,338,429,527,349,297,51,5,241,52,26,22,0,4,26,0,7,19,178,135,35,0,100,43,7,7,0,0,36,0,14,22,40336
13106,3775,980,1607,924,130,134,251,148,112,4,5,103,36,14,0,0,14,22,0,22,0,103,100,15,19,66,3,3,0,3,0,0,0,0,0,40337
13107,0,0,0,0,0,0,0,0,0,0,0,0,0,0,0,0,0,0,0,0,0,0,0,0,0,0,0,0,0,0,0,0,0,0,0,40339
13108,14302,1826,5348,4188,1715,1225,1141,603,492,217,22,253,111,74,55,0,19,37,0,37,0,538,473,187,6,280,65,29,0,0,29,36,0,7,29,40342
13109,419,113,182,115,0,9,68,56,52,0,0,52,4,0,0,0,0,4,0,0,4,12,12,12,0,0,0,0,0,0,0,0,0,0,0,40346
13110,1906,140,464,536,483,283,170,31,23,0,0,23,8,8,8,0,0,0,0,0,0,139,139,69,8,62,0,0,0,0,0,0,0,0,0,40347
13111,509,148,221,98,28,14,43,35,28,16,0,12,7,0,0,0,0,7,5,2,0,8,8,0,0,8,0,0,0,0,0,0,0,0,0,40348
13112,76,46,30,0,0,0,0,0,0,0,0,0,0,0,0,0,0,0,0,0,0,0,0,0,0,0,0,0,0,0,0,0,0,0,0,40350
13113,11376,2616,3418,2474,1317,1551,2343,902,852,116,0,736,50,18,8,0,10,32,0,17,15,1441,1209,174,37,998,232,147,115,0,32,85,0,0,85,40351
13114,13962,2815,5315,3491,1419,922,1004,464,352,114,69,169,112,72,14,47,11,40,0,9,31,540,413,124,0,289,127,10,3,0,7,117,0,21,96,40353
13115,26967,4163,8167,8118,4112,2407,2268,1145,947,275,173,499,198,186,135,28,23,12,0,0,12,1123,982,264,133,585,141,90,77,1,12,51,10,20,21,40356
13116,644,212,166,169,82,15,34,9,9,0,9,0,0,0,0,0,0,0,0,0,0,25,25,12,0,13,0,0,0,0,0,0,0,0,0,40358
13117,4672,848,2059,1090,418,257,322,207,195,59,4,132,12,12,0,12,0,0,0,0,0,115,79,32,0,47,36,36,20,14,2,0,0,0,0,40359
13118,4624,920,1783,1201,508,212,375,218,150,33,9,108,68,68,14,54,0,0,0,0,0,157,157,0,7,150,0,0,0,0,0,0,0,0,0,40360
13119,12401,2166,4879,3351,1385,620,1087,607,491,74,34,383,116,92,48,6,38,24,14,0,10,480,324,125,28,171,156,150,57,0,93,6,0,0,6,40361
13120,0,0,0,0,0,0,0,0,0,0,0,0,0,0,0,0,0,0,0,0,0,0,0,0,0,0,0,0,0,0,0,0,0,0,0,40363
13121,1673,239,722,469,136,107,83,51,42,9,18,15,9,9,9,0,0,0,0,0,0,32,32,1,9,22,0,0,0,0,0,0,0,0,0,40370
13122,1862,553,916,284,80,29,100,21,20,0,18,2,1,0,0,0,0,1,0,1,0,79,72,0,19,53,7,0,0,0,0,7,0,0,7,40371
13123,1682,202,641,454,197,188,163,109,103,34,0,69,6,6,6,0,0,0,0,0,0,54,54,32,0,22,0,0,0,0,0,0,0,0,0,40372
13124,1198,371,513,226,73,15,68,44,32,0,0,32,12,0,0,0,0,12,0,0,12,24,16,2,0,14,8,0,0,0,0,8,0,0,8,40374
13125,14,0,14,0,0,0,0,0,0,0,0,0,0,0,0,0,0,0,0,0,0,0,0,0,0,0,0,0,0,0,0,0,0,0,0,40376
13126,2482,378,890,701,313,200,226,158,135,66,11,58,23,23,16,7,0,0,0,0,0,68,50,36,0,14,18,18,18,0,0,0,0,0,0,40379
13127,4027,995,1647,720,363,302,401,240,116,21,23,72,124,93,73,10,10,31,7,24,0,161,128,0,30,98,33,33,17,0,16,0,0,0,0,40380
13128,15416,1886,4569,4131,2999,1831,1175,656,556,141,131,284,100,68,58,0,10,32,20,0,12,519,496,167,18,311,23,23,23,0,0,0,0,0,0,40383
13129,2084,592,938,359,121,74,166,99,51,29,0,22,48,12,12,0,0,36,0,36,0,67,56,13,0,43,11,11,0,11,0,0,0,0,0,40385
13130,1530,316,625,331,163,95,115,64,64,17,7,40,0,0,0,0,0,0,0,0,0,51,51,0,0,51,0,0,0,0,0,0,0,0,0,40387
13131,4099,599,814,723,893,1070,761,349,321,83,17,221,28,24,14,0,10,4,0,0,4,412,412,241,26,145,0,0,0,0,0,0,0,0,0,40390
13132,24548,4312,8476,7034,3147,1579,1621,807,674,204,46,424,133,106,68,9,29,27,15,12,0,814,730,294,57,379,84,81,31,15,35,3,0,0,3,40391
13133,1613,502,747,166,79,119,122,100,95,28,0,67,5,5,0,5,0,0,0,0,0,22,22,0,0,22,0,0,0,0,0,0,0,0,0,40402
13134,15827,2541,5945,4037,1837,1467,1575,847,713,339,42,332,134,121,64,13,44,13,0,13,0,728,605,241,55,309,123,67,33,0,34,56,0,8,48,40403
13135,12,0,0,9,0,3,319,130,130,86,6,38,0,0,0,0,0,0,0,0,0,189,189,123,3,63,0,0,0,0,0,0,0,0,0,40404
13136,2586,604,995,578,225,184,197,151,106,43,14,49,45,41,19,0,22,4,0,4,0,46,43,24,0,19,3,3,0,0,3,0,0,0,0,40409
13137,2863,759,1370,555,128,51,190,123,82,11,0,71,41,12,0,0,12,29,12,0,17,67,64,16,0,48,3,0,0,0,0,3,0,0,3,40419
13138,16562,2246,5652,4436,2322,1906,1567,771,705,134,42,529,66,54,40,7,7,12,10,0,2,796,727,225,43,459,69,42,15,10,17,27,9,0,18,40422
13139,88,0,35,0,53,0,0,0,0,0,0,0,0,0,0,0,0,0,0,0,0,0,0,0,0,0,0,0,0,0,0,0,0,0,0,40434
13140,3857,969,1759,692,212,225,318,47,46,12,4,30,1,1,1,0,0,0,0,0,0,271,141,8,14,119,130,81,31,0,50,49,0,0,49,40437
13141,1379,405,539,355,55,25,121,63,26,0,22,4,37,33,33,0,0,4,0,4,0,58,48,16,0,32,10,4,4,0,0,6,0,0,6,40440
13142,762,133,354,225,10,40,19,19,19,0,0,19,0,0,0,0,0,0,0,0,0,0,0,0,0,0,0,0,0,0,0,0,0,0,0,40442
13143,9537,1678,3913,2493,1037,416,688,367,271,65,47,159,96,63,51,0,12,33,23,0,10,321,274,107,31,136,47,47,0,38,9,0,0,0,0,40444
13144,654,257,329,63,0,5,45,7,7,7,0,0,0,0,0,0,0,0,0,0,0,38,19,11,0,8,19,19,19,0,0,0,0,0,0,40445
13145,5622,1844,2347,1106,124,201,234,152,100,0,5,95,52,52,30,22,0,0,0,0,0,82,44,0,3,41,38,38,34,4,0,0,0,0,0,40447
13146,0,0,0,0,0,0,0,0,0,0,0,0,0,0,0,0,0,0,0,0,0,0,0,0,0,0,0,0,0,0,0,0,0,0,0,40448
13147,6639,1509,2449,1838,368,475,543,313,263,25,23,215,50,31,31,0,0,19,6,0,13,230,206,41,52,113,24,24,7,17,0,0,0,0,0,40456
13148,678,254,344,80,0,0,20,14,14,6,0,8,0,0,0,0,0,0,0,0,0,6,6,0,0,6,0,0,0,0,0,0,0,0,0,40460
13149,2335,453,794,635,348,105,144,111,41,0,0,41,70,34,34,0,0,36,0,9,27,33,33,10,7,16,0,0,0,0,0,0,0,0,0,40461
13150,665,144,401,75,25,20,34,34,11,0,0,11,23,23,23,0,0,0,0,0,0,0,0,0,0,0,0,0,0,0,0,0,0,0,0,40464
13151,1427,379,484,385,106,73,96,29,15,1,2,12,14,14,11,3,0,0,0,0,0,67,49,17,24,8,18,18,8,0,10,0,0,0,0,40468
13152,1114,300,441,281,47,45,76,48,45,0,0,45,3,3,0,3,0,0,0,0,0,28,28,9,0,19,0,0,0,0,0,0,0,0,0,40472
13153,34053,4890,9098,9366,6072,4627,4299,1977,1824,629,125,1070,153,128,75,47,6,25,18,7,0,2322,2090,729,279,1082,232,120,53,54,13,112,0,0,112,40475
13154,240,70,92,65,13,0,53,27,27,0,0,27,0,0,0,0,0,0,0,0,0,26,26,0,0,26,0,0,0,0,0,0,0,0,0,40481
13155,7592,1481,3399,1780,544,388,665,397,339,0,29,310,58,33,17,16,0,25,0,0,25,268,207,91,0,116,61,30,15,0,15,31,0,0,31,40484
13156,1715,421,925,198,112,59,232,74,74,0,0,74,0,0,0,0,0,0,0,0,0,158,158,39,11,108,0,0,0,0,0,0,0,0,0,40486
13157,2914,788,1294,696,75,61,201,93,93,62,14,17,0,0,0,0,0,0,0,0,0,108,108,10,17,81,0,0,0,0,0,0,0,0,0,40489
13158,18317,1231,1877,3489,5675,6045,1509,654,633,85,110,438,21,6,0,0,6,15,0,8,7,855,843,117,52,674,12,6,6,0,0,6,0,6,0,40502
13159,18809,1055,3497,5442,4969,3846,1325,696,646,132,86,428,50,37,28,0,9,13,13,0,0,629,580,109,67,404,49,49,42,0,7,0,0,0,0,40503
13160,16152,3658,4096,4001,2844,1553,1156,707,548,180,42,326,159,75,45,30,0,84,42,27,15,449,358,206,35,117,91,71,1,29,41,20,0,20,0,40504
13161,17934,4178,6054,5291,1575,836,1226,550,421,35,95,291,129,34,2,22,10,95,52,14,29,676,509,180,60,269,167,104,23,39,42,63,9,17,37,40505
13162,26,0,0,5,21,0,1806,728,728,134,47,547,0,0,0,0,0,0,0,0,0,1078,1078,253,36,789,0,0,0,0,0,0,0,0,0,40506
13163,1337,163,203,420,334,217,13,0,0,0,0,0,0,0,0,0,0,0,0,0,0,13,13,0,0,13,0,0,0,0,0,0,0,0,0,40507
13164,10942,2465,2586,2986,1658,1247,4012,2004,1913,466,178,1269,91,50,50,0,0,41,0,40,1,2008,1993,737,55,1201,15,0,0,0,0,15,0,5,10,40508
13165,23149,1842,4026,6216,6660,4405,997,544,396,35,138,223,148,138,113,0,25,10,0,0,10,453,415,94,8,313,38,38,28,7,3,0,0,0,0,40509
13166,1572,388,403,302,311,168,81,53,16,0,0,16,37,6,0,0,6,31,0,0,31,28,13,8,0,5,15,8,0,0,8,7,0,0,7,40510
13167,21638,3285,5539,6363,3922,2529,1130,552,412,47,74,291,140,70,63,0,7,70,7,24,39,578,470,103,48,319,108,103,77,17,9,5,0,0,5,40511
13168,7587,265,761,1561,2325,2675,737,339,332,47,34,251,7,0,0,0,0,7,0,7,0,398,396,117,7,272,2,0,0,0,0,2,2,0,0,40513
13169,10014,271,1643,3308,2622,2170,601,294,266,186,8,72,28,22,22,0,0,6,0,0,6,307,307,121,23,163,0,0,0,0,0,0,0,0,0,40514
13170,22425,1057,3528,5954,7058,4828,1035,649,608,189,56,363,41,26,4,11,11,15,2,12,1,386,375,170,47,158,11,11,11,0,0,0,0,0,0,40515
13171,1859,295,403,440,271,450,160,122,81,0,0,81,41,41,41,0,0,0,0,0,0,38,38,9,3,26,0,0,0,0,0,0,0,0,0,40516
13172,23194,2063,5868,8389,4373,2501,1269,601,370,133,18,219,231,175,149,15,11,56,8,0,48,668,516,223,114,179,152,102,88,0,14,50,0,35,15,40517
13173,34201,4691,11350,8986,5769,3405,2786,1343,1030,258,90,682,313,246,176,60,10,67,0,17,50,1443,1219,390,95,734,224,156,51,65,40,68,26,0,42,40601
13174,356,57,212,75,12,0,1,1,1,0,0,1,0,0,0,0,0,0,0,0,0,0,0,0,0,0,0,0,0,0,0,0,0,0,0,40604
13175,19467,4265,7847,4661,1583,1111,1432,821,679,171,17,491,142,122,45,17,60,20,0,0,20,611,526,195,94,237,85,84,35,0,49,1,0,0,1,40701
13176,4059,1464,1371,970,138,116,333,201,157,58,13,86,44,26,6,0,20,18,18,0,0,132,108,17,0,91,24,14,14,0,0,10,10,0,0,40729
13177,2309,819,886,462,115,27,133,49,14,8,0,6,35,7,7,0,0,28,0,0,28,84,64,16,0,48,20,0,0,0,0,20,0,0,20,40734
13178,850,204,347,145,154,0,159,70,50,0,0,50,20,20,20,0,0,0,0,0,0,89,61,47,0,14,28,28,0,28,0,0,0,0,0,40737
13179,2287,730,956,462,106,33,126,96,72,9,0,63,24,0,0,0,0,24,10,14,0,30,23,0,0,23,7,7,0,7,0,0,0,0,0,40740
13180,14913,3491,5597,3888,1014,923,1030,547,399,91,59,249,148,112,72,0,40,36,0,0,36,483,424,130,62,232,59,29,19,0,10,30,0,0,30,40741
13181,363,36,144,100,43,40,0,0,0,0,0,0,0,0,0,0,0,0,0,0,0,0,0,0,0,0,0,0,0,0,0,0,0,0,0,40743
13182,12141,2910,4300,3174,1104,653,650,284,218,22,47,149,66,20,20,0,0,46,0,15,31,366,240,58,0,182,126,126,49,13,64,0,0,0,0,40744
13183,1739,571,608,384,114,62,250,136,46,0,0,46,90,90,0,38,52,0,0,0,0,114,81,0,16,65,33,33,0,0,33,0,0,0,0,40759
13184,351,78,167,58,27,21,33,19,11,0,5,6,8,8,0,8,0,0,0,0,0,14,14,0,0,14,0,0,0,0,0,0,0,0,0,40763
13185,11405,3431,4241,2236,700,797,1389,637,517,72,74,371,120,87,44,34,9,33,15,0,18,752,698,192,7,499,54,49,7,42,0,5,0,5,0,40769
13186,823,295,289,239,0,0,72,27,0,0,0,0,27,27,0,0,27,0,0,0,0,45,45,0,0,45,0,0,0,0,0,0,0,0,0,40771
13187,326,180,53,85,8,0,27,21,15,0,15,0,6,6,0,6,0,0,0,0,0,6,6,0,0,6,0,0,0,0,0,0,0,0,0,40801
13188,1709,434,572,525,160,18,166,91,74,49,0,25,17,10,0,10,0,7,0,0,7,75,75,0,0,75,0,0,0,0,0,0,0,0,0,40806
13189,345,45,84,98,56,62,15,10,10,0,0,10,0,0,0,0,0,0,0,0,0,5,5,0,0,5,0,0,0,0,0,0,0,0,0,40807
13190,30,0,9,15,4,2,10,0,0,0,0,0,0,0,0,0,0,0,0,0,0,10,10,0,0,10,0,0,0,0,0,0,0,0,0,40808
13191,838,282,380,145,22,9,58,15,10,2,0,8,5,5,5,0,0,0,0,0,0,43,43,14,0,29,0,0,0,0,0,0,0,0,0,40810
13192,447,84,261,58,32,12,50,17,17,0,0,17,0,0,0,0,0,0,0,0,0,33,5,0,0,5,28,28,0,0,28,0,0,0,0,40813
13193,1041,445,404,129,20,43,70,28,10,7,0,3,18,0,0,0,0,18,14,0,4,42,31,0,0,31,11,11,0,0,11,0,0,0,0,40815
13194,26,19,7,0,0,0,7,0,0,0,0,0,0,0,0,0,0,0,0,0,0,7,7,0,0,7,0,0,0,0,0,0,0,0,0,40816
13195,50,13,25,0,6,6,0,0,0,0,0,0,0,0,0,0,0,0,0,0,0,0,0,0,0,0,0,0,0,0,0,0,0,0,0,40818
13196,523,128,125,131,119,20,83,33,33,0,0,33,0,0,0,0,0,0,0,0,0,50,50,0,0,50,0,0,0,0,0,0,0,0,0,40819
13197,239,98,86,55,0,0,0,0,0,0,0,0,0,0,0,0,0,0,0,0,0,0,0,0,0,0,0,0,0,0,0,0,0,0,0,40820
13198,2894,837,972,864,94,127,170,64,61,5,0,56,3,0,0,0,0,3,0,0,3,106,94,41,8,45,12,0,0,0,0,12,0,5,7,40823
13199,550,136,375,14,25,0,47,47,47,26,0,21,0,0,0,0,0,0,0,0,0,0,0,0,0,0,0,0,0,0,0,0,0,0,0,40824
13200,496,122,209,129,23,13,45,6,0,0,0,0,6,0,0,0,0,6,0,0,6,39,39,0,39,0,0,0,0,0,0,0,0,0,0,40826
13201,359,146,132,37,4,40,49,0,0,0,0,0,0,0,0,0,0,0,0,0,0,49,49,0,0,49,0,0,0,0,0,0,0,0,0,40827
13202,2412,739,902,632,65,74,177,103,91,0,6,85,12,0,0,0,0,12,0,3,9,74,65,0,17,48,9,9,9,0,0,0,0,0,0,40828
13203,247,122,113,12,0,0,28,28,0,0,0,0,28,28,28,0,0,0,0,0,0,0,0,0,0,0,0,0,0,0,0,0,0,0,0,40829
13204,203,54,60,89,0,0,0,0,0,0,0,0,0,0,0,0,0,0,0,0,0,0,0,0,0,0,0,0,0,0,0,0,0,0,0,40830
13205,3680,938,1138,912,333,359,183,96,61,0,0,61,35,21,14,7,0,14,0,14,0,87,87,23,2,62,0,0,0,0,0,0,0,0,0,40831
13206,221,68,76,24,0,53,33,0,0,0,0,0,0,0,0,0,0,0,0,0,0,33,33,0,0,33,0,0,0,0,0,0,0,0,0,40840
13207,239,133,51,55,0,0,9,0,0,0,0,0,0,0,0,0,0,0,0,0,0,9,0,0,0,0,9,0,0,0,0,9,0,0,9,40843
13208,28,0,11,17,0,0,0,0,0,0,0,0,0,0,0,0,0,0,0,0,0,0,0,0,0,0,0,0,0,0,0,0,0,0,0,40844
13209,381,213,103,56,9,0,33,13,13,0,0,13,0,0,0,0,0,0,0,0,0,20,20,0,0,20,0,0,0,0,0,0,0,0,0,40845
13210,156,109,21,13,0,13,33,8,8,0,0,8,0,0,0,0,0,0,0,0,0,25,19,0,0,19,6,0,0,0,0,6,0,0,6,40847
13211,235,30,141,56,0,8,11,11,3,0,3,0,8,0,0,0,0,8,0,0,8,0,0,0,0,0,0,0,0,0,0,0,0,0,0,40849
13212,832,197,280,274,22,59,58,29,17,0,0,17,12,0,0,0,0,12,0,0,12,29,29,5,0,24,0,0,0,0,0,0,0,0,0,40854
13213,603,82,216,248,38,19,68,39,30,0,0,30,9,9,0,5,4,0,0,0,0,29,29,5,0,24,0,0,0,0,0,0,0,0,0,40855
13214,750,233,359,92,7,59,42,2,2,0,0,2,0,0,0,0,0,0,0,0,0,40,40,30,0,10,0,0,0,0,0,0,0,0,0,40856
13215,420,102,242,76,0,0,34,0,0,0,0,0,0,0,0,0,0,0,0,0,0,34,0,0,0,0,34,34,0,34,0,0,0,0,0,40858
13216,634,201,233,163,25,12,42,16,13,10,0,3,3,3,3,0,0,0,0,0,0,26,26,0,0,26,0,0,0,0,0,0,0,0,0,40862
13217,366,127,130,76,4,29,35,15,15,0,0,15,0,0,0,0,0,0,0,0,0,20,20,0,0,20,0,0,0,0,0,0,0,0,0,40863
13218,266,57,113,54,18,24,16,7,7,0,0,7,0,0,0,0,0,0,0,0,0,9,9,9,0,0,0,0,0,0,0,0,0,0,0,40865
13219,843,228,321,270,16,8,57,38,38,0,0,38,0,0,0,0,0,0,0,0,0,19,19,0,0,19,0,0,0,0,0,0,0,0,0,40868
13220,180,21,81,47,21,10,28,28,28,17,0,11,0,0,0,0,0,0,0,0,0,0,0,0,0,0,0,0,0,0,0,0,0,0,0,40870
13221,1553,432,648,240,109,124,122,73,73,0,0,73,0,0,0,0,0,0,0,0,0,49,49,0,0,49,0,0,0,0,0,0,0,0,0,40873
13222,398,188,90,106,0,14,8,8,8,0,0,8,0,0,0,0,0,0,0,0,0,0,0,0,0,0,0,0,0,0,0,0,0,0,0,40874
13223,831,279,294,194,21,43,0,0,0,0,0,0,0,0,0,0,0,0,0,0,0,0,0,0,0,0,0,0,0,0,0,0,0,0,0,40902
13224,556,124,317,94,0,21,70,29,29,0,0,29,0,0,0,0,0,0,0,0,0,41,19,0,0,19,22,22,22,0,0,0,0,0,0,40903
13225,7635,2536,2879,1271,617,332,670,374,228,60,44,124,146,110,4,106,0,36,0,36,0,296,256,58,0,198,40,36,0,0,36,4,0,0,4,40906
13226,113,52,22,15,18,6,21,15,15,0,8,7,0,0,0,0,0,0,0,0,0,6,6,0,0,6,0,0,0,0,0,0,0,0,0,40913
13227,315,92,144,48,10,21,57,24,24,0,0,24,0,0,0,0,0,0,0,0,0,33,33,0,0,33,0,0,0,0,0,0,0,0,0,40914
13228,798,235,271,164,83,45,180,112,66,0,0,66,46,46,0,46,0,0,0,0,0,68,23,0,0,23,45,21,0,0,21,24,0,0,24,40915
13229,239,80,139,15,0,5,10,0,0,0,0,0,0,0,0,0,0,0,0,0,0,10,10,10,0,0,0,0,0,0,0,0,0,0,0,40921
13230,553,212,213,128,0,0,49,22,6,6,0,0,16,16,0,0,16,0,0,0,0,27,0,0,0,0,27,27,0,27,0,0,0,0,0,40923
13231,148,49,71,24,4,0,24,19,19,0,0,19,0,0,0,0,0,0,0,0,0,5,5,0,5,0,0,0,0,0,0,0,0,0,0,40927
13232,1833,873,577,188,45,150,94,57,57,0,0,57,0,0,0,0,0,0,0,0,0,37,24,0,0,24,13,13,13,0,0,0,0,0,0,40935
13233,168,76,66,26,0,0,21,21,21,0,0,21,0,0,0,0,0,0,0,0,0,0,0,0,0,0,0,0,0,0,0,0,0,0,0,40939
13234,382,215,139,28,0,0,0,0,0,0,0,0,0,0,0,0,0,0,0,0,0,0,0,0,0,0,0,0,0,0,0,0,0,0,0,40940
13235,58,20,38,0,0,0,16,8,0,0,0,0,8,8,8,0,0,0,0,0,0,8,0,0,0,0,8,0,0,0,0,8,0,0,8,40941
13236,509,252,223,34,0,0,91,25,25,18,0,7,0,0,0,0,0,0,0,0,0,66,37,9,0,28,29,19,0,0,19,10,10,0,0,40943
13237,137,15,76,34,0,12,0,0,0,0,0,0,0,0,0,0,0,0,0,0,0,0,0,0,0,0,0,0,0,0,0,0,0,0,0,40946
13238,434,92,201,70,17,54,0,0,0,0,0,0,0,0,0,0,0,0,0,0,0,0,0,0,0,0,0,0,0,0,0,0,0,0,0,40949
13239,647,181,297,149,20,0,70,13,13,7,0,6,0,0,0,0,0,0,0,0,0,57,50,0,17,33,7,0,0,0,0,7,0,0,7,40953
13240,213,138,60,0,0,15,46,12,12,0,0,12,0,0,0,0,0,0,0,0,0,34,34,0,9,25,0,0,0,0,0,0,0,0,0,40958
13241,13338,4776,5058,2318,634,552,873,463,381,22,20,339,82,37,12,16,9,45,9,15,21,410,340,36,153,151,70,56,33,19,4,14,0,0,14,40962
13242,208,98,43,67,0,0,0,0,0,0,0,0,0,0,0,0,0,0,0,0,0,0,0,0,0,0,0,0,0,0,0,0,0,0,0,40964
13243,9259,2914,3436,1806,552,551,846,397,317,78,22,217,80,80,14,33,33,0,0,0,0,449,337,34,31,272,112,55,33,0,22,57,8,32,17,40965
13244,695,238,298,111,31,17,143,80,61,10,0,51,19,19,17,0,2,0,0,0,0,63,63,25,0,38,0,0,0,0,0,0,0,0,0,40972
13245,7020,2099,2249,1886,297,489,478,272,218,45,0,173,54,15,0,0,15,39,19,0,20,206,167,73,0,94,39,30,5,0,25,9,8,0,1,40977
13246,88,16,29,43,0,0,0,0,0,0,0,0,0,0,0,0,0,0,0,0,0,0,0,0,0,0,0,0,0,0,0,0,0,0,0,40979
13247,284,170,81,23,10,0,37,29,29,0,9,20,0,0,0,0,0,0,0,0,0,8,8,0,0,8,0,0,0,0,0,0,0,0,0,40982
13248,312,220,48,0,44,0,0,0,0,0,0,0,0,0,0,0,0,0,0,0,0,0,0,0,0,0,0,0,0,0,0,0,0,0,0,40983
13249,433,123,197,89,0,24,19,0,0,0,0,0,0,0,0,0,0,0,0,0,0,19,19,0,0,19,0,0,0,0,0,0,0,0,0,40988
13250,4,0,4,0,0,0,4,4,4,0,0,4,0,0,0,0,0,0,0,0,0,0,0,0,0,0,0,0,0,0,0,0,0,0,0,40995
13251,175,111,40,19,0,5,10,0,0,0,0,0,0,0,0,0,0,0,0,0,0,10,10,0,0,10,0,0,0,0,0,0,0,0,0,40997
13252,10606,944,3847,3290,1671,854,800,413,310,69,24,217,103,83,53,20,10,20,0,20,0,387,375,170,11,194,12,12,12,0,0,0,0,0,0,41001
13253,1677,430,576,391,202,78,105,56,52,5,0,47,4,0,0,0,0,4,0,0,4,49,18,3,0,15,31,27,3,11,13,4,0,0,4,41002
13254,1681,348,811,476,30,16,92,48,39,17,0,22,9,2,0,2,0,7,0,7,0,44,33,8,10,15,11,11,0,0,11,0,0,0,0,41003
13255,2863,503,1198,747,279,136,172,84,28,4,13,11,56,54,20,0,34,2,0,0,2,88,66,32,0,34,22,22,0,0,22,0,0,0,0,41004
13256,15615,806,4927,5882,2902,1098,1023,496,402,101,33,268,94,87,43,44,0,7,0,0,7,527,452,205,25,222,75,75,61,0,14,0,0,0,0,41005
13257,2949,402,1538,549,292,168,184,108,108,38,7,63,0,0,0,0,0,0,0,0,0,76,76,18,0,58,0,0,0,0,0,0,0,0,0,41006
13258,2438,277,1003,792,233,133,229,116,116,42,0,74,0,0,0,0,0,0,0,0,0,113,109,17,21,71,4,0,0,0,0,4,0,0,4,41007
13259,4943,1221,1982,1218,305,217,402,172,144,27,24,93,28,28,28,0,0,0,0,0,0,230,186,73,2,111,44,14,5,9,0,30,0,30,0,41008
13260,2419,339,930,867,196,87,179,95,48,9,0,39,47,47,22,25,0,0,0,0,0,84,41,13,0,28,43,16,15,1,0,27,0,0,27,41010
13261,17631,2734,4497,4773,3648,1979,961,452,354,120,31,203,98,16,0,9,7,82,50,22,10,509,300,137,36,127,209,145,67,27,51,64,0,31,33,41011
13262,4887,974,1754,1403,440,316,470,235,173,16,20,137,62,18,2,6,10,44,0,25,19,235,213,25,55,133,22,19,0,19,0,3,0,0,3,41014
13263,14214,2173,4721,4266,1949,1105,911,505,384,78,33,273,121,59,56,3,0,62,0,48,14,406,360,133,68,159,46,16,16,0,0,30,0,7,23,41015
13264,3865,554,1324,1050,707,230,288,118,118,16,0,102,0,0,0,0,0,0,0,0,0,170,99,37,26,36,71,31,6,25,0,40,0,0,40,41016
13265,26471,1602,6484,7452,6623,4310,2319,1126,975,188,101,686,151,139,99,15,25,12,12,0,0,1193,1165,451,64,650,28,17,17,0,0,11,0,0,11,41017
13266,18456,2064,6110,6265,2735,1282,1030,573,435,142,32,261,138,124,33,74,17,14,14,0,0,457,366,118,55,193,91,73,22,0,51,18,10,0,8,41018
13267,3653,506,1464,1187,344,152,387,196,159,19,9,131,37,0,0,0,0,37,9,15,13,191,135,45,20,70,56,47,9,38,0,9,0,0,9,41030
13268,10887,2178,4090,2921,1049,649,918,498,413,61,53,299,85,57,43,0,14,28,17,0,11,420,330,103,39,188,90,39,39,0,0,51,8,0,43,41031
13269,1230,265,563,282,120,0,110,103,103,25,0,78,0,0,0,0,0,0,0,0,0,7,7,7,0,0,0,0,0,0,0,0,0,0,0,41033
13270,702,99,335,142,94,32,53,32,13,0,0,13,19,19,19,0,0,0,0,0,0,21,21,0,10,11,0,0,0,0,0,0,0,0,0,41034
13271,6891,1214,3075,1884,484,234,552,390,298,90,108,100,92,86,66,4,16,6,0,0,6,162,86,38,0,48,76,38,12,14,12,38,14,20,4,41035
13272,1829,407,678,541,113,90,134,54,48,8,0,40,6,6,6,0,0,0,0,0,0,80,80,37,0,43,0,0,0,0,0,0,0,0,0,41039
13273,5013,864,2276,1244,375,254,523,194,144,32,23,89,50,50,6,5,39,0,0,0,0,329,289,63,61,165,40,40,17,17,6,0,0,0,0,41040
13274,5118,1018,2011,1293,440,356,313,75,45,17,6,22,30,17,17,0,0,13,13,0,0,238,212,8,10,194,26,3,0,0,3,23,6,0,17,41041
13275,32967,3068,10835,10131,5822,3111,1967,1077,874,292,108,474,203,149,120,29,0,54,18,36,0,890,608,263,6,339,282,265,265,0,0,17,0,13,4,41042
13276,1168,163,554,293,121,37,75,28,28,9,0,19,0,0,0,0,0,0,0,0,0,47,43,5,0,38,4,4,0,0,4,0,0,0,0,41043
13277,582,131,277,109,15,50,45,28,14,0,2,12,14,14,14,0,0,0,0,0,0,17,17,0,0,17,0,0,0,0,0,0,0,0,0,41044
13278,909,239,419,173,36,42,95,57,42,10,5,27,15,15,9,6,0,0,0,0,0,38,13,0,6,7,25,25,16,9,0,0,0,0,0,41045
13279,969,297,393,253,25,1,241,158,68,0,0,68,90,87,0,29,58,3,0,0,3,83,83,52,26,5,0,0,0,0,0,0,0,0,0,41046
13280,8771,594,1975,2672,2321,1209,865,386,305,139,37,129,81,81,81,0,0,0,0,0,0,479,422,235,32,155,57,57,46,0,11,0,0,0,0,41048
13281,1328,441,508,226,82,71,100,70,32,10,0,22,38,14,0,14,0,24,24,0,0,30,30,30,0,0,0,0,0,0,0,0,0,0,0,41049
13282,17343,1382,5361,5521,3378,1701,1599,796,670,379,42,249,126,95,53,42,0,31,20,0,11,803,742,274,104,364,61,61,0,23,38,0,0,0,0,41051
13283,54,0,38,16,0,0,11,0,0,0,0,0,0,0,0,0,0,0,0,0,0,11,11,0,0,11,0,0,0,0,0,0,0,0,0,41052
13284,1197,236,376,281,129,175,160,76,56,9,0,47,20,0,0,0,0,20,12,0,8,84,56,11,0,45,28,0,0,0,0,28,0,0,28,41055
13285,9651,1948,3580,2838,645,640,782,341,291,62,9,220,50,41,25,0,16,9,0,9,0,441,379,131,0,248,62,18,12,0,6,44,8,0,36,41056
13286,2088,196,936,521,203,232,253,171,151,93,0,58,20,20,20,0,0,0,0,0,0,82,82,70,0,12,0,0,0,0,0,0,0,0,0,41059
13287,36,0,31,5,0,0,0,0,0,0,0,0,0,0,0,0,0,0,0,0,0,0,0,0,0,0,0,0,0,0,0,0,0,0,0,41062
13288,2121,270,1068,440,209,134,201,168,168,21,0,147,0,0,0,0,0,0,0,0,0,33,33,0,0,33,0,0,0,0,0,0,0,0,0,41063
13289,1340,389,536,284,96,35,106,49,36,8,0,28,13,10,10,0,0,3,0,0,3,57,50,18,0,32,7,7,0,0,7,0,0,0,0,41064
13290,14459,2630,4913,3603,2099,1214,1314,763,583,93,56,434,180,91,78,13,0,89,43,17,29,551,462,181,53,228,89,89,58,26,5,0,0,0,0,41071
13291,4096,530,1533,980,667,386,283,47,47,16,11,20,0,0,0,0,0,0,0,0,0,236,186,24,34,128,50,50,26,24,0,0,0,0,0,41073
13292,3308,708,1362,861,208,169,282,110,99,25,14,60,11,11,8,3,0,0,0,0,0,172,156,25,6,125,16,16,16,0,0,0,0,0,0,41074
13293,11103,665,2332,3092,3118,1896,820,347,316,84,32,200,31,31,31,0,0,0,0,0,0,473,441,229,59,153,32,21,21,0,0,11,11,0,0,41075
13294,11602,919,2951,3742,2416,1574,797,509,464,127,35,302,45,15,0,15,0,30,0,0,30,288,273,103,0,170,15,15,15,0,0,0,0,0,0,41076
13295,1441,314,424,358,232,113,41,8,8,0,0,8,0,0,0,0,0,0,0,0,0,33,33,0,0,33,0,0,0,0,0,0,0,0,0,41080
13296,765,153,377,194,41,0,24,12,5,0,0,5,7,7,7,0,0,0,0,0,0,12,12,11,0,1,0,0,0,0,0,0,0,0,0,41083
13297,380,36,230,96,15,3,56,28,14,4,0,10,14,3,3,0,0,11,0,11,0,28,24,12,0,12,4,4,4,0,0,0,0,0,0,41085
13298,1824,176,913,430,221,84,133,53,36,2,13,21,17,17,17,0,0,0,0,0,0,80,44,0,2,42,36,36,36,0,0,0,0,0,0,41086
13299,10583,693,2272,3056,2765,1797,1046,506,431,88,56,287,75,45,45,0,0,30,0,0,30,540,502,274,23,205,38,38,4,10,24,0,0,0,0,41091
13300,2379,457,946,613,227,136,104,82,74,27,6,41,8,8,0,0,8,0,0,0,0,22,22,17,0,5,0,0,0,0,0,0,0,0,0,41092
13301,2026,581,770,489,110,76,124,83,69,0,12,57,14,14,0,14,0,0,0,0,0,41,32,0,17,15,9,9,9,0,0,0,0,0,0,41093
13302,8642,707,2894,2730,1561,750,773,484,364,143,0,221,120,52,52,0,0,68,0,61,7,289,278,97,16,165,11,11,11,0,0,0,0,0,0,41094
13303,2181,601,908,452,157,63,74,28,28,2,0,26,0,0,0,0,0,0,0,0,0,46,41,8,0,33,5,5,0,5,0,0,0,0,0,41095
13304,4797,1049,1839,1327,428,154,477,257,211,30,0,181,46,32,0,32,0,14,0,0,14,220,178,81,25,72,42,42,42,0,0,0,0,0,0,41097
13305,1498,299,630,320,176,73,44,38,38,36,0,2,0,0,0,0,0,0,0,0,0,6,6,4,0,2,0,0,0,0,0,0,0,0,0,41098
13306,9,0,0,9,0,0,537,209,209,62,53,94,0,0,0,0,0,0,0,0,0,328,328,199,37,92,0,0,0,0,0,0,0,0,0,41099
13307,13329,1647,4568,4505,1367,1242,1081,599,371,88,25,258,228,142,70,72,0,86,12,0,74,482,406,128,47,231,76,51,0,0,51,25,0,0,25,41101
13308,15530,1774,5801,5492,1414,1049,872,477,455,80,39,336,22,21,21,0,0,1,0,0,1,395,313,76,66,171,82,53,53,0,0,29,0,0,29,41102
13309,1094,208,385,372,97,32,58,48,48,27,12,9,0,0,0,0,0,0,0,0,0,10,10,0,0,10,0,0,0,0,0,0,0,0,0,41121
13310,871,277,287,236,33,38,88,23,23,13,0,10,0,0,0,0,0,0,0,0,0,65,65,54,0,11,0,0,0,0,0,0,0,0,0,41124
13311,7304,929,2743,2406,825,401,478,236,219,25,18,176,17,13,0,13,0,4,4,0,0,242,228,24,5,199,14,14,3,0,11,0,0,0,0,41129
13312,338,108,123,75,9,23,8,8,8,0,0,8,0,0,0,0,0,0,0,0,0,0,0,0,0,0,0,0,0,0,0,0,0,0,0,41132
13313,146,75,57,14,0,0,12,0,0,0,0,0,0,0,0,0,0,0,0,0,0,12,12,0,12,0,0,0,0,0,0,0,0,0,0,41135
13314,5901,746,2070,2083,596,406,335,202,185,11,37,137,17,17,17,0,0,0,0,0,0,133,89,13,0,76,44,44,44,0,0,0,0,0,0,41139
13315,1429,415,646,255,44,69,98,43,43,0,0,43,0,0,0,0,0,0,0,0,0,55,44,0,0,44,11,11,0,0,11,0,0,0,0,41141
13316,12,12,0,0,0,0,0,0,0,0,0,0,0,0,0,0,0,0,0,0,0,0,0,0,0,0,0,0,0,0,0,0,0,0,0,41142
13317,9575,2119,3819,2504,659,474,930,464,428,86,43,299,36,36,14,21,1,0,0,0,0,466,325,72,19,234,141,93,29,13,51,48,25,0,23,41143
13318,7264,1613,2633,2105,490,423,421,290,249,16,29,204,41,16,3,1,12,25,0,8,17,131,114,26,9,79,17,17,17,0,0,0,0,0,0,41144
13319,219,33,143,43,0,0,0,0,0,0,0,0,0,0,0,0,0,0,0,0,0,0,0,0,0,0,0,0,0,0,0,0,0,0,0,41146
13320,338,166,40,85,42,5,60,51,51,0,0,51,0,0,0,0,0,0,0,0,0,9,9,0,0,9,0,0,0,0,0,0,0,0,0,41149
13321,290,134,101,26,15,14,0,0,0,0,0,0,0,0,0,0,0,0,0,0,0,0,0,0,0,0,0,0,0,0,0,0,0,0,0,41159
13322,9108,2484,3626,2063,432,503,690,404,291,37,19,235,113,74,16,31,27,39,5,10,24,286,237,79,41,117,49,24,22,2,0,25,9,0,16,41164
13323,577,136,266,166,9,0,120,90,67,33,0,34,23,23,23,0,0,0,0,0,0,30,30,0,0,30,0,0,0,0,0,0,0,0,0,41166
13324,2086,384,809,660,133,100,307,126,97,0,0,97,29,25,0,11,14,4,0,0,4,181,169,37,0,132,12,12,12,0,0,0,0,0,0,41168
13325,4035,442,1255,1526,544,268,235,98,52,4,0,48,46,30,0,6,24,16,0,0,16,137,130,44,0,86,7,4,0,0,4,3,3,0,0,41169
13326,3307,948,1368,828,93,70,268,145,63,20,0,43,82,72,26,20,26,10,0,0,10,123,114,35,0,79,9,0,0,0,0,9,0,0,9,41171
13327,745,172,339,207,27,0,117,50,44,0,0,44,6,6,0,0,6,0,0,0,0,67,67,0,0,67,0,0,0,0,0,0,0,0,0,41174
13328,4102,865,1632,1177,264,164,360,191,142,17,16,109,49,31,22,0,9,18,0,0,18,169,96,37,0,59,73,49,27,0,22,24,0,0,24,41175
13329,5218,1407,2129,1053,362,267,326,186,183,44,6,133,3,3,0,0,3,0,0,0,0,140,104,23,0,81,36,36,32,4,0,0,0,0,0,41179
13330,869,411,278,111,42,27,38,38,14,0,0,14,24,0,0,0,0,24,0,24,0,0,0,0,0,0,0,0,0,0,0,0,0,0,0,41180
13331,1024,136,404,322,95,67,60,32,27,0,4,23,5,5,2,3,0,0,0,0,0,28,25,2,3,20,3,0,0,0,0,3,0,0,3,41183
13332,1568,403,612,353,159,41,54,34,34,6,0,28,0,0,0,0,0,0,0,0,0,20,0,0,0,0,20,0,0,0,0,20,0,0,20,41189
13333,217,86,92,26,13,0,0,0,0,0,0,0,0,0,0,0,0,0,0,0,0,0,0,0,0,0,0,0,0,0,0,0,0,0,0,41201
13334,485,131,196,158,0,0,103,60,44,0,0,44,16,7,0,7,0,9,0,0,9,43,24,0,0,24,19,19,19,0,0,0,0,0,0,41203
13335,453,163,165,117,8,0,47,43,41,28,0,13,2,2,0,2,0,0,0,0,0,4,0,0,0,0,4,4,4,0,0,0,0,0,0,41204
13336,263,101,101,50,0,11,0,0,0,0,0,0,0,0,0,0,0,0,0,0,0,0,0,0,0,0,0,0,0,0,0,0,0,0,0,41214
13337,771,76,304,262,67,62,47,12,12,0,0,12,0,0,0,0,0,0,0,0,0,35,35,22,0,13,0,0,0,0,0,0,0,0,0,41216
13338,1495,556,584,298,48,9,32,32,13,6,0,7,19,0,0,0,0,19,0,19,0,0,0,0,0,0,0,0,0,0,0,0,0,0,0,41219
13339,1663,453,761,302,113,34,100,35,25,17,0,8,10,10,0,10,0,0,0,0,0,65,65,40,0,25,0,0,0,0,0,0,0,0,0,41222
13340,4906,1210,1974,1364,189,169,256,162,127,3,2,122,35,35,0,35,0,0,0,0,0,94,90,4,0,86,4,4,0,4,0,0,0,0,0,41224
13341,75,0,0,45,11,19,0,0,0,0,0,0,0,0,0,0,0,0,0,0,0,0,0,0,0,0,0,0,0,0,0,0,0,0,0,41226
13342,7905,2076,3120,1996,376,337,489,209,195,25,5,165,14,14,0,0,14,0,0,0,0,280,170,0,0,170,110,76,42,27,7,34,0,0,34,41230
13343,462,159,155,96,45,7,42,15,8,4,0,4,7,7,0,0,7,0,0,0,0,27,27,0,0,27,0,0,0,0,0,0,0,0,0,41231
13344,385,104,99,104,13,65,71,53,53,0,0,53,0,0,0,0,0,0,0,0,0,18,18,0,0,18,0,0,0,0,0,0,0,0,0,41232
13345,328,99,163,43,0,23,0,0,0,0,0,0,0,0,0,0,0,0,0,0,0,0,0,0,0,0,0,0,0,0,0,0,0,0,0,41234
13346,754,175,330,171,29,49,0,0,0,0,0,0,0,0,0,0,0,0,0,0,0,0,0,0,0,0,0,0,0,0,0,0,0,0,0,41238
13347,5579,1278,2159,1270,500,372,433,214,182,55,0,127,32,11,11,0,0,21,12,0,9,219,145,45,0,100,74,50,50,0,0,24,0,0,24,41240
13348,708,238,194,228,30,18,46,18,16,0,4,12,2,2,0,2,0,0,0,0,0,28,28,0,0,28,0,0,0,0,0,0,0,0,0,41250
13349,378,92,119,141,0,26,53,18,18,0,0,18,0,0,0,0,0,0,0,0,0,35,11,0,0,11,24,24,0,0,24,0,0,0,0,41254
13350,773,172,441,113,36,11,71,71,71,29,0,42,0,0,0,0,0,0,0,0,0,0,0,0,0,0,0,0,0,0,0,0,0,0,0,41255
13351,1497,354,608,334,101,100,52,32,32,0,0,32,0,0,0,0,0,0,0,0,0,20,20,20,0,0,0,0,0,0,0,0,0,0,0,41256
13352,142,55,56,15,16,0,0,0,0,0,0,0,0,0,0,0,0,0,0,0,0,0,0,0,0,0,0,0,0,0,0,0,0,0,0,41257
13353,508,150,144,200,0,14,28,10,0,0,0,0,10,0,0,0,0,10,0,0,10,18,18,0,0,18,0,0,0,0,0,0,0,0,0,41260
13354,1058,219,193,517,42,87,36,36,10,0,0,10,26,0,0,0,0,26,0,0,26,0,0,0,0,0,0,0,0,0,0,0,0,0,0,41262
13355,291,32,106,145,8,0,12,12,12,12,0,0,0,0,0,0,0,0,0,0,0,0,0,0,0,0,0,0,0,0,0,0,0,0,0,41263
13356,142,45,81,7,9,0,0,0,0,0,0,0,0,0,0,0,0,0,0,0,0,0,0,0,0,0,0,0,0,0,0,0,0,0,0,41264
13357,1254,301,602,272,25,54,125,55,55,0,0,55,0,0,0,0,0,0,0,0,0,70,46,20,0,26,24,24,24,0,0,0,0,0,0,41265
13358,778,343,249,123,39,24,80,65,6,0,0,6,59,2,0,0,2,57,0,18,39,15,5,5,0,0,10,10,0,0,10,0,0,0,0,41267
13359,265,149,60,50,6,0,0,0,0,0,0,0,0,0,0,0,0,0,0,0,0,0,0,0,0,0,0,0,0,0,0,0,0,0,0,41268
13360,162,75,81,6,0,0,11,0,0,0,0,0,0,0,0,0,0,0,0,0,0,11,11,11,0,0,0,0,0,0,0,0,0,0,0,41271
13361,290,41,113,96,12,28,51,15,15,15,0,0,0,0,0,0,0,0,0,0,0,36,36,0,0,36,0,0,0,0,0,0,0,0,0,41274
13362,4134,1348,1528,776,324,158,319,234,173,19,49,105,61,49,8,24,17,12,0,0,12,85,85,36,0,49,0,0,0,0,0,0,0,0,0,41301
13363,5350,1558,2216,1289,130,157,271,131,114,0,0,114,17,8,0,8,0,9,0,0,9,140,91,45,0,46,49,16,0,16,0,33,0,0,33,41311
13364,3774,1428,1238,639,253,216,195,109,87,12,5,70,22,17,17,0,0,5,0,0,5,86,72,0,14,58,14,6,0,6,0,8,0,0,8,41314
13365,196,81,93,17,0,5,37,0,0,0,0,0,0,0,0,0,0,0,0,0,0,37,37,0,0,37,0,0,0,0,0,0,0,0,0,41317
13366,775,217,346,116,17,79,21,21,21,0,0,21,0,0,0,0,0,0,0,0,0,0,0,0,0,0,0,0,0,0,0,0,0,0,0,41332
13367,7424,2671,2261,1701,366,425,650,425,372,84,27,261,53,43,14,11,18,10,6,0,4,225,214,74,18,122,11,5,5,0,0,6,0,0,6,41339
13368,963,373,367,178,0,45,93,31,20,6,0,14,11,11,3,8,0,0,0,0,0,62,62,30,0,32,0,0,0,0,0,0,0,0,0,41348
13369,555,108,297,96,6,48,28,20,20,0,0,20,0,0,0,0,0,0,0,0,0,8,8,2,0,6,0,0,0,0,0,0,0,0,0,41352
13370,295,176,101,7,0,11,23,20,20,0,8,12,0,0,0,0,0,0,0,0,0,3,3,0,0,3,0,0,0,0,0,0,0,0,0,41360
13371,366,105,85,109,33,34,48,0,0,0,0,0,0,0,0,0,0,0,0,0,0,48,48,38,0,10,0,0,0,0,0,0,0,0,0,41365
13372,10,0,4,6,0,0,0,0,0,0,0,0,0,0,0,0,0,0,0,0,0,0,0,0,0,0,0,0,0,0,0,0,0,0,0,41366
13373,137,22,63,45,7,0,8,0,0,0,0,0,0,0,0,0,0,0,0,0,0,8,8,0,0,8,0,0,0,0,0,0,0,0,0,41367
13374,170,80,73,10,7,0,16,8,8,0,0,8,0,0,0,0,0,0,0,0,0,8,0,0,0,0,8,8,8,0,0,0,0,0,0,41385
13375,37,23,14,0,0,0,0,0,0,0,0,0,0,0,0,0,0,0,0,0,0,0,0,0,0,0,0,0,0,0,0,0,0,0,0,41390
13376,0,0,0,0,0,0,0,0,0,0,0,0,0,0,0,0,0,0,0,0,0,0,0,0,0,0,0,0,0,0,0,0,0,0,0,41397
13377,204,124,53,27,0,0,11,0,0,0,0,0,0,0,0,0,0,0,0,0,0,11,11,11,0,0,0,0,0,0,0,0,0,0,0,41408
13378,79,46,26,3,0,4,17,0,0,0,0,0,0,0,0,0,0,0,0,0,0,17,17,0,0,17,0,0,0,0,0,0,0,0,0,41421
13379,712,289,202,111,27,83,78,41,36,0,0,36,5,0,0,0,0,5,0,5,0,37,19,0,5,14,18,6,0,0,6,12,0,0,12,41425
13380,521,289,165,56,6,5,17,0,0,0,0,0,0,0,0,0,0,0,0,0,0,17,9,0,0,9,8,8,0,0,8,0,0,0,0,41464
13381,7923,2503,2918,1730,417,355,721,347,264,8,8,248,83,69,37,32,0,14,0,0,14,374,354,23,14,317,20,20,3,0,17,0,0,0,0,41465
13382,8089,2263,3060,1810,551,405,446,258,203,30,17,156,55,50,33,0,17,5,0,0,5,188,135,34,0,101,53,36,4,5,27,17,0,0,17,41472
13383,16775,3846,5506,4073,1735,1615,1205,666,551,131,58,362,115,85,64,13,8,30,21,0,9,539,432,112,18,302,107,53,14,0,39,54,0,0,54,41501
13384,409,93,140,96,39,41,37,6,6,0,6,0,0,0,0,0,0,0,0,0,0,31,12,0,0,12,19,13,13,0,0,6,0,0,6,41503
13385,790,265,223,203,55,44,30,12,0,0,0,0,12,12,0,0,12,0,0,0,0,18,18,0,8,10,0,0,0,0,0,0,0,0,0,41512
13386,460,142,171,122,8,17,35,0,0,0,0,0,0,0,0,0,0,0,0,0,0,35,35,12,0,23,0,0,0,0,0,0,0,0,0,41513
13387,2152,589,839,524,130,70,140,53,48,6,12,30,5,5,5,0,0,0,0,0,0,87,75,0,0,75,12,0,0,0,0,12,0,0,12,41514
13388,43,11,8,13,0,11,0,0,0,0,0,0,0,0,0,0,0,0,0,0,0,0,0,0,0,0,0,0,0,0,0,0,0,0,0,41517
13389,867,228,248,307,67,17,47,9,9,0,0,9,0,0,0,0,0,0,0,0,0,38,38,31,0,7,0,0,0,0,0,0,0,0,0,41519
13390,3735,1066,1523,816,162,168,199,104,65,9,3,53,39,21,0,21,0,18,0,0,18,95,87,27,9,51,8,5,0,5,0,3,0,0,3,41522
13391,337,130,80,42,19,66,8,8,8,0,8,0,0,0,0,0,0,0,0,0,0,0,0,0,0,0,0,0,0,0,0,0,0,0,0,41524
13392,79,36,0,21,22,0,0,0,0,0,0,0,0,0,0,0,0,0,0,0,0,0,0,0,0,0,0,0,0,0,0,0,0,0,0,41526
13393,536,30,200,184,33,89,66,38,5,0,0,5,33,0,0,0,0,33,0,33,0,28,28,9,0,19,0,0,0,0,0,0,0,0,0,41527
13394,463,164,159,109,21,10,51,14,14,0,0,14,0,0,0,0,0,0,0,0,0,37,37,0,0,37,0,0,0,0,0,0,0,0,0,41528
13395,611,162,260,120,15,54,29,29,29,29,0,0,0,0,0,0,0,0,0,0,0,0,0,0,0,0,0,0,0,0,0,0,0,0,0,41531
13396,152,79,56,7,0,10,0,0,0,0,0,0,0,0,0,0,0,0,0,0,0,0,0,0,0,0,0,0,0,0,0,0,0,0,0,41534
13397,368,137,152,55,11,13,9,9,9,0,0,9,0,0,0,0,0,0,0,0,0,0,0,0,0,0,0,0,0,0,0,0,0,0,0,41535
13398,3871,1115,1311,1035,237,173,232,95,80,0,0,80,15,0,0,0,0,15,0,5,10,137,134,8,7,119,3,0,0,0,0,3,0,0,3,41537
13399,34,7,14,13,0,0,0,0,0,0,0,0,0,0,0,0,0,0,0,0,0,0,0,0,0,0,0,0,0,0,0,0,0,0,0,41538
13400,1148,458,419,201,41,29,33,8,8,0,0,8,0,0,0,0,0,0,0,0,0,25,25,0,6,19,0,0,0,0,0,0,0,0,0,41539
13401,189,19,99,61,1,9,6,6,6,0,6,0,0,0,0,0,0,0,0,0,0,0,0,0,0,0,0,0,0,0,0,0,0,0,0,41540
13402,324,93,167,21,10,33,72,0,0,0,0,0,0,0,0,0,0,0,0,0,0,72,43,0,0,43,29,29,0,0,29,0,0,0,0,41543
13403,648,186,312,109,37,4,22,15,15,0,0,15,0,0,0,0,0,0,0,0,0,7,7,3,0,4,0,0,0,0,0,0,0,0,0,41544
13404,177,121,19,15,0,22,38,38,38,0,0,38,0,0,0,0,0,0,0,0,0,0,0,0,0,0,0,0,0,0,0,0,0,0,0,41547
13405,512,261,181,63,0,7,7,0,0,0,0,0,0,0,0,0,0,0,0,0,0,7,7,7,0,0,0,0,0,0,0,0,0,0,0,41548
13406,1999,1035,557,306,54,47,183,106,54,0,23,31,52,11,0,0,11,41,0,0,41,77,60,34,0,26,17,8,0,0,8,9,0,0,9,41553
13407,841,257,348,180,34,22,70,42,29,23,0,6,13,13,0,0,13,0,0,0,0,28,20,7,0,13,8,0,0,0,0,8,0,0,8,41554
13408,541,178,260,81,22,0,65,26,19,0,0,19,7,7,0,7,0,0,0,0,0,39,34,0,7,27,5,5,0,0,5,0,0,0,0,41555
13409,1343,299,572,400,21,51,51,31,31,0,0,31,0,0,0,0,0,0,0,0,0,20,20,0,0,20,0,0,0,0,0,0,0,0,0,41557
13410,541,132,241,147,5,16,48,38,25,0,5,20,13,8,8,0,0,5,0,0,5,10,10,0,0,10,0,0,0,0,0,0,0,0,0,41558
13411,232,29,111,79,0,13,36,36,36,0,10,26,0,0,0,0,0,0,0,0,0,0,0,0,0,0,0,0,0,0,0,0,0,0,0,41559
13412,195,67,57,45,10,16,17,17,17,0,0,17,0,0,0,0,0,0,0,0,0,0,0,0,0,0,0,0,0,0,0,0,0,0,0,41560
13413,1807,497,763,482,15,50,114,75,64,15,0,49,11,11,11,0,0,0,0,0,0,39,16,10,0,6,23,23,0,0,23,0,0,0,0,41562
13414,328,112,91,97,17,11,33,15,15,0,0,15,0,0,0,0,0,0,0,0,0,18,18,0,18,0,0,0,0,0,0,0,0,0,0,41563
13415,812,230,313,238,0,31,37,9,0,0,0,0,9,9,9,0,0,0,0,0,0,28,28,15,0,13,0,0,0,0,0,0,0,0,0,41564
13416,419,106,158,104,30,21,31,19,19,0,7,12,0,0,0,0,0,0,0,0,0,12,12,8,0,4,0,0,0,0,0,0,0,0,0,41566
13417,148,45,65,29,0,9,0,0,0,0,0,0,0,0,0,0,0,0,0,0,0,0,0,0,0,0,0,0,0,0,0,0,0,0,0,41567
13418,490,283,134,48,25,0,23,0,0,0,0,0,0,0,0,0,0,0,0,0,0,23,0,0,0,0,23,12,0,0,12,11,0,0,11,41568
13419,405,141,180,73,11,0,21,15,15,0,0,15,0,0,0,0,0,0,0,0,0,6,6,6,0,0,0,0,0,0,0,0,0,0,0,41571
13420,2515,606,1159,583,120,47,133,36,27,0,0,27,9,9,9,0,0,0,0,0,0,97,97,32,10,55,0,0,0,0,0,0,0,0,0,41572
13421,396,124,106,47,33,86,82,49,49,0,0,49,0,0,0,0,0,0,0,0,0,33,33,0,0,33,0,0,0,0,0,0,0,0,0,41601
13422,261,23,132,87,19,0,28,22,22,0,0,22,0,0,0,0,0,0,0,0,0,6,6,6,0,0,0,0,0,0,0,0,0,0,0,41602
13423,960,251,261,300,115,33,33,33,11,0,0,11,22,0,0,0,0,22,0,22,0,0,0,0,0,0,0,0,0,0,0,0,0,0,0,41603
13424,305,146,143,16,0,0,64,19,8,0,0,8,11,11,11,0,0,0,0,0,0,45,9,0,0,9,36,0,0,0,0,36,0,0,36,41604
13425,528,59,272,127,49,21,31,31,31,0,0,31,0,0,0,0,0,0,0,0,0,0,0,0,0,0,0,0,0,0,0,0,0,0,0,41605
13426,510,90,251,99,50,20,15,15,15,0,0,15,0,0,0,0,0,0,0,0,0,0,0,0,0,0,0,0,0,0,0,0,0,0,0,41606
13427,241,136,30,56,11,8,44,13,13,0,0,13,0,0,0,0,0,0,0,0,0,31,31,31,0,0,0,0,0,0,0,0,0,0,0,41607
13428,30,25,5,0,0,0,11,11,11,0,0,11,0,0,0,0,0,0,0,0,0,0,0,0,0,0,0,0,0,0,0,0,0,0,0,41612
13429,407,118,88,108,93,0,16,16,16,0,0,16,0,0,0,0,0,0,0,0,0,0,0,0,0,0,0,0,0,0,0,0,0,0,0,41615
13430,589,155,201,101,17,115,0,0,0,0,0,0,0,0,0,0,0,0,0,0,0,0,0,0,0,0,0,0,0,0,0,0,0,0,0,41616
13431,443,140,190,83,24,6,36,36,18,0,0,18,18,0,0,0,0,18,0,18,0,0,0,0,0,0,0,0,0,0,0,0,0,0,0,41619
13432,343,59,95,109,56,24,0,0,0,0,0,0,0,0,0,0,0,0,0,0,0,0,0,0,0,0,0,0,0,0,0,0,0,0,0,41621
13433,320,53,171,96,0,0,25,0,0,0,0,0,0,0,0,0,0,0,0,0,0,25,25,0,0,25,0,0,0,0,0,0,0,0,0,41622
13434,876,234,223,257,105,57,14,0,0,0,0,0,0,0,0,0,0,0,0,0,0,14,12,12,0,0,2,0,0,0,0,2,0,2,0,41630
13435,801,244,288,242,27,0,154,83,83,0,0,83,0,0,0,0,0,0,0,0,0,71,71,47,0,24,0,0,0,0,0,0,0,0,0,41631
13436,515,289,127,84,15,0,25,7,7,0,0,7,0,0,0,0,0,0,0,0,0,18,18,0,0,18,0,0,0,0,0,0,0,0,0,41632
13437,2142,688,564,541,143,206,68,30,30,14,0,16,0,0,0,0,0,0,0,0,0,38,0,0,0,0,38,15,15,0,0,23,0,0,23,41635
13438,735,153,391,118,50,23,76,53,53,0,24,29,0,0,0,0,0,0,0,0,0,23,23,6,0,17,0,0,0,0,0,0,0,0,0,41636
13439,646,253,167,89,1,136,14,8,8,0,0,8,0,0,0,0,0,0,0,0,0,6,0,0,0,0,6,6,6,0,0,0,0,0,0,41640
13440,338,123,144,40,31,0,57,0,0,0,0,0,0,0,0,0,0,0,0,0,0,57,57,17,6,34,0,0,0,0,0,0,0,0,0,41642
13441,212,55,55,71,17,14,72,19,19,0,0,19,0,0,0,0,0,0,0,0,0,53,53,45,0,8,0,0,0,0,0,0,0,0,0,41643
13442,681,86,91,308,157,39,86,38,38,0,0,38,0,0,0,0,0,0,0,0,0,48,0,0,0,0,48,48,0,0,48,0,0,0,0,41645
13443,992,282,415,214,21,60,43,30,30,0,0,30,0,0,0,0,0,0,0,0,0,13,13,6,0,7,0,0,0,0,0,0,0,0,0,41647
13444,2081,531,794,460,184,112,87,61,36,0,0,36,25,21,0,0,21,4,0,0,4,26,25,22,0,3,1,1,0,0,1,0,0,0,0,41649
13445,304,145,54,85,6,14,6,0,0,0,0,0,0,0,0,0,0,0,0,0,0,6,6,0,0,6,0,0,0,0,0,0,0,0,0,41650
13446,8232,2079,2622,2533,600,398,672,302,162,5,18,139,140,105,71,0,34,35,0,0,35,370,277,32,12,233,93,63,33,0,30,30,0,0,30,41653
13447,561,125,136,258,42,0,0,0,0,0,0,0,0,0,0,0,0,0,0,0,0,0,0,0,0,0,0,0,0,0,0,0,0,0,0,41655
13448,277,19,90,123,33,12,0,0,0,0,0,0,0,0,0,0,0,0,0,0,0,0,0,0,0,0,0,0,0,0,0,0,0,0,0,41659
13449,627,300,213,76,17,21,0,0,0,0,0,0,0,0,0,0,0,0,0,0,0,0,0,0,0,0,0,0,0,0,0,0,0,0,0,41660
13450,517,89,299,109,0,20,0,0,0,0,0,0,0,0,0,0,0,0,0,0,0,0,0,0,0,0,0,0,0,0,0,0,0,0,0,41663
13451,624,104,250,199,20,51,66,40,36,0,0,36,4,4,0,0,4,0,0,0,0,26,25,5,0,20,1,1,1,0,0,0,0,0,0,41666
13452,430,149,216,63,0,2,15,15,15,0,0,15,0,0,0,0,0,0,0,0,0,0,0,0,0,0,0,0,0,0,0,0,0,0,0,41667
13453,857,277,323,216,26,15,116,75,53,0,2,51,22,22,0,0,22,0,0,0,0,41,33,0,0,33,8,8,4,0,4,0,0,0,0,41669
13454,12134,3466,3583,3134,1086,865,910,513,459,51,30,378,54,54,54,0,0,0,0,0,0,397,351,94,38,219,46,20,0,0,20,26,0,0,26,41701
13455,226,91,95,40,0,0,0,0,0,0,0,0,0,0,0,0,0,0,0,0,0,0,0,0,0,0,0,0,0,0,0,0,0,0,0,41712
13456,0,0,0,0,0,0,0,0,0,0,0,0,0,0,0,0,0,0,0,0,0,0,0,0,0,0,0,0,0,0,0,0,0,0,0,41713
13457,167,50,30,76,11,0,0,0,0,0,0,0,0,0,0,0,0,0,0,0,0,0,0,0,0,0,0,0,0,0,0,0,0,0,0,41714
13458,733,334,262,105,32,0,22,13,0,0,0,0,13,0,0,0,0,13,0,13,0,9,0,0,0,0,9,0,0,0,0,9,0,0,9,41719
13459,409,144,144,90,7,24,75,45,16,0,0,16,29,25,6,9,10,4,0,0,4,30,23,7,7,9,7,7,0,7,0,0,0,0,0,41721
13460,1183,320,492,218,46,107,117,94,94,0,0,94,0,0,0,0,0,0,0,0,0,23,23,0,12,11,0,0,0,0,0,0,0,0,0,41722
13461,968,417,315,119,117,0,139,36,36,0,8,28,0,0,0,0,0,0,0,0,0,103,71,0,0,71,32,0,0,0,0,32,0,17,15,41723
13462,87,0,74,13,0,0,0,0,0,0,0,0,0,0,0,0,0,0,0,0,0,0,0,0,0,0,0,0,0,0,0,0,0,0,0,41725
13463,328,82,75,159,12,0,58,10,10,0,0,10,0,0,0,0,0,0,0,0,0,48,48,0,0,48,0,0,0,0,0,0,0,0,0,41727
13464,260,218,0,42,0,0,0,0,0,0,0,0,0,0,0,0,0,0,0,0,0,0,0,0,0,0,0,0,0,0,0,0,0,0,0,41729
13465,715,304,300,46,23,42,26,0,0,0,0,0,0,0,0,0,0,0,0,0,0,26,26,13,0,13,0,0,0,0,0,0,0,0,0,41731
13466,89,37,40,7,5,0,15,0,0,0,0,0,0,0,0,0,0,0,0,0,0,15,15,11,0,4,0,0,0,0,0,0,0,0,0,41735
13467,115,30,15,28,11,31,0,0,0,0,0,0,0,0,0,0,0,0,0,0,0,0,0,0,0,0,0,0,0,0,0,0,0,0,0,41739
13468,729,132,268,224,61,44,27,27,27,0,0,27,0,0,0,0,0,0,0,0,0,0,0,0,0,0,0,0,0,0,0,0,0,0,0,41740
13469,21,12,0,9,0,0,13,13,13,0,0,13,0,0,0,0,0,0,0,0,0,0,0,0,0,0,0,0,0,0,0,0,0,0,0,41745
13470,475,193,142,133,0,7,39,23,23,0,0,23,0,0,0,0,0,0,0,0,0,16,16,0,0,16,0,0,0,0,0,0,0,0,0,41746
13471,2560,1169,716,426,133,116,153,55,24,9,0,15,31,18,18,0,0,13,0,13,0,98,76,2,0,74,22,22,0,0,22,0,0,0,0,41749
13472,278,82,79,83,34,0,9,0,0,0,0,0,0,0,0,0,0,0,0,0,0,9,9,0,0,9,0,0,0,0,0,0,0,0,0,41751
13473,259,101,87,57,14,0,0,0,0,0,0,0,0,0,0,0,0,0,0,0,0,0,0,0,0,0,0,0,0,0,0,0,0,0,0,41754
13474,223,34,101,59,19,10,0,0,0,0,0,0,0,0,0,0,0,0,0,0,0,0,0,0,0,0,0,0,0,0,0,0,0,0,0,41759
13475,9,0,0,5,4,0,0,0,0,0,0,0,0,0,0,0,0,0,0,0,0,0,0,0,0,0,0,0,0,0,0,0,0,0,0,41760
13476,199,53,82,64,0,0,0,0,0,0,0,0,0,0,0,0,0,0,0,0,0,0,0,0,0,0,0,0,0,0,0,0,0,0,0,41762
13477,466,125,201,59,51,30,21,15,15,0,0,15,0,0,0,0,0,0,0,0,0,6,6,0,0,6,0,0,0,0,0,0,0,0,0,41763
13478,592,188,244,91,57,12,64,24,24,0,0,24,0,0,0,0,0,0,0,0,0,40,40,0,5,35,0,0,0,0,0,0,0,0,0,41764
13479,103,30,23,43,7,0,13,13,13,13,0,0,0,0,0,0,0,0,0,0,0,0,0,0,0,0,0,0,0,0,0,0,0,0,0,41766
13480,196,24,83,79,10,0,6,0,0,0,0,0,0,0,0,0,0,0,0,0,0,6,0,0,0,0,6,6,0,0,6,0,0,0,0,41772
13481,1006,285,447,178,55,41,140,43,32,3,9,20,11,3,0,0,3,8,8,0,0,97,90,3,18,69,7,3,0,0,3,4,0,4,0,41773
13482,1814,483,892,261,75,103,109,70,62,0,16,46,8,8,8,0,0,0,0,0,0,39,39,15,8,16,0,0,0,0,0,0,0,0,0,41774
13483,46,22,12,12,0,0,0,0,0,0,0,0,0,0,0,0,0,0,0,0,0,0,0,0,0,0,0,0,0,0,0,0,0,0,0,41775
13484,907,241,344,248,32,42,82,32,32,19,0,13,0,0,0,0,0,0,0,0,0,50,50,18,0,32,0,0,0,0,0,0,0,0,0,41776
13485,759,269,240,228,6,16,22,9,9,9,0,0,0,0,0,0,0,0,0,0,0,13,13,0,0,13,0,0,0,0,0,0,0,0,0,41777
13486,781,171,373,128,70,39,83,55,49,0,0,49,6,6,0,6,0,0,0,0,0,28,20,0,0,20,8,0,0,0,0,8,0,0,8,41804
13487,300,48,72,180,0,0,43,31,31,31,0,0,0,0,0,0,0,0,0,0,0,12,12,0,0,12,0,0,0,0,0,0,0,0,0,41810
13488,284,109,91,36,35,13,25,0,0,0,0,0,0,0,0,0,0,0,0,0,0,25,25,0,0,25,0,0,0,0,0,0,0,0,0,41812
13489,377,38,159,156,24,0,23,0,0,0,0,0,0,0,0,0,0,0,0,0,0,23,13,13,0,0,10,0,0,0,0,10,10,0,0,41815
13490,154,18,76,24,23,13,24,24,0,0,0,0,24,0,0,0,0,24,0,0,24,0,0,0,0,0,0,0,0,0,0,0,0,0,0,41817
13491,208,97,48,49,14,0,0,0,0,0,0,0,0,0,0,0,0,0,0,0,0,0,0,0,0,0,0,0,0,0,0,0,0,0,0,41819
13492,505,129,160,164,29,23,39,21,21,0,0,21,0,0,0,0,0,0,0,0,0,18,18,0,0,18,0,0,0,0,0,0,0,0,0,41821
13493,1452,427,517,250,143,115,232,86,71,14,7,50,15,0,0,0,0,15,0,0,15,146,129,19,9,101,17,14,0,14,0,3,3,0,0,41822
13494,707,207,283,200,17,0,35,0,0,0,0,0,0,0,0,0,0,0,0,0,0,35,35,13,0,22,0,0,0,0,0,0,0,0,0,41824
13495,322,74,114,108,26,0,20,0,0,0,0,0,0,0,0,0,0,0,0,0,0,20,20,0,0,20,0,0,0,0,0,0,0,0,0,41825
13496,704,112,205,302,0,85,10,10,10,0,0,10,0,0,0,0,0,0,0,0,0,0,0,0,0,0,0,0,0,0,0,0,0,0,0,41826
13497,700,311,162,146,15,66,69,9,9,0,0,9,0,0,0,0,0,0,0,0,0,60,40,9,0,31,20,20,0,0,20,0,0,0,0,41828
13498,665,147,248,193,65,12,21,21,9,0,0,9,12,12,0,12,0,0,0,0,0,0,0,0,0,0,0,0,0,0,0,0,0,0,0,41831
13499,418,120,124,156,0,18,46,46,46,0,0,46,0,0,0,0,0,0,0,0,0,0,0,0,0,0,0,0,0,0,0,0,0,0,0,41832
13500,168,94,60,14,0,0,17,17,0,0,0,0,17,0,0,0,0,17,0,17,0,0,0,0,0,0,0,0,0,0,0,0,0,0,0,41833
13501,515,83,293,100,22,17,28,15,9,0,0,9,6,0,0,0,0,6,0,0,6,13,2,0,0,2,11,0,0,0,0,11,0,0,11,41834
13502,789,136,358,137,149,9,61,29,29,9,0,20,0,0,0,0,0,0,0,0,0,32,32,12,0,20,0,0,0,0,0,0,0,0,0,41835
13503,611,139,146,172,73,81,61,25,25,0,8,17,0,0,0,0,0,0,0,0,0,36,17,0,0,17,19,9,9,0,0,10,0,0,10,41836
13504,398,116,114,135,33,0,0,0,0,0,0,0,0,0,0,0,0,0,0,0,0,0,0,0,0,0,0,0,0,0,0,0,0,0,0,41837
13505,293,99,113,51,30,0,0,0,0,0,0,0,0,0,0,0,0,0,0,0,0,0,0,0,0,0,0,0,0,0,0,0,0,0,0,41838
13506,939,343,394,138,38,26,45,17,17,0,0,17,0,0,0,0,0,0,0,0,0,28,28,0,0,28,0,0,0,0,0,0,0,0,0,41839
13507,983,260,408,179,97,39,83,61,34,8,0,26,27,25,4,0,21,2,0,0,2,22,20,4,1,15,2,2,0,2,0,0,0,0,0,41840
13508,476,240,160,59,9,8,49,40,40,0,0,40,0,0,0,0,0,0,0,0,0,9,9,0,0,9,0,0,0,0,0,0,0,0,0,41843
13509,1068,337,310,192,88,141,183,81,75,9,0,66,6,0,0,0,0,6,0,0,6,102,94,35,8,51,8,0,0,0,0,8,0,0,8,41844
13510,74,19,30,25,0,0,9,0,0,0,0,0,0,0,0,0,0,0,0,0,0,9,9,0,0,9,0,0,0,0,0,0,0,0,0,41845
13511,354,133,122,61,14,24,0,0,0,0,0,0,0,0,0,0,0,0,0,0,0,0,0,0,0,0,0,0,0,0,0,0,0,0,0,41847
13512,18,0,18,0,0,0,0,0,0,0,0,0,0,0,0,0,0,0,0,0,0,0,0,0,0,0,0,0,0,0,0,0,0,0,0,41848
13513,75,24,31,20,0,0,0,0,0,0,0,0,0,0,0,0,0,0,0,0,0,0,0,0,0,0,0,0,0,0,0,0,0,0,0,41849
13514,385,62,153,124,20,26,68,45,32,2,0,30,13,13,0,0,13,0,0,0,0,23,23,0,0,23,0,0,0,0,0,0,0,0,0,41855
13515,5706,1394,2062,1399,503,348,370,156,124,22,2,100,32,15,0,10,5,17,0,17,0,214,198,100,4,94,16,0,0,0,0,16,0,16,0,41858
13516,300,57,151,47,4,41,20,5,5,0,0,5,0,0,0,0,0,0,0,0,0,15,15,9,0,6,0,0,0,0,0,0,0,0,0,41859
13517,142,14,56,61,0,11,0,0,0,0,0,0,0,0,0,0,0,0,0,0,0,0,0,0,0,0,0,0,0,0,0,0,0,0,0,41861
13518,593,236,191,96,55,15,28,22,8,0,0,8,14,9,0,0,9,5,0,5,0,6,6,0,0,6,0,0,0,0,0,0,0,0,0,41862
13519,19863,2006,5140,6742,3320,2655,1064,644,568,108,38,422,76,57,57,0,0,19,0,14,5,420,368,91,54,223,52,37,9,19,9,15,0,0,15,42001
13520,20694,3333,7407,6698,2101,1155,1146,564,470,166,76,228,94,59,24,8,27,35,0,26,9,582,411,146,0,265,171,72,22,50,0,99,74,0,25,42003
13521,1555,152,562,482,227,132,112,78,78,33,4,41,0,0,0,0,0,0,0,0,0,34,34,5,0,29,0,0,0,0,0,0,0,0,0,42020
13522,993,188,426,311,33,35,129,52,52,13,0,39,0,0,0,0,0,0,0,0,0,77,20,0,0,20,57,46,46,0,0,11,6,0,5,42021
13523,50,0,20,30,0,0,0,0,0,0,0,0,0,0,0,0,0,0,0,0,0,0,0,0,0,0,0,0,0,0,0,0,0,0,0,42022
13524,1824,301,688,538,149,148,131,62,53,6,6,41,9,9,6,3,0,0,0,0,0,69,54,21,2,31,15,15,0,0,15,0,0,0,0,42023
13525,1061,183,384,329,96,69,96,36,31,7,0,24,5,5,5,0,0,0,0,0,0,60,60,7,10,43,0,0,0,0,0,0,0,0,0,42024
13526,14310,2104,5957,4081,1300,868,839,315,247,55,33,159,68,52,12,15,25,16,0,8,8,524,503,283,31,189,21,21,0,21,0,0,0,0,0,42025
13527,1504,242,552,368,150,192,172,117,63,16,0,47,54,54,0,0,54,0,0,0,0,55,14,14,0,0,41,41,41,0,0,0,0,0,0,42027
13528,456,40,219,117,47,33,15,9,5,0,0,5,4,4,4,0,0,0,0,0,0,6,6,0,0,6,0,0,0,0,0,0,0,0,0,42028
13529,4379,657,1774,1258,456,234,500,344,315,96,10,209,29,29,29,0,0,0,0,0,0,156,142,78,0,64,14,14,14,0,0,0,0,0,0,42029
13530,2407,567,853,668,207,112,133,62,27,0,0,27,35,2,0,2,0,33,0,16,17,71,65,11,0,54,6,6,6,0,0,0,0,0,0,42031
13531,197,61,93,36,7,0,9,5,5,0,0,5,0,0,0,0,0,0,0,0,0,4,3,0,3,0,1,1,1,0,0,0,0,0,0,42032
13532,601,106,238,114,114,29,79,27,27,0,13,14,0,0,0,0,0,0,0,0,0,52,24,14,0,10,28,0,0,0,0,28,0,0,28,42035
13533,782,202,357,146,58,19,65,11,11,0,0,11,0,0,0,0,0,0,0,0,0,54,44,0,0,44,10,10,10,0,0,0,0,0,0,42036
13534,0,0,0,0,0,0,0,0,0,0,0,0,0,0,0,0,0,0,0,0,0,0,0,0,0,0,0,0,0,0,0,0,0,0,0,42037
13535,4242,754,1716,1333,287,152,173,105,102,47,0,55,3,3,0,3,0,0,0,0,0,68,62,27,14,21,6,6,0,6,0,0,0,0,0,42038
13536,1241,134,421,487,73,126,94,53,46,21,0,25,7,7,7,0,0,0,0,0,0,41,27,6,0,21,14,0,0,0,0,14,0,0,14,42039
13537,855,123,267,224,149,92,77,13,0,0,0,0,13,13,0,0,13,0,0,0,0,64,64,0,0,64,0,0,0,0,0,0,0,0,0,42040
13538,3302,696,1343,903,243,117,192,133,115,14,33,68,18,18,0,18,0,0,0,0,0,59,51,15,0,36,8,0,0,0,0,8,8,0,0,42041
13539,2268,278,841,644,333,172,36,7,7,2,0,5,0,0,0,0,0,0,0,0,0,29,29,29,0,0,0,0,0,0,0,0,0,0,0,42044
13540,1362,305,498,377,106,76,77,57,57,26,0,31,0,0,0,0,0,0,0,0,0,20,20,10,0,10,0,0,0,0,0,0,0,0,0,42045
13541,116,8,50,58,0,0,0,0,0,0,0,0,0,0,0,0,0,0,0,0,0,0,0,0,0,0,0,0,0,0,0,0,0,0,0,42047
13542,1590,280,743,472,80,15,180,139,74,25,0,49,65,0,0,0,0,65,0,8,57,41,24,13,2,9,17,5,5,0,0,12,0,0,12,42048
13543,1259,119,411,451,200,78,89,30,21,0,0,21,9,9,7,2,0,0,0,0,0,59,50,35,2,13,9,7,7,0,0,2,0,0,2,42049
13544,2261,628,804,536,213,80,145,43,43,23,12,8,0,0,0,0,0,0,0,0,0,102,72,26,0,46,30,30,24,6,0,0,0,0,0,42050
13545,1879,240,820,510,173,136,151,56,43,18,0,25,13,13,13,0,0,0,0,0,0,95,95,36,24,35,0,0,0,0,0,0,0,0,0,42051
13546,3240,460,1269,911,293,307,325,144,128,22,22,84,16,16,0,16,0,0,0,0,0,181,126,85,0,41,55,54,0,0,54,1,0,0,1,42053
13547,653,64,279,194,40,76,32,32,18,0,0,18,14,14,5,0,9,0,0,0,0,0,0,0,0,0,0,0,0,0,0,0,0,0,0,42054
13548,2105,273,846,570,270,146,85,34,34,0,0,34,0,0,0,0,0,0,0,0,0,51,42,10,11,21,9,0,0,0,0,9,0,0,9,42055
13549,1666,258,704,520,81,103,73,55,41,0,0,41,14,0,0,0,0,14,0,14,0,18,4,0,0,4,14,12,12,0,0,2,0,0,2,42056
13550,1402,139,679,385,49,150,146,49,39,7,0,32,10,0,0,0,0,10,0,0,10,97,91,59,21,11,6,6,6,0,0,0,0,0,0,42058
13551,96,21,31,44,0,0,0,0,0,0,0,0,0,0,0,0,0,0,0,0,0,0,0,0,0,0,0,0,0,0,0,0,0,0,0,42060
13552,68,0,0,0,51,17,0,0,0,0,0,0,0,0,0,0,0,0,0,0,0,0,0,0,0,0,0,0,0,0,0,0,0,0,0,42061
13553,5788,1190,2287,1618,443,250,332,178,103,25,17,61,75,16,5,0,11,59,26,0,33,154,96,35,14,47,58,18,9,0,9,40,0,0,40,42064
13554,15795,3252,5456,4444,1679,964,1290,568,389,133,22,234,179,104,104,0,0,75,22,50,3,722,683,147,149,387,39,34,29,0,5,5,0,0,5,42066
13555,566,121,243,116,76,10,48,48,29,10,0,19,19,19,0,19,0,0,0,0,0,0,0,0,0,0,0,0,0,0,0,0,0,0,0,42069
13556,17216,2439,5121,4409,2911,2336,2650,1010,935,224,98,613,75,53,17,13,23,22,6,5,11,1640,1573,493,160,920,67,67,38,26,3,0,0,0,0,42071
13557,834,140,382,187,77,48,21,10,10,10,0,0,0,0,0,0,0,0,0,0,0,11,11,0,0,11,0,0,0,0,0,0,0,0,0,42076
13558,1411,242,689,360,50,70,44,21,10,10,0,0,11,11,0,2,9,0,0,0,0,23,17,2,4,11,6,6,6,0,0,0,0,0,0,42078
13559,968,186,318,225,175,64,63,63,51,0,0,51,12,0,0,0,0,12,0,12,0,0,0,0,0,0,0,0,0,0,0,0,0,0,0,42079
13560,2008,465,869,495,118,61,125,44,34,2,0,32,10,3,3,0,0,7,0,0,7,81,80,32,0,48,1,0,0,0,0,1,1,0,0,42081
13561,1352,232,627,300,125,68,41,24,24,16,0,8,0,0,0,0,0,0,0,0,0,17,17,17,0,0,0,0,0,0,0,0,0,0,0,42082
13562,271,21,151,85,14,0,21,0,0,0,0,0,0,0,0,0,0,0,0,0,0,21,21,0,0,21,0,0,0,0,0,0,0,0,0,42083
13563,123,46,33,44,0,0,18,7,0,0,0,0,7,7,7,0,0,0,0,0,0,11,11,3,0,8,0,0,0,0,0,0,0,0,0,42084
13564,525,87,199,220,19,0,28,15,0,0,0,0,15,4,0,0,4,11,0,0,11,13,13,1,0,12,0,0,0,0,0,0,0,0,0,42085
13565,2930,238,1004,1109,344,235,284,111,111,36,14,61,0,0,0,0,0,0,0,0,0,173,173,73,0,100,0,0,0,0,0,0,0,0,0,42086
13566,1678,328,637,507,144,62,120,61,32,0,0,32,29,26,13,13,0,3,0,0,3,59,59,43,0,16,0,0,0,0,0,0,0,0,0,42087
13567,1802,349,763,482,197,11,103,68,52,0,2,50,16,16,6,0,10,0,0,0,0,35,9,3,0,6,26,25,25,0,0,1,0,0,1,42088
13568,31342,5942,11478,7845,3774,2303,5671,2487,2137,470,320,1347,350,288,71,115,102,62,0,0,62,3184,3027,859,378,1790,157,121,70,6,45,36,0,21,15,42101
13569,37,0,9,28,0,0,0,0,0,0,0,0,0,0,0,0,0,0,0,0,0,0,0,0,0,0,0,0,0,0,0,0,0,0,0,42102
13570,13624,1330,3335,3761,3172,2026,819,576,454,106,66,282,122,122,64,0,58,0,0,0,0,243,228,54,9,165,15,11,11,0,0,4,0,0,4,42103
13571,19112,1695,4924,5332,4366,2795,1168,652,540,83,58,399,112,93,70,6,17,19,19,0,0,516,459,199,15,245,57,57,37,0,20,0,0,0,0,42104
13572,1688,651,565,321,108,43,115,96,48,14,0,34,48,0,0,0,0,48,0,0,48,19,19,0,0,19,0,0,0,0,0,0,0,0,0,42120
13573,3183,219,1080,973,555,356,173,111,106,0,0,106,5,5,0,0,5,0,0,0,0,62,55,33,0,22,7,7,7,0,0,0,0,0,0,42122
13574,654,131,369,121,22,11,63,48,48,0,0,48,0,0,0,0,0,0,0,0,0,15,15,8,0,7,0,0,0,0,0,0,0,0,0,42123
13575,13,0,13,0,0,0,0,0,0,0,0,0,0,0,0,0,0,0,0,0,0,0,0,0,0,0,0,0,0,0,0,0,0,0,0,42124
13576,4085,812,2010,752,233,278,225,75,75,20,0,55,0,0,0,0,0,0,0,0,0,150,127,44,10,73,23,6,0,6,0,17,0,0,17,42127
13577,4727,1424,1982,916,258,147,400,210,173,0,5,168,37,37,33,4,0,0,0,0,0,190,145,14,17,114,45,41,23,0,18,4,0,4,0,42129
13578,72,0,34,38,0,0,12,12,12,0,12,0,0,0,0,0,0,0,0,0,0,0,0,0,0,0,0,0,0,0,0,0,0,0,0,42130
13579,896,282,362,139,65,48,53,26,4,0,0,4,22,4,4,0,0,18,18,0,0,27,20,20,0,0,7,0,0,0,0,7,6,0,1,42133
13580,11203,1960,4688,2935,1112,508,722,429,318,73,7,238,111,87,87,0,0,24,0,0,24,293,255,82,31,142,38,38,17,0,21,0,0,0,0,42134
13581,859,208,415,175,38,23,82,48,42,9,10,23,6,6,4,2,0,0,0,0,0,34,34,28,0,6,0,0,0,0,0,0,0,0,0,42140
13582,20970,4542,8078,5049,2052,1249,1546,758,576,160,59,357,182,104,33,58,13,78,0,0,78,788,545,178,60,307,243,194,113,0,81,49,0,0,49,42141
13583,117,71,33,13,0,0,0,0,0,0,0,0,0,0,0,0,0,0,0,0,0,0,0,0,0,0,0,0,0,0,0,0,0,0,0,42151
13584,153,59,51,37,0,6,9,0,0,0,0,0,0,0,0,0,0,0,0,0,0,9,9,9,0,0,0,0,0,0,0,0,0,0,0,42153
13585,509,216,199,63,31,0,24,0,0,0,0,0,0,0,0,0,0,0,0,0,0,24,15,0,0,15,9,9,9,0,0,0,0,0,0,42154
13586,158,26,59,22,13,38,18,6,6,6,0,0,0,0,0,0,0,0,0,0,0,12,12,12,0,0,0,0,0,0,0,0,0,0,0,42156
13587,189,72,39,43,26,9,0,0,0,0,0,0,0,0,0,0,0,0,0,0,0,0,0,0,0,0,0,0,0,0,0,0,0,0,0,42157
13588,825,123,273,248,162,19,176,104,99,2,20,77,5,4,4,0,0,1,0,0,1,72,70,55,13,2,2,2,2,0,0,0,0,0,0,42159
13589,1254,307,564,252,103,28,60,34,0,0,0,0,34,4,4,0,0,30,16,14,0,26,26,15,6,5,0,0,0,0,0,0,0,0,0,42160
13590,27,27,0,0,0,0,22,0,0,0,0,0,0,0,0,0,0,0,0,0,0,22,15,0,0,15,7,7,0,0,7,0,0,0,0,42163
13591,11239,2383,4169,3188,873,626,1056,486,423,64,92,267,63,54,10,17,27,9,5,0,4,570,455,102,36,317,115,110,93,11,6,5,5,0,0,42164
13592,1608,425,751,298,37,97,152,77,46,31,15,0,31,31,31,0,0,0,0,0,0,75,75,16,0,59,0,0,0,0,0,0,0,0,0,42166
13593,5795,1452,2517,1061,529,236,339,220,175,48,0,127,45,45,34,11,0,0,0,0,0,119,119,33,19,67,0,0,0,0,0,0,0,0,0,42167
13594,947,150,348,276,93,80,72,55,51,0,3,48,4,4,0,0,4,0,0,0,0,17,17,0,0,17,0,0,0,0,0,0,0,0,0,42170
13595,4530,603,1766,1464,493,204,237,129,85,18,19,48,44,0,0,0,0,44,23,0,21,108,108,57,0,51,0,0,0,0,0,0,0,0,0,42171
13596,1785,501,822,300,121,41,86,11,4,3,0,1,7,0,0,0,0,7,0,0,7,75,60,46,0,14,15,8,8,0,0,7,7,0,0,42202
13597,302,47,129,100,21,5,7,0,0,0,0,0,0,0,0,0,0,0,0,0,0,7,7,0,7,0,0,0,0,0,0,0,0,0,0,42204
13598,3596,808,1227,986,310,265,417,238,168,18,32,118,70,41,35,4,2,29,16,13,0,179,164,57,0,107,15,0,0,0,0,15,0,0,15,42206
13599,1086,189,478,311,55,53,103,85,64,39,9,16,21,21,21,0,0,0,0,0,0,18,18,0,0,18,0,0,0,0,0,0,0,0,0,42207
13600,2748,657,1356,521,105,109,244,154,82,4,29,49,72,68,5,63,0,4,4,0,0,90,54,17,6,31,36,31,5,0,26,5,0,0,5,42210
13601,9454,1570,3189,2915,1017,763,625,454,375,101,16,258,79,10,0,0,10,69,0,43,26,171,160,36,8,116,11,0,0,0,0,11,2,0,9,42211
13602,380,36,193,119,20,12,17,17,17,10,0,7,0,0,0,0,0,0,0,0,0,0,0,0,0,0,0,0,0,0,0,0,0,0,0,42214
13603,888,259,428,116,23,62,36,28,28,0,0,28,0,0,0,0,0,0,0,0,0,8,8,0,0,8,0,0,0,0,0,0,0,0,0,42215
13604,2504,411,1090,778,131,94,235,133,62,20,0,42,71,28,7,0,21,43,43,0,0,102,85,37,6,42,17,9,0,0,9,8,8,0,0,42217
13605,4497,1089,1857,1213,195,143,287,144,101,22,0,79,43,14,11,0,3,29,27,0,2,143,99,37,15,47,44,6,0,0,6,38,0,0,38,42220
13606,7698,452,1942,4122,874,308,1271,925,332,78,109,145,593,569,501,8,60,24,24,0,0,346,239,53,8,178,107,107,73,0,34,0,0,0,0,42223
13607,357,61,108,104,62,22,13,13,13,13,0,0,0,0,0,0,0,0,0,0,0,0,0,0,0,0,0,0,0,0,0,0,0,0,0,42232
13608,1551,426,503,432,139,51,207,95,74,0,6,68,21,21,5,10,6,0,0,0,0,112,56,4,0,52,56,29,6,12,11,27,0,0,27,42234
13609,462,88,182,124,20,48,62,9,9,0,0,9,0,0,0,0,0,0,0,0,0,53,53,0,0,53,0,0,0,0,0,0,0,0,0,42236
13610,28201,4525,9829,8977,2866,2004,2482,1289,902,72,117,713,387,251,185,0,66,136,54,76,6,1193,1003,193,110,700,190,148,71,49,28,42,0,0,42,42240
13611,113,14,48,44,5,2,24,10,10,10,0,0,0,0,0,0,0,0,0,0,0,14,14,2,10,2,0,0,0,0,0,0,0,0,0,42254
13612,3294,898,1356,651,270,119,267,138,99,10,12,77,39,24,19,0,5,15,0,13,2,129,104,47,0,57,25,13,4,0,9,12,0,12,0,42256
13613,729,144,397,132,35,21,137,88,13,11,0,2,75,26,10,0,16,49,22,0,27,49,41,15,8,18,8,8,0,0,8,0,0,0,0,42259
13614,7559,1714,3354,1869,359,263,535,380,380,56,0,324,0,0,0,0,0,0,0,0,0,155,150,28,10,112,5,0,0,0,0,5,0,0,5,42261
13615,4044,436,1180,2114,262,52,335,214,214,131,9,74,0,0,0,0,0,0,0,0,0,121,110,24,23,63,11,11,0,11,0,0,0,0,0,42262
13616,906,92,439,256,85,34,0,0,0,0,0,0,0,0,0,0,0,0,0,0,0,0,0,0,0,0,0,0,0,0,0,0,0,0,0,42265
13617,1414,248,601,311,194,60,85,33,33,1,3,29,0,0,0,0,0,0,0,0,0,52,32,17,0,15,20,7,5,2,0,13,0,0,13,42266
13618,279,43,118,62,36,20,21,10,10,0,0,10,0,0,0,0,0,0,0,0,0,11,4,0,0,4,7,7,7,0,0,0,0,0,0,42273
13619,1510,153,609,475,200,73,0,0,0,0,0,0,0,0,0,0,0,0,0,0,0,0,0,0,0,0,0,0,0,0,0,0,0,0,0,42274
13620,463,143,194,87,30,9,16,0,0,0,0,0,0,0,0,0,0,0,0,0,0,16,0,0,0,0,16,0,0,0,0,16,0,0,16,42275
13621,9707,2298,3772,2390,756,491,681,365,294,105,26,163,71,60,54,6,0,11,0,0,11,316,231,34,53,144,85,74,7,43,24,11,0,0,11,42276
13622,269,89,91,79,0,10,17,7,0,0,0,0,7,7,7,0,0,0,0,0,0,10,0,0,0,0,10,10,10,0,0,0,0,0,0,42280
13623,285,63,125,83,0,14,65,0,0,0,0,0,0,0,0,0,0,0,0,0,0,65,65,0,4,61,0,0,0,0,0,0,0,0,0,42285
13624,738,145,247,223,60,63,26,23,23,1,0,22,0,0,0,0,0,0,0,0,0,3,3,0,0,3,0,0,0,0,0,0,0,0,0,42286
13625,28948,3754,11608,8645,2832,2109,1928,985,767,246,88,433,218,173,99,60,14,45,15,0,30,943,816,210,91,515,127,110,84,11,15,17,0,0,17,42301
13626,25567,3032,9298,7759,3339,2139,2088,1065,923,243,116,564,142,98,53,12,33,44,0,0,44,1023,891,372,108,411,132,116,90,0,26,16,0,0,16,42303
13627,5933,1694,2422,1321,250,246,369,232,157,43,15,99,75,73,50,23,0,2,2,0,0,137,77,27,2,48,60,40,0,9,31,20,0,2,18,42320
13628,172,132,40,0,0,0,7,0,0,0,0,0,0,0,0,0,0,0,0,0,0,7,7,0,0,7,0,0,0,0,0,0,0,0,0,42321
13629,0,0,0,0,0,0,0,0,0,0,0,0,0,0,0,0,0,0,0,0,0,0,0,0,0,0,0,0,0,0,0,0,0,0,0,42322
13630,624,83,278,210,13,40,89,0,0,0,0,0,0,0,0,0,0,0,0,0,0,89,89,0,0,89,0,0,0,0,0,0,0,0,0,42323
13631,876,193,390,242,39,12,128,56,41,9,0,32,15,15,15,0,0,0,0,0,0,72,72,19,22,31,0,0,0,0,0,0,0,0,0,42324
13632,1654,307,776,413,91,67,92,43,33,0,16,17,10,10,0,0,10,0,0,0,0,49,40,2,0,38,9,9,9,0,0,0,0,0,0,42325
13633,452,99,209,85,59,0,26,14,14,0,0,14,0,0,0,0,0,0,0,0,0,12,12,0,0,12,0,0,0,0,0,0,0,0,0,42326
13634,2805,453,1047,921,196,188,290,150,98,14,0,84,52,49,40,9,0,3,0,0,3,140,110,52,0,58,30,30,20,0,10,0,0,0,0,42327
13635,1051,230,462,296,34,29,91,40,35,1,0,34,5,3,3,0,0,2,0,0,2,51,46,0,0,46,5,5,4,1,0,0,0,0,0,42328
13636,6901,1360,3166,1857,265,253,411,300,267,4,2,261,33,15,15,0,0,18,0,0,18,111,92,34,3,55,19,19,19,0,0,0,0,0,0,42330
13637,121,30,65,20,0,6,36,21,21,21,0,0,0,0,0,0,0,0,0,0,0,15,15,10,0,5,0,0,0,0,0,0,0,0,0,42332
13638,726,245,373,75,33,0,86,49,45,0,0,45,4,2,0,0,2,2,0,0,2,37,37,25,0,12,0,0,0,0,0,0,0,0,0,42333
13639,1216,414,423,294,66,19,84,61,58,25,0,33,3,3,0,3,0,0,0,0,0,23,19,15,4,0,4,4,0,4,0,0,0,0,0,42337
13640,105,0,84,21,0,0,0,0,0,0,0,0,0,0,0,0,0,0,0,0,0,0,0,0,0,0,0,0,0,0,0,0,0,0,0,42338
13641,551,138,203,89,89,32,39,26,26,0,0,26,0,0,0,0,0,0,0,0,0,13,13,0,0,13,0,0,0,0,0,0,0,0,0,42339
13642,1294,295,624,336,20,19,94,53,34,8,0,26,19,19,2,17,0,0,0,0,0,41,41,2,0,39,0,0,0,0,0,0,0,0,0,42343
13643,768,173,297,291,7,0,12,12,12,0,0,12,0,0,0,0,0,0,0,0,0,0,0,0,0,0,0,0,0,0,0,0,0,0,0,42344
13644,7637,1617,2533,2168,575,744,690,370,321,64,0,257,49,43,14,23,6,6,0,0,6,320,251,92,6,153,69,42,2,0,40,27,0,11,16,42345
13645,4107,668,1790,1184,195,270,297,126,117,30,6,81,9,9,9,0,0,0,0,0,0,171,111,52,0,59,60,60,14,4,42,0,0,0,0,42347
13646,3650,388,1897,998,241,126,290,169,136,23,17,96,33,33,33,0,0,0,0,0,0,121,112,58,2,52,9,0,0,0,0,9,0,3,6,42348
13647,785,226,391,159,9,0,95,22,9,0,0,9,13,0,0,0,0,13,0,0,13,73,73,49,16,8,0,0,0,0,0,0,0,0,0,42349
13648,1096,262,430,319,45,40,55,18,12,1,0,11,6,6,0,6,0,0,0,0,0,37,37,2,20,15,0,0,0,0,0,0,0,0,0,42350
13649,2480,275,1090,736,288,91,146,80,74,34,17,23,6,6,6,0,0,0,0,0,0,66,44,0,0,44,22,19,19,0,0,3,3,0,0,42351
13650,1264,257,527,378,52,50,93,50,50,0,0,50,0,0,0,0,0,0,0,0,0,43,38,25,8,5,5,5,5,0,0,0,0,0,0,42352
13651,187,40,74,69,4,0,2,2,2,0,0,2,0,0,0,0,0,0,0,0,0,0,0,0,0,0,0,0,0,0,0,0,0,0,0,42354
13652,1322,108,519,472,132,91,42,16,16,4,0,12,0,0,0,0,0,0,0,0,0,26,26,4,0,22,0,0,0,0,0,0,0,0,0,42355
13653,117,0,0,7,8,102,0,0,0,0,0,0,0,0,0,0,0,0,0,0,0,0,0,0,0,0,0,0,0,0,0,0,0,0,0,42356
13654,277,43,160,60,14,0,64,45,22,0,0,22,23,0,0,0,0,23,0,23,0,19,19,0,0,19,0,0,0,0,0,0,0,0,0,42361
13655,4072,368,1910,1154,297,343,369,233,212,109,33,70,21,21,21,0,0,0,0,0,0,136,123,23,0,100,13,13,0,10,3,0,0,0,0,42366
13656,455,119,248,69,12,7,34,18,3,0,0,3,15,15,12,3,0,0,0,0,0,16,5,0,0,5,11,11,0,1,10,0,0,0,0,42367
13657,809,97,462,217,20,13,61,15,15,2,0,13,0,0,0,0,0,0,0,0,0,46,46,14,6,26,0,0,0,0,0,0,0,0,0,42368
13658,238,78,85,68,7,0,19,12,12,3,0,9,0,0,0,0,0,0,0,0,0,7,5,0,0,5,2,2,2,0,0,0,0,0,0,42369
13659,0,0,0,0,0,0,0,0,0,0,0,0,0,0,0,0,0,0,0,0,0,0,0,0,0,0,0,0,0,0,0,0,0,0,0,42370
13660,384,70,251,55,0,8,8,0,0,0,0,0,0,0,0,0,0,0,0,0,0,8,8,0,0,8,0,0,0,0,0,0,0,0,0,42371
13661,1173,321,398,314,69,71,59,40,16,0,8,8,24,24,0,21,3,0,0,0,0,19,13,3,8,2,6,6,6,0,0,0,0,0,0,42372
13662,118,45,39,18,16,0,8,8,8,5,1,2,0,0,0,0,0,0,0,0,0,0,0,0,0,0,0,0,0,0,0,0,0,0,0,42374
13663,3841,493,1612,1108,328,300,211,89,71,44,0,27,18,18,0,7,11,0,0,0,0,122,103,20,43,40,19,19,19,0,0,0,0,0,0,42376
13664,1916,291,821,516,158,130,179,106,67,22,12,33,39,24,24,0,0,15,0,0,15,73,73,13,22,38,0,0,0,0,0,0,0,0,0,42378
13665,1998,394,902,485,104,113,136,76,76,28,9,39,0,0,0,0,0,0,0,0,0,60,41,0,4,37,19,5,0,0,5,14,0,6,8,42404
13666,2418,489,743,966,75,145,249,106,73,13,13,47,33,30,25,5,0,3,0,0,3,143,137,0,15,122,6,0,0,0,0,6,6,0,0,42406
13667,4609,757,2286,983,373,210,325,205,139,9,26,104,66,20,16,4,0,46,0,7,39,120,114,8,7,99,6,6,6,0,0,0,0,0,0,42408
13668,1638,409,734,323,68,104,88,31,17,10,0,7,14,2,0,2,0,12,0,0,12,57,52,39,4,9,5,4,0,0,4,1,0,0,1,42409
13669,967,182,384,345,24,32,53,39,36,4,0,32,3,3,3,0,0,0,0,0,0,14,14,4,0,10,0,0,0,0,0,0,0,0,0,42410
13670,1279,200,596,320,46,117,97,86,24,0,0,24,62,58,58,0,0,4,1,3,0,11,6,5,0,1,5,5,1,0,4,0,0,0,0,42411
13671,2452,200,894,940,199,219,148,74,71,2,7,62,3,3,3,0,0,0,0,0,0,74,74,32,0,42,0,0,0,0,0,0,0,0,0,42413
13672,26073,3825,9765,7869,2755,1859,1714,874,655,160,49,446,219,90,69,0,21,129,33,44,52,840,660,240,43,377,180,145,74,62,9,35,11,9,15,42420
13673,18459,2981,6887,5614,1774,1203,1199,605,459,85,33,341,146,82,41,29,12,64,35,11,18,594,582,231,38,313,12,12,12,0,0,0,0,0,0,42431
13674,845,207,332,252,44,10,15,15,15,0,0,15,0,0,0,0,0,0,0,0,0,0,0,0,0,0,0,0,0,0,0,0,0,0,0,42436
13675,5201,820,1849,1841,460,231,1006,662,346,110,0,236,316,137,1,14,122,179,20,0,159,344,251,75,23,153,93,42,23,0,19,51,7,0,44,42437
13676,521,194,183,83,23,38,33,18,13,4,2,7,5,0,0,0,0,5,5,0,0,15,0,0,0,0,15,6,0,0,6,9,0,0,9,42440
13677,1024,227,378,354,39,26,53,34,18,0,0,18,16,16,16,0,0,0,0,0,0,19,15,0,0,15,4,4,0,4,0,0,0,0,0,42441
13678,2476,533,965,649,198,131,105,48,43,3,18,22,5,0,0,0,0,5,0,2,3,57,40,3,0,37,17,3,3,0,0,14,3,0,11,42442
13679,7548,1280,3007,2019,650,592,509,209,145,0,19,126,64,57,4,7,46,7,0,0,7,300,211,116,0,95,89,54,37,0,17,35,0,0,35,42445
13680,2766,553,1214,829,95,75,146,100,75,0,10,65,25,25,25,0,0,0,0,0,0,46,28,0,0,28,18,18,18,0,0,0,0,0,0,42450
13681,691,185,368,138,0,0,56,17,17,17,0,0,0,0,0,0,0,0,0,0,0,39,39,0,0,39,0,0,0,0,0,0,0,0,0,42451
13682,1553,185,653,482,167,66,98,28,19,8,1,10,9,9,8,0,1,0,0,0,0,70,69,10,0,59,1,1,1,0,0,0,0,0,0,42452
13683,411,83,154,109,61,4,45,34,34,0,0,34,0,0,0,0,0,0,0,0,0,11,7,0,0,7,4,0,0,0,0,4,0,0,4,42453
13684,2215,547,888,604,118,58,244,122,99,30,0,69,23,0,0,0,0,23,0,0,23,122,108,21,0,87,14,0,0,0,0,14,0,0,14,42455
13685,912,160,408,217,53,74,64,48,39,0,7,32,9,0,0,0,0,9,0,0,9,16,11,5,0,6,5,5,0,0,5,0,0,0,0,42456
13686,802,62,255,351,104,30,33,33,33,33,0,0,0,0,0,0,0,0,0,0,0,0,0,0,0,0,0,0,0,0,0,0,0,0,0,42458
13687,3035,663,1194,966,67,145,155,70,70,5,6,59,0,0,0,0,0,0,0,0,0,85,76,11,0,65,9,0,0,0,0,9,6,0,3,42459
13688,913,215,399,256,33,10,33,20,20,11,3,6,0,0,0,0,0,0,0,0,0,13,3,3,0,0,10,10,0,0,10,0,0,0,0,42461
13689,763,75,373,158,74,83,38,27,13,7,0,6,14,14,0,14,0,0,0,0,0,11,11,0,0,11,0,0,0,0,0,0,0,0,0,42462
13690,84,16,60,8,0,0,4,1,0,0,0,0,1,0,0,0,0,1,0,1,0,3,3,0,0,3,0,0,0,0,0,0,0,0,0,42463
13691,1461,490,543,264,103,61,135,39,37,0,3,34,2,2,2,0,0,0,0,0,0,96,79,6,5,68,17,17,10,0,7,0,0,0,0,42464
13692,12166,2894,4463,3126,951,732,908,485,422,115,14,293,63,47,28,13,6,16,0,16,0,423,358,140,34,184,65,42,42,0,0,23,0,23,0,42501
13693,16627,2682,6359,4334,2005,1247,1399,668,624,219,39,366,44,43,38,0,5,1,0,0,1,731,629,152,107,370,102,55,0,0,55,47,34,0,13,42503
13694,347,88,169,61,29,0,36,5,0,0,0,0,5,5,0,0,5,0,0,0,0,31,31,0,0,31,0,0,0,0,0,0,0,0,0,42516
13695,2174,361,757,840,105,111,92,54,42,0,0,42,12,12,0,12,0,0,0,0,0,38,38,11,0,27,0,0,0,0,0,0,0,0,0,42518
13696,2110,711,736,441,101,121,204,163,153,32,0,121,10,10,9,0,1,0,0,0,0,41,2,0,0,2,39,39,8,0,31,0,0,0,0,42519
13697,1114,309,421,239,70,75,83,71,37,18,0,19,34,17,17,0,0,17,0,0,17,12,8,0,0,8,4,4,0,4,0,0,0,0,0,42528
13698,657,96,314,201,26,20,20,12,12,6,0,6,0,0,0,0,0,0,0,0,0,8,8,8,0,0,0,0,0,0,0,0,0,0,0,42533
13699,6846,2180,2701,1483,203,279,507,317,244,78,26,140,73,14,14,0,0,59,47,4,8,190,162,55,18,89,28,17,10,0,7,11,5,0,6,42539
13700,544,22,156,244,80,42,12,12,12,9,0,3,0,0,0,0,0,0,0,0,0,0,0,0,0,0,0,0,0,0,0,0,0,0,0,42541
13701,4300,886,1874,1011,268,261,292,111,55,27,0,28,56,56,0,0,56,0,0,0,0,181,166,87,0,79,15,15,15,0,0,0,0,0,0,42544
13702,3189,466,1283,1013,206,221,186,139,139,18,1,120,0,0,0,0,0,0,0,0,0,47,47,9,1,37,0,0,0,0,0,0,0,0,0,42553
13703,494,170,130,153,23,18,27,0,0,0,0,0,0,0,0,0,0,0,0,0,0,27,27,6,0,21,0,0,0,0,0,0,0,0,0,42565
13704,394,153,166,53,14,8,35,35,26,13,0,13,9,9,9,0,0,0,0,0,0,0,0,0,0,0,0,0,0,0,0,0,0,0,0,42566
13705,4190,1108,1825,901,214,142,146,65,32,0,20,12,33,2,0,0,2,31,6,23,2,81,68,30,2,36,13,11,11,0,0,2,0,0,2,42567
13706,6988,2195,2507,1753,251,282,678,343,215,42,13,160,128,62,23,38,1,66,57,0,9,335,220,18,2,200,115,84,24,0,60,31,0,0,31,42602
13707,94,56,38,0,0,0,29,29,29,0,0,29,0,0,0,0,0,0,0,0,0,0,0,0,0,0,0,0,0,0,0,0,0,0,0,42603
13708,3737,933,1535,806,268,195,243,104,92,22,33,37,12,3,0,0,3,9,0,0,9,139,86,33,12,41,53,0,0,0,0,53,0,7,46,42629
13709,85,0,0,85,0,0,0,0,0,0,0,0,0,0,0,0,0,0,0,0,0,0,0,0,0,0,0,0,0,0,0,0,0,0,0,42631
13710,13835,4303,5176,3018,680,658,969,586,513,74,37,402,73,66,50,16,0,7,0,0,7,383,331,105,28,198,52,51,6,45,0,1,0,0,1,42633
13711,1073,311,486,232,11,33,80,51,19,0,0,19,32,27,0,13,14,5,0,0,5,29,29,5,0,24,0,0,0,0,0,0,0,0,0,42634
13712,3499,1101,1534,676,135,53,358,193,70,23,0,47,123,39,0,14,25,84,0,0,84,165,134,0,23,111,31,3,0,0,3,28,0,22,6,42635
13713,182,75,63,44,0,0,0,0,0,0,0,0,0,0,0,0,0,0,0,0,0,0,0,0,0,0,0,0,0,0,0,0,0,0,0,42638
13714,8138,2148,3095,1918,512,465,549,296,154,28,40,86,142,106,70,0,36,36,0,0,36,253,186,75,7,104,67,39,13,0,26,28,0,0,28,42642
13715,3019,908,1011,724,108,268,172,65,50,0,27,23,15,15,5,0,10,0,0,0,0,107,103,59,0,44,4,4,0,4,0,0,0,0,0,42647
13716,1610,484,706,271,38,111,94,31,13,0,0,13,18,18,0,0,18,0,0,0,0,63,63,48,0,15,0,0,0,0,0,0,0,0,0,42649
13717,2745,789,815,995,105,41,249,158,132,32,31,69,26,15,15,0,0,11,0,0,11,91,81,17,13,51,10,0,0,0,0,10,10,0,0,42653
13718,32226,3589,10662,9960,4681,3334,2583,1201,967,182,100,685,234,198,108,31,59,36,0,0,36,1382,1093,380,106,607,289,270,165,80,25,19,19,0,0,42701
13719,1189,250,623,289,15,12,88,79,65,0,0,65,14,14,14,0,0,0,0,0,0,9,9,0,0,9,0,0,0,0,0,0,0,0,0,42712
13720,914,223,386,227,43,35,30,10,10,0,7,3,0,0,0,0,0,0,0,0,0,20,15,11,1,3,5,4,2,2,0,1,0,0,1,42713
13721,250,86,70,61,22,11,35,10,10,0,0,10,0,0,0,0,0,0,0,0,0,25,25,0,0,25,0,0,0,0,0,0,0,0,0,42715
13722,1261,247,509,356,81,68,21,21,21,0,0,21,0,0,0,0,0,0,0,0,0,0,0,0,0,0,0,0,0,0,0,0,0,0,0,42716
13723,4631,1239,1697,1082,371,242,394,171,113,20,0,93,58,53,16,30,7,5,0,5,0,223,168,69,12,87,55,0,0,0,0,55,0,14,41,42717
13724,15688,3092,6158,3997,1178,1263,1712,755,549,223,36,290,206,92,0,48,44,114,29,0,85,957,809,333,127,349,148,96,65,0,31,52,0,0,52,42718
13725,2799,750,1237,544,157,111,253,154,138,8,69,61,16,16,16,0,0,0,0,0,0,99,73,49,7,17,26,26,19,7,0,0,0,0,0,42721
13726,437,111,246,48,27,5,22,16,16,9,0,7,0,0,0,0,0,0,0,0,0,6,6,0,0,6,0,0,0,0,0,0,0,0,0,42722
13727,2931,504,1092,798,222,315,346,131,131,7,15,109,0,0,0,0,0,0,0,0,0,215,215,127,10,78,0,0,0,0,0,0,0,0,0,42724
13728,3226,834,1336,809,135,112,269,163,147,13,19,115,16,0,0,0,0,16,16,0,0,106,87,15,0,72,19,0,0,0,0,19,0,0,19,42726
13729,10515,2750,3849,2409,824,683,1093,620,454,28,29,397,166,120,29,13,78,46,0,0,46,473,415,145,52,218,58,49,26,8,15,9,0,0,9,42728
13730,1117,271,472,245,50,79,96,71,21,0,0,21,50,29,29,0,0,21,21,0,0,25,25,0,0,25,0,0,0,0,0,0,0,0,0,42729
13731,153,67,0,36,0,50,0,0,0,0,0,0,0,0,0,0,0,0,0,0,0,0,0,0,0,0,0,0,0,0,0,0,0,0,0,42731
13732,1425,230,845,290,47,13,109,55,55,11,16,28,0,0,0,0,0,0,0,0,0,54,40,19,21,0,14,14,0,14,0,0,0,0,0,42732
13733,1133,334,477,249,27,46,123,66,48,0,0,48,18,0,0,0,0,18,8,0,10,57,34,0,11,23,23,6,0,0,6,17,0,0,17,42733
13734,1312,250,468,470,56,68,102,33,33,0,18,15,0,0,0,0,0,0,0,0,0,69,69,16,19,34,0,0,0,0,0,0,0,0,0,42740
13735,428,110,187,57,63,11,45,14,7,0,0,7,7,0,0,0,0,7,7,0,0,31,31,2,0,29,0,0,0,0,0,0,0,0,0,42741
13736,6437,1508,2863,1220,437,409,403,217,192,24,38,130,25,25,25,0,0,0,0,0,0,186,166,41,26,99,20,20,0,0,20,0,0,0,0,42743
13737,1590,583,661,165,82,99,130,80,72,8,9,55,8,8,8,0,0,0,0,0,0,50,40,0,3,37,10,10,0,10,0,0,0,0,0,42746
13738,5830,1128,2690,1360,383,269,582,390,317,43,11,263,73,70,10,0,60,3,0,0,3,192,167,53,31,83,25,25,0,0,25,0,0,0,0,42748
13739,3399,927,1156,898,274,144,312,151,127,34,23,70,24,0,0,0,0,24,0,0,24,161,151,23,16,112,10,5,5,0,0,5,0,0,5,42749
13740,442,132,185,88,32,5,21,0,0,0,0,0,0,0,0,0,0,0,0,0,0,21,21,0,0,21,0,0,0,0,0,0,0,0,0,42753
13741,10236,2416,4007,2717,440,656,841,473,437,134,25,278,36,24,14,0,10,12,0,12,0,368,284,68,19,197,84,69,42,27,0,15,0,4,11,42754
13742,2024,410,887,509,111,107,145,59,59,0,22,37,0,0,0,0,0,0,0,0,0,86,65,7,12,46,21,21,21,0,0,0,0,0,0,42757
13743,70,34,21,0,15,0,0,0,0,0,0,0,0,0,0,0,0,0,0,0,0,0,0,0,0,0,0,0,0,0,0,0,0,0,0,42758
13744,379,120,221,33,5,0,13,0,0,0,0,0,0,0,0,0,0,0,0,0,0,13,13,13,0,0,0,0,0,0,0,0,0,0,0,42762
13745,348,145,124,67,12,0,7,0,0,0,0,0,0,0,0,0,0,0,0,0,0,7,7,0,0,7,0,0,0,0,0,0,0,0,0,42764
13746,3970,1231,1811,747,106,75,432,242,199,56,0,143,43,25,18,4,3,18,0,0,18,190,152,30,10,112,38,8,8,0,0,30,14,0,16,42765
13747,1517,309,644,472,65,27,215,112,93,69,0,24,19,1,0,0,1,18,2,0,16,103,87,40,0,47,16,2,2,0,0,14,14,0,0,42776
13748,732,178,370,131,19,34,100,31,0,0,0,0,31,22,22,0,0,9,0,9,0,69,47,7,0,40,22,22,22,0,0,0,0,0,0,42782
13749,1895,460,871,381,99,84,184,41,30,0,6,24,11,11,11,0,0,0,0,0,0,143,96,8,11,77,47,42,0,0,42,5,0,0,5,42784
13750,261,14,152,31,24,40,37,14,14,0,14,0,0,0,0,0,0,0,0,0,0,23,11,11,0,0,12,12,12,0,0,0,0,0,0,42788
13751,1691,142,487,657,238,167,86,35,35,17,2,16,0,0,0,0,0,0,0,0,0,51,45,20,0,25,6,6,6,0,0,0,0,0,0,43001
13752,1663,0,269,359,636,399,8,0,0,0,0,0,0,0,0,0,0,0,0,0,0,8,8,8,0,0,0,0,0,0,0,0,0,0,0,43002
13753,1788,164,983,366,159,116,120,41,29,0,0,29,12,0,0,0,0,12,12,0,0,79,63,10,12,41,16,0,0,0,0,16,0,0,16,43003
13754,15754,864,4057,4907,4029,1897,1010,629,621,125,56,440,8,0,0,0,0,8,0,8,0,381,381,208,0,173,0,0,0,0,0,0,0,0,0,43004
13755,127,11,114,2,0,0,23,23,23,0,0,23,0,0,0,0,0,0,0,0,0,0,0,0,0,0,0,0,0,0,0,0,0,0,0,43005
13756,391,212,91,72,7,9,14,4,3,0,0,3,1,1,1,0,0,0,0,0,0,10,0,0,0,0,10,0,0,0,0,10,0,0,10,43006
13757,1517,478,461,443,62,73,66,49,49,0,24,25,0,0,0,0,0,0,0,0,0,17,0,0,0,0,17,17,17,0,0,0,0,0,0,43008
13758,1397,132,444,611,149,61,150,123,123,0,0,123,0,0,0,0,0,0,0,0,0,27,0,0,0,0,27,27,27,0,0,0,0,0,0,43009
13759,202,13,111,74,4,0,16,5,4,1,0,3,1,1,1,0,0,0,0,0,0,11,9,1,4,4,2,2,0,2,0,0,0,0,0,43010
13760,4834,378,1865,1610,706,275,451,229,199,33,58,108,30,30,30,0,0,0,0,0,0,222,215,69,63,83,7,7,7,0,0,0,0,0,0,43011
13761,684,83,225,193,120,63,20,16,6,0,2,4,10,10,10,0,0,0,0,0,0,4,4,1,0,3,0,0,0,0,0,0,0,0,0,43013
13762,2245,294,1195,457,161,138,377,164,135,36,2,97,29,29,11,18,0,0,0,0,0,213,204,57,33,114,9,9,9,0,0,0,0,0,0,43014
13763,32023,2265,8635,9863,7270,3990,3308,1732,1444,251,116,1077,288,126,70,0,56,162,109,0,53,1576,1409,537,137,735,167,131,129,2,0,36,11,0,25,43015
13764,23280,512,3145,4502,9550,5571,1090,543,523,147,11,365,20,20,0,11,9,0,0,0,0,547,505,202,22,281,42,42,42,0,0,0,0,0,0,43016
13765,24791,503,2145,5554,10428,6161,2121,1153,1073,154,117,802,80,72,59,13,0,8,8,0,0,968,931,313,79,539,37,37,37,0,0,0,0,0,0,43017
13766,5780,778,2364,1625,620,393,450,122,55,23,7,25,67,30,30,0,0,37,37,0,0,328,245,62,4,179,83,39,28,0,11,44,0,0,44,43019
13767,7015,166,1482,1788,2516,1063,468,233,233,88,3,142,0,0,0,0,0,0,0,0,0,235,200,71,3,126,35,10,10,0,0,25,14,0,11,43021
13768,1953,162,651,369,476,295,930,396,396,100,25,271,0,0,0,0,0,0,0,0,0,534,526,185,36,305,8,0,0,0,0,8,0,0,8,43022
13769,7132,115,1516,1512,2113,1876,1765,840,840,285,41,514,0,0,0,0,0,0,0,0,0,925,925,307,50,568,0,0,0,0,0,0,0,0,0,43023
13770,4349,538,1839,1157,507,308,463,210,128,16,18,94,82,82,68,10,4,0,0,0,0,253,241,78,37,126,12,12,9,0,3,0,0,0,0,43025
13771,37053,1553,8235,10330,11298,5637,2808,1375,1183,410,109,664,192,169,110,52,7,23,6,0,17,1433,1181,464,90,627,252,220,112,68,40,32,12,0,20,43026
13772,5330,490,1736,1671,1026,407,179,68,41,0,0,41,27,0,0,0,0,27,13,0,14,111,70,30,0,40,41,13,0,13,0,28,0,0,28,43028
13773,263,23,74,75,57,34,59,40,40,0,0,40,0,0,0,0,0,0,0,0,0,19,19,10,0,9,0,0,0,0,0,0,0,0,0,43029
13774,148,28,120,0,0,0,32,0,0,0,0,0,0,0,0,0,0,0,0,0,0,32,32,32,0,0,0,0,0,0,0,0,0,0,0,43030
13775,8279,707,3227,2340,1457,548,537,261,246,101,16,129,15,15,0,0,15,0,0,0,0,276,228,40,51,137,48,48,48,0,0,0,0,0,0,43031
13776,75,0,53,22,0,0,0,0,0,0,0,0,0,0,0,0,0,0,0,0,0,0,0,0,0,0,0,0,0,0,0,0,0,0,0,43032
13777,290,24,165,72,27,2,50,35,24,18,0,6,11,6,6,0,0,5,0,5,0,15,12,0,0,12,3,1,1,0,0,2,2,0,0,43033
13778,15306,546,2239,3447,6014,3060,1368,730,699,278,18,403,31,31,15,8,8,0,0,0,0,638,623,206,0,417,15,15,15,0,0,0,0,0,0,43035
13779,190,39,85,42,24,0,25,22,22,4,0,18,0,0,0,0,0,0,0,0,0,3,3,3,0,0,0,0,0,0,0,0,0,0,0,43036
13780,277,32,123,80,42,0,21,8,0,0,0,0,8,8,8,0,0,0,0,0,0,13,6,0,3,3,7,7,0,7,0,0,0,0,0,43037
13781,21232,1918,7725,6092,3888,1609,1721,828,703,192,112,399,125,97,65,0,32,28,13,0,15,893,719,241,88,390,174,96,43,13,40,78,49,0,29,43040
13782,3535,412,1478,1018,375,252,224,139,100,16,8,76,39,37,26,0,11,2,2,0,0,85,85,46,0,39,0,0,0,0,0,0,0,0,0,43044
13783,1232,74,601,321,157,79,93,15,15,0,0,15,0,0,0,0,0,0,0,0,0,78,78,3,2,73,0,0,0,0,0,0,0,0,0,43045
13784,2438,220,1119,589,341,169,166,102,98,23,14,61,4,0,0,0,0,4,0,0,4,64,64,14,24,26,0,0,0,0,0,0,0,0,0,43046
13785,19086,2211,8442,4528,2322,1583,1764,859,771,147,100,524,88,75,24,9,42,13,5,0,8,905,770,169,109,492,135,105,65,31,9,30,0,0,30,43050
13786,13418,259,1456,2581,5225,3897,831,485,449,168,28,253,36,29,29,0,0,7,7,0,0,346,292,62,15,215,54,17,17,0,0,37,0,0,37,43054
13787,40487,5082,16894,12132,4592,1787,2986,1755,1464,503,134,827,291,206,113,73,20,85,5,40,40,1231,966,293,230,443,265,209,161,0,48,56,15,36,5,43055
13788,11734,1473,4772,3615,1314,560,759,348,335,57,14,264,13,13,13,0,0,0,0,0,0,411,355,25,19,311,56,56,40,16,0,0,0,0,0,43056
13789,1658,227,808,375,183,65,136,79,60,10,10,40,19,19,3,0,16,0,0,0,0,57,33,17,0,16,24,24,5,0,19,0,0,0,0,43060
13790,2805,130,916,875,617,267,128,51,41,0,2,39,10,10,10,0,0,0,0,0,0,77,62,12,2,48,15,15,15,0,0,0,0,0,0,43061
13791,18435,1487,6371,5385,3486,1706,1304,708,607,133,49,425,101,63,49,7,7,38,15,23,0,596,487,184,8,295,109,64,27,21,16,45,14,0,31,43062
13792,8551,616,2812,2273,1991,859,624,379,347,125,38,184,32,32,32,0,0,0,0,0,0,245,217,88,0,129,28,28,8,20,0,0,0,0,0,43064
13793,25279,536,3260,5646,10016,5821,1944,985,949,296,51,602,36,34,15,19,0,2,0,0,2,959,908,220,95,593,51,39,2,0,37,12,0,0,12,43065
13794,1018,45,529,242,100,102,66,66,66,7,0,59,0,0,0,0,0,0,0,0,0,0,0,0,0,0,0,0,0,0,0,0,0,0,0,43066
13795,837,81,378,246,132,0,37,19,19,19,0,0,0,0,0,0,0,0,0,0,0,18,18,8,0,10,0,0,0,0,0,0,0,0,0,43067
13796,33912,2577,10548,11638,6717,2432,2839,1466,1253,511,131,611,213,150,150,0,0,63,54,0,9,1373,1169,545,99,525,204,152,119,24,9,52,20,16,16,43068
13797,78,0,34,44,0,0,0,0,0,0,0,0,0,0,0,0,0,0,0,0,0,0,0,0,0,0,0,0,0,0,0,0,0,0,0,43070
13798,1586,292,934,306,35,19,185,55,33,2,0,31,22,3,3,0,0,19,0,0,19,130,130,1,0,129,0,0,0,0,0,0,0,0,0,43071
13799,4196,497,2016,889,551,243,382,270,263,103,25,135,7,7,0,4,3,0,0,0,0,112,81,30,14,37,31,31,31,0,0,0,0,0,0,43072
13800,8332,529,3049,2266,1758,730,601,329,225,40,30,155,104,104,62,0,42,0,0,0,0,272,250,101,52,97,22,22,0,17,5,0,0,0,0,43074
13801,6897,638,3169,1931,781,378,297,160,144,47,20,77,16,16,0,16,0,0,0,0,0,137,84,18,5,61,53,53,48,0,5,0,0,0,0,43076
13802,156,23,96,23,12,2,11,5,3,0,0,3,2,2,2,0,0,0,0,0,0,6,6,2,2,2,0,0,0,0,0,0,0,0,0,43077
13803,14111,1932,6419,3496,1611,653,1119,455,363,60,34,269,92,74,39,16,19,18,0,0,18,664,521,101,90,330,143,107,21,61,25,36,0,0,36,43078
13804,3783,470,1730,951,461,171,260,107,88,48,13,27,19,0,0,0,0,19,0,0,19,153,135,18,49,68,18,18,18,0,0,0,0,0,0,43080
13805,37528,1565,6795,10787,12321,6060,3222,1459,1339,448,126,765,120,120,65,47,8,0,0,0,0,1763,1663,668,88,907,100,85,85,0,0,15,0,0,15,43081
13806,20337,425,3314,4032,8389,4177,1827,1044,1034,360,47,627,10,10,0,10,0,0,0,0,0,783,679,265,66,348,104,83,0,0,83,21,0,0,21,43082
13807,538,99,279,132,22,6,76,39,38,20,0,18,1,1,0,0,1,0,0,0,0,37,37,21,4,12,0,0,0,0,0,0,0,0,0,43084
13808,16246,581,1956,3673,5775,4261,810,481,462,106,17,339,19,19,0,9,10,0,0,0,0,329,322,110,53,159,7,7,7,0,0,0,0,0,0,43085
13809,243,76,134,20,13,0,7,1,0,0,0,0,1,0,0,0,0,1,1,0,0,6,6,0,0,6,0,0,0,0,0,0,0,0,0,43101
13810,3003,293,1533,794,300,83,198,143,128,40,4,84,15,8,2,0,6,7,0,0,7,55,55,5,0,50,0,0,0,0,0,0,0,0,0,43102
13811,7196,1040,2747,1842,929,638,628,272,259,108,0,151,13,13,13,0,0,0,0,0,0,356,295,119,0,176,61,61,10,0,51,0,0,0,0,43103
13812,5568,411,2172,1767,814,404,446,216,169,48,0,121,47,47,11,27,9,0,0,0,0,230,230,35,40,155,0,0,0,0,0,0,0,0,0,43105
13813,976,221,430,270,49,6,99,59,52,11,12,29,7,7,7,0,0,0,0,0,0,40,38,7,1,30,2,2,0,0,2,0,0,0,0,43106
13814,2383,266,950,863,215,89,237,87,47,11,0,36,40,5,5,0,0,35,35,0,0,150,131,30,0,101,19,0,0,0,0,19,0,0,19,43107
13815,115,9,13,25,11,57,6,0,0,0,0,0,0,0,0,0,0,0,0,0,0,6,6,2,0,4,0,0,0,0,0,0,0,0,0,43109
13816,22071,1064,6183,8029,4459,2336,1747,935,887,294,28,565,48,48,48,0,0,0,0,0,0,812,739,239,4,496,73,73,52,21,0,0,0,0,0,43110
13817,75,15,50,0,0,10,0,0,0,0,0,0,0,0,0,0,0,0,0,0,0,0,0,0,0,0,0,0,0,0,0,0,0,0,0,43111
13818,3038,229,1302,906,390,211,247,162,121,48,6,67,41,41,0,41,0,0,0,0,0,85,83,39,10,34,2,2,0,0,2,0,0,0,0,43112
13819,16033,2159,7844,3585,1523,922,1512,696,576,126,77,373,120,113,30,30,53,7,0,0,7,816,771,360,57,354,45,45,14,12,19,0,0,0,0,43113
13820,907,175,429,157,86,60,64,14,14,0,1,13,0,0,0,0,0,0,0,0,0,50,43,9,6,28,7,7,0,7,0,0,0,0,0,43115
13821,750,40,198,322,111,79,42,37,21,3,8,10,16,16,16,0,0,0,0,0,0,5,5,2,0,3,0,0,0,0,0,0,0,0,0,43116
13822,0,0,0,0,0,0,0,0,0,0,0,0,0,0,0,0,0,0,0,0,0,0,0,0,0,0,0,0,0,0,0,0,0,0,0,43117
13823,17656,1791,6170,5019,3555,1121,1138,560,494,89,43,362,66,56,49,7,0,10,0,0,10,578,536,190,13,333,42,42,33,0,9,0,0,0,0,43119
13824,40055,3710,13498,13314,6665,2868,2902,1449,1130,266,68,796,319,220,108,16,96,99,0,0,99,1453,1252,379,216,657,201,183,82,25,76,18,7,0,11,43123
13825,8387,817,3224,2477,1218,651,544,270,228,8,97,123,42,36,15,21,0,6,0,0,6,274,251,175,0,76,23,23,8,9,6,0,0,0,0,43125
13826,260,28,139,65,23,5,10,3,1,0,0,1,2,0,0,0,0,2,2,0,0,7,3,0,0,3,4,4,4,0,0,0,0,0,0,43126
13827,67,8,43,9,0,7,8,0,0,0,0,0,0,0,0,0,0,0,0,0,0,8,8,0,0,8,0,0,0,0,0,0,0,0,0,43127
13828,1469,203,734,375,120,37,135,66,48,38,5,5,18,18,8,0,10,0,0,0,0,69,55,10,8,37,14,14,11,0,3,0,0,0,0,43128
13829,40675,5031,16321,11978,4914,2431,3111,1744,1461,423,313,725,283,187,71,48,68,96,35,10,51,1367,1037,419,47,571,330,305,209,76,20,25,19,0,6,43130
13830,2758,508,1413,563,211,63,184,79,76,18,25,33,3,3,3,0,0,0,0,0,0,105,75,25,17,33,30,30,0,30,0,0,0,0,0,43135
13831,373,24,153,104,64,28,53,0,0,0,0,0,0,0,0,0,0,0,0,0,0,53,53,53,0,0,0,0,0,0,0,0,0,0,0,43136
13832,1362,199,734,274,141,14,166,106,103,1,25,77,3,3,0,0,3,0,0,0,0,60,43,17,22,4,17,17,0,2,15,0,0,0,0,43137
13833,12921,1702,6021,3635,969,594,1034,477,425,116,24,285,52,33,16,17,0,19,12,0,7,557,475,170,75,230,82,58,27,31,0,24,0,0,24,43138
13834,17231,2875,6753,4928,1946,729,1082,595,468,65,17,386,127,83,51,32,0,44,0,0,44,487,418,121,57,240,69,69,16,22,31,0,0,0,0,43140
13835,91,22,32,37,0,0,14,3,2,2,0,0,1,1,0,1,0,0,0,0,0,11,11,8,3,0,0,0,0,0,0,0,0,0,0,43142
13836,3698,551,1531,1051,435,130,345,189,178,25,11,142,11,7,0,7,0,4,0,0,4,156,144,33,17,94,12,0,0,0,0,12,12,0,0,43143
13837,319,18,188,96,11,6,35,21,16,2,0,14,5,5,0,0,5,0,0,0,0,14,14,3,0,11,0,0,0,0,0,0,0,0,0,43144
13838,1110,150,557,282,85,36,50,29,29,3,4,22,0,0,0,0,0,0,0,0,0,21,14,3,2,9,7,7,7,0,0,0,0,0,0,43145
13839,9546,1692,3636,2851,1074,293,497,328,255,146,9,100,73,38,6,0,32,35,9,0,26,169,154,98,0,56,15,15,15,0,0,0,0,0,0,43146
13840,25340,728,5158,8080,7286,4088,2802,1554,1403,356,249,798,151,98,98,0,0,53,0,53,0,1248,1206,459,59,688,42,0,0,0,0,42,42,0,0,43147
13841,1346,171,565,446,143,21,105,38,25,12,5,8,13,9,9,0,0,4,0,3,1,67,54,34,2,18,13,6,6,0,0,7,4,0,3,43148
13842,2022,195,843,622,241,121,228,133,124,22,29,73,9,0,0,0,0,9,0,0,9,95,79,43,0,36,16,0,0,0,0,16,0,16,0,43149
13843,1656,243,503,540,281,89,206,117,99,0,20,79,18,16,16,0,0,2,0,0,2,89,89,18,33,38,0,0,0,0,0,0,0,0,0,43150
13844,155,13,74,57,10,1,13,10,10,0,0,10,0,0,0,0,0,0,0,0,0,3,3,0,0,3,0,0,0,0,0,0,0,0,0,43151
13845,560,122,263,111,28,36,26,13,13,0,0,13,0,0,0,0,0,0,0,0,0,13,13,0,0,13,0,0,0,0,0,0,0,0,0,43152
13846,638,69,320,166,45,38,67,50,44,6,4,34,6,2,0,0,2,4,0,0,4,17,15,6,4,5,2,2,0,2,0,0,0,0,0,43153
13847,2051,235,1011,426,256,123,65,47,44,11,0,33,3,3,0,3,0,0,0,0,0,18,18,3,0,15,0,0,0,0,0,0,0,0,0,43154
13848,1614,66,659,568,204,117,136,90,81,3,10,68,9,9,3,6,0,0,0,0,0,46,26,3,12,11,20,0,0,0,0,20,20,0,0,43155
13849,153,27,77,34,11,4,9,3,3,1,0,2,0,0,0,0,0,0,0,0,0,6,1,0,0,1,5,4,0,4,0,1,0,0,1,43156
13850,359,67,175,87,25,5,29,3,0,0,0,0,3,0,0,0,0,3,0,3,0,26,26,0,14,12,0,0,0,0,0,0,0,0,0,43157
13851,210,21,109,80,0,0,17,5,5,0,0,5,0,0,0,0,0,0,0,0,0,12,0,0,0,0,12,12,12,0,0,0,0,0,0,43158
13852,15271,2675,6825,3541,1456,774,1364,790,578,158,121,299,212,163,105,52,6,49,49,0,0,574,460,123,63,274,114,99,72,10,17,15,0,9,6,43160
13853,4861,557,2146,1436,507,215,460,241,235,77,16,142,6,6,6,0,0,0,0,0,0,219,212,115,28,69,7,7,0,7,0,0,0,0,0,43162
13854,1471,212,779,351,93,36,263,214,178,21,53,104,36,25,21,0,4,11,7,0,4,49,43,6,5,32,6,0,0,0,0,6,0,0,6,43164
13855,11061,912,1483,2628,3892,2146,2788,1635,1580,439,125,1016,55,39,16,13,10,16,0,16,0,1153,1117,492,79,546,36,28,11,8,9,8,0,0,8,43201
13856,12389,276,1065,3542,4517,2989,555,308,282,25,31,226,26,9,0,0,9,17,11,0,6,247,237,86,13,138,10,10,0,0,10,0,0,0,0,43202
13857,4266,718,1487,1349,537,175,508,222,140,0,67,73,82,27,0,4,23,55,0,37,18,286,269,19,65,185,17,7,0,0,7,10,10,0,0,43203
13858,26015,5195,8880,6588,3752,1600,1797,860,625,35,70,520,235,81,40,24,17,154,21,16,117,937,790,73,46,671,147,145,46,0,99,2,0,0,2,43204
13859,8250,1443,2567,2755,1005,480,644,332,195,10,45,140,137,87,47,7,33,50,0,33,17,312,262,26,65,171,50,17,0,0,17,33,12,0,21,43205
13860,16005,2382,4458,3750,3455,1960,842,339,257,0,45,212,82,33,16,8,9,49,8,27,14,503,412,64,79,269,91,41,20,21,0,50,13,28,9,43206
13861,31230,7200,13611,7825,1833,761,2508,1438,1130,237,174,719,308,177,86,52,39,131,70,37,24,1070,860,219,112,529,210,109,48,27,34,101,4,41,56,43207
13862,18176,1043,3265,4685,5168,4015,1821,829,757,214,29,514,72,66,58,8,0,6,6,0,0,992,964,403,77,484,28,18,18,0,0,10,10,0,0,43209
13863,447,48,5,45,160,189,8066,4007,4007,689,340,2978,0,0,0,0,0,0,0,0,0,4059,4059,1263,317,2479,0,0,0,0,0,0,0,0,0,43210
13864,12387,3183,4864,3567,552,221,1094,591,421,28,52,341,170,86,33,53,0,84,32,12,40,503,429,109,124,196,74,29,6,0,23,45,0,0,45,43211
13865,13280,274,1346,2960,4807,3893,389,306,289,13,31,245,17,17,8,0,9,0,0,0,0,83,79,23,0,56,4,4,0,0,4,0,0,0,0,43212
13866,21383,3657,7415,6416,2681,1214,1349,683,526,116,63,347,157,60,57,3,0,97,44,32,21,666,547,113,71,363,119,79,26,6,47,40,0,0,40,43213
13867,19767,857,2704,4660,6801,4745,711,367,336,166,56,114,31,15,7,8,0,16,15,0,1,344,323,154,39,130,21,21,9,0,12,0,0,0,0,43214
13868,9094,607,1144,2207,2931,2205,376,175,173,55,16,102,2,0,0,0,0,2,0,0,2,201,190,87,0,103,11,11,11,0,0,0,0,0,0,43215
13869,1260,159,559,449,86,7,159,82,46,8,8,30,36,26,24,2,0,10,0,10,0,77,75,0,1,74,2,2,2,0,0,0,0,0,0,43217
13870,17190,2966,5135,5693,2346,1050,1442,703,525,150,60,315,178,74,63,11,0,104,31,33,40,739,661,179,115,367,78,60,13,28,19,18,0,0,18,43219
13871,17850,617,2042,3803,6554,4834,856,422,422,126,13,283,0,0,0,0,0,0,0,0,0,434,421,155,34,232,13,6,6,0,0,7,7,0,0,43220
13872,22836,339,2626,4225,9134,6512,1502,734,699,141,0,558,35,26,0,0,26,9,9,0,0,768,709,200,83,426,59,52,42,10,0,7,0,0,7,43221
13873,2362,1045,483,520,249,65,316,208,90,12,0,78,118,9,9,0,0,109,0,84,25,108,18,0,0,18,90,0,0,0,0,90,0,87,3,43222
13874,16503,4503,6693,3904,1136,267,1183,599,395,55,77,263,204,97,4,16,77,107,0,7,100,584,482,87,75,320,102,44,22,0,22,58,0,11,47,43223
13875,24427,4813,9040,6682,2875,1017,2037,901,795,154,106,535,106,64,35,0,29,42,7,25,10,1136,925,161,49,715,211,111,58,47,6,100,34,7,59,43224
13876,14361,2509,5090,4836,1295,631,1264,744,669,75,157,437,75,31,17,0,14,44,0,0,44,520,388,74,66,248,132,109,60,44,5,23,14,0,9,43227
13877,32417,6444,10475,9333,4340,1825,2036,957,830,174,223,433,127,69,45,0,24,58,25,15,18,1079,668,226,85,357,411,322,178,14,130,89,25,48,16,43228
13878,31303,3926,9476,10288,5693,1920,1993,1038,814,123,74,617,224,111,68,36,7,113,112,0,1,955,868,260,120,488,87,65,51,14,0,22,12,0,10,43229
13879,35833,2041,7148,10063,10839,5742,2630,1420,1283,225,269,789,137,105,94,0,11,32,0,13,19,1210,1136,376,108,652,74,56,23,0,33,18,18,0,0,43230
13880,12680,953,3564,4385,2906,872,756,351,282,43,12,227,69,46,26,0,20,23,10,0,13,405,339,130,6,203,66,66,7,48,11,0,0,0,0,43231
13881,26459,3387,11022,8438,2511,1101,2309,1006,766,53,47,666,240,129,71,39,19,111,18,31,62,1303,1028,224,139,665,275,206,152,54,0,69,27,12,30,43232
13882,28967,1702,4413,7523,9329,6000,1763,781,681,164,30,487,100,74,61,0,13,26,0,0,26,982,937,417,43,477,45,41,22,0,19,4,4,0,0,43235
13883,2579,66,400,740,847,526,70,27,27,14,0,13,0,0,0,0,0,0,0,0,0,43,7,0,0,7,36,36,22,14,0,0,0,0,0,43240
13884,38351,5978,16287,11530,2605,1951,2613,1440,1187,264,50,873,253,201,101,21,79,52,0,12,40,1173,962,134,100,728,211,157,125,4,28,54,0,38,16,43302
13885,2343,353,1196,539,109,146,301,184,135,3,34,98,49,49,49,0,0,0,0,0,0,117,67,9,4,54,50,32,25,7,0,18,18,0,0,43310
13886,12880,1768,6196,2895,1184,837,1136,566,426,56,62,308,140,140,57,64,19,0,0,0,0,570,568,143,17,408,2,0,0,0,0,2,0,0,2,43311
13887,2169,159,1027,561,275,147,149,95,83,33,0,50,12,12,0,12,0,0,0,0,0,54,29,23,0,6,25,25,22,3,0,0,0,0,0,43314
13888,4945,587,2423,1296,443,196,557,263,201,22,39,140,62,56,28,18,10,6,2,0,4,294,248,43,21,184,46,46,41,0,5,0,0,0,0,43315
13889,4029,408,2075,1162,294,90,363,205,152,56,17,79,53,53,27,26,0,0,0,0,0,158,140,47,0,93,18,18,0,18,0,0,0,0,0,43316
13890,115,10,64,23,18,0,7,3,0,0,0,0,3,3,3,0,0,0,0,0,0,4,4,0,0,4,0,0,0,0,0,0,0,0,0,43317
13891,2465,574,1053,519,249,70,186,106,104,48,6,50,2,2,2,0,0,0,0,0,0,80,62,0,0,62,18,18,18,0,0,0,0,0,0,43318
13892,685,104,400,80,90,11,79,19,19,0,0,19,0,0,0,0,0,0,0,0,0,60,60,44,0,16,0,0,0,0,0,0,0,0,0,43319
13893,1094,160,575,260,27,72,145,96,77,1,0,76,19,19,10,9,0,0,0,0,0,49,47,15,0,32,2,2,0,2,0,0,0,0,0,43320
13894,162,18,79,57,8,0,7,2,2,0,0,2,0,0,0,0,0,0,0,0,0,5,3,0,2,1,2,0,0,0,0,2,0,0,2,43321
13895,254,45,130,59,13,7,37,24,13,3,0,10,11,9,7,0,2,2,0,0,2,13,12,9,0,3,1,1,0,1,0,0,0,0,0,43322
13896,480,43,186,195,47,9,32,4,4,0,0,4,0,0,0,0,0,0,0,0,0,28,28,0,17,11,0,0,0,0,0,0,0,0,0,43323
13897,1746,180,669,444,261,192,76,28,28,1,9,18,0,0,0,0,0,0,0,0,0,48,48,34,2,12,0,0,0,0,0,0,0,0,0,43324
13898,8977,1198,4816,2087,524,352,646,342,267,132,18,117,75,27,15,12,0,48,3,0,45,304,278,127,48,103,26,26,8,6,12,0,0,0,0,43326
13899,74,13,55,2,2,2,5,0,0,0,0,0,0,0,0,0,0,0,0,0,0,5,0,0,0,0,5,5,5,0,0,0,0,0,0,43330
13900,3580,616,2023,745,120,76,239,119,88,29,27,32,31,5,5,0,0,26,0,3,23,120,118,36,24,58,2,2,0,2,0,0,0,0,0,43331
13901,1205,132,572,403,43,55,86,55,34,5,14,15,21,2,0,2,0,19,0,0,19,31,28,3,0,25,3,3,3,0,0,0,0,0,0,43332
13902,625,39,272,146,112,56,0,0,0,0,0,0,0,0,0,0,0,0,0,0,0,0,0,0,0,0,0,0,0,0,0,0,0,0,0,43333
13903,4529,625,1953,1332,424,195,302,176,128,0,0,128,48,7,7,0,0,41,23,0,18,126,126,28,0,98,0,0,0,0,0,0,0,0,0,43334
13904,0,0,0,0,0,0,0,0,0,0,0,0,0,0,0,0,0,0,0,0,0,0,0,0,0,0,0,0,0,0,0,0,0,0,0,43336
13905,863,130,361,250,77,45,128,54,52,6,0,46,2,1,1,0,0,1,0,0,1,74,40,3,0,37,34,0,0,0,0,34,4,0,30,43337
13906,6906,757,2975,2070,774,330,410,243,196,37,30,129,47,40,9,0,31,7,0,0,7,167,134,51,27,56,33,33,33,0,0,0,0,0,0,43338
13907,1158,181,615,244,73,45,126,72,42,4,10,28,30,3,3,0,0,27,6,0,21,54,39,0,4,35,15,5,2,3,0,10,0,0,10,43340
13908,688,72,426,154,9,27,75,29,4,1,0,3,25,9,0,9,0,16,0,16,0,46,46,0,0,46,0,0,0,0,0,0,0,0,0,43341
13909,2092,178,916,628,204,166,205,135,81,16,8,57,54,0,0,0,0,54,3,51,0,70,65,12,0,53,5,0,0,0,0,5,0,1,4,43342
13910,785,114,381,206,79,5,205,135,90,33,0,57,45,45,5,40,0,0,0,0,0,70,64,0,0,64,6,6,6,0,0,0,0,0,0,43343
13911,3491,272,1830,1066,249,74,313,147,133,31,0,102,14,14,14,0,0,0,0,0,0,166,134,43,24,67,32,13,13,0,0,19,0,0,19,43344
13912,619,64,365,139,35,16,35,16,16,2,4,10,0,0,0,0,0,0,0,0,0,19,5,3,0,2,14,14,14,0,0,0,0,0,0,43345
13913,955,101,532,182,98,42,75,38,36,7,13,16,2,2,0,2,0,0,0,0,0,37,31,0,11,20,6,6,6,0,0,0,0,0,0,43347
13914,1308,253,635,297,55,68,121,97,79,2,10,67,18,0,0,0,0,18,9,0,9,24,24,13,0,11,0,0,0,0,0,0,0,0,0,43348
13915,7493,849,3844,1863,623,314,520,250,207,35,104,68,43,43,43,0,0,0,0,0,0,270,270,121,27,122,0,0,0,0,0,0,0,0,0,43351
13916,707,31,345,166,80,85,26,22,10,0,0,10,12,11,10,1,0,1,1,0,0,4,2,0,0,2,2,2,0,0,2,0,0,0,0,43356
13917,2962,220,1186,794,574,188,319,143,116,85,1,30,27,25,25,0,0,2,2,0,0,176,164,114,13,37,12,12,12,0,0,0,0,0,0,43357
13918,1916,173,1222,332,102,87,149,98,50,37,9,4,48,48,0,17,31,0,0,0,0,51,33,12,0,21,18,11,0,0,11,7,0,0,7,43358
13919,497,18,261,178,36,4,49,26,20,2,3,15,6,6,6,0,0,0,0,0,0,23,19,15,3,1,4,4,0,4,0,0,0,0,0,43359
13920,924,44,422,304,85,69,40,34,30,13,6,11,4,0,0,0,0,4,0,0,4,6,6,0,0,6,0,0,0,0,0,0,0,0,0,43360
13921,17862,1114,4797,4769,3596,3586,1587,825,762,272,57,433,63,63,0,35,28,0,0,0,0,762,664,201,113,350,98,98,43,7,48,0,0,0,0,43402
13922,21,0,0,15,0,6,4475,1799,1799,292,390,1117,0,0,0,0,0,0,0,0,0,2676,2676,509,585,1582,0,0,0,0,0,0,0,0,0,43403
13923,1134,146,515,314,153,6,109,31,25,0,0,25,6,4,0,4,0,2,0,0,2,78,75,13,8,54,3,3,3,0,0,0,0,0,0,43406
13924,531,110,127,187,92,15,86,6,6,6,0,0,0,0,0,0,0,0,0,0,0,80,79,42,2,35,1,1,0,1,0,0,0,0,0,43407
13925,176,20,118,32,4,2,37,32,30,5,0,25,2,2,0,2,0,0,0,0,0,5,5,2,0,3,0,0,0,0,0,0,0,0,0,43408
13926,7059,692,2697,2629,660,381,457,198,146,52,0,94,52,52,9,43,0,0,0,0,0,259,204,114,7,83,55,55,40,15,0,0,0,0,0,43410
13927,2947,149,1334,1031,352,81,277,126,126,12,0,114,0,0,0,0,0,0,0,0,0,151,151,27,8,116,0,0,0,0,0,0,0,0,0,43412
13928,950,263,361,225,65,36,71,38,33,13,10,10,5,5,5,0,0,0,0,0,0,33,24,8,0,16,9,9,0,5,4,0,0,0,0,43413
13929,2070,134,782,706,295,153,94,20,13,10,0,3,7,7,7,0,0,0,0,0,0,74,74,21,7,46,0,0,0,0,0,0,0,0,0,43416
13930,20919,2419,8646,6999,1776,1079,1636,892,714,245,144,325,178,109,80,23,6,69,23,11,35,744,638,214,92,332,106,80,35,36,9,26,0,0,26,43420
13931,3344,265,1189,1353,339,198,284,176,148,67,0,81,28,28,28,0,0,0,0,0,0,108,108,55,13,40,0,0,0,0,0,0,0,0,0,43430
13932,2949,372,1273,1064,137,103,272,89,67,11,17,39,22,22,7,6,9,0,0,0,0,183,171,26,18,127,12,12,5,7,0,0,0,0,0,43431
13933,956,45,560,113,186,52,49,0,0,0,0,0,0,0,0,0,0,0,0,0,0,49,49,21,0,28,0,0,0,0,0,0,0,0,0,43432
13934,44,0,44,0,0,0,16,16,0,0,0,0,16,16,0,0,16,0,0,0,0,0,0,0,0,0,0,0,0,0,0,0,0,0,0,43433
13935,144,46,51,41,6,0,13,3,3,2,0,1,0,0,0,0,0,0,0,0,0,10,10,1,0,9,0,0,0,0,0,0,0,0,0,43434
13936,877,101,401,310,42,23,51,40,40,2,0,38,0,0,0,0,0,0,0,0,0,11,11,6,3,2,0,0,0,0,0,0,0,0,0,43435
13937,288,50,153,55,21,9,31,12,10,6,0,4,2,0,0,0,0,2,0,0,2,19,18,1,10,7,1,1,1,0,0,0,0,0,0,43437
13938,177,10,65,69,29,4,0,0,0,0,0,0,0,0,0,0,0,0,0,0,0,0,0,0,0,0,0,0,0,0,0,0,0,0,0,43438
13939,86,38,48,0,0,0,0,0,0,0,0,0,0,0,0,0,0,0,0,0,0,0,0,0,0,0,0,0,0,0,0,0,0,0,0,43439
13940,4059,203,1595,1281,702,278,156,94,49,9,29,11,45,45,45,0,0,0,0,0,0,62,53,6,14,33,9,9,9,0,0,0,0,0,0,43440
13941,799,93,365,237,77,27,62,28,28,24,0,4,0,0,0,0,0,0,0,0,0,34,31,0,4,27,3,3,3,0,0,0,0,0,0,43442
13942,1183,78,365,516,148,76,90,44,38,12,3,23,6,6,0,4,2,0,0,0,0,46,46,12,10,24,0,0,0,0,0,0,0,0,0,43443
13943,746,53,326,250,70,47,32,25,12,0,12,0,13,13,13,0,0,0,0,0,0,7,7,0,0,7,0,0,0,0,0,0,0,0,0,43445
13944,120,3,48,29,18,22,4,2,2,0,0,2,0,0,0,0,0,0,0,0,0,2,2,0,0,2,0,0,0,0,0,0,0,0,0,43446
13945,2289,174,865,824,291,135,249,106,102,35,33,34,4,4,0,4,0,0,0,0,0,143,141,62,45,34,2,2,2,0,0,0,0,0,0,43447
13946,6196,551,2542,2035,739,329,532,301,206,71,0,135,95,44,28,0,16,51,0,23,28,231,147,45,30,72,84,66,44,0,22,18,0,0,18,43449
13947,2556,102,885,928,386,255,258,107,97,29,1,67,10,10,10,0,0,0,0,0,0,151,151,26,14,111,0,0,0,0,0,0,0,0,0,43450
13948,678,88,287,119,97,87,28,13,13,4,0,9,0,0,0,0,0,0,0,0,0,15,11,5,0,6,4,4,2,2,0,0,0,0,0,43451
13949,10023,1115,3558,3085,1452,813,593,256,233,38,15,180,23,12,0,12,0,11,0,0,11,337,279,75,33,171,58,58,58,0,0,0,0,0,0,43452
13950,448,18,67,158,141,64,4,1,1,0,0,1,0,0,0,0,0,0,0,0,0,3,3,0,0,3,0,0,0,0,0,0,0,0,0,43456
13951,874,82,538,197,18,39,91,34,34,3,0,31,0,0,0,0,0,0,0,0,0,57,56,10,6,40,1,0,0,0,0,1,1,0,0,43457
13952,223,45,93,75,8,2,10,9,5,2,3,0,4,4,0,0,4,0,0,0,0,1,0,0,0,0,1,1,0,0,1,0,0,0,0,43458
13953,4297,276,1308,1731,531,451,332,157,128,20,55,53,29,20,9,0,11,9,0,0,9,175,175,57,35,83,0,0,0,0,0,0,0,0,0,43460
13954,751,46,366,258,55,26,23,14,14,0,0,14,0,0,0,0,0,0,0,0,0,9,9,6,3,0,0,0,0,0,0,0,0,0,0,43462
13955,16,0,16,0,0,0,0,0,0,0,0,0,0,0,0,0,0,0,0,0,0,0,0,0,0,0,0,0,0,0,0,0,0,0,0,43463
13956,1089,54,529,451,10,45,43,20,20,0,11,9,0,0,0,0,0,0,0,0,0,23,9,9,0,0,14,14,14,0,0,0,0,0,0,43464
13957,3742,339,1770,1253,255,125,253,160,147,72,30,45,13,13,13,0,0,0,0,0,0,93,93,16,0,77,0,0,0,0,0,0,0,0,0,43465
13958,1406,99,690,464,109,44,84,30,23,10,9,4,7,0,0,0,0,7,0,0,7,54,54,26,4,24,0,0,0,0,0,0,0,0,0,43466
13959,60,3,22,19,16,0,5,4,4,4,0,0,0,0,0,0,0,0,0,0,0,1,1,0,0,1,0,0,0,0,0,0,0,0,0,43467
13960,327,62,198,55,12,0,22,0,0,0,0,0,0,0,0,0,0,0,0,0,0,22,0,0,0,0,22,0,0,0,0,22,0,0,22,43468
13961,2032,92,719,781,311,129,248,99,92,13,0,79,7,7,7,0,0,0,0,0,0,149,104,31,22,51,45,37,37,0,0,8,0,0,8,43469
13962,559,113,235,177,24,10,28,11,11,0,0,11,0,0,0,0,0,0,0,0,0,17,17,7,0,10,0,0,0,0,0,0,0,0,0,43501
13963,4436,600,1654,1172,549,461,452,115,107,42,5,60,8,8,0,8,0,0,0,0,0,337,300,104,28,168,37,30,30,0,0,7,0,0,7,43502
13964,1002,17,476,273,144,92,32,25,25,12,0,13,0,0,0,0,0,0,0,0,0,7,5,0,0,5,2,0,0,0,0,2,2,0,0,43504
13965,48,5,17,25,1,0,3,1,1,0,0,1,0,0,0,0,0,0,0,0,0,2,2,0,0,2,0,0,0,0,0,0,0,0,0,43505
13966,10046,961,4599,2868,1135,483,796,454,411,58,48,305,43,43,43,0,0,0,0,0,0,342,322,43,106,173,20,11,0,11,0,9,0,0,9,43506
13967,598,25,278,209,29,57,42,16,15,8,0,7,1,1,1,0,0,0,0,0,0,26,25,0,0,25,1,1,1,0,0,0,0,0,0,43511
13968,19184,2144,8056,5615,2155,1214,1747,1049,906,268,178,460,143,114,85,23,6,29,24,5,0,698,579,116,73,390,119,93,80,13,0,26,0,0,26,43512
13969,5423,441,2132,1974,549,327,438,213,205,8,52,145,8,6,3,3,0,2,0,2,0,225,220,18,15,187,5,5,0,0,5,0,0,0,0,43515
13970,1931,193,964,553,174,47,164,67,64,41,0,23,3,3,0,0,3,0,0,0,0,97,73,10,0,63,24,19,10,9,0,5,0,0,5,43516
13971,2652,196,1412,710,212,122,112,18,18,4,0,14,0,0,0,0,0,0,0,0,0,94,82,22,0,60,12,12,12,0,0,0,0,0,0,43517
13972,1895,209,977,488,154,67,131,70,60,16,0,44,10,0,0,0,0,10,10,0,0,61,31,0,6,25,30,0,0,0,0,30,19,0,11,43518
13973,67,0,37,22,8,0,0,0,0,0,0,0,0,0,0,0,0,0,0,0,0,0,0,0,0,0,0,0,0,0,0,0,0,0,0,43519
13974,2088,247,1044,598,115,84,127,76,71,13,0,58,5,5,0,5,0,0,0,0,0,51,51,13,14,24,0,0,0,0,0,0,0,0,0,43521
13975,2124,131,816,765,260,152,215,144,144,59,11,74,0,0,0,0,0,0,0,0,0,71,70,2,4,64,1,1,1,0,0,0,0,0,0,43522
13976,0,0,0,0,0,0,0,0,0,0,0,0,0,0,0,0,0,0,0,0,0,0,0,0,0,0,0,0,0,0,0,0,0,0,0,43523
13977,793,74,372,274,62,11,77,44,37,3,5,29,7,7,7,0,0,0,0,0,0,33,30,15,7,8,3,2,0,0,2,1,1,0,0,43524
13978,726,11,182,347,124,62,52,15,13,0,0,13,2,2,2,0,0,0,0,0,0,37,37,8,2,27,0,0,0,0,0,0,0,0,0,43525
13979,3529,571,1577,1036,218,127,437,200,178,58,16,104,22,22,8,14,0,0,0,0,0,237,195,39,0,156,42,30,18,0,12,12,12,0,0,43526
13980,1550,223,677,471,106,73,104,55,42,26,0,16,13,13,0,0,13,0,0,0,0,49,39,0,0,39,10,10,10,0,0,0,0,0,0,43527
13981,11008,950,3280,3295,2109,1374,717,420,329,52,9,268,91,58,0,51,7,33,0,16,17,297,246,22,44,180,51,51,4,31,16,0,0,0,0,43528
13982,167,48,85,33,1,0,18,10,6,0,6,0,4,4,3,1,0,0,0,0,0,8,2,0,0,2,6,4,4,0,0,2,2,0,0,43529
13983,134,0,89,19,0,26,0,0,0,0,0,0,0,0,0,0,0,0,0,0,0,0,0,0,0,0,0,0,0,0,0,0,0,0,0,43531
13984,2639,143,1270,978,203,45,227,160,134,44,10,80,26,26,26,0,0,0,0,0,0,67,63,38,0,25,4,4,0,4,0,0,0,0,0,43532
13985,937,134,492,211,94,6,150,72,68,15,13,40,4,0,0,0,0,4,0,4,0,78,55,23,0,32,23,2,2,0,0,21,0,0,21,43533
13986,1146,102,573,328,70,73,122,57,56,24,5,27,1,1,0,0,1,0,0,0,0,65,65,0,32,33,0,0,0,0,0,0,0,0,0,43534
13987,460,83,178,165,33,1,93,41,40,8,27,5,1,0,0,0,0,1,1,0,0,52,51,0,21,30,1,0,0,0,0,1,1,0,0,43535
13988,368,36,145,121,46,20,0,0,0,0,0,0,0,0,0,0,0,0,0,0,0,0,0,0,0,0,0,0,0,0,0,0,0,0,0,43536
13989,18518,1122,4607,5752,4506,2531,1364,839,820,266,157,397,19,15,15,0,0,4,0,0,4,525,498,184,18,296,27,15,8,7,0,12,12,0,0,43537
13990,1069,77,484,377,101,30,38,32,31,6,2,23,1,1,0,1,0,0,0,0,0,6,6,2,0,4,0,0,0,0,0,0,0,0,0,43540
13991,102,31,41,24,4,2,1,1,1,0,0,1,0,0,0,0,0,0,0,0,0,0,0,0,0,0,0,0,0,0,0,0,0,0,0,43541
13992,2694,107,790,920,424,453,187,47,33,16,0,17,14,14,14,0,0,0,0,0,0,140,140,44,0,96,0,0,0,0,0,0,0,0,0,43542
13993,5326,548,2718,1418,491,151,494,282,200,24,72,104,82,79,28,42,9,3,0,0,3,212,178,36,0,142,34,34,8,26,0,0,0,0,0,43543
13994,9870,926,4308,2953,1093,590,747,401,349,158,2,189,52,52,26,17,9,0,0,0,0,346,304,81,18,205,42,34,34,0,0,8,8,0,0,43545
13995,288,60,126,74,10,18,18,18,18,18,0,0,0,0,0,0,0,0,0,0,0,0,0,0,0,0,0,0,0,0,0,0,0,0,0,43547
13996,463,41,219,154,27,22,4,4,4,0,0,4,0,0,0,0,0,0,0,0,0,0,0,0,0,0,0,0,0,0,0,0,0,0,0,43548
13997,963,125,486,224,71,57,55,52,48,19,0,29,4,4,1,0,3,0,0,0,0,3,3,1,0,2,0,0,0,0,0,0,0,0,0,43549
13998,25237,1118,5934,7873,6237,4075,1730,796,666,232,97,337,130,130,110,20,0,0,0,0,0,934,901,387,93,421,33,33,33,0,0,0,0,0,0,43551
13999,144,8,64,55,17,0,6,6,6,0,0,6,0,0,0,0,0,0,0,0,0,0,0,0,0,0,0,0,0,0,0,0,0,0,0,43553
14000,1788,217,870,492,135,74,105,45,40,16,4,20,5,5,5,0,0,0,0,0,0,60,45,18,3,24,15,11,5,6,0,4,0,0,4,43554
14001,100,6,27,67,0,0,0,0,0,0,0,0,0,0,0,0,0,0,0,0,0,0,0,0,0,0,0,0,0,0,0,0,0,0,0,43555
14002,1316,136,652,276,205,47,55,22,12,3,0,9,10,10,10,0,0,0,0,0,0,33,20,2,2,16,13,13,13,0,0,0,0,0,0,43556
14003,2406,428,1008,744,170,56,136,103,38,19,2,17,65,20,0,2,18,45,0,0,45,33,23,21,0,2,10,0,0,0,0,10,0,10,0,43557
14004,9383,878,3876,3163,1062,404,755,385,354,80,48,226,31,31,21,10,0,0,0,0,0,370,278,62,16,200,92,14,14,0,0,78,71,0,7,43558
14005,21558,1152,4604,6778,5268,3756,1821,946,884,372,27,485,62,46,31,0,15,16,0,16,0,875,849,257,54,538,26,26,16,10,0,0,0,0,0,43560
14006,240,8,114,88,18,12,30,24,24,0,0,24,0,0,0,0,0,0,0,0,0,6,6,0,5,1,0,0,0,0,0,0,0,0,0,43565
14007,5508,263,1398,1990,1012,845,262,171,171,105,0,66,0,0,0,0,0,0,0,0,0,91,91,14,16,61,0,0,0,0,0,0,0,0,0,43566
14008,8458,1180,3447,2471,907,453,672,377,342,54,13,275,35,35,35,0,0,0,0,0,0,295,228,71,57,100,67,57,30,15,12,10,0,0,10,43567
14009,1917,188,777,684,167,101,126,72,65,3,25,37,7,4,0,0,4,3,0,0,3,54,43,0,8,35,11,11,5,0,6,0,0,0,0,43569
14010,2291,141,1221,701,138,90,207,82,78,22,10,46,4,4,4,0,0,0,0,0,0,125,116,40,13,63,9,0,0,0,0,9,0,9,0,43570
14011,4609,183,1311,1739,765,611,312,162,149,33,0,116,13,0,0,0,0,13,0,13,0,150,150,25,9,116,0,0,0,0,0,0,0,0,0,43571
14012,5049,1307,1557,1602,381,202,579,319,190,11,44,135,129,18,8,10,0,111,0,36,75,260,217,70,59,88,43,24,24,0,0,19,13,0,6,43604
14013,16453,4184,6891,4589,625,164,1833,928,655,64,90,501,273,126,69,49,8,147,27,61,59,905,721,94,117,510,184,100,56,15,29,84,25,24,35,43605
14014,14788,1444,2795,4756,3159,2634,2983,1438,1356,309,144,903,82,82,77,5,0,0,0,0,0,1545,1528,463,211,854,17,0,0,0,0,17,0,0,17,43606
14015,14340,2881,4798,4705,1316,640,1904,835,721,189,82,450,114,57,57,0,0,57,0,31,26,1069,966,279,200,487,103,68,14,54,0,35,0,20,15,43607
14016,10094,2912,3714,2706,470,292,1127,520,380,19,199,162,140,27,26,0,1,113,5,27,81,607,495,14,172,309,112,112,59,28,25,0,0,0,0,43608
14017,14661,3096,5887,4472,707,499,1460,663,594,90,161,343,69,20,12,8,0,49,33,0,16,797,524,172,139,213,273,108,43,50,15,165,39,105,21,43609
14018,3016,451,965,1073,294,233,288,134,121,29,22,70,13,13,0,13,0,0,0,0,0,154,132,46,68,18,22,21,0,0,21,1,0,0,1,43610
14019,13359,1818,5435,4822,956,328,785,396,286,58,46,182,110,7,1,6,0,103,10,73,20,389,319,161,30,128,70,42,32,0,10,28,0,10,18,43611
14020,19193,2352,7835,6445,1811,750,1554,908,763,250,105,408,145,105,105,0,0,40,0,35,5,646,496,157,55,284,150,129,35,42,52,21,0,16,5,43612
14021,20933,2038,6889,7824,3122,1060,1838,861,650,193,134,323,211,211,176,35,0,0,0,0,0,977,844,246,232,366,133,106,106,0,0,27,0,6,21,43613
14022,21018,1717,6315,6830,4115,2041,1245,613,458,134,68,256,155,121,84,20,17,34,26,0,8,632,593,267,56,270,39,10,0,0,10,29,13,16,0,43614
14023,25715,2755,7821,8434,4199,2506,1942,840,725,185,227,313,115,109,26,48,35,6,0,6,0,1102,926,329,123,474,176,85,85,0,0,91,30,11,50,43615
14024,14731,1658,5282,5079,1699,1013,1147,711,605,133,68,404,106,85,85,0,0,21,0,12,9,436,388,197,15,176,48,37,9,9,19,11,0,0,11,43616
14025,4926,278,1082,1285,1331,950,319,191,191,73,17,101,0,0,0,0,0,0,0,0,0,128,72,41,0,31,56,56,56,0,0,0,0,0,0,43617
14026,5277,503,2116,2021,486,151,347,138,138,12,12,114,0,0,0,0,0,0,0,0,0,209,178,82,23,73,31,31,0,31,0,0,0,0,0,43619
14027,4163,1095,959,1187,543,379,210,130,112,0,74,38,18,15,15,0,0,3,0,0,3,80,78,0,0,78,2,0,0,0,0,2,0,0,2,43620
14028,14930,1098,5063,4584,2322,1863,614,374,287,76,85,126,87,62,11,29,22,25,0,0,25,240,240,37,10,193,0,0,0,0,0,0,0,0,0,43623
14029,37999,5435,16534,10622,3239,2169,2591,1376,1249,303,98,848,127,98,38,52,8,29,0,12,17,1215,870,328,25,517,345,321,182,35,104,24,9,8,7,43701
14030,12,0,0,12,0,0,0,0,0,0,0,0,0,0,0,0,0,0,0,0,0,0,0,0,0,0,0,0,0,0,0,0,0,0,0,43711
14031,5169,584,2412,1311,573,289,249,184,184,0,0,184,0,0,0,0,0,0,0,0,0,65,65,0,0,65,0,0,0,0,0,0,0,0,0,43713
14032,1259,132,687,317,84,39,68,41,40,7,5,28,1,1,0,1,0,0,0,0,0,27,26,5,0,21,1,0,0,0,0,1,0,0,1,43716
14033,161,44,84,30,0,3,24,16,11,0,0,11,5,5,0,5,0,0,0,0,0,8,8,8,0,0,0,0,0,0,0,0,0,0,0,43717
14034,2578,378,1149,754,171,126,195,105,83,22,0,61,22,22,22,0,0,0,0,0,0,90,85,18,12,55,5,5,5,0,0,0,0,0,0,43718
14035,1738,160,681,622,217,58,129,43,43,9,0,34,0,0,0,0,0,0,0,0,0,86,66,22,2,42,20,20,13,7,0,0,0,0,0,43719
14036,826,128,391,199,77,31,34,16,0,0,0,0,16,16,7,9,0,0,0,0,0,18,18,0,1,17,0,0,0,0,0,0,0,0,0,43720
14037,34,17,17,0,0,0,0,0,0,0,0,0,0,0,0,0,0,0,0,0,0,0,0,0,0,0,0,0,0,0,0,0,0,0,0,43721
14038,258,52,141,65,0,0,22,22,15,0,8,7,7,7,0,7,0,0,0,0,0,0,0,0,0,0,0,0,0,0,0,0,0,0,0,43722
14039,3248,558,1463,958,173,96,264,112,59,20,29,10,53,53,11,32,10,0,0,0,0,152,146,87,0,59,6,0,0,0,0,6,0,0,6,43723
14040,7086,1578,3507,1364,345,292,265,173,135,23,0,112,38,19,17,0,2,19,0,0,19,92,87,4,16,67,5,1,1,0,0,4,0,4,0,43724
14041,14390,1920,5663,4414,1431,962,949,539,479,116,6,357,60,50,11,10,29,10,0,0,10,410,354,58,29,267,56,37,9,0,28,19,0,19,0,43725
14042,878,51,553,255,9,10,65,31,20,6,0,14,11,11,11,0,0,0,0,0,0,34,34,0,13,21,0,0,0,0,0,0,0,0,0,43727
14043,770,125,376,177,64,28,157,81,50,28,0,22,31,31,31,0,0,0,0,0,0,76,74,24,15,35,2,2,2,0,0,0,0,0,0,43728
14044,1526,263,805,365,37,56,213,129,92,20,12,60,37,37,32,5,0,0,0,0,0,84,82,4,21,57,2,2,2,0,0,0,0,0,0,43730
14045,3821,523,1948,1066,206,78,369,248,221,35,0,186,27,20,15,0,5,7,0,0,7,121,115,11,0,104,6,6,6,0,0,0,0,0,0,43731
14046,1378,162,689,319,160,48,73,23,22,0,2,20,1,0,0,0,0,1,0,1,0,50,50,20,0,30,0,0,0,0,0,0,0,0,0,43732
14047,149,18,131,0,0,0,115,115,11,0,0,11,104,104,0,104,0,0,0,0,0,0,0,0,0,0,0,0,0,0,0,0,0,0,0,43733
14048,849,62,311,317,99,60,64,4,4,0,0,4,0,0,0,0,0,0,0,0,0,60,46,0,0,46,14,14,14,0,0,0,0,0,0,43734
14049,207,24,143,33,0,7,28,13,13,0,0,13,0,0,0,0,0,0,0,0,0,15,15,0,0,15,0,0,0,0,0,0,0,0,0,43735
14050,37,8,16,13,0,0,2,0,0,0,0,0,0,0,0,0,0,0,0,0,0,2,2,0,0,2,0,0,0,0,0,0,0,0,0,43736
14051,90,16,49,21,2,2,7,0,0,0,0,0,0,0,0,0,0,0,0,0,0,7,2,2,0,0,5,0,0,0,0,5,0,0,5,43738
14052,1198,182,448,477,71,20,121,81,81,25,4,52,0,0,0,0,0,0,0,0,0,40,40,24,0,16,0,0,0,0,0,0,0,0,0,43739
14053,289,23,203,50,13,0,17,6,6,0,0,6,0,0,0,0,0,0,0,0,0,11,11,2,0,9,0,0,0,0,0,0,0,0,0,43740
14054,1209,95,494,442,133,45,57,25,16,0,0,16,9,9,9,0,0,0,0,0,0,32,23,9,0,14,9,0,0,0,0,9,0,0,9,43746
14055,628,153,248,213,13,1,132,36,34,25,0,9,2,2,0,2,0,0,0,0,0,96,30,6,0,24,66,0,0,0,0,66,0,0,66,43747
14056,1989,328,1015,549,53,44,134,74,67,23,0,44,7,7,7,0,0,0,0,0,0,60,55,10,0,45,5,5,5,0,0,0,0,0,0,43748
14057,1568,411,632,410,83,32,156,111,76,0,8,68,35,12,12,0,0,23,23,0,0,45,35,13,0,22,10,10,10,0,0,0,0,0,0,43749
14058,86,0,58,21,7,0,0,0,0,0,0,0,0,0,0,0,0,0,0,0,0,0,0,0,0,0,0,0,0,0,0,0,0,0,0,43750
14059,1083,138,466,342,85,52,67,59,16,0,0,16,43,43,30,13,0,0,0,0,0,8,7,0,2,5,1,1,0,0,1,0,0,0,0,43754
14060,1001,164,537,199,78,23,34,20,20,10,0,10,0,0,0,0,0,0,0,0,0,14,14,14,0,0,0,0,0,0,0,0,0,0,0,43755
14061,3892,612,1695,1134,245,206,220,81,67,35,0,32,14,14,7,7,0,0,0,0,0,139,114,39,17,58,25,15,0,13,2,10,0,4,6,43756
14062,2301,390,1049,632,148,82,220,131,128,23,17,88,3,0,0,0,0,3,3,0,0,89,67,3,0,64,22,22,5,17,0,0,0,0,0,43758
14063,27,0,12,12,3,0,7,0,0,0,0,0,0,0,0,0,0,0,0,0,0,7,7,0,7,0,0,0,0,0,0,0,0,0,0,43759
14064,1067,150,509,310,98,0,16,16,16,16,0,0,0,0,0,0,0,0,0,0,0,0,0,0,0,0,0,0,0,0,0,0,0,0,0,43760
14065,57,28,29,0,0,0,14,14,14,14,0,0,0,0,0,0,0,0,0,0,0,0,0,0,0,0,0,0,0,0,0,0,0,0,0,43761
14066,3107,274,1315,882,361,275,768,282,259,52,0,207,23,15,0,15,0,8,0,8,0,486,481,171,26,284,5,0,0,0,0,5,0,0,5,43762
14067,5279,902,2516,1362,296,203,462,229,229,14,27,188,0,0,0,0,0,0,0,0,0,233,147,39,0,108,86,24,24,0,0,62,0,0,62,43764
14068,1005,359,425,172,22,27,138,31,23,12,3,8,8,8,0,0,8,0,0,0,0,107,107,0,0,107,0,0,0,0,0,0,0,0,0,43766
14069,941,81,391,264,148,57,96,92,92,1,1,90,0,0,0,0,0,0,0,0,0,4,4,2,0,2,0,0,0,0,0,0,0,0,0,43767
14070,197,13,114,58,3,9,24,8,8,0,0,8,0,0,0,0,0,0,0,0,0,16,16,5,0,11,0,0,0,0,0,0,0,0,0,43768
14071,1252,203,625,340,46,38,152,62,44,3,0,41,18,18,0,0,18,0,0,0,0,90,81,5,10,66,9,9,0,9,0,0,0,0,0,43771
14072,1308,162,654,316,151,25,138,96,85,6,0,79,11,11,0,6,5,0,0,0,0,42,16,11,0,5,26,24,5,9,10,2,0,0,2,43772
14073,2012,371,976,528,126,11,169,71,54,16,0,38,17,5,5,0,0,12,0,0,12,98,61,10,4,47,37,15,13,2,0,22,0,0,22,43773
14074,2786,556,1462,624,90,54,356,258,199,100,3,96,59,20,15,0,5,39,0,39,0,98,84,21,12,51,14,14,0,0,14,0,0,0,0,43777
14075,1068,167,506,309,79,7,115,81,39,10,0,29,42,17,17,0,0,25,0,0,25,34,34,12,3,19,0,0,0,0,0,0,0,0,0,43778
14076,644,104,413,56,71,0,44,23,17,3,4,10,6,6,0,6,0,0,0,0,0,21,18,16,0,2,3,2,2,0,0,1,0,1,0,43779
14077,1181,139,593,312,107,30,88,41,28,0,2,26,13,0,0,0,0,13,7,6,0,47,38,9,0,29,9,0,0,0,0,9,9,0,0,43780
14078,491,85,262,131,11,2,29,17,15,0,0,15,2,2,0,2,0,0,0,0,0,12,12,0,0,12,0,0,0,0,0,0,0,0,0,43782
14079,3285,434,1499,991,287,74,238,80,60,16,0,44,20,0,0,0,0,20,0,0,20,158,156,33,26,97,2,2,2,0,0,0,0,0,0,43783
14080,21,5,11,2,3,0,5,5,2,0,0,2,3,3,0,1,2,0,0,0,0,0,0,0,0,0,0,0,0,0,0,0,0,0,0,43786
14081,1785,235,902,507,111,30,72,46,42,0,8,34,4,4,3,1,0,0,0,0,0,26,13,6,0,7,13,7,0,2,5,6,6,0,0,43787
14082,568,136,283,126,14,9,25,7,6,1,0,5,1,1,1,0,0,0,0,0,0,18,9,0,0,9,9,0,0,0,0,9,0,0,9,43788
14083,3700,561,1689,954,322,174,197,114,114,34,0,80,0,0,0,0,0,0,0,0,0,83,83,12,0,71,0,0,0,0,0,0,0,0,0,43793
14084,755,68,355,242,53,37,48,18,1,0,0,1,17,17,17,0,0,0,0,0,0,30,23,10,0,13,7,7,0,0,7,0,0,0,0,43802
14085,1887,1118,479,214,40,36,352,191,55,28,0,27,136,0,0,0,0,136,136,0,0,161,42,7,5,30,119,0,0,0,0,119,85,12,22,43804
14086,60,11,35,14,0,0,0,0,0,0,0,0,0,0,0,0,0,0,0,0,0,0,0,0,0,0,0,0,0,0,0,0,0,0,0,43805
14087,475,75,307,79,4,10,35,14,14,12,2,0,0,0,0,0,0,0,0,0,0,21,21,0,7,14,0,0,0,0,0,0,0,0,0,43811
14088,13571,1721,6638,3432,1176,604,1050,560,419,94,12,313,141,129,75,54,0,12,9,0,3,490,403,93,41,269,87,67,40,15,12,20,20,0,0,43812
14089,2733,208,1427,783,232,83,238,157,143,40,48,55,14,3,0,0,3,11,11,0,0,81,73,46,2,25,8,4,4,0,0,4,4,0,0,43821
14090,3548,590,1656,1039,215,48,308,176,99,0,5,94,77,64,15,11,38,13,0,0,13,132,85,20,53,12,47,23,19,0,4,24,0,5,19,43822
14091,2008,508,742,566,152,40,171,80,43,14,0,29,37,0,0,0,0,37,17,0,20,91,58,27,12,19,33,0,0,0,0,33,19,6,8,43824
14092,4009,313,1630,1192,621,253,380,202,192,120,0,72,10,10,10,0,0,0,0,0,0,178,151,28,0,123,27,27,27,0,0,0,0,0,0,43830
14093,5252,927,2679,1177,334,135,461,299,220,38,0,182,79,45,12,33,0,34,22,0,12,162,151,9,0,142,11,11,0,0,11,0,0,0,0,43832
14094,114,7,61,35,7,4,2,2,2,2,0,0,0,0,0,0,0,0,0,0,0,0,0,0,0,0,0,0,0,0,0,0,0,0,0,43836
14095,1299,173,753,219,91,63,118,63,61,21,4,36,2,2,0,2,0,0,0,0,0,55,55,3,0,52,0,0,0,0,0,0,0,0,0,43837
14096,842,142,405,183,88,24,29,13,11,8,0,3,2,2,2,0,0,0,0,0,0,16,15,15,0,0,1,1,1,0,0,0,0,0,0,43840
14097,137,30,44,63,0,0,0,0,0,0,0,0,0,0,0,0,0,0,0,0,0,0,0,0,0,0,0,0,0,0,0,0,0,0,0,43842
14098,900,198,389,185,82,46,136,46,38,0,0,38,8,0,0,0,0,8,8,0,0,90,59,0,0,59,31,16,0,16,0,15,15,0,0,43843
14099,2453,258,1328,566,235,66,185,145,108,8,10,90,37,16,16,0,0,21,0,11,10,40,40,6,0,34,0,0,0,0,0,0,0,0,0,43844
14100,3445,518,1555,915,304,153,189,46,46,4,6,36,0,0,0,0,0,0,0,0,0,143,106,14,14,78,37,5,0,0,5,32,0,0,32,43845
14101,1765,222,918,355,204,66,103,64,58,43,3,12,6,4,4,0,0,2,2,0,0,39,39,14,0,25,0,0,0,0,0,0,0,0,0,43901
14102,199,44,22,13,55,65,0,0,0,0,0,0,0,0,0,0,0,0,0,0,0,0,0,0,0,0,0,0,0,0,0,0,0,0,0,43902
14103,1638,325,835,356,84,38,71,58,29,0,0,29,29,29,0,2,27,0,0,0,0,13,13,0,0,13,0,0,0,0,0,0,0,0,0,43903
14104,128,56,44,28,0,0,0,0,0,0,0,0,0,0,0,0,0,0,0,0,0,0,0,0,0,0,0,0,0,0,0,0,0,0,0,43905
14105,6104,985,2665,1841,413,200,564,302,217,35,73,109,85,71,45,6,20,14,0,14,0,262,172,56,17,99,90,53,36,0,17,37,0,0,37,43906
14106,4397,643,1993,1311,316,134,251,144,102,5,2,95,42,23,13,0,10,19,19,0,0,107,105,20,19,66,2,2,2,0,0,0,0,0,0,43907
14107,1247,234,742,209,53,9,69,30,18,14,2,2,12,2,2,0,0,10,10,0,0,39,39,26,0,13,0,0,0,0,0,0,0,0,0,43908
14108,2591,232,1034,822,280,223,128,63,63,25,0,38,0,0,0,0,0,0,0,0,0,65,65,0,0,65,0,0,0,0,0,0,0,0,0,43910
14109,5227,726,2503,1370,504,124,243,153,128,35,0,93,25,19,0,0,19,6,0,0,6,90,86,33,21,32,4,4,4,0,0,0,0,0,0,43912
14110,1168,39,619,440,56,14,84,16,16,0,0,16,0,0,0,0,0,0,0,0,0,68,67,33,0,34,1,0,0,0,0,1,0,0,1,43913
14111,11,5,0,6,0,0,0,0,0,0,0,0,0,0,0,0,0,0,0,0,0,0,0,0,0,0,0,0,0,0,0,0,0,0,0,43914
14112,1130,133,648,310,30,9,65,23,17,3,0,14,6,6,6,0,0,0,0,0,0,42,37,0,1,36,5,5,5,0,0,0,0,0,0,43915
14113,2349,383,1101,574,158,133,166,61,26,10,2,14,35,35,35,0,0,0,0,0,0,105,44,31,0,13,61,11,0,11,0,50,29,13,8,43917
14114,16373,2597,7101,4925,841,909,1146,553,464,141,102,221,89,74,32,42,0,15,0,15,0,593,547,139,137,271,46,25,11,0,14,21,7,0,14,43920
14115,74,0,46,28,0,0,28,28,28,0,0,28,0,0,0,0,0,0,0,0,0,0,0,0,0,0,0,0,0,0,0,0,0,0,0,43925
14116,176,27,96,37,7,9,7,6,6,0,0,6,0,0,0,0,0,0,0,0,0,1,1,0,0,1,0,0,0,0,0,0,0,0,0,43926
14117,36,0,29,7,0,0,0,0,0,0,0,0,0,0,0,0,0,0,0,0,0,0,0,0,0,0,0,0,0,0,0,0,0,0,0,43927
14118,64,28,36,0,0,0,0,0,0,0,0,0,0,0,0,0,0,0,0,0,0,0,0,0,0,0,0,0,0,0,0,0,0,0,0,43928
14119,560,47,329,134,15,35,49,18,13,0,5,8,5,0,0,0,0,5,5,0,0,31,31,19,8,4,0,0,0,0,0,0,0,0,0,43930
14120,102,0,67,26,0,9,11,0,0,0,0,0,0,0,0,0,0,0,0,0,0,11,11,11,0,0,0,0,0,0,0,0,0,0,0,43931
14121,601,61,319,198,18,5,47,18,16,0,0,16,2,1,0,0,1,1,1,0,0,29,26,0,0,26,3,3,0,0,3,0,0,0,0,43932
14122,1598,132,944,489,14,19,142,40,40,0,11,29,0,0,0,0,0,0,0,0,0,102,102,58,0,44,0,0,0,0,0,0,0,0,0,43933
14123,213,22,79,112,0,0,0,0,0,0,0,0,0,0,0,0,0,0,0,0,0,0,0,0,0,0,0,0,0,0,0,0,0,0,0,43934
14124,6148,813,2481,2065,588,201,399,191,175,31,7,137,16,16,16,0,0,0,0,0,0,208,170,41,22,107,38,38,0,0,38,0,0,0,0,43935
14125,3853,368,2060,1072,188,165,368,206,194,9,13,172,12,12,0,7,5,0,0,0,0,162,162,35,1,126,0,0,0,0,0,0,0,0,0,43938
14126,374,32,157,145,21,19,30,13,13,0,0,13,0,0,0,0,0,0,0,0,0,17,12,5,0,7,5,0,0,0,0,5,5,0,0,43939
14127,322,85,121,85,22,9,30,0,0,0,0,0,0,0,0,0,0,0,0,0,0,30,30,0,0,30,0,0,0,0,0,0,0,0,0,43940
14128,1648,174,906,354,134,80,188,149,136,11,25,100,13,9,0,9,0,4,4,0,0,39,11,0,3,8,28,28,0,0,28,0,0,0,0,43942
14129,2380,255,1306,627,122,70,170,72,58,8,8,42,14,14,12,0,2,0,0,0,0,98,96,56,0,40,2,2,2,0,0,0,0,0,0,43943
14130,1992,165,987,661,130,49,34,9,9,3,0,6,0,0,0,0,0,0,0,0,0,25,25,2,0,23,0,0,0,0,0,0,0,0,0,43944
14131,2166,293,1203,446,163,61,108,37,26,10,3,13,11,11,0,10,1,0,0,0,0,71,68,15,13,40,3,3,3,0,0,0,0,0,0,43945
14132,1734,112,1056,380,95,91,106,41,41,0,6,35,0,0,0,0,0,0,0,0,0,65,62,12,0,50,3,0,0,0,0,3,3,0,0,43946
14133,3876,371,1756,1092,425,232,130,79,79,0,0,79,0,0,0,0,0,0,0,0,0,51,39,8,0,31,12,12,12,0,0,0,0,0,0,43947
14134,421,60,227,84,28,22,33,19,15,0,9,6,4,4,0,0,4,0,0,0,0,14,14,7,0,7,0,0,0,0,0,0,0,0,0,43948
14135,12389,1291,4823,3771,1545,959,846,459,393,56,0,337,66,37,8,0,29,29,0,0,29,387,365,36,57,272,22,21,20,0,1,1,0,0,1,43950
14136,177,60,70,35,12,0,14,14,14,14,0,0,0,0,0,0,0,0,0,0,0,0,0,0,0,0,0,0,0,0,0,0,0,0,0,43951
14137,11863,1549,4566,3712,1353,683,1503,643,609,92,46,471,34,28,5,16,7,6,0,0,6,860,805,244,56,505,55,51,3,14,34,4,0,0,4,43952
14138,8757,743,2955,3085,1275,699,388,153,144,20,30,94,9,9,9,0,0,0,0,0,0,235,140,27,31,82,95,38,0,0,38,57,0,35,22,43953
14139,188,18,98,61,11,0,11,1,1,0,0,1,0,0,0,0,0,0,0,0,0,10,10,3,0,7,0,0,0,0,0,0,0,0,0,43961
14140,71,9,34,13,11,4,1,0,0,0,0,0,0,0,0,0,0,0,0,0,0,1,1,0,0,1,0,0,0,0,0,0,0,0,0,43962
14141,990,77,401,371,92,49,75,34,22,10,6,6,12,9,0,1,8,3,0,3,0,41,31,18,0,13,10,0,0,0,0,10,0,0,10,43963
14142,6664,679,3086,2077,492,330,479,264,205,25,0,180,59,50,21,0,29,9,0,5,4,215,196,42,7,147,19,19,7,8,4,0,0,0,0,43964
14143,0,0,0,0,0,0,0,0,0,0,0,0,0,0,0,0,0,0,0,0,0,0,0,0,0,0,0,0,0,0,0,0,0,0,0,43967
14144,5058,836,2393,1391,296,142,442,292,177,40,0,137,115,75,0,13,62,40,40,0,0,150,144,35,37,72,6,0,0,0,0,6,0,0,6,43968
14145,0,0,0,0,0,0,0,0,0,0,0,0,0,0,0,0,0,0,0,0,0,0,0,0,0,0,0,0,0,0,0,0,0,0,0,43970
14146,865,86,406,236,125,12,45,14,14,6,0,8,0,0,0,0,0,0,0,0,0,31,21,10,0,11,10,6,0,0,6,4,0,0,4,43971
14147,106,21,19,57,0,9,28,28,28,0,28,0,0,0,0,0,0,0,0,0,0,0,0,0,0,0,0,0,0,0,0,0,0,0,0,43972
14148,1397,327,617,344,104,5,148,96,41,6,2,33,55,16,4,0,12,39,4,35,0,52,41,9,9,23,11,0,0,0,0,11,0,0,11,43973
14149,50,19,16,12,3,0,6,6,0,0,0,0,6,6,6,0,0,0,0,0,0,0,0,0,0,0,0,0,0,0,0,0,0,0,0,43974
14150,1252,140,648,303,104,57,118,49,49,0,0,49,0,0,0,0,0,0,0,0,0,69,61,37,0,24,8,8,8,0,0,0,0,0,0,43976
14151,1686,127,777,629,89,64,143,64,61,31,3,27,3,3,3,0,0,0,0,0,0,79,45,25,7,13,34,0,0,0,0,34,34,0,0,43977
14152,331,50,227,54,0,0,37,0,0,0,0,0,0,0,0,0,0,0,0,0,0,37,37,0,0,37,0,0,0,0,0,0,0,0,0,43983
14153,85,16,43,26,0,0,11,9,9,6,3,0,0,0,0,0,0,0,0,0,0,2,2,0,0,2,0,0,0,0,0,0,0,0,0,43985
14154,1374,281,616,373,58,46,136,50,31,4,0,27,19,7,0,0,7,12,0,0,12,86,64,19,0,45,22,12,2,9,1,10,0,10,0,43986
14155,1538,275,761,385,97,20,142,82,43,3,7,33,39,39,39,0,0,0,0,0,0,60,51,21,0,30,9,9,2,0,7,0,0,0,0,43988
14156,14104,1162,5158,4571,2067,1146,1154,557,515,164,79,272,42,42,32,10,0,0,0,0,0,597,479,196,71,212,118,104,94,0,10,14,14,0,0,44001
14157,3379,558,1656,733,310,122,340,148,141,45,9,87,7,7,0,7,0,0,0,0,0,192,148,114,14,20,44,31,12,7,12,13,0,13,0,44003
14158,23127,3521,10427,6355,1708,1116,1613,662,507,164,51,292,155,112,26,72,14,43,0,0,43,951,811,145,85,581,140,78,6,47,25,62,0,4,58,44004
14159,1185,62,520,391,136,76,92,58,52,14,32,6,6,0,0,0,0,6,0,0,6,34,34,0,0,34,0,0,0,0,0,0,0,0,0,44010
14160,14356,573,3031,3388,4343,3021,908,465,445,139,64,242,20,20,0,0,20,0,0,0,0,443,433,141,0,292,10,10,0,10,0,0,0,0,0,44011
14161,15489,511,3004,4215,4851,2908,1012,626,574,221,44,309,52,31,16,0,15,21,0,0,21,386,368,107,64,197,18,18,18,0,0,0,0,0,0,44012
14162,12576,1022,3345,4358,2526,1325,1784,783,758,267,121,370,25,25,0,25,0,0,0,0,0,1001,898,448,57,393,103,89,7,75,7,14,0,0,14,44017
14163,3858,568,1403,1179,526,182,394,215,121,92,0,29,94,31,18,6,7,63,31,0,32,179,123,57,23,43,56,35,32,0,3,21,8,0,13,44021
14164,11959,277,1330,2233,4566,3553,660,282,282,58,13,211,0,0,0,0,0,0,0,0,0,378,378,87,3,288,0,0,0,0,0,0,0,0,0,44022
14165,12090,210,2571,2553,4223,2533,1053,664,643,139,71,433,21,21,21,0,0,0,0,0,0,389,379,98,8,273,10,10,10,0,0,0,0,0,0,44023
14166,16216,954,4805,5555,2932,1970,1165,599,539,168,53,318,60,60,50,2,8,0,0,0,0,566,542,146,87,309,24,24,23,1,0,0,0,0,0,44024
14167,8080,447,1985,2320,2194,1134,692,326,297,94,28,175,29,29,0,0,29,0,0,0,0,366,318,106,0,212,48,48,16,0,32,0,0,0,0,44026
14168,6067,553,2310,2032,833,339,437,205,166,58,0,108,39,24,15,9,0,15,0,7,8,232,196,40,28,128,36,36,31,5,0,0,0,0,0,44028
14169,11700,1691,5708,3079,804,418,686,501,367,89,18,260,134,92,7,53,32,42,0,11,31,185,179,58,20,101,6,0,0,0,0,6,0,6,0,44030
14170,1035,232,545,214,12,32,92,54,54,0,17,37,0,0,0,0,0,0,0,0,0,38,38,0,0,38,0,0,0,0,0,0,0,0,0,44032
14171,43495,5206,16857,14741,4289,2402,3759,1877,1587,414,280,893,290,192,79,90,23,98,49,4,45,1882,1719,610,205,904,163,75,41,9,25,88,0,60,28,44035
14172,21814,1535,6938,7401,4043,1897,1102,747,716,223,74,419,31,14,14,0,0,17,0,0,17,355,327,159,29,139,28,12,0,0,12,16,0,16,0,44039
14173,2468,20,330,520,924,674,131,47,47,0,0,47,0,0,0,0,0,0,0,0,0,84,84,4,24,56,0,0,0,0,0,0,0,0,0,44040
14174,10360,1412,4574,2992,1018,364,797,456,329,52,75,202,127,101,80,12,9,26,0,0,26,341,282,113,37,132,59,58,40,0,18,1,0,0,1,44041
14175,11677,1811,4487,3926,1047,406,703,361,273,63,53,157,88,34,14,0,20,54,14,0,40,342,286,91,31,164,56,20,9,11,0,36,7,0,29,44044
14176,241,44,97,83,15,2,21,14,6,6,0,0,8,8,0,8,0,0,0,0,0,7,7,3,2,2,0,0,0,0,0,0,0,0,0,44045
14177,1576,230,581,476,239,50,123,41,9,0,0,9,32,0,0,0,0,32,32,0,0,82,53,35,9,9,29,0,0,0,0,29,17,0,12,44046
14178,6516,769,2849,1737,724,437,594,341,322,73,23,226,19,15,15,0,0,4,0,0,4,253,253,93,10,150,0,0,0,0,0,0,0,0,0,44047
14179,1986,372,786,601,137,90,229,70,50,0,28,22,20,20,20,0,0,0,0,0,0,159,149,40,0,109,10,0,0,0,0,10,0,10,0,44048
14180,191,12,97,62,20,0,6,2,2,0,0,2,0,0,0,0,0,0,0,0,0,4,4,1,0,3,0,0,0,0,0,0,0,0,0,44049
14181,4213,381,1666,1370,505,291,487,308,282,47,35,200,26,15,15,0,0,11,11,0,0,179,158,63,15,80,21,18,15,0,3,3,0,0,3,44050
14182,18832,3824,7153,5896,1199,760,1611,835,685,159,83,443,150,70,66,0,4,80,31,40,9,776,611,97,268,246,165,82,63,15,4,83,0,75,8,44052
14183,12622,1476,4589,4441,1434,682,911,407,324,139,7,178,83,24,24,0,0,59,29,0,30,504,438,100,27,311,66,51,37,14,0,15,0,0,15,44053
14184,8984,901,3526,2949,1099,509,401,226,210,130,0,80,16,15,0,15,0,1,1,0,0,175,162,58,0,104,13,13,13,0,0,0,0,0,0,44054
14185,12294,3041,4501,3761,743,248,1371,661,550,106,54,390,111,50,46,0,4,61,44,9,8,710,593,136,177,280,117,84,79,0,5,33,0,5,28,44055
14186,8354,336,2215,2512,2022,1269,556,378,345,97,59,189,33,32,0,32,0,1,0,0,1,178,178,45,20,113,0,0,0,0,0,0,0,0,0,44056
14187,13787,1829,5373,4268,1616,701,1197,643,573,187,52,334,70,70,21,49,0,0,0,0,0,554,487,114,25,348,67,45,0,19,26,22,0,0,22,44057
14188,44030,2731,13797,14849,8429,4224,3149,1582,1362,388,136,838,220,166,113,53,0,54,29,0,25,1567,1493,488,101,904,74,73,56,15,2,1,0,0,1,44060
14189,7644,3155,2406,1263,630,190,1033,549,112,21,15,76,437,52,22,21,9,385,309,40,36,484,184,50,36,98,300,22,22,0,0,278,141,0,137,44062
14190,1178,151,368,501,134,24,107,51,49,25,7,17,2,2,2,0,0,0,0,0,0,56,56,3,22,31,0,0,0,0,0,0,0,0,0,44064
14191,3139,206,1200,934,465,334,526,256,188,107,0,81,68,68,0,0,68,0,0,0,0,270,270,100,18,152,0,0,0,0,0,0,0,0,0,44065
14192,15295,1076,4456,4357,3412,1994,851,445,429,136,63,230,16,14,0,0,14,2,0,0,2,406,406,111,28,267,0,0,0,0,0,0,0,0,0,44067
14193,24366,1767,6425,8687,5082,2405,1413,756,705,202,107,396,51,41,33,0,8,10,0,0,10,657,613,292,82,239,44,38,38,0,0,6,0,0,6,44070
14194,3142,131,559,968,798,686,114,76,76,26,0,50,0,0,0,0,0,0,0,0,0,38,38,0,0,38,0,0,0,0,0,0,0,0,0,44072
14195,6459,427,1951,1946,916,1219,1778,897,874,372,60,442,23,11,7,4,0,12,12,0,0,881,864,242,40,582,17,0,0,0,0,17,9,8,0,44074
14196,2690,563,1072,871,154,30,250,106,94,5,2,87,12,0,0,0,0,12,0,12,0,144,123,4,2,117,21,21,21,0,0,0,0,0,0,44076
14197,37400,4192,12643,11256,6154,3155,3122,1528,1323,467,110,746,205,139,94,16,29,66,11,8,47,1594,1274,601,161,512,320,272,86,51,135,48,32,0,16,44077
14198,109,0,0,30,61,18,0,0,0,0,0,0,0,0,0,0,0,0,0,0,0,0,0,0,0,0,0,0,0,0,0,0,0,0,0,44080
14199,4606,383,1953,1376,578,316,290,206,171,67,2,102,35,14,14,0,0,21,16,0,5,84,71,28,3,40,13,13,3,0,10,0,0,0,0,44081
14200,957,243,472,189,53,0,82,21,10,0,10,0,11,0,0,0,0,11,0,11,0,61,11,0,0,11,50,50,0,0,50,0,0,0,0,44082
14201,2605,309,1034,765,350,147,173,94,78,23,16,39,16,16,13,3,0,0,0,0,0,79,65,22,12,31,14,11,11,0,0,3,0,0,3,44084
14202,2389,246,1069,679,316,79,111,34,34,17,0,17,0,0,0,0,0,0,0,0,0,77,15,10,0,5,62,62,62,0,0,0,0,0,0,44085
14203,1590,140,668,542,179,61,103,66,43,0,23,20,23,23,16,0,7,0,0,0,0,37,37,0,32,5,0,0,0,0,0,0,0,0,0,44086
14204,13762,950,3679,3286,3837,2010,1119,677,594,173,36,385,83,82,25,57,0,1,0,0,1,442,404,161,0,243,38,38,0,20,18,0,0,0,0,44087
14205,11841,1228,4779,3710,1143,981,855,415,287,24,18,245,128,128,100,28,0,0,0,0,0,440,422,243,60,119,18,9,9,0,0,9,9,0,0,44089
14206,7809,741,3214,2761,577,516,510,221,210,53,70,87,11,5,0,5,0,6,6,0,0,289,201,104,0,97,88,82,32,48,2,6,6,0,0,44090
14207,12109,937,4446,3982,1967,777,713,409,369,67,52,250,40,32,32,0,0,8,0,7,1,304,275,107,51,117,29,13,13,0,0,16,16,0,0,44092
14208,689,66,320,274,29,0,50,14,0,0,0,0,14,14,14,0,0,0,0,0,0,36,36,0,0,36,0,0,0,0,0,0,0,0,0,44093
14209,25616,1592,8015,7965,5198,2846,1737,992,847,375,86,386,145,144,140,0,4,1,0,0,1,745,689,322,36,331,56,47,47,0,0,9,9,0,0,44094
14210,24499,2595,9444,8077,2996,1387,1548,696,629,278,66,285,67,32,17,10,5,35,9,0,26,852,754,328,71,355,98,71,71,0,0,27,12,0,15,44095
14211,1044,199,445,270,113,17,120,70,54,54,0,0,16,0,0,0,0,16,16,0,0,50,33,19,0,14,17,17,0,0,17,0,0,0,0,44099
14212,263,53,82,110,14,4,295,68,68,0,0,68,0,0,0,0,0,0,0,0,0,227,165,0,0,165,62,54,0,0,54,8,0,0,8,44101
14213,28447,7716,8980,7595,2689,1467,2713,1318,979,82,130,767,339,180,104,10,66,159,49,17,93,1395,1019,177,212,630,376,184,53,0,131,192,72,14,106,44102
14214,11817,3705,3708,3583,507,314,1070,528,398,79,49,270,130,72,27,45,0,58,38,9,11,542,421,66,129,226,121,56,28,6,22,65,38,0,27,44103
14215,12668,3708,4552,3720,470,218,1431,775,660,61,212,387,115,13,0,13,0,102,39,35,28,656,467,43,90,334,189,32,0,25,7,157,38,74,45,44104
14216,24421,6343,8855,6982,1706,535,2133,994,795,94,232,469,199,115,32,45,38,84,12,32,40,1139,1009,90,281,638,130,87,57,8,22,43,7,5,31,44105
14217,15156,2555,3565,3171,2593,3272,2731,1355,1280,318,130,832,75,15,0,15,0,60,19,15,26,1376,1273,501,143,629,103,54,14,40,0,49,23,26,0,44106
14218,36774,2893,8286,10663,9813,5119,1953,890,714,198,43,473,176,114,74,8,32,62,51,0,11,1063,872,299,88,485,191,94,45,25,24,97,3,41,53,44107
14219,15854,3406,5378,5326,1007,737,1868,868,627,95,142,390,241,99,35,62,2,142,34,53,55,1000,782,63,89,630,218,147,37,62,48,71,0,5,66,44108
14220,27272,6505,10065,7674,2198,830,1955,1002,760,98,149,513,242,112,70,23,19,130,30,45,55,953,793,276,95,422,160,92,30,34,28,68,8,0,60,44109
14221,13577,2753,5005,4649,725,445,1468,628,494,129,79,286,134,58,0,45,13,76,24,10,42,840,627,142,70,415,213,104,30,23,51,109,13,25,71,44110
14222,27906,4990,8647,8033,4046,2190,1758,832,597,108,124,365,235,188,170,0,18,47,8,12,27,926,804,303,84,417,122,28,28,0,0,94,16,10,68,44111
14223,15323,3005,5827,4797,995,699,1122,619,425,48,52,325,194,59,9,0,50,135,6,27,102,503,378,60,65,253,125,80,12,48,20,45,15,0,30,44112
14224,13624,3025,2896,2993,2637,2073,992,643,398,54,44,300,245,79,7,0,72,166,7,11,148,349,278,38,25,215,71,13,0,0,13,58,0,9,49,44113
14225,3937,819,832,702,591,993,179,99,99,0,57,42,0,0,0,0,0,0,0,0,0,80,55,0,0,55,25,20,0,12,8,5,0,0,5,44114
14226,3387,802,1007,909,345,324,829,405,357,85,46,226,48,8,0,0,8,40,0,29,11,424,327,75,134,118,97,46,8,23,15,51,13,23,15,44115
14227,14757,791,2544,3288,5056,3078,1079,500,457,145,18,294,43,34,0,34,0,9,0,0,9,579,579,220,73,286,0,0,0,0,0,0,0,0,0,44116
14228,7515,1328,2375,2568,809,435,720,454,403,60,84,259,51,13,0,0,13,38,0,0,38,266,238,4,49,185,28,27,16,11,0,1,0,0,1,44117
14229,25752,1458,3844,6465,6792,7193,2996,1438,1335,292,84,959,103,65,28,26,11,38,9,0,29,1558,1432,389,116,927,126,114,71,19,24,12,7,0,5,44118
14230,8721,1101,2601,3140,1007,872,879,426,409,33,67,309,17,1,0,0,1,16,0,0,16,453,235,28,33,174,218,116,0,23,93,102,17,21,64,44119
14231,24374,3402,6143,6409,3841,4579,1867,854,786,72,104,610,68,46,32,14,0,22,0,0,22,1013,825,51,55,719,188,108,37,11,60,80,7,36,37,44120
14232,22033,1474,5192,7178,4646,3543,2443,1380,1073,211,145,717,307,216,89,39,88,91,0,0,91,1063,998,311,131,556,65,7,7,0,0,58,0,0,58,44121
14233,24885,1715,3552,5998,6224,7396,1755,867,752,169,44,539,115,47,19,11,17,68,15,10,43,888,845,152,57,636,43,43,20,15,8,0,0,0,0,44122
14234,11623,1118,3946,4159,1643,757,959,629,460,82,0,378,169,142,79,27,36,27,0,0,27,330,282,73,24,185,48,48,27,0,21,0,0,0,0,44123
14235,28000,1974,5993,7240,7450,5343,1524,808,768,157,67,544,40,32,32,0,0,8,0,0,8,716,653,284,59,310,63,29,29,0,0,34,0,0,34,44124
14236,19483,2437,8244,5854,1911,1037,1603,742,599,140,54,405,143,72,56,11,5,71,11,36,24,861,786,268,99,419,75,75,3,72,0,0,0,0,0,44125
14237,11817,591,3083,3684,2881,1578,687,409,375,117,21,237,34,23,11,12,0,11,0,0,11,278,229,125,20,84,49,37,8,0,29,12,12,0,0,44126
14238,2885,868,1029,651,197,140,300,193,167,27,0,140,26,26,17,9,0,0,0,0,0,107,74,14,14,46,33,0,0,0,0,33,21,12,0,44127
14239,19996,3421,6347,7728,1668,832,2037,1235,1023,270,129,624,212,136,100,9,27,76,21,14,41,802,678,129,106,443,124,92,1,78,13,32,3,0,29,44128
14240,19849,2351,6961,6311,2906,1320,1559,700,525,142,88,295,175,50,50,0,0,125,57,58,10,859,733,370,118,245,126,94,84,0,10,32,12,11,9,44129
14241,36848,3718,12691,11532,5938,2969,1940,1020,862,344,97,421,158,104,37,13,54,54,30,18,6,920,760,288,100,372,160,118,48,41,29,42,0,0,42,44130
14242,15152,1371,4697,4048,3279,1757,788,477,431,113,36,282,46,36,33,3,0,10,0,7,3,311,311,61,101,149,0,0,0,0,0,0,0,0,0,44131
14243,9148,902,3064,3327,1256,599,838,370,250,23,36,191,120,88,0,76,12,32,7,11,14,468,386,83,18,285,82,38,8,9,21,44,0,0,44,44132
14244,22189,1262,6708,6584,4627,3008,1563,769,699,169,44,486,70,60,27,12,21,10,0,10,0,794,695,320,113,262,99,86,86,0,0,13,0,13,0,44133
14245,27295,2881,10494,8944,3355,1621,2373,1386,1235,428,84,723,151,78,28,16,34,73,42,13,18,987,836,381,104,351,151,130,77,32,21,21,0,0,21,44134
14246,19379,3534,7248,5991,1769,837,1411,829,623,239,85,299,206,112,55,38,19,94,8,40,46,582,535,90,216,229,47,20,20,0,0,27,19,0,8,44135
14247,18188,1160,4523,4868,4808,2829,1287,609,577,97,175,305,32,31,8,13,10,1,0,0,1,678,675,339,63,273,3,0,0,0,0,3,0,0,3,44136
14248,15645,1882,6249,5332,1532,650,1485,468,460,84,59,317,8,0,0,0,0,8,0,0,8,1017,822,96,186,540,195,115,55,35,25,80,10,62,8,44137
14249,15397,971,4170,4952,3309,1995,897,384,365,132,56,177,19,13,13,0,0,6,0,0,6,513,454,227,25,202,59,45,39,6,0,14,0,0,14,44138
14250,16335,673,2587,3929,4744,4402,1367,886,827,176,33,618,59,36,17,19,0,23,0,0,23,481,481,198,5,278,0,0,0,0,0,0,0,0,0,44139
14251,10949,212,1693,2887,3763,2394,676,318,281,51,20,210,37,32,0,12,20,5,0,0,5,358,343,118,20,205,15,15,7,8,0,0,0,0,0,44140
14252,10086,558,1650,2729,2853,2296,717,437,417,102,44,271,20,20,20,0,0,0,0,0,0,280,267,138,0,129,13,13,13,0,0,0,0,0,0,44141
14253,13401,1966,5755,4162,1137,381,933,545,497,240,66,191,48,29,19,0,10,19,0,0,19,388,363,103,17,243,25,25,25,0,0,0,0,0,0,44142
14254,17770,1312,4020,4431,4747,3260,1319,674,610,112,154,344,64,56,18,37,1,8,8,0,0,645,571,192,28,351,74,62,47,15,0,12,0,0,12,44143
14255,15589,2395,6100,4435,1976,683,899,372,309,76,0,233,63,48,0,47,1,15,15,0,0,527,451,70,104,277,76,76,57,0,19,0,0,0,0,44144
14256,23812,1159,4398,5774,7499,4982,1559,866,811,262,36,513,55,38,38,0,0,17,0,17,0,693,652,245,74,333,41,41,41,0,0,0,0,0,0,44145
14257,21566,2631,7734,7080,2712,1409,1344,712,618,179,50,389,94,78,49,10,19,16,0,0,16,632,587,224,83,280,45,45,41,4,0,0,0,0,0,44146
14258,13447,737,3211,3583,3358,2558,1170,625,618,152,66,400,7,0,0,0,0,7,7,0,0,545,545,221,29,295,0,0,0,0,0,0,0,0,0,44147
14259,13441,581,3184,3703,3716,2257,762,479,470,178,38,254,9,9,9,0,0,0,0,0,0,283,275,110,0,165,8,8,8,0,0,0,0,0,0,44149
14260,4683,372,2098,1540,531,142,385,146,86,44,0,42,60,30,30,0,0,30,10,20,0,239,219,141,0,78,20,20,10,10,0,0,0,0,0,44201
14261,13576,592,3127,3729,3695,2433,925,393,358,164,69,125,35,35,14,13,8,0,0,0,0,532,507,235,16,256,25,25,25,0,0,0,0,0,0,44202
14262,28807,3502,13290,7682,3249,1084,2253,1116,888,215,48,625,228,188,135,27,26,40,0,40,0,1137,1056,390,55,611,81,49,26,9,14,32,8,14,10,44203
14263,29893,2235,10717,10087,4875,1979,2473,1173,976,379,181,416,197,174,158,9,7,23,0,0,23,1300,1104,521,92,491,196,189,114,34,41,7,7,0,0,44212
14264,1387,114,682,284,171,136,53,19,12,0,1,11,7,0,0,0,0,7,7,0,0,34,12,0,10,2,22,22,16,0,6,0,0,0,0,44214
14265,1616,195,673,516,142,90,88,46,28,18,0,10,18,13,13,0,0,5,0,0,5,42,33,6,3,24,9,9,9,0,0,0,0,0,0,44215
14266,6702,599,2562,1954,1072,515,683,353,273,72,56,145,80,67,47,20,0,13,13,0,0,330,300,82,54,164,30,30,30,0,0,0,0,0,0,44216
14267,2655,402,1326,650,208,69,224,92,92,27,3,62,0,0,0,0,0,0,0,0,0,132,113,68,13,32,19,19,7,0,12,0,0,0,0,44217
14268,21199,1443,7851,6457,3855,1593,1134,601,497,104,44,349,104,103,27,65,11,1,0,0,1,533,408,184,54,170,125,115,101,14,0,10,0,10,0,44221
14269,13165,794,3697,3559,3383,1732,931,489,431,159,62,210,58,58,58,0,0,0,0,0,0,442,406,40,27,339,36,35,35,0,0,1,0,0,1,44223
14270,26397,1504,6666,7356,7201,3670,1872,937,857,233,82,542,80,80,42,16,22,0,0,0,0,935,860,327,68,465,75,37,37,0,0,38,0,10,28,44224
14271,6051,492,2985,1267,884,423,316,197,137,52,32,53,60,60,60,0,0,0,0,0,0,119,119,8,6,105,0,0,0,0,0,0,0,0,0,44230
14272,5651,859,2589,1190,674,339,579,306,249,70,16,163,57,45,24,13,8,12,0,0,12,273,103,27,24,52,170,160,160,0,0,10,10,0,0,44231
14273,5400,162,1453,1727,1283,775,344,167,167,40,1,126,0,0,0,0,0,0,0,0,0,177,167,73,21,73,10,10,10,0,0,0,0,0,0,44233
14274,2487,264,687,783,459,294,653,304,274,75,49,150,30,21,11,10,0,9,9,0,0,349,345,164,18,163,4,4,4,0,0,0,0,0,0,44234
14275,1185,276,411,367,91,40,88,35,26,0,0,26,9,9,0,9,0,0,0,0,0,53,29,0,0,29,24,8,8,0,0,16,0,0,16,44235
14276,16792,301,2047,3466,6510,4468,1416,722,695,181,69,445,27,22,22,0,0,5,0,0,5,694,641,138,14,489,53,32,32,0,0,21,0,11,10,44236
14277,22849,1584,6118,6358,5214,3575,2823,1450,1233,340,245,648,217,144,121,0,23,73,0,58,15,1373,1268,589,147,532,105,44,44,0,0,61,0,0,61,44240
14278,10879,856,4258,3238,1758,769,829,492,425,243,55,127,67,53,53,0,0,14,0,14,0,337,278,136,0,142,59,22,22,0,0,37,0,0,37,44241
14279,76,0,9,8,11,48,3120,1073,1073,281,220,572,0,0,0,0,0,0,0,0,0,2047,2047,599,381,1067,0,0,0,0,0,0,0,0,0,44243
14280,779,165,374,190,17,33,128,64,42,42,0,0,22,0,0,0,0,22,0,15,7,64,64,33,9,22,0,0,0,0,0,0,0,0,0,44250
14281,689,15,228,171,175,100,42,27,27,13,0,14,0,0,0,0,0,0,0,0,0,15,15,0,4,11,0,0,0,0,0,0,0,0,0,44251
14282,2486,202,1098,632,347,207,129,98,80,28,0,52,18,18,18,0,0,0,0,0,0,31,31,31,0,0,0,0,0,0,0,0,0,0,0,44253
14283,3468,371,1661,927,364,145,250,127,105,41,14,50,22,4,4,0,0,18,0,18,0,123,123,47,10,66,0,0,0,0,0,0,0,0,0,44254
14284,5809,555,2955,1522,545,232,653,302,263,139,30,94,39,20,12,8,0,19,12,0,7,351,211,63,91,57,140,128,69,0,59,12,0,0,12,44255
14285,41997,2244,11856,12683,10367,4847,3508,1862,1683,553,126,1004,179,124,124,0,0,55,0,19,36,1646,1455,487,76,892,191,151,133,13,5,40,0,0,40,44256
14286,8998,625,4153,2418,1233,569,723,376,348,57,66,225,28,28,0,21,7,0,0,0,0,347,311,147,54,110,36,36,15,0,21,0,0,0,0,44260
14287,3716,277,995,838,908,698,164,82,68,30,0,38,14,14,14,0,0,0,0,0,0,82,57,23,0,34,25,25,25,0,0,0,0,0,0,44262
14288,1858,143,442,526,534,213,148,94,85,16,9,60,9,2,2,0,0,7,0,0,7,54,49,10,33,6,5,5,3,2,0,0,0,0,0,44264
14289,0,0,0,0,0,0,0,0,0,0,0,0,0,0,0,0,0,0,0,0,0,0,0,0,0,0,0,0,0,0,0,0,0,0,0,44265
14290,22688,2817,10492,5911,2179,1289,2056,1041,727,157,157,413,314,204,77,109,18,110,36,26,48,1015,803,199,104,500,212,211,187,17,7,1,0,0,1,44266
14291,6060,717,3211,1309,553,270,446,300,259,82,0,177,41,22,22,0,0,19,0,0,19,146,116,64,6,46,30,30,7,23,0,0,0,0,0,44270
14292,3420,244,1527,1191,295,163,260,105,83,0,14,69,22,22,13,9,0,0,0,0,0,155,155,67,37,51,0,0,0,0,0,0,0,0,0,44272
14293,4786,369,2092,1264,703,358,452,201,161,24,19,118,40,25,25,0,0,15,0,0,15,251,194,47,11,136,57,39,9,30,0,18,18,0,0,44273
14294,90,0,42,11,27,10,0,0,0,0,0,0,0,0,0,0,0,0,0,0,0,0,0,0,0,0,0,0,0,0,0,0,0,0,0,44274
14295,2153,150,1073,639,180,111,217,135,123,56,30,37,12,12,12,0,0,0,0,0,0,82,55,14,0,41,27,27,15,12,0,0,0,0,0,44275
14296,1213,109,558,322,148,76,80,32,32,17,8,7,0,0,0,0,0,0,0,0,0,48,30,21,0,9,18,18,18,0,0,0,0,0,0,44276
14297,12313,951,3983,3878,2303,1198,944,426,372,86,29,257,54,23,15,8,0,31,16,9,6,518,449,231,24,194,69,2,2,0,0,67,44,0,23,44278
14298,3313,347,985,1108,498,375,281,125,116,20,0,96,9,9,9,0,0,0,0,0,0,156,156,104,0,52,0,0,0,0,0,0,0,0,0,44280
14299,20235,1389,5830,6341,4383,2292,1463,733,636,191,0,445,97,69,16,53,0,28,0,0,28,730,636,278,46,312,94,49,30,0,19,45,16,0,29,44281
14300,47,11,23,0,13,0,0,0,0,0,0,0,0,0,0,0,0,0,0,0,0,0,0,0,0,0,0,0,0,0,0,0,0,0,0,44285
14301,4268,195,1106,940,1222,805,346,198,193,44,0,149,5,5,0,5,0,0,0,0,0,148,148,24,12,112,0,0,0,0,0,0,0,0,0,44286
14302,5031,707,2300,1376,393,255,288,148,118,26,22,70,30,30,15,15,0,0,0,0,0,140,116,64,11,41,24,12,6,2,4,12,3,0,9,44287
14303,2431,459,1235,529,122,86,270,142,78,33,23,22,64,64,54,5,5,0,0,0,0,128,99,34,9,56,29,0,0,0,0,29,0,29,0,44288
14304,9838,1210,3647,3142,1401,438,894,455,378,68,35,275,77,45,30,5,10,32,17,3,12,439,387,153,51,183,52,18,3,0,15,34,26,0,8,44301
14305,4066,640,874,1571,769,212,322,120,95,11,14,70,25,25,25,0,0,0,0,0,0,202,168,26,36,106,34,34,34,0,0,0,0,0,0,44302
14306,5581,321,850,1507,1836,1067,300,131,102,46,13,43,29,17,6,11,0,12,12,0,0,169,169,77,11,81,0,0,0,0,0,0,0,0,0,44303
14307,1428,305,247,487,235,154,1638,893,882,145,97,640,11,11,0,0,11,0,0,0,0,745,745,279,61,405,0,0,0,0,0,0,0,0,0,44304
14308,14559,2030,5945,4333,1675,576,1058,574,498,226,74,198,76,48,11,32,5,28,21,7,0,484,318,32,101,185,166,137,104,0,33,29,9,11,9,44305
14309,13452,2983,5578,3804,812,275,1178,330,243,47,16,180,87,37,16,6,15,50,29,0,21,848,642,137,248,257,206,124,55,15,54,82,0,31,51,44306
14310,4011,726,1727,1291,147,120,279,183,130,15,29,86,53,41,16,11,14,12,12,0,0,96,96,0,38,58,0,0,0,0,0,0,0,0,0,44307
14311,503,87,205,87,54,70,151,88,82,26,6,50,6,0,0,0,0,6,0,0,6,63,63,25,6,32,0,0,0,0,0,0,0,0,0,44308
14312,15387,3131,5845,4383,1563,465,1251,800,618,123,76,419,182,43,25,0,18,139,8,38,93,451,354,50,34,270,97,43,10,33,0,54,0,0,54,44310
14313,4278,1332,1441,1153,221,131,1078,630,598,154,27,417,32,0,0,0,0,32,0,8,24,448,406,187,128,91,42,8,0,0,8,34,0,17,17,44311
14314,23147,2500,9899,7007,2330,1411,1215,711,551,153,41,357,160,123,91,27,5,37,10,27,0,504,451,235,33,183,53,15,15,0,0,38,0,38,0,44312
14315,17462,967,3276,5307,4858,3054,927,489,367,91,34,242,122,78,58,0,20,44,44,0,0,438,393,114,0,279,45,40,40,0,0,5,0,5,0,44313
14316,12717,2286,5959,3415,775,282,1047,407,351,138,24,189,56,56,56,0,0,0,0,0,0,640,574,144,65,365,66,44,10,34,0,22,0,0,22,44314
14317,16432,1134,6717,4734,2726,1121,1226,579,538,160,123,255,41,24,0,24,0,17,0,16,1,647,616,340,64,212,31,31,28,1,2,0,0,0,0,44319
14318,14107,1806,5423,4360,1757,761,1466,711,626,79,129,418,85,0,0,0,0,85,0,25,60,755,545,98,128,319,210,192,97,45,50,18,0,0,18,44320
14319,10416,522,2140,2888,3063,1803,728,469,437,52,15,370,32,32,29,0,3,0,0,0,0,259,259,21,29,209,0,0,0,0,0,0,0,0,0,44321
14320,13936,567,2087,3480,4421,3381,776,326,282,43,34,205,44,14,0,14,0,30,17,0,13,450,388,183,0,205,62,62,12,0,50,0,0,0,0,44333
14321,2099,265,1035,566,133,100,182,123,77,30,0,47,46,37,0,0,37,9,9,0,0,59,54,0,30,24,5,5,5,0,0,0,0,0,0,44401
14322,1919,164,987,520,196,52,251,175,159,38,0,121,16,16,16,0,0,0,0,0,0,76,76,34,17,25,0,0,0,0,0,0,0,0,0,44402
14323,3162,348,1469,743,479,123,204,103,73,10,0,63,30,0,0,0,0,30,0,0,30,101,88,20,0,68,13,13,13,0,0,0,0,0,0,44403
14324,1235,109,687,218,204,17,69,19,19,2,0,17,0,0,0,0,0,0,0,0,0,50,50,18,0,32,0,0,0,0,0,0,0,0,0,44404
14325,5541,858,2761,1399,341,182,376,186,155,12,36,107,31,28,26,0,2,3,0,0,3,190,140,23,47,70,50,37,23,7,7,13,5,0,8,44405
14326,15125,547,4805,4048,3597,2128,1097,551,520,96,48,376,31,25,18,0,7,6,0,0,6,546,511,269,22,220,35,18,18,0,0,17,0,0,17,44406
14327,7334,695,3223,2039,839,538,499,217,201,47,23,131,16,0,0,0,0,16,0,0,16,282,189,85,0,104,93,0,0,0,0,93,56,0,37,44408
14328,13040,955,5521,3449,2177,938,635,226,226,9,41,176,0,0,0,0,0,0,0,0,0,409,378,99,13,266,31,31,0,31,0,0,0,0,0,44410
14329,1445,202,842,252,114,35,121,52,43,3,12,28,9,9,0,9,0,0,0,0,0,69,69,55,0,14,0,0,0,0,0,0,0,0,0,44411
14330,1810,123,948,576,110,53,241,128,100,0,17,83,28,28,10,0,18,0,0,0,0,113,113,24,47,42,0,0,0,0,0,0,0,0,0,44412
14331,5367,866,2366,1653,361,121,427,204,194,23,15,156,10,10,0,0,10,0,0,0,0,223,205,47,62,96,18,18,18,0,0,0,0,0,0,44413
14332,1197,74,511,304,208,100,130,50,50,0,22,28,0,0,0,0,0,0,0,0,0,80,80,42,10,28,0,0,0,0,0,0,0,0,0,44417
14333,974,49,315,336,172,102,132,55,49,33,0,16,6,6,6,0,0,0,0,0,0,77,77,28,27,22,0,0,0,0,0,0,0,0,0,44418
14334,10689,1053,4381,2947,1666,642,685,292,207,102,0,105,85,46,0,31,15,39,0,25,14,393,279,54,38,187,114,73,69,0,4,41,0,0,41,44420
14335,1801,195,843,615,106,42,215,93,90,65,0,25,3,3,3,0,0,0,0,0,0,122,108,37,6,65,14,14,14,0,0,0,0,0,0,44423
14336,10644,854,4650,3019,1558,563,729,357,302,113,42,147,55,36,36,0,0,19,0,0,19,372,336,82,9,245,36,36,23,13,0,0,0,0,0,44425
14337,1024,160,484,283,46,51,93,0,0,0,0,0,0,0,0,0,0,0,0,0,0,93,62,12,0,50,31,31,0,31,0,0,0,0,0,44427
14338,2159,363,1202,446,123,25,161,35,10,0,10,0,25,25,14,11,0,0,0,0,0,126,68,18,0,50,58,58,58,0,0,0,0,0,0,44428
14339,2002,210,961,453,262,116,79,34,17,3,0,14,17,3,0,0,3,14,0,0,14,45,40,0,3,37,5,5,2,0,3,0,0,0,0,44429
14340,3858,780,1846,970,178,84,209,115,70,19,0,51,45,45,45,0,0,0,0,0,0,94,79,3,61,15,15,15,15,0,0,0,0,0,0,44430
14341,3199,354,1520,780,469,76,282,176,138,25,14,99,38,16,14,0,2,22,0,0,22,106,82,36,9,37,24,19,16,0,3,5,0,5,0,44431
14342,10161,1492,5243,2356,703,367,490,271,187,32,68,87,84,35,4,26,5,49,0,11,38,219,187,69,30,88,32,32,16,16,0,0,0,0,0,44432
14343,2624,194,1157,815,310,148,191,95,89,24,11,54,6,6,4,0,2,0,0,0,0,96,93,18,26,49,3,3,0,0,3,0,0,0,0,44436
14344,2825,372,1102,847,364,140,202,75,75,27,13,35,0,0,0,0,0,0,0,0,0,127,82,37,0,45,45,45,45,0,0,0,0,0,0,44437
14345,3084,295,1645,810,267,67,277,122,122,23,0,99,0,0,0,0,0,0,0,0,0,155,66,28,12,26,89,89,89,0,0,0,0,0,0,44438
14346,31,0,15,16,0,0,0,0,0,0,0,0,0,0,0,0,0,0,0,0,0,0,0,0,0,0,0,0,0,0,0,0,0,0,0,44439
14347,3562,499,1451,871,527,214,213,141,141,69,0,72,0,0,0,0,0,0,0,0,0,72,61,26,0,35,11,11,0,11,0,0,0,0,0,44440
14348,1164,182,505,180,228,69,30,0,0,0,0,0,0,0,0,0,0,0,0,0,0,30,30,30,0,0,0,0,0,0,0,0,0,0,0,44441
14349,3128,188,1534,762,490,154,193,65,65,15,21,29,0,0,0,0,0,0,0,0,0,128,124,56,15,53,4,0,0,0,0,4,0,0,4,44442
14350,1361,210,739,301,52,59,160,60,60,44,0,16,0,0,0,0,0,0,0,0,0,100,34,0,0,34,66,66,40,26,0,0,0,0,0,44443
14351,7470,997,3679,2016,477,301,479,310,263,5,21,237,47,47,36,0,11,0,0,0,0,169,104,29,0,75,65,40,40,0,0,25,0,0,25,44444
14352,2335,284,1194,548,175,134,142,56,50,16,10,24,6,2,2,0,0,4,0,0,4,86,74,9,36,29,12,12,12,0,0,0,0,0,0,44445
14353,14197,2122,6259,3594,1577,645,1207,705,552,141,13,398,153,71,60,0,11,82,0,11,71,502,441,152,67,222,61,39,29,10,0,22,11,11,0,44446
14354,946,109,491,168,162,16,78,11,11,0,0,11,0,0,0,0,0,0,0,0,0,67,51,26,17,8,16,16,0,16,0,0,0,0,0,44449
14355,1763,325,773,393,235,37,175,98,85,9,16,60,13,0,0,0,0,13,13,0,0,77,77,18,7,52,0,0,0,0,0,0,0,0,0,44450
14356,2341,143,1172,588,316,122,152,86,76,9,4,63,10,0,0,0,0,10,0,10,0,66,66,54,0,12,0,0,0,0,0,0,0,0,0,44451
14357,2074,229,922,604,208,111,88,37,22,0,10,12,15,15,15,0,0,0,0,0,0,51,19,0,0,19,32,32,32,0,0,0,0,0,0,44452
14358,657,104,382,75,48,48,43,30,18,0,0,18,12,12,12,0,0,0,0,0,0,13,13,13,0,0,0,0,0,0,0,0,0,0,0,44454
14359,1327,133,783,329,28,54,128,85,33,18,0,15,52,0,0,0,0,52,52,0,0,43,40,1,12,27,3,3,3,0,0,0,0,0,0,44455
14360,18972,2148,8576,5102,2217,929,1224,628,613,118,0,495,15,15,0,15,0,0,0,0,0,596,544,275,32,237,52,30,30,0,0,22,0,14,8,44460
14361,2890,295,1401,814,335,45,155,99,90,1,0,89,9,9,9,0,0,0,0,0,0,56,56,5,10,41,0,0,0,0,0,0,0,0,0,44470
14362,7565,725,3780,2001,752,307,725,425,369,152,26,191,56,31,6,25,0,25,0,0,25,300,253,150,39,64,47,24,16,8,0,23,23,0,0,44471
14363,2947,191,1431,832,317,176,101,14,14,0,14,0,0,0,0,0,0,0,0,0,0,87,53,0,0,53,34,34,34,0,0,0,0,0,0,44473
14364,7920,952,4113,1915,644,296,543,361,248,58,11,179,113,82,12,70,0,31,0,0,31,182,176,77,0,99,6,0,0,0,0,6,0,0,6,44481
14365,18342,2620,8279,4748,1770,925,1107,548,406,84,75,247,142,128,73,10,45,14,14,0,0,559,431,47,57,327,128,92,47,11,34,36,0,7,29,44483
14366,16129,1535,6005,4491,2768,1330,1067,450,351,66,24,261,99,18,7,0,11,81,0,0,81,617,528,267,34,227,89,47,0,47,0,42,12,0,30,44484
14367,10042,1640,5137,2477,560,228,1019,546,463,90,16,357,83,70,41,0,29,13,0,13,0,473,346,31,33,282,127,102,28,54,20,25,0,0,25,44485
14368,548,44,281,162,41,20,45,34,32,0,3,29,2,0,0,0,0,2,0,0,2,11,11,3,0,8,0,0,0,0,0,0,0,0,0,44490
14369,1952,502,833,390,149,78,141,95,63,18,0,45,32,12,0,12,0,20,15,0,5,46,44,0,0,44,2,0,0,0,0,2,0,0,2,44491
14370,43,0,22,0,21,0,0,0,0,0,0,0,0,0,0,0,0,0,0,0,0,0,0,0,0,0,0,0,0,0,0,0,0,0,0,44493
14371,6291,1280,3089,1551,303,68,850,393,359,86,72,201,34,33,0,33,0,1,0,0,1,457,403,128,73,202,54,42,23,13,6,12,0,0,12,44502
14372,741,205,254,225,36,21,77,64,7,0,0,7,57,28,0,0,28,29,0,0,29,13,13,13,0,0,0,0,0,0,0,0,0,0,0,44503
14373,3136,380,1160,793,291,512,632,354,326,78,33,215,28,15,7,8,0,13,0,13,0,278,255,76,49,130,23,23,23,0,0,0,0,0,0,44504
14374,13863,2998,5449,3484,1114,818,1006,471,346,49,74,223,125,98,8,34,56,27,7,0,20,535,439,80,138,221,96,69,23,46,0,27,0,0,27,44505
14375,1432,379,588,372,84,9,89,45,37,10,8,19,8,8,0,0,8,0,0,0,0,44,44,25,0,19,0,0,0,0,0,0,0,0,0,44506
14376,3420,883,1278,1027,156,76,475,305,278,46,26,206,27,0,0,0,0,27,17,0,10,170,123,0,30,93,47,35,12,0,23,12,0,0,12,44507
14377,8231,1337,3888,2195,502,309,726,266,180,112,17,51,86,39,15,2,22,47,0,0,47,460,349,13,32,304,111,101,6,67,28,10,0,0,10,44509
14378,1673,313,872,423,56,9,130,87,76,4,46,26,11,5,5,0,0,6,0,6,0,43,43,6,0,37,0,0,0,0,0,0,0,0,0,44510
14379,14115,1618,5195,4636,1682,984,1066,611,584,111,119,354,27,27,27,0,0,0,0,0,0,455,429,143,50,236,26,16,7,0,9,10,0,10,0,44511
14380,24960,1966,8052,7703,4787,2452,1377,735,701,291,23,387,34,17,11,0,6,17,7,10,0,642,585,267,78,240,57,17,17,0,0,40,0,16,24,44512
14381,16230,880,5405,4367,3621,1957,1038,532,504,181,19,304,28,18,18,0,0,10,10,0,0,506,453,91,78,284,53,23,0,6,17,30,0,0,30,44514
14382,19822,1708,8291,6109,2528,1186,1066,428,360,127,29,204,68,56,38,0,18,12,6,0,6,638,552,121,165,266,86,80,46,34,0,6,0,6,0,44515
14383,22646,3552,10744,5356,1982,1012,2916,1604,1415,333,132,950,189,152,63,53,36,37,0,15,22,1312,1165,380,95,690,147,99,47,39,13,48,0,23,25,44601
14384,4041,1333,1602,607,383,116,517,257,176,59,37,80,81,39,37,0,2,42,42,0,0,260,112,35,12,65,148,27,5,22,0,121,79,0,42,44606
14385,84,0,52,32,0,0,7,7,0,0,0,0,7,0,0,0,0,7,0,7,0,0,0,0,0,0,0,0,0,0,0,0,0,0,0,44607
14386,1725,222,940,391,95,77,162,85,85,0,3,82,0,0,0,0,0,0,0,0,0,77,60,37,0,23,17,13,0,0,13,4,0,4,0,44608
14387,2717,258,1355,651,280,173,241,90,81,27,0,54,9,5,0,5,0,4,4,0,0,151,144,49,0,95,7,4,4,0,0,3,3,0,0,44609
14388,128,59,12,9,29,19,23,23,23,23,0,0,0,0,0,0,0,0,0,0,0,0,0,0,0,0,0,0,0,0,0,0,0,0,0,44610
14389,1238,145,797,205,40,51,26,15,15,0,0,15,0,0,0,0,0,0,0,0,0,11,11,0,11,0,0,0,0,0,0,0,0,0,0,44611
14390,3827,267,1543,1182,509,326,178,100,100,10,5,85,0,0,0,0,0,0,0,0,0,78,75,9,10,56,3,3,3,0,0,0,0,0,0,44612
14391,1606,191,835,468,93,19,94,16,9,3,0,6,7,7,7,0,0,0,0,0,0,78,78,16,14,48,0,0,0,0,0,0,0,0,0,44613
14392,8326,604,3255,2558,1383,526,1013,662,587,138,94,355,75,50,50,0,0,25,0,17,8,351,351,192,11,148,0,0,0,0,0,0,0,0,0,44614
14393,7437,1002,3728,1914,460,333,610,329,270,75,44,151,59,40,22,11,7,19,0,9,10,281,245,83,10,152,36,33,16,0,17,3,0,0,3,44615
14394,4429,675,1970,918,609,257,473,181,135,21,0,114,46,21,2,0,19,25,14,0,11,292,209,26,8,175,83,24,24,0,0,59,40,0,19,44618
14395,1266,208,578,334,92,54,29,23,22,0,0,22,1,1,0,0,1,0,0,0,0,6,6,0,5,1,0,0,0,0,0,0,0,0,0,44620
14396,3188,414,1626,817,252,79,189,113,113,16,11,86,0,0,0,0,0,0,0,0,0,76,61,5,14,42,15,15,0,0,15,0,0,0,0,44621
14397,13279,1202,5616,3463,1905,1093,653,250,154,0,0,154,96,13,7,6,0,83,10,0,73,403,389,187,65,137,14,3,3,0,0,11,11,0,0,44622
14398,2977,1862,703,316,71,25,369,239,149,56,0,93,90,10,10,0,0,80,71,0,9,130,36,0,0,36,94,9,9,0,0,85,73,12,0,44624
14399,818,238,294,204,43,39,52,40,7,0,0,7,33,15,15,0,0,18,0,18,0,12,12,0,0,12,0,0,0,0,0,0,0,0,0,44625
14400,2175,226,1116,603,136,94,192,164,134,58,16,60,30,23,11,12,0,7,7,0,0,28,19,6,0,13,9,2,2,0,0,7,7,0,0,44626
14401,3255,2199,711,205,103,37,614,343,87,51,23,13,256,10,9,1,0,246,138,31,77,271,52,45,0,7,219,1,0,0,1,218,123,0,95,44627
14402,641,72,428,80,52,9,50,20,19,13,3,3,1,1,1,0,0,0,0,0,0,30,23,5,3,15,7,7,7,0,0,0,0,0,0,44628
14403,1725,132,908,411,201,73,256,187,99,11,0,88,88,88,47,41,0,0,0,0,0,69,62,56,3,3,7,7,3,0,4,0,0,0,0,44629
14404,6381,683,2405,1721,1099,473,715,356,294,59,16,219,62,54,20,0,34,8,0,0,8,359,272,41,0,231,87,78,69,9,0,9,9,0,0,44632
14405,1802,908,469,236,133,56,126,40,7,0,0,7,33,16,16,0,0,17,17,0,0,86,12,7,0,5,74,12,12,0,0,62,62,0,0,44633
14406,1486,99,855,359,130,43,109,49,41,10,12,19,8,0,0,0,0,8,0,0,8,60,60,40,7,13,0,0,0,0,0,0,0,0,0,44634
14407,1840,314,905,440,106,75,79,58,55,13,0,42,3,0,0,0,0,3,0,3,0,21,21,7,0,14,0,0,0,0,0,0,0,0,0,44637
14408,1121,218,528,266,99,10,138,62,53,9,0,44,9,9,9,0,0,0,0,0,0,76,40,0,0,40,36,24,0,24,0,12,12,0,0,44638
14409,136,4,55,69,1,7,2,2,2,0,0,2,0,0,0,0,0,0,0,0,0,0,0,0,0,0,0,0,0,0,0,0,0,0,0,44640
14410,14538,1386,6096,4395,1713,948,843,450,385,135,0,250,65,65,41,0,24,0,0,0,0,393,365,156,41,168,28,28,17,0,11,0,0,0,0,44641
14411,2218,189,1082,696,172,79,144,110,102,52,0,50,8,8,8,0,0,0,0,0,0,34,34,0,0,34,0,0,0,0,0,0,0,0,0,44643
14412,3392,441,1506,846,381,218,180,158,120,11,0,109,38,0,0,0,0,38,0,38,0,22,13,13,0,0,9,9,9,0,0,0,0,0,0,44644
14413,1802,187,872,428,214,101,142,60,60,32,0,28,0,0,0,0,0,0,0,0,0,82,80,25,0,55,2,2,2,0,0,0,0,0,0,44645
14414,32223,3062,12118,9742,4798,2503,2774,1650,1422,284,166,972,228,208,154,13,41,20,16,0,4,1124,927,441,110,376,197,104,46,30,28,93,36,36,21,44646
14415,13277,1526,6697,3701,933,420,876,557,477,110,98,269,80,56,0,29,27,24,0,0,24,319,301,64,67,170,18,0,0,0,0,18,18,0,0,44647
14416,465,86,258,87,8,26,0,0,0,0,0,0,0,0,0,0,0,0,0,0,0,0,0,0,0,0,0,0,0,0,0,0,0,0,0,44651
14417,0,0,0,0,0,0,0,0,0,0,0,0,0,0,0,0,0,0,0,0,0,0,0,0,0,0,0,0,0,0,0,0,0,0,0,44652
14418,472,87,287,85,2,11,52,33,21,0,17,4,12,12,0,0,12,0,0,0,0,19,19,0,0,19,0,0,0,0,0,0,0,0,0,44653
14419,10762,4635,3453,1637,608,429,1405,818,279,44,28,207,539,70,66,0,4,469,381,28,60,587,316,145,33,138,271,10,10,0,0,261,219,0,42,44654
14420,2109,173,1376,409,99,52,233,97,90,38,3,49,7,7,0,7,0,0,0,0,0,136,120,43,28,49,16,16,16,0,0,0,0,0,0,44656
14421,7439,1086,3605,1788,592,368,552,210,171,9,26,136,39,18,18,0,0,21,12,0,9,342,309,39,9,261,33,16,16,0,0,17,17,0,0,44657
14422,95,26,34,20,2,13,2,2,2,0,0,2,0,0,0,0,0,0,0,0,0,0,0,0,0,0,0,0,0,0,0,0,0,0,0,44659
14423,138,21,81,21,14,1,24,11,11,8,0,3,0,0,0,0,0,0,0,0,0,13,13,1,0,12,0,0,0,0,0,0,0,0,0,44661
14424,6654,969,3246,1612,498,329,410,226,174,44,23,107,52,47,34,13,0,5,5,0,0,184,176,35,6,135,8,8,0,0,8,0,0,0,0,44662
14425,17536,2253,8187,4259,1788,1049,1518,844,736,296,73,367,108,67,49,9,9,41,0,0,41,674,610,274,42,294,64,41,30,11,0,23,14,0,9,44663
14426,2000,178,927,557,210,128,196,120,114,34,13,67,6,6,6,0,0,0,0,0,0,76,76,41,0,35,0,0,0,0,0,0,0,0,0,44666
14427,9073,1229,3854,2330,995,665,757,406,347,91,28,228,59,31,16,15,0,28,21,0,7,351,328,116,0,212,23,8,0,8,0,15,15,0,0,44667
14428,964,102,407,230,146,79,53,41,41,21,0,20,0,0,0,0,0,0,0,0,0,12,12,0,0,12,0,0,0,0,0,0,0,0,0,44669
14429,278,35,106,103,0,34,0,0,0,0,0,0,0,0,0,0,0,0,0,0,0,0,0,0,0,0,0,0,0,0,0,0,0,0,0,44670
14430,235,15,72,102,46,0,0,0,0,0,0,0,0,0,0,0,0,0,0,0,0,0,0,0,0,0,0,0,0,0,0,0,0,0,0,44671
14431,3614,613,1522,940,411,128,224,117,97,0,16,81,20,20,20,0,0,0,0,0,0,107,98,41,0,57,9,9,9,0,0,0,0,0,0,44672
14432,1784,196,939,409,131,109,75,45,45,0,2,43,0,0,0,0,0,0,0,0,0,30,27,18,2,7,3,0,0,0,0,3,0,0,3,44675
14433,3191,491,1576,697,305,122,340,156,108,53,13,42,48,0,0,0,0,48,32,0,16,184,121,44,7,70,63,20,13,7,0,43,12,27,4,44676
14434,1685,168,816,393,248,60,113,70,70,12,8,50,0,0,0,0,0,0,0,0,0,43,35,10,0,25,8,6,6,0,0,2,0,0,2,44677
14435,28,0,13,15,0,0,0,0,0,0,0,0,0,0,0,0,0,0,0,0,0,0,0,0,0,0,0,0,0,0,0,0,0,0,0,44678
14436,3069,299,1616,655,343,156,222,122,98,13,22,63,24,9,0,9,0,15,15,0,0,100,100,26,0,74,0,0,0,0,0,0,0,0,0,44680
14437,4610,1772,1634,554,433,217,482,280,148,37,0,111,132,7,7,0,0,125,101,0,24,202,107,52,0,55,95,15,15,0,0,80,74,0,6,44681
14438,653,43,346,155,44,65,28,19,19,0,10,9,0,0,0,0,0,0,0,0,0,9,9,0,0,9,0,0,0,0,0,0,0,0,0,44682
14439,5618,1050,3267,980,205,116,321,166,135,24,0,111,31,31,9,22,0,0,0,0,0,155,143,33,25,85,12,12,12,0,0,0,0,0,0,44683
14440,18866,1109,5316,5715,4468,2258,1381,720,672,170,117,385,48,19,19,0,0,29,12,0,17,661,613,202,38,373,48,35,35,0,0,13,0,0,13,44685
14441,161,67,87,7,0,0,0,0,0,0,0,0,0,0,0,0,0,0,0,0,0,0,0,0,0,0,0,0,0,0,0,0,0,0,0,44687
14442,2128,216,1258,438,179,37,206,106,64,5,0,59,42,26,14,0,12,16,0,0,16,100,92,25,0,67,8,8,8,0,0,0,0,0,0,44688
14443,350,109,172,62,7,0,49,12,10,0,0,10,2,2,2,0,0,0,0,0,0,37,37,19,0,18,0,0,0,0,0,0,0,0,0,44689
14444,72,28,38,0,6,0,0,0,0,0,0,0,0,0,0,0,0,0,0,0,0,0,0,0,0,0,0,0,0,0,0,0,0,0,0,44690
14445,28364,2698,11005,7037,4667,2957,2972,1379,1152,374,19,759,227,122,100,9,13,105,76,21,8,1593,1425,533,158,734,168,147,134,0,13,21,0,0,21,44691
14446,40,2,11,22,5,0,2,0,0,0,0,0,0,0,0,0,0,0,0,0,0,2,2,0,0,2,0,0,0,0,0,0,0,0,0,44693
14447,1299,171,758,336,20,14,67,50,50,32,0,18,0,0,0,0,0,0,0,0,0,17,16,1,0,15,1,1,0,0,1,0,0,0,0,44695
14448,165,8,52,39,37,29,6,4,4,2,0,2,0,0,0,0,0,0,0,0,0,2,1,1,0,0,1,1,0,1,0,0,0,0,0,44697
14449,475,24,340,54,34,23,0,0,0,0,0,0,0,0,0,0,0,0,0,0,0,0,0,0,0,0,0,0,0,0,0,0,0,0,0,44699
14450,867,182,383,251,51,0,19,19,19,19,0,0,0,0,0,0,0,0,0,0,0,0,0,0,0,0,0,0,0,0,0,0,0,0,0,44702
14451,5511,792,1928,2059,402,330,282,130,114,0,0,114,16,7,0,7,0,9,0,9,0,152,138,11,71,56,14,0,0,0,0,14,9,5,0,44703
14452,2461,674,1144,493,136,14,234,137,113,5,44,64,24,24,11,13,0,0,0,0,0,97,92,4,0,88,5,0,0,0,0,5,0,0,5,44704
14453,11662,2448,4924,3293,654,343,941,295,258,18,27,213,37,16,0,3,13,21,0,7,14,646,582,79,164,339,64,64,28,36,0,0,0,0,0,44705
14454,12678,1983,6030,3782,676,207,991,489,432,77,111,244,57,53,17,20,16,4,0,0,4,502,410,151,26,233,92,33,33,0,0,59,28,0,31,44706
14455,5721,1193,2411,1634,270,213,542,305,268,37,44,187,37,37,0,20,17,0,0,0,0,237,222,100,29,93,15,15,0,0,15,0,0,0,0,44707
14456,17605,1368,6322,5301,3069,1545,1166,460,442,202,48,192,18,18,0,18,0,0,0,0,0,706,661,205,128,328,45,14,14,0,0,31,31,0,0,44708
14457,13306,1227,4769,3774,2398,1138,1089,488,407,124,50,233,81,78,52,0,26,3,0,0,3,601,559,266,109,184,42,42,0,42,0,0,0,0,0,44709
14458,6196,854,2632,2154,429,127,643,329,284,98,34,152,45,21,0,21,0,24,0,24,0,314,178,26,8,144,136,113,52,0,61,23,23,0,0,44710
14459,6931,1037,2335,1915,1180,464,191,126,126,48,42,36,0,0,0,0,0,0,0,0,0,65,49,0,0,49,16,16,9,0,7,0,0,0,0,44714
14460,8589,319,1876,2220,2591,1583,690,273,267,94,0,173,6,6,0,6,0,0,0,0,0,417,417,193,0,224,0,0,0,0,0,0,0,0,0,44718
14461,28218,1704,7906,8503,6649,3456,1813,1049,886,217,109,560,163,146,117,29,0,17,0,0,17,764,718,180,38,500,46,31,31,0,0,15,15,0,0,44720
14462,8785,605,2865,2712,1877,726,999,486,474,91,80,303,12,0,0,0,0,12,12,0,0,513,481,224,81,176,32,32,18,0,14,0,0,0,0,44721
14463,4376,678,2239,998,307,154,232,109,106,48,22,36,3,3,3,0,0,0,0,0,0,123,110,56,3,51,13,0,0,0,0,13,0,0,13,44730
14464,705,48,289,303,54,11,33,25,17,5,0,12,8,5,5,0,0,3,0,0,3,8,6,3,0,3,2,0,0,0,0,2,0,0,2,44802
14465,745,49,340,132,149,75,60,50,47,33,0,14,3,3,3,0,0,0,0,0,0,10,7,2,0,5,3,3,1,2,0,0,0,0,0,44804
14466,21442,2570,9007,4771,2920,2174,2220,1096,954,201,96,657,142,116,76,26,14,26,26,0,0,1124,1043,328,117,598,81,64,44,10,10,17,6,11,0,44805
14467,1691,221,888,434,83,65,136,84,84,10,13,61,0,0,0,0,0,0,0,0,0,52,47,17,0,30,5,5,2,0,3,0,0,0,0,44807
14468,157,0,69,56,5,27,7,0,0,0,0,0,0,0,0,0,0,0,0,0,0,7,7,0,0,7,0,0,0,0,0,0,0,0,0,44809
14469,8651,829,3765,2561,1030,466,656,364,348,176,30,142,16,16,16,0,0,0,0,0,0,292,266,115,44,107,26,26,19,0,7,0,0,0,0,44811
14470,5147,539,2397,1596,413,202,481,327,274,31,5,238,53,53,53,0,0,0,0,0,0,154,139,41,0,98,15,15,0,0,15,0,0,0,0,44813
14471,1992,161,882,614,226,109,119,52,52,2,11,39,0,0,0,0,0,0,0,0,0,67,67,8,17,42,0,0,0,0,0,0,0,0,0,44814
14472,432,76,241,85,18,12,23,20,19,6,10,3,1,1,1,0,0,0,0,0,0,3,3,3,0,0,0,0,0,0,0,0,0,0,0,44815
14473,55,0,19,36,0,0,0,0,0,0,0,0,0,0,0,0,0,0,0,0,0,0,0,0,0,0,0,0,0,0,0,0,0,0,0,44816
14474,1096,112,486,317,145,36,55,21,21,5,3,13,0,0,0,0,0,0,0,0,0,34,15,0,4,11,19,2,0,2,0,17,17,0,0,44817
14475,1686,200,828,393,234,31,171,94,82,26,0,56,12,12,12,0,0,0,0,0,0,77,73,25,10,38,4,4,0,2,2,0,0,0,0,44818
14476,12708,1604,6037,3648,944,475,751,448,353,62,18,273,95,32,29,0,3,63,0,0,63,303,212,19,25,168,91,41,17,11,13,50,38,0,12,44820
14477,2066,288,828,624,225,101,68,28,22,7,0,15,6,3,3,0,0,3,0,0,3,40,19,7,0,12,21,18,18,0,0,3,3,0,0,44822
14478,2572,288,1134,711,312,127,281,129,105,17,8,80,24,20,17,1,2,4,4,0,0,152,125,47,28,50,27,27,17,10,0,0,0,0,0,44824
14479,17,0,12,5,0,0,0,0,0,0,0,0,0,0,0,0,0,0,0,0,0,0,0,0,0,0,0,0,0,0,0,0,0,0,0,44825
14480,1118,120,582,275,90,51,58,20,20,20,0,0,0,0,0,0,0,0,0,0,0,38,38,20,0,18,0,0,0,0,0,0,0,0,0,44826
14481,4688,659,2106,1392,416,115,545,287,257,116,16,125,30,30,30,0,0,0,0,0,0,258,221,148,0,73,37,4,0,4,0,33,17,16,0,44827
14482,23,4,19,0,0,0,0,0,0,0,0,0,0,0,0,0,0,0,0,0,0,0,0,0,0,0,0,0,0,0,0,0,0,0,0,44828
14483,12411,1358,5841,3851,922,439,830,466,415,117,74,224,51,51,32,10,9,0,0,0,0,364,288,91,0,197,76,45,0,38,7,31,0,31,0,44830
14484,11646,1591,5445,3294,697,619,775,293,221,81,36,104,72,48,7,0,41,24,0,0,24,482,417,114,29,274,65,32,8,24,0,33,9,0,24,44833
14485,1734,142,785,619,131,57,174,87,78,30,0,48,9,9,2,0,7,0,0,0,0,87,75,49,11,15,12,12,3,0,9,0,0,0,0,44836
14486,2777,590,1426,512,145,104,324,162,159,26,0,133,3,3,3,0,0,0,0,0,0,162,112,26,25,61,50,0,0,0,0,50,15,0,35,44837
14487,136,16,80,28,10,2,12,4,4,0,0,4,0,0,0,0,0,0,0,0,0,8,8,2,0,6,0,0,0,0,0,0,0,0,0,44838
14488,9008,526,2610,2866,1954,1052,478,239,190,48,8,134,49,29,21,8,0,20,20,0,0,239,204,121,0,83,35,35,0,35,0,0,0,0,0,44839
14489,2357,348,1042,675,219,73,308,165,106,0,6,100,59,30,30,0,0,29,0,0,29,143,82,4,0,78,61,13,13,0,0,48,0,23,25,44840
14490,511,13,260,195,43,0,14,12,9,0,0,9,3,0,0,0,0,3,0,0,3,2,2,0,0,2,0,0,0,0,0,0,0,0,0,44841
14491,3731,412,1704,1100,298,217,306,148,132,42,34,56,16,10,10,0,0,6,6,0,0,158,152,49,0,103,6,0,0,0,0,6,6,0,0,44842
14492,1685,141,693,512,197,142,117,59,56,0,0,56,3,3,0,3,0,0,0,0,0,58,58,39,3,16,0,0,0,0,0,0,0,0,0,44843
14493,358,26,215,66,27,24,14,14,14,0,0,14,0,0,0,0,0,0,0,0,0,0,0,0,0,0,0,0,0,0,0,0,0,0,0,44844
14494,2203,182,990,460,209,362,131,82,70,31,17,22,12,12,12,0,0,0,0,0,0,49,49,22,0,27,0,0,0,0,0,0,0,0,0,44846
14495,2457,233,1275,656,218,75,157,48,26,21,0,5,22,22,16,6,0,0,0,0,0,109,109,48,0,61,0,0,0,0,0,0,0,0,0,44847
14496,1469,163,676,419,115,96,111,90,79,31,0,48,11,11,9,0,2,0,0,0,0,21,21,3,0,18,0,0,0,0,0,0,0,0,0,44849
14497,35,0,35,0,0,0,0,0,0,0,0,0,0,0,0,0,0,0,0,0,0,0,0,0,0,0,0,0,0,0,0,0,0,0,0,44850
14498,3430,431,1592,875,369,163,277,119,119,47,12,60,0,0,0,0,0,0,0,0,0,158,122,75,9,38,36,36,27,0,9,0,0,0,0,44851
14499,894,39,416,309,90,40,75,35,28,7,5,16,7,7,7,0,0,0,0,0,0,40,40,13,0,27,0,0,0,0,0,0,0,0,0,44853
14500,1215,105,574,348,117,71,87,33,33,11,0,22,0,0,0,0,0,0,0,0,0,54,54,4,0,50,0,0,0,0,0,0,0,0,0,44854
14501,891,81,520,194,83,13,40,31,28,17,0,11,3,3,3,0,0,0,0,0,0,9,9,2,2,5,0,0,0,0,0,0,0,0,0,44855
14502,75,29,38,8,0,0,0,0,0,0,0,0,0,0,0,0,0,0,0,0,0,0,0,0,0,0,0,0,0,0,0,0,0,0,0,44856
14503,15769,1790,7330,4290,1441,918,1284,678,649,196,31,422,29,23,0,19,4,6,0,0,6,606,537,185,78,274,69,31,14,17,0,38,0,0,38,44857
14504,832,120,319,252,86,55,37,35,35,0,0,35,0,0,0,0,0,0,0,0,0,2,2,0,2,0,0,0,0,0,0,0,0,0,0,44859
14505,39,0,18,9,12,0,3,3,3,3,0,0,0,0,0,0,0,0,0,0,0,0,0,0,0,0,0,0,0,0,0,0,0,0,0,44861
14506,2165,228,987,634,232,84,243,129,102,24,15,63,27,6,0,0,6,21,0,9,12,114,111,21,0,90,3,3,0,0,3,0,0,0,0,44864
14507,2301,575,972,497,184,73,250,86,58,4,3,51,28,28,28,0,0,0,0,0,0,164,112,9,14,89,52,0,0,0,0,52,44,0,8,44865
14508,1344,302,550,382,92,18,164,53,53,1,4,48,0,0,0,0,0,0,0,0,0,111,32,8,0,24,79,1,1,0,0,78,0,0,78,44866
14509,1603,170,664,488,188,93,79,43,41,10,3,28,2,2,2,0,0,0,0,0,0,36,23,0,7,16,13,8,0,0,8,5,0,5,0,44867
14510,28482,3705,11623,7956,3313,1885,1987,1074,854,168,124,562,220,152,47,44,61,68,0,30,38,913,754,410,73,271,159,133,96,21,16,26,26,0,0,44870
14511,213,47,89,33,31,13,11,2,2,0,0,2,0,0,0,0,0,0,0,0,0,9,9,2,0,7,0,0,0,0,0,0,0,0,0,44874
14512,9411,1023,4245,2839,866,438,590,281,198,41,14,143,83,73,20,0,53,10,0,0,10,309,259,37,0,222,50,19,19,0,0,31,0,0,31,44875
14513,1948,561,859,426,32,70,147,59,31,16,0,15,28,0,0,0,0,28,28,0,0,88,53,12,0,41,35,16,16,0,0,19,19,0,0,44878
14514,1947,405,855,574,42,71,198,161,144,0,16,128,17,17,17,0,0,0,0,0,0,37,37,13,0,24,0,0,0,0,0,0,0,0,0,44880
14515,28,0,10,10,8,0,0,0,0,0,0,0,0,0,0,0,0,0,0,0,0,0,0,0,0,0,0,0,0,0,0,0,0,0,0,44881
14516,2118,264,954,562,264,74,147,84,76,54,0,22,8,8,8,0,0,0,0,0,0,63,63,13,0,50,0,0,0,0,0,0,0,0,0,44882
14517,19169,2001,8199,5333,2140,1496,2123,1093,1017,177,114,726,76,61,37,24,0,15,5,0,10,1030,920,233,157,530,110,98,34,23,41,12,0,0,12,44883
14518,774,84,463,109,78,40,45,29,25,0,2,23,4,4,0,2,2,0,0,0,0,16,14,0,2,12,2,0,0,0,0,2,2,0,0,44887
14519,4671,483,2066,1376,384,362,466,296,229,65,29,135,67,56,30,14,12,11,11,0,0,170,141,27,4,110,29,9,9,0,0,20,0,4,16,44889
14520,7732,1114,3763,2043,535,277,477,241,206,35,24,147,35,26,6,6,14,9,0,0,9,236,196,55,44,97,40,32,6,26,0,8,0,0,8,44890
14521,2062,872,606,527,38,19,85,85,45,0,0,45,40,28,0,0,28,12,0,0,12,0,0,0,0,0,0,0,0,0,0,0,0,0,0,44901
14522,3686,840,1761,949,84,52,345,230,192,72,0,120,38,25,15,0,10,13,1,0,12,115,82,0,0,82,33,33,33,0,0,0,0,0,0,44902
14523,17370,2105,7285,5113,1863,1004,1207,708,571,136,71,364,137,82,54,28,0,55,18,10,27,499,469,225,46,198,30,30,30,0,0,0,0,0,0,44903
14524,9747,595,3021,3526,1672,933,775,345,305,71,0,234,40,36,36,0,0,4,0,0,4,430,354,50,9,295,76,20,20,0,0,56,28,0,28,44904
14525,10139,1932,4624,2736,643,204,775,402,265,57,67,141,137,117,59,38,20,20,0,0,20,373,308,147,25,136,65,30,20,0,10,35,0,35,0,44905
14526,11726,1680,4856,3356,1292,542,788,351,276,110,46,120,75,37,22,4,11,38,18,16,4,437,354,90,19,245,83,71,42,18,11,12,12,0,0,44906
14527,10218,1170,4240,3041,1066,701,563,302,253,85,43,125,49,32,32,0,0,17,0,0,17,261,229,59,49,121,32,32,10,0,22,0,0,0,0,44907
14528,385,107,211,54,9,4,22,17,17,9,0,8,0,0,0,0,0,0,0,0,0,5,5,0,0,5,0,0,0,0,0,0,0,0,0,45001
14529,8352,752,2989,2446,1539,626,639,276,246,101,27,118,30,13,13,0,0,17,0,17,0,363,321,48,40,233,42,29,5,0,24,13,0,0,13,45002
14530,486,63,225,125,53,20,46,25,21,4,3,14,4,0,0,0,0,4,0,0,4,21,21,2,10,9,0,0,0,0,0,0,0,0,0,45003
14531,20811,2873,8871,6452,1737,878,1357,772,723,179,35,509,49,49,0,49,0,0,0,0,0,585,457,213,55,189,128,28,28,0,0,100,52,17,31,45005
14532,42553,5719,14201,11692,7303,3638,3626,1957,1679,631,66,982,278,180,101,58,21,98,0,57,41,1669,1529,663,102,764,140,123,48,21,54,17,0,7,10,45011
14533,36404,4395,14970,9973,4562,2504,2753,1384,1122,255,99,768,262,149,72,29,48,113,58,19,36,1369,1163,459,98,606,206,141,54,28,59,65,45,0,20,45013
14534,30608,2635,10132,9851,5470,2520,2112,955,850,161,128,561,105,103,29,15,59,2,0,2,0,1157,1020,372,89,559,137,123,118,0,5,14,0,14,0,45014
14535,8045,1396,3828,1971,665,185,377,185,153,24,74,55,32,20,0,20,0,12,12,0,0,192,165,14,40,111,27,27,0,0,27,0,0,0,0,45015
14536,12030,1179,4502,3798,1791,760,939,423,321,106,21,194,102,93,34,59,0,9,0,0,9,516,474,242,15,217,42,35,27,8,0,7,7,0,0,45030
14537,221,25,103,71,16,6,7,4,4,4,0,0,0,0,0,0,0,0,0,0,0,3,3,0,0,3,0,0,0,0,0,0,0,0,0,45032
14538,161,12,109,40,0,0,74,8,8,8,0,0,0,0,0,0,0,0,0,0,0,66,37,0,5,32,29,29,29,0,0,0,0,0,0,45033
14539,639,29,142,193,233,42,61,47,47,18,0,29,0,0,0,0,0,0,0,0,0,14,14,14,0,0,0,0,0,0,0,0,0,0,0,45034
14540,25382,2660,7529,7594,4967,2632,2259,1236,929,285,127,517,307,81,57,0,24,226,42,71,113,1023,987,448,26,513,36,36,31,5,0,0,0,0,0,45036
14541,14956,664,2485,4334,4982,2491,1021,527,506,82,57,367,21,21,18,0,3,0,0,0,0,494,448,229,0,219,46,46,42,0,4,0,0,0,0,45039
14542,31908,1199,5660,7091,10571,7387,3217,1660,1545,534,181,830,115,46,33,13,0,69,26,30,13,1557,1403,538,204,661,154,148,101,11,36,6,0,0,6,45040
14543,0,0,0,0,0,0,0,0,0,0,0,0,0,0,0,0,0,0,0,0,0,0,0,0,0,0,0,0,0,0,0,0,0,0,0,45041
14544,18776,2776,7164,5135,2693,1008,1293,656,542,158,109,275,114,53,24,9,20,61,14,34,13,637,547,189,86,272,90,55,19,36,0,35,3,0,32,45042
14545,32839,4866,12105,8146,5234,2488,2508,1276,1041,284,84,673,235,180,109,34,37,55,0,34,21,1232,1004,319,150,535,228,163,69,44,50,65,0,16,49,45044
14546,5803,355,1668,1898,1493,389,512,272,219,153,39,27,53,53,53,0,0,0,0,0,0,240,162,56,15,91,78,0,0,0,0,78,0,64,14,45050
14547,165,32,60,21,21,31,0,0,0,0,0,0,0,0,0,0,0,0,0,0,0,0,0,0,0,0,0,0,0,0,0,0,0,0,0,45051
14548,3336,373,1029,904,683,347,222,141,141,53,6,82,0,0,0,0,0,0,0,0,0,81,81,10,4,67,0,0,0,0,0,0,0,0,0,45052
14549,2215,121,898,538,401,257,150,102,97,25,10,62,5,5,5,0,0,0,0,0,0,48,48,36,0,12,0,0,0,0,0,0,0,0,0,45053
14550,1523,191,481,530,166,155,42,33,24,0,5,19,9,9,9,0,0,0,0,0,0,9,9,2,0,7,0,0,0,0,0,0,0,0,0,45054
14551,10124,601,2444,2096,2410,2573,6666,3295,3279,811,72,2396,16,16,16,0,0,0,0,0,0,3371,3339,1178,215,1946,32,32,0,0,32,0,0,0,0,45056
14552,484,83,232,133,27,9,26,4,4,0,0,4,0,0,0,0,0,0,0,0,0,22,22,0,0,22,0,0,0,0,0,0,0,0,0,45062
14553,1965,213,997,471,192,92,154,74,70,3,10,57,4,4,0,4,0,0,0,0,0,80,67,0,0,67,13,0,0,0,0,13,0,0,13,45064
14554,3266,502,1097,611,806,250,174,86,40,0,0,40,46,46,9,37,0,0,0,0,0,88,46,0,46,0,42,42,0,0,42,0,0,0,0,45065
14555,15984,516,3493,4223,4730,3022,1194,591,576,214,73,289,15,15,15,0,0,0,0,0,0,603,594,164,55,375,9,9,9,0,0,0,0,0,0,45066
14556,8537,896,3955,2559,765,362,619,433,406,79,31,296,27,8,8,0,0,19,0,0,19,186,122,42,12,68,64,43,17,0,26,21,0,11,10,45067
14557,7314,627,2780,1704,1444,759,629,437,405,84,28,293,32,32,18,12,2,0,0,0,0,192,170,96,13,61,22,22,22,0,0,0,0,0,0,45068
14558,32535,1574,7166,8787,8962,6046,2295,952,911,297,31,583,41,21,13,1,7,20,0,0,20,1343,1317,604,56,657,26,26,12,0,14,0,0,0,0,45069
14559,164,20,105,39,0,0,22,11,9,0,0,9,2,2,2,0,0,0,0,0,0,11,4,0,0,4,7,7,0,0,7,0,0,0,0,45070
14560,1726,493,716,380,108,29,189,102,83,21,4,58,19,7,0,4,3,12,0,0,12,87,60,20,3,37,27,27,0,23,4,0,0,0,0,45101
14561,14505,1654,5408,4563,1889,991,1392,880,675,212,40,423,205,181,85,22,74,24,0,24,0,512,501,214,75,212,11,11,11,0,0,0,0,0,0,45102
14562,21326,2520,8404,5836,3073,1493,1881,1169,939,283,75,581,230,159,79,44,36,71,14,0,57,712,573,243,27,303,139,139,76,5,58,0,0,0,0,45103
14563,8181,1438,3966,1899,510,368,627,348,265,116,6,143,83,65,54,0,11,18,0,0,18,279,179,35,11,133,100,96,63,18,15,4,4,0,0,45106
14564,5991,924,2852,1573,430,212,560,237,153,27,40,86,84,59,59,0,0,25,0,0,25,323,293,63,40,190,30,30,30,0,0,0,0,0,0,45107
14565,245,25,107,56,29,28,48,19,19,3,16,0,0,0,0,0,0,0,0,0,0,29,29,26,0,3,0,0,0,0,0,0,0,0,0,45111
14566,36,21,6,7,2,0,3,3,3,0,3,0,0,0,0,0,0,0,0,0,0,0,0,0,0,0,0,0,0,0,0,0,0,0,0,45112
14567,2518,261,1060,719,267,211,115,51,51,7,0,44,0,0,0,0,0,0,0,0,0,64,60,0,0,60,4,4,4,0,0,0,0,0,0,45113
14568,46,0,35,11,0,0,0,0,0,0,0,0,0,0,0,0,0,0,0,0,0,0,0,0,0,0,0,0,0,0,0,0,0,0,0,45115
14569,2573,371,1240,574,295,93,190,135,127,17,0,110,8,0,0,0,0,8,0,0,8,55,55,1,0,54,0,0,0,0,0,0,0,0,0,45118
14570,2046,449,842,571,137,47,228,69,32,16,0,16,37,30,14,16,0,7,0,0,7,159,145,20,2,123,14,14,0,14,0,0,0,0,0,45120
14571,6503,1009,3320,1503,333,338,361,171,84,9,15,60,87,58,12,25,21,29,0,0,29,190,172,64,0,108,18,18,18,0,0,0,0,0,0,45121
14572,7742,1219,3750,1807,760,206,611,321,243,106,57,80,78,78,46,32,0,0,0,0,0,290,225,28,25,172,65,65,60,0,5,0,0,0,0,45122
14573,5863,1166,2743,1283,425,246,383,228,144,17,27,100,84,62,0,55,7,22,9,3,10,155,132,21,34,77,23,0,0,0,0,23,12,0,11,45123
14574,2760,667,1141,655,191,106,367,171,108,0,3,105,63,24,0,0,24,39,39,0,0,196,196,108,0,88,0,0,0,0,0,0,0,0,0,45130
14575,194,64,72,34,13,11,10,10,7,0,7,0,3,3,3,0,0,0,0,0,0,0,0,0,0,0,0,0,0,0,0,0,0,0,0,45131
14576,136,32,48,40,13,3,11,2,2,0,0,2,0,0,0,0,0,0,0,0,0,9,9,0,0,9,0,0,0,0,0,0,0,0,0,45132
14577,15836,2821,6426,4775,1191,623,1085,478,374,90,49,235,104,71,11,23,37,33,0,0,33,607,354,176,9,169,253,253,72,17,164,0,0,0,0,45133
14578,3209,508,1508,735,275,183,282,184,168,36,18,114,16,7,7,0,0,9,9,0,0,98,95,43,0,52,3,0,0,0,0,3,3,0,0,45135
14579,34318,2389,7694,8409,10068,5758,2924,1427,1280,434,59,787,147,114,89,0,25,33,33,0,0,1497,1336,631,100,605,161,110,38,36,36,51,26,0,25,45140
14580,2698,331,1296,766,152,153,242,133,109,51,3,55,24,24,6,0,18,0,0,0,0,109,100,21,28,51,9,5,5,0,0,4,3,1,0,45142
14581,3279,848,1439,682,153,157,208,97,54,11,0,43,43,27,19,3,5,16,7,9,0,111,85,23,4,58,26,26,5,21,0,0,0,0,0,45144
14582,0,0,0,0,0,0,0,0,0,0,0,0,0,0,0,0,0,0,0,0,0,0,0,0,0,0,0,0,0,0,0,0,0,0,0,45145
14583,1181,127,587,331,113,23,219,144,105,28,24,53,39,39,39,0,0,0,0,0,0,75,46,9,0,37,29,29,0,20,9,0,0,0,0,45146
14584,187,71,48,57,0,11,0,0,0,0,0,0,0,0,0,0,0,0,0,0,0,0,0,0,0,0,0,0,0,0,0,0,0,0,0,45147
14585,930,234,401,263,15,17,122,93,87,2,0,85,6,1,1,0,0,5,0,5,0,29,22,20,1,1,7,2,2,0,0,5,5,0,0,45148
14586,21666,2241,7082,5797,4278,2268,1496,665,523,260,23,240,142,88,22,0,66,54,19,0,35,831,740,249,58,433,91,77,77,0,0,14,14,0,0,45150
14587,8099,1144,2718,2060,1515,662,506,302,296,84,51,161,6,6,6,0,0,0,0,0,0,204,140,36,4,100,64,64,64,0,0,0,0,0,0,45152
14588,1258,229,539,341,147,2,79,47,47,0,0,47,0,0,0,0,0,0,0,0,0,32,27,0,0,27,5,5,2,0,3,0,0,0,0,45153
14589,6012,1292,2873,1262,434,151,448,234,146,51,9,86,88,74,34,16,24,14,0,14,0,214,163,79,7,77,51,51,31,0,20,0,0,0,0,45154
14590,153,18,70,61,4,0,34,16,8,8,0,0,8,8,8,0,0,0,0,0,0,18,18,9,0,9,0,0,0,0,0,0,0,0,0,45155
14591,68,20,18,14,8,8,12,6,6,0,0,6,0,0,0,0,0,0,0,0,0,6,6,6,0,0,0,0,0,0,0,0,0,0,0,45156
14592,6663,960,2835,1572,722,574,480,315,272,70,16,186,43,4,0,0,4,39,0,0,39,165,154,38,31,85,11,0,0,0,0,11,0,0,11,45157
14593,259,24,174,45,14,2,19,6,2,2,0,0,4,4,4,0,0,0,0,0,0,13,3,0,0,3,10,8,8,0,0,2,0,0,2,45158
14594,2249,302,973,730,152,92,254,150,130,11,27,92,20,20,0,0,20,0,0,0,0,104,104,33,0,71,0,0,0,0,0,0,0,0,0,45159
14595,482,94,228,125,25,10,37,0,0,0,0,0,0,0,0,0,0,0,0,0,0,37,29,0,0,29,8,8,0,0,8,0,0,0,0,45160
14596,1854,259,839,459,220,77,59,11,8,1,0,7,3,2,2,0,0,1,0,1,0,48,42,13,6,23,6,6,6,0,0,0,0,0,0,45162
14597,174,41,99,24,5,5,38,13,13,0,0,13,0,0,0,0,0,0,0,0,0,25,22,7,0,15,3,3,0,0,3,0,0,0,0,45164
14598,163,0,65,98,0,0,0,0,0,0,0,0,0,0,0,0,0,0,0,0,0,0,0,0,0,0,0,0,0,0,0,0,0,0,0,45166
14599,2486,415,1107,671,176,117,211,120,90,2,23,65,30,20,0,11,9,10,0,0,10,91,74,29,0,45,17,17,6,11,0,0,0,0,0,45167
14600,1061,164,512,283,23,79,126,65,65,10,0,55,0,0,0,0,0,0,0,0,0,61,57,8,0,49,4,4,4,0,0,0,0,0,0,45168
14601,3271,471,1689,755,262,94,186,92,87,36,4,47,5,0,0,0,0,5,0,5,0,94,78,19,0,59,16,7,0,7,0,9,0,9,0,45169
14602,4206,831,1814,1055,317,189,258,123,84,3,28,53,39,39,0,39,0,0,0,0,0,135,98,41,17,40,37,37,0,37,0,0,0,0,0,45171
14603,106,40,48,13,2,3,7,4,4,0,0,4,0,0,0,0,0,0,0,0,0,3,3,0,0,3,0,0,0,0,0,0,0,0,0,45172
14604,1383,13,85,220,668,397,178,102,102,16,7,79,0,0,0,0,0,0,0,0,0,76,76,24,3,49,0,0,0,0,0,0,0,0,0,45174
14605,5841,977,2718,1485,482,179,700,254,193,5,24,164,61,32,9,4,19,29,2,0,27,446,354,112,8,234,92,48,48,0,0,44,0,41,3,45176
14606,14416,1518,5610,4624,1727,937,1342,673,659,229,49,381,14,14,14,0,0,0,0,0,0,669,659,265,93,301,10,10,0,0,10,0,0,0,0,45177
14607,9006,1172,1791,2098,2068,1877,514,229,120,7,20,93,109,35,0,9,26,74,0,0,74,285,215,6,8,201,70,61,17,12,32,9,0,0,9,45202
14608,1400,368,600,201,119,112,106,60,29,0,22,7,31,19,12,0,7,12,0,0,12,46,31,0,0,31,15,15,10,0,5,0,0,0,0,45203
14609,3962,1160,1308,948,363,183,558,264,224,15,5,204,40,18,18,0,0,22,0,6,16,294,213,47,60,106,81,53,0,17,36,28,0,0,28,45204
14610,12033,3561,4245,2976,880,371,1084,517,376,90,35,251,141,84,49,0,35,57,0,41,16,567,442,112,51,279,125,46,9,37,0,79,22,0,57,45205
14611,7467,1245,1442,2070,1434,1276,451,357,204,11,55,138,153,130,35,9,86,23,0,0,23,94,58,18,11,29,36,24,20,0,4,12,0,0,12,45206
14612,3744,818,1438,1077,238,173,1700,685,685,122,46,517,0,0,0,0,0,0,0,0,0,1015,965,245,30,690,50,19,19,0,0,31,0,0,31,45207
14613,12976,336,950,1576,5683,4431,921,415,341,83,7,251,74,71,9,18,44,3,0,0,3,506,506,227,46,233,0,0,0,0,0,0,0,0,0,45208
14614,7737,722,849,1371,2945,1850,153,78,78,52,0,26,0,0,0,0,0,0,0,0,0,75,60,17,0,43,15,15,15,0,0,0,0,0,0,45209
14615,25314,3321,8947,7596,3645,1805,1635,702,630,203,131,296,72,39,39,0,0,33,0,0,33,933,761,215,72,474,172,92,21,0,71,80,0,0,80,45211
14616,14919,2672,4845,3349,2845,1208,1045,554,400,13,50,337,154,129,61,26,42,25,14,0,11,491,334,55,13,266,157,73,39,0,34,84,45,21,18,45212
14617,8360,516,1780,2462,2226,1376,750,585,446,112,0,334,139,113,66,0,47,26,0,0,26,165,129,101,0,28,36,36,19,0,17,0,0,0,0,45213
14618,4804,1431,1727,1193,363,90,548,342,267,65,61,141,75,37,0,21,16,38,0,11,27,206,164,12,19,133,42,31,5,0,26,11,0,0,11,45214
14619,19842,2634,5933,5259,3320,2696,2129,1218,928,205,87,636,290,120,55,40,25,170,74,93,3,911,752,276,56,420,159,64,58,6,0,95,0,10,85,45215
14620,6592,1722,2214,1787,663,206,376,165,131,40,0,91,34,11,11,0,0,23,0,0,23,211,188,66,22,100,23,0,0,0,0,23,0,0,23,45216
14621,4301,499,1525,1548,489,240,398,136,125,0,28,97,11,11,0,11,0,0,0,0,0,262,202,51,10,141,60,46,26,20,0,14,14,0,0,45217
14622,2733,210,541,978,630,374,136,71,69,20,0,49,2,0,0,0,0,2,0,0,2,65,65,48,0,17,0,0,0,0,0,0,0,0,0,45218
14623,5262,1108,965,1316,1022,851,4101,2211,1972,452,208,1312,239,204,130,28,46,35,21,0,14,1890,1882,606,155,1121,8,8,8,0,0,0,0,0,0,45219
14624,8999,486,1125,1876,2621,2891,951,525,525,140,67,318,0,0,0,0,0,0,0,0,0,426,418,142,13,263,8,7,7,0,0,1,0,0,1,45220
14625,7255,1172,2206,1982,1316,579,547,293,241,15,10,216,52,45,14,12,19,7,7,0,0,254,210,62,49,99,44,44,31,5,8,0,0,0,0,45223
14626,14688,1684,3852,5379,2251,1522,846,434,387,50,21,316,47,36,12,6,18,11,0,10,1,412,363,101,10,252,49,49,33,0,16,0,0,0,0,45224
14627,4693,1494,1289,1598,240,72,408,209,123,27,12,84,86,22,0,17,5,64,63,0,1,199,160,12,45,103,39,10,0,10,0,29,0,0,29,45225
14628,4254,390,521,761,1662,920,210,109,70,28,0,42,39,6,0,6,0,33,0,22,11,101,90,20,14,56,11,0,0,0,0,11,0,0,11,45226
14629,12666,1478,2966,3129,3226,1867,850,366,302,74,29,199,64,41,38,3,0,23,14,9,0,484,360,98,14,248,124,110,0,7,103,14,0,14,0,45227
14630,7908,1704,2088,2079,1120,917,459,178,125,19,0,106,53,53,0,23,30,0,0,0,0,281,254,20,0,234,27,27,0,27,0,0,0,0,0,45229
14631,19168,1140,3841,5817,4934,3436,1134,636,589,139,0,450,47,28,28,0,0,19,19,0,0,498,399,221,12,166,99,82,46,36,0,17,0,17,0,45230
14632,27255,2723,9131,9616,3735,2050,2414,1279,1063,288,307,468,216,166,105,13,48,50,0,27,23,1135,972,282,41,649,163,149,63,36,50,14,0,14,0,45231
14633,2965,593,1160,919,161,132,421,165,110,25,16,69,55,0,0,0,0,55,0,55,0,256,174,0,0,174,82,23,23,0,0,59,0,33,26,45232
14634,9899,676,2728,2659,2509,1327,1148,735,679,239,62,378,56,56,12,0,44,0,0,0,0,413,399,130,25,244,14,0,0,0,0,14,5,0,9,45233
14635,17755,1296,4537,4796,4287,2839,935,447,369,82,78,209,78,78,78,0,0,0,0,0,0,488,385,153,51,181,103,93,83,0,10,10,0,0,10,45236
14636,13639,1969,4389,4330,1831,1120,898,341,290,27,52,211,51,26,10,8,8,25,0,0,25,557,373,68,9,296,184,117,32,34,51,67,0,0,67,45237
14637,30504,3494,11132,9244,4742,1892,2551,1144,920,308,140,472,224,148,128,20,0,76,42,0,34,1407,1341,424,287,630,66,39,10,0,29,27,0,0,27,45238
14638,18769,2317,6665,6255,2490,1042,1233,603,516,117,97,302,87,43,17,26,0,44,0,7,37,630,580,311,61,208,50,31,31,0,0,19,19,0,0,45239
14639,17343,2038,5309,5620,2975,1401,1344,780,594,164,11,419,186,111,104,7,0,75,74,0,1,564,525,142,127,256,39,39,12,0,27,0,0,0,0,45240
14640,16836,1271,4141,4174,4089,3161,1036,671,544,179,6,359,127,123,68,55,0,4,0,0,4,365,325,108,4,213,40,28,28,0,0,12,0,0,12,45241
14641,15720,903,2497,3259,4900,4161,1057,671,671,147,65,459,0,0,0,0,0,0,0,0,0,386,305,89,19,197,81,61,51,0,10,20,0,20,0,45242
14642,10004,335,1222,1789,3693,2965,610,296,296,47,0,249,0,0,0,0,0,0,0,0,0,314,314,74,12,228,0,0,0,0,0,0,0,0,0,45243
14643,18372,1189,3544,4588,5837,3214,1607,752,694,180,36,478,58,58,45,0,13,0,0,0,0,855,740,231,19,490,115,80,39,5,36,35,0,0,35,45244
14644,13544,1137,4184,4263,2616,1344,817,469,431,47,33,351,38,38,38,0,0,0,0,0,0,348,348,122,29,197,0,0,0,0,0,0,0,0,0,45245
14645,9712,1645,1938,2949,2076,1104,900,433,343,68,37,238,90,61,48,13,0,29,0,29,0,467,337,169,9,159,130,50,50,0,0,80,27,0,53,45246
14646,16229,997,4644,4828,3985,1775,1044,485,437,120,38,279,48,48,0,33,15,0,0,0,0,559,483,221,31,231,76,76,68,8,0,0,0,0,0,45247
14647,17596,1491,5981,5095,3475,1554,1355,821,686,217,125,344,135,116,116,0,0,19,10,0,9,534,504,231,24,249,30,30,21,0,9,0,0,0,0,45248
14648,9529,445,1359,2205,3144,2376,611,256,256,72,15,169,0,0,0,0,0,0,0,0,0,355,282,55,24,203,73,73,0,73,0,0,0,0,0,45249
14649,14048,1851,5155,4634,1867,541,1197,610,524,147,80,297,86,66,25,41,0,20,8,12,0,587,500,266,7,227,87,87,50,0,37,0,0,0,0,45251
14650,3518,272,1239,877,688,442,159,102,68,61,0,7,34,34,34,0,0,0,0,0,0,57,57,23,0,34,0,0,0,0,0,0,0,0,0,45252
14651,15241,907,3396,4259,4241,2438,1012,517,478,114,12,352,39,39,22,16,1,0,0,0,0,495,409,184,8,217,86,57,44,0,13,29,0,12,17,45255
14652,96,43,45,0,8,0,0,0,0,0,0,0,0,0,0,0,0,0,0,0,0,0,0,0,0,0,0,0,0,0,0,0,0,0,0,45301
14653,2556,111,1056,869,329,191,357,167,158,55,3,100,9,0,0,0,0,9,9,0,0,190,183,53,0,130,7,7,7,0,0,0,0,0,0,45302
14654,1390,261,673,326,63,67,113,49,38,0,3,35,11,11,8,3,0,0,0,0,0,64,62,10,11,41,2,2,2,0,0,0,0,0,0,45303
14655,4968,466,2311,1506,443,242,403,234,224,71,30,123,10,7,7,0,0,3,0,0,3,169,106,63,12,31,63,54,6,48,0,9,0,0,9,45304
14656,7106,323,1574,2337,1479,1393,660,344,329,146,0,183,15,15,15,0,0,0,0,0,0,316,265,100,49,116,51,51,30,0,21,0,0,0,0,45305
14657,1605,61,814,424,228,78,81,46,42,23,0,19,4,4,4,0,0,0,0,0,0,35,35,23,0,12,0,0,0,0,0,0,0,0,0,45306
14658,195,23,122,45,5,0,14,11,11,0,2,9,0,0,0,0,0,0,0,0,0,3,2,0,0,2,1,1,1,0,0,0,0,0,0,45307
14659,2874,358,1494,784,166,72,247,119,79,21,8,50,40,40,34,0,6,0,0,0,0,128,113,39,13,61,15,8,8,0,0,7,7,0,0,45308
14660,8938,779,3559,3151,970,479,454,280,264,91,24,149,16,10,0,0,10,6,6,0,0,174,174,68,3,103,0,0,0,0,0,0,0,0,0,45309
14661,147,15,99,19,14,0,4,2,2,0,0,2,0,0,0,0,0,0,0,0,0,2,2,2,0,0,0,0,0,0,0,0,0,0,0,45310
14662,4703,796,2244,1333,150,180,326,158,93,26,0,67,65,19,9,0,10,46,0,17,29,168,168,75,0,93,0,0,0,0,0,0,0,0,0,45311
14663,941,55,433,305,78,70,109,67,65,17,0,48,2,2,0,0,2,0,0,0,0,42,42,1,0,41,0,0,0,0,0,0,0,0,0,45312
14664,2262,102,721,834,310,295,1494,652,627,153,47,427,25,13,13,0,0,12,0,0,12,842,838,330,73,435,4,4,0,0,4,0,0,0,0,45314
14665,2816,169,709,787,735,416,141,23,16,7,0,9,7,7,0,7,0,0,0,0,0,118,94,34,12,48,24,24,0,24,0,0,0,0,0,45315
14666,107,17,36,35,14,5,25,19,13,7,0,6,6,6,6,0,0,0,0,0,0,6,2,0,0,2,4,4,0,0,4,0,0,0,0,45316
14667,639,9,295,173,84,78,64,44,28,11,0,17,16,0,0,0,0,16,0,0,16,20,20,0,0,20,0,0,0,0,0,0,0,0,0,45317
14668,3738,463,1983,894,265,133,210,117,91,19,8,64,26,26,26,0,0,0,0,0,0,93,77,28,17,32,16,16,0,0,16,0,0,0,0,45318
14669,234,15,83,70,50,16,9,6,6,0,3,3,0,0,0,0,0,0,0,0,0,3,3,2,0,1,0,0,0,0,0,0,0,0,0,45319
14670,10170,933,4203,3534,1071,429,695,352,326,75,13,238,26,21,20,0,1,5,5,0,0,343,320,144,14,162,23,6,0,3,3,17,0,17,0,45320
14671,672,109,330,176,41,16,73,30,27,9,0,18,3,3,0,3,0,0,0,0,0,43,35,17,0,18,8,8,6,2,0,0,0,0,0,45321
14672,15193,874,5236,5555,2114,1414,943,528,501,151,113,237,27,27,0,0,27,0,0,0,0,415,397,141,24,232,18,18,10,0,8,0,0,0,0,45322
14673,4017,411,1130,1461,614,401,169,88,87,38,16,33,1,1,0,0,1,0,0,0,0,81,81,46,0,35,0,0,0,0,0,0,0,0,0,45323
14674,23985,3084,7305,7188,3699,2709,3384,1512,1384,347,205,832,128,116,29,33,54,12,0,0,12,1872,1778,721,282,775,94,65,55,0,10,29,0,0,29,45324
14675,1739,253,689,492,190,115,104,23,23,0,0,23,0,0,0,0,0,0,0,0,0,81,76,29,6,41,5,0,0,0,0,5,0,0,5,45325
14676,753,101,371,188,48,45,35,5,5,1,0,4,0,0,0,0,0,0,0,0,0,30,29,8,15,6,1,1,1,0,0,0,0,0,0,45326
14677,6354,598,2378,1993,891,494,306,139,125,38,35,52,14,11,11,0,0,3,0,0,3,167,156,43,3,110,11,11,11,0,0,0,0,0,0,45327
14678,408,47,219,123,3,16,26,13,13,6,0,7,0,0,0,0,0,0,0,0,0,13,10,0,0,10,3,1,1,0,0,2,0,0,2,45328
14679,499,88,234,152,10,15,48,25,22,0,3,19,3,3,3,0,0,0,0,0,0,23,23,3,0,20,0,0,0,0,0,0,0,0,0,45330
14680,16039,2057,7893,4198,1065,826,981,616,544,201,77,266,72,32,32,0,0,40,0,0,40,365,298,136,41,121,67,61,38,0,23,6,0,0,6,45331
14681,447,95,162,177,10,3,10,0,0,0,0,0,0,0,0,0,0,0,0,0,0,10,10,0,0,10,0,0,0,0,0,0,0,0,0,45332
14682,723,52,330,189,100,52,73,56,56,16,0,40,0,0,0,0,0,0,0,0,0,17,17,2,3,12,0,0,0,0,0,0,0,0,0,45333
14683,1497,157,809,328,97,106,136,84,51,22,0,29,33,23,14,5,4,10,0,0,10,52,38,12,0,26,14,14,0,0,14,0,0,0,0,45334
14684,4614,387,1970,1654,388,215,349,136,136,44,6,86,0,0,0,0,0,0,0,0,0,213,175,26,9,140,38,32,17,15,0,6,1,5,0,45335
14685,100,12,32,28,26,2,12,9,9,4,0,5,0,0,0,0,0,0,0,0,0,3,3,0,3,0,0,0,0,0,0,0,0,0,0,45336
14686,1123,169,484,299,120,51,115,43,42,28,0,14,1,1,0,1,0,0,0,0,0,72,72,13,0,59,0,0,0,0,0,0,0,0,0,45337
14687,3495,433,1597,1038,245,182,235,125,106,4,15,87,19,19,19,0,0,0,0,0,0,110,92,26,6,60,18,18,18,0,0,0,0,0,0,45338
14688,958,147,420,243,107,41,67,26,25,24,0,1,1,1,0,1,0,0,0,0,0,41,39,0,0,39,2,2,2,0,0,0,0,0,0,45339
14689,494,57,265,140,23,9,15,0,0,0,0,0,0,0,0,0,0,0,0,0,0,15,15,3,0,12,0,0,0,0,0,0,0,0,0,45340
14690,2411,461,850,765,237,98,143,70,55,37,0,18,15,6,6,0,0,9,0,9,0,73,73,44,0,29,0,0,0,0,0,0,0,0,0,45341
14691,24929,2644,7482,8226,3910,2667,1481,863,730,104,102,524,133,79,62,17,0,54,47,7,0,618,556,165,47,344,62,47,38,0,9,15,0,0,15,45342
14692,11692,1667,4624,3631,1226,544,1047,504,431,90,52,289,73,61,61,0,0,12,0,12,0,543,460,131,75,254,83,55,39,0,16,28,5,0,23,45344
14693,4216,411,2188,1300,228,89,216,85,63,19,10,34,22,13,0,0,13,9,9,0,0,131,125,26,9,90,6,6,0,0,6,0,0,0,0,45345
14694,1400,89,706,468,95,42,103,55,38,16,0,22,17,17,17,0,0,0,0,0,0,48,34,25,4,5,14,14,14,0,0,0,0,0,0,45346
14695,3153,483,1630,750,204,86,332,180,147,62,5,80,33,33,8,20,5,0,0,0,0,152,144,44,0,100,8,5,0,5,0,3,0,3,0,45347
14696,402,95,195,88,0,24,38,28,28,12,0,16,0,0,0,0,0,0,0,0,0,10,9,7,0,2,1,1,0,0,1,0,0,0,0,45348
14697,283,6,112,127,18,20,5,0,0,0,0,0,0,0,0,0,0,0,0,0,0,5,5,0,0,5,0,0,0,0,0,0,0,0,0,45349
14698,83,11,29,28,13,2,10,8,8,2,0,6,0,0,0,0,0,0,0,0,0,2,2,0,2,0,0,0,0,0,0,0,0,0,0,45350
14699,169,20,83,46,16,4,7,6,4,0,1,3,2,2,2,0,0,0,0,0,0,1,1,0,0,1,0,0,0,0,0,0,0,0,0,45351
14700,134,23,77,34,0,0,15,15,15,6,7,2,0,0,0,0,0,0,0,0,0,0,0,0,0,0,0,0,0,0,0,0,0,0,0,45352
14701,132,23,86,23,0,0,15,0,0,0,0,0,0,0,0,0,0,0,0,0,0,15,0,0,0,0,15,15,15,0,0,0,0,0,0,45353
14702,439,52,213,119,53,2,14,14,10,10,0,0,4,4,4,0,0,0,0,0,0,0,0,0,0,0,0,0,0,0,0,0,0,0,0,45354
14703,17144,2822,7208,5154,1223,737,1336,704,456,37,60,359,248,237,192,35,10,11,0,0,11,632,527,151,115,261,105,105,74,31,0,0,0,0,0,45356
14704,246,10,124,91,16,5,31,3,3,0,3,0,0,0,0,0,0,0,0,0,0,28,14,1,4,9,14,14,6,8,0,0,0,0,0,45358
14705,1230,95,628,359,89,59,121,80,71,37,0,34,9,9,9,0,0,0,0,0,0,41,30,0,11,19,11,11,0,0,11,0,0,0,0,45359
14706,290,44,188,45,10,3,30,30,28,7,0,21,2,0,0,0,0,2,0,0,2,0,0,0,0,0,0,0,0,0,0,0,0,0,0,45360
14707,165,28,66,60,10,1,1,0,0,0,0,0,0,0,0,0,0,0,0,0,0,1,1,0,0,1,0,0,0,0,0,0,0,0,0,45361
14708,849,97,496,169,48,39,85,26,24,3,0,21,2,2,2,0,0,0,0,0,0,59,59,25,3,31,0,0,0,0,0,0,0,0,0,45362
14709,1001,44,465,286,148,58,108,51,44,11,4,29,7,7,4,0,3,0,0,0,0,57,53,27,2,24,4,4,4,0,0,0,0,0,0,45363
14710,20217,2807,9103,5642,1486,1179,1686,822,654,150,100,404,168,89,51,0,38,79,0,44,35,864,794,344,95,355,70,56,25,0,31,14,0,0,14,45365
14711,3103,267,1353,993,294,196,300,146,146,17,0,129,0,0,0,0,0,0,0,0,0,154,154,66,27,61,0,0,0,0,0,0,0,0,0,45368
14712,2469,318,966,736,299,150,315,173,145,22,1,122,28,28,27,0,1,0,0,0,0,142,132,18,26,88,10,1,1,0,0,9,0,0,9,45369
14713,1699,93,538,375,308,385,141,58,51,18,4,29,7,0,0,0,0,7,0,7,0,83,81,43,8,30,2,2,2,0,0,0,0,0,0,45370
14714,12868,1055,4046,3989,2321,1457,1135,528,468,111,140,217,60,39,15,24,0,21,0,0,21,607,558,175,99,284,49,49,34,15,0,0,0,0,0,45371
14715,345,53,179,102,9,2,41,25,23,18,2,3,2,2,2,0,0,0,0,0,0,16,14,3,0,11,2,2,0,2,0,0,0,0,0,45372
14716,24150,2490,8599,7279,3825,1957,1754,907,787,180,212,395,120,110,80,21,9,10,0,0,10,847,801,298,47,456,46,30,17,0,13,16,0,0,16,45373
14717,10481,960,3291,3944,1335,951,713,460,443,130,85,228,17,17,0,0,17,0,0,0,0,253,242,106,9,127,11,11,0,11,0,0,0,0,0,45377
14718,251,32,139,69,8,3,15,8,8,0,2,6,0,0,0,0,0,0,0,0,0,7,7,0,3,4,0,0,0,0,0,0,0,0,0,45378
14719,3583,389,1532,940,448,274,322,134,109,24,8,77,25,25,0,7,18,0,0,0,0,188,181,25,0,156,7,7,7,0,0,0,0,0,0,45380
14720,3839,488,1868,1103,255,125,273,146,127,24,2,101,19,19,19,0,0,0,0,0,0,127,127,90,16,21,0,0,0,0,0,0,0,0,0,45381
14721,908,68,483,275,64,18,72,48,46,0,7,39,2,2,2,0,0,0,0,0,0,24,24,5,0,19,0,0,0,0,0,0,0,0,0,45382
14722,5010,525,1507,2145,649,184,299,225,161,57,0,104,64,57,0,17,40,7,7,0,0,74,74,27,0,47,0,0,0,0,0,0,0,0,0,45383
14723,126,8,7,30,28,53,716,233,233,37,20,176,0,0,0,0,0,0,0,0,0,483,483,146,55,282,0,0,0,0,0,0,0,0,0,45384
14724,26679,2735,9191,7942,3861,2950,1839,1034,873,223,100,550,161,95,15,0,80,66,13,0,53,805,755,182,92,481,50,27,20,7,0,23,9,0,14,45385
14725,4029,122,588,1005,1071,1243,220,131,124,33,0,91,7,7,7,0,0,0,0,0,0,89,80,20,16,44,9,0,0,0,0,9,0,0,9,45387
14726,563,49,325,96,66,27,45,38,38,36,0,2,0,0,0,0,0,0,0,0,0,7,7,6,0,1,0,0,0,0,0,0,0,0,0,45388
14727,322,52,174,85,7,4,35,26,26,2,3,21,0,0,0,0,0,0,0,0,0,9,6,3,0,3,3,3,3,0,0,0,0,0,0,45389
14728,2290,569,1101,462,104,54,163,84,64,15,6,43,20,13,10,3,0,7,0,6,1,79,68,9,18,41,11,6,2,4,0,5,0,5,0,45390
14729,7119,1606,2082,2026,683,722,516,257,199,0,0,199,58,15,0,0,15,43,0,0,43,259,201,29,40,132,58,34,34,0,0,24,0,8,16,45402
14730,9800,2900,2624,3302,614,360,497,201,174,26,2,146,27,7,7,0,0,20,0,0,20,296,246,124,41,81,50,30,22,8,0,20,3,7,10,45403
14731,6981,2143,2555,1948,248,87,394,259,160,0,50,110,99,24,24,0,0,75,0,35,40,135,115,9,41,65,20,20,0,11,9,0,0,0,0,45404
14732,12352,2047,3658,4543,1382,722,912,576,485,98,84,303,91,57,18,3,36,34,17,0,17,336,316,78,42,196,20,20,4,16,0,0,0,0,0,45405
14733,13482,2064,4344,4933,1295,846,997,588,497,71,107,319,91,45,5,40,0,46,29,4,13,409,322,27,128,167,87,63,31,9,23,24,0,12,12,45406
14734,4875,218,1021,1336,1252,1048,5498,2551,2534,613,215,1706,17,17,17,0,0,0,0,0,0,2947,2947,933,276,1738,0,0,0,0,0,0,0,0,0,45409
14735,10476,2242,3126,3293,1319,496,665,433,336,50,56,230,97,79,9,18,52,18,0,8,10,232,121,57,24,40,111,55,34,10,11,56,5,20,31,45410
14736,13949,1869,4598,4795,1459,1228,902,331,290,51,93,146,41,10,10,0,0,31,5,0,26,571,509,201,150,158,62,33,26,7,0,29,0,24,5,45414
14737,8996,720,2623,2938,1521,1194,604,301,259,61,6,192,42,35,35,0,0,7,0,0,7,303,231,80,36,115,72,20,4,16,0,52,0,0,52,45415
14738,3968,799,1198,1533,276,162,428,172,172,23,12,137,0,0,0,0,0,0,0,0,0,256,244,0,62,182,12,10,10,0,0,2,0,0,2,45416
14739,19860,4557,6256,7238,1163,646,2155,1011,780,134,122,524,231,112,47,37,28,119,5,47,67,1144,932,191,99,642,212,124,84,13,27,88,1,43,44,45417
14740,1005,68,364,449,108,16,143,67,67,3,0,64,0,0,0,0,0,0,0,0,0,76,30,16,0,14,46,34,26,0,8,12,12,0,0,45418
14741,10367,388,1363,3173,2688,2755,495,230,225,50,29,146,5,5,5,0,0,0,0,0,0,265,248,92,13,143,17,10,10,0,0,7,7,0,0,45419
14742,17469,1716,5741,6985,2047,980,1896,978,881,259,102,520,97,80,45,31,4,17,0,13,4,918,838,345,101,392,80,62,35,16,11,18,0,10,8,45420
14743,33357,2850,9382,13018,4769,3338,2296,1173,1065,293,147,625,108,41,29,12,0,67,0,36,31,1123,1055,407,146,502,68,63,27,0,36,5,5,0,0,45424
14744,10371,1383,3071,4310,990,617,787,375,323,86,17,220,52,21,21,0,0,31,21,0,10,412,391,180,4,207,21,17,0,0,17,4,0,0,4,45426
14745,290,114,105,47,15,9,13,0,0,0,0,0,0,0,0,0,0,0,0,0,0,13,13,0,0,13,0,0,0,0,0,0,0,0,0,45428
14746,18800,948,4344,6086,4389,3033,1027,555,508,171,46,291,47,27,15,12,0,20,0,0,20,472,434,138,66,230,38,30,18,6,6,8,8,0,0,45429
14747,5224,213,1067,1552,1125,1267,469,252,252,35,5,212,0,0,0,0,0,0,0,0,0,217,197,116,0,81,20,20,15,0,5,0,0,0,0,45430
14748,18370,1435,4839,5499,3520,3077,692,379,352,64,43,245,27,6,0,0,6,21,21,0,0,313,288,121,5,162,25,16,16,0,0,9,0,0,9,45431
14749,10629,1123,3558,3455,1168,1325,766,426,377,63,74,240,49,49,49,0,0,0,0,0,0,340,312,164,33,115,28,5,0,0,5,23,23,0,0,45432
14750,1140,7,84,498,297,254,153,124,79,46,10,23,45,45,45,0,0,0,0,0,0,29,12,12,0,0,17,17,17,0,0,0,0,0,0,45433
14751,8107,193,1125,2382,2067,2340,497,244,244,72,28,144,0,0,0,0,0,0,0,0,0,253,238,50,7,181,15,0,0,0,0,15,15,0,0,45434
14752,6515,1229,2448,2143,448,247,432,248,189,47,0,142,59,18,3,0,15,41,13,25,3,184,121,8,22,91,63,49,34,6,9,14,0,14,0,45439
14753,14760,706,3300,4527,3346,2881,626,247,219,56,27,136,28,28,12,12,4,0,0,0,0,379,366,132,43,191,13,13,0,13,0,0,0,0,0,45440
14754,13069,1440,4490,4907,1531,701,692,365,320,118,109,93,45,14,8,0,6,31,0,31,0,327,312,124,22,166,15,5,5,0,0,10,0,10,0,45449
14755,21064,1104,3038,6243,5821,4858,1267,715,697,86,136,475,18,18,18,0,0,0,0,0,0,552,541,131,80,330,11,11,11,0,0,0,0,0,0,45458
14756,21288,1074,4221,6476,5686,3831,1147,444,415,97,50,268,29,21,0,13,8,8,0,0,8,703,688,246,32,410,15,15,3,0,12,0,0,0,0,45459
14757,11660,996,4156,3830,1783,895,955,422,371,96,26,249,51,28,24,0,4,23,0,0,23,533,515,137,77,301,18,10,10,0,0,8,8,0,0,45502
14758,22830,2981,8328,7442,2623,1456,1616,854,716,143,170,403,138,93,39,48,6,45,0,41,4,762,669,308,149,212,93,80,17,53,10,13,9,4,0,45503
14759,11525,1380,3949,2992,1919,1285,1562,751,675,135,27,513,76,69,29,8,32,7,7,0,0,811,759,269,37,453,52,42,42,0,0,10,0,0,10,45504
14760,12657,2448,5388,3806,710,305,1017,479,370,82,101,187,109,70,28,32,10,39,13,8,18,538,401,111,72,218,137,92,28,8,56,45,4,0,41,45505
14761,8930,1713,3088,3053,729,347,625,336,231,43,46,142,105,48,43,0,5,57,0,17,40,289,243,51,31,161,46,32,21,0,11,14,9,5,0,45506
14762,40370,6419,17060,11058,3509,2324,2784,1402,1125,240,258,627,277,210,52,115,43,67,16,22,29,1382,1120,324,166,630,262,256,138,103,15,6,0,6,0,45601
14763,3918,718,1769,907,433,91,162,109,74,0,18,56,35,0,0,0,0,35,33,0,2,53,15,0,0,15,38,14,14,0,0,24,24,0,0,45612
14764,2394,591,1148,543,72,40,208,96,68,15,20,33,28,28,25,3,0,0,0,0,0,112,110,14,17,79,2,2,0,2,0,0,0,0,0,45613
14765,3172,493,1389,831,318,141,254,96,34,0,0,34,62,62,0,46,16,0,0,0,0,158,139,13,0,126,19,19,0,0,19,0,0,0,0,45614
14766,1065,250,385,276,72,82,41,14,0,0,0,0,14,14,14,0,0,0,0,0,0,27,27,15,0,12,0,0,0,0,0,0,0,0,0,45616
14767,33,8,0,25,0,0,0,0,0,0,0,0,0,0,0,0,0,0,0,0,0,0,0,0,0,0,0,0,0,0,0,0,0,0,0,45617
14768,12,6,5,1,0,0,0,0,0,0,0,0,0,0,0,0,0,0,0,0,0,0,0,0,0,0,0,0,0,0,0,0,0,0,0,45618
14769,5766,888,2071,1683,882,242,594,322,262,68,0,194,60,54,54,0,0,6,0,0,6,272,213,6,2,205,59,59,59,0,0,0,0,0,0,45619
14770,793,160,359,228,15,31,21,15,15,0,0,15,0,0,0,0,0,0,0,0,0,6,6,0,0,6,0,0,0,0,0,0,0,0,0,45620
14771,265,81,93,79,12,0,48,15,15,0,0,15,0,0,0,0,0,0,0,0,0,33,21,0,9,12,12,2,2,0,0,10,0,0,10,45621
14772,214,26,63,69,36,20,18,18,18,18,0,0,0,0,0,0,0,0,0,0,0,0,0,0,0,0,0,0,0,0,0,0,0,0,0,45622
14773,2073,338,1156,355,196,28,170,99,76,1,3,72,23,23,23,0,0,0,0,0,0,71,71,19,7,45,0,0,0,0,0,0,0,0,0,45623
14774,28,13,15,0,0,0,0,0,0,0,0,0,0,0,0,0,0,0,0,0,0,0,0,0,0,0,0,0,0,0,0,0,0,0,0,45624
14775,3468,563,1387,969,287,262,233,120,114,19,0,95,6,0,0,0,0,6,0,6,0,113,111,66,13,32,2,2,0,0,2,0,0,0,0,45628
14776,2274,498,869,643,121,143,356,260,244,35,0,209,16,11,0,0,11,5,0,0,5,96,87,23,0,64,9,9,0,0,9,0,0,0,0,45629
14777,211,89,91,31,0,0,0,0,0,0,0,0,0,0,0,0,0,0,0,0,0,0,0,0,0,0,0,0,0,0,0,0,0,0,0,45630
14778,10766,2047,3986,2777,1167,789,744,386,324,7,0,317,62,50,50,0,0,12,0,12,0,358,332,11,15,306,26,0,0,0,0,26,0,0,26,45631
14779,1454,366,628,338,80,42,112,62,56,11,8,37,6,0,0,0,0,6,0,6,0,50,5,0,0,5,45,45,17,0,28,0,0,0,0,45634
14780,144,13,69,48,14,0,0,0,0,0,0,0,0,0,0,0,0,0,0,0,0,0,0,0,0,0,0,0,0,0,0,0,0,0,0,45636
14781,14674,1893,6722,4104,1207,748,1376,666,599,114,75,410,67,43,10,0,33,24,10,0,14,710,613,133,14,466,97,64,28,8,28,33,0,0,33,45638
14782,11040,1864,4750,2574,1040,812,809,382,343,155,53,135,39,23,9,14,0,16,0,10,6,427,292,106,50,136,135,135,60,38,37,0,0,0,0,45640
14783,0,0,0,0,0,0,0,0,0,0,0,0,0,0,0,0,0,0,0,0,0,0,0,0,0,0,0,0,0,0,0,0,0,0,0,45642
14784,3198,417,1560,929,141,151,266,136,105,5,0,100,31,31,22,9,0,0,0,0,0,130,121,15,0,106,9,0,0,0,0,9,0,0,9,45644
14785,2178,257,1046,530,165,180,159,121,85,17,0,68,36,36,0,0,36,0,0,0,0,38,38,0,0,38,0,0,0,0,0,0,0,0,0,45645
14786,256,44,128,74,0,10,25,0,0,0,0,0,0,0,0,0,0,0,0,0,0,25,25,25,0,0,0,0,0,0,0,0,0,0,0,45646
14787,1619,295,980,344,0,0,78,20,20,0,0,20,0,0,0,0,0,0,0,0,0,58,58,23,0,35,0,0,0,0,0,0,0,0,0,45647
14788,9197,2085,4009,2046,693,364,534,241,202,29,0,173,39,35,20,9,6,4,0,0,4,293,291,16,72,203,2,0,0,0,0,2,0,0,2,45648
14789,164,78,51,31,0,4,24,14,0,0,0,0,14,14,14,0,0,0,0,0,0,10,10,10,0,0,0,0,0,0,0,0,0,0,0,45650
14790,4027,736,1684,1132,332,143,428,248,248,39,14,195,0,0,0,0,0,0,0,0,0,180,168,21,5,142,12,12,0,0,12,0,0,0,0,45651
14791,2474,466,971,654,264,119,170,91,91,0,0,91,0,0,0,0,0,0,0,0,0,79,79,0,0,79,0,0,0,0,0,0,0,0,0,45652
14792,2903,410,1023,1056,245,169,134,72,72,7,0,65,0,0,0,0,0,0,0,0,0,62,45,0,0,45,17,17,0,0,17,0,0,0,0,45653
14793,594,178,266,135,15,0,51,51,41,27,0,14,10,10,0,0,10,0,0,0,0,0,0,0,0,0,0,0,0,0,0,0,0,0,0,45654
14794,4169,871,1900,834,384,180,299,173,147,38,35,74,26,20,2,12,6,6,6,0,0,126,104,6,2,96,22,22,9,0,13,0,0,0,0,45656
14795,1653,406,890,237,88,32,67,48,34,16,0,18,14,0,0,0,0,14,14,0,0,19,0,0,0,0,19,19,19,0,0,0,0,0,0,45657
14796,1588,385,668,321,95,119,95,63,58,25,0,33,5,5,0,0,5,0,0,0,0,32,32,0,12,20,0,0,0,0,0,0,0,0,0,45658
14797,2080,465,1056,251,168,140,106,76,53,22,0,31,23,0,0,0,0,23,0,0,23,30,30,26,0,4,0,0,0,0,0,0,0,0,0,45659
14798,5706,1331,2588,1181,360,246,432,202,168,8,8,152,34,20,12,8,0,14,14,0,0,230,127,9,9,109,103,23,0,19,4,80,47,33,0,45660
14799,4734,1163,2111,880,343,237,330,226,188,14,11,163,38,38,31,7,0,0,0,0,0,104,95,8,12,75,9,9,2,0,7,0,0,0,0,45661
14800,19874,3994,6807,5838,2005,1230,1866,813,763,90,84,589,50,37,26,11,0,13,6,7,0,1053,871,284,104,483,182,167,67,44,56,15,8,7,0,45662
14801,4458,690,1968,1451,254,95,496,252,185,18,13,154,67,52,0,18,34,15,0,0,15,244,230,44,80,106,14,14,14,0,0,0,0,0,0,45663
14802,7269,1065,2882,2012,900,410,579,351,319,12,28,279,32,32,0,32,0,0,0,0,0,228,180,24,0,156,48,48,37,0,11,0,0,0,0,45669
14803,252,44,143,56,6,3,41,5,0,0,0,0,5,0,0,0,0,5,0,0,5,36,36,0,0,36,0,0,0,0,0,0,0,0,0,45671
14804,969,77,557,274,20,41,141,23,23,13,0,10,0,0,0,0,0,0,0,0,0,118,118,0,0,118,0,0,0,0,0,0,0,0,0,45672
14805,258,54,193,11,0,0,64,64,64,0,0,64,0,0,0,0,0,0,0,0,0,0,0,0,0,0,0,0,0,0,0,0,0,0,0,45673
14806,201,0,112,32,21,36,264,145,145,47,0,98,0,0,0,0,0,0,0,0,0,119,119,61,17,41,0,0,0,0,0,0,0,0,0,45674
14807,939,293,476,147,23,0,48,0,0,0,0,0,0,0,0,0,0,0,0,0,0,48,48,0,0,48,0,0,0,0,0,0,0,0,0,45678
14808,1912,445,866,434,67,100,148,78,78,11,12,55,0,0,0,0,0,0,0,0,0,70,68,8,0,60,2,2,2,0,0,0,0,0,0,45679
14809,8601,1335,3898,2203,829,336,371,219,167,40,11,116,52,44,0,44,0,8,0,0,8,152,146,81,0,65,6,6,6,0,0,0,0,0,0,45680
14810,1366,290,735,249,44,48,99,51,43,9,0,34,8,8,0,8,0,0,0,0,0,48,48,18,0,30,0,0,0,0,0,0,0,0,0,45681
14811,1764,354,819,343,132,116,143,65,56,0,7,49,9,9,0,9,0,0,0,0,0,78,78,9,8,61,0,0,0,0,0,0,0,0,0,45682
14812,1257,179,562,389,59,68,95,66,58,22,0,36,8,8,0,0,8,0,0,0,0,29,29,12,17,0,0,0,0,0,0,0,0,0,0,45684
14813,717,147,236,203,51,80,64,12,12,0,0,12,0,0,0,0,0,0,0,0,0,52,28,3,14,11,24,24,24,0,0,0,0,0,0,45685
14814,2521,565,1214,556,122,64,215,133,123,49,33,41,10,0,0,0,0,10,0,0,10,82,70,30,0,40,12,0,0,0,0,12,12,0,0,45686
14815,380,48,294,33,0,5,23,23,23,0,10,13,0,0,0,0,0,0,0,0,0,0,0,0,0,0,0,0,0,0,0,0,0,0,0,45688
14816,9530,1715,3996,2225,927,667,734,385,332,67,29,236,53,53,10,8,35,0,0,0,0,349,236,96,36,104,113,71,55,0,16,42,0,36,6,45690
14817,5707,1090,2509,1223,706,179,488,216,166,19,8,139,50,50,29,14,7,0,0,0,0,272,215,46,5,164,57,57,12,16,29,0,0,0,0,45692
14818,5475,1323,2343,1257,229,323,397,199,149,60,0,89,50,40,30,0,10,10,0,0,10,198,180,27,25,128,18,18,0,12,6,0,0,0,0,45693
14819,8626,1223,3464,2424,1052,463,619,314,276,6,61,209,38,10,0,10,0,28,28,0,0,305,304,53,0,251,1,0,0,0,0,1,0,0,1,45694
14820,426,44,232,121,22,7,27,18,18,0,0,18,0,0,0,0,0,0,0,0,0,9,9,0,0,9,0,0,0,0,0,0,0,0,0,45695
14821,920,192,445,214,51,18,30,0,0,0,0,0,0,0,0,0,0,0,0,0,0,30,30,10,0,20,0,0,0,0,0,0,0,0,0,45696
14822,3371,525,1583,912,252,99,324,124,88,11,0,77,36,25,16,9,0,11,0,0,11,200,147,11,4,132,53,42,0,24,18,11,0,0,11,45697
14823,323,56,181,58,2,26,13,9,3,0,0,3,6,6,2,2,2,0,0,0,0,4,4,0,0,4,0,0,0,0,0,0,0,0,0,45698
14824,13772,763,3136,3274,2619,3980,6045,2859,2838,575,231,2032,21,17,17,0,0,4,0,0,4,3186,3165,970,276,1919,21,19,19,0,0,2,0,0,2,45701
14825,4056,406,1692,1259,416,283,279,83,77,23,29,25,6,6,0,0,6,0,0,0,0,196,196,81,19,96,0,0,0,0,0,0,0,0,0,45710
14826,885,150,352,176,126,81,79,25,25,0,0,25,0,0,0,0,0,0,0,0,0,54,54,27,0,27,0,0,0,0,0,0,0,0,0,45711
14827,7132,790,3071,2426,664,181,345,180,180,21,0,159,0,0,0,0,0,0,0,0,0,165,165,51,0,114,0,0,0,0,0,0,0,0,0,45714
14828,1795,226,791,535,198,45,76,51,36,26,0,10,15,2,2,0,0,13,0,0,13,25,25,0,0,25,0,0,0,0,0,0,0,0,0,45715
14829,308,60,117,75,31,25,25,10,8,5,0,3,2,2,0,2,0,0,0,0,0,15,15,7,5,3,0,0,0,0,0,0,0,0,0,45716
14830,802,181,341,234,34,12,68,3,0,0,0,0,3,3,0,2,1,0,0,0,0,65,24,0,21,3,41,29,0,19,10,12,0,12,0,45719
14831,11,0,11,0,0,0,0,0,0,0,0,0,0,0,0,0,0,0,0,0,0,0,0,0,0,0,0,0,0,0,0,0,0,0,0,45721
14832,2697,366,1297,748,164,122,271,165,155,0,0,155,10,10,7,0,3,0,0,0,0,106,106,16,15,75,0,0,0,0,0,0,0,0,0,45723
14833,1389,210,592,423,82,82,80,0,0,0,0,0,0,0,0,0,0,0,0,0,0,80,80,59,0,21,0,0,0,0,0,0,0,0,0,45724
14834,307,28,197,69,6,7,45,21,18,0,0,18,3,3,0,0,3,0,0,0,0,24,22,22,0,0,2,0,0,0,0,2,0,2,0,45727
14835,956,76,404,350,97,29,37,21,14,0,0,14,7,7,7,0,0,0,0,0,0,16,16,0,0,16,0,0,0,0,0,0,0,0,0,45729
14836,2880,478,1238,869,169,126,299,127,92,18,7,67,35,33,11,9,13,2,0,0,2,172,124,32,40,52,48,31,9,12,10,17,8,0,9,45732
14837,437,38,318,70,4,7,24,24,9,0,0,9,15,15,15,0,0,0,0,0,0,0,0,0,0,0,0,0,0,0,0,0,0,0,0,45734
14838,1454,133,586,419,216,100,17,0,0,0,0,0,0,0,0,0,0,0,0,0,0,17,17,0,0,17,0,0,0,0,0,0,0,0,0,45735
14839,350,38,172,92,34,14,21,21,21,13,0,8,0,0,0,0,0,0,0,0,0,0,0,0,0,0,0,0,0,0,0,0,0,0,0,45740
14840,688,227,199,250,0,12,20,0,0,0,0,0,0,0,0,0,0,0,0,0,0,20,15,0,0,15,5,5,0,0,5,0,0,0,0,45741
14841,2261,147,897,837,311,69,89,76,76,0,31,45,0,0,0,0,0,0,0,0,0,13,13,0,0,13,0,0,0,0,0,0,0,0,0,45742
14842,888,130,415,264,55,24,62,18,0,0,0,0,18,18,18,0,0,0,0,0,0,44,44,25,19,0,0,0,0,0,0,0,0,0,0,45743
14843,1810,249,899,398,202,62,82,62,59,15,11,33,3,0,0,0,0,3,0,0,3,20,20,14,0,6,0,0,0,0,0,0,0,0,0,45744
14844,1098,121,596,278,74,29,44,25,5,0,0,5,20,20,20,0,0,0,0,0,0,19,19,4,0,15,0,0,0,0,0,0,0,0,0,45745
14845,257,90,147,19,1,0,2,2,2,0,0,2,0,0,0,0,0,0,0,0,0,0,0,0,0,0,0,0,0,0,0,0,0,0,0,45746
14846,18786,1997,7266,5593,2556,1374,1788,983,901,220,51,630,82,70,64,0,6,12,0,11,1,805,647,161,66,420,158,142,25,0,117,16,15,0,1,45750
14847,2813,579,1258,744,127,105,173,63,54,4,0,50,9,9,9,0,0,0,0,0,0,110,90,11,46,33,20,0,0,0,0,20,0,0,20,45760
14848,1329,184,439,444,119,143,98,59,59,0,0,59,0,0,0,0,0,0,0,0,0,39,39,26,0,13,0,0,0,0,0,0,0,0,0,45761
14849,5597,991,2129,1971,249,257,881,521,474,68,79,327,47,24,5,19,0,23,0,0,23,360,321,119,72,130,39,39,5,0,34,0,0,0,0,45764
14850,857,101,341,228,122,65,65,0,0,0,0,0,0,0,0,0,0,0,0,0,0,65,65,0,0,65,0,0,0,0,0,0,0,0,0,45766
14851,2004,396,1143,351,96,18,44,25,25,0,8,17,0,0,0,0,0,0,0,0,0,19,10,8,0,2,9,9,4,5,0,0,0,0,0,45767
14852,1192,91,601,324,149,27,62,48,48,29,0,19,0,0,0,0,0,0,0,0,0,14,14,0,0,14,0,0,0,0,0,0,0,0,0,45768
14853,4592,701,2100,1156,442,193,196,92,60,2,27,31,32,26,11,15,0,6,0,5,1,104,89,10,13,66,15,15,6,0,9,0,0,0,0,45769
14854,307,54,116,92,29,16,18,18,18,0,0,18,0,0,0,0,0,0,0,0,0,0,0,0,0,0,0,0,0,0,0,0,0,0,0,45770
14855,2425,297,1092,790,149,97,257,165,163,75,11,77,2,0,0,0,0,2,0,0,2,92,75,21,0,54,17,9,9,0,0,8,0,0,8,45771
14856,1459,330,629,268,124,108,126,93,69,0,0,69,24,0,0,0,0,24,0,0,24,33,33,16,17,0,0,0,0,0,0,0,0,0,0,45772
14857,116,42,61,13,0,0,22,0,0,0,0,0,0,0,0,0,0,0,0,0,0,22,22,0,0,22,0,0,0,0,0,0,0,0,0,45773
14858,836,135,427,217,42,15,107,44,34,14,0,20,10,0,0,0,0,10,0,0,10,63,63,13,0,50,0,0,0,0,0,0,0,0,0,45775
14859,482,37,192,90,97,66,7,7,7,7,0,0,0,0,0,0,0,0,0,0,0,0,0,0,0,0,0,0,0,0,0,0,0,0,0,45776
14860,507,85,236,112,25,49,13,13,13,0,0,13,0,0,0,0,0,0,0,0,0,0,0,0,0,0,0,0,0,0,0,0,0,0,0,45778
14861,448,63,164,178,23,20,57,28,21,0,0,21,7,5,5,0,0,2,2,0,0,29,29,6,9,14,0,0,0,0,0,0,0,0,0,45779
14862,2273,221,732,770,304,246,92,19,19,2,0,17,0,0,0,0,0,0,0,0,0,73,13,0,0,13,60,24,0,0,24,36,0,0,36,45780
14863,259,64,114,68,8,5,22,13,13,2,4,7,0,0,0,0,0,0,0,0,0,9,6,2,0,4,3,0,0,0,0,3,0,0,3,45782
14864,2267,230,1011,738,173,115,183,98,88,14,0,74,10,10,0,10,0,0,0,0,0,85,85,0,36,49,0,0,0,0,0,0,0,0,0,45784
14865,2393,166,1187,703,227,110,269,114,100,26,0,74,14,14,14,0,0,0,0,0,0,155,138,9,0,129,17,6,0,0,6,11,0,0,11,45786
14866,0,0,0,0,0,0,0,0,0,0,0,0,0,0,0,0,0,0,0,0,0,0,0,0,0,0,0,0,0,0,0,0,0,0,0,45787
14867,822,123,384,218,77,20,90,52,52,6,0,46,0,0,0,0,0,0,0,0,0,38,38,24,14,0,0,0,0,0,0,0,0,0,0,45788
14868,127,36,61,18,12,0,0,0,0,0,0,0,0,0,0,0,0,0,0,0,0,0,0,0,0,0,0,0,0,0,0,0,0,0,0,45789
14869,15678,2301,6390,5296,996,695,1514,971,733,311,141,281,238,186,104,61,21,52,19,9,24,543,447,205,72,170,96,52,43,0,9,44,26,8,10,45801
14870,9307,2144,3902,2501,421,339,991,356,318,23,102,193,38,15,0,15,0,23,0,0,23,635,561,120,55,386,74,26,0,6,20,48,26,0,22,45804
14871,15282,1320,5072,5203,2182,1505,1730,1139,1032,307,155,570,107,78,38,36,4,29,0,29,0,591,541,268,122,151,50,50,19,0,31,0,0,0,0,45805
14872,7724,754,3276,2207,936,551,456,269,241,124,17,100,28,28,14,0,14,0,0,0,0,187,180,74,23,83,7,7,7,0,0,0,0,0,0,45806
14873,8213,580,3507,2716,848,562,742,398,355,134,14,207,43,36,36,0,0,7,0,0,7,344,327,132,22,173,17,17,0,0,17,0,0,0,0,45807
14874,265,38,136,74,14,3,23,10,10,6,0,4,0,0,0,0,0,0,0,0,0,13,13,3,8,2,0,0,0,0,0,0,0,0,0,45808
14875,48,4,31,13,0,0,0,0,0,0,0,0,0,0,0,0,0,0,0,0,0,0,0,0,0,0,0,0,0,0,0,0,0,0,0,45809
14876,3776,362,1421,947,504,542,1238,605,553,252,35,266,52,32,3,29,0,20,0,0,20,633,607,211,47,349,26,26,3,0,23,0,0,0,0,45810
14877,1095,218,491,282,59,45,89,59,50,16,6,28,9,9,7,2,0,0,0,0,0,30,1,0,0,1,29,10,7,3,0,19,0,9,10,45812
14878,2499,197,1221,699,201,181,139,49,49,11,9,29,0,0,0,0,0,0,0,0,0,90,90,30,0,60,0,0,0,0,0,0,0,0,0,45813
14879,1733,101,773,512,313,34,196,60,47,18,2,27,13,13,13,0,0,0,0,0,0,136,136,71,13,52,0,0,0,0,0,0,0,0,0,45814
14880,270,17,114,112,3,24,17,11,11,0,0,11,0,0,0,0,0,0,0,0,0,6,3,0,0,3,3,0,0,0,0,3,0,0,3,45816
14881,4387,225,1701,907,876,678,558,267,259,49,62,148,8,8,8,0,0,0,0,0,0,291,291,175,44,72,0,0,0,0,0,0,0,0,0,45817
14882,156,10,77,62,2,5,8,5,5,0,2,3,0,0,0,0,0,0,0,0,0,3,2,1,1,0,1,1,1,0,0,0,0,0,0,45819
14883,300,24,120,111,38,7,31,13,10,0,0,10,3,0,0,0,0,3,3,0,0,18,18,8,5,5,0,0,0,0,0,0,0,0,0,45820
14884,1155,128,661,223,96,47,85,44,31,0,0,31,13,13,1,8,4,0,0,0,0,41,41,0,0,41,0,0,0,0,0,0,0,0,0,45821
14885,13355,1320,6000,3832,1238,965,1192,642,532,135,67,330,110,84,34,41,9,26,21,5,0,550,493,179,70,244,57,34,0,10,24,23,0,23,0,45822
14886,264,24,141,46,38,15,15,10,10,4,5,1,0,0,0,0,0,0,0,0,0,5,5,5,0,0,0,0,0,0,0,0,0,0,0,45826
14887,1334,81,574,378,157,144,71,28,27,8,0,19,1,1,1,0,0,0,0,0,0,43,43,14,0,29,0,0,0,0,0,0,0,0,0,45827
14888,4056,333,2067,940,405,311,449,246,222,73,42,107,24,24,24,0,0,0,0,0,0,203,186,42,0,144,17,0,0,0,0,17,17,0,0,45828
14889,4114,191,1937,1348,354,284,475,267,251,147,38,66,16,16,6,0,10,0,0,0,0,208,173,54,23,96,35,35,17,0,18,0,0,0,0,45830
14890,2192,343,1021,591,176,61,316,177,169,18,16,135,8,8,0,8,0,0,0,0,0,139,115,47,61,7,24,20,20,0,0,4,4,0,0,45831
14891,2060,93,1076,606,173,112,201,136,102,28,4,70,34,31,31,0,0,3,0,0,3,65,65,30,12,23,0,0,0,0,0,0,0,0,0,45832
14892,7233,632,3067,2342,678,514,630,282,246,85,53,108,36,33,7,26,0,3,0,3,0,348,306,56,87,163,42,42,42,0,0,0,0,0,0,45833
14893,302,41,155,42,43,21,0,0,0,0,0,0,0,0,0,0,0,0,0,0,0,0,0,0,0,0,0,0,0,0,0,0,0,0,0,45835
14894,1018,79,509,262,99,69,88,46,46,5,10,31,0,0,0,0,0,0,0,0,0,42,41,6,8,27,1,0,0,0,0,1,0,0,1,45836
14895,16,2,10,2,2,0,3,1,1,0,1,0,0,0,0,0,0,0,0,0,0,2,2,1,0,1,0,0,0,0,0,0,0,0,0,45838
14896,36649,3202,12190,10982,6658,3617,3311,1611,1350,445,170,735,261,234,82,100,52,27,16,0,11,1700,1595,526,380,689,105,91,48,20,23,14,6,0,8,45840
14897,513,29,225,140,99,20,52,26,26,22,2,2,0,0,0,0,0,0,0,0,0,26,18,1,0,17,8,8,8,0,0,0,0,0,0,45841
14898,2756,297,1361,743,176,179,159,62,46,0,11,35,16,10,10,0,0,6,0,6,0,97,93,34,7,52,4,4,4,0,0,0,0,0,0,45843
14899,2206,129,997,666,271,143,96,53,53,9,1,43,0,0,0,0,0,0,0,0,0,43,43,19,0,24,0,0,0,0,0,0,0,0,0,45844
14900,1743,157,939,345,169,133,189,86,86,28,0,58,0,0,0,0,0,0,0,0,0,103,103,17,6,80,0,0,0,0,0,0,0,0,0,45845
14901,2488,232,1348,573,199,136,279,107,94,8,29,57,13,13,12,1,0,0,0,0,0,172,155,53,46,56,17,9,0,9,0,8,0,0,8,45846
14902,818,79,468,208,28,35,103,53,33,9,3,21,20,20,20,0,0,0,0,0,0,50,49,0,0,49,1,1,0,0,1,0,0,0,0,45849
14903,2443,240,1143,742,236,82,240,78,62,15,5,42,16,16,16,0,0,0,0,0,0,162,112,22,0,90,50,31,15,0,16,19,9,0,10,45850
14904,379,59,237,29,38,16,42,18,16,0,0,16,2,2,2,0,0,0,0,0,0,24,24,0,0,24,0,0,0,0,0,0,0,0,0,45851
14905,868,113,272,208,162,113,71,42,39,28,0,11,3,0,0,0,0,3,3,0,0,29,29,10,19,0,0,0,0,0,0,0,0,0,0,45853
14906,358,30,187,108,11,22,11,10,3,2,0,1,7,7,7,0,0,0,0,0,0,1,1,1,0,0,0,0,0,0,0,0,0,0,0,45854
14907,131,26,68,22,13,2,8,1,1,1,0,0,0,0,0,0,0,0,0,0,0,7,7,2,0,5,0,0,0,0,0,0,0,0,0,45855
14908,3450,347,1794,808,327,174,237,135,109,34,13,62,26,18,13,5,0,8,0,8,0,102,102,48,0,54,0,0,0,0,0,0,0,0,0,45856
14909,2124,120,956,722,218,108,248,175,156,79,10,67,19,17,14,0,3,2,2,0,0,73,66,31,4,31,7,7,7,0,0,0,0,0,0,45858
14910,294,79,151,49,9,6,16,15,10,1,4,5,5,2,0,0,2,3,0,0,3,1,1,1,0,0,0,0,0,0,0,0,0,0,0,45859
14911,1151,58,564,268,147,114,98,0,0,0,0,0,0,0,0,0,0,0,0,0,0,98,98,27,0,71,0,0,0,0,0,0,0,0,0,45860
14912,99,25,64,10,0,0,26,8,4,0,0,4,4,4,0,4,0,0,0,0,0,18,9,0,0,9,9,9,0,0,9,0,0,0,0,45861
14913,1073,147,565,243,80,38,72,43,43,6,0,37,0,0,0,0,0,0,0,0,0,29,26,8,3,15,3,0,0,0,0,3,0,3,0,45862
14914,680,108,330,205,11,26,44,14,13,0,0,13,1,1,0,0,1,0,0,0,0,30,30,0,10,20,0,0,0,0,0,0,0,0,0,45863
14915,96,6,51,26,9,4,10,1,1,0,0,1,0,0,0,0,0,0,0,0,0,9,9,7,0,2,0,0,0,0,0,0,0,0,0,45864
14916,3388,299,1407,859,590,233,287,160,123,75,0,48,37,37,37,0,0,0,0,0,0,127,116,38,16,62,11,11,0,0,11,0,0,0,0,45865
14917,187,36,97,40,14,0,18,6,6,0,2,4,0,0,0,0,0,0,0,0,0,12,12,0,0,12,0,0,0,0,0,0,0,0,0,45866
14918,638,28,307,129,100,74,60,12,12,1,0,11,0,0,0,0,0,0,0,0,0,48,43,35,0,8,5,5,0,5,0,0,0,0,0,45867
14919,335,35,188,59,48,5,23,2,2,0,0,2,0,0,0,0,0,0,0,0,0,21,21,21,0,0,0,0,0,0,0,0,0,0,0,45868
14920,2953,141,1190,859,446,317,240,157,129,50,22,57,28,28,28,0,0,0,0,0,0,83,77,26,0,51,6,6,3,3,0,0,0,0,0,45869
14921,58,0,4,8,5,41,5,0,0,0,0,0,0,0,0,0,0,0,0,0,0,5,5,0,0,5,0,0,0,0,0,0,0,0,0,45870
14922,1276,63,536,378,221,78,98,49,49,32,0,17,0,0,0,0,0,0,0,0,0,49,40,8,13,19,9,0,0,0,0,9,0,0,9,45871
14923,2873,286,1352,846,325,64,153,99,80,7,11,62,19,19,16,3,0,0,0,0,0,54,54,22,15,17,0,0,0,0,0,0,0,0,0,45872
14924,1423,231,645,418,86,43,100,43,27,8,0,19,16,16,7,9,0,0,0,0,0,57,38,12,14,12,19,10,0,10,0,9,0,0,9,45873
14925,1459,131,796,338,125,69,76,35,35,10,0,25,0,0,0,0,0,0,0,0,0,41,41,12,0,29,0,0,0,0,0,0,0,0,0,45874
14926,7471,554,2886,2186,1299,546,573,227,189,82,2,105,38,38,24,14,0,0,0,0,0,346,311,183,14,114,35,25,7,0,18,10,0,10,0,45875
14927,518,32,164,200,87,35,56,26,24,6,4,14,2,2,2,0,0,0,0,0,0,30,30,17,0,13,0,0,0,0,0,0,0,0,0,45876
14928,1450,117,558,446,213,116,103,62,57,49,0,8,5,5,5,0,0,0,0,0,0,41,38,15,0,23,3,3,0,3,0,0,0,0,0,45877
14929,4050,454,1901,1140,334,221,407,241,196,73,0,123,45,34,34,0,0,11,11,0,0,166,145,48,37,60,21,21,21,0,0,0,0,0,0,45879
14930,1628,173,853,449,95,58,70,38,38,8,0,30,0,0,0,0,0,0,0,0,0,32,15,0,0,15,17,17,0,17,0,0,0,0,0,45880
14931,1177,103,506,311,191,66,86,58,56,13,0,43,2,2,0,2,0,0,0,0,0,28,28,6,5,17,0,0,0,0,0,0,0,0,0,45881
14932,1897,164,923,538,167,105,161,78,78,22,0,56,0,0,0,0,0,0,0,0,0,83,74,12,0,62,9,9,9,0,0,0,0,0,0,45882
14933,2449,203,1216,631,313,86,213,153,140,64,14,62,13,10,5,5,0,3,3,0,0,60,50,30,3,17,10,10,10,0,0,0,0,0,0,45883
14934,119,33,55,31,0,0,0,0,0,0,0,0,0,0,0,0,0,0,0,0,0,0,0,0,0,0,0,0,0,0,0,0,0,0,0,45884
14935,8759,1030,3632,2669,831,597,580,341,326,109,21,196,15,15,0,4,11,0,0,0,0,239,193,77,69,47,46,46,30,16,0,0,0,0,0,45885
14936,456,64,221,135,17,19,29,12,10,3,2,5,2,2,2,0,0,0,0,0,0,17,17,2,2,13,0,0,0,0,0,0,0,0,0,45886
14937,3142,255,1589,794,380,124,186,95,77,17,17,43,18,13,13,0,0,5,0,0,5,91,59,24,5,30,32,32,16,0,16,0,0,0,0,45887
14938,157,11,73,66,4,3,0,0,0,0,0,0,0,0,0,0,0,0,0,0,0,0,0,0,0,0,0,0,0,0,0,0,0,0,0,45888
14939,856,81,348,225,97,105,74,56,53,18,6,29,3,3,3,0,0,0,0,0,0,18,15,11,0,4,3,3,3,0,0,0,0,0,0,45889
14940,519,40,242,186,29,22,66,38,29,16,0,13,9,9,9,0,0,0,0,0,0,28,28,8,12,8,0,0,0,0,0,0,0,0,0,45890
14941,10407,1041,4832,2766,1116,652,631,313,276,114,16,146,37,27,22,5,0,10,0,3,7,318,268,118,23,127,50,37,12,25,0,13,6,0,7,45891
14942,386,41,206,76,43,20,46,20,14,0,11,3,6,0,0,0,0,6,6,0,0,26,26,12,14,0,0,0,0,0,0,0,0,0,0,45894
14943,12143,962,5518,3911,1017,735,951,498,418,128,55,235,80,63,48,15,0,17,11,0,6,453,379,187,6,186,74,61,37,24,0,13,5,0,8,45895
14944,1481,83,765,475,106,52,158,92,65,25,3,37,27,27,0,27,0,0,0,0,0,66,58,12,0,46,8,8,8,0,0,0,0,0,0,45896
14945,102,76,13,13,0,0,0,0,0,0,0,0,0,0,0,0,0,0,0,0,0,0,0,0,0,0,0,0,0,0,0,0,0,0,0,45897
14946,907,59,464,263,102,19,73,31,31,27,0,4,0,0,0,0,0,0,0,0,0,42,34,13,0,21,8,3,0,0,3,5,2,0,3,45898
14947,224,26,98,83,11,6,14,7,7,0,0,7,0,0,0,0,0,0,0,0,0,7,7,4,0,3,0,0,0,0,0,0,0,0,0,45899
14948,7396,1060,2854,2454,690,338,439,196,186,43,37,106,10,10,10,0,0,0,0,0,0,243,234,42,40,152,9,9,0,9,0,0,0,0,0,46001
14949,11820,1094,4516,3453,1744,1013,817,472,406,98,45,263,66,57,52,0,5,9,9,0,0,345,287,73,33,181,58,38,25,13,0,20,7,0,13,46011
14950,13262,1388,4815,4182,1916,961,1376,601,493,174,21,298,108,48,18,23,7,60,9,15,36,775,638,147,176,315,137,36,23,3,10,101,0,25,76,46012
14951,12609,1388,5284,4015,1279,643,804,450,280,95,36,149,170,123,31,44,48,47,47,0,0,354,206,119,0,87,148,77,48,0,29,71,13,26,32,46013
14952,11817,3079,4888,3152,548,150,1004,560,405,84,39,282,155,41,19,5,17,114,11,4,99,444,311,47,80,184,133,59,19,0,40,74,0,15,59,46016
14953,4160,406,1883,1312,367,192,272,166,116,40,31,45,50,39,12,27,0,11,0,0,11,106,49,18,6,25,57,22,22,0,0,35,0,0,35,46017
14954,2155,272,1001,590,184,108,152,79,47,26,3,18,32,14,4,0,10,18,0,0,18,73,55,29,0,26,18,10,0,10,0,8,0,0,8,46030
14955,1483,110,654,490,173,56,220,87,78,20,0,58,9,0,0,0,0,9,9,0,0,133,119,36,0,83,14,14,10,0,4,0,0,0,0,46031
14956,28370,523,3347,6273,10266,7961,2248,1064,1049,300,67,682,15,15,0,15,0,0,0,0,0,1184,1142,393,68,681,42,40,26,14,0,2,0,0,2,46032
14957,22796,350,2193,4177,9294,6782,2311,1123,1016,309,72,635,107,84,64,8,12,23,0,0,23,1188,1086,481,107,498,102,73,55,0,18,29,12,0,17,46033
14958,4875,362,1616,1543,1023,331,421,187,187,47,0,140,0,0,0,0,0,0,0,0,0,234,219,17,32,170,15,15,0,15,0,0,0,0,0,46034
14959,804,62,444,242,32,24,57,31,31,2,0,29,0,0,0,0,0,0,0,0,0,26,22,0,0,22,4,0,0,0,0,4,0,0,4,46035
14960,7876,1216,3730,2028,633,269,550,242,190,18,0,172,52,16,0,16,0,36,4,32,0,308,243,15,54,174,65,52,52,0,0,13,13,0,0,46036
14961,22595,585,2453,5246,9345,4966,2095,816,650,40,278,332,166,124,82,22,20,42,0,0,42,1279,1191,186,43,962,88,77,39,0,38,11,0,0,11,46037
14962,25096,521,3600,7305,9717,3953,1987,1010,862,325,41,496,148,111,82,0,29,37,0,0,37,977,867,263,30,574,110,47,15,32,0,63,0,0,63,46038
14963,542,17,187,107,190,41,75,34,8,0,0,8,26,26,0,0,26,0,0,0,0,41,41,41,0,0,0,0,0,0,0,0,0,0,0,46039
14964,7589,694,2412,1912,1777,794,781,312,196,5,59,132,116,104,67,0,37,12,0,0,12,469,469,107,12,350,0,0,0,0,0,0,0,0,0,46040
14965,15189,2689,7262,3515,1057,666,1219,602,494,140,17,337,108,108,108,0,0,0,0,0,0,617,424,154,37,233,193,146,86,25,35,47,0,0,47,46041
14966,1804,147,909,515,176,57,142,78,78,4,7,67,0,0,0,0,0,0,0,0,0,64,64,39,0,25,0,0,0,0,0,0,0,0,0,46044
14967,123,0,47,64,12,0,18,0,0,0,0,0,0,0,0,0,0,0,0,0,0,18,0,0,0,0,18,18,18,0,0,0,0,0,0,46045
14968,22,0,0,22,0,0,0,0,0,0,0,0,0,0,0,0,0,0,0,0,0,0,0,0,0,0,0,0,0,0,0,0,0,0,0,46047
14969,1312,177,569,429,110,27,69,44,44,28,6,10,0,0,0,0,0,0,0,0,0,25,17,12,0,5,8,8,8,0,0,0,0,0,0,46048
14970,650,56,385,154,48,7,55,7,7,0,0,7,0,0,0,0,0,0,0,0,0,48,48,1,0,47,0,0,0,0,0,0,0,0,0,46049
14971,1280,133,675,280,165,27,93,56,56,33,0,23,0,0,0,0,0,0,0,0,0,37,34,10,0,24,3,0,0,0,0,3,0,0,3,46050
14972,2204,127,995,551,405,126,138,53,46,17,0,29,7,4,0,4,0,3,3,0,0,85,72,34,17,21,13,13,8,0,5,0,0,0,0,46051
14973,14843,1600,6162,3927,2180,974,1089,587,487,125,35,327,100,57,0,19,38,43,41,0,2,502,391,112,30,249,111,68,7,17,44,43,14,0,29,46052
14974,6308,192,1257,2052,2046,761,547,309,309,19,16,274,0,0,0,0,0,0,0,0,0,238,186,22,29,135,52,0,0,0,0,52,0,0,52,46055
14975,1418,191,550,473,100,104,103,67,59,29,14,16,8,2,0,0,2,6,0,6,0,36,32,20,0,12,4,4,4,0,0,0,0,0,0,46056
14976,603,56,288,212,27,20,49,32,32,2,0,30,0,0,0,0,0,0,0,0,0,17,17,0,4,13,0,0,0,0,0,0,0,0,0,46057
14977,1452,197,539,457,166,93,60,21,21,0,0,21,0,0,0,0,0,0,0,0,0,39,24,3,7,14,15,8,0,8,0,7,0,0,7,46058
14978,22562,1548,5216,5883,6848,3067,1821,1044,854,389,6,459,190,108,104,0,4,82,13,46,23,777,643,245,47,351,134,75,0,0,75,59,0,24,35,46060
14979,20225,1058,4385,6119,6076,2587,1601,893,681,241,56,384,212,106,106,0,0,106,0,0,106,708,685,327,0,358,23,23,0,0,23,0,0,0,0,46062
14980,326,41,124,119,40,2,23,10,10,0,8,2,0,0,0,0,0,0,0,0,0,13,13,6,0,7,0,0,0,0,0,0,0,0,0,46063
14981,10948,999,3753,3422,1944,830,829,465,402,152,7,243,63,20,15,0,5,43,0,0,43,364,309,113,18,178,55,55,40,15,0,0,0,0,0,46064
14982,2283,171,1057,688,293,74,313,218,157,16,0,141,61,61,0,61,0,0,0,0,0,95,80,35,0,45,15,10,10,0,0,5,5,0,0,46065
14983,1881,240,890,460,200,91,78,45,42,6,0,36,3,3,3,0,0,0,0,0,0,33,25,8,10,7,8,8,8,0,0,0,0,0,0,46068
14984,4691,423,1980,1453,576,259,522,329,302,70,0,232,27,16,16,0,0,11,5,0,6,193,181,70,38,73,12,0,0,0,0,12,0,12,0,46069
14985,1511,156,702,415,191,47,84,10,10,0,0,10,0,0,0,0,0,0,0,0,0,74,45,7,4,34,29,29,0,15,14,0,0,0,0,46070
14986,2569,238,1048,792,298,193,290,166,148,66,0,82,18,18,0,18,0,0,0,0,0,124,121,28,32,61,3,3,3,0,0,0,0,0,0,46071
14987,6556,789,2433,2202,765,367,459,289,264,64,18,182,25,11,11,0,0,14,0,0,14,170,162,86,0,76,8,8,8,0,0,0,0,0,0,46072
14988,17217,784,2262,3793,6468,3910,1324,816,737,199,47,491,79,49,49,0,0,30,30,0,0,508,508,155,28,325,0,0,0,0,0,0,0,0,0,46074
14989,2085,66,611,560,526,322,134,74,72,3,0,69,2,0,0,0,0,2,0,2,0,60,51,10,0,41,9,9,9,0,0,0,0,0,0,46075
14990,1256,177,553,325,109,92,61,18,16,0,0,16,2,0,0,0,0,2,2,0,0,43,28,0,0,28,15,15,2,0,13,0,0,0,0,46076
14991,15986,293,1536,3150,5871,5136,1336,619,554,230,16,308,65,52,33,19,0,13,0,0,13,717,675,149,55,471,42,19,0,0,19,23,10,0,13,46077
14992,146,7,67,46,26,0,21,14,12,4,0,8,2,2,2,0,0,0,0,0,0,7,7,6,0,1,0,0,0,0,0,0,0,0,0,46103
14993,599,53,309,122,95,20,56,30,30,0,8,22,0,0,0,0,0,0,0,0,0,26,26,0,0,26,0,0,0,0,0,0,0,0,0,46104
14994,1289,244,566,377,86,16,158,81,69,0,18,51,12,0,0,0,0,12,12,0,0,77,57,12,0,45,20,0,0,0,0,20,0,0,20,46105
14995,4090,248,1640,956,910,336,149,87,87,10,11,66,0,0,0,0,0,0,0,0,0,62,62,38,13,11,0,0,0,0,0,0,0,0,0,46106
14996,8332,1009,3373,2599,900,451,599,337,262,58,43,161,75,45,23,0,22,30,17,13,0,262,231,34,29,168,31,18,11,7,0,13,0,13,0,46107
14997,362,20,199,93,39,11,18,18,18,0,0,18,0,0,0,0,0,0,0,0,0,0,0,0,0,0,0,0,0,0,0,0,0,0,0,46110
14998,278,55,135,65,21,2,6,2,2,0,0,2,0,0,0,0,0,0,0,0,0,4,4,0,0,4,0,0,0,0,0,0,0,0,0,46111
14999,22229,1044,5654,6855,6226,2450,1814,1078,991,312,68,611,87,26,18,8,0,61,0,12,49,736,645,161,24,460,91,79,24,0,55,12,0,0,12,46112
15000,8950,711,3510,3120,1208,401,833,428,375,12,0,363,53,53,27,0,26,0,0,0,0,405,384,83,0,301,21,21,21,0,0,0,0,0,0,46113
15001,1312,143,653,296,119,101,112,75,47,11,17,19,28,15,15,0,0,13,0,5,8,37,33,21,2,10,4,2,2,0,0,2,0,0,2,46115
15002,370,33,142,154,27,14,0,0,0,0,0,0,0,0,0,0,0,0,0,0,0,0,0,0,0,0,0,0,0,0,0,0,0,0,0,46117
15003,3608,379,1717,981,445,86,328,147,129,43,0,86,18,15,15,0,0,3,0,0,3,181,145,25,18,102,36,36,0,0,36,0,0,0,0,46118
15004,4276,602,1948,1013,459,254,287,165,108,8,23,77,57,0,0,0,0,57,21,36,0,122,86,20,0,66,36,36,0,0,36,0,0,0,0,46120
15005,3680,406,1786,1024,292,172,345,158,142,40,30,72,16,16,0,16,0,0,0,0,0,187,106,32,0,74,81,0,0,0,0,81,0,0,81,46121
15006,9802,775,3297,3229,1764,737,830,488,424,82,21,321,64,38,11,27,0,26,26,0,0,342,274,76,0,198,68,56,0,23,33,12,12,0,0,46122
15007,20166,985,5501,6225,5241,2214,2412,1393,1089,290,49,750,304,254,91,0,163,50,10,0,40,1019,851,373,43,435,168,156,130,8,18,12,0,0,12,46123
15008,5192,983,2177,1266,488,278,400,125,101,26,0,75,24,9,0,9,0,15,0,0,15,275,230,139,0,91,45,15,15,0,0,30,9,0,21,46124
15009,48,0,9,24,15,0,0,0,0,0,0,0,0,0,0,0,0,0,0,0,0,0,0,0,0,0,0,0,0,0,0,0,0,0,0,46125
15010,2982,535,1263,820,226,138,158,77,58,8,10,40,19,19,2,17,0,0,0,0,0,81,81,17,9,55,0,0,0,0,0,0,0,0,0,46126
15011,229,26,94,78,24,7,9,0,0,0,0,0,0,0,0,0,0,0,0,0,0,9,9,0,9,0,0,0,0,0,0,0,0,0,0,46127
15012,1195,154,590,340,43,68,114,57,57,32,0,25,0,0,0,0,0,0,0,0,0,57,57,19,0,38,0,0,0,0,0,0,0,0,0,46128
15013,1687,132,536,658,259,102,78,30,23,0,0,23,7,7,0,7,0,0,0,0,0,48,48,30,0,18,0,0,0,0,0,0,0,0,0,46130
15014,19890,2132,7373,6035,2894,1456,1791,880,729,210,39,480,151,65,53,0,12,86,0,41,45,911,734,334,96,304,177,109,65,21,23,68,47,0,21,46131
15015,544,114,304,100,3,23,58,49,47,0,0,47,2,0,0,0,0,2,0,2,0,9,2,0,0,2,7,6,0,6,0,1,0,0,1,46133
15016,12926,2026,4877,3600,1251,1172,1693,874,687,218,52,417,187,141,88,44,9,46,0,0,46,819,745,255,81,409,74,0,0,0,0,74,29,0,45,46135
15017,26374,2426,9822,8067,3656,2403,2108,1104,861,181,114,566,243,103,60,16,27,140,12,63,65,1004,903,344,45,514,101,84,73,0,11,17,0,0,17,46140
15018,19863,1626,6288,5535,4280,2134,1696,791,754,275,32,447,37,37,37,0,0,0,0,0,0,905,861,376,57,428,44,44,44,0,0,0,0,0,0,46142
15019,33037,2431,10299,9892,6890,3525,2738,1434,1368,392,170,806,66,62,50,12,0,4,0,0,4,1304,1084,338,76,670,220,171,81,29,61,49,19,0,30,46143
15020,116,28,47,22,0,19,0,0,0,0,0,0,0,0,0,0,0,0,0,0,0,0,0,0,0,0,0,0,0,0,0,0,0,0,0,46144
15021,56,0,20,10,26,0,0,0,0,0,0,0,0,0,0,0,0,0,0,0,0,0,0,0,0,0,0,0,0,0,0,0,0,0,0,46146
15022,2255,143,994,622,383,113,228,158,131,40,0,91,27,27,12,0,15,0,0,0,0,70,58,25,8,25,12,12,0,0,12,0,0,0,0,46147
15023,3626,403,1787,924,308,204,284,109,102,5,15,82,7,7,7,0,0,0,0,0,0,175,146,38,0,108,29,29,0,29,0,0,0,0,0,46148
15024,1500,100,629,535,210,26,94,38,31,3,1,27,7,0,0,0,0,7,0,0,7,56,56,23,1,32,0,0,0,0,0,0,0,0,0,46149
15025,447,79,174,162,9,23,9,0,0,0,0,0,0,0,0,0,0,0,0,0,0,9,9,9,0,0,0,0,0,0,0,0,0,0,0,46150
15026,20797,2904,8451,5860,2209,1373,1640,884,647,281,74,292,237,75,75,0,0,162,73,31,58,756,724,261,28,435,32,31,21,10,0,1,1,0,0,46151
15027,97,10,32,39,0,16,13,13,13,0,0,13,0,0,0,0,0,0,0,0,0,0,0,0,0,0,0,0,0,0,0,0,0,0,0,46155
15028,1010,211,534,215,40,10,50,38,38,0,16,22,0,0,0,0,0,0,0,0,0,12,12,5,0,7,0,0,0,0,0,0,0,0,0,46156
15029,2467,276,1082,725,273,111,239,124,111,5,10,96,13,13,13,0,0,0,0,0,0,115,104,87,0,17,11,11,11,0,0,0,0,0,0,46157
15030,15757,1824,6271,5146,1823,693,1172,650,545,262,16,267,105,20,10,10,0,85,0,22,63,522,479,203,50,226,43,43,33,10,0,0,0,0,0,46158
15031,4528,827,1615,1397,413,276,366,140,140,20,22,98,0,0,0,0,0,0,0,0,0,226,156,45,11,100,70,29,0,0,29,41,41,0,0,46160
15032,1829,229,816,525,204,55,123,85,76,16,9,51,9,0,0,0,0,9,9,0,0,38,33,13,0,20,5,5,0,5,0,0,0,0,0,46161
15033,218,16,38,120,44,0,7,7,7,0,0,7,0,0,0,0,0,0,0,0,0,0,0,0,0,0,0,0,0,0,0,0,0,0,0,46162
15034,7859,227,2532,2669,1540,891,603,328,276,81,13,182,52,48,36,12,0,4,4,0,0,275,275,121,14,140,0,0,0,0,0,0,0,0,0,46163
15035,3066,323,1366,864,285,228,218,131,108,31,5,72,23,17,0,17,0,6,6,0,0,87,85,11,0,74,2,2,0,2,0,0,0,0,0,46164
15036,1016,73,468,277,138,60,59,44,38,10,0,28,6,3,0,3,0,3,0,3,0,15,15,7,0,8,0,0,0,0,0,0,0,0,0,46165
15037,1455,288,750,347,43,27,152,67,48,0,0,48,19,13,7,6,0,6,0,0,6,85,62,17,0,45,23,11,11,0,0,12,0,12,0,46166
15038,4188,243,1481,1235,892,337,442,211,200,66,0,134,11,4,0,0,4,7,3,0,4,231,181,84,11,86,50,44,0,0,44,6,0,0,6,46167
15039,21234,1898,7112,6255,4149,1820,1571,752,670,146,62,462,82,60,55,0,5,22,0,0,22,819,793,204,60,529,26,25,9,0,16,1,0,0,1,46168
15040,1229,132,525,398,92,82,149,89,89,0,0,89,0,0,0,0,0,0,0,0,0,60,60,0,0,60,0,0,0,0,0,0,0,0,0,46171
15041,1642,202,670,575,77,118,108,48,48,13,0,35,0,0,0,0,0,0,0,0,0,60,60,24,0,36,0,0,0,0,0,0,0,0,0,46172
15042,7690,954,3763,1715,774,484,697,327,220,49,7,164,107,75,75,0,0,32,13,0,19,370,264,63,19,182,106,71,36,0,35,35,0,18,17,46173
15043,456,73,234,108,21,20,96,84,35,4,0,31,49,45,0,45,0,4,0,0,4,12,12,0,0,12,0,0,0,0,0,0,0,0,0,46175
15044,18655,2933,7955,5132,1806,829,1581,863,647,231,17,399,216,112,99,8,5,104,46,13,45,718,502,100,0,402,216,111,61,45,5,105,0,46,59,46176
15045,699,70,352,169,87,21,129,77,77,17,10,50,0,0,0,0,0,0,0,0,0,52,43,18,0,25,9,0,0,0,0,9,0,0,9,46180
15046,3046,270,1226,965,342,243,125,99,96,19,24,53,3,3,3,0,0,0,0,0,0,26,22,12,0,10,4,1,1,0,0,3,3,0,0,46181
15047,1167,146,491,333,146,51,78,13,10,0,0,10,3,3,3,0,0,0,0,0,0,65,65,36,0,29,0,0,0,0,0,0,0,0,0,46182
15048,100,0,0,100,0,0,103,48,48,0,0,48,0,0,0,0,0,0,0,0,0,55,55,0,0,55,0,0,0,0,0,0,0,0,0,46183
15049,7861,701,3221,2602,1102,235,466,195,164,78,0,86,31,31,16,15,0,0,0,0,0,271,256,109,0,147,15,15,15,0,0,0,0,0,0,46184
15050,1354,110,659,365,161,59,54,8,8,2,1,5,0,0,0,0,0,0,0,0,0,46,33,6,2,25,13,13,0,0,13,0,0,0,0,46186
15051,20044,6403,6275,4611,1957,798,1458,737,508,55,93,360,229,62,28,19,15,167,39,34,94,721,545,46,42,457,176,73,44,0,29,103,27,0,76,46201
15052,11073,1504,2493,2308,2506,2262,1188,478,328,66,29,233,150,56,17,0,39,94,6,23,65,710,556,206,55,295,154,87,24,60,3,67,18,34,15,46202
15053,23835,6921,8993,5292,1874,755,1815,926,602,44,86,472,324,167,77,41,49,157,3,17,137,889,614,76,62,476,275,43,10,0,33,232,0,55,177,46203
15054,4576,874,940,905,910,947,209,141,50,0,0,50,91,72,0,0,72,19,0,0,19,68,54,7,0,47,14,0,0,0,0,14,0,0,14,46204
15055,17760,2681,4489,4919,3759,1912,1438,787,666,58,113,495,121,95,56,26,13,26,17,9,0,651,516,52,76,388,135,47,28,12,7,88,8,20,60,46205
15056,13682,1825,3688,3990,2517,1662,2290,1015,913,214,154,545,102,49,16,9,24,53,0,23,30,1275,1180,389,122,669,95,71,13,29,29,24,0,0,24,46208
15057,15861,2000,4316,5560,2815,1170,1299,582,465,74,96,295,117,12,12,0,0,105,64,0,41,717,606,100,111,395,111,57,0,0,57,54,0,9,45,46214
15058,1273,125,360,380,312,96,47,31,31,0,0,31,0,0,0,0,0,0,0,0,0,16,0,0,0,0,16,16,16,0,0,0,0,0,0,46216
15059,19764,1699,5865,5885,4482,1833,1426,837,761,250,38,473,76,52,41,0,11,24,24,0,0,589,539,222,17,300,50,13,0,13,0,37,37,0,0,46217
15060,19155,4819,7995,4909,1021,411,1529,725,574,61,117,396,151,77,29,29,19,74,18,15,41,804,635,51,191,393,169,67,25,24,18,102,0,47,55,46218
15061,23739,3942,8103,6710,3282,1702,1545,733,581,165,17,399,152,90,51,26,13,62,34,0,28,812,621,111,112,398,191,146,111,29,6,45,25,14,6,46219
15062,25012,954,3850,5398,9037,5773,1193,571,507,136,28,343,64,49,42,7,0,15,0,0,15,622,528,183,36,309,94,45,26,0,19,49,48,0,1,46220
15063,17042,3453,6309,5259,1550,471,1428,788,677,178,108,391,111,103,14,69,20,8,0,0,8,640,570,147,19,404,70,39,8,31,0,31,0,7,24,46221
15064,21098,5782,8084,5135,1540,557,1666,692,564,125,71,368,128,68,45,23,0,60,14,40,6,974,851,161,128,562,123,78,30,0,48,45,0,11,34,46222
15065,22115,5164,7120,6280,2556,995,1685,818,572,105,108,359,246,47,26,0,21,199,56,19,124,867,691,194,154,343,176,65,31,0,34,111,76,0,35,46224
15066,4699,1474,1905,1019,216,85,255,144,122,39,50,33,22,11,11,0,0,11,0,9,2,111,76,2,29,45,35,10,10,0,0,25,14,0,11,46225
15067,28085,5455,9849,8870,2689,1222,2334,1364,1071,308,143,620,293,134,65,22,47,159,100,59,0,970,829,203,257,369,141,51,51,0,0,90,14,42,34,46226
15068,36602,6671,12944,9444,5182,2361,3804,1564,1329,254,218,857,235,87,27,38,22,148,15,11,122,2240,1796,369,159,1268,444,329,213,27,89,115,53,2,60,46227
15069,10009,1065,2180,2713,2330,1721,792,505,452,54,7,391,53,0,0,0,0,53,0,0,53,287,273,38,39,196,14,13,13,0,0,1,0,0,1,46228
15070,17805,2331,6235,6330,2166,743,2109,1027,969,235,92,642,58,41,11,0,30,17,0,0,17,1082,995,207,158,630,87,49,0,19,30,38,15,0,23,46229
15071,6854,579,2297,2290,1312,376,433,229,190,26,44,120,39,39,0,39,0,0,0,0,0,204,190,69,10,111,14,14,0,0,14,0,0,0,0,46231
15072,17659,974,4649,5381,4798,1857,1164,559,541,156,10,375,18,18,0,18,0,0,0,0,0,605,573,61,185,327,32,25,0,6,19,7,7,0,0,46234
15073,17060,3046,4877,6128,2270,739,1990,1111,882,118,82,682,229,63,40,0,23,166,25,126,15,879,647,161,29,457,232,146,125,0,21,86,49,0,37,46235
15074,18748,993,3186,5144,6087,3338,1618,740,734,174,56,504,6,0,0,0,0,6,0,6,0,878,862,359,12,491,16,16,0,16,0,0,0,0,0,46236
15075,26275,2471,7827,8010,5462,2505,1399,740,659,220,57,382,81,81,26,55,0,0,0,0,0,659,576,241,58,277,83,24,17,0,7,59,10,16,33,46237
15076,16285,1413,4719,5131,3489,1533,1464,811,782,267,37,478,29,29,18,0,11,0,0,0,0,653,560,171,123,266,93,93,36,52,5,0,0,0,0,46239
15077,13315,666,2458,3143,4367,2681,745,434,317,105,53,159,117,32,32,0,0,85,0,13,72,311,269,58,0,211,42,42,30,0,12,0,0,0,0,46240
15078,19666,5805,7713,4729,1036,383,1224,784,654,86,47,521,130,92,25,36,31,38,28,10,0,440,371,18,57,296,69,47,13,22,12,22,0,0,22,46241
15079,12868,1019,1850,3447,4627,1925,420,176,166,70,63,33,10,0,0,0,0,10,10,0,0,244,202,46,26,130,42,42,42,0,0,0,0,0,0,46250
15080,22549,3098,5454,7492,4193,2312,2233,1027,697,201,53,443,330,168,96,0,72,162,48,114,0,1206,1099,295,53,751,107,69,8,46,15,38,0,38,0,46254
15081,15954,629,2433,4570,5571,2751,1204,727,682,159,5,518,45,19,19,0,0,26,0,26,0,477,433,199,0,234,44,28,28,0,0,16,0,0,16,46256
15082,7657,345,2116,2154,2104,938,748,316,286,54,39,193,30,30,0,0,30,0,0,0,0,432,396,62,8,326,36,15,0,15,0,21,11,10,0,46259
15083,21933,2425,4450,6303,5233,3522,1896,909,808,201,171,436,101,28,28,0,0,73,0,48,25,987,916,283,69,564,71,42,42,0,0,29,0,0,29,46260
15084,16967,1926,3828,4939,4133,2141,1328,633,344,86,93,165,289,234,210,0,24,55,14,41,0,695,562,140,93,329,133,79,79,0,0,54,0,36,18,46268
15085,4994,88,527,1146,1793,1440,451,214,187,30,31,126,27,27,12,0,15,0,0,0,0,237,185,26,0,159,52,26,13,13,0,26,0,0,26,46278
15086,4776,133,1027,1220,1718,678,359,226,226,89,0,137,0,0,0,0,0,0,0,0,0,133,119,84,0,35,14,14,14,0,0,0,0,0,0,46280
15087,292,0,0,50,169,73,0,0,0,0,0,0,0,0,0,0,0,0,0,0,0,0,0,0,0,0,0,0,0,0,0,0,0,0,0,46290
15088,472,4,60,108,161,139,12,8,6,0,0,6,2,0,0,0,0,2,0,0,2,4,4,4,0,0,0,0,0,0,0,0,0,0,0,46301
15089,8755,957,3827,2774,870,327,795,415,384,84,54,246,31,31,15,16,0,0,0,0,0,380,317,143,0,174,63,33,33,0,0,30,0,0,30,46303
15090,15988,1346,5210,4705,2713,2014,1179,691,569,159,59,351,122,103,75,9,19,19,0,19,0,488,452,110,0,342,36,12,12,0,0,24,0,24,0,46304
15091,41904,2884,14062,12207,8802,3949,3039,1637,1352,451,78,823,285,175,112,63,0,110,77,0,33,1402,1324,326,81,917,78,78,42,0,36,0,0,0,0,46307
15092,8828,993,4016,2854,722,243,687,403,351,91,22,238,52,52,42,10,0,0,0,0,0,284,206,117,3,86,78,72,55,10,7,6,0,0,6,46310
15093,15092,1111,5088,4774,2858,1261,1308,803,638,162,45,431,165,149,139,0,10,16,15,0,1,505,500,277,17,206,5,5,3,0,2,0,0,0,0,46311
15094,16789,4759,6246,4602,823,359,1796,852,709,140,28,541,143,94,46,16,32,49,0,0,49,944,738,88,70,580,206,77,29,0,48,129,8,10,111,46312
15095,11899,1235,4677,4094,1380,513,908,387,351,71,23,257,36,36,16,20,0,0,0,0,0,521,449,186,0,263,72,61,12,0,49,11,0,0,11,46319
15096,8935,2357,3275,2340,761,202,835,329,315,17,5,293,14,0,0,0,0,14,14,0,0,506,382,70,40,272,124,78,0,25,53,46,0,25,21,46320
15097,16762,980,4408,4569,3998,2807,1066,567,494,44,24,426,73,73,40,26,7,0,0,0,0,499,432,86,36,310,67,67,40,17,10,0,0,0,0,46321
15098,16734,1348,5673,5281,3060,1372,1176,714,615,136,58,421,99,99,30,25,44,0,0,0,0,462,364,114,39,211,98,21,21,0,0,77,13,51,13,46322
15099,14429,2699,5222,4507,1329,672,1409,795,706,84,61,561,89,44,17,27,0,45,12,0,33,614,574,109,28,437,40,26,0,5,21,14,14,0,0,46323
15100,14507,2370,4973,5053,1363,748,1622,799,609,153,38,418,190,81,52,11,18,109,25,28,56,823,546,135,32,379,277,196,92,44,60,81,22,0,59,46324
15101,6783,1871,2953,1324,486,149,674,369,291,21,8,262,78,13,0,0,13,65,29,0,36,305,281,46,29,206,24,0,0,0,0,24,18,6,0,46327
15102,683,132,263,169,61,58,17,11,11,0,0,11,0,0,0,0,0,0,0,0,0,6,0,0,0,0,6,6,0,6,0,0,0,0,0,46340
15103,7225,782,3163,2420,586,274,458,225,152,21,0,131,73,42,13,0,29,31,11,20,0,233,221,33,66,122,12,0,0,0,0,12,12,0,0,46341
15104,21300,2575,8799,6868,2063,995,1187,714,591,105,58,428,123,68,34,11,23,55,42,0,13,473,405,184,72,149,68,12,5,7,0,56,10,0,46,46342
15105,225,31,108,66,9,11,21,12,12,0,0,12,0,0,0,0,0,0,0,0,0,9,7,3,0,4,2,2,2,0,0,0,0,0,0,46345
15106,914,200,389,237,73,15,66,27,18,11,3,4,9,5,0,0,5,4,0,0,4,39,32,8,0,24,7,3,0,3,0,4,4,0,0,46346
15107,3249,151,1454,939,490,215,254,139,127,22,6,99,12,12,3,0,9,0,0,0,0,115,113,16,31,66,2,0,0,0,0,2,0,0,2,46347
15108,753,72,386,215,49,31,42,20,17,2,0,15,3,3,3,0,0,0,0,0,0,22,22,7,0,15,0,0,0,0,0,0,0,0,0,46348
15109,2471,422,1201,757,42,49,191,112,79,8,0,71,33,33,33,0,0,0,0,0,0,79,73,31,0,42,6,0,0,0,0,6,6,0,0,46349
15110,29542,3324,11916,8586,3760,1956,2412,1480,1335,247,83,1005,145,91,53,11,27,54,15,0,39,932,673,210,46,417,259,152,88,43,21,107,16,24,67,46350
15111,11264,858,4679,4016,1135,576,1004,393,350,99,0,251,43,28,9,10,9,15,0,0,15,611,570,138,191,241,41,31,31,0,0,10,10,0,0,46356
15112,30637,4443,11523,9138,3482,2051,2333,1173,897,225,66,606,276,153,99,40,14,123,6,50,67,1160,945,361,54,530,215,134,0,57,77,81,0,20,61,46360
15113,788,37,338,270,105,38,57,24,0,0,0,0,24,0,0,0,0,24,0,0,24,33,0,0,0,0,33,14,0,14,0,19,0,0,19,46365
15114,3970,717,1568,1055,384,246,356,179,135,16,0,119,44,8,0,8,0,36,14,9,13,177,139,29,8,102,38,14,3,0,11,24,6,6,12,46366
15115,25912,2978,10579,8020,2930,1405,1934,1078,776,150,82,544,302,249,36,88,125,53,29,0,24,856,703,212,105,386,153,90,21,10,59,63,35,19,9,46368
15116,2215,128,790,754,322,221,205,92,67,16,17,34,25,0,0,0,0,25,25,0,0,113,77,21,11,45,36,20,20,0,0,16,0,0,16,46371
15117,9795,320,2667,3188,2464,1156,912,525,509,171,21,317,16,0,0,0,0,16,16,0,0,387,312,141,0,171,75,61,49,12,0,14,0,14,0,46373
15118,630,76,356,140,22,36,41,34,21,21,0,0,13,0,0,0,0,13,0,0,13,7,0,0,0,0,7,0,0,0,0,7,7,0,0,46374
15119,16573,1116,4978,5119,2969,2391,1068,504,476,137,7,332,28,16,16,0,0,12,0,0,12,564,538,243,0,295,26,13,0,0,13,13,0,0,13,46375
15120,260,22,163,46,21,8,12,7,4,1,0,3,3,3,0,0,3,0,0,0,0,5,5,2,0,3,0,0,0,0,0,0,0,0,0,46376
15121,245,28,154,45,0,18,47,18,18,0,0,18,0,0,0,0,0,0,0,0,0,29,29,9,20,0,0,0,0,0,0,0,0,0,0,46377
15122,90,11,46,22,0,11,56,0,0,0,0,0,0,0,0,0,0,0,0,0,0,56,56,0,0,56,0,0,0,0,0,0,0,0,0,46379
15123,223,29,66,80,48,0,13,0,0,0,0,0,0,0,0,0,0,0,0,0,0,13,13,0,0,13,0,0,0,0,0,0,0,0,0,46381
15124,1482,140,678,498,105,61,50,31,31,15,0,16,0,0,0,0,0,0,0,0,0,19,19,8,0,11,0,0,0,0,0,0,0,0,0,46382
15125,25996,2048,8077,8088,4959,2824,2825,1503,1428,344,115,969,75,15,12,0,3,60,0,0,60,1322,1250,308,62,880,72,21,0,17,4,51,35,0,16,46383
15126,25696,1819,8372,7750,5153,2602,2245,963,864,255,38,571,99,65,45,17,3,34,13,0,21,1282,1253,443,64,746,29,16,0,0,16,13,0,0,13,46385
15127,1740,149,941,466,142,42,98,53,47,5,8,34,6,6,3,3,0,0,0,0,0,45,45,16,0,29,0,0,0,0,0,0,0,0,0,46390
15128,7529,1612,2684,2401,603,229,343,206,144,19,0,125,62,24,0,0,24,38,0,0,38,137,127,32,2,93,10,10,10,0,0,0,0,0,0,46391
15129,5161,609,2496,1441,445,170,420,203,170,29,6,135,33,33,33,0,0,0,0,0,0,217,203,20,11,172,14,0,0,0,0,14,0,1,13,46392
15130,297,6,172,113,6,0,57,57,6,0,0,6,51,51,0,0,51,0,0,0,0,0,0,0,0,0,0,0,0,0,0,0,0,0,0,46393
15131,8501,1397,3535,2198,915,456,552,248,248,47,0,201,0,0,0,0,0,0,0,0,0,304,260,57,25,178,44,21,10,0,11,23,8,0,15,46394
15132,4246,864,1794,1333,186,69,351,205,178,0,30,148,27,27,11,16,0,0,0,0,0,146,131,22,11,98,15,5,0,5,0,10,0,0,10,46402
15133,7725,684,2414,2708,1117,802,574,306,220,59,20,141,86,42,29,13,0,44,0,0,44,268,190,16,35,139,78,61,0,38,23,17,0,17,0,46403
15134,11168,1953,3937,3855,869,554,1160,556,500,41,20,439,56,56,44,12,0,0,0,0,0,604,562,87,17,458,42,10,5,5,0,32,0,0,32,46404
15135,7876,1668,3638,2128,361,81,729,440,340,51,69,220,100,73,14,7,52,27,0,0,27,289,236,47,20,169,53,10,0,10,0,43,20,0,23,46405
15136,6402,1397,2813,1662,371,159,780,265,185,34,0,151,80,34,13,0,21,46,34,0,12,515,393,71,32,290,122,66,47,0,19,56,0,5,51,46406
15137,8078,1420,2795,3034,621,208,813,343,248,0,5,243,95,56,18,25,13,39,2,0,37,470,397,28,30,339,73,60,2,43,15,13,0,13,0,46407
15138,11270,2024,4281,3920,752,293,908,572,434,122,30,282,138,33,15,4,14,105,42,5,58,336,312,0,0,312,24,16,4,0,12,8,0,8,0,46408
15139,5349,967,2170,1760,323,129,680,369,230,28,23,179,139,104,46,11,47,35,15,20,0,311,247,21,0,226,64,38,38,0,0,26,26,0,0,46409
15140,25445,2523,8925,8778,3342,1877,2242,1212,1073,162,90,821,139,113,58,41,14,26,15,11,0,1030,972,279,178,515,58,38,24,0,14,20,0,0,20,46410
15141,2370,353,1064,702,181,70,210,119,67,26,0,41,52,45,11,15,19,7,7,0,0,91,78,34,0,44,13,7,7,0,0,6,6,0,0,46501
15142,169,0,81,88,0,0,0,0,0,0,0,0,0,0,0,0,0,0,0,0,0,0,0,0,0,0,0,0,0,0,0,0,0,0,0,46502
15143,2349,215,1072,792,190,80,210,112,94,11,0,83,18,5,0,0,5,13,13,0,0,98,61,18,3,40,37,6,0,4,2,31,8,0,23,46504
15144,6282,1238,2437,1712,549,346,612,242,126,30,20,76,116,59,37,22,0,57,38,0,19,370,317,72,11,234,53,19,0,0,19,34,23,0,11,46506
15145,6267,1007,2467,1635,722,436,438,237,129,48,16,65,108,69,13,30,26,39,19,15,5,201,201,49,16,136,0,0,0,0,0,0,0,0,0,46507
15146,82,14,50,16,2,0,4,0,0,0,0,0,0,0,0,0,0,0,0,0,0,4,4,0,0,4,0,0,0,0,0,0,0,0,0,46508
15147,2218,256,997,657,191,117,134,72,70,11,14,45,2,0,0,0,0,2,0,0,2,62,62,33,0,29,0,0,0,0,0,0,0,0,0,46510
15148,3029,314,1139,891,301,384,204,95,87,37,4,46,8,8,0,1,7,0,0,0,0,109,109,24,0,85,0,0,0,0,0,0,0,0,0,46511
15149,26403,4100,9794,7664,3312,1533,2319,1234,1049,323,245,481,185,117,87,0,30,68,53,0,15,1085,973,340,46,587,112,35,12,23,0,77,14,35,28,46514
15150,20979,4741,7706,5533,1997,1002,1876,933,760,132,68,560,173,111,35,28,48,62,38,13,11,943,673,87,90,496,270,184,44,90,50,86,6,36,44,46516
15151,14803,2998,5629,3950,1598,628,1266,585,447,93,7,347,138,79,69,10,0,59,0,13,46,681,617,295,9,313,64,34,34,0,0,30,11,0,19,46517
15152,1481,333,556,387,177,28,200,119,98,59,4,35,21,0,0,0,0,21,21,0,0,81,67,17,2,48,14,0,0,0,0,14,3,0,11,46524
15153,20633,3762,7191,4796,3196,1688,1779,801,665,211,6,448,136,74,39,9,26,62,49,13,0,978,913,256,37,620,65,65,65,0,0,0,0,0,0,46526
15154,14576,3083,5208,3353,1959,973,1938,1087,685,84,88,513,402,154,137,0,17,248,224,0,24,851,559,144,145,270,292,128,86,36,6,164,148,0,16,46528
15155,19734,1055,3839,4914,5840,4086,1829,911,851,166,37,648,60,60,49,11,0,0,0,0,0,918,848,260,44,544,70,0,0,0,0,70,0,0,70,46530
15156,958,254,359,214,117,14,119,70,70,10,0,60,0,0,0,0,0,0,0,0,0,49,49,23,0,26,0,0,0,0,0,0,0,0,0,46531
15157,1304,225,514,425,110,30,106,34,21,0,5,16,13,13,0,0,13,0,0,0,0,72,70,15,0,55,2,0,0,0,0,2,0,0,2,46532
15158,7648,1279,3517,2042,501,309,605,405,378,74,7,297,27,8,0,8,0,19,19,0,0,200,128,26,9,93,72,63,0,34,29,9,0,0,9,46534
15159,2365,265,1036,752,181,131,157,95,95,17,0,78,0,0,0,0,0,0,0,0,0,62,54,13,0,41,8,8,0,8,0,0,0,0,0,46536
15160,300,60,132,82,23,3,12,8,6,0,4,2,2,2,2,0,0,0,0,0,0,4,4,0,0,4,0,0,0,0,0,0,0,0,0,46537
15161,2716,180,1141,818,447,130,215,89,77,36,0,41,12,12,12,0,0,0,0,0,0,126,126,38,0,88,0,0,0,0,0,0,0,0,0,46538
15162,1266,176,693,240,97,60,68,15,7,0,0,7,8,0,0,0,0,8,0,8,0,53,51,10,0,41,2,2,2,0,0,0,0,0,0,46539
15163,6983,1828,2176,1690,879,410,523,354,268,85,17,166,86,36,36,0,0,50,45,5,0,169,93,46,0,47,76,49,0,49,0,27,17,0,10,46540
15164,2371,360,1273,548,150,40,146,102,66,16,4,46,36,28,25,3,0,8,8,0,0,44,28,3,2,23,16,13,7,3,3,3,3,0,0,46542
15165,2019,930,634,308,120,27,351,183,80,42,2,36,103,44,27,0,17,59,43,0,16,168,82,38,6,38,86,0,0,0,0,86,67,0,19,46543
15166,20561,2915,6856,6031,3001,1758,1489,533,436,146,35,255,97,43,26,0,17,54,12,22,20,956,741,316,86,339,215,65,39,11,15,150,48,34,68,46544
15167,16210,1783,5908,4585,2396,1538,1297,626,601,96,66,439,25,25,12,0,13,0,0,0,0,671,659,159,73,427,12,7,0,0,7,5,5,0,0,46545
15168,7378,2144,2593,1520,796,325,659,474,291,102,0,189,183,43,27,0,16,140,111,7,22,185,112,24,0,88,73,0,0,0,0,73,62,0,11,46550
15169,4785,384,1873,1662,472,394,246,108,90,37,15,38,18,18,9,9,0,0,0,0,0,138,138,41,30,67,0,0,0,0,0,0,0,0,0,46552
15170,2036,312,835,535,291,63,146,68,65,20,0,45,3,3,3,0,0,0,0,0,0,78,78,34,0,44,0,0,0,0,0,0,0,0,0,46553
15171,3263,343,1607,849,339,125,237,155,135,19,6,110,20,8,0,0,8,12,0,0,12,82,64,41,0,23,18,18,18,0,0,0,0,0,0,46554
15172,2122,312,818,698,157,137,140,110,74,21,33,20,36,25,3,0,22,11,0,11,0,30,25,9,0,16,5,0,0,0,0,5,0,5,0,46555
15173,573,30,69,59,215,200,3118,1464,1462,374,27,1061,2,2,2,0,0,0,0,0,0,1654,1654,396,62,1196,0,0,0,0,0,0,0,0,0,46556
15174,8860,1011,3133,2754,1341,621,817,333,325,69,107,149,8,0,0,0,0,8,8,0,0,484,449,131,61,257,35,22,22,0,0,13,0,0,13,46561
15175,3102,540,1442,875,182,63,203,56,54,12,13,29,2,2,0,2,0,0,0,0,0,147,85,15,2,68,62,27,2,20,5,35,2,0,33,46562
15176,15709,2559,6308,4018,1908,916,1315,685,546,121,49,376,139,139,84,37,18,0,0,0,0,630,517,173,40,304,113,87,22,21,44,26,0,26,0,46563
15177,4307,2472,895,619,177,144,534,296,126,45,0,81,170,37,37,0,0,133,133,0,0,238,66,2,0,64,172,16,16,0,0,156,109,47,0,46565
15178,6666,786,2226,2006,1011,637,374,150,123,27,7,89,27,0,0,0,0,27,27,0,0,224,176,66,0,110,48,48,8,0,40,0,0,0,0,46567
15179,835,180,393,167,76,19,55,22,22,0,0,22,0,0,0,0,0,0,0,0,0,33,33,5,28,0,0,0,0,0,0,0,0,0,0,46570
15180,2477,1544,502,321,75,35,362,177,61,0,0,61,116,2,0,0,2,114,86,9,19,185,54,19,14,21,131,5,0,5,0,126,48,0,78,46571
15181,2286,250,973,576,321,166,211,88,88,10,3,75,0,0,0,0,0,0,0,0,0,123,123,56,0,67,0,0,0,0,0,0,0,0,0,46573
15182,5517,832,2274,1572,617,222,426,260,197,45,16,136,63,54,0,20,34,9,0,0,9,166,144,9,13,122,22,8,3,5,0,14,0,0,14,46574
15183,14371,2072,5157,3950,1873,1319,1360,833,653,162,0,491,180,145,16,92,37,35,0,34,1,527,497,209,6,282,30,30,0,0,30,0,0,0,0,46580
15184,7857,809,3334,1906,1264,544,625,292,276,69,4,203,16,0,0,0,0,16,0,16,0,333,301,162,15,124,32,32,32,0,0,0,0,0,0,46582
15185,3055,270,612,740,894,539,421,193,187,49,0,138,6,6,0,0,6,0,0,0,0,228,203,41,31,131,25,25,25,0,0,0,0,0,0,46590
15186,49,11,22,16,0,0,13,0,0,0,0,0,0,0,0,0,0,0,0,0,0,13,13,0,13,0,0,0,0,0,0,0,0,0,0,46595
15187,3825,890,1038,1107,334,456,324,193,130,9,8,113,63,20,8,12,0,43,0,6,37,131,114,28,50,36,17,7,0,0,7,10,0,0,10,46601
15188,6516,1686,2290,2028,416,96,633,366,262,24,35,203,104,36,0,30,6,68,42,26,0,267,161,39,21,101,106,16,7,6,3,90,33,57,0,46613
15189,21974,1984,7196,6935,3631,2228,1207,698,574,179,53,342,124,66,33,0,33,58,19,6,33,509,361,116,30,215,148,41,41,0,0,107,42,41,24,46614
15190,10261,931,3256,3446,1527,1101,689,283,229,69,0,160,54,17,8,9,0,37,0,0,37,406,324,81,42,201,82,62,60,0,2,20,0,20,0,46615
15191,3573,468,1011,1070,606,418,159,53,37,14,0,23,16,10,4,6,0,6,0,6,0,106,74,8,0,66,32,0,0,0,0,32,0,32,0,46616
15192,6387,723,1132,1206,1801,1525,408,184,177,38,60,79,7,0,0,0,0,7,7,0,0,224,180,114,0,66,44,20,3,0,17,24,24,0,0,46617
15193,13328,3031,5364,3834,797,302,1107,455,396,46,38,312,59,25,25,0,0,34,9,13,12,652,537,67,86,384,115,61,33,0,28,54,0,40,14,46619
15194,16763,2529,5620,5356,2153,1105,1542,909,788,136,172,480,121,110,36,60,14,11,0,2,9,633,470,106,27,337,163,59,15,0,44,104,87,0,17,46628
15195,4170,289,1263,1241,855,522,234,95,95,31,19,45,0,0,0,0,0,0,0,0,0,139,139,19,0,120,0,0,0,0,0,0,0,0,0,46635
15196,9185,757,2851,2434,1791,1352,1342,775,635,123,9,503,140,44,14,29,1,96,8,57,31,567,544,251,17,276,23,23,21,2,0,0,0,0,0,46637
15197,5188,784,2194,1664,295,251,366,159,135,42,13,80,24,8,8,0,0,16,0,0,16,207,167,39,19,109,40,40,14,5,21,0,0,0,0,46701
15198,1517,191,727,422,108,69,95,39,36,11,0,25,3,0,0,0,0,3,0,0,3,56,56,6,0,50,0,0,0,0,0,0,0,0,0,46702
15199,11387,1306,4308,3240,1684,849,1389,796,762,262,53,447,34,26,26,0,0,8,8,0,0,593,511,151,22,338,82,75,60,0,15,7,0,0,7,46703
15200,119,0,80,39,0,0,10,0,0,0,0,0,0,0,0,0,0,0,0,0,0,10,10,0,0,10,0,0,0,0,0,0,0,0,0,46704
15201,1073,120,534,329,81,9,61,46,46,27,2,17,0,0,0,0,0,0,0,0,0,15,12,8,0,4,3,0,0,0,0,3,0,0,3,46705
15202,12821,1160,4598,3991,1973,1099,1031,596,478,146,38,294,118,111,109,0,2,7,7,0,0,435,372,86,22,264,63,63,51,0,12,0,0,0,0,46706
15203,3048,276,1245,1055,297,175,299,192,192,76,25,91,0,0,0,0,0,0,0,0,0,107,77,44,9,24,30,30,19,0,11,0,0,0,0,46710
15204,4337,685,1666,1078,568,340,471,301,258,84,14,160,43,18,18,0,0,25,7,11,7,170,92,30,25,37,78,26,0,26,0,52,11,0,41,46711
15205,9704,1027,3989,2998,1042,648,756,405,350,101,58,191,55,51,0,51,0,4,0,0,4,351,319,130,15,174,32,16,0,16,0,16,9,0,7,46714
15206,3210,540,1584,765,169,152,325,155,134,22,8,104,21,21,21,0,0,0,0,0,0,170,164,30,17,117,6,0,0,0,0,6,0,0,6,46721
15207,4834,383,2240,1598,494,119,424,281,244,81,27,136,37,34,20,0,14,3,0,0,3,143,122,27,9,86,21,12,0,12,0,9,0,0,9,46723
15208,16003,1410,6631,4893,1874,1195,1132,553,439,120,79,240,114,74,17,21,36,40,6,30,4,579,438,81,59,298,141,71,62,0,9,70,21,0,49,46725
15209,938,148,480,240,50,20,119,60,39,6,0,33,21,4,0,0,4,17,17,0,0,59,56,31,0,25,3,0,0,0,0,3,3,0,0,46730
15210,395,56,181,133,25,0,11,11,11,0,0,11,0,0,0,0,0,0,0,0,0,0,0,0,0,0,0,0,0,0,0,0,0,0,0,46731
15211,1810,367,716,591,98,38,176,67,56,7,39,10,11,9,0,0,9,2,0,2,0,109,102,73,0,29,7,7,0,0,7,0,0,0,0,46732
15212,12563,1504,5849,3415,1172,623,810,422,363,89,20,254,59,11,11,0,0,48,13,11,24,388,377,145,68,164,11,11,0,11,0,0,0,0,0,46733
15213,5066,571,1846,1639,595,415,370,210,142,66,24,52,68,42,32,10,0,26,0,26,0,160,160,47,11,102,0,0,0,0,0,0,0,0,0,46737
15214,5106,712,2165,1586,485,158,336,153,153,75,6,72,0,0,0,0,0,0,0,0,0,183,164,72,0,92,19,19,0,0,19,0,0,0,0,46738
15215,2320,556,954,618,93,99,355,204,115,74,3,38,89,5,5,0,0,84,84,0,0,151,115,58,0,57,36,4,0,4,0,32,0,0,32,46740
15216,2919,875,808,642,333,261,292,151,58,28,0,30,93,25,2,13,10,68,53,0,15,141,80,10,7,63,61,9,0,0,9,52,23,9,20,46741
15217,2451,267,1014,772,275,123,149,92,92,41,7,44,0,0,0,0,0,0,0,0,0,57,32,23,3,6,25,25,25,0,0,0,0,0,0,46742
15218,1138,148,513,316,143,18,106,59,54,32,0,22,5,0,0,0,0,5,0,0,5,47,31,10,0,21,16,0,0,0,0,16,0,0,16,46743
15219,1259,108,420,384,226,121,152,76,64,11,28,25,12,12,0,12,0,0,0,0,0,76,76,44,17,15,0,0,0,0,0,0,0,0,0,46745
15220,2509,524,1110,643,106,126,390,154,72,0,0,72,82,0,0,0,0,82,67,0,15,236,124,66,0,58,112,41,41,0,0,71,18,0,53,46746
15221,1944,163,985,567,203,26,189,104,91,63,3,25,13,13,11,0,2,0,0,0,0,85,80,49,0,31,5,5,0,0,5,0,0,0,0,46747
15222,3358,54,985,1303,649,367,285,132,114,48,13,53,18,18,8,0,10,0,0,0,0,153,148,41,10,97,5,5,0,0,5,0,0,0,0,46748
15223,18093,2203,7399,5370,1869,1252,1743,815,729,203,67,459,86,55,38,0,17,31,11,12,8,928,771,133,153,485,157,119,59,8,52,38,0,14,24,46750
15224,10153,1158,4076,3153,1202,564,943,414,343,93,31,219,71,68,39,29,0,3,0,0,3,529,415,134,0,281,114,17,6,0,11,97,0,67,30,46755
15225,449,36,230,121,21,41,13,0,0,0,0,0,0,0,0,0,0,0,0,0,0,13,13,0,0,13,0,0,0,0,0,0,0,0,0,46759
15226,1003,186,503,255,35,24,53,25,25,0,0,25,0,0,0,0,0,0,0,0,0,28,28,7,0,21,0,0,0,0,0,0,0,0,0,46760
15227,7092,2350,2371,1517,460,394,709,373,198,87,0,111,175,12,0,4,8,163,121,21,21,336,200,29,24,147,136,6,3,0,3,130,103,5,22,46761
15228,1316,125,697,327,109,58,187,93,78,13,0,65,15,15,15,0,0,0,0,0,0,94,63,0,0,63,31,31,31,0,0,0,0,0,0,46763
15229,821,86,418,258,38,21,91,13,0,0,0,0,13,13,13,0,0,0,0,0,0,78,73,1,2,70,5,5,5,0,0,0,0,0,0,46764
15230,3499,99,920,1316,840,324,314,162,133,29,6,98,29,0,0,0,0,29,29,0,0,152,143,40,4,99,9,9,0,0,9,0,0,0,0,46765
15231,503,53,232,177,24,17,27,6,6,0,0,6,0,0,0,0,0,0,0,0,0,21,21,0,0,21,0,0,0,0,0,0,0,0,0,46766
15232,4642,1836,1668,715,251,172,500,322,218,74,54,90,104,48,48,0,0,56,56,0,0,178,104,50,0,54,74,7,7,0,0,67,13,23,31,46767
15233,1942,99,869,683,181,110,155,85,73,25,2,46,12,5,5,0,0,7,7,0,0,70,70,37,0,33,0,0,0,0,0,0,0,0,0,46770
15234,0,0,0,0,0,0,0,0,0,0,0,0,0,0,0,0,0,0,0,0,0,0,0,0,0,0,0,0,0,0,0,0,0,0,0,46771
15235,1522,509,534,310,111,58,277,74,15,13,0,2,59,6,5,0,1,53,40,13,0,203,36,27,0,9,167,36,7,0,29,131,45,26,60,46772
15236,2556,327,1094,846,185,104,259,150,126,34,12,80,24,21,4,8,9,3,0,3,0,109,105,32,17,56,4,4,0,4,0,0,0,0,0,46773
15237,10950,1319,3871,3497,1547,716,791,398,329,108,34,187,69,15,15,0,0,54,50,0,4,393,270,50,77,143,123,61,3,0,58,62,33,0,29,46774
15238,1151,160,594,247,102,48,38,33,30,1,3,26,3,0,0,0,0,3,0,0,3,5,1,0,0,1,4,4,4,0,0,0,0,0,0,46776
15239,4458,333,1744,1706,551,124,319,148,113,50,0,63,35,35,35,0,0,0,0,0,0,171,171,115,0,56,0,0,0,0,0,0,0,0,0,46777
15240,1476,206,589,449,139,93,134,59,34,15,0,19,25,25,0,25,0,0,0,0,0,75,63,17,14,32,12,12,12,0,0,0,0,0,0,46779
15241,568,88,270,201,8,1,41,11,11,0,0,11,0,0,0,0,0,0,0,0,0,30,29,0,0,29,1,1,1,0,0,0,0,0,0,46781
15242,4162,202,1446,1402,642,470,399,240,215,52,27,136,25,25,25,0,0,0,0,0,0,159,159,88,6,65,0,0,0,0,0,0,0,0,0,46783
15243,1495,208,629,437,118,103,138,23,12,0,7,5,11,0,0,0,0,11,0,0,11,115,98,49,0,49,17,2,0,0,2,15,0,15,0,46784
15244,1240,122,560,449,91,18,67,31,13,0,1,12,18,3,0,3,0,15,0,0,15,36,35,2,0,33,1,1,1,0,0,0,0,0,0,46785
15245,88,0,21,67,0,0,12,0,0,0,0,0,0,0,0,0,0,0,0,0,0,12,0,0,0,0,12,12,0,0,12,0,0,0,0,46786
15246,2503,302,1165,825,153,58,332,138,123,34,18,71,15,6,6,0,0,9,0,9,0,194,179,102,27,50,15,15,15,0,0,0,0,0,0,46787
15247,1778,119,646,609,303,101,218,106,85,10,30,45,21,11,11,0,0,10,10,0,0,112,75,18,0,57,37,0,0,0,0,37,0,0,37,46788
15248,431,30,195,133,36,37,90,72,43,22,8,13,29,0,0,0,0,29,0,29,0,18,18,8,2,8,0,0,0,0,0,0,0,0,0,46791
15249,2368,222,1132,702,225,87,118,73,55,9,3,43,18,18,14,4,0,0,0,0,0,45,39,21,3,15,6,6,6,0,0,0,0,0,0,46792
15250,2717,481,1287,702,189,58,297,195,135,16,11,108,60,41,4,37,0,19,19,0,0,102,85,19,0,66,17,17,0,17,0,0,0,0,0,46793
15251,1337,144,706,309,123,55,114,66,66,8,37,21,0,0,0,0,0,0,0,0,0,48,48,12,0,36,0,0,0,0,0,0,0,0,0,46794
15252,3897,748,1587,1078,220,264,244,111,94,21,12,61,17,0,0,0,0,17,17,0,0,133,74,41,0,33,59,34,33,0,1,25,12,3,10,46795
15253,2758,172,1133,988,362,103,207,103,97,23,0,74,6,6,6,0,0,0,0,0,0,104,81,47,10,24,23,20,20,0,0,3,0,0,3,46797
15254,1323,170,647,337,119,50,124,58,37,12,0,25,21,21,21,0,0,0,0,0,0,66,64,28,1,35,2,2,0,2,0,0,0,0,0,46798
15255,106,12,60,29,5,0,8,0,0,0,0,0,0,0,0,0,0,0,0,0,0,8,8,0,5,3,0,0,0,0,0,0,0,0,0,46799
15256,7082,1663,1900,2240,936,343,406,197,188,49,0,139,9,9,5,4,0,0,0,0,0,209,142,22,35,85,67,29,0,29,0,38,19,5,14,46802
15257,4822,1463,1819,1239,231,70,901,494,360,72,51,237,134,91,9,29,53,43,28,9,6,407,269,53,23,193,138,38,22,0,16,100,0,64,36,46803
15258,18300,855,4278,5983,4607,2577,1527,691,639,108,20,511,52,32,20,11,1,20,0,20,0,836,796,207,51,538,40,7,7,0,0,33,6,7,20,46804
15259,13853,1740,4263,4956,1983,911,694,339,241,61,57,123,98,52,40,0,12,46,17,29,0,355,311,87,56,168,44,6,6,0,0,38,1,0,37,46805
15260,13235,3803,5032,3435,643,322,1682,964,673,75,99,499,291,166,46,43,77,125,10,10,105,718,605,24,60,521,113,51,27,6,18,62,8,39,15,46806
15261,9412,1271,2297,3076,1881,887,987,545,432,132,86,214,113,97,38,59,0,16,16,0,0,442,360,133,18,209,82,39,18,9,12,43,0,10,33,46807
15262,12204,1703,4556,3999,1568,378,934,454,406,39,15,352,48,40,28,0,12,8,0,0,8,480,437,174,50,213,43,0,0,0,0,43,8,8,27,46808
15263,5661,706,2198,1889,636,232,383,192,179,45,8,126,13,0,0,0,0,13,13,0,0,191,184,55,18,111,7,7,7,0,0,0,0,0,0,46809
15264,7847,205,938,1696,2823,2185,685,367,367,125,0,242,0,0,0,0,0,0,0,0,0,318,318,75,0,243,0,0,0,0,0,0,0,0,0,46814
15265,17309,1078,4644,6356,3495,1736,1620,820,709,212,63,434,111,111,41,30,40,0,0,0,0,800,736,214,73,449,64,64,64,0,0,0,0,0,0,46815
15266,11358,2331,4209,3405,1115,298,1091,646,525,30,66,429,121,121,32,18,71,0,0,0,0,445,372,54,45,273,73,49,17,3,29,24,0,0,24,46816
15267,13133,1139,4028,4949,2014,1003,1050,561,522,113,35,374,39,35,20,8,7,4,4,0,0,489,429,162,24,243,60,55,37,18,0,5,0,0,5,46818
15268,6441,706,2484,2143,632,476,423,94,63,11,4,48,31,12,12,0,0,19,10,9,0,329,329,158,0,171,0,0,0,0,0,0,0,0,0,46819
15269,19269,1669,6085,6342,3686,1487,1653,793,685,206,46,433,108,83,37,0,46,25,10,0,15,860,748,262,64,422,112,100,100,0,0,12,12,0,0,46825
15270,21731,1021,5491,7601,4980,2638,1552,777,659,220,76,363,118,91,54,37,0,27,17,0,10,775,710,182,81,447,65,60,33,27,0,5,0,0,5,46835
15271,13531,403,3094,4107,3466,2461,1496,699,698,142,37,519,1,0,0,0,0,1,1,0,0,797,769,266,10,493,28,12,12,0,0,16,16,0,0,46845
15272,26585,3995,10400,7887,2761,1542,2167,1168,847,181,59,607,321,130,13,84,33,191,79,46,66,999,887,332,107,448,112,89,52,29,8,23,10,0,13,46901
15273,24335,2255,8849,7725,3481,2025,1609,909,839,248,73,518,70,53,33,20,0,17,0,10,7,700,551,235,61,255,149,135,75,43,17,14,0,0,14,46902
15274,2128,379,941,614,134,60,189,146,139,64,18,57,7,7,2,5,0,0,0,0,0,43,43,19,3,21,0,0,0,0,0,0,0,0,0,46910
15275,882,86,387,272,59,78,87,65,51,9,11,31,14,14,7,7,0,0,0,0,0,22,22,0,0,22,0,0,0,0,0,0,0,0,0,46911
15276,832,116,366,247,68,35,57,41,41,9,0,32,0,0,0,0,0,0,0,0,0,16,16,0,0,16,0,0,0,0,0,0,0,0,0,46913
15277,1241,238,635,296,44,28,111,55,55,20,0,35,0,0,0,0,0,0,0,0,0,56,56,11,3,42,0,0,0,0,0,0,0,0,0,46914
15278,546,73,224,160,65,24,13,10,10,2,0,8,0,0,0,0,0,0,0,0,0,3,3,1,0,2,0,0,0,0,0,0,0,0,0,46915
15279,1429,182,616,378,178,75,141,99,91,29,24,38,8,8,8,0,0,0,0,0,0,42,41,5,0,36,1,1,1,0,0,0,0,0,0,46917
15280,1609,155,716,445,150,143,214,130,127,65,13,49,3,3,0,3,0,0,0,0,0,84,76,27,0,49,8,0,0,0,0,8,8,0,0,46919
15281,648,36,241,242,121,8,105,57,57,0,0,57,0,0,0,0,0,0,0,0,0,48,26,0,4,22,22,22,22,0,0,0,0,0,0,46920
15282,0,0,0,0,0,0,0,0,0,0,0,0,0,0,0,0,0,0,0,0,0,0,0,0,0,0,0,0,0,0,0,0,0,0,0,46922
15283,5427,886,1964,1736,540,301,402,128,100,28,0,72,28,28,28,0,0,0,0,0,0,274,268,91,0,177,6,6,0,6,0,0,0,0,0,46923
15284,1226,127,597,340,123,39,118,59,58,8,0,50,1,1,1,0,0,0,0,0,0,59,34,13,6,15,25,0,0,0,0,25,0,0,25,46926
15285,3223,426,1371,898,312,216,383,251,221,26,13,182,30,30,30,0,0,0,0,0,0,132,126,44,1,81,6,6,0,6,0,0,0,0,0,46928
15286,2313,229,1021,722,219,122,228,130,84,18,27,39,46,46,9,37,0,0,0,0,0,98,69,14,7,48,29,23,4,0,19,6,6,0,0,46929
15287,105,14,64,18,9,0,10,6,6,0,0,6,0,0,0,0,0,0,0,0,0,4,4,0,4,0,0,0,0,0,0,0,0,0,0,46930
15288,68,5,33,17,2,11,15,10,10,3,1,6,0,0,0,0,0,0,0,0,0,5,5,5,0,0,0,0,0,0,0,0,0,0,0,46931
15289,2699,149,1040,1005,337,168,189,66,49,8,4,37,17,17,0,17,0,0,0,0,0,123,123,42,29,52,0,0,0,0,0,0,0,0,0,46932
15290,4465,587,2138,1187,399,154,400,136,128,9,15,104,8,8,0,0,8,0,0,0,0,264,237,72,42,123,27,0,0,0,0,27,27,0,0,46933
15291,4249,325,1770,1337,533,284,375,230,194,64,10,120,36,36,36,0,0,0,0,0,0,145,131,31,0,100,14,5,0,5,0,9,0,0,9,46936
15292,2002,311,940,479,185,87,183,128,91,16,7,68,37,0,0,0,0,37,0,0,37,55,34,21,0,13,21,21,15,1,5,0,0,0,0,46938
15293,1343,164,792,275,95,17,186,88,80,13,0,67,8,0,0,0,0,8,3,2,3,98,92,23,4,65,6,0,0,0,0,6,0,0,6,46939
15294,1909,231,879,467,160,172,177,59,45,11,17,17,14,14,0,14,0,0,0,0,0,118,98,5,9,84,20,20,15,5,0,0,0,0,0,46940
15295,689,122,319,216,20,12,82,45,42,30,0,12,3,3,0,3,0,0,0,0,0,37,37,5,0,32,0,0,0,0,0,0,0,0,0,46941
15296,99,17,65,17,0,0,6,0,0,0,0,0,0,0,0,0,0,0,0,0,0,6,6,0,0,6,0,0,0,0,0,0,0,0,0,46943
15297,57,28,18,0,11,0,18,0,0,0,0,0,0,0,0,0,0,0,0,0,0,18,18,0,0,18,0,0,0,0,0,0,0,0,0,46946
15298,19106,3638,8123,4894,1632,819,1617,870,689,107,138,444,181,55,47,8,0,126,52,9,65,747,642,220,48,374,105,83,39,44,0,22,0,22,0,46947
15299,514,66,210,147,48,43,36,19,19,13,0,6,0,0,0,0,0,0,0,0,0,17,17,17,0,0,0,0,0,0,0,0,0,0,0,46950
15300,1338,178,594,362,153,51,79,47,37,9,6,22,10,10,10,0,0,0,0,0,0,32,32,29,0,3,0,0,0,0,0,0,0,0,0,46951
15301,14242,1973,5620,3746,1551,1352,793,370,323,72,19,232,47,38,38,0,0,9,0,0,9,423,308,87,20,201,115,107,93,10,4,8,8,0,0,46952
15302,15132,2684,6533,4101,1350,464,2028,825,622,161,59,402,203,73,50,6,17,130,32,19,79,1203,1109,477,46,586,94,50,49,1,0,44,3,4,37,46953
15303,429,65,224,100,36,4,31,8,8,0,0,8,0,0,0,0,0,0,0,0,0,23,23,10,0,13,0,0,0,0,0,0,0,0,0,46957
15304,289,37,127,95,21,9,7,0,0,0,0,0,0,0,0,0,0,0,0,0,0,7,7,0,0,7,0,0,0,0,0,0,0,0,0,46958
15305,476,78,260,112,26,0,101,55,0,0,0,0,55,55,0,9,46,0,0,0,0,46,0,0,0,0,46,46,0,46,0,0,0,0,0,46959
15306,642,115,304,159,64,0,68,39,39,24,0,15,0,0,0,0,0,0,0,0,0,29,21,12,0,9,8,8,0,0,8,0,0,0,0,46960
15307,71,9,35,27,0,0,0,0,0,0,0,0,0,0,0,0,0,0,0,0,0,0,0,0,0,0,0,0,0,0,0,0,0,0,0,46961
15308,6111,795,2593,1377,747,599,781,496,477,66,88,323,19,19,9,0,10,0,0,0,0,285,252,82,19,151,33,25,25,0,0,8,8,0,0,46962
15309,81,24,35,20,2,0,4,4,4,3,0,1,0,0,0,0,0,0,0,0,0,0,0,0,0,0,0,0,0,0,0,0,0,0,0,46967
15310,88,25,49,14,0,0,0,0,0,0,0,0,0,0,0,0,0,0,0,0,0,0,0,0,0,0,0,0,0,0,0,0,0,0,0,46968
15311,16368,2941,6547,5111,1143,626,1328,735,672,78,88,506,63,39,15,18,6,24,0,0,24,593,520,232,24,264,73,73,36,37,0,0,0,0,0,46970
15312,1132,181,631,239,55,26,197,66,60,14,12,34,6,6,6,0,0,0,0,0,0,131,124,52,6,66,7,7,2,0,5,0,0,0,0,46974
15313,10234,1505,4346,2993,888,502,640,336,247,39,65,143,89,66,56,4,6,23,14,0,9,304,297,198,44,55,7,0,0,0,0,7,7,0,0,46975
15314,1458,229,631,314,161,123,107,62,56,3,2,51,6,3,0,3,0,3,0,0,3,45,39,18,10,11,6,6,0,6,0,0,0,0,0,46978
15315,3437,162,1169,1250,413,443,394,149,145,48,0,97,4,4,0,4,0,0,0,0,0,245,237,50,0,187,8,8,8,0,0,0,0,0,0,46979
15316,1931,288,1055,473,61,54,144,34,34,18,0,16,0,0,0,0,0,0,0,0,0,110,99,17,6,76,11,0,0,0,0,11,0,11,0,46982
15317,162,8,88,37,15,14,0,0,0,0,0,0,0,0,0,0,0,0,0,0,0,0,0,0,0,0,0,0,0,0,0,0,0,0,0,46984
15318,778,28,429,177,96,48,50,40,40,11,0,29,0,0,0,0,0,0,0,0,0,10,10,0,0,10,0,0,0,0,0,0,0,0,0,46985
15319,1326,130,605,384,76,131,59,29,21,3,3,15,8,5,0,5,0,3,3,0,0,30,25,11,5,9,5,0,0,0,0,5,0,0,5,46986
15320,422,45,200,104,38,35,20,13,13,2,0,11,0,0,0,0,0,0,0,0,0,7,7,4,0,3,0,0,0,0,0,0,0,0,0,46987
15321,602,76,250,201,75,0,136,62,28,0,12,16,34,0,0,0,0,34,34,0,0,74,62,34,0,28,12,0,0,0,0,12,0,0,12,46988
15322,2291,101,669,557,553,411,837,372,357,123,36,198,15,15,15,0,0,0,0,0,0,465,449,219,23,207,16,5,5,0,0,11,0,0,11,46989
15323,767,144,280,215,95,33,75,43,43,0,31,12,0,0,0,0,0,0,0,0,0,32,17,5,0,12,15,15,15,0,0,0,0,0,0,46990
15324,1240,124,485,517,59,55,78,47,47,3,0,44,0,0,0,0,0,0,0,0,0,31,29,0,0,29,2,2,0,0,2,0,0,0,0,46991
15325,11719,1689,4910,3372,1044,704,1075,561,506,125,15,366,55,39,0,39,0,16,0,0,16,514,390,141,21,228,124,74,45,29,0,50,0,23,27,46992
15326,1726,158,855,500,135,78,136,74,74,17,0,57,0,0,0,0,0,0,0,0,0,62,58,11,0,47,4,4,4,0,0,0,0,0,0,46994
15327,4934,696,2123,1399,520,196,402,227,227,13,11,203,0,0,0,0,0,0,0,0,0,175,152,35,32,85,23,23,12,11,0,0,0,0,0,46996
15328,74,14,30,30,0,0,0,0,0,0,0,0,0,0,0,0,0,0,0,0,0,0,0,0,0,0,0,0,0,0,0,0,0,0,0,46998
15329,7046,900,3053,2256,539,298,539,208,171,74,0,97,37,32,32,0,0,5,0,0,5,331,231,63,7,161,100,48,9,31,8,52,0,25,27,47001
15330,685,109,298,227,42,9,71,35,26,0,0,26,9,0,0,0,0,9,0,0,9,36,36,6,8,22,0,0,0,0,0,0,0,0,0,47003
15331,7839,631,2952,2268,1404,584,706,337,290,154,6,130,47,47,47,0,0,0,0,0,0,369,342,125,33,184,27,27,27,0,0,0,0,0,0,47006
15332,191,0,120,0,62,9,0,0,0,0,0,0,0,0,0,0,0,0,0,0,0,0,0,0,0,0,0,0,0,0,0,0,0,0,0,47010
15333,615,78,353,120,54,10,38,38,6,0,0,6,32,0,0,0,0,32,11,0,21,0,0,0,0,0,0,0,0,0,0,0,0,0,0,47011
15334,7050,891,3047,1722,889,501,594,302,275,144,14,117,27,12,12,0,0,15,0,11,4,292,285,82,16,187,7,7,7,0,0,0,0,0,0,47012
15335,538,75,316,78,46,23,28,28,28,3,24,1,0,0,0,0,0,0,0,0,0,0,0,0,0,0,0,0,0,0,0,0,0,0,0,47016
15336,324,82,95,106,41,0,0,0,0,0,0,0,0,0,0,0,0,0,0,0,0,0,0,0,0,0,0,0,0,0,0,0,0,0,0,47017
15337,3010,484,1202,970,229,125,168,54,25,5,5,15,29,29,21,0,8,0,0,0,0,114,114,55,0,59,0,0,0,0,0,0,0,0,0,47018
15338,1056,202,470,343,36,5,130,38,18,6,0,12,20,0,0,0,0,20,0,20,0,92,90,10,0,80,2,0,0,0,0,2,0,0,2,47020
15339,2161,184,856,589,355,177,142,88,88,25,10,53,0,0,0,0,0,0,0,0,0,54,54,20,9,25,0,0,0,0,0,0,0,0,0,47022
15340,1054,246,572,139,70,27,77,62,59,31,0,28,3,0,0,0,0,3,0,3,0,15,5,0,2,3,10,8,5,3,0,2,0,0,2,47023
15341,2166,650,1032,412,40,32,252,162,107,10,0,97,55,0,0,0,0,55,52,0,3,90,80,0,0,80,10,0,0,0,0,10,0,10,0,47024
15342,15366,1516,5779,4714,2283,1074,1270,768,676,284,57,335,92,26,26,0,0,66,21,0,45,502,468,173,54,241,34,14,0,14,0,20,19,0,1,47025
15343,980,327,345,203,44,61,52,34,34,18,0,16,0,0,0,0,0,0,0,0,0,18,18,0,0,18,0,0,0,0,0,0,0,0,0,47030
15344,3642,429,1979,844,310,80,277,165,124,6,2,116,41,41,41,0,0,0,0,0,0,112,112,23,29,60,0,0,0,0,0,0,0,0,0,47031
15345,2184,249,963,698,196,78,83,80,76,3,0,73,4,4,4,0,0,0,0,0,0,3,3,3,0,0,0,0,0,0,0,0,0,0,0,47032
15346,65,18,23,17,3,4,8,8,8,0,0,8,0,0,0,0,0,0,0,0,0,0,0,0,0,0,0,0,0,0,0,0,0,0,0,47034
15347,190,72,50,0,49,19,0,0,0,0,0,0,0,0,0,0,0,0,0,0,0,0,0,0,0,0,0,0,0,0,0,0,0,0,0,47035
15348,646,22,295,128,90,111,36,12,12,8,2,2,0,0,0,0,0,0,0,0,0,24,24,12,0,12,0,0,0,0,0,0,0,0,0,47036
15349,2965,634,1384,617,270,60,221,96,61,34,0,27,35,10,10,0,0,25,0,23,2,125,122,25,22,75,3,3,0,3,0,0,0,0,0,47037
15350,905,227,309,224,88,57,81,51,35,12,10,13,16,16,16,0,0,0,0,0,0,30,30,0,0,30,0,0,0,0,0,0,0,0,0,47038
15351,3928,539,1948,891,414,136,252,124,86,21,12,53,38,30,0,5,25,8,0,8,0,128,113,74,0,39,15,15,15,0,0,0,0,0,0,47040
15352,3956,442,1814,1083,467,150,473,216,200,43,5,152,16,0,0,0,0,16,16,0,0,257,257,96,13,148,0,0,0,0,0,0,0,0,0,47041
15353,2932,369,1535,560,311,157,180,51,47,8,23,16,4,4,4,0,0,0,0,0,0,129,119,35,0,84,10,10,10,0,0,0,0,0,0,47042
15354,3605,649,1705,900,219,132,253,118,67,12,23,32,51,21,0,16,5,30,0,30,0,135,121,77,5,39,14,7,4,0,3,7,4,0,3,47043
15355,4519,430,2075,1432,391,191,284,162,145,72,0,73,17,3,3,0,0,14,4,0,10,122,119,73,0,46,3,0,0,0,0,3,3,0,0,47060
15356,5027,1360,2095,1251,208,113,217,91,67,3,9,55,24,7,0,7,0,17,7,10,0,126,63,29,14,20,63,12,12,0,0,51,0,5,46,47102
15357,0,0,0,0,0,0,0,0,0,0,0,0,0,0,0,0,0,0,0,0,0,0,0,0,0,0,0,0,0,0,0,0,0,0,0,47104
15358,3274,539,1133,1093,376,133,158,64,61,28,0,33,3,0,0,0,0,3,3,0,0,94,94,58,0,36,0,0,0,0,0,0,0,0,0,47106
15359,1410,299,579,406,35,91,135,93,79,0,2,77,14,3,3,0,0,11,11,0,0,42,39,0,2,37,3,3,0,3,0,0,0,0,0,47108
15360,199,109,62,14,14,0,11,0,0,0,0,0,0,0,0,0,0,0,0,0,0,11,11,0,0,11,0,0,0,0,0,0,0,0,0,47110
15361,10081,1254,3860,3217,1163,587,667,341,279,105,27,147,62,28,28,0,0,34,16,0,18,326,326,110,10,206,0,0,0,0,0,0,0,0,0,47111
15362,11459,1498,4984,3174,1115,688,986,455,325,65,65,195,130,56,21,25,10,74,64,10,0,531,420,100,34,286,111,54,13,0,41,57,0,45,12,47112
15363,230,38,78,41,69,4,4,2,2,0,0,2,0,0,0,0,0,0,0,0,0,2,2,2,0,0,0,0,0,0,0,0,0,0,0,47114
15364,1894,304,782,502,231,75,122,64,61,3,11,47,3,3,3,0,0,0,0,0,0,58,58,31,23,4,0,0,0,0,0,0,0,0,0,47115
15365,577,144,250,114,34,35,17,5,0,0,0,0,5,0,0,0,0,5,0,5,0,12,12,12,0,0,0,0,0,0,0,0,0,0,0,47116
15366,3129,437,1400,1069,148,75,192,102,94,0,28,66,8,8,0,0,8,0,0,0,0,90,63,6,0,57,27,27,27,0,0,0,0,0,0,47117
15367,2477,481,1124,514,167,191,243,137,102,0,0,102,35,2,2,0,0,33,0,0,33,106,91,30,7,54,15,3,3,0,0,12,0,0,12,47118
15368,8022,492,2762,2354,1619,795,592,257,240,99,0,141,17,15,15,0,0,2,2,0,0,335,314,108,12,194,21,4,4,0,0,17,0,17,0,47119
15369,707,164,346,145,24,28,3,2,1,1,0,0,1,1,0,1,0,0,0,0,0,1,1,0,0,1,0,0,0,0,0,0,0,0,0,47120
15370,6591,361,2224,2057,1386,563,613,300,300,120,18,162,0,0,0,0,0,0,0,0,0,313,272,75,29,168,41,38,29,0,9,3,0,0,3,47122
15371,113,15,74,16,8,0,0,0,0,0,0,0,0,0,0,0,0,0,0,0,0,0,0,0,0,0,0,0,0,0,0,0,0,0,0,47123
15372,3004,176,924,1269,372,263,201,86,73,13,2,58,13,13,3,0,10,0,0,0,0,115,115,20,3,92,0,0,0,0,0,0,0,0,0,47124
15373,1205,146,524,491,27,17,96,55,53,8,2,43,2,0,0,0,0,2,0,2,0,41,15,15,0,0,26,26,13,0,13,0,0,0,0,47125
15374,2770,365,1021,1004,261,119,134,43,38,0,10,28,5,5,0,0,5,0,0,0,0,91,60,15,0,45,31,31,15,0,16,0,0,0,0,47126
15375,13394,2333,5019,3879,1571,592,987,606,453,116,9,328,153,114,52,4,58,39,39,0,0,381,202,74,26,102,179,112,8,34,70,67,67,0,0,47129
15376,30814,4067,10104,10422,4004,2217,2022,1084,736,210,53,473,348,209,53,103,53,139,109,13,17,938,813,389,32,392,125,113,82,19,12,12,0,12,0,47130
15377,860,85,408,225,90,52,94,44,32,0,0,32,12,12,12,0,0,0,0,0,0,50,49,16,0,33,1,0,0,0,0,1,0,0,1,47135
15378,2901,245,991,915,506,244,220,155,139,53,2,84,16,12,12,0,0,4,4,0,0,65,65,13,0,52,0,0,0,0,0,0,0,0,0,47136
15379,1118,124,512,241,95,146,79,33,33,2,0,31,0,0,0,0,0,0,0,0,0,46,38,10,8,20,8,0,0,0,0,8,0,8,0,47137
15380,3459,555,1386,1115,324,79,235,163,163,65,11,87,0,0,0,0,0,0,0,0,0,72,72,15,12,45,0,0,0,0,0,0,0,0,0,47138
15381,1672,374,848,283,125,42,135,76,71,13,0,58,5,3,0,0,3,2,0,0,2,59,42,11,0,31,17,17,2,2,13,0,0,0,0,47140
15382,1281,203,637,377,30,34,101,101,101,10,0,91,0,0,0,0,0,0,0,0,0,0,0,0,0,0,0,0,0,0,0,0,0,0,0,47141
15383,785,76,492,168,49,0,13,13,0,0,0,0,13,13,13,0,0,0,0,0,0,0,0,0,0,0,0,0,0,0,0,0,0,0,0,47142
15384,2388,197,876,787,333,195,81,38,38,10,0,28,0,0,0,0,0,0,0,0,0,43,43,14,10,19,0,0,0,0,0,0,0,0,0,47143
15385,1300,178,648,387,47,40,39,28,28,8,9,11,0,0,0,0,0,0,0,0,0,11,0,0,0,0,11,9,0,9,0,2,0,2,0,47145
15386,662,128,216,183,60,75,46,21,21,0,0,21,0,0,0,0,0,0,0,0,0,25,25,25,0,0,0,0,0,0,0,0,0,0,0,47147
15387,32216,4902,11572,9500,4232,2010,2541,1249,907,159,56,692,342,198,104,83,11,144,7,12,125,1292,1112,345,63,704,180,105,93,0,12,75,18,25,32,47150
15388,59,12,34,9,4,0,2,0,0,0,0,0,0,0,0,0,0,0,0,0,0,2,2,0,0,2,0,0,0,0,0,0,0,0,0,47160
15389,2365,61,1147,841,158,158,288,137,100,31,0,69,37,37,37,0,0,0,0,0,0,151,100,47,0,53,51,0,0,0,0,51,0,0,51,47161
15390,514,144,163,192,15,0,36,14,14,0,0,14,0,0,0,0,0,0,0,0,0,22,22,22,0,0,0,0,0,0,0,0,0,0,0,47162
15391,1188,194,496,344,137,17,141,49,49,28,0,21,0,0,0,0,0,0,0,0,0,92,92,11,0,81,0,0,0,0,0,0,0,0,0,47163
15392,2346,554,1012,615,104,61,185,100,98,29,0,69,2,2,2,0,0,0,0,0,0,85,81,32,0,49,4,4,0,0,4,0,0,0,0,47164
15393,4314,845,1880,1008,286,295,323,148,136,35,15,86,12,5,0,5,0,7,0,0,7,175,168,47,0,121,7,7,0,0,7,0,0,0,0,47165
15394,1047,59,431,306,159,92,47,38,30,13,0,17,8,8,8,0,0,0,0,0,0,9,9,0,0,9,0,0,0,0,0,0,0,0,0,47166
15395,10090,2104,4356,2327,752,551,928,535,348,42,39,267,187,89,42,23,24,98,49,9,40,393,326,85,44,197,67,63,22,41,0,4,4,0,0,47167
15396,9691,1744,3976,2581,1009,381,735,402,313,35,17,261,89,67,40,0,27,22,0,0,22,333,292,73,26,193,41,0,0,0,0,41,18,0,23,47170
15397,10299,1064,3501,3122,1781,831,1033,531,506,138,67,301,25,17,17,0,0,8,0,8,0,502,457,60,47,350,45,0,0,0,0,45,23,0,22,47172
15398,641,168,304,120,38,11,58,23,7,7,0,0,16,16,16,0,0,0,0,0,0,35,35,0,0,35,0,0,0,0,0,0,0,0,0,47175
15399,927,207,273,325,47,75,102,29,29,8,0,21,0,0,0,0,0,0,0,0,0,73,55,0,0,55,18,9,0,0,9,9,9,0,0,47177
15400,28231,3512,9905,7354,4396,3064,2313,1263,962,350,139,473,301,186,20,56,110,115,86,13,16,1050,929,253,37,639,121,94,52,0,42,27,27,0,0,47201
15401,18200,1478,6164,5067,3346,2145,1391,829,747,240,66,441,82,29,6,10,13,53,0,43,10,562,562,218,25,319,0,0,0,0,0,0,0,0,0,47203
15402,3788,467,1605,1236,271,209,199,100,81,7,26,48,19,19,0,9,10,0,0,0,0,99,99,15,6,78,0,0,0,0,0,0,0,0,0,47220
15403,1029,249,486,269,10,15,242,78,78,16,0,62,0,0,0,0,0,0,0,0,0,164,91,21,0,70,73,60,60,0,0,13,0,13,0,47223
15404,377,96,102,144,35,0,29,29,13,0,0,13,16,8,8,0,0,8,8,0,0,0,0,0,0,0,0,0,0,0,0,0,0,0,0,47224
15405,176,30,94,47,5,0,6,2,2,0,0,2,0,0,0,0,0,0,0,0,0,4,4,0,2,2,0,0,0,0,0,0,0,0,0,47226
15406,1121,168,656,230,29,38,23,23,16,0,0,16,7,0,0,0,0,7,7,0,0,0,0,0,0,0,0,0,0,0,0,0,0,0,0,47227
15407,2023,285,1046,548,123,21,258,169,157,14,13,130,12,12,6,6,0,0,0,0,0,89,80,28,0,52,9,9,9,0,0,0,0,0,0,47229
15408,1338,312,536,390,90,10,104,84,74,0,0,74,10,0,0,0,0,10,0,10,0,20,20,11,0,9,0,0,0,0,0,0,0,0,0,47230
15409,695,152,329,137,13,64,42,15,14,1,0,13,1,1,0,1,0,0,0,0,0,27,23,5,1,17,4,4,2,0,2,0,0,0,0,47231
15410,2101,211,926,658,240,66,168,118,80,8,0,72,38,3,3,0,0,35,3,7,25,50,38,7,13,18,12,0,0,0,0,12,12,0,0,47232
15411,1175,121,536,373,133,12,93,36,36,27,9,0,0,0,0,0,0,0,0,0,0,57,57,35,12,10,0,0,0,0,0,0,0,0,0,47234
15412,1483,171,833,188,126,165,57,14,14,0,14,0,0,0,0,0,0,0,0,0,0,43,30,30,0,0,13,13,0,13,0,0,0,0,0,47235
15413,14334,1881,6768,3655,1304,726,996,537,421,90,25,306,116,25,17,8,0,91,29,30,32,459,380,125,10,245,79,20,20,0,0,59,12,9,38,47240
15414,3222,541,1377,763,323,218,761,311,290,46,33,211,21,4,0,4,0,17,0,17,0,450,450,131,9,310,0,0,0,0,0,0,0,0,0,47243
15415,610,48,230,219,92,21,49,18,14,3,3,8,4,3,3,0,0,1,0,0,1,31,23,0,4,19,8,0,0,0,0,8,8,0,0,47244
15416,2950,302,1256,960,312,120,264,156,138,90,0,48,18,18,14,0,4,0,0,0,0,108,77,23,0,54,31,21,14,7,0,10,0,0,10,47246
15417,71,15,35,20,0,1,3,3,3,0,3,0,0,0,0,0,0,0,0,0,0,0,0,0,0,0,0,0,0,0,0,0,0,0,0,47247
15418,15581,2289,5800,4517,1607,1368,1069,500,426,24,35,367,74,13,0,13,0,61,44,0,17,569,449,64,74,311,120,60,20,0,40,60,23,0,37,47250
15419,1305,263,688,299,51,4,134,91,85,14,13,58,6,3,3,0,0,3,0,0,3,43,41,19,4,18,2,2,0,2,0,0,0,0,0,47260
15420,137,20,65,45,5,2,32,17,10,0,0,10,7,0,0,0,0,7,0,7,0,15,15,0,0,15,0,0,0,0,0,0,0,0,0,47263
15421,1284,121,758,198,155,52,148,136,122,0,64,58,14,0,0,0,0,14,0,0,14,12,12,12,0,0,0,0,0,0,0,0,0,0,0,47264
15422,13430,2078,6312,3718,866,456,1390,760,587,98,121,368,173,135,116,4,15,38,0,38,0,630,542,99,52,391,88,44,2,18,24,44,0,0,44,47265
15423,458,33,221,174,17,13,15,0,0,0,0,0,0,0,0,0,0,0,0,0,0,15,15,0,0,15,0,0,0,0,0,0,0,0,0,47270
15424,1585,197,789,454,98,47,109,50,45,12,0,33,5,5,5,0,0,0,0,0,0,59,50,10,9,31,9,9,3,0,6,0,0,0,0,47272
15425,1150,90,549,328,89,94,32,25,25,25,0,0,0,0,0,0,0,0,0,0,0,7,7,7,0,0,0,0,0,0,0,0,0,0,0,47273
15426,19264,2703,8486,4910,2143,1022,1371,657,447,129,52,266,210,119,95,22,2,91,18,0,73,714,582,218,36,328,132,92,72,13,7,40,33,0,7,47274
15427,427,38,168,202,19,0,15,15,15,15,0,0,0,0,0,0,0,0,0,0,0,0,0,0,0,0,0,0,0,0,0,0,0,0,0,47280
15428,1072,135,615,223,40,59,26,18,18,0,0,18,0,0,0,0,0,0,0,0,0,8,8,0,0,8,0,0,0,0,0,0,0,0,0,47281
15429,152,17,34,78,17,6,6,0,0,0,0,0,0,0,0,0,0,0,0,0,0,6,6,0,0,6,0,0,0,0,0,0,0,0,0,47282
15430,1768,210,882,429,122,125,234,91,66,32,15,19,25,0,0,0,0,25,21,0,4,143,105,52,8,45,38,30,23,0,7,8,0,0,8,47283
15431,18197,3669,7950,4901,1014,663,1320,686,489,102,103,284,197,93,30,28,35,104,55,31,18,634,553,185,79,289,81,46,13,0,33,35,0,10,25,47302
15432,14252,2330,5141,4411,1507,863,1483,701,622,116,51,455,79,34,28,0,6,45,0,1,44,782,700,140,96,464,82,64,40,16,8,18,18,0,0,47303
15433,19265,1023,4788,5486,3859,4109,1585,825,653,188,100,365,172,108,92,16,0,64,36,14,14,760,656,161,43,452,104,71,41,30,0,33,0,0,33,47304
15434,2830,795,803,753,219,260,140,97,46,9,8,29,51,4,4,0,0,47,0,2,45,43,43,20,10,13,0,0,0,0,0,0,0,0,0,47305
15435,59,0,36,22,1,0,4198,1648,1648,239,176,1233,0,0,0,0,0,0,0,0,0,2550,2550,456,371,1723,0,0,0,0,0,0,0,0,0,47306
15436,3069,331,1233,997,244,264,198,124,115,17,6,92,9,6,6,0,0,3,0,0,3,74,72,33,2,37,2,0,0,0,0,2,0,0,2,47320
15437,108,21,44,39,0,4,6,5,0,0,0,0,5,5,5,0,0,0,0,0,0,1,0,0,0,0,1,1,1,0,0,0,0,0,0,47324
15438,476,69,265,99,30,13,51,32,16,16,0,0,16,16,16,0,0,0,0,0,0,19,0,0,0,0,19,0,0,0,0,19,0,0,19,47325
15439,1081,170,549,243,94,25,127,82,59,51,0,8,23,15,15,0,0,8,8,0,0,45,21,1,0,20,24,6,0,6,0,18,0,0,18,47326
15440,3352,461,1559,881,272,179,168,81,75,29,10,36,6,3,3,0,0,3,0,0,3,87,59,19,11,29,28,2,0,2,0,26,18,8,0,47327
15441,3954,490,1684,1150,355,275,286,188,154,19,4,131,34,13,3,10,0,21,0,21,0,98,64,9,8,47,34,14,0,14,0,20,0,0,20,47330
15442,16045,3620,6812,4162,931,520,1186,627,545,62,0,483,82,82,36,46,0,0,0,0,0,559,471,136,29,306,88,47,14,24,9,41,0,0,41,47331
15443,2316,206,967,737,244,162,163,80,63,43,4,16,17,17,17,0,0,0,0,0,0,83,83,35,11,37,0,0,0,0,0,0,0,0,0,47334
15444,481,107,231,94,42,7,36,23,23,8,12,3,0,0,0,0,0,0,0,0,0,13,13,0,5,8,0,0,0,0,0,0,0,0,0,47335
15445,2423,536,1152,544,109,82,239,114,91,12,10,69,23,19,12,7,0,4,4,0,0,125,102,31,4,67,23,23,19,4,0,0,0,0,0,47336
15446,121,14,70,31,4,2,4,0,0,0,0,0,0,0,0,0,0,0,0,0,0,4,4,0,0,4,0,0,0,0,0,0,0,0,0,47337
15447,1855,179,923,525,161,67,124,65,26,5,0,21,39,35,32,0,3,4,0,0,4,59,52,29,0,23,7,0,0,0,0,7,0,7,0,47338
15448,469,35,231,127,43,33,25,11,11,11,0,0,0,0,0,0,0,0,0,0,0,14,7,7,0,0,7,7,7,0,0,0,0,0,0,47339
15449,2024,214,944,572,185,109,121,83,61,18,10,33,22,22,9,11,2,0,0,0,0,38,38,8,0,30,0,0,0,0,0,0,0,0,0,47340
15450,1556,216,632,548,110,50,122,37,22,4,2,16,15,15,15,0,0,0,0,0,0,85,73,2,0,71,12,10,10,0,0,2,0,0,2,47341
15451,2040,188,1158,431,184,79,192,94,94,20,0,74,0,0,0,0,0,0,0,0,0,98,98,15,18,65,0,0,0,0,0,0,0,0,0,47342
15452,113,18,74,15,2,4,32,31,30,0,0,30,1,1,0,1,0,0,0,0,0,1,1,0,0,1,0,0,0,0,0,0,0,0,0,47344
15453,998,133,435,203,201,26,107,71,55,6,0,49,16,0,0,0,0,16,16,0,0,36,24,1,20,3,12,0,0,0,0,12,12,0,0,47345
15454,2725,314,1081,780,299,251,269,119,108,40,0,68,11,0,0,0,0,11,0,11,0,150,108,37,3,68,42,0,0,0,0,42,42,0,0,47346
15455,6985,932,3491,1876,432,254,503,233,189,32,14,143,44,44,16,16,12,0,0,0,0,270,209,47,0,162,61,61,23,18,20,0,0,0,0,47348
15456,377,61,183,99,21,13,22,22,22,2,5,15,0,0,0,0,0,0,0,0,0,0,0,0,0,0,0,0,0,0,0,0,0,0,0,47351
15457,582,100,294,98,81,9,64,50,50,2,0,48,0,0,0,0,0,0,0,0,0,14,14,0,0,14,0,0,0,0,0,0,0,0,0,47352
15458,3889,588,1434,1080,461,326,304,189,148,66,15,67,41,0,0,0,0,41,18,20,3,115,95,41,23,31,20,16,10,0,6,4,0,4,0,47353
15459,764,129,382,148,61,44,64,23,9,0,2,7,14,13,13,0,0,1,1,0,0,41,36,0,21,15,5,5,5,0,0,0,0,0,0,47354
15460,1968,284,912,545,110,117,125,47,43,9,3,31,4,2,2,0,0,2,2,0,0,78,60,13,17,30,18,18,7,11,0,0,0,0,0,47355
15461,4192,350,1863,1319,445,215,286,152,132,32,23,77,20,20,0,13,7,0,0,0,0,134,109,32,5,72,25,10,10,0,0,15,0,0,15,47356
15462,984,97,393,331,121,42,108,83,76,12,0,64,7,7,7,0,0,0,0,0,0,25,25,4,7,14,0,0,0,0,0,0,0,0,0,47357
15463,781,90,248,330,74,39,74,68,62,10,8,44,6,6,6,0,0,0,0,0,0,6,3,0,0,3,3,3,3,0,0,0,0,0,0,47358
15464,1942,246,1020,466,159,51,180,119,90,30,0,60,29,14,8,0,6,15,0,0,15,61,58,9,0,49,3,0,0,0,0,3,0,3,0,47359
15465,1113,97,646,233,87,50,69,56,35,9,14,12,21,5,5,0,0,16,9,3,4,13,13,0,0,13,0,0,0,0,0,0,0,0,0,47360
15466,102,18,29,33,19,3,24,19,14,0,0,14,5,5,5,0,0,0,0,0,0,5,5,0,0,5,0,0,0,0,0,0,0,0,0,47361
15467,21186,3404,8980,5628,2084,1090,1418,652,499,95,17,387,153,117,39,16,62,36,0,10,26,766,709,145,14,550,57,56,49,0,7,1,0,0,1,47362
15468,79,11,12,33,0,23,0,0,0,0,0,0,0,0,0,0,0,0,0,0,0,0,0,0,0,0,0,0,0,0,0,0,0,0,0,47367
15469,1974,219,882,492,175,206,126,69,64,10,5,49,5,2,2,0,0,3,0,0,3,57,48,6,0,42,9,6,6,0,0,3,0,3,0,47368
15470,1016,144,543,249,76,4,110,55,48,5,17,26,7,7,4,0,3,0,0,0,0,55,41,3,29,9,14,5,2,0,3,9,0,9,0,47369
15471,8434,1304,3879,2331,583,337,639,387,325,90,57,178,62,5,0,0,5,57,18,28,11,252,225,82,12,131,27,27,0,9,18,0,0,0,0,47371
15472,1421,227,738,326,66,64,82,39,35,7,0,28,4,4,4,0,0,0,0,0,0,43,41,27,0,14,2,0,0,0,0,2,0,0,2,47373
15473,31310,5749,11630,8265,3209,2457,2776,1427,1083,128,138,817,344,164,15,81,68,180,39,21,120,1349,1144,348,75,721,205,105,69,26,10,100,15,33,52,47374
15474,1299,144,654,345,131,25,149,68,67,13,27,27,1,1,0,1,0,0,0,0,0,81,71,18,0,53,10,10,0,1,9,0,0,0,0,47380
15475,110,23,57,30,0,0,4,4,4,0,2,2,0,0,0,0,0,0,0,0,0,0,0,0,0,0,0,0,0,0,0,0,0,0,0,47381
15476,90,27,37,21,2,3,12,4,4,4,0,0,0,0,0,0,0,0,0,0,0,8,3,3,0,0,5,5,5,0,0,0,0,0,0,47382
15477,1875,141,774,565,311,84,116,56,52,2,5,45,4,2,2,0,0,2,2,0,0,60,47,11,0,36,13,13,0,13,0,0,0,0,0,47383
15478,1348,213,592,398,93,52,149,88,83,0,23,60,5,3,3,0,0,2,0,2,0,61,61,17,0,44,0,0,0,0,0,0,0,0,0,47384
15479,1268,106,724,207,140,91,77,29,27,14,0,13,2,2,0,2,0,0,0,0,0,48,48,0,7,41,0,0,0,0,0,0,0,0,0,47385
15480,1056,107,497,270,168,14,70,48,34,31,0,3,14,0,0,0,0,14,0,14,0,22,22,0,0,22,0,0,0,0,0,0,0,0,0,47386
15481,553,98,254,109,48,44,22,15,15,0,0,15,0,0,0,0,0,0,0,0,0,7,7,7,0,0,0,0,0,0,0,0,0,0,0,47387
15482,261,17,155,71,18,0,19,9,4,1,0,3,5,0,0,0,0,5,0,0,5,10,10,0,0,10,0,0,0,0,0,0,0,0,0,47388
15483,3515,536,1556,1071,259,93,306,188,157,69,0,88,31,13,13,0,0,18,14,4,0,118,99,26,24,49,19,19,0,0,19,0,0,0,0,47390
15484,1136,189,432,330,127,58,157,134,107,54,14,39,27,0,0,0,0,27,0,0,27,23,23,0,0,23,0,0,0,0,0,0,0,0,0,47393
15485,5641,932,2518,1550,427,214,419,151,116,6,4,106,35,35,28,7,0,0,0,0,0,268,231,46,41,144,37,26,17,0,9,11,0,7,4,47394
15486,4788,381,1602,1206,1073,526,446,238,226,25,0,201,12,12,12,0,0,0,0,0,0,208,205,56,18,131,3,3,3,0,0,0,0,0,0,47396
15487,24039,1208,3580,4824,6706,7721,2646,1334,1239,339,53,847,95,78,66,0,12,17,0,0,17,1312,1252,380,153,719,60,47,44,0,3,13,0,0,13,47401
15488,19987,1664,6349,6245,3400,2329,1192,503,386,75,60,251,117,75,48,21,6,42,36,0,6,689,578,261,100,217,111,33,30,0,3,78,4,18,56,47403
15489,12548,1544,3520,3544,2297,1643,1081,453,395,73,0,322,58,12,1,0,11,46,39,0,7,628,582,192,53,337,46,42,42,0,0,4,1,3,0,47404
15490,72,0,0,46,0,26,3067,1631,1631,248,50,1333,0,0,0,0,0,0,0,0,0,1436,1436,316,75,1045,0,0,0,0,0,0,0,0,0,47405
15491,20,0,0,0,0,20,3204,1606,1606,125,59,1422,0,0,0,0,0,0,0,0,0,1598,1598,245,111,1242,0,0,0,0,0,0,0,0,0,47406
15492,12036,652,1513,2526,3133,4212,2276,914,892,119,51,722,22,0,0,0,0,22,0,8,14,1362,1307,302,106,899,55,21,21,0,0,34,34,0,0,47408
15493,33,0,0,0,33,0,0,0,0,0,0,0,0,0,0,0,0,0,0,0,0,0,0,0,0,0,0,0,0,0,0,0,0,0,0,47420
15494,19017,2940,7632,5835,1753,857,1402,775,647,208,24,415,128,43,15,28,0,85,41,0,44,627,445,82,43,320,182,182,77,16,89,0,0,0,0,47421
15495,6129,747,2327,2251,485,319,361,203,147,56,10,81,56,12,0,0,12,44,0,0,44,158,144,14,2,128,14,14,0,0,14,0,0,0,0,47424
15496,855,245,395,166,39,10,14,14,14,14,0,0,0,0,0,0,0,0,0,0,0,0,0,0,0,0,0,0,0,0,0,0,0,0,0,47427
15497,5626,704,2051,1540,808,523,238,161,157,25,28,104,4,0,0,0,0,4,0,0,4,77,65,50,0,15,12,12,0,0,12,0,0,0,0,47429
15498,801,165,347,205,65,19,96,41,25,0,0,25,16,0,0,0,0,16,16,0,0,55,55,33,0,22,0,0,0,0,0,0,0,0,0,47431
15499,3225,810,1322,735,203,155,348,126,107,50,0,57,19,9,0,9,0,10,10,0,0,222,147,38,0,109,75,10,0,10,0,65,11,16,38,47432
15500,2997,467,1457,757,160,156,273,132,105,27,14,64,27,6,6,0,0,21,21,0,0,141,126,38,14,74,15,0,0,0,0,15,0,0,15,47433
15501,99,27,22,35,15,0,0,0,0,0,0,0,0,0,0,0,0,0,0,0,0,0,0,0,0,0,0,0,0,0,0,0,0,0,0,47434
15502,1076,201,541,140,98,96,131,105,83,23,18,42,22,5,5,0,0,17,0,17,0,26,26,0,0,26,0,0,0,0,0,0,0,0,0,47436
15503,0,0,0,0,0,0,0,0,0,0,0,0,0,0,0,0,0,0,0,0,0,0,0,0,0,0,0,0,0,0,0,0,0,0,0,47437
15504,2952,373,1542,739,219,79,207,115,100,22,0,78,15,0,0,0,0,15,0,0,15,92,78,25,0,53,14,14,14,0,0,0,0,0,0,47438
15505,6383,1105,2395,2068,477,338,439,318,235,124,30,81,83,62,46,16,0,21,0,5,16,121,111,50,9,52,10,10,10,0,0,0,0,0,0,47441
15506,782,151,355,190,48,38,51,17,13,2,0,11,4,0,0,0,0,4,4,0,0,34,23,4,0,19,11,11,0,11,0,0,0,0,0,47443
15507,7423,1410,3179,1760,708,366,498,237,164,29,4,131,73,16,16,0,0,57,16,11,30,261,210,45,0,165,51,11,11,0,0,40,0,0,40,47446
15508,5235,612,1849,1485,729,560,220,157,116,30,16,70,41,41,26,13,2,0,0,0,0,63,47,14,8,25,16,16,14,0,2,0,0,0,0,47448
15509,386,78,125,168,14,1,27,16,3,0,3,0,13,13,13,0,0,0,0,0,0,11,9,3,0,6,2,2,2,0,0,0,0,0,0,47449
15510,1016,153,469,323,47,24,47,21,15,4,0,11,6,6,3,3,0,0,0,0,0,26,22,8,0,14,4,4,0,0,4,0,0,0,0,47451
15511,3340,657,1550,638,263,232,288,158,126,15,10,101,32,32,32,0,0,0,0,0,0,130,71,11,3,57,59,15,10,5,0,44,0,0,44,47452
15512,277,71,119,48,22,17,54,0,0,0,0,0,0,0,0,0,0,0,0,0,0,54,54,54,0,0,0,0,0,0,0,0,0,0,0,47453
15513,5030,910,2272,1242,418,188,494,312,239,101,13,125,73,65,9,10,46,8,0,0,8,182,130,31,10,89,52,52,44,8,0,0,0,0,0,47454
15514,21,21,0,0,0,0,0,0,0,0,0,0,0,0,0,0,0,0,0,0,0,0,0,0,0,0,0,0,0,0,0,0,0,0,0,47455
15515,738,94,399,183,43,19,100,20,20,0,0,20,0,0,0,0,0,0,0,0,0,80,80,0,6,74,0,0,0,0,0,0,0,0,0,47456
15516,33,9,0,16,8,0,0,0,0,0,0,0,0,0,0,0,0,0,0,0,0,0,0,0,0,0,0,0,0,0,0,0,0,0,0,47457
15517,0,0,0,0,0,0,0,0,0,0,0,0,0,0,0,0,0,0,0,0,0,0,0,0,0,0,0,0,0,0,0,0,0,0,0,47458
15518,2705,365,1144,776,258,162,260,114,114,29,13,72,0,0,0,0,0,0,0,0,0,146,118,0,0,118,28,28,0,0,28,0,0,0,0,47459
15519,7963,1194,3658,2030,720,361,547,299,228,65,27,136,71,33,15,0,18,38,38,0,0,248,196,72,22,102,52,51,37,8,6,1,0,0,1,47460
15520,3653,578,1499,1149,260,167,301,59,59,28,13,18,0,0,0,0,0,0,0,0,0,242,227,131,37,59,15,15,0,0,15,0,0,0,0,47462
15521,126,36,34,38,13,5,7,2,1,0,0,1,1,1,0,0,1,0,0,0,0,5,5,0,0,5,0,0,0,0,0,0,0,0,0,47464
15522,414,50,142,168,39,15,21,16,12,0,2,10,4,0,0,0,0,4,4,0,0,5,5,3,0,2,0,0,0,0,0,0,0,0,0,47465
15523,38,19,19,0,0,0,0,0,0,0,0,0,0,0,0,0,0,0,0,0,0,0,0,0,0,0,0,0,0,0,0,0,0,0,0,47467
15524,877,112,265,305,23,172,8,8,8,8,0,0,0,0,0,0,0,0,0,0,0,0,0,0,0,0,0,0,0,0,0,0,0,0,0,47468
15525,1245,284,483,260,196,22,110,38,34,0,0,34,4,2,0,0,2,2,2,0,0,72,58,16,0,42,14,14,14,0,0,0,0,0,0,47469
15526,1318,146,584,386,95,107,104,95,62,17,29,16,33,33,33,0,0,0,0,0,0,9,9,0,0,9,0,0,0,0,0,0,0,0,0,47470
15527,1646,360,747,422,61,56,159,91,68,32,0,36,23,3,3,0,0,20,16,4,0,68,56,10,0,46,12,5,0,0,5,7,0,0,7,47471
15528,11680,1845,5289,2898,947,701,793,379,265,83,9,173,114,63,22,32,9,51,6,0,45,414,348,180,4,164,66,35,21,6,8,31,6,0,25,47501
15529,2632,414,1126,840,170,82,191,99,99,32,6,61,0,0,0,0,0,0,0,0,0,92,69,30,0,39,23,10,1,0,9,13,0,13,0,47512
15530,1270,167,736,240,67,60,122,87,73,26,0,47,14,1,1,0,0,13,13,0,0,35,35,8,2,25,0,0,0,0,0,0,0,0,0,47513
15531,1397,325,792,224,56,0,58,58,28,28,0,0,30,0,0,0,0,30,0,0,30,0,0,0,0,0,0,0,0,0,0,0,0,0,0,47514
15532,599,102,344,132,21,0,65,36,29,0,0,29,7,7,0,7,0,0,0,0,0,29,29,5,0,24,0,0,0,0,0,0,0,0,0,47515
15533,1011,99,475,314,43,80,42,18,18,15,0,3,0,0,0,0,0,0,0,0,0,24,24,19,0,5,0,0,0,0,0,0,0,0,0,47516
15534,220,79,98,36,5,2,16,9,8,8,0,0,1,1,1,0,0,0,0,0,0,7,7,2,0,5,0,0,0,0,0,0,0,0,0,47519
15535,2070,391,929,622,86,42,133,44,22,12,0,10,22,13,0,3,10,9,0,5,4,89,78,11,13,54,11,1,0,0,1,10,0,0,10,47520
15536,554,11,267,189,58,29,36,15,15,15,0,0,0,0,0,0,0,0,0,0,0,21,21,21,0,0,0,0,0,0,0,0,0,0,0,47521
15537,161,22,53,73,7,6,6,2,1,1,0,0,1,1,1,0,0,0,0,0,0,4,4,0,0,4,0,0,0,0,0,0,0,0,0,47522
15538,2383,469,806,719,220,169,57,28,21,8,0,13,7,0,0,0,0,7,0,7,0,29,29,20,0,9,0,0,0,0,0,0,0,0,0,47523
15539,414,29,199,115,71,0,6,6,6,2,0,4,0,0,0,0,0,0,0,0,0,0,0,0,0,0,0,0,0,0,0,0,0,0,0,47524
15540,200,0,75,52,45,28,0,0,0,0,0,0,0,0,0,0,0,0,0,0,0,0,0,0,0,0,0,0,0,0,0,0,0,0,0,47525
15541,1326,129,504,364,218,111,88,53,45,0,0,45,8,8,8,0,0,0,0,0,0,35,35,24,0,11,0,0,0,0,0,0,0,0,0,47527
15542,492,62,221,138,68,3,38,6,6,1,0,5,0,0,0,0,0,0,0,0,0,32,19,0,0,19,13,2,0,0,2,11,11,0,0,47528
15543,541,85,213,168,52,23,62,36,26,0,0,26,10,8,4,0,4,2,0,0,2,26,9,0,0,9,17,12,3,0,9,5,3,0,2,47529
15544,525,33,276,187,13,16,0,0,0,0,0,0,0,0,0,0,0,0,0,0,0,0,0,0,0,0,0,0,0,0,0,0,0,0,0,47531
15545,3232,300,1494,813,327,298,285,155,132,29,5,98,23,3,3,0,0,20,20,0,0,130,111,31,3,77,19,6,0,6,0,13,0,0,13,47532
15546,266,20,108,118,0,20,0,0,0,0,0,0,0,0,0,0,0,0,0,0,0,0,0,0,0,0,0,0,0,0,0,0,0,0,0,47535
15547,0,0,0,0,0,0,0,0,0,0,0,0,0,0,0,0,0,0,0,0,0,0,0,0,0,0,0,0,0,0,0,0,0,0,0,47536
15548,496,91,243,128,20,14,39,37,37,0,0,37,0,0,0,0,0,0,0,0,0,2,2,2,0,0,0,0,0,0,0,0,0,0,0,47537
15549,869,82,344,308,84,51,66,14,4,2,0,2,10,10,10,0,0,0,0,0,0,52,49,32,12,5,3,3,0,0,3,0,0,0,0,47541
15550,6351,1189,2540,1608,639,375,583,217,189,33,9,147,28,28,28,0,0,0,0,0,0,366,303,160,9,134,63,63,0,0,63,0,0,0,0,47542
15551,14300,1783,5509,3943,2022,1043,1173,784,633,342,44,247,151,116,101,14,1,35,35,0,0,389,316,126,20,170,73,28,28,0,0,45,45,0,0,47546
15552,478,36,204,186,30,22,67,23,23,23,0,0,0,0,0,0,0,0,0,0,0,44,44,31,0,13,0,0,0,0,0,0,0,0,0,47550
15553,603,59,220,176,73,75,32,6,6,0,0,6,0,0,0,0,0,0,0,0,0,26,26,13,0,13,0,0,0,0,0,0,0,0,0,47551
15554,97,42,32,11,12,0,0,0,0,0,0,0,0,0,0,0,0,0,0,0,0,0,0,0,0,0,0,0,0,0,0,0,0,0,0,47552
15555,5532,1229,2094,1617,394,198,505,277,213,63,30,120,64,16,16,0,0,48,26,0,22,228,174,62,10,102,54,0,0,0,0,54,52,0,2,47553
15556,901,36,462,314,77,12,19,15,15,7,2,6,0,0,0,0,0,0,0,0,0,4,4,4,0,0,0,0,0,0,0,0,0,0,0,47557
15557,2785,1364,664,486,77,194,416,245,82,14,11,57,163,32,32,0,0,131,131,0,0,171,37,7,0,30,134,12,0,0,12,122,114,0,8,47558
15558,945,190,410,307,29,9,113,58,37,0,0,37,21,0,0,0,0,21,21,0,0,55,42,3,0,39,13,13,0,13,0,0,0,0,0,47561
15559,2667,521,1144,720,174,108,265,124,114,0,6,108,10,10,0,0,10,0,0,0,0,141,113,21,8,84,28,13,10,0,3,15,15,0,0,47562
15560,1143,196,511,354,51,31,95,15,15,15,0,0,0,0,0,0,0,0,0,0,0,80,75,0,0,75,5,0,0,0,0,5,0,0,5,47564
15561,3933,585,1842,993,327,186,240,125,54,12,12,30,71,40,19,10,11,31,14,17,0,115,103,49,0,54,12,12,5,0,7,0,0,0,0,47567
15562,446,49,212,147,21,17,32,22,20,0,0,20,2,2,0,2,0,0,0,0,0,10,8,5,0,3,2,1,1,0,0,1,0,0,1,47568
15563,94,18,58,18,0,0,0,0,0,0,0,0,0,0,0,0,0,0,0,0,0,0,0,0,0,0,0,0,0,0,0,0,0,0,0,47574
15564,587,57,303,185,42,0,89,0,0,0,0,0,0,0,0,0,0,0,0,0,0,89,89,22,48,19,0,0,0,0,0,0,0,0,0,47575
15565,239,47,118,63,0,11,50,10,10,0,0,10,0,0,0,0,0,0,0,0,0,40,40,0,0,40,0,0,0,0,0,0,0,0,0,47576
15566,772,190,297,172,63,50,21,0,0,0,0,0,0,0,0,0,0,0,0,0,0,21,21,0,0,21,0,0,0,0,0,0,0,0,0,47577
15567,528,44,153,231,72,28,54,8,8,0,2,6,0,0,0,0,0,0,0,0,0,46,46,2,0,44,0,0,0,0,0,0,0,0,0,47578
15568,2021,86,782,577,295,281,221,133,133,44,11,78,0,0,0,0,0,0,0,0,0,88,88,33,0,55,0,0,0,0,0,0,0,0,0,47579
15569,326,0,200,108,18,0,7,7,7,7,0,0,0,0,0,0,0,0,0,0,0,0,0,0,0,0,0,0,0,0,0,0,0,0,0,47580
15570,2692,415,1133,852,173,119,117,36,35,12,15,8,1,0,0,0,0,1,0,0,1,81,81,34,0,47,0,0,0,0,0,0,0,0,0,47581
15571,89,9,58,18,3,1,1,0,0,0,0,0,0,0,0,0,0,0,0,0,0,1,1,0,0,1,0,0,0,0,0,0,0,0,0,47584
15572,407,9,242,134,22,0,10,10,10,10,0,0,0,0,0,0,0,0,0,0,0,0,0,0,0,0,0,0,0,0,0,0,0,0,0,47585
15573,7791,1076,3510,2213,528,464,569,339,282,111,46,125,57,35,24,11,0,22,22,0,0,230,206,105,13,88,24,24,24,0,0,0,0,0,0,47586
15574,480,106,240,116,3,15,3,1,0,0,0,0,1,0,0,0,0,1,0,1,0,2,2,1,0,1,0,0,0,0,0,0,0,0,0,47588
15575,428,30,202,80,60,56,59,45,45,0,0,45,0,0,0,0,0,0,0,0,0,14,14,6,0,8,0,0,0,0,0,0,0,0,0,47590
15576,17127,2494,5786,6148,1663,1036,2419,1488,1425,237,9,1179,63,37,20,14,3,26,0,21,5,931,895,224,58,613,36,1,0,0,1,35,9,13,13,47591
15577,62,0,49,13,0,0,0,0,0,0,0,0,0,0,0,0,0,0,0,0,0,0,0,0,0,0,0,0,0,0,0,0,0,0,0,47596
15578,774,65,353,246,68,42,84,51,51,29,0,22,0,0,0,0,0,0,0,0,0,33,33,21,0,12,0,0,0,0,0,0,0,0,0,47597
15579,2562,400,1232,730,143,57,242,141,95,40,0,55,46,46,39,1,6,0,0,0,0,101,67,43,0,24,34,26,8,0,18,8,2,0,6,47598
15580,9924,1062,4052,3143,1081,586,547,270,224,74,0,150,46,36,0,0,36,10,0,10,0,277,259,205,20,34,18,18,18,0,0,0,0,0,0,47601
15581,3162,332,1381,1126,260,63,249,86,86,47,0,39,0,0,0,0,0,0,0,0,0,163,84,19,10,55,79,58,0,51,7,21,21,0,0,47610
15582,912,172,413,256,33,38,55,24,24,12,0,12,0,0,0,0,0,0,0,0,0,31,31,3,5,23,0,0,0,0,0,0,0,0,0,47611
15583,697,102,279,208,98,10,74,62,36,11,0,25,26,10,10,0,0,16,12,0,4,12,2,0,0,2,10,0,0,0,0,10,10,0,0,47612
15584,1852,237,621,682,218,94,156,51,48,5,0,43,3,3,3,0,0,0,0,0,0,105,105,55,17,33,0,0,0,0,0,0,0,0,0,47613
15585,1101,151,490,299,95,66,142,77,53,4,21,28,24,22,0,0,22,2,2,0,0,65,44,20,0,24,21,21,0,21,0,0,0,0,0,47615
15586,211,22,66,70,53,0,29,0,0,0,0,0,0,0,0,0,0,0,0,0,0,29,29,6,0,23,0,0,0,0,0,0,0,0,0,47616
15587,1055,107,490,332,59,67,73,49,45,10,4,31,4,4,2,2,0,0,0,0,0,24,24,9,0,15,0,0,0,0,0,0,0,0,0,47619
15588,8872,685,3469,2833,1154,731,810,437,405,121,26,258,32,18,0,13,5,14,14,0,0,373,352,148,0,204,21,21,0,0,21,0,0,0,0,47620
15589,23427,1236,6078,7646,5469,2998,1801,1032,981,355,75,551,51,51,18,0,33,0,0,0,0,769,741,451,37,253,28,28,12,0,16,0,0,0,0,47630
15590,1395,139,542,477,143,94,60,20,20,8,3,9,0,0,0,0,0,0,0,0,0,40,40,16,11,13,0,0,0,0,0,0,0,0,0,47631
15591,1807,190,740,514,259,104,137,87,59,42,0,17,28,28,9,0,19,0,0,0,0,50,39,14,0,25,11,11,7,0,4,0,0,0,0,47633
15592,1713,158,1047,332,154,22,133,76,31,12,0,19,45,45,32,0,13,0,0,0,0,57,44,28,0,16,13,13,0,0,13,0,0,0,0,47634
15593,3946,621,1732,950,338,305,433,242,183,21,15,147,59,33,0,19,14,26,2,0,24,191,184,16,20,148,7,0,0,0,0,7,0,7,0,47635
15594,1114,131,574,315,61,33,96,41,38,1,0,37,3,3,3,0,0,0,0,0,0,55,55,0,0,55,0,0,0,0,0,0,0,0,0,47637
15595,2480,109,1060,839,331,141,210,85,85,15,11,59,0,0,0,0,0,0,0,0,0,125,125,41,0,84,0,0,0,0,0,0,0,0,0,47638
15596,2855,145,1167,959,472,112,184,110,110,70,4,36,0,0,0,0,0,0,0,0,0,74,66,25,28,13,8,3,3,0,0,5,0,5,0,47639
15597,711,87,335,213,60,16,37,31,23,0,0,23,8,0,0,0,0,8,8,0,0,6,6,0,0,6,0,0,0,0,0,0,0,0,0,47640
15598,3116,175,1294,1020,365,262,148,66,60,13,3,44,6,6,6,0,0,0,0,0,0,82,72,35,0,37,10,10,10,0,0,0,0,0,0,47648
15599,1010,103,479,340,39,49,73,50,43,12,0,31,7,0,0,0,0,7,0,0,7,23,23,23,0,0,0,0,0,0,0,0,0,0,0,47649
15600,55,3,21,29,2,0,6,0,0,0,0,0,0,0,0,0,0,0,0,0,0,6,0,0,0,0,6,0,0,0,0,6,0,0,6,47654
15601,3575,659,1504,1014,196,202,273,103,74,10,6,58,29,12,4,8,0,17,0,0,17,170,170,27,12,131,0,0,0,0,0,0,0,0,0,47660
15602,2406,148,932,935,335,56,215,62,31,23,0,8,31,20,20,0,0,11,4,7,0,153,118,6,20,92,35,35,21,0,14,0,0,0,0,47665
15603,993,116,485,302,51,39,79,23,12,3,0,9,11,11,11,0,0,0,0,0,0,56,49,10,0,39,7,7,7,0,0,0,0,0,0,47666
15604,8279,828,3057,2950,1192,252,592,311,286,122,27,137,25,5,5,0,0,20,0,16,4,281,267,75,49,143,14,14,14,0,0,0,0,0,0,47670
15605,113,16,38,23,29,7,11,3,0,0,0,0,3,3,0,3,0,0,0,0,0,8,8,8,0,0,0,0,0,0,0,0,0,0,0,47683
15606,277,12,90,101,38,36,11,11,10,0,0,10,1,1,0,0,1,0,0,0,0,0,0,0,0,0,0,0,0,0,0,0,0,0,0,47708
15607,13433,2324,5356,3713,1414,626,853,551,459,150,39,270,92,46,38,2,6,46,12,19,15,302,242,105,7,130,60,17,0,8,9,43,39,0,4,47710
15608,22241,2183,8088,7368,3246,1356,1387,791,569,160,51,358,222,147,48,57,42,75,10,13,52,596,402,145,18,239,194,79,72,0,7,115,42,21,52,47711
15609,15893,1628,5506,5199,2307,1253,2568,996,984,265,70,649,12,0,0,0,0,12,0,0,12,1572,1525,488,70,967,47,42,15,0,27,5,0,0,5,47712
15610,7016,1383,2478,2281,498,376,493,248,190,61,6,123,58,52,35,0,17,6,0,5,1,245,148,22,38,88,97,63,21,5,37,34,5,13,16,47713
15611,21543,3163,8026,6767,2518,1069,2155,894,718,138,74,506,176,56,0,41,15,120,42,11,67,1261,1187,250,40,897,74,15,15,0,0,59,23,19,17,47714
15612,18043,1115,5266,6161,3638,1863,1129,577,525,96,45,384,52,0,0,0,0,52,0,7,45,552,408,201,40,167,144,74,54,13,7,70,0,14,56,47715
15613,12645,839,5210,3748,2035,813,846,471,393,104,79,210,78,78,29,0,49,0,0,0,0,375,303,190,0,113,72,72,38,0,34,0,0,0,0,47720
15614,10906,437,2560,3448,2832,1629,562,306,279,96,16,167,27,27,0,11,16,0,0,0,0,256,188,65,0,123,68,3,0,3,0,65,23,10,32,47725
15615,24015,2916,7759,7819,3204,2317,1391,689,603,139,41,423,86,23,11,0,12,63,1,8,54,702,474,126,28,320,228,57,13,0,44,171,25,43,103,47802
15616,13301,1036,4030,4013,2308,1914,1603,1083,981,262,103,616,102,24,4,0,20,78,20,47,11,520,514,197,15,302,6,6,0,0,6,0,0,0,0,47803
15617,7797,1545,2965,2326,588,373,525,207,189,23,19,147,18,10,10,0,0,8,0,0,8,318,275,46,65,164,43,37,37,0,0,6,0,0,6,47804
15618,8372,774,3209,2774,1090,525,725,337,307,149,17,141,30,11,11,0,0,19,0,0,19,388,326,67,30,229,62,11,11,0,0,51,35,0,16,47805
15619,7544,1740,2376,2318,815,295,651,432,281,7,81,193,151,74,9,0,65,77,0,26,51,219,165,48,0,117,54,7,0,0,7,47,4,0,43,47807
15620,107,0,0,54,39,14,1608,733,733,151,123,459,0,0,0,0,0,0,0,0,0,875,875,348,69,458,0,0,0,0,0,0,0,0,0,47809
15621,604,20,185,238,142,19,38,16,15,12,0,3,1,0,0,0,0,1,1,0,0,22,22,9,1,12,0,0,0,0,0,0,0,0,0,47832
15622,927,185,353,347,32,10,61,41,41,0,9,32,0,0,0,0,0,0,0,0,0,20,8,8,0,0,12,12,0,0,12,0,0,0,0,47833
15623,13227,1909,5859,3569,1186,704,1111,630,487,69,86,332,143,70,6,4,60,73,0,19,54,481,346,145,19,182,135,89,54,4,31,46,0,0,46,47834
15624,31,0,0,16,15,0,10,10,10,0,0,10,0,0,0,0,0,0,0,0,0,0,0,0,0,0,0,0,0,0,0,0,0,0,0,47836
15625,932,118,474,270,36,34,54,31,31,0,0,31,0,0,0,0,0,0,0,0,0,23,23,18,0,5,0,0,0,0,0,0,0,0,0,47837
15626,3155,632,1247,973,224,79,196,132,40,10,0,30,92,45,0,0,45,47,0,0,47,64,27,12,2,13,37,6,0,4,2,31,0,0,31,47838
15627,1308,238,520,349,131,70,100,50,35,6,0,29,15,0,0,0,0,15,0,15,0,50,50,23,0,27,0,0,0,0,0,0,0,0,0,47840
15628,1310,101,653,359,175,22,143,48,41,0,20,21,7,0,0,0,0,7,0,7,0,95,78,42,6,30,17,17,17,0,0,0,0,0,0,47841
15629,6671,728,3009,1961,672,301,465,244,143,41,35,67,101,71,63,4,4,30,30,0,0,221,183,107,3,73,38,0,0,0,0,38,11,0,27,47842
15630,332,0,151,125,31,25,40,16,16,0,0,16,0,0,0,0,0,0,0,0,0,24,24,0,15,9,0,0,0,0,0,0,0,0,0,47846
15631,810,64,388,253,90,15,68,39,39,0,0,39,0,0,0,0,0,0,0,0,0,29,13,0,0,13,16,0,0,0,0,16,16,0,0,47847
15632,1310,108,606,445,88,63,92,63,44,5,2,37,19,7,7,0,0,12,12,0,0,29,29,10,0,19,0,0,0,0,0,0,0,0,0,47848
15633,254,49,112,54,31,8,31,31,31,9,0,22,0,0,0,0,0,0,0,0,0,0,0,0,0,0,0,0,0,0,0,0,0,0,0,47849
15634,1693,140,774,506,137,136,121,67,56,24,0,32,11,11,11,0,0,0,0,0,0,54,44,25,7,12,10,0,0,0,0,10,0,0,10,47850
15635,68,7,24,22,12,3,2,0,0,0,0,0,0,0,0,0,0,0,0,0,0,2,2,2,0,0,0,0,0,0,0,0,0,0,0,47853
15636,783,77,359,263,52,32,60,30,30,0,0,30,0,0,0,0,0,0,0,0,0,30,30,0,0,30,0,0,0,0,0,0,0,0,0,47854
15637,339,83,152,74,30,0,44,26,24,4,0,20,2,0,0,0,0,2,0,0,2,18,13,6,0,7,5,5,0,0,5,0,0,0,0,47855
15638,373,36,190,106,31,10,32,8,8,4,0,4,0,0,0,0,0,0,0,0,0,24,24,16,0,8,0,0,0,0,0,0,0,0,0,47857
15639,765,42,348,283,70,22,37,0,0,0,0,0,0,0,0,0,0,0,0,0,0,37,25,25,0,0,12,0,0,0,0,12,0,12,0,47858
15640,837,160,372,209,59,37,85,27,7,2,0,5,20,0,0,0,0,20,17,3,0,58,27,11,0,16,31,6,6,0,0,25,6,0,19,47859
15641,235,42,114,68,2,9,20,7,4,0,1,3,3,3,3,0,0,0,0,0,0,13,13,0,4,9,0,0,0,0,0,0,0,0,0,47860
15642,324,51,100,117,25,31,66,17,1,0,0,1,16,16,16,0,0,0,0,0,0,49,49,34,2,13,0,0,0,0,0,0,0,0,0,47861
15643,981,122,386,313,75,85,97,48,25,1,0,24,23,9,9,0,0,14,6,0,8,49,36,2,0,34,13,13,9,0,4,0,0,0,0,47862
15644,117,15,42,22,38,0,66,0,0,0,0,0,0,0,0,0,0,0,0,0,0,66,66,33,0,33,0,0,0,0,0,0,0,0,0,47863
15645,24,0,3,21,0,0,0,0,0,0,0,0,0,0,0,0,0,0,0,0,0,0,0,0,0,0,0,0,0,0,0,0,0,0,0,47865
15646,131,36,84,0,0,11,26,0,0,0,0,0,0,0,0,0,0,0,0,0,0,26,26,13,13,0,0,0,0,0,0,0,0,0,0,47866
15647,2088,285,976,656,124,47,114,41,13,8,0,5,28,0,0,0,0,28,0,0,28,73,73,48,0,25,0,0,0,0,0,0,0,0,0,47868
15648,71,24,0,47,0,0,0,0,0,0,0,0,0,0,0,0,0,0,0,0,0,0,0,0,0,0,0,0,0,0,0,0,0,0,0,47869
15649,143,16,63,55,7,2,5,2,2,0,0,2,0,0,0,0,0,0,0,0,0,3,3,2,0,1,0,0,0,0,0,0,0,0,0,47871
15650,6005,1258,2207,1830,438,272,387,246,144,39,0,105,102,47,13,0,34,55,44,0,11,141,111,33,0,78,30,27,9,0,18,3,0,0,3,47872
15651,2452,294,1103,650,276,129,157,58,56,0,22,34,2,2,0,0,2,0,0,0,0,99,99,9,0,90,0,0,0,0,0,0,0,0,0,47874
15652,156,0,24,20,23,89,94,0,0,0,0,0,0,0,0,0,0,0,0,0,0,94,94,45,16,33,0,0,0,0,0,0,0,0,0,47876
15653,2462,407,1136,648,173,98,182,58,29,1,0,28,29,29,0,10,19,0,0,0,0,124,90,3,0,87,34,20,20,0,0,14,14,0,0,47879
15654,69,10,0,33,26,0,0,0,0,0,0,0,0,0,0,0,0,0,0,0,0,0,0,0,0,0,0,0,0,0,0,0,0,0,0,47880
15655,316,24,134,123,26,9,31,22,22,2,0,20,0,0,0,0,0,0,0,0,0,9,9,2,0,7,0,0,0,0,0,0,0,0,0,47881
15656,5447,706,2151,1703,649,238,309,172,108,17,0,91,64,53,53,0,0,11,0,0,11,137,121,78,0,43,16,0,0,0,0,16,0,0,16,47882
15657,180,43,72,64,1,0,2,2,0,0,0,0,2,0,0,0,0,2,2,0,0,0,0,0,0,0,0,0,0,0,0,0,0,0,0,47884
15658,6157,1105,2594,1661,519,278,546,318,290,64,14,212,28,5,5,0,0,23,7,0,16,228,177,80,37,60,51,42,10,0,32,9,0,0,9,47885
15659,2097,227,466,716,325,363,73,13,13,5,0,8,0,0,0,0,0,0,0,0,0,60,24,11,0,13,36,36,33,3,0,0,0,0,0,47901
15660,9712,1765,3752,2456,1131,608,561,301,237,11,43,183,64,62,2,22,38,2,0,0,2,260,175,14,49,112,85,52,21,22,9,33,16,5,12,47904
15661,26431,2417,8634,7393,5019,2968,1563,846,711,159,93,459,135,126,106,14,6,9,1,0,8,717,637,207,65,365,80,37,10,19,8,43,28,0,15,47905
15662,27608,1518,5014,5509,6864,8703,10445,5718,5579,971,187,4421,139,120,79,5,36,19,0,9,10,4727,4647,1183,182,3282,80,80,45,0,35,0,0,0,0,47906
15663,0,0,0,0,0,0,0,0,0,0,0,0,0,0,0,0,0,0,0,0,0,0,0,0,0,0,0,0,0,0,0,0,0,0,0,47907
15664,25172,2650,7337,7895,5059,2231,1745,752,709,117,125,467,43,8,8,0,0,35,23,3,9,993,933,485,116,332,60,58,22,24,12,2,0,2,0,47909
15665,28,8,20,0,0,0,2,2,2,0,0,2,0,0,0,0,0,0,0,0,0,0,0,0,0,0,0,0,0,0,0,0,0,0,0,47916
15666,351,97,118,87,46,3,37,7,7,2,0,5,0,0,0,0,0,0,0,0,0,30,30,4,0,26,0,0,0,0,0,0,0,0,0,47917
15667,3946,621,1748,1039,315,223,341,240,215,73,0,142,25,19,14,0,5,6,0,6,0,101,101,14,26,61,0,0,0,0,0,0,0,0,0,47918
15668,1633,52,629,567,233,152,111,94,48,5,39,4,46,45,6,0,39,1,0,0,1,17,17,2,0,15,0,0,0,0,0,0,0,0,0,47920
15669,761,87,345,177,114,38,24,12,12,2,3,7,0,0,0,0,0,0,0,0,0,12,12,4,0,8,0,0,0,0,0,0,0,0,0,47921
15670,1054,189,459,287,101,18,83,41,41,5,4,32,0,0,0,0,0,0,0,0,0,42,39,33,0,6,3,3,3,0,0,0,0,0,0,47922
15671,2437,220,973,754,342,148,161,98,87,24,4,59,11,8,0,8,0,3,0,0,3,63,53,11,0,42,10,7,7,0,0,3,0,0,3,47923
15672,161,0,96,65,0,0,0,0,0,0,0,0,0,0,0,0,0,0,0,0,0,0,0,0,0,0,0,0,0,0,0,0,0,0,0,47924
15673,209,9,137,35,28,0,11,0,0,0,0,0,0,0,0,0,0,0,0,0,0,11,11,0,0,11,0,0,0,0,0,0,0,0,0,47925
15674,545,44,229,177,61,34,65,37,29,5,0,24,8,8,6,2,0,0,0,0,0,28,27,15,0,12,1,0,0,0,0,1,0,1,0,47926
15675,1334,152,728,266,138,50,81,46,46,0,0,46,0,0,0,0,0,0,0,0,0,35,35,23,0,12,0,0,0,0,0,0,0,0,0,47928
15676,424,29,186,143,57,9,29,14,5,3,0,2,9,9,9,0,0,0,0,0,0,15,13,5,0,8,2,2,0,0,2,0,0,0,0,47929
15677,669,50,295,238,54,32,58,25,19,12,0,7,6,4,0,4,0,2,2,0,0,33,17,12,0,5,16,2,2,0,0,14,0,0,14,47930
15678,3725,362,1522,1260,405,176,259,104,97,20,23,54,7,7,0,7,0,0,0,0,0,155,120,72,8,40,35,35,12,23,0,0,0,0,0,47932
15679,18460,2273,8106,4474,2168,1439,1840,1127,1006,333,36,637,121,29,0,17,12,92,14,56,22,713,598,199,31,368,115,115,37,34,44,0,0,0,0,47933
15680,982,51,476,353,85,17,67,38,36,15,0,21,2,2,1,0,1,0,0,0,0,29,29,6,0,23,0,0,0,0,0,0,0,0,0,47940
15681,720,49,260,247,117,47,47,17,15,12,0,3,2,2,0,0,2,0,0,0,0,30,30,7,0,23,0,0,0,0,0,0,0,0,0,47941
15682,502,53,301,91,45,12,38,23,21,16,0,5,2,2,2,0,0,0,0,0,0,15,9,9,0,0,6,6,2,0,4,0,0,0,0,47942
15683,536,153,174,112,11,86,38,38,38,19,0,19,0,0,0,0,0,0,0,0,0,0,0,0,0,0,0,0,0,0,0,0,0,0,0,47943
15684,2256,186,1096,633,181,160,246,101,84,28,0,56,17,17,17,0,0,0,0,0,0,145,113,17,0,96,32,26,18,0,8,6,0,0,6,47944
15685,1311,195,664,276,106,70,156,92,81,7,0,74,11,0,0,0,0,11,0,0,11,64,64,50,0,14,0,0,0,0,0,0,0,0,0,47946
15686,1015,118,557,174,123,43,107,63,54,23,0,31,9,2,2,0,0,7,0,7,0,44,41,6,2,33,3,0,0,0,0,3,0,0,3,47948
15687,1108,87,611,337,39,34,78,46,29,20,0,9,17,13,0,3,10,4,4,0,0,32,19,5,3,11,13,13,11,0,2,0,0,0,0,47949
15688,635,91,355,151,29,9,42,30,0,0,0,0,30,6,6,0,0,24,0,24,0,12,8,8,0,0,4,0,0,0,0,4,0,4,0,47950
15689,1496,166,732,352,161,85,90,51,25,15,0,10,26,22,2,20,0,4,0,0,4,39,37,3,4,30,2,2,2,0,0,0,0,0,0,47951
15690,1938,331,960,430,147,70,137,80,80,15,0,65,0,0,0,0,0,0,0,0,0,57,42,17,0,25,15,15,15,0,0,0,0,0,0,47952
15691,1687,160,830,413,192,92,94,44,42,17,0,25,2,2,0,0,2,0,0,0,0,50,50,18,0,32,0,0,0,0,0,0,0,0,0,47954
15692,736,91,291,235,89,30,63,26,25,2,0,23,1,1,0,0,1,0,0,0,0,37,19,0,3,16,18,18,18,0,0,0,0,0,0,47955
15693,1498,283,606,452,141,16,109,30,14,2,0,12,16,0,0,0,0,16,8,0,8,79,59,27,0,32,20,20,20,0,0,0,0,0,0,47957
15694,174,51,92,29,0,2,13,13,13,0,0,13,0,0,0,0,0,0,0,0,0,0,0,0,0,0,0,0,0,0,0,0,0,0,0,47958
15695,1768,323,788,467,113,77,193,138,92,33,0,59,46,46,11,3,32,0,0,0,0,55,45,22,0,23,10,10,10,0,0,0,0,0,0,47959
15696,11023,1068,4678,3430,1111,736,806,411,309,123,10,176,102,78,63,11,4,24,7,17,0,395,331,135,26,170,64,64,27,32,5,0,0,0,0,47960
15697,1400,232,656,418,57,37,125,41,37,3,5,29,4,2,2,0,0,2,2,0,0,84,82,51,7,24,2,2,0,0,2,0,0,0,0,47963
15698,94,29,56,7,0,2,7,5,5,3,0,2,0,0,0,0,0,0,0,0,0,2,2,0,2,0,0,0,0,0,0,0,0,0,0,47964
15699,438,27,237,144,18,12,63,32,27,1,0,26,5,5,0,5,0,0,0,0,0,31,31,6,0,25,0,0,0,0,0,0,0,0,0,47965
15700,337,36,186,103,12,0,28,15,15,0,0,15,0,0,0,0,0,0,0,0,0,13,0,0,0,0,13,13,0,0,13,0,0,0,0,47966
15701,605,72,306,162,56,9,48,10,7,0,0,7,3,1,0,1,0,2,2,0,0,38,25,11,1,13,13,13,4,9,0,0,0,0,0,47967
15702,497,63,277,121,16,20,21,6,6,1,0,5,0,0,0,0,0,0,0,0,0,15,10,0,1,9,5,5,5,0,0,0,0,0,0,47968
15703,96,9,47,35,2,3,1,1,1,0,1,0,0,0,0,0,0,0,0,0,0,0,0,0,0,0,0,0,0,0,0,0,0,0,0,47969
15704,1361,195,416,468,199,83,107,64,49,5,0,44,15,6,6,0,0,9,0,0,9,43,43,11,8,24,0,0,0,0,0,0,0,0,0,47970
15705,1383,174,603,404,158,44,31,20,18,3,0,15,2,0,0,0,0,2,0,0,2,11,11,0,7,4,0,0,0,0,0,0,0,0,0,47971
15706,808,96,415,220,71,6,71,9,5,3,0,2,4,4,4,0,0,0,0,0,0,62,62,2,10,50,0,0,0,0,0,0,0,0,0,47974
15707,341,43,135,101,53,9,16,10,10,2,0,8,0,0,0,0,0,0,0,0,0,6,6,4,0,2,0,0,0,0,0,0,0,0,0,47975
15708,1463,193,622,423,164,61,29,11,10,6,0,4,1,1,1,0,0,0,0,0,0,18,18,0,6,12,0,0,0,0,0,0,0,0,0,47977
15709,7602,1075,2887,2205,910,525,757,420,391,152,11,228,29,29,0,0,29,0,0,0,0,337,337,73,32,232,0,0,0,0,0,0,0,0,0,47978
15710,704,73,374,150,61,46,64,18,18,15,0,3,0,0,0,0,0,0,0,0,0,46,46,0,0,46,0,0,0,0,0,0,0,0,0,47980
15711,585,24,196,196,169,0,87,47,47,0,23,24,0,0,0,0,0,0,0,0,0,40,21,0,0,21,19,19,19,0,0,0,0,0,0,47981
15712,97,10,40,41,6,0,4,1,1,0,0,1,0,0,0,0,0,0,0,0,0,3,3,0,0,3,0,0,0,0,0,0,0,0,0,47982
15713,246,8,171,67,0,0,40,0,0,0,0,0,0,0,0,0,0,0,0,0,0,40,40,40,0,0,0,0,0,0,0,0,0,0,0,47983
15714,2803,489,1389,707,152,66,171,105,94,37,10,47,11,11,6,0,5,0,0,0,0,66,66,24,0,42,0,0,0,0,0,0,0,0,0,47987
15715,1030,150,411,234,189,46,46,20,19,9,0,10,1,1,1,0,0,0,0,0,0,26,16,0,11,5,10,10,10,0,0,0,0,0,0,47989
15716,1074,173,454,304,127,16,49,7,6,0,3,3,1,1,0,1,0,0,0,0,0,42,39,3,10,26,3,3,3,0,0,0,0,0,0,47990
15717,793,136,412,176,65,4,88,52,47,0,0,47,5,5,5,0,0,0,0,0,0,36,36,13,0,23,0,0,0,0,0,0,0,0,0,47991
15718,979,136,282,309,99,153,42,26,26,0,0,26,0,0,0,0,0,0,0,0,0,16,16,0,0,16,0,0,0,0,0,0,0,0,0,47992
15719,2934,598,1121,727,330,158,195,126,102,49,5,48,24,12,10,2,0,12,0,12,0,69,63,25,0,38,6,6,0,0,6,0,0,0,0,47993
15720,280,38,138,69,33,2,13,12,10,2,0,8,2,2,2,0,0,0,0,0,0,1,0,0,0,0,1,1,1,0,0,0,0,0,0,47994
15721,1005,114,508,281,65,37,91,31,31,16,3,12,0,0,0,0,0,0,0,0,0,60,58,8,12,38,2,0,0,0,0,2,0,0,2,47995
15722,77,18,29,21,7,2,4,2,2,0,2,0,0,0,0,0,0,0,0,0,0,2,2,0,0,2,0,0,0,0,0,0,0,0,0,47997
15723,8801,912,3485,2914,868,622,496,203,102,15,4,83,101,69,31,0,38,32,0,6,26,293,266,91,12,163,27,27,19,0,8,0,0,0,0,48001
15724,2387,227,916,1005,179,60,194,79,73,0,19,54,6,6,6,0,0,0,0,0,0,115,95,15,6,74,20,20,20,0,0,0,0,0,0,48002
15725,3996,282,1482,1410,471,351,281,192,152,24,26,102,40,40,10,17,13,0,0,0,0,89,89,6,0,83,0,0,0,0,0,0,0,0,0,48003
15726,3793,323,1188,1482,564,236,291,168,147,63,29,55,21,21,19,2,0,0,0,0,0,123,104,20,11,73,19,13,13,0,0,6,3,0,3,48005
15727,2672,303,1061,1018,204,86,203,112,95,14,3,78,17,17,14,3,0,0,0,0,0,91,86,25,3,58,5,5,2,0,3,0,0,0,0,48006
15728,14381,175,904,2244,5726,5332,793,488,488,124,21,343,0,0,0,0,0,0,0,0,0,305,294,104,7,183,11,0,0,0,0,11,0,0,11,48009
15729,2702,503,996,984,153,66,367,238,197,57,22,118,41,20,11,2,7,21,21,0,0,129,116,39,12,65,13,7,7,0,0,6,0,0,6,48014
15730,5740,807,2150,1982,622,179,419,166,145,21,26,98,21,20,6,14,0,1,1,0,0,253,140,16,23,101,113,113,113,0,0,0,0,0,0,48015
15731,8844,627,2415,2899,1972,931,507,225,210,31,41,138,15,6,6,0,0,9,0,9,0,282,254,142,0,112,28,28,23,0,5,0,0,0,0,48017
15732,20504,3093,7025,7706,1679,1001,1961,889,746,197,93,456,143,104,35,60,9,39,8,16,15,1072,915,225,162,528,157,142,85,48,9,15,7,8,0,48021
15733,1782,122,736,763,127,34,94,56,43,8,5,30,13,13,6,7,0,0,0,0,0,38,38,10,12,16,0,0,0,0,0,0,0,0,0,48022
15734,3584,398,1100,1598,303,185,323,165,152,94,11,47,13,13,0,13,0,0,0,0,0,158,127,74,0,53,31,31,31,0,0,0,0,0,0,48023
15735,10077,178,826,2073,3562,3438,635,335,335,93,37,205,0,0,0,0,0,0,0,0,0,300,300,67,13,220,0,0,0,0,0,0,0,0,0,48025
15736,10295,1033,3163,4158,1330,611,938,507,412,123,15,274,95,83,46,28,9,12,12,0,0,431,410,143,23,244,21,21,12,9,0,0,0,0,0,48026
15737,2264,185,952,741,284,102,148,88,79,6,23,50,9,9,9,0,0,0,0,0,0,60,54,3,5,46,6,6,6,0,0,0,0,0,0,48027
15738,989,124,283,318,152,112,67,0,0,0,0,0,0,0,0,0,0,0,0,0,0,67,67,16,0,51,0,0,0,0,0,0,0,0,0,48028
15739,11150,2278,4645,3080,938,209,552,212,129,38,0,91,83,68,20,30,18,15,0,0,15,340,277,67,34,176,63,39,12,0,27,24,9,0,15,48030
15740,1607,154,679,576,134,64,107,40,40,3,0,37,0,0,0,0,0,0,0,0,0,67,51,13,9,29,16,16,16,0,0,0,0,0,0,48032
15741,11696,1056,2734,4191,2270,1445,778,415,319,53,89,177,96,55,43,12,0,41,0,0,41,363,322,20,104,198,41,34,6,14,14,7,0,7,0,48033
15742,9411,542,2134,3299,2004,1432,362,260,197,0,31,166,63,63,63,0,0,0,0,0,0,102,86,12,0,74,16,16,0,0,16,0,0,0,0,48034
15743,23297,2966,8791,8312,2263,965,1953,854,658,191,121,346,196,144,48,66,30,52,13,32,7,1099,872,243,116,513,227,204,100,45,59,23,0,0,23,48035
15744,14410,1720,4552,5109,1812,1217,1192,615,486,166,81,239,129,93,56,9,28,36,5,0,31,577,477,136,105,236,100,78,28,37,13,22,0,10,12,48036
15745,30311,2570,9337,10696,4984,2724,2197,1040,907,247,177,483,133,112,105,0,7,21,0,9,12,1157,914,356,140,418,243,184,115,24,45,59,0,42,17,48038
15746,5400,542,2261,2030,374,193,466,274,231,46,36,149,43,43,43,0,0,0,0,0,0,192,137,60,23,54,55,48,18,22,8,7,0,0,7,48039
15747,6902,500,2346,2406,939,711,525,241,233,61,48,124,8,6,0,6,0,2,0,0,2,284,256,146,44,66,28,18,18,0,0,10,0,10,0,48040
15748,3026,267,1288,1119,220,132,217,130,115,26,5,84,15,15,9,6,0,0,0,0,0,87,87,11,26,50,0,0,0,0,0,0,0,0,0,48041
15749,17999,1552,4669,5813,4260,1705,1549,815,657,182,100,375,158,138,109,0,29,20,20,0,0,734,673,258,39,376,61,60,60,0,0,1,0,0,1,48042
15750,11793,1984,3417,4250,1340,802,851,509,282,41,21,220,227,90,50,18,22,137,21,0,116,342,264,84,0,180,78,43,11,32,0,35,22,0,13,48043
15751,33788,2471,8232,11535,7182,4368,2738,1280,1181,421,78,682,99,99,99,0,0,0,0,0,0,1458,1403,529,107,767,55,28,28,0,0,27,9,0,18,48044
15752,18193,1452,5343,6891,2683,1824,1040,506,402,99,117,186,104,60,23,5,32,44,33,0,11,534,417,59,59,299,117,113,54,59,0,4,0,0,4,48045
15753,26534,2125,7211,10512,4501,2185,1948,979,814,190,111,513,165,110,57,9,44,55,42,13,0,969,914,373,71,470,55,46,46,0,0,9,9,0,0,48047
15754,5399,631,1959,2090,474,245,389,221,167,76,34,57,54,36,5,22,9,18,0,15,3,168,150,40,44,66,18,11,11,0,0,7,7,0,0,48048
15755,3845,280,1387,1455,531,192,444,236,161,43,33,85,75,61,50,11,0,14,0,0,14,208,153,51,4,98,55,55,34,16,5,0,0,0,0,48049
15756,1217,114,561,376,115,51,84,61,61,29,0,32,0,0,0,0,0,0,0,0,0,23,23,23,0,0,0,0,0,0,0,0,0,0,0,48050
15757,11178,1338,3881,4139,1302,518,877,450,358,61,37,260,92,55,40,15,0,37,0,0,37,427,427,127,26,274,0,0,0,0,0,0,0,0,0,48051
15758,5328,446,2037,1870,636,339,398,148,148,39,28,81,0,0,0,0,0,0,0,0,0,250,250,70,60,120,0,0,0,0,0,0,0,0,0,48054
15759,10446,869,3693,3375,1366,1143,797,440,342,112,54,176,98,91,0,40,51,7,0,0,7,357,296,88,42,166,61,61,47,0,14,0,0,0,0,48059
15760,26687,3733,9692,9463,2477,1322,2266,1152,884,121,224,539,268,169,64,80,25,99,39,7,53,1114,903,275,123,505,211,167,112,44,11,44,11,8,25,48060
15761,6639,823,2160,2609,656,391,419,155,131,46,5,80,24,24,17,7,0,0,0,0,0,264,253,33,97,123,11,11,11,0,0,0,0,0,0,48062
15762,2758,213,1170,1052,198,125,242,106,93,38,13,42,13,13,13,0,0,0,0,0,0,136,85,26,11,48,51,51,0,27,24,0,0,0,0,48063
15763,2608,256,951,974,311,116,253,125,91,16,3,72,34,20,0,11,9,14,0,0,14,128,104,19,4,81,24,9,9,0,0,15,15,0,0,48064
15764,7177,718,1983,2693,1028,755,706,479,418,214,24,180,61,26,17,9,0,35,9,0,26,227,178,100,12,66,49,40,32,0,8,9,0,0,9,48065
15765,32029,4735,12545,11615,2375,759,2523,1511,1122,184,126,812,389,226,79,70,77,163,23,44,96,1012,813,237,108,468,199,91,43,20,28,108,12,12,84,48066
15766,19085,1011,3126,4861,6010,4077,606,288,272,102,42,128,16,0,0,0,0,16,0,16,0,318,310,128,0,182,8,0,0,0,0,8,0,0,8,48067
15767,1984,22,268,404,638,652,93,46,46,20,3,23,0,0,0,0,0,0,0,0,0,47,44,12,8,24,3,3,3,0,0,0,0,0,0,48069
15768,4292,28,347,488,1599,1830,288,186,172,67,0,105,14,14,14,0,0,0,0,0,0,102,98,61,0,37,4,4,4,0,0,0,0,0,0,48070
15769,21474,3539,6479,6749,3517,1190,1501,884,657,211,129,317,227,111,83,28,0,116,0,107,9,617,541,206,75,260,76,62,15,26,21,14,0,0,14,48071
15770,10896,493,1811,3585,3090,1917,398,226,202,75,39,88,24,14,0,14,0,10,0,10,0,172,162,38,7,117,10,10,10,0,0,0,0,0,0,48072
15771,25265,1175,4834,7144,7118,4994,1260,499,441,142,16,283,58,20,0,20,0,38,10,0,28,761,702,322,25,355,59,44,41,0,3,15,0,0,15,48073
15772,6574,1039,2345,2400,393,397,488,351,313,61,70,182,38,31,0,31,0,7,0,0,7,137,127,7,0,120,10,9,0,0,9,1,0,0,1,48074
15773,15001,1102,2972,5678,2599,2650,1430,793,725,131,73,521,68,41,0,41,0,27,0,0,27,637,565,194,69,302,72,72,67,5,0,0,0,0,0,48075
15774,18222,1339,3032,6244,4438,3169,1677,871,739,117,178,444,132,97,78,0,19,35,28,0,7,806,772,134,140,498,34,2,2,0,0,32,0,17,15,48076
15775,8441,697,2619,3113,1188,824,706,337,282,82,58,142,55,48,31,17,0,7,7,0,0,369,330,126,62,142,39,28,23,0,5,11,11,0,0,48079
15776,17307,1204,4951,6306,3314,1532,660,344,326,107,12,207,18,18,7,11,0,0,0,0,0,316,295,69,38,188,21,21,9,12,0,0,0,0,0,48080
15777,15369,1212,4789,5844,2324,1200,1076,484,400,156,36,208,84,40,11,29,0,44,14,30,0,592,530,135,83,312,62,59,29,25,5,3,0,3,0,48081
15778,11934,1231,4117,4180,1831,575,900,559,399,74,33,292,160,114,41,55,18,46,17,29,0,341,277,101,0,176,64,60,32,25,3,4,4,0,0,48082
15779,16052,1720,3406,3884,4202,2840,914,467,409,45,39,325,58,58,16,21,21,0,0,0,0,447,394,137,39,218,53,45,21,0,24,8,8,0,0,48083
15780,10240,337,981,1994,3302,3626,619,380,352,149,30,173,28,28,28,0,0,0,0,0,0,239,239,65,0,174,0,0,0,0,0,0,0,0,0,48084
15781,16634,786,2435,3981,5169,4263,1430,847,810,210,85,515,37,30,21,9,0,7,7,0,0,583,564,223,10,331,19,11,0,11,0,8,8,0,0,48085
15782,16092,1929,5370,5757,2025,1011,1381,601,498,95,85,318,103,69,54,1,14,34,0,13,21,780,720,212,32,476,60,28,0,11,17,32,0,7,25,48088
15783,18944,3913,7837,5554,1135,505,1954,1103,775,109,59,607,328,188,108,75,5,140,13,9,118,851,679,114,166,399,172,74,31,31,12,98,12,54,32,48089
15784,20587,3902,8076,6248,1724,637,1807,870,714,95,113,506,156,130,59,8,63,26,7,5,14,937,780,191,86,503,157,139,33,76,30,18,12,6,0,48091
15785,18670,2567,6214,5513,3171,1205,1260,690,600,221,32,347,90,54,46,8,0,36,0,0,36,570,513,241,57,215,57,45,38,0,7,12,0,0,12,48092
15786,16989,2483,5303,5734,2364,1105,844,365,338,135,55,148,27,15,9,0,6,12,1,0,11,479,459,85,85,289,20,9,9,0,0,11,0,0,11,48093
15787,12541,926,3084,4684,2491,1356,735,350,301,60,20,221,49,34,21,0,13,15,0,0,15,385,367,106,48,213,18,11,2,9,0,7,7,0,0,48094
15788,3353,106,1049,1095,751,352,221,98,89,22,0,67,9,9,0,9,0,0,0,0,0,123,123,43,8,72,0,0,0,0,0,0,0,0,0,48095
15789,2865,316,883,1030,343,293,205,127,127,81,0,46,0,0,0,0,0,0,0,0,0,78,78,37,8,33,0,0,0,0,0,0,0,0,0,48096
15790,3537,557,1404,1129,307,140,338,191,162,46,11,105,29,23,6,13,4,6,3,0,3,147,136,26,26,84,11,8,8,0,0,3,0,0,3,48097
15791,13497,526,1714,2171,4566,4520,1106,618,548,35,67,446,70,42,0,9,33,28,12,0,16,488,478,89,17,372,10,10,0,0,10,0,0,0,0,48098
15792,19429,1912,6459,6635,2917,1506,1615,803,706,199,85,422,97,55,35,20,0,42,20,2,20,812,777,268,71,438,35,35,17,18,0,0,0,0,0,48101
15793,38390,1027,3830,7078,11115,15340,2110,1168,1056,197,116,743,112,95,37,35,23,17,0,17,0,942,892,239,104,549,50,36,36,0,0,14,0,0,14,48103
15794,16968,381,1244,2723,5274,7346,4368,2133,2084,492,207,1385,49,32,32,0,0,17,5,0,12,2235,2180,534,98,1548,55,55,14,34,7,0,0,0,0,48104
15795,21645,649,1534,2943,5898,10621,2578,1593,1567,311,164,1092,26,26,2,0,24,0,0,0,0,985,961,324,97,540,24,24,7,0,17,0,0,0,0,48105
15796,17262,959,2171,4621,4638,4873,1471,796,671,113,162,396,125,62,42,0,20,63,20,0,43,675,594,145,60,389,81,59,23,0,36,22,0,0,22,48108
15797,155,3,12,50,34,56,5293,2535,2535,596,188,1751,0,0,0,0,0,0,0,0,0,2758,2758,694,180,1884,0,0,0,0,0,0,0,0,0,48109
15798,28801,2993,8747,10457,4240,2364,2210,1149,1067,234,206,627,82,48,14,25,9,34,0,24,10,1061,914,296,161,457,147,63,63,0,0,84,9,0,75,48111
15799,14051,537,3236,4476,3666,2136,1385,711,642,168,86,388,69,69,27,10,32,0,0,0,0,674,635,231,23,381,39,25,19,0,6,14,14,0,0,48114
15800,18662,833,4369,5626,5089,2745,1372,606,582,190,50,342,24,24,12,6,6,0,0,0,0,766,682,255,73,354,84,84,70,4,10,0,0,0,0,48116
15801,6811,847,2421,2578,681,284,482,212,165,74,18,73,47,40,40,0,0,7,0,0,7,270,229,77,17,135,41,37,0,0,37,4,0,0,4,48117
15802,9072,531,1720,2636,2277,1908,627,339,300,94,55,151,39,14,7,0,7,25,0,0,25,288,284,56,16,212,4,4,0,4,0,0,0,0,0,48118
15803,4274,1227,749,1168,626,504,407,268,268,23,52,193,0,0,0,0,0,0,0,0,0,139,139,31,0,108,0,0,0,0,0,0,0,0,0,48120
15804,6914,1602,2383,2126,498,305,628,351,207,43,50,114,144,140,69,0,71,4,0,3,1,277,269,98,39,132,8,8,0,8,0,0,0,0,0,48122
15805,22332,1557,5234,7766,4656,3119,1473,758,659,144,103,412,99,28,19,9,0,71,0,26,45,715,633,197,33,403,82,67,31,0,36,15,0,15,0,48124
15806,14097,2083,5730,4675,963,646,926,574,426,78,24,324,148,120,49,38,33,28,14,0,14,352,273,45,43,185,79,79,25,15,39,0,0,0,0,48125
15807,25612,8107,5913,6476,3309,1807,3100,1622,1413,189,99,1125,209,126,40,31,55,83,0,43,40,1478,1334,154,44,1136,144,76,22,29,25,68,49,0,19,48126
15808,24014,3557,7365,7130,3587,2375,2089,924,832,82,85,665,92,19,9,9,1,73,0,15,58,1165,1080,224,85,771,85,65,33,28,4,20,0,0,20,48127
15809,6898,298,1223,2318,1735,1324,428,179,154,26,11,117,25,25,0,0,25,0,0,0,0,249,239,72,34,133,10,10,0,10,0,0,0,0,0,48128
15810,9461,282,1437,2621,2674,2447,493,227,198,36,8,154,29,29,0,0,29,0,0,0,0,266,237,94,30,113,29,29,6,23,0,0,0,0,0,48130
15811,4409,485,1592,1622,529,181,411,217,190,37,17,136,27,27,19,0,8,0,0,0,0,194,194,130,0,64,0,0,0,0,0,0,0,0,0,48131
15812,3930,600,1581,1302,314,133,338,160,112,43,8,61,48,19,9,10,0,29,14,15,0,178,123,88,0,35,55,12,5,7,0,43,32,5,6,48133
15813,13952,1344,5108,4768,1668,1064,1221,660,584,95,90,399,76,63,57,6,0,13,0,0,13,561,480,139,110,231,81,66,21,45,0,15,0,0,15,48134
15814,19155,2025,8094,6675,1742,619,1426,715,648,161,122,365,67,28,28,0,0,39,0,4,35,711,571,198,112,261,140,96,38,11,47,44,18,18,8,48135
15815,3511,218,958,1212,787,336,217,113,91,10,20,61,22,0,0,0,0,22,10,0,12,104,64,26,0,38,40,40,29,0,11,0,0,0,0,48137
15816,7522,243,1477,2281,1964,1557,511,329,279,64,11,204,50,25,0,25,0,25,8,0,17,182,158,62,0,96,24,24,0,9,15,0,0,0,0,48138
15817,216,0,114,53,25,24,0,0,0,0,0,0,0,0,0,0,0,0,0,0,0,0,0,0,0,0,0,0,0,0,0,0,0,0,0,48139
15818,2250,105,658,1030,328,129,196,103,88,0,13,75,15,15,0,0,15,0,0,0,0,93,81,27,0,54,12,12,0,0,12,0,0,0,0,48140
15819,15186,3144,4764,5737,1149,392,1570,680,555,42,56,457,125,125,68,37,20,0,0,0,0,890,740,128,174,438,150,82,46,36,0,68,18,0,50,48141
15820,0,0,0,0,0,0,0,0,0,0,0,0,0,0,0,0,0,0,0,0,0,0,0,0,0,0,0,0,0,0,0,0,0,0,0,48143
15821,7030,296,2036,2558,1242,898,751,341,341,71,32,238,0,0,0,0,0,0,0,0,0,410,410,114,84,212,0,0,0,0,0,0,0,0,0,48144
15822,2482,331,914,858,274,105,198,112,68,18,0,50,44,23,8,15,0,21,0,0,21,86,71,32,0,39,15,15,0,0,15,0,0,0,0,48145
15823,25329,4930,10310,8043,1468,578,2077,1075,763,237,106,420,312,185,78,28,79,127,0,17,110,1002,844,256,100,488,158,118,63,23,32,40,0,0,40,48146
15824,19205,1329,5518,6699,3909,1750,1150,590,490,168,22,300,100,79,55,24,0,21,8,13,0,560,534,159,90,285,26,26,6,20,0,0,0,0,0,48150
15825,22300,1540,5062,7243,5484,2971,1350,737,651,204,63,384,86,64,7,0,57,22,11,0,11,613,519,200,8,311,94,76,76,0,0,18,9,0,9,48152
15826,27499,1820,6378,8961,6908,3432,1930,1163,1118,308,110,700,45,28,5,15,8,17,6,10,1,767,708,238,49,421,59,33,17,5,11,26,0,0,26,48154
15827,997,117,310,422,115,33,27,12,8,0,3,5,4,0,0,0,0,4,4,0,0,15,11,0,0,11,4,0,0,0,0,4,0,0,4,48157
15828,5305,263,1215,1973,1184,670,470,301,262,97,12,153,39,27,22,5,0,12,0,0,12,169,160,37,0,123,9,9,9,0,0,0,0,0,0,48158
15829,1703,180,736,613,108,66,112,62,37,18,8,11,25,21,21,0,0,4,0,4,0,50,45,13,0,32,5,5,5,0,0,0,0,0,0,48159
15830,9700,694,2903,3777,1442,884,783,294,218,67,26,125,76,44,22,0,22,32,0,12,20,489,432,142,85,205,57,46,42,4,0,11,0,0,11,48160
15831,17578,2490,6822,5651,1668,947,1679,857,572,86,51,435,285,103,53,13,37,182,105,55,22,822,593,204,76,313,229,168,116,40,12,61,27,34,0,48161
15832,19693,2551,7154,6573,1973,1442,1454,820,686,136,44,506,134,90,22,43,25,44,0,0,44,634,522,188,70,264,112,112,102,10,0,0,0,0,0,48162
15833,6217,601,1824,2431,880,481,416,218,196,27,6,163,22,22,15,0,7,0,0,0,0,198,198,45,79,74,0,0,0,0,0,0,0,0,0,48164
15834,3953,366,1109,1286,843,349,304,140,126,66,34,26,14,14,14,0,0,0,0,0,0,164,146,37,52,57,18,0,0,0,0,18,0,18,0,48165
15835,7304,866,2855,2582,569,432,574,251,226,17,36,173,25,1,1,0,0,24,0,0,24,323,281,38,31,212,42,42,42,0,0,0,0,0,0,48166
15836,15445,567,2826,4194,4408,3450,1232,649,620,173,112,335,29,28,28,0,0,1,0,0,1,583,555,212,35,308,28,20,20,0,0,8,0,0,8,48167
15837,15287,676,2013,3384,4380,4834,1245,699,657,62,32,563,42,42,42,0,0,0,0,0,0,546,489,160,16,313,57,49,15,14,20,8,0,0,8,48168
15838,14642,1096,3874,5314,2683,1675,1011,640,578,156,39,383,62,45,7,14,24,17,0,14,3,371,346,143,15,188,25,20,5,0,15,5,0,0,5,48169
15839,28517,1079,5179,8108,7989,6162,1648,932,867,226,62,579,65,41,41,0,0,24,12,0,12,716,684,221,82,381,32,21,10,11,0,11,0,0,11,48170
15840,8598,769,3031,2989,1110,699,776,354,325,31,58,236,29,10,10,0,0,19,19,0,0,422,379,129,66,184,43,20,20,0,0,23,0,0,23,48173
15841,20823,3037,7909,7597,1584,696,1942,923,783,112,80,591,140,99,85,0,14,41,0,0,41,1019,903,201,113,589,116,89,34,51,4,27,0,0,27,48174
15842,14042,547,2023,3839,4402,3231,1156,563,522,89,60,373,41,35,0,19,16,6,3,0,3,593,542,138,65,339,51,28,16,12,0,23,10,0,13,48176
15843,178,17,104,33,24,0,8,0,0,0,0,0,0,0,0,0,0,0,0,0,0,8,8,0,0,8,0,0,0,0,0,0,0,0,0,48177
15844,20347,1355,4850,6572,4864,2706,1670,769,713,224,23,466,56,36,29,7,0,20,12,0,8,901,850,307,103,440,51,51,18,0,33,0,0,0,0,48178
15845,2296,344,855,740,216,141,247,162,101,23,15,63,61,32,32,0,0,29,15,8,6,85,80,26,13,41,5,5,5,0,0,0,0,0,0,48179
15846,41241,7291,16075,13868,2864,1143,3354,1685,1280,314,127,839,405,186,81,72,33,219,110,72,37,1669,1350,345,301,704,319,133,91,24,18,186,48,85,53,48180
15847,14668,931,4624,5689,2252,1172,1269,792,688,229,91,368,104,70,12,58,0,34,11,0,23,477,436,122,30,284,41,41,31,0,10,0,0,0,0,48182
15848,29581,2639,9119,10847,4460,2516,2059,1066,918,230,59,629,148,94,86,7,1,54,0,37,17,993,948,283,151,514,45,32,21,0,11,13,0,0,13,48183
15849,12051,1907,4370,4353,1039,382,828,436,375,103,19,253,61,37,6,0,31,24,0,11,13,392,353,30,129,194,39,14,0,14,0,25,0,0,25,48184
15850,33408,3703,10943,12120,4690,1952,2562,1303,951,332,128,491,352,277,233,16,28,75,0,12,63,1259,923,476,79,368,336,209,76,0,133,127,0,35,92,48185
15851,23769,3323,8949,7989,2591,917,1885,1054,843,167,138,538,211,125,26,32,67,86,23,31,32,831,673,286,72,315,158,158,79,37,42,0,0,0,0,48186
15852,31483,1844,5750,9665,8736,5488,2713,1296,1249,441,88,720,47,34,30,0,4,13,0,13,0,1417,1361,389,161,811,56,44,44,0,0,12,0,0,12,48187
15853,26702,1363,4830,7585,7673,5251,2337,1133,989,272,67,650,144,76,53,23,0,68,0,0,68,1204,1112,351,174,587,92,69,12,0,57,23,0,0,23,48188
15854,9237,543,2394,3381,1870,1049,598,355,329,102,72,155,26,25,20,0,5,1,1,0,0,243,217,117,25,75,26,15,15,0,0,11,11,0,0,48189
15855,75,20,33,0,22,0,7,0,0,0,0,0,0,0,0,0,0,0,0,0,0,7,0,0,0,0,7,7,0,7,0,0,0,0,0,48190
15856,2624,261,993,910,258,202,175,111,68,0,15,53,43,37,0,6,31,6,0,6,0,64,64,49,0,15,0,0,0,0,0,0,0,0,0,48191
15857,18090,2425,6907,5907,1857,994,1472,729,655,183,116,356,74,57,26,31,0,17,5,12,0,743,618,247,68,303,125,100,43,7,50,25,0,5,20,48192
15858,10729,1345,3324,3561,1725,774,715,374,361,50,23,288,13,13,13,0,0,0,0,0,0,341,299,144,21,134,42,42,42,0,0,0,0,0,0,48193
15859,21062,2437,7655,7478,2218,1274,1673,871,762,152,74,536,109,96,75,21,0,13,0,0,13,802,692,259,53,380,110,61,29,0,32,49,0,0,49,48195
15860,37405,3574,6590,12387,8895,5959,5131,2219,2066,466,343,1257,153,150,78,64,8,3,0,3,0,2912,2772,806,359,1607,140,89,67,0,22,51,0,34,17,48197
15861,24252,3208,6456,8762,3815,2011,1778,708,501,129,92,280,207,122,43,55,24,85,0,27,58,1070,925,247,117,561,145,94,19,48,27,51,0,46,5,48198
15862,7960,1621,1765,2581,927,1066,727,343,289,38,86,165,54,0,0,0,0,54,0,11,43,384,323,55,51,217,61,49,0,0,49,12,0,0,12,48201
15863,10368,1982,3146,3188,973,1079,1213,582,516,99,94,323,66,54,0,36,18,12,0,7,5,631,588,72,73,443,43,43,0,21,22,0,0,0,0,48202
15864,17663,4052,6069,5541,1116,885,1837,1004,740,58,172,510,264,173,61,70,42,91,0,0,91,833,614,81,60,473,219,108,81,0,27,111,50,20,41,48203
15865,17828,4300,6407,5656,922,543,1333,602,440,27,152,261,162,55,20,19,16,107,8,65,34,731,478,42,90,346,253,83,21,19,43,170,19,38,113,48204
15866,21752,4896,8379,7053,869,555,2701,1312,1045,114,250,681,267,170,46,76,48,97,21,54,22,1389,1150,42,195,913,239,170,33,92,45,69,0,17,52,48205
15867,12779,2848,4139,4161,874,757,1377,680,423,31,147,245,257,137,53,48,36,120,6,16,98,697,497,65,90,342,200,156,85,59,12,44,0,39,5,48206
15868,15004,2698,4255,4637,1521,1893,917,516,287,7,73,207,229,134,34,100,0,95,22,35,38,401,295,65,48,182,106,63,0,37,26,43,0,43,0,48207
15869,6511,1544,2031,1971,600,365,476,214,166,39,37,90,48,40,0,27,13,8,0,0,8,262,185,0,0,185,77,69,31,38,0,8,0,0,8,48208
15870,18406,9161,5421,3096,574,154,2297,1225,847,107,79,661,378,243,68,83,92,135,17,68,50,1072,697,68,109,520,375,104,29,29,46,271,22,51,198,48209
15871,16489,7796,5021,2971,525,176,2276,1071,630,34,109,487,441,176,86,37,53,265,102,98,65,1205,777,128,108,541,428,178,56,68,54,250,0,62,188,48210
15872,3852,1244,1567,801,180,60,447,310,259,44,35,180,51,35,19,0,16,16,0,0,16,137,96,23,11,62,41,3,3,0,0,38,0,17,21,48211
15873,23047,7558,7530,5474,1557,928,2204,1038,844,125,131,588,194,136,68,36,32,58,6,3,49,1166,1006,78,101,827,160,60,26,0,34,100,0,25,75,48212
15874,16635,4467,6027,5044,840,257,2017,908,629,22,110,497,279,106,14,52,40,173,0,0,173,1109,721,103,87,531,388,235,65,59,111,153,17,47,89,48213
15875,15367,3839,4513,4602,1298,1115,1277,637,583,9,88,486,54,22,0,22,0,32,0,0,32,640,544,9,140,395,96,48,21,0,27,48,0,11,37,48214
15876,8065,2038,2973,2370,442,242,1144,599,447,41,45,361,152,88,4,23,61,64,0,6,58,545,417,69,130,218,128,95,0,23,72,33,0,0,33,48215
15877,3747,1202,1176,848,257,264,291,177,140,32,0,108,37,25,0,25,0,12,0,0,12,114,61,12,0,49,53,48,19,29,0,5,0,0,5,48216
15878,5493,1247,2201,1584,271,190,486,281,227,0,44,183,54,37,23,14,0,17,0,9,8,205,175,0,12,163,30,0,0,0,0,30,0,0,30,48217
15879,4967,1292,2122,1220,195,138,631,404,333,40,15,278,71,20,20,0,0,51,0,51,0,227,194,10,68,116,33,33,0,33,0,0,0,0,0,48218
15880,31444,4968,9205,12070,3424,1777,3252,1755,1474,150,218,1106,281,154,50,56,48,127,12,56,59,1497,1256,208,278,770,241,148,97,41,10,93,0,69,24,48219
15881,16532,1271,3736,5389,3809,2327,958,422,367,78,70,219,55,47,26,6,15,8,0,0,8,536,487,93,56,338,49,45,40,0,5,4,4,0,0,48220
15882,25481,3638,6201,9411,3005,3226,3087,1412,1071,252,69,750,341,233,133,42,58,108,17,42,49,1675,1327,162,189,976,348,235,86,52,97,113,0,46,67,48221
15883,15063,2371,4378,5898,1373,1043,1837,884,682,51,169,462,202,87,22,12,53,115,0,39,76,953,695,176,122,397,258,232,143,65,24,26,0,6,20,48223
15884,26436,4889,7877,9676,2799,1195,3374,1577,1209,106,265,838,368,129,58,60,11,239,90,123,26,1797,1398,207,316,875,399,278,88,69,121,121,12,67,42,48224
15885,9241,1164,2770,3044,1455,808,1165,586,457,118,40,299,129,92,54,38,0,37,18,8,11,579,482,104,53,325,97,77,0,49,28,20,14,0,6,48225
15886,4348,546,824,1445,796,737,203,148,41,0,0,41,107,25,0,0,25,82,0,0,82,55,30,0,0,30,25,25,0,13,12,0,0,0,0,48226
15887,27997,5037,10210,9609,2054,1087,3697,1638,1210,152,144,914,428,345,140,14,191,83,0,4,79,2059,1775,248,194,1333,284,239,58,47,134,45,0,27,18,48227
15888,30289,6400,10206,10845,1907,931,3386,1775,1408,147,226,1035,367,147,48,39,60,220,12,106,102,1611,1274,143,382,749,337,170,62,77,31,167,0,107,60,48228
15889,6102,1734,2219,1453,482,214,594,395,319,17,82,220,76,25,0,25,0,51,0,36,15,199,142,0,17,125,57,49,8,30,11,8,0,0,8,48229
15890,11541,394,1002,2487,3542,4116,944,409,396,75,17,304,13,8,0,0,8,5,0,0,5,535,535,77,38,420,0,0,0,0,0,0,0,0,0,48230
15891,0,0,0,0,0,0,0,0,0,0,0,0,0,0,0,0,0,0,0,0,0,0,0,0,0,0,0,0,0,0,0,0,0,0,0,48233
15892,22259,5101,7811,7770,1047,530,2704,1417,966,56,337,573,451,212,36,75,101,239,0,105,134,1287,1113,205,272,636,174,79,0,73,6,95,36,35,24,48234
15893,30710,4533,11028,10683,2690,1776,2781,1576,1366,109,116,1141,210,83,12,26,45,127,6,0,121,1205,964,185,195,584,241,90,78,0,12,151,0,39,112,48235
15894,21034,523,2690,5296,6812,5713,1504,921,886,203,27,656,35,31,9,22,0,4,0,0,4,583,569,98,25,446,14,14,0,0,14,0,0,0,0,48236
15895,18984,1677,4423,7410,3655,1819,1846,924,808,159,120,529,116,67,37,27,3,49,0,12,37,922,786,122,174,490,136,108,90,0,18,28,0,14,14,48237
15896,19871,4338,6452,7272,1191,618,2577,1250,952,125,148,679,298,114,40,27,47,184,41,37,106,1327,1210,295,173,742,117,93,36,19,38,24,0,24,0,48238
15897,24213,2541,8365,8786,3084,1437,2019,1086,867,200,82,585,219,152,38,49,65,67,27,0,40,933,783,200,186,397,150,107,63,26,18,43,13,14,16,48239
15898,12172,1433,4421,4196,1209,913,1040,539,445,86,75,284,94,66,39,11,16,28,18,0,10,501,431,108,6,317,70,70,0,40,30,0,0,0,0,48240
15899,0,0,0,0,0,0,0,0,0,0,0,0,0,0,0,0,0,0,0,0,0,0,0,0,0,0,0,0,0,0,0,0,0,0,0,48242
15900,0,0,0,0,0,0,0,0,0,0,0,0,0,0,0,0,0,0,0,0,0,0,0,0,0,0,0,0,0,0,0,0,0,0,0,48243
15901,9867,112,766,1807,3558,3624,895,500,477,109,57,311,23,5,0,5,0,18,0,0,18,395,384,69,12,303,11,11,0,0,11,0,0,0,0,48301
15902,11254,427,1345,1949,3580,3953,818,335,326,36,5,285,9,0,0,0,0,9,0,0,9,483,468,85,12,371,15,15,15,0,0,0,0,0,0,48302
15903,12036,394,1055,2126,4364,4097,930,524,487,60,82,345,37,7,7,0,0,30,0,30,0,406,406,86,5,315,0,0,0,0,0,0,0,0,0,48304
15904,18333,291,2205,4354,6155,5328,1518,815,797,184,58,555,18,8,0,0,8,10,0,0,10,703,675,166,44,465,28,4,4,0,0,24,0,0,24,48306
15905,28110,1518,4155,8226,8114,6097,2048,945,710,243,58,409,235,137,56,36,45,98,9,75,14,1103,1031,422,44,565,72,72,53,3,16,0,0,0,0,48307
15906,20182,819,3641,5214,5941,4567,1902,834,804,318,68,418,30,30,27,0,3,0,0,0,0,1068,1054,433,28,593,14,9,0,0,9,5,0,0,5,48309
15907,30301,6040,9110,7646,5014,2491,2196,1154,990,277,107,606,164,91,13,65,13,73,10,49,14,1042,973,179,214,580,69,31,24,7,0,38,0,0,38,48310
15908,23476,2699,6812,7829,3875,2261,1461,760,706,199,74,433,54,41,31,10,0,13,0,13,0,701,668,219,91,358,33,32,0,32,0,1,0,1,0,48312
15909,23362,2590,6750,8659,3504,1859,1883,1025,923,291,167,465,102,65,19,31,15,37,0,0,37,858,733,334,45,354,125,115,91,11,13,10,0,10,0,48313
15910,14332,1653,3735,4301,2843,1800,1162,438,396,166,27,203,42,24,0,0,24,18,7,0,11,724,642,188,30,424,82,30,18,0,12,52,0,0,52,48314
15911,18975,1985,5255,6089,3278,2368,1553,772,709,261,79,369,63,48,48,0,0,15,0,0,15,781,706,230,49,427,75,75,68,0,7,0,0,0,0,48315
15912,18200,1292,4444,6270,3777,2417,1145,581,559,122,48,389,22,9,0,9,0,13,0,0,13,564,487,155,76,256,77,69,32,8,29,8,8,0,0,48316
15913,18053,1894,5642,6219,2973,1325,1397,886,782,147,116,519,104,51,44,0,7,53,27,0,26,511,464,116,56,292,47,9,9,0,0,38,4,0,34,48317
15914,3127,343,806,700,825,453,153,95,45,6,5,34,50,38,29,0,9,12,0,0,12,58,42,11,0,31,16,16,16,0,0,0,0,0,0,48320
15915,22381,1574,3313,5638,6235,5621,1883,893,826,177,97,552,67,35,0,0,35,32,0,0,32,990,892,237,75,580,98,52,33,0,19,46,2,0,44,48322
15916,12275,763,1481,2730,3415,3886,1062,561,523,82,74,367,38,21,0,21,0,17,0,17,0,501,491,79,0,412,10,10,10,0,0,0,0,0,0,48323
15917,11705,368,1756,2812,3688,3081,1049,629,518,101,63,354,111,81,36,25,20,30,0,0,30,420,385,88,17,280,35,0,0,0,0,35,0,13,22,48324
15918,14027,1382,2765,4196,3484,2200,944,408,298,90,90,118,110,82,68,0,14,28,8,0,20,536,514,104,42,368,22,22,22,0,0,0,0,0,0,48326
15919,15166,1370,4650,5182,2334,1630,1110,532,384,80,98,206,148,89,21,68,0,59,59,0,0,578,500,78,147,275,78,78,78,0,0,0,0,0,0,48327
15920,17081,2152,4646,6112,2914,1257,1318,658,535,85,31,419,123,103,54,29,20,20,0,0,20,660,516,172,51,293,144,39,13,8,18,105,38,4,63,48328
15921,17362,1317,5253,6062,3059,1671,1459,802,636,155,55,426,166,78,26,43,9,88,14,19,55,657,593,244,35,314,64,43,37,6,0,21,0,0,21,48329
15922,15778,878,2039,3072,5008,4781,1616,794,740,271,80,389,54,32,32,0,0,22,22,0,0,822,804,313,52,439,18,18,5,0,13,0,0,0,0,48331
15923,13064,759,2032,3358,3933,2982,713,360,302,76,11,215,58,58,58,0,0,0,0,0,0,353,301,105,0,196,52,42,39,0,3,10,10,0,0,48334
15924,16217,579,2604,4263,5004,3767,593,327,327,68,22,237,0,0,0,0,0,0,0,0,0,266,266,82,0,184,0,0,0,0,0,0,0,0,0,48335
15925,18811,1580,4086,5995,4100,3050,1184,648,495,155,21,319,153,140,107,20,13,13,0,12,1,536,373,139,21,213,163,123,28,0,95,40,0,0,40,48336
15926,14599,3826,4762,4560,1045,406,1807,831,595,181,112,302,236,65,64,0,1,171,45,12,114,976,789,239,143,407,187,57,50,7,0,130,12,84,34,48340
15927,11682,2129,3430,4048,1637,438,984,688,505,63,168,274,183,72,16,46,10,111,27,8,76,296,210,43,9,158,86,54,0,54,0,32,0,0,32,48341
15928,10860,2748,3872,3373,574,293,1197,565,349,55,37,257,216,134,36,60,38,82,6,0,76,632,508,102,155,251,124,68,0,43,25,56,0,0,56,48342
15929,15493,1000,4086,5436,2873,2098,1404,747,584,197,57,330,163,119,18,92,9,44,13,31,0,657,634,145,162,327,23,15,7,0,8,8,0,0,8,48346
15930,15100,692,3088,4857,4086,2377,1659,842,708,203,91,414,134,106,41,35,30,28,0,0,28,817,755,214,114,427,62,46,25,14,7,16,0,9,7,48348
15931,4824,260,1264,1718,1017,565,433,173,137,27,28,82,36,36,10,14,12,0,0,0,0,260,260,136,16,108,0,0,0,0,0,0,0,0,0,48350
15932,4214,342,1083,1618,877,294,313,172,126,28,15,83,46,39,39,0,0,7,0,0,7,141,141,63,46,32,0,0,0,0,0,0,0,0,0,48353
15933,5832,399,1712,2128,1050,543,560,318,288,69,14,205,30,6,6,0,0,24,0,8,16,242,227,75,0,152,15,15,0,0,15,0,0,0,0,48356
15934,5841,539,1865,1830,1190,417,410,236,210,63,45,102,26,9,3,0,6,17,0,0,17,174,152,53,9,90,22,22,12,0,10,0,0,0,0,48357
15935,5149,491,1148,1718,1308,484,436,223,223,89,41,93,0,0,0,0,0,0,0,0,0,213,171,73,26,72,42,42,5,0,37,0,0,0,0,48359
15936,7539,242,1194,2378,2266,1459,693,349,346,104,17,225,3,0,0,0,0,3,3,0,0,344,293,115,44,134,51,51,28,10,13,0,0,0,0,48360
15937,10267,453,2372,3834,2399,1209,706,408,350,136,0,214,58,58,58,0,0,0,0,0,0,298,217,68,0,149,81,81,72,9,0,0,0,0,0,48362
15938,3387,289,740,908,774,676,413,288,259,18,63,178,29,29,19,0,10,0,0,0,0,125,112,47,32,33,13,5,5,0,0,8,0,0,8,48363
15939,3147,323,946,1100,505,273,322,118,118,20,7,91,0,0,0,0,0,0,0,0,0,204,172,35,42,95,32,24,10,4,10,8,0,0,8,48367
15940,1251,112,236,340,341,222,95,53,34,3,14,17,19,19,19,0,0,0,0,0,0,42,42,0,0,42,0,0,0,0,0,0,0,0,0,48370
15941,15342,998,4052,4980,3226,2086,1046,458,448,87,52,309,10,10,10,0,0,0,0,0,0,588,510,194,50,266,78,69,54,15,0,9,0,0,9,48371
15942,9135,387,694,1826,3268,2960,1076,528,528,124,26,378,0,0,0,0,0,0,0,0,0,548,536,86,28,422,12,12,0,0,12,0,0,0,0,48374
15943,15064,690,2044,3855,4907,3568,1075,638,600,178,36,386,38,38,16,22,0,0,0,0,0,437,366,91,0,275,71,21,0,21,0,50,49,1,0,48375
15944,11266,850,2288,2893,3047,2188,442,263,222,75,11,136,41,26,0,13,13,15,15,0,0,179,109,43,37,29,70,70,57,13,0,0,0,0,0,48377
15945,4962,273,1060,1455,1374,800,556,255,209,118,6,85,46,40,0,40,0,6,6,0,0,301,276,96,6,174,25,0,0,0,0,25,0,0,25,48380
15946,8893,542,2111,2837,2317,1086,770,450,392,120,13,259,58,42,30,12,0,16,6,0,10,320,296,131,35,130,24,24,24,0,0,0,0,0,0,48381
15947,14551,684,2885,4163,4574,2245,957,545,511,139,34,338,34,26,25,0,1,8,8,0,0,412,364,122,11,231,48,35,23,12,0,13,0,13,0,48382
15948,8515,649,2409,3192,1535,730,600,277,276,67,30,179,1,0,0,0,0,1,0,0,1,323,304,122,30,152,19,19,11,0,8,0,0,0,0,48383
15949,12576,750,3539,3917,2950,1420,877,520,429,144,0,285,91,78,69,0,9,13,0,0,13,357,311,164,0,147,46,0,0,0,0,46,0,39,7,48386
15950,16684,1442,4192,5299,3896,1855,1188,634,490,227,55,208,144,112,20,37,55,32,0,0,32,554,497,151,18,328,57,50,50,0,0,7,0,0,7,48390
15951,10433,882,2424,3639,2376,1112,867,419,277,83,52,142,142,142,92,50,0,0,0,0,0,448,357,182,5,170,91,72,72,0,0,19,0,19,0,48393
15952,0,0,0,0,0,0,0,0,0,0,0,0,0,0,0,0,0,0,0,0,0,0,0,0,0,0,0,0,0,0,0,0,0,0,0,48397
15953,1106,216,493,290,90,17,88,31,14,2,0,12,17,12,0,4,8,5,0,0,5,57,43,9,5,29,14,0,0,0,0,14,0,0,14,48401
15954,20,0,20,0,0,0,0,0,0,0,0,0,0,0,0,0,0,0,0,0,0,0,0,0,0,0,0,0,0,0,0,0,0,0,0,48411
15955,4001,364,1794,1524,200,119,380,164,146,67,44,35,18,18,18,0,0,0,0,0,0,216,146,0,26,120,70,50,28,12,10,20,0,0,20,48412
15956,5221,698,2347,1412,508,256,382,188,154,43,5,106,34,23,5,18,0,11,1,8,2,194,178,78,21,79,16,16,10,0,6,0,0,0,0,48413
15957,1951,194,865,705,143,44,166,122,84,14,3,67,38,16,16,0,0,22,0,22,0,44,41,14,11,16,3,3,0,0,3,0,0,0,0,48414
15958,6495,579,2675,2398,667,176,574,320,262,114,28,120,58,47,6,41,0,11,0,0,11,254,240,75,16,149,14,14,14,0,0,0,0,0,0,48415
15959,3252,498,1499,943,201,111,322,186,140,22,30,88,46,40,35,4,1,6,0,0,6,136,104,14,21,69,32,14,9,0,5,18,14,0,4,48416
15960,1912,294,757,625,163,73,113,80,77,32,2,43,3,0,0,0,0,3,0,0,3,33,24,0,0,24,9,9,0,9,0,0,0,0,0,48417
15961,2845,228,1079,1129,323,86,260,123,85,32,9,44,38,34,12,12,10,4,0,4,0,137,109,23,4,82,28,27,13,14,0,1,0,0,1,48418
15962,1855,251,850,520,114,120,132,69,52,9,0,43,17,6,0,4,2,11,0,8,3,63,43,7,0,36,20,20,2,0,18,0,0,0,0,48419
15963,15408,1813,5836,5489,1416,854,1125,627,552,162,116,274,75,49,22,27,0,26,8,9,9,498,433,161,25,247,65,45,25,8,12,20,20,0,0,48420
15964,4407,418,1679,1585,542,183,493,139,104,6,11,87,35,35,7,20,8,0,0,0,0,354,267,62,21,184,87,87,51,32,4,0,0,0,0,48421
15965,4209,487,2013,1304,242,163,359,180,150,29,41,80,30,30,19,11,0,0,0,0,0,179,169,44,14,111,10,6,6,0,0,4,0,0,4,48422
15966,21518,1462,6955,8590,2870,1641,1826,988,889,144,129,616,99,49,20,8,21,50,0,10,40,838,784,153,67,564,54,35,35,0,0,19,11,0,8,48423
15967,666,84,347,197,37,1,45,33,20,0,3,17,13,3,3,0,0,10,7,0,3,12,9,0,3,6,3,0,0,0,0,3,0,0,3,48426
15968,1989,224,976,575,157,57,157,94,88,14,3,71,6,6,3,0,3,0,0,0,0,63,54,11,0,43,9,3,0,0,3,6,3,0,3,48427
15969,3338,150,1036,1429,472,251,343,244,236,67,13,156,8,8,0,8,0,0,0,0,0,99,77,41,0,36,22,19,19,0,0,3,0,0,3,48428
15970,5610,631,2219,2131,376,253,393,227,191,19,36,136,36,28,11,7,10,8,0,8,0,166,121,20,0,101,45,45,12,0,33,0,0,0,0,48429
15971,24367,1621,6500,8592,5147,2507,2085,1122,948,329,107,512,174,113,81,7,25,61,12,49,0,963,874,381,33,460,89,37,0,7,30,52,22,10,20,48430
15972,494,66,259,126,37,6,19,12,12,2,2,8,0,0,0,0,0,0,0,0,0,7,7,5,0,2,0,0,0,0,0,0,0,0,0,48432
15973,18181,854,5179,7060,3343,1745,1365,637,564,153,67,344,73,44,17,27,0,29,0,19,10,728,681,172,79,430,47,47,20,0,27,0,0,0,0,48433
15974,49,9,14,9,2,15,0,0,0,0,0,0,0,0,0,0,0,0,0,0,0,0,0,0,0,0,0,0,0,0,0,0,0,0,0,48434
15975,1382,178,694,366,114,30,194,87,79,2,22,55,8,0,0,0,0,8,0,0,8,107,103,18,26,59,4,4,0,0,4,0,0,0,0,48435
15976,2551,208,1076,940,259,68,264,190,100,9,2,89,90,58,10,35,13,32,0,11,21,74,56,19,2,35,18,18,1,17,0,0,0,0,0,48436
15977,338,17,100,150,71,0,20,9,9,0,0,9,0,0,0,0,0,0,0,0,0,11,5,0,5,0,6,6,6,0,0,0,0,0,0,48437
15978,4609,186,1246,1765,777,635,342,173,173,56,13,104,0,0,0,0,0,0,0,0,0,169,142,62,16,64,27,27,27,0,0,0,0,0,0,48438
15979,32380,1650,7885,11134,6800,4911,2667,1362,1156,304,98,754,206,206,41,19,146,0,0,0,0,1305,1210,272,28,910,95,62,40,22,0,33,0,0,33,48439
15980,296,206,69,8,13,0,24,24,24,0,0,24,0,0,0,0,0,0,0,0,0,0,0,0,0,0,0,0,0,0,0,0,0,0,0,48440
15981,2852,414,1267,777,285,109,146,90,75,41,3,31,15,14,9,2,3,1,0,0,1,56,49,8,9,32,7,7,1,6,0,0,0,0,0,48441
15982,14418,1175,4439,5354,2326,1124,1242,661,589,104,82,403,72,67,54,0,13,5,0,5,0,581,428,218,18,192,153,62,53,0,9,91,55,0,36,48442
15983,5896,1042,2243,1887,558,166,471,291,228,41,0,187,63,33,23,10,0,30,30,0,0,180,133,40,34,59,47,8,8,0,0,39,0,0,39,48444
15984,1006,154,457,300,54,41,70,34,24,4,0,20,10,10,10,0,0,0,0,0,0,36,20,7,0,13,16,8,8,0,0,8,0,5,3,48445
15985,21977,2008,8226,7914,2533,1296,1724,981,631,139,85,407,350,139,52,29,58,211,29,0,182,743,628,232,81,315,115,74,23,41,10,41,0,0,41,48446
15986,2100,192,832,850,189,37,132,59,50,0,0,50,9,0,0,0,0,9,0,0,9,73,48,12,0,36,25,25,25,0,0,0,0,0,0,48449
15987,3344,271,1288,1241,290,254,232,134,125,27,38,60,9,0,0,0,0,9,0,0,9,98,72,9,3,60,26,0,0,0,0,26,0,0,26,48450
15988,9997,596,3112,3475,1595,1219,582,284,266,51,27,188,18,0,0,0,0,18,10,0,8,298,272,76,24,172,26,10,10,0,0,16,0,0,16,48451
15989,3390,474,1463,1145,189,119,226,89,50,14,19,17,39,33,16,17,0,6,0,0,6,137,122,33,37,52,15,4,0,4,0,11,5,0,6,48453
15990,891,106,408,296,53,28,90,50,48,15,4,29,2,2,2,0,0,0,0,0,0,40,31,6,8,17,9,6,3,0,3,3,0,0,3,48454
15991,5664,379,1473,2045,1053,714,387,167,136,43,0,93,31,31,12,0,19,0,0,0,0,220,219,103,0,116,1,1,1,0,0,0,0,0,0,48455
15992,637,92,292,185,59,9,26,19,11,0,0,11,8,2,2,0,0,6,3,3,0,7,7,3,0,4,0,0,0,0,0,0,0,0,0,48456
15993,5421,659,2236,2079,340,107,641,280,245,23,75,147,35,15,2,4,9,20,9,11,0,361,344,122,10,212,17,3,3,0,0,14,14,0,0,48457
15994,14176,2327,5908,4768,801,372,1288,693,532,142,41,349,161,53,12,29,12,108,6,0,102,595,440,80,60,300,155,71,12,20,39,84,0,35,49,48458
15995,1560,143,652,541,153,71,98,46,32,14,3,15,14,5,4,1,0,9,6,3,0,52,50,20,3,27,2,0,0,0,0,2,0,0,2,48460
15996,5582,481,2727,1635,456,283,687,419,325,70,10,245,94,94,2,51,41,0,0,0,0,268,249,68,30,151,19,19,4,0,15,0,0,0,0,48461
15997,9127,592,2576,3414,1666,879,928,563,509,121,81,307,54,39,16,14,9,15,0,15,0,365,328,144,0,184,37,16,6,0,10,21,0,0,21,48462
15998,3241,219,1450,1170,263,139,211,69,40,8,0,32,29,25,25,0,0,4,0,0,4,142,128,30,15,83,14,14,7,7,0,0,0,0,0,48463
15999,1366,137,660,384,139,46,79,43,23,0,7,16,20,6,0,0,6,14,4,0,10,36,36,4,15,17,0,0,0,0,0,0,0,0,0,48464
16000,434,32,219,119,40,24,5,3,3,2,0,1,0,0,0,0,0,0,0,0,0,2,2,0,0,2,0,0,0,0,0,0,0,0,0,48465
16001,1200,202,569,318,80,31,84,31,28,5,6,17,3,3,3,0,0,0,0,0,0,53,46,2,0,44,7,7,3,0,4,0,0,0,0,48466
16002,1944,237,730,618,174,185,67,31,31,10,0,21,0,0,0,0,0,0,0,0,0,36,31,2,10,19,5,5,5,0,0,0,0,0,0,48467
16003,1140,160,594,276,72,38,51,31,27,1,5,21,4,2,2,0,0,2,0,0,2,20,15,1,2,12,5,2,0,0,2,3,0,0,3,48468
16004,935,101,442,177,108,107,46,22,7,2,0,5,15,11,11,0,0,4,0,0,4,24,24,13,0,11,0,0,0,0,0,0,0,0,0,48469
16005,522,117,256,103,28,18,48,27,27,15,0,12,0,0,0,0,0,0,0,0,0,21,21,15,0,6,0,0,0,0,0,0,0,0,0,48470
16006,4046,503,1894,1152,312,185,326,151,116,42,9,65,35,16,10,3,3,19,5,0,14,175,134,5,23,106,41,18,18,0,0,23,4,7,12,48471
16007,1252,231,640,271,81,29,116,71,41,7,2,32,30,26,12,4,10,4,4,0,0,45,38,11,4,23,7,3,0,0,3,4,4,0,0,48472
16008,15214,1024,5033,6251,1844,1062,1350,840,739,193,60,486,101,53,44,9,0,48,9,0,39,510,437,162,10,265,73,36,13,0,23,37,0,0,37,48473
16009,1792,241,853,469,151,78,129,80,76,17,10,49,4,4,4,0,0,0,0,0,0,49,49,13,11,25,0,0,0,0,0,0,0,0,0,48475
16010,502,32,209,187,38,36,89,43,43,5,0,38,0,0,0,0,0,0,0,0,0,46,31,0,0,31,15,6,0,0,6,9,0,0,9,48476
16011,650,280,147,163,14,46,134,102,30,0,0,30,72,23,0,0,23,49,0,0,49,32,8,8,0,0,24,7,0,0,7,17,0,0,17,48502
16012,16806,2559,5164,5947,1745,1391,1214,477,393,34,80,279,84,0,0,0,0,84,35,34,15,737,654,208,22,424,83,51,3,0,48,32,5,7,20,48503
16013,18419,3153,6739,6438,1492,597,2379,1260,1036,136,208,692,224,123,81,16,26,101,29,24,48,1119,991,149,76,766,128,123,65,37,21,5,0,0,5,48504
16014,14331,3184,5622,4796,533,196,1897,751,595,99,99,397,156,86,0,14,72,70,0,32,38,1146,992,141,90,761,154,101,66,35,0,53,0,0,53,48505
16015,19241,3847,7457,6279,1308,350,1486,710,479,77,25,377,231,118,42,26,50,113,0,12,101,776,548,105,31,412,228,117,23,72,22,111,0,29,82,48506
16016,20141,2816,7441,7506,1613,765,1904,859,759,65,119,575,100,62,9,35,18,38,0,0,38,1045,801,104,146,551,244,188,88,92,8,56,0,0,56,48507
16017,7115,629,2672,2720,717,377,470,244,211,69,10,132,33,9,0,9,0,24,0,14,10,226,220,66,29,125,6,6,0,6,0,0,0,0,0,48509
16018,5400,578,1974,2152,526,170,264,118,78,14,0,64,40,40,8,18,14,0,0,0,0,146,73,9,42,22,73,73,0,39,34,0,0,0,0,48519
16019,6248,992,2526,2290,369,71,522,360,288,38,67,183,72,41,0,32,9,31,0,31,0,162,134,0,2,132,28,28,19,9,0,0,0,0,0,48529
16020,13478,1482,3615,5549,1595,1237,1151,681,651,60,112,479,30,15,9,0,6,15,0,15,0,470,402,109,79,214,68,5,0,0,5,63,10,8,45,48532
16021,0,0,0,0,0,0,0,0,0,0,0,0,0,0,0,0,0,0,0,0,0,0,0,0,0,0,0,0,0,0,0,0,0,0,0,48551
16022,0,0,0,0,0,0,0,0,0,0,0,0,0,0,0,0,0,0,0,0,0,0,0,0,0,0,0,0,0,0,0,0,0,0,0,48553
16023,0,0,0,0,0,0,0,0,0,0,0,0,0,0,0,0,0,0,0,0,0,0,0,0,0,0,0,0,0,0,0,0,0,0,0,48554
16024,23872,5570,8900,7442,1332,628,2730,1442,1024,104,231,689,418,241,40,154,47,177,0,40,137,1288,953,179,182,592,335,214,107,73,34,121,81,15,25,48601
16025,19001,3350,6724,6161,1814,952,1837,1052,783,197,221,365,269,182,155,21,6,87,23,0,64,785,619,144,83,392,166,133,82,12,39,33,4,0,29,48602
16026,18483,1367,5367,5534,3954,2261,1263,659,606,197,64,345,53,19,19,0,0,34,0,34,0,604,549,196,57,296,55,37,24,0,13,18,18,0,0,48603
16027,7644,846,2831,2856,830,281,1638,549,537,198,56,283,12,4,0,4,0,8,4,0,4,1089,1046,254,25,767,43,5,5,0,0,38,0,0,38,48604
16028,1098,344,366,243,86,59,37,22,22,14,0,8,0,0,0,0,0,0,0,0,0,15,13,0,7,6,2,0,0,0,0,2,0,0,2,48607
16029,8541,851,3128,2845,1171,546,778,436,379,121,36,222,57,48,48,0,0,9,0,0,9,342,288,109,27,152,54,36,27,9,0,18,0,0,18,48609
16030,2478,516,1052,717,120,73,108,48,45,27,2,16,3,0,0,0,0,3,3,0,0,60,43,22,4,17,17,17,14,3,0,0,0,0,0,48610
16031,4658,370,1340,1865,769,314,317,176,159,16,0,143,17,17,14,3,0,0,0,0,0,141,116,64,30,22,25,13,13,0,0,12,0,0,12,48611
16032,6875,1018,2886,2300,478,193,318,169,123,28,19,76,46,23,9,10,4,23,2,10,11,149,129,30,8,91,20,18,6,9,3,2,2,0,0,48612
16033,750,121,322,213,43,51,38,12,12,9,0,3,0,0,0,0,0,0,0,0,0,26,22,3,3,16,4,4,4,0,0,0,0,0,0,48613
16034,868,139,366,284,58,21,92,37,37,6,7,24,0,0,0,0,0,0,0,0,0,55,40,9,0,31,15,13,2,0,11,2,0,0,2,48614
16035,2072,131,1009,720,146,66,150,84,72,5,3,64,12,12,12,0,0,0,0,0,0,66,60,20,7,33,6,3,0,0,3,3,0,0,3,48615
16036,5175,611,2001,1835,506,222,312,158,149,50,30,69,9,9,0,6,3,0,0,0,0,154,96,54,4,38,58,58,55,3,0,0,0,0,0,48616
16037,5690,821,2096,1745,672,356,343,172,152,61,11,80,20,13,13,0,0,7,7,0,0,171,142,29,18,95,29,2,0,2,0,27,0,27,0,48617
16038,3830,452,1774,1216,269,119,292,174,139,26,0,113,35,21,12,9,0,14,3,3,8,118,91,33,7,51,27,4,0,4,0,23,0,0,23,48618
16039,323,27,142,127,20,7,11,4,4,0,2,2,0,0,0,0,0,0,0,0,0,7,7,0,2,5,0,0,0,0,0,0,0,0,0,48619
16040,934,150,384,254,91,55,61,42,19,11,0,8,23,10,4,0,6,13,13,0,0,19,19,7,0,12,0,0,0,0,0,0,0,0,0,48621
16041,4485,665,1800,1490,334,196,371,216,165,26,49,90,51,7,7,0,0,44,18,0,26,155,136,27,14,95,19,10,0,5,5,9,0,0,9,48622
16042,9431,812,2945,2989,2038,647,711,430,388,88,40,260,42,42,24,0,18,0,0,0,0,281,275,94,41,140,6,6,6,0,0,0,0,0,0,48623
16043,11672,1979,4408,3742,897,646,818,458,300,45,31,224,158,44,29,2,13,114,54,0,60,360,260,48,9,203,100,27,12,7,8,73,2,0,71,48624
16044,9944,1764,4039,3318,534,289,614,296,254,55,6,193,42,27,24,0,3,15,1,6,8,318,234,49,72,113,84,51,21,30,0,33,0,9,24,48625
16045,4256,265,1704,1533,512,242,354,210,183,90,15,78,27,27,15,0,12,0,0,0,0,144,131,39,11,81,13,13,13,0,0,0,0,0,0,48626
16046,99,3,19,54,15,8,0,0,0,0,0,0,0,0,0,0,0,0,0,0,0,0,0,0,0,0,0,0,0,0,0,0,0,0,0,48627
16047,1519,153,589,491,191,95,72,33,33,3,1,29,0,0,0,0,0,0,0,0,0,39,33,14,5,14,6,2,0,0,2,4,4,0,0,48628
16048,6213,1135,2412,1968,369,329,375,267,186,32,27,127,81,61,51,10,0,20,20,0,0,108,90,39,4,47,18,11,0,0,11,7,0,0,7,48629
16049,87,10,46,8,23,0,34,0,0,0,0,0,0,0,0,0,0,0,0,0,0,34,34,0,0,34,0,0,0,0,0,0,0,0,0,48630
16050,3314,239,1137,1446,372,120,250,175,78,3,5,70,97,82,58,24,0,15,0,0,15,75,75,19,0,56,0,0,0,0,0,0,0,0,0,48631
16051,3669,605,1648,1091,220,105,238,152,95,17,12,66,57,43,21,8,14,14,0,8,6,86,81,24,9,48,5,5,0,5,0,0,0,0,0,48632
16052,186,28,45,92,21,0,22,0,0,0,0,0,0,0,0,0,0,0,0,0,0,22,22,0,0,22,0,0,0,0,0,0,0,0,0,48633
16053,3131,325,1247,995,361,203,240,181,177,52,10,115,4,4,0,0,4,0,0,0,0,59,35,4,4,27,24,4,4,0,0,20,0,20,0,48634
16054,1353,185,625,428,67,48,62,29,29,9,0,20,0,0,0,0,0,0,0,0,0,33,24,2,8,14,9,9,6,3,0,0,0,0,0,48635
16055,775,53,392,261,39,30,21,5,5,0,0,5,0,0,0,0,0,0,0,0,0,16,16,0,0,16,0,0,0,0,0,0,0,0,0,48636
16056,2403,191,961,870,288,93,201,87,81,18,10,53,6,3,3,0,0,3,0,0,3,114,102,32,8,62,12,12,12,0,0,0,0,0,0,48637
16057,9158,544,2106,3663,1802,1043,540,295,235,78,16,141,60,45,45,0,0,15,0,0,15,245,215,79,28,108,30,30,0,0,30,0,0,0,0,48638
16058,21142,1532,5676,6489,4266,3179,2090,1253,1119,246,70,803,134,117,27,44,46,17,0,3,14,837,771,166,46,559,66,49,22,18,9,17,8,0,9,48640
16059,22260,1613,5270,6808,5351,3218,1761,793,691,251,52,388,102,75,55,3,17,27,11,0,16,968,855,301,31,523,113,82,51,3,28,31,11,19,1,48642
16060,3093,678,1245,876,234,60,197,101,31,15,0,16,70,27,20,0,7,43,15,0,28,96,69,37,10,22,27,6,0,6,0,21,3,0,18,48647
16061,1053,104,511,361,54,23,117,54,36,11,2,23,18,9,9,0,0,9,0,0,9,63,58,27,0,31,5,5,5,0,0,0,0,0,0,48649
16062,5062,658,2105,1647,487,165,397,169,127,32,1,94,42,27,4,4,19,15,3,12,0,228,221,96,11,114,7,7,3,4,0,0,0,0,0,48650
16063,3792,500,1578,1268,283,163,195,97,83,8,27,48,14,7,0,0,7,7,0,0,7,98,75,31,0,44,23,0,0,0,0,23,0,0,23,48651
16064,1076,151,503,306,65,51,70,40,32,14,2,16,8,5,4,1,0,3,0,3,0,30,30,7,0,23,0,0,0,0,0,0,0,0,0,48652
16065,7706,875,2637,2860,875,459,388,207,175,52,25,98,32,26,16,2,8,6,0,0,6,181,138,19,7,112,43,33,8,25,0,10,0,0,10,48653
16066,1742,284,712,548,135,63,154,65,45,16,10,19,20,13,9,4,0,7,7,0,0,89,63,10,6,47,26,9,6,3,0,17,8,0,9,48654
16067,4347,410,1729,1633,440,135,297,149,137,24,4,109,12,12,0,12,0,0,0,0,0,148,132,41,29,62,16,16,14,0,2,0,0,0,0,48655
16068,3189,563,1336,1064,168,58,131,56,38,0,0,38,18,10,9,0,1,8,0,0,8,75,55,16,5,34,20,4,4,0,0,16,0,7,9,48656
16069,5669,520,1946,2012,822,369,463,230,189,41,4,144,41,13,6,0,7,28,0,0,28,233,215,81,4,130,18,18,15,3,0,0,0,0,0,48657
16070,3819,667,1638,1097,286,131,308,164,126,39,11,76,38,29,10,3,16,9,0,0,9,144,121,35,3,83,23,15,5,5,5,8,0,0,8,48658
16071,1992,286,904,590,147,65,154,76,54,16,0,38,22,6,3,0,3,16,2,4,10,78,52,33,2,17,26,24,14,0,10,2,2,0,0,48659
16072,7242,847,2784,2441,772,398,488,270,217,66,13,138,53,30,14,13,3,23,4,2,17,218,193,70,31,92,25,7,2,2,3,18,12,1,5,48661
16073,1054,91,510,327,70,56,69,34,32,2,0,30,2,2,2,0,0,0,0,0,0,35,32,3,0,29,3,3,3,0,0,0,0,0,0,48662
16074,0,0,0,0,0,0,0,0,0,0,0,0,0,0,0,0,0,0,0,0,0,0,0,0,0,0,0,0,0,0,0,0,0,0,0,48667
16075,915,156,359,331,41,28,85,52,31,2,0,29,21,17,0,17,0,4,0,4,0,33,31,2,13,16,2,2,2,0,0,0,0,0,0,48701
16076,2320,274,915,756,190,185,91,36,27,11,3,13,9,9,0,9,0,0,0,0,0,55,49,20,4,25,6,0,0,0,0,6,2,0,4,48703
16077,368,82,160,94,27,5,7,2,2,0,2,0,0,0,0,0,0,0,0,0,0,5,5,5,0,0,0,0,0,0,0,0,0,0,0,48705
16078,28214,2637,10187,10036,3748,1606,1874,932,829,228,87,514,103,61,61,0,0,42,23,0,19,942,802,330,30,442,140,93,50,12,31,47,0,16,31,48706
16079,18217,2667,6556,5794,2125,1075,1336,720,556,102,66,388,164,141,79,37,25,23,0,0,23,616,484,162,63,259,132,60,12,15,33,72,26,0,46,48708
16080,0,0,0,0,0,0,0,0,0,0,0,0,0,0,0,0,0,0,0,0,0,0,0,0,0,0,0,0,0,0,0,0,0,0,0,48710
16081,805,121,374,222,73,15,60,37,37,10,5,22,0,0,0,0,0,0,0,0,0,23,23,8,0,15,0,0,0,0,0,0,0,0,0,48720
16082,308,35,128,100,32,13,12,4,4,0,0,4,0,0,0,0,0,0,0,0,0,8,4,0,0,4,4,4,0,0,4,0,0,0,0,48721
16083,2257,237,873,838,167,142,146,76,57,32,0,25,19,0,0,0,0,19,0,0,19,70,54,22,0,32,16,0,0,0,0,16,0,0,16,48722
16084,9076,1220,3508,2956,871,521,521,308,232,71,8,153,76,58,25,31,2,18,0,0,18,213,207,81,26,100,6,6,0,0,6,0,0,0,0,48723
16085,259,25,70,91,0,73,0,0,0,0,0,0,0,0,0,0,0,0,0,0,0,0,0,0,0,0,0,0,0,0,0,0,0,0,0,48724
16086,1904,215,847,630,152,60,89,40,26,14,0,12,14,14,9,5,0,0,0,0,0,49,45,2,5,38,4,4,0,0,4,0,0,0,0,48725
16087,4202,568,1570,1562,376,126,426,237,203,61,11,131,34,14,5,1,8,20,7,11,2,189,158,58,17,83,31,13,3,4,6,18,11,0,7,48726
16088,897,166,508,180,20,23,77,32,22,1,7,14,10,10,0,10,0,0,0,0,0,45,31,14,0,17,14,11,11,0,0,3,0,0,3,48727
16089,280,45,104,93,22,16,0,0,0,0,0,0,0,0,0,0,0,0,0,0,0,0,0,0,0,0,0,0,0,0,0,0,0,0,0,48728
16090,1052,228,454,294,62,14,129,79,61,7,6,48,18,9,0,9,0,9,0,9,0,50,36,0,11,25,14,4,4,0,0,10,0,10,0,48729
16091,3428,371,1211,1087,514,245,242,51,36,6,0,30,15,7,0,7,0,8,0,8,0,191,167,43,11,113,24,24,24,0,0,0,0,0,0,48730
16092,1124,147,476,356,134,11,121,83,70,27,15,28,13,11,11,0,0,2,0,0,2,38,38,20,0,18,0,0,0,0,0,0,0,0,0,48731
16093,8093,861,2454,3131,1141,506,634,350,311,55,68,188,39,25,0,25,0,14,0,14,0,284,185,109,22,54,99,91,0,24,67,8,0,8,0,48732
16094,1246,147,567,390,110,32,103,32,21,10,0,11,11,9,9,0,0,2,0,0,2,71,46,23,0,23,25,14,12,2,0,11,0,0,11,48733
16095,5596,329,1427,1816,1342,682,319,171,155,50,16,89,16,16,13,0,3,0,0,0,0,148,138,55,7,76,10,10,4,2,4,0,0,0,0,48734
16096,628,125,244,197,45,17,36,30,29,11,0,18,1,1,1,0,0,0,0,0,0,6,6,0,0,6,0,0,0,0,0,0,0,0,0,48735
16097,1079,185,469,296,89,40,35,10,7,0,2,5,3,0,0,0,0,3,0,0,3,25,14,0,6,8,11,0,0,0,0,11,0,0,11,48737
16098,1124,88,389,460,111,76,23,3,3,0,0,3,0,0,0,0,0,0,0,0,0,20,15,0,0,15,5,5,5,0,0,0,0,0,0,48738
16099,3178,449,1421,1004,181,123,136,82,50,21,3,26,32,18,18,0,0,14,0,14,0,54,37,6,2,29,17,4,0,0,4,13,0,13,0,48739
16100,1991,243,733,719,163,133,124,56,29,0,0,29,27,20,3,1,16,7,0,0,7,68,41,12,0,29,27,25,21,0,4,2,0,0,2,48740
16101,1413,213,527,475,117,81,102,61,28,5,4,19,33,2,0,0,2,31,0,13,18,41,27,3,0,24,14,7,3,4,0,7,0,7,0,48741
16102,1185,135,472,384,123,71,69,42,31,5,1,25,11,0,0,0,0,11,4,0,7,27,20,8,1,11,7,2,0,2,0,5,0,5,0,48742
16103,11,5,3,3,0,0,0,0,0,0,0,0,0,0,0,0,0,0,0,0,0,0,0,0,0,0,0,0,0,0,0,0,0,0,0,48743
16104,3386,548,1558,959,246,75,181,97,94,42,11,41,3,3,3,0,0,0,0,0,0,84,70,13,0,57,14,11,11,0,0,3,0,3,0,48744
16105,1015,146,443,390,34,2,104,56,42,18,15,9,14,6,4,2,0,8,0,8,0,48,45,0,0,45,3,0,0,0,0,3,0,0,3,48745
16106,5523,569,2451,1954,287,262,598,251,204,53,30,121,47,14,2,6,6,33,0,4,29,347,302,152,9,141,45,45,18,27,0,0,0,0,0,48746
16107,1002,107,368,427,80,20,79,66,30,8,3,19,36,20,20,0,0,16,14,2,0,13,13,5,4,4,0,0,0,0,0,0,0,0,0,48747
16108,1426,208,716,423,56,23,67,48,44,3,0,41,4,4,4,0,0,0,0,0,0,19,19,0,0,19,0,0,0,0,0,0,0,0,0,48748
16109,782,141,335,248,26,32,31,16,6,0,0,6,10,10,10,0,0,0,0,0,0,15,12,3,0,9,3,3,0,3,0,0,0,0,0,48749
16110,6576,818,2437,2318,563,440,408,270,184,56,4,124,86,14,12,0,2,72,5,25,42,138,82,24,11,47,56,19,7,12,0,37,0,18,19,48750
16111,616,56,363,132,53,12,61,32,30,7,3,20,2,2,0,0,2,0,0,0,0,29,22,13,1,8,7,0,0,0,0,7,0,0,7,48754
16112,2358,230,919,686,334,189,111,57,47,21,0,26,10,10,2,0,8,0,0,0,0,54,44,13,0,31,10,2,2,0,0,8,0,8,0,48755
16113,3334,648,1593,960,65,68,274,138,113,18,2,93,25,7,3,0,4,18,0,0,18,136,112,14,31,67,24,0,0,0,0,24,0,0,24,48756
16114,2830,235,1105,967,370,153,97,77,68,9,7,52,9,6,3,0,3,3,0,3,0,20,20,10,0,10,0,0,0,0,0,0,0,0,0,48757
16115,2387,261,1080,782,200,64,153,78,53,35,0,18,25,25,25,0,0,0,0,0,0,75,57,15,15,27,18,18,0,11,7,0,0,0,0,48759
16116,822,121,430,196,60,15,53,30,25,3,0,22,5,5,2,0,3,0,0,0,0,23,19,5,11,3,4,4,4,0,0,0,0,0,0,48760
16117,865,146,425,276,16,2,27,5,5,0,0,5,0,0,0,0,0,0,0,0,0,22,22,0,0,22,0,0,0,0,0,0,0,0,0,48761
16118,897,111,310,358,76,42,22,15,15,4,0,11,0,0,0,0,0,0,0,0,0,7,4,0,0,4,3,0,0,0,0,3,0,3,0,48762
16119,4028,382,1608,1376,378,284,276,139,106,27,16,63,33,2,0,2,0,31,5,2,24,137,130,34,28,68,7,0,0,0,0,7,0,0,7,48763
16120,543,81,272,141,42,7,15,8,8,4,3,1,0,0,0,0,0,0,0,0,0,7,6,0,0,6,1,0,0,0,0,1,0,0,1,48765
16121,938,175,485,224,45,9,81,56,34,2,4,28,22,14,12,2,0,8,3,3,2,25,25,2,4,19,0,0,0,0,0,0,0,0,0,48766
16122,1446,121,562,532,170,61,103,67,59,15,15,29,8,5,3,0,2,3,0,0,3,36,34,11,3,20,2,2,0,2,0,0,0,0,0,48767
16123,6548,951,2749,2120,541,187,603,400,348,20,88,240,52,27,14,13,0,25,5,0,20,203,177,31,52,94,26,19,10,9,0,7,0,0,7,48768
16124,1431,280,719,358,48,26,111,60,52,10,3,39,8,8,1,7,0,0,0,0,0,51,46,16,0,30,5,2,0,0,2,3,0,0,3,48770
16125,7788,850,2723,2620,948,647,1479,713,703,180,57,466,10,10,8,2,0,0,0,0,0,766,690,264,61,365,76,51,43,6,2,25,0,0,25,48801
16126,1179,132,479,397,111,60,68,34,31,11,0,20,3,2,0,0,2,1,0,0,1,34,34,7,7,20,0,0,0,0,0,0,0,0,0,48806
16127,577,60,267,193,35,22,31,18,18,13,0,5,0,0,0,0,0,0,0,0,0,13,13,4,2,7,0,0,0,0,0,0,0,0,0,48807
16128,3865,130,956,1357,919,503,287,165,159,35,25,99,6,2,0,0,2,4,0,4,0,122,122,57,18,47,0,0,0,0,0,0,0,0,0,48808
16129,7227,1149,2800,2339,691,248,560,332,268,49,31,188,64,47,14,1,32,17,12,0,5,228,199,60,39,100,29,29,21,0,8,0,0,0,0,48809
16130,4069,444,1839,1381,232,173,244,121,96,33,10,53,25,15,0,0,15,10,2,0,8,123,101,36,7,58,22,22,14,8,0,0,0,0,0,48811
16131,14522,1112,5152,5769,1656,833,1093,570,489,96,54,339,81,62,33,15,14,19,6,0,13,523,417,101,37,279,106,90,14,38,38,16,3,11,2,48813
16132,1456,142,494,590,189,41,85,53,14,3,0,11,39,28,11,17,0,11,0,0,11,32,32,5,4,23,0,0,0,0,0,0,0,0,0,48815
16133,43,9,13,17,4,0,8,4,4,0,0,4,0,0,0,0,0,0,0,0,0,4,4,4,0,0,0,0,0,0,0,0,0,0,0,48816
16134,4451,441,1541,1815,398,256,395,214,148,16,21,111,66,42,11,31,0,24,3,10,11,181,177,20,62,95,4,0,0,0,0,4,0,4,0,48817
16135,1643,240,630,584,102,87,174,95,71,16,7,48,24,24,0,0,24,0,0,0,0,79,62,0,7,55,17,17,17,0,0,0,0,0,0,48818
16136,1740,170,545,669,207,149,175,111,74,4,26,44,37,33,30,3,0,4,4,0,0,64,62,2,1,59,2,2,0,0,2,0,0,0,0,48819
16137,11438,448,2326,4228,2869,1567,993,356,344,49,39,256,12,11,1,10,0,1,0,0,1,637,545,231,133,181,92,88,48,0,40,4,0,0,4,48820
16138,4116,232,1286,1584,690,324,362,217,156,45,10,101,61,27,27,0,0,34,0,0,34,145,145,72,25,48,0,0,0,0,0,0,0,0,0,48821
16139,2081,141,607,806,357,170,173,128,123,25,0,98,5,0,0,0,0,5,0,0,5,45,45,9,2,34,0,0,0,0,0,0,0,0,0,48822
16140,23348,902,2389,4862,6932,8263,3729,1962,1920,413,90,1417,42,26,10,4,12,16,7,0,9,1767,1694,757,86,851,73,17,9,0,8,56,0,20,36,48823
16141,52,0,29,0,4,19,10504,5018,5018,1021,191,3806,0,0,0,0,0,0,0,0,0,5486,5486,1719,173,3594,0,0,0,0,0,0,0,0,0,48825
16142,10292,681,3379,4181,1284,767,1052,568,452,85,11,356,116,74,19,35,20,42,21,21,0,484,388,158,20,210,96,70,30,21,19,26,0,0,26,48827
16143,2093,222,886,681,182,122,161,94,63,15,4,44,31,18,18,0,0,13,0,0,13,67,54,13,0,41,13,0,0,0,0,13,5,0,8,48829
16144,2314,341,998,798,126,51,234,143,109,38,4,67,34,21,5,2,14,13,0,0,13,91,83,17,10,56,8,5,3,2,0,3,0,3,0,48831
16145,911,95,393,311,91,21,22,21,21,0,0,21,0,0,0,0,0,0,0,0,0,1,1,0,0,1,0,0,0,0,0,0,0,0,0,48832
16146,1483,252,536,540,95,60,138,59,44,4,14,26,15,5,2,3,0,10,5,5,0,79,61,11,0,50,18,18,6,9,3,0,0,0,0,48834
16147,1585,137,666,513,189,80,144,78,71,22,2,47,7,7,7,0,0,0,0,0,0,66,62,23,7,32,4,4,4,0,0,0,0,0,0,48835
16148,8915,762,3277,3299,1044,533,811,503,484,87,49,348,19,19,7,12,0,0,0,0,0,308,237,60,26,151,71,38,19,7,12,33,0,0,33,48836
16149,12980,494,3231,5229,2429,1597,1028,424,343,178,14,151,81,78,68,10,0,3,0,3,0,604,538,255,10,273,66,52,12,12,28,14,14,0,0,48837
16150,11974,1200,4524,4050,1351,849,992,571,401,71,58,272,170,53,34,12,7,117,0,64,53,421,359,174,9,176,62,14,0,14,0,48,6,22,20,48838
16151,8642,330,1174,2568,2487,2083,709,328,259,78,17,164,69,54,8,0,46,15,0,15,0,381,297,172,0,125,84,76,20,0,56,8,8,0,0,48840
16152,654,86,333,184,46,5,46,24,21,3,0,18,3,0,0,0,0,3,0,0,3,22,20,5,5,10,2,0,0,0,0,2,0,0,2,48841
16153,14146,852,3331,5575,2880,1508,1066,409,344,46,82,216,65,46,13,26,7,19,0,19,0,657,629,208,61,360,28,28,21,7,0,0,0,0,0,48842
16154,28604,1599,7333,10551,6304,2817,2287,1232,1035,246,123,666,197,156,63,79,14,41,0,0,41,1055,860,332,33,495,195,186,102,22,62,9,0,0,9,48843
16155,634,179,253,173,20,9,54,21,16,4,4,8,5,3,0,3,0,2,0,0,2,33,26,5,0,21,7,2,2,0,0,5,5,0,0,48845
16156,13761,2059,5892,4446,935,429,1080,509,368,114,58,196,141,77,41,0,36,64,2,0,62,571,438,216,51,171,133,58,48,10,0,75,0,16,59,48846
16157,4008,346,1706,1332,428,196,295,154,140,21,8,111,14,10,6,1,3,4,3,0,1,141,89,43,0,46,52,37,21,16,0,15,6,3,6,48847
16158,5179,350,1524,2126,795,384,509,202,179,37,3,139,23,23,2,19,2,0,0,0,0,307,242,78,4,160,65,65,20,0,45,0,0,0,0,48848
16159,3880,358,1569,1337,486,130,340,173,137,39,18,80,36,31,31,0,0,5,5,0,0,167,159,31,7,121,8,8,8,0,0,0,0,0,0,48849
16160,2775,449,1171,829,241,85,218,115,89,12,9,68,26,23,6,8,9,3,0,3,0,103,61,5,0,56,42,15,4,11,0,27,0,20,7,48850
16161,1599,178,661,624,87,49,142,65,55,16,2,37,10,10,2,0,8,0,0,0,0,77,64,3,13,48,13,13,7,3,3,0,0,0,0,48851
16162,59,7,19,23,8,2,1,1,0,0,0,0,1,1,1,0,0,0,0,0,0,0,0,0,0,0,0,0,0,0,0,0,0,0,0,48852
16163,462,39,232,148,37,6,32,21,21,4,4,13,0,0,0,0,0,0,0,0,0,11,11,6,0,5,0,0,0,0,0,0,0,0,0,48853
16164,12879,895,3340,5086,2064,1494,640,286,237,68,25,144,49,42,13,7,22,7,0,0,7,354,293,44,20,229,61,47,24,23,0,14,0,0,14,48854
16165,9566,539,2936,3636,1610,845,828,429,376,125,26,225,53,44,27,17,0,9,4,0,5,399,380,115,58,207,19,19,0,19,0,0,0,0,0,48855
16166,589,132,232,186,37,2,75,28,21,7,0,14,7,0,0,0,0,7,4,0,3,47,47,2,0,45,0,0,0,0,0,0,0,0,0,48856
16167,1793,165,777,642,140,69,145,57,26,0,0,26,31,24,6,18,0,7,0,0,7,88,48,20,6,22,40,40,40,0,0,0,0,0,0,48857
16168,21815,1919,6035,6940,3655,3266,6970,2978,2811,704,349,1758,167,129,46,50,33,38,3,3,32,3992,3820,1076,552,2192,172,149,87,4,58,23,0,0,23,48858
16169,869,71,432,326,38,2,52,9,9,2,0,7,0,0,0,0,0,0,0,0,0,43,3,0,0,3,40,38,2,36,0,2,0,0,2,48860
16170,1014,96,413,372,81,52,125,42,32,2,0,30,10,7,7,0,0,3,3,0,0,83,81,16,0,65,2,0,0,0,0,2,2,0,0,48861
16171,13710,240,1223,2424,4594,5229,876,373,337,70,20,247,36,9,9,0,0,27,0,0,27,503,490,130,11,349,13,9,9,0,0,4,4,0,0,48864
16172,1210,191,541,369,90,19,132,79,71,0,17,54,8,8,4,4,0,0,0,0,0,53,43,16,0,27,10,10,5,5,0,0,0,0,0,48865
16173,3363,396,1438,1141,237,151,359,198,196,22,31,143,2,2,0,2,0,0,0,0,0,161,146,32,5,109,15,10,6,0,4,5,3,0,2,48866
16174,18464,1696,7103,6908,1714,1043,1638,862,696,214,60,422,166,108,63,42,3,58,18,34,6,776,667,172,79,416,109,78,29,35,14,31,13,18,0,48867
16175,123,11,97,8,7,0,0,0,0,0,0,0,0,0,0,0,0,0,0,0,0,0,0,0,0,0,0,0,0,0,0,0,0,0,0,48870
16176,1468,181,548,550,130,59,51,29,27,14,5,8,2,2,0,2,0,0,0,0,0,22,15,0,1,14,7,2,0,2,0,5,0,0,5,48871
16177,5146,529,1894,1908,486,329,461,261,179,42,14,123,82,52,24,28,0,30,0,0,30,200,170,52,0,118,30,0,0,0,0,30,0,0,30,48872
16178,1126,53,562,330,135,46,63,26,24,4,17,3,2,2,0,2,0,0,0,0,0,37,36,0,0,36,1,1,1,0,0,0,0,0,0,48873
16179,148,3,41,76,28,0,12,3,3,0,0,3,0,0,0,0,0,0,0,0,0,9,6,4,0,2,3,3,0,0,3,0,0,0,0,48874
16180,6822,327,2095,2855,1006,539,577,306,295,114,40,141,11,10,10,0,0,1,0,0,1,271,232,125,11,96,39,39,13,26,0,0,0,0,0,48875
16181,2599,187,753,1207,342,110,251,172,134,45,8,81,38,38,33,5,0,0,0,0,0,79,59,15,0,44,20,12,5,0,7,8,0,0,8,48876
16182,1734,294,737,606,66,31,159,98,93,0,29,64,5,0,0,0,0,5,2,0,3,61,49,5,6,38,12,3,3,0,0,9,3,2,4,48877
16183,1056,117,429,358,86,66,78,30,24,8,0,16,6,0,0,0,0,6,0,0,6,48,48,28,0,20,0,0,0,0,0,0,0,0,0,48878
16184,12282,1061,4165,4648,1490,918,1077,596,504,151,12,341,92,50,14,2,34,42,1,5,36,481,446,106,40,300,35,26,24,0,2,9,0,0,9,48879
16185,7624,1247,3380,2223,492,282,387,287,182,39,31,112,105,47,15,2,30,58,1,0,57,100,95,26,0,69,5,5,0,0,5,0,0,0,0,48880
16186,3373,299,1161,1169,525,219,241,158,144,17,2,125,14,11,8,0,3,3,0,0,3,83,66,12,0,54,17,11,11,0,0,6,0,6,0,48881
16187,4904,512,1907,1660,509,316,394,154,140,12,6,122,14,12,8,0,4,2,2,0,0,240,192,48,14,130,48,36,10,14,12,12,0,0,12,48883
16188,3136,382,1159,1223,236,136,274,167,146,6,10,130,21,11,5,3,3,10,0,5,5,107,86,49,7,30,21,19,17,0,2,2,2,0,0,48884
16189,615,115,217,186,78,19,67,37,37,0,8,29,0,0,0,0,0,0,0,0,0,30,13,7,0,6,17,17,0,0,17,0,0,0,0,48885
16190,1559,161,635,592,107,64,120,80,78,0,5,73,2,2,0,0,2,0,0,0,0,40,40,21,5,14,0,0,0,0,0,0,0,0,0,48886
16191,4386,560,1720,1601,271,234,314,195,147,15,39,93,48,13,11,0,2,35,18,11,6,119,85,23,5,57,34,20,10,7,3,14,4,4,6,48888
16192,920,116,419,321,53,11,88,31,25,4,7,14,6,1,1,0,0,5,0,5,0,57,53,2,1,50,4,0,0,0,0,4,4,0,0,48889
16193,1375,139,533,554,99,50,50,28,28,3,0,25,0,0,0,0,0,0,0,0,0,22,20,2,10,8,2,0,0,0,0,2,2,0,0,48890
16194,2147,204,1047,627,192,77,211,112,96,32,2,62,16,13,4,9,0,3,0,0,3,99,99,21,0,78,0,0,0,0,0,0,0,0,0,48891
16195,3123,381,1153,1108,337,144,220,119,103,21,31,51,16,16,0,16,0,0,0,0,0,101,72,32,0,40,29,29,8,11,10,0,0,0,0,48892
16196,3732,376,1567,1166,429,194,277,98,91,28,7,56,7,4,4,0,0,3,3,0,0,179,160,39,34,87,19,7,0,7,0,12,0,8,4,48893
16197,1339,92,563,474,141,69,98,45,45,25,0,20,0,0,0,0,0,0,0,0,0,53,50,33,4,13,3,3,3,0,0,0,0,0,0,48894
16198,7627,329,1685,2415,1671,1527,592,314,294,96,21,177,20,20,20,0,0,0,0,0,0,278,257,55,10,192,21,21,3,0,18,0,0,0,0,48895
16199,96,21,43,32,0,0,5,5,5,0,0,5,0,0,0,0,0,0,0,0,0,0,0,0,0,0,0,0,0,0,0,0,0,0,0,48896
16200,994,131,418,318,81,46,114,57,46,18,0,28,11,0,0,0,0,11,11,0,0,57,35,15,0,20,22,4,0,4,0,18,0,0,18,48897
16201,17054,2593,4863,5767,2600,1231,1218,621,439,78,58,303,182,102,22,41,39,80,46,27,7,597,473,144,63,266,124,60,55,5,0,64,0,11,53,48906
16202,22450,2726,5837,7911,3572,2404,1488,733,637,156,100,381,96,51,6,29,16,45,9,5,31,755,625,305,93,227,130,61,54,7,0,69,0,7,62,48910
16203,24355,3304,6519,9509,3411,1612,2174,994,834,72,117,645,160,62,32,30,0,98,14,30,54,1180,920,333,279,308,260,103,50,44,9,157,66,70,21,48911
16204,11131,1262,1721,4027,2589,1532,697,382,337,90,20,227,45,16,0,9,7,29,0,29,0,315,278,106,46,126,37,31,31,0,0,6,0,6,0,48912
16205,5415,637,1225,2222,791,540,424,148,134,18,8,108,14,0,0,0,0,14,13,0,1,276,220,65,11,144,56,23,5,0,18,33,0,0,33,48915
16206,23037,1279,4971,8932,5119,2736,1305,789,680,165,20,495,109,86,21,50,15,23,9,0,14,516,508,214,19,275,8,8,0,0,8,0,0,0,0,48917
16207,0,0,0,0,0,0,0,0,0,0,0,0,0,0,0,0,0,0,0,0,0,0,0,0,0,0,0,0,0,0,0,0,0,0,0,48921
16208,1935,296,367,501,540,231,68,16,12,0,12,0,4,4,0,0,4,0,0,0,0,52,9,4,5,0,43,0,0,0,0,43,0,0,43,48933
16209,13958,1570,3644,5551,2198,995,931,585,496,123,128,245,89,61,42,0,19,28,0,4,24,346,258,56,12,190,88,54,39,0,15,34,0,34,0,49001
16210,12685,810,3179,4667,2646,1383,844,418,371,59,98,214,47,31,17,0,14,16,0,0,16,426,389,113,10,266,37,10,10,0,0,27,11,16,0,49002
16211,10465,1244,2929,3736,1832,724,679,265,199,30,40,129,66,43,0,31,12,23,0,19,4,414,346,83,51,212,68,68,3,13,52,0,0,0,0,49004
16212,11292,722,1911,3744,2868,2047,3977,2087,1941,684,183,1074,146,79,36,34,9,67,24,0,43,1890,1747,515,143,1089,143,143,36,98,9,0,0,0,0,49006
16213,5873,979,1549,2232,668,445,467,291,197,83,40,74,94,34,24,10,0,60,0,11,49,176,153,14,63,76,23,10,10,0,0,13,0,5,8,49007
16214,9889,552,1333,2857,2744,2403,1943,921,888,225,94,569,33,25,20,5,0,8,0,0,8,1022,1016,270,81,665,6,0,0,0,0,6,0,0,6,49008
16215,27091,1213,5774,7900,6798,5406,2324,1000,963,265,112,586,37,37,13,24,0,0,0,0,0,1324,1240,513,179,548,84,60,0,0,60,24,0,8,16,49009
16216,12090,1135,5101,3788,1329,737,927,454,331,122,6,203,123,83,61,17,5,40,0,0,40,473,444,84,30,330,29,10,7,0,3,19,3,0,16,49010
16217,1488,147,552,586,149,54,93,53,51,13,4,34,2,2,2,0,0,0,0,0,0,40,32,0,5,27,8,3,3,0,0,5,0,0,5,49011
16218,2441,163,822,675,559,222,134,58,56,0,3,53,2,2,2,0,0,0,0,0,0,76,72,18,30,24,4,4,4,0,0,0,0,0,0,49012
16219,3242,654,1188,1011,261,128,309,159,142,54,13,75,17,14,0,0,14,3,0,0,3,150,119,30,11,78,31,19,3,16,0,12,2,0,10,49013
16220,14063,1920,4831,5178,1529,605,1071,571,436,107,9,320,135,61,14,47,0,74,0,6,68,500,446,98,112,236,54,22,17,5,0,32,3,10,19,49014
16221,17798,1349,4874,6125,3426,2024,1610,910,787,176,127,484,123,93,32,31,30,30,0,11,19,700,593,275,33,285,107,86,23,0,63,21,0,0,21,49015
16222,14718,1474,4727,5825,1595,1097,1095,664,612,110,18,484,52,52,34,18,0,0,0,0,0,431,407,67,13,327,24,9,9,0,0,15,0,15,0,49017
16223,4370,618,1672,1439,435,206,299,174,111,5,23,83,63,48,44,0,4,15,0,8,7,125,115,44,4,67,10,4,4,0,0,6,0,0,6,49021
16224,20093,4352,7136,6262,1382,961,1941,953,681,74,89,518,272,131,0,117,14,141,13,23,105,988,777,132,60,585,211,128,70,0,58,83,24,13,46,49022
16225,18608,637,3770,5982,5030,3189,1278,696,591,88,111,392,105,60,34,7,19,45,0,37,8,582,516,216,38,262,66,66,48,18,0,0,0,0,0,49024
16226,1729,228,859,461,134,47,87,80,76,43,0,33,4,0,0,0,0,4,0,0,4,7,7,0,2,5,0,0,0,0,0,0,0,0,0,49026
16227,75,8,41,21,3,2,6,3,1,0,0,1,2,2,0,0,2,0,0,0,0,3,3,2,0,1,0,0,0,0,0,0,0,0,0,49027
16228,4083,686,1767,1146,368,116,410,256,203,37,17,149,53,33,28,0,5,20,0,14,6,154,105,15,0,90,49,42,32,0,10,7,0,3,4,49028
16229,1153,113,561,339,125,15,147,34,34,21,0,13,0,0,0,0,0,0,0,0,0,113,88,0,12,76,25,25,0,6,19,0,0,0,0,49029
16230,1620,323,768,446,66,17,53,16,14,2,0,12,2,0,0,0,0,2,2,0,0,37,35,3,5,27,2,2,0,0,2,0,0,0,0,49030
16231,5539,749,2166,1805,579,240,378,176,159,50,0,109,17,3,3,0,0,14,4,0,10,202,172,18,4,150,30,30,30,0,0,0,0,0,0,49031
16232,2396,451,754,905,227,59,250,126,78,7,15,56,48,22,17,5,0,26,20,0,6,124,116,18,15,83,8,0,0,0,0,8,0,0,8,49032
16233,1358,124,541,506,96,91,80,61,61,0,0,61,0,0,0,0,0,0,0,0,0,19,19,12,0,7,0,0,0,0,0,0,0,0,0,49033
16234,1470,69,530,544,239,88,130,74,70,4,7,59,4,4,0,0,4,0,0,0,0,56,50,20,6,24,6,6,6,0,0,0,0,0,0,49034
16235,16759,2028,6629,5628,1533,941,1079,495,374,125,74,175,121,76,63,0,13,45,0,30,15,584,523,214,64,245,61,61,33,12,16,0,0,0,0,49036
16236,14565,2462,5725,4976,992,410,1388,836,588,163,97,328,248,124,86,31,7,124,23,22,79,552,433,126,65,242,119,93,40,44,9,26,0,0,26,49037
16237,6291,750,2475,2026,708,332,736,351,261,35,55,171,90,80,29,43,8,10,0,8,2,385,325,116,22,187,60,19,19,0,0,41,0,0,41,49038
16238,2368,432,890,789,171,86,144,102,102,0,20,82,0,0,0,0,0,0,0,0,0,42,39,18,5,16,3,0,0,0,0,3,0,3,0,49040
16239,3139,442,1420,994,203,80,360,239,233,24,18,191,6,6,0,0,6,0,0,0,0,121,113,41,13,59,8,5,2,3,0,3,0,0,3,49042
16240,1692,628,548,402,76,38,240,129,114,33,0,81,15,6,0,6,0,9,9,0,0,111,103,27,0,76,8,4,4,0,0,4,0,0,4,49043
16241,3803,731,1467,1175,308,122,474,248,223,10,74,139,25,25,13,12,0,0,0,0,0,226,203,54,8,141,23,17,0,9,8,6,0,6,0,49045
16242,5370,509,2265,1721,606,269,338,80,80,10,0,70,0,0,0,0,0,0,0,0,0,258,228,64,0,164,30,8,0,8,0,22,0,0,22,49046
16243,9954,1309,3689,3618,896,442,839,513,411,74,65,272,102,33,8,19,6,69,19,0,50,326,288,88,27,173,38,0,0,0,0,38,29,0,9,49047
16244,16299,2068,5480,5595,1923,1233,1457,661,521,69,43,409,140,82,38,15,29,58,0,0,58,796,607,242,87,278,189,116,0,78,38,73,15,32,26,49048
16245,982,127,353,338,98,66,52,31,13,3,0,10,18,4,4,0,0,14,0,14,0,21,21,0,0,21,0,0,0,0,0,0,0,0,0,49050
16246,1982,76,734,710,328,134,95,36,36,0,0,36,0,0,0,0,0,0,0,0,0,59,59,12,0,47,0,0,0,0,0,0,0,0,0,49051
16247,744,72,376,220,56,20,20,9,8,0,0,8,1,1,0,0,1,0,0,0,0,11,11,0,0,11,0,0,0,0,0,0,0,0,0,49052
16248,4691,485,1454,1634,723,395,241,160,121,56,7,58,39,27,6,21,0,12,0,0,12,81,68,17,7,44,13,9,0,0,9,4,4,0,0,49053
16249,4419,489,1627,1588,468,247,345,204,139,23,6,110,65,56,52,4,0,9,0,0,9,141,113,50,12,51,28,6,0,6,0,22,5,0,17,49055
16250,2720,643,1191,654,139,93,244,151,103,4,3,96,48,48,48,0,0,0,0,0,0,93,72,0,0,72,21,0,0,0,0,21,4,0,17,49056
16251,4336,1237,1607,1179,186,127,412,297,269,32,11,226,28,28,22,0,6,0,0,0,0,115,96,33,0,63,19,8,8,0,0,11,0,8,3,49057
16252,12969,1271,5280,4455,1098,865,1002,518,394,111,16,267,124,87,57,6,24,37,25,0,12,484,411,90,104,217,73,67,20,22,25,6,0,6,0,49058
16253,1194,86,285,351,271,201,38,26,26,0,0,26,0,0,0,0,0,0,0,0,0,12,12,0,1,11,0,0,0,0,0,0,0,0,0,49060
16254,1001,126,494,265,82,34,55,11,11,0,0,11,0,0,0,0,0,0,0,0,0,44,44,3,0,41,0,0,0,0,0,0,0,0,0,49061
16255,2495,340,941,817,231,166,234,94,94,20,0,74,0,0,0,0,0,0,0,0,0,140,132,30,12,90,8,3,3,0,0,5,0,0,5,49064
16256,4358,431,1559,1475,461,432,534,306,242,28,13,201,64,64,23,16,25,0,0,0,0,228,185,48,20,117,43,28,19,0,9,15,9,0,6,49065
16257,404,110,164,96,15,19,24,5,5,3,0,2,0,0,0,0,0,0,0,0,0,19,19,3,4,12,0,0,0,0,0,0,0,0,0,49066
16258,3083,307,1307,981,328,160,243,113,109,13,0,96,4,4,4,0,0,0,0,0,0,130,91,40,8,43,39,39,35,0,4,0,0,0,0,49067
16259,10309,610,2991,3702,1858,1148,689,333,276,66,58,152,57,57,40,10,7,0,0,0,0,356,347,118,33,196,9,9,5,2,2,0,0,0,0,49068
16260,1535,131,674,508,165,57,87,45,40,13,2,25,5,5,0,0,5,0,0,0,0,42,42,13,7,22,0,0,0,0,0,0,0,0,0,49070
16261,5902,188,1577,2212,1205,720,391,227,215,114,18,83,12,12,9,0,3,0,0,0,0,164,164,78,20,66,0,0,0,0,0,0,0,0,0,49071
16262,1953,253,780,641,218,61,200,106,77,4,6,67,29,17,15,2,0,12,6,0,6,94,87,9,9,69,7,7,7,0,0,0,0,0,0,49072
16263,3063,339,1247,1114,269,94,314,194,145,26,18,101,49,18,4,11,3,31,0,15,16,120,97,16,3,78,23,17,17,0,0,6,6,0,0,49073
16264,184,0,61,17,6,100,9,0,0,0,0,0,0,0,0,0,0,0,0,0,0,9,9,9,0,0,0,0,0,0,0,0,0,0,0,49074
16265,73,52,4,17,0,0,0,0,0,0,0,0,0,0,0,0,0,0,0,0,0,0,0,0,0,0,0,0,0,0,0,0,0,0,0,49075
16266,2524,201,953,830,385,155,539,307,285,66,62,157,22,22,18,4,0,0,0,0,0,232,232,85,17,130,0,0,0,0,0,0,0,0,0,49076
16267,6282,439,2707,2169,613,354,495,229,204,46,35,123,25,25,13,12,0,0,0,0,0,266,248,109,22,117,18,18,18,0,0,0,0,0,0,49078
16268,9287,1049,2957,3093,1504,684,700,290,199,60,15,124,91,85,12,49,24,6,0,0,6,410,348,83,0,265,62,13,0,0,13,49,0,0,49,49079
16269,10483,956,3549,3457,1653,868,1054,661,562,57,65,440,99,65,0,0,65,34,9,17,8,393,331,73,74,184,62,43,18,9,16,19,10,0,9,49080
16270,4474,706,1931,1254,382,201,321,168,134,52,0,82,34,0,0,0,0,34,12,0,22,153,86,17,8,61,67,20,20,0,0,47,5,0,42,49082
16271,4920,239,698,1561,1462,960,401,161,150,38,16,96,11,11,11,0,0,0,0,0,0,240,215,32,11,172,25,25,3,22,0,0,0,0,0,49083
16272,5,3,0,2,0,0,0,0,0,0,0,0,0,0,0,0,0,0,0,0,0,0,0,0,0,0,0,0,0,0,0,0,0,0,0,49084
16273,16708,808,3557,5559,4067,2717,1133,522,449,158,34,257,73,56,16,9,31,17,0,7,10,611,569,135,48,386,42,42,25,17,0,0,0,0,0,49085
16274,4128,204,1224,1537,837,326,405,197,161,29,8,124,36,36,33,0,3,0,0,0,0,208,191,41,37,113,17,17,6,8,3,0,0,0,0,49087
16275,2457,168,809,915,434,131,183,97,92,52,3,37,5,5,5,0,0,0,0,0,0,86,75,15,21,39,11,11,11,0,0,0,0,0,0,49088
16276,1094,186,447,370,62,29,124,71,64,3,27,34,7,7,2,5,0,0,0,0,0,53,52,12,18,22,1,1,1,0,0,0,0,0,0,49089
16277,9658,1168,3205,3260,1082,943,718,365,302,59,9,234,63,11,11,0,0,52,17,25,10,353,324,140,23,161,29,0,0,0,0,29,5,0,24,49090
16278,12412,2175,4391,3580,1392,874,931,480,431,76,99,256,49,40,26,3,11,9,9,0,0,451,394,124,9,261,57,38,13,21,4,19,0,19,0,49091
16279,1445,195,626,449,107,68,112,63,50,9,3,38,13,13,10,0,3,0,0,0,0,49,39,16,6,17,10,10,10,0,0,0,0,0,0,49092
16280,12552,1523,4794,4108,1393,734,863,428,360,76,17,267,68,51,29,22,0,17,5,0,12,435,362,80,70,212,73,70,55,5,10,3,0,3,0,49093
16281,2815,315,1189,996,238,77,181,83,80,9,0,71,3,3,3,0,0,0,0,0,0,98,83,10,0,73,15,15,12,0,3,0,0,0,0,49094
16282,1514,211,537,486,194,86,120,57,57,2,6,49,0,0,0,0,0,0,0,0,0,63,63,5,0,58,0,0,0,0,0,0,0,0,0,49095
16283,2200,213,960,771,186,70,151,78,50,0,0,50,28,28,24,4,0,0,0,0,0,73,39,5,6,28,34,34,8,8,18,0,0,0,0,49096
16284,6969,346,2628,2590,966,439,446,272,226,63,15,148,46,32,28,4,0,14,0,0,14,174,150,62,0,88,24,14,8,6,0,10,10,0,0,49097
16285,4170,807,1507,1208,487,161,415,311,284,23,4,257,27,6,3,3,0,21,0,0,21,104,66,26,4,36,38,36,27,2,7,2,0,0,2,49098
16286,3890,649,1842,1067,219,113,506,317,274,10,27,237,43,43,5,38,0,0,0,0,0,189,134,15,4,115,55,17,7,6,4,38,0,0,38,49099
16287,2159,241,721,759,317,121,172,54,45,13,10,22,9,8,8,0,0,1,0,1,0,118,118,76,5,37,0,0,0,0,0,0,0,0,0,49101
16288,1124,150,354,384,103,133,114,56,56,11,0,45,0,0,0,0,0,0,0,0,0,58,58,9,0,49,0,0,0,0,0,0,0,0,0,49102
16289,7734,509,1310,2238,1713,1964,520,211,205,40,14,151,6,6,0,0,6,0,0,0,0,309,300,154,10,136,9,9,9,0,0,0,0,0,0,49103
16290,31,0,0,0,21,10,245,91,91,60,0,31,0,0,0,0,0,0,0,0,0,154,154,69,21,64,0,0,0,0,0,0,0,0,0,49104
16291,2988,206,1083,1025,380,294,196,91,81,48,10,23,10,0,0,0,0,10,6,4,0,105,96,26,3,67,9,9,0,9,0,0,0,0,0,49106
16292,7257,853,2730,2384,802,488,488,289,238,36,19,183,51,19,10,0,9,32,0,0,32,199,147,42,0,105,52,23,15,0,8,29,1,26,2,49107
16293,2419,358,924,792,198,147,289,148,135,65,14,56,13,8,8,0,0,5,0,0,5,141,102,35,2,65,39,34,0,3,31,5,3,0,2,49111
16294,6723,826,2400,2196,872,429,679,299,283,111,6,166,16,15,15,0,0,1,1,0,0,380,324,80,6,238,56,54,37,17,0,2,2,0,0,49112
16295,1322,120,625,450,63,64,77,45,28,0,0,28,17,13,13,0,0,4,0,4,0,32,27,7,8,12,5,5,5,0,0,0,0,0,0,49113
16296,200,0,24,49,50,77,0,0,0,0,0,0,0,0,0,0,0,0,0,0,0,0,0,0,0,0,0,0,0,0,0,0,0,0,0,49115
16297,388,11,98,69,89,121,0,0,0,0,0,0,0,0,0,0,0,0,0,0,0,0,0,0,0,0,0,0,0,0,0,0,0,0,0,49116
16298,2842,315,849,779,484,415,145,86,77,12,3,62,9,9,0,9,0,0,0,0,0,59,59,5,6,48,0,0,0,0,0,0,0,0,0,49117
16299,51,0,30,15,6,0,0,0,0,0,0,0,0,0,0,0,0,0,0,0,0,0,0,0,0,0,0,0,0,0,0,0,0,0,0,49119
16300,25408,3818,9218,8126,2762,1484,1785,995,871,173,85,613,124,106,69,37,0,18,0,18,0,790,726,166,44,516,64,38,6,10,22,26,7,0,19,49120
16301,1552,77,519,553,272,131,62,24,15,0,0,15,9,9,0,0,9,0,0,0,0,38,15,0,0,15,23,9,0,0,9,14,12,0,2,49125
16302,1151,195,392,410,93,61,62,24,24,13,0,11,0,0,0,0,0,0,0,0,0,38,23,0,15,8,15,15,0,0,15,0,0,0,0,49126
16303,7820,564,1970,2380,1874,1032,445,246,234,38,6,190,12,4,4,0,0,8,5,0,3,199,195,73,13,109,4,4,3,0,1,0,0,0,0,49127
16304,2909,311,1056,960,362,220,232,102,89,12,3,74,13,3,3,0,0,10,10,0,0,130,117,80,0,37,13,13,3,4,6,0,0,0,0,49128
16305,309,6,81,65,100,57,4,0,0,0,0,0,0,0,0,0,0,0,0,0,0,4,4,0,0,4,0,0,0,0,0,0,0,0,0,49129
16306,1499,182,644,463,181,29,146,92,92,22,0,70,0,0,0,0,0,0,0,0,0,54,54,0,0,54,0,0,0,0,0,0,0,0,0,49130
16307,31309,3373,10720,11152,4245,1819,2209,1175,940,277,79,584,235,70,21,0,49,165,46,60,59,1034,936,286,130,520,98,72,64,0,8,26,0,0,26,49201
16308,13975,2169,5064,5298,1093,351,1181,508,356,87,10,259,152,111,73,0,38,41,5,0,36,673,425,108,43,274,248,142,115,27,0,106,64,13,29,49202
16309,25207,3016,7643,9179,3483,1886,1834,1046,916,191,74,651,130,67,13,48,6,63,0,50,13,788,681,122,152,407,107,28,16,6,6,79,9,19,51,49203
16310,1789,166,771,584,221,47,164,48,34,15,3,16,14,14,14,0,0,0,0,0,0,116,114,69,0,45,2,2,0,2,0,0,0,0,0,49220
16311,27167,3957,10349,7743,3219,1899,2542,1503,1306,514,136,656,197,165,98,6,61,32,0,14,18,1039,939,338,126,475,100,60,19,14,27,40,0,0,40,49221
16312,9174,1286,3585,2754,940,609,1183,583,523,75,42,406,60,31,24,7,0,29,0,0,29,600,524,212,29,283,76,68,33,0,35,8,0,7,1,49224
16313,810,91,361,291,53,14,56,33,20,8,0,12,13,11,9,2,0,2,0,0,2,23,23,9,3,11,0,0,0,0,0,0,0,0,0,49227
16314,3905,224,1463,1396,625,197,289,145,117,13,8,96,28,11,11,0,0,17,8,0,9,144,144,16,27,101,0,0,0,0,0,0,0,0,0,49228
16315,2172,144,668,935,281,144,135,65,61,10,0,51,4,0,0,0,0,4,0,0,4,70,66,31,11,24,4,4,4,0,0,0,0,0,0,49229
16316,7415,546,2544,2752,1059,514,465,325,215,62,25,128,110,110,39,0,71,0,0,0,0,140,140,28,35,77,0,0,0,0,0,0,0,0,0,49230
16317,1794,385,757,455,110,87,152,102,68,13,12,43,34,8,2,0,6,26,18,0,8,50,42,7,1,34,8,2,0,0,2,6,2,0,4,49232
16318,1955,154,675,650,249,227,58,44,43,5,5,33,1,1,1,0,0,0,0,0,0,14,11,0,0,11,3,3,0,3,0,0,0,0,0,49233
16319,1875,93,723,587,330,142,113,101,101,12,0,89,0,0,0,0,0,0,0,0,0,12,12,12,0,0,0,0,0,0,0,0,0,0,0,49234
16320,1512,222,601,454,133,102,123,59,43,6,1,36,16,14,14,0,0,2,0,0,2,64,51,7,4,40,13,13,5,8,0,0,0,0,0,49235
16321,3133,196,1129,1160,500,148,305,196,174,20,3,151,22,10,8,2,0,12,8,3,1,109,106,22,0,84,3,3,3,0,0,0,0,0,0,49236
16322,1899,123,603,760,236,177,125,65,46,14,1,31,19,3,3,0,0,16,3,13,0,60,60,19,0,41,0,0,0,0,0,0,0,0,0,49237
16323,1248,100,519,391,149,89,120,49,38,3,3,32,11,11,10,1,0,0,0,0,0,71,66,30,0,36,5,2,0,2,0,3,0,0,3,49238
16324,6396,345,1907,2631,938,575,435,261,238,32,17,189,23,20,10,10,0,3,0,3,0,174,167,84,0,83,7,3,3,0,0,4,0,4,0,49240
16325,1655,246,637,621,112,39,206,121,76,5,0,71,45,14,14,0,0,31,28,0,3,85,80,0,0,80,5,1,0,1,0,4,0,0,4,49241
16326,9469,1118,3702,2980,895,774,1288,495,437,78,14,345,58,43,43,0,0,15,0,0,15,793,727,343,50,334,66,35,23,9,3,31,0,7,24,49242
16327,3105,427,1431,937,232,78,259,136,119,23,7,89,17,10,0,3,7,7,0,0,7,123,104,28,7,69,19,9,0,0,9,10,2,0,8,49245
16328,2446,100,841,896,397,212,221,91,74,9,0,65,17,0,0,0,0,17,0,0,17,130,114,30,0,84,16,16,0,0,16,0,0,0,0,49246
16329,3834,529,1691,1154,318,142,330,184,162,29,11,122,22,10,10,0,0,12,0,12,0,146,134,4,35,95,12,10,7,2,1,2,2,0,0,49247
16330,568,80,231,190,41,26,48,20,20,0,2,18,0,0,0,0,0,0,0,0,0,28,21,4,3,14,7,7,4,0,3,0,0,0,0,49248
16331,2611,195,1004,724,375,313,115,49,49,22,11,16,0,0,0,0,0,0,0,0,0,66,45,11,11,23,21,21,21,0,0,0,0,0,0,49249
16332,3991,447,1713,1230,350,251,394,270,263,68,0,195,7,3,3,0,0,4,0,0,4,124,121,26,0,95,3,3,3,0,0,0,0,0,0,49250
16333,4291,375,1648,1623,444,201,463,252,235,17,10,208,17,13,3,0,10,4,0,0,4,211,178,30,22,126,33,14,0,14,0,19,5,0,14,49251
16334,1754,217,749,568,158,62,119,67,54,13,16,25,13,12,12,0,0,1,1,0,0,52,36,7,2,27,16,16,11,0,5,0,0,0,0,49252
16335,2534,244,734,893,436,227,94,94,94,42,7,45,0,0,0,0,0,0,0,0,0,0,0,0,0,0,0,0,0,0,0,0,0,0,0,49253
16336,2350,401,936,551,343,119,151,45,45,13,3,29,0,0,0,0,0,0,0,0,0,106,106,26,21,59,0,0,0,0,0,0,0,0,0,49254
16337,1115,276,521,255,49,14,103,69,45,10,0,35,24,5,3,0,2,19,10,0,9,34,24,0,0,24,10,0,0,0,0,10,10,0,0,49255
16338,2502,369,1063,771,219,80,253,127,107,26,14,67,20,5,0,5,0,15,15,0,0,126,114,0,9,105,12,9,6,3,0,3,0,0,3,49256
16339,1575,179,702,475,132,87,180,80,26,26,0,0,54,54,17,0,37,0,0,0,0,100,100,16,0,84,0,0,0,0,0,0,0,0,0,49259
16340,244,10,98,122,14,0,54,9,9,0,0,9,0,0,0,0,0,0,0,0,0,45,45,0,0,45,0,0,0,0,0,0,0,0,0,49261
16341,875,74,405,294,77,25,83,60,53,2,2,49,7,7,0,7,0,0,0,0,0,23,20,1,0,19,3,1,0,1,0,2,2,0,0,49262
16342,11,0,0,11,0,0,0,0,0,0,0,0,0,0,0,0,0,0,0,0,0,0,0,0,0,0,0,0,0,0,0,0,0,0,0,49263
16343,1501,127,607,621,116,30,122,45,45,8,0,37,0,0,0,0,0,0,0,0,0,77,59,0,32,27,18,11,11,0,0,7,0,0,7,49264
16344,3531,209,1223,1376,437,286,330,176,171,32,5,134,5,5,0,5,0,0,0,0,0,154,152,33,0,119,2,2,2,0,0,0,0,0,0,49265
16345,2215,309,861,798,147,100,155,82,82,17,0,65,0,0,0,0,0,0,0,0,0,73,70,18,7,45,3,1,1,0,0,2,0,0,2,49266
16346,2947,129,1322,882,411,203,195,53,44,21,7,16,9,9,9,0,0,0,0,0,0,142,114,64,0,50,28,28,28,0,0,0,0,0,0,49267
16347,641,50,305,196,49,41,25,8,6,1,0,5,2,2,2,0,0,0,0,0,0,17,17,12,3,2,0,0,0,0,0,0,0,0,0,49268
16348,4009,434,1347,1652,377,199,444,233,224,87,0,137,9,9,4,5,0,0,0,0,0,211,174,49,26,99,37,5,5,0,0,32,0,22,10,49269
16349,4113,378,1585,1366,513,271,214,100,94,17,5,72,6,0,0,0,0,6,0,0,6,114,106,44,0,62,8,8,8,0,0,0,0,0,0,49270
16350,1465,248,638,423,97,59,71,44,33,9,0,24,11,0,0,0,0,11,0,4,7,27,19,5,0,14,8,2,2,0,0,6,0,0,6,49271
16351,1601,213,556,527,227,78,178,75,66,0,16,50,9,0,0,0,0,9,9,0,0,103,58,20,0,38,45,45,28,0,17,0,0,0,0,49272
16352,2491,414,1032,770,161,114,248,125,105,19,11,75,20,11,0,9,2,9,0,0,9,123,89,15,15,59,34,12,1,9,2,22,0,0,22,49274
16353,738,56,284,240,121,37,75,24,19,0,4,15,5,5,5,0,0,0,0,0,0,51,47,11,0,36,4,0,0,0,0,4,0,0,4,49276
16354,2229,107,906,852,201,163,191,124,77,10,0,67,47,34,34,0,0,13,8,5,0,67,54,18,6,30,13,13,13,0,0,0,0,0,0,49277
16355,433,49,196,121,43,24,44,20,17,4,0,13,3,3,0,3,0,0,0,0,0,24,24,4,3,17,0,0,0,0,0,0,0,0,0,49279
16356,392,113,156,64,49,10,0,0,0,0,0,0,0,0,0,0,0,0,0,0,0,0,0,0,0,0,0,0,0,0,0,0,0,0,0,49282
16357,2245,198,524,659,589,275,850,255,255,59,88,108,0,0,0,0,0,0,0,0,0,595,595,226,36,333,0,0,0,0,0,0,0,0,0,49283
16358,2186,263,998,680,180,65,125,50,47,3,3,41,3,0,0,0,0,3,0,0,3,75,64,8,11,45,11,8,8,0,0,3,0,0,3,49284
16359,3941,393,1283,1511,521,233,228,74,72,20,10,42,2,2,0,0,2,0,0,0,0,154,140,13,21,106,14,14,2,10,2,0,0,0,0,49285
16360,10226,705,3122,4099,1594,706,932,407,359,132,65,162,48,27,13,2,12,21,1,0,20,525,509,190,42,277,16,16,9,3,4,0,0,0,0,49286
16361,1280,64,490,426,163,137,112,47,33,6,0,27,14,14,10,4,0,0,0,0,0,65,65,24,0,41,0,0,0,0,0,0,0,0,0,49287
16362,883,101,456,214,92,20,85,54,49,3,0,46,5,0,0,0,0,5,2,3,0,31,31,3,0,28,0,0,0,0,0,0,0,0,0,49288
16363,123,18,67,38,0,0,0,0,0,0,0,0,0,0,0,0,0,0,0,0,0,0,0,0,0,0,0,0,0,0,0,0,0,0,0,49289
16364,12173,152,1462,3008,4480,3071,1281,650,650,205,75,370,0,0,0,0,0,0,0,0,0,631,615,123,86,406,16,16,16,0,0,0,0,0,0,49301
16365,5240,262,1302,1834,1244,598,467,267,248,90,19,139,19,19,12,7,0,0,0,0,0,200,188,92,0,96,12,0,0,0,0,12,0,0,12,49302
16366,690,64,255,279,85,7,43,11,8,0,8,0,3,3,0,3,0,0,0,0,0,32,32,4,0,28,0,0,0,0,0,0,0,0,0,49303
16367,3179,660,1185,1038,184,112,172,124,95,5,0,90,29,7,0,7,0,22,15,0,7,48,41,3,0,38,7,0,0,0,0,7,4,1,2,49304
16368,1631,275,740,453,109,54,68,43,42,0,9,33,1,0,0,0,0,1,0,1,0,25,20,1,0,19,5,5,0,0,5,0,0,0,0,49305
16369,6833,333,1529,2516,1534,921,666,331,331,80,16,235,0,0,0,0,0,0,0,0,0,335,262,50,0,212,73,39,39,0,0,34,0,15,19,49306
16370,10036,948,2793,3137,1804,1354,2832,1483,1451,340,350,761,32,29,3,19,7,3,0,0,3,1349,1293,442,191,660,56,27,7,8,12,29,0,0,29,49307
16371,1225,286,498,372,48,21,75,55,49,10,0,39,6,3,2,0,1,3,3,0,0,20,20,5,0,15,0,0,0,0,0,0,0,0,0,49309
16372,1812,224,819,546,140,83,267,184,175,99,1,75,9,9,2,7,0,0,0,0,0,83,72,29,11,32,11,7,0,4,3,4,4,0,0,49310
16373,199,53,81,52,13,0,0,0,0,0,0,0,0,0,0,0,0,0,0,0,0,0,0,0,0,0,0,0,0,0,0,0,0,0,0,49312
16374,13171,1008,3832,4040,3003,1288,1163,672,596,349,19,228,76,76,76,0,0,0,0,0,0,491,446,217,61,168,45,31,11,0,20,14,0,0,14,49315
16375,13326,694,3078,4503,3301,1750,935,475,413,225,59,129,62,24,6,18,0,38,17,18,3,460,444,120,29,295,16,15,15,0,0,1,0,0,1,49316
16376,1017,119,434,309,120,35,81,34,30,10,4,16,4,0,0,0,0,4,0,4,0,47,40,7,0,33,7,7,1,6,0,0,0,0,0,49318
16377,10079,1448,3383,3524,1286,438,738,338,306,8,35,263,32,27,27,0,0,5,0,5,0,400,318,104,92,122,82,72,59,4,9,10,0,0,10,49319
16378,16,0,3,13,0,0,0,0,0,0,0,0,0,0,0,0,0,0,0,0,0,0,0,0,0,0,0,0,0,0,0,0,0,0,0,49320
16379,10291,1219,3169,3466,1813,624,888,510,473,70,105,298,37,17,10,7,0,20,20,0,0,378,328,138,45,145,50,50,45,0,5,0,0,0,0,49321
16380,837,137,324,282,61,33,72,27,19,2,3,14,8,8,6,2,0,0,0,0,0,45,39,4,3,32,6,6,6,0,0,0,0,0,0,49322
16381,5835,353,2507,2176,618,181,506,286,224,104,29,91,62,47,47,0,0,15,0,15,0,220,183,92,13,78,37,37,19,0,18,0,0,0,0,49323
16382,1084,43,497,370,125,49,115,73,39,12,9,18,34,6,6,0,0,28,6,22,0,42,42,24,4,14,0,0,0,0,0,0,0,0,0,49325
16383,2765,341,1033,998,222,171,278,138,131,14,14,103,7,0,0,0,0,7,0,0,7,140,135,61,13,61,5,0,0,0,0,5,0,0,5,49326
16384,5409,855,2190,1691,523,150,528,308,212,23,10,179,96,62,38,0,24,34,6,20,8,220,179,62,0,117,41,18,18,0,0,23,0,9,14,49327
16385,2699,219,1224,935,213,108,273,135,118,23,8,87,17,17,14,3,0,0,0,0,0,138,110,25,3,82,28,19,19,0,0,9,0,0,9,49328
16386,5352,739,2391,1638,434,150,445,242,215,27,22,166,27,8,2,6,0,19,15,0,4,203,175,10,51,114,28,16,9,0,7,12,6,6,0,49329
16387,3301,438,1328,1121,335,79,344,214,133,44,6,83,81,43,26,10,7,38,0,32,6,130,120,18,29,73,10,10,10,0,0,0,0,0,0,49330
16388,11357,851,3607,3782,2350,767,1094,615,493,101,81,311,122,97,42,41,14,25,0,0,25,479,423,159,107,157,56,32,27,0,5,24,24,0,0,49331
16389,2240,229,820,843,208,140,141,84,82,8,16,58,2,1,1,0,0,1,0,0,1,57,52,1,7,44,5,2,0,0,2,3,0,0,3,49332
16390,7357,450,2530,2792,1036,549,459,316,297,162,41,94,19,19,19,0,0,0,0,0,0,143,139,39,7,93,4,0,0,0,0,4,0,0,4,49333
16391,319,1,125,153,19,21,13,13,13,0,0,13,0,0,0,0,0,0,0,0,0,0,0,0,0,0,0,0,0,0,0,0,0,0,0,49335
16392,3008,448,1390,872,210,88,355,143,111,23,2,86,32,14,4,0,10,18,9,1,8,212,177,32,9,136,35,16,0,0,16,19,0,16,3,49336
16393,8188,1057,3540,2566,622,403,649,350,251,53,13,185,99,71,58,5,8,28,13,9,6,299,224,29,25,170,75,69,63,0,6,6,0,0,6,49337
16394,1032,88,483,347,85,29,110,51,50,21,2,27,1,0,0,0,0,1,0,1,0,59,17,8,3,6,42,0,0,0,0,42,0,1,41,49338
16395,1655,236,681,519,141,78,86,30,25,15,0,10,5,5,5,0,0,0,0,0,0,56,56,25,0,31,0,0,0,0,0,0,0,0,0,49339
16396,2050,237,854,645,215,99,151,85,85,9,9,67,0,0,0,0,0,0,0,0,0,66,53,12,6,35,13,9,0,0,9,4,0,2,2,49340
16397,21154,916,4302,6990,5913,3033,1795,937,859,289,77,493,78,58,45,13,0,20,0,0,20,858,822,215,52,555,36,25,10,0,15,11,11,0,0,49341
16398,1282,84,629,374,129,66,67,27,27,0,0,27,0,0,0,0,0,0,0,0,0,40,40,0,8,32,0,0,0,0,0,0,0,0,0,49342
16399,3658,446,1427,1260,337,188,223,132,117,20,47,50,15,15,11,4,0,0,0,0,0,91,86,33,0,53,5,3,3,0,0,2,2,0,0,49343
16400,2634,312,1129,851,232,110,210,112,81,2,18,61,31,14,14,0,0,17,10,0,7,98,68,9,3,56,30,8,8,0,0,22,0,0,22,49344
16401,8941,590,3270,3246,1295,540,834,390,346,63,44,239,44,35,19,16,0,9,0,9,0,444,365,59,80,226,79,58,26,0,32,21,3,0,18,49345
16402,3944,304,1319,1326,640,355,235,126,103,15,0,88,23,11,9,0,2,12,0,1,11,109,71,18,4,49,38,15,0,0,15,23,4,0,19,49346
16403,754,93,294,288,56,23,62,23,21,2,3,16,2,2,0,0,2,0,0,0,0,39,35,6,0,29,4,4,4,0,0,0,0,0,0,49347
16404,7839,698,3187,2535,957,462,735,377,287,35,41,211,90,71,22,0,49,19,5,14,0,358,248,49,57,142,110,75,48,17,10,35,0,0,35,49348
16405,5764,959,2427,1856,300,222,474,263,198,18,23,157,65,42,2,12,28,23,11,3,9,211,176,20,14,142,35,24,18,0,6,11,0,0,11,49349
16406,6817,405,2285,2328,1189,610,4251,1726,1607,474,177,956,119,90,90,0,0,29,0,29,0,2525,2483,797,150,1536,42,42,5,30,7,0,0,0,0,49401
16407,1127,129,519,340,82,57,63,38,29,5,3,21,9,5,5,0,0,4,0,4,0,25,20,5,11,4,5,3,0,3,0,2,0,0,2,49402
16408,1545,167,629,444,214,91,128,53,33,14,0,19,20,6,3,3,0,14,0,10,4,75,57,38,3,16,18,4,2,0,2,14,14,0,0,49403
16409,5614,602,1968,2002,795,247,534,351,315,74,22,219,36,36,26,10,0,0,0,0,0,183,178,33,6,139,5,5,5,0,0,0,0,0,0,49404
16410,1119,143,462,372,100,42,73,44,44,17,5,22,0,0,0,0,0,0,0,0,0,29,22,11,0,11,7,4,4,0,0,3,0,0,3,49405
16411,610,42,99,185,185,99,16,10,5,5,0,0,5,5,0,0,5,0,0,0,0,6,6,0,0,6,0,0,0,0,0,0,0,0,0,49406
16412,6116,1065,2108,1760,826,357,512,222,190,43,0,147,32,7,3,4,0,25,25,0,0,290,233,60,14,159,57,43,3,17,23,14,0,0,14,49408
16413,1399,174,564,508,85,68,61,28,23,5,1,17,5,0,0,0,0,5,0,0,5,33,33,17,0,16,0,0,0,0,0,0,0,0,0,49410
16414,1109,138,379,415,112,65,48,25,21,2,0,19,4,3,0,3,0,1,1,0,0,23,20,2,4,14,3,0,0,0,0,3,0,3,0,49411
16415,7539,850,2660,2626,911,492,787,396,272,44,38,190,124,69,28,14,27,55,9,5,41,391,344,70,71,203,47,47,47,0,0,0,0,0,0,49412
16416,4449,265,1492,1661,796,235,278,125,109,15,4,90,16,16,0,16,0,0,0,0,0,153,153,69,0,84,0,0,0,0,0,0,0,0,0,49415
16417,20069,1393,5682,6030,4800,2164,1407,782,720,183,134,403,62,62,45,17,0,0,0,0,0,625,529,129,55,345,96,66,54,0,12,30,0,0,30,49417
16418,17876,993,5015,5438,4343,2087,1657,619,567,129,111,327,52,32,14,18,0,20,11,0,9,1038,915,273,253,389,123,81,68,13,0,42,12,2,28,49418
16419,4985,305,2014,1582,788,296,427,212,186,63,12,111,26,12,12,0,0,14,0,0,14,215,194,75,11,108,21,15,15,0,0,6,0,0,6,49419
16420,4773,942,1725,1473,400,233,438,188,110,18,8,84,78,35,23,3,9,43,26,0,17,250,199,74,2,123,51,46,19,0,27,5,0,5,0,49420
16421,3906,516,1856,1203,191,140,380,166,130,27,3,100,36,30,6,13,11,6,0,0,6,214,127,12,7,108,87,70,42,0,28,17,8,0,9,49421
16422,26857,3633,8134,6955,4974,3161,4345,1829,1604,558,163,883,225,138,79,17,42,87,29,17,41,2516,2303,642,154,1507,213,152,88,21,43,61,0,0,61,49423
16423,28156,3629,8652,7774,5312,2789,2553,1290,947,143,130,674,343,129,114,15,0,214,82,22,110,1263,954,363,88,503,309,166,87,66,13,143,8,15,120,49424
16424,2322,456,789,909,124,44,156,99,66,3,0,63,33,17,8,2,7,16,3,0,13,57,39,4,10,25,18,5,5,0,0,13,0,8,5,49425
16425,20637,1300,5879,6505,4933,2020,1801,829,703,341,32,330,126,113,38,38,37,13,0,0,13,972,800,321,38,441,172,115,65,13,37,57,0,0,57,49426
16426,16903,935,4929,6076,3450,1513,1379,853,768,324,71,373,85,62,20,0,42,23,15,0,8,526,503,208,54,241,23,23,0,23,0,0,0,0,0,49428
16427,12137,1156,3883,4300,1780,1018,808,362,293,100,34,159,69,19,5,14,0,50,22,28,0,446,384,85,21,278,62,23,13,10,0,39,11,0,28,49431
16428,6,0,0,0,6,0,0,0,0,0,0,0,0,0,0,0,0,0,0,0,0,0,0,0,0,0,0,0,0,0,0,0,0,0,0,49434
16429,2255,188,838,738,371,120,273,168,146,6,0,140,22,22,22,0,0,0,0,0,0,105,91,38,0,53,14,14,0,14,0,0,0,0,0,49435
16430,1164,149,436,359,126,94,33,31,29,0,5,24,2,0,0,0,0,2,2,0,0,2,2,0,0,2,0,0,0,0,0,0,0,0,0,49436
16431,4743,444,1656,1800,549,294,388,153,114,57,0,57,39,30,9,17,4,9,7,0,2,235,219,69,17,133,16,13,2,0,11,3,0,3,0,49437
16432,769,134,155,305,137,38,0,0,0,0,0,0,0,0,0,0,0,0,0,0,0,0,0,0,0,0,0,0,0,0,0,0,0,0,0,49440
16433,24636,2023,7472,8981,4389,1771,2144,1157,914,168,198,548,243,151,76,71,4,92,12,34,46,987,805,282,113,410,182,148,65,8,75,34,6,28,0,49441
16434,26659,4961,10918,8956,1280,544,2505,1199,928,158,110,660,271,209,91,21,97,62,6,13,43,1306,1111,279,187,645,195,141,118,17,6,54,20,18,16,49442
16435,17598,2829,7006,5775,1274,714,1489,605,495,152,44,299,110,75,38,11,26,35,0,27,8,884,609,137,77,395,275,196,107,40,49,79,0,10,69,49444
16436,14277,906,4094,5618,2210,1449,1174,616,542,66,29,447,74,58,46,12,0,16,9,7,0,558,481,188,58,235,77,62,50,12,0,15,0,6,9,49445
16437,1766,227,571,678,166,124,187,118,83,4,25,54,35,21,21,0,0,14,8,6,0,69,64,6,5,53,5,0,0,0,0,5,0,0,5,49446
16438,2202,294,740,815,215,138,145,93,74,39,19,16,19,19,0,0,19,0,0,0,0,52,52,0,20,32,0,0,0,0,0,0,0,0,0,49448
16439,1964,104,565,662,375,258,82,37,30,11,0,19,7,0,0,0,0,7,0,0,7,45,45,24,0,21,0,0,0,0,0,0,0,0,0,49449
16440,1773,462,719,450,100,42,207,106,106,0,25,81,0,0,0,0,0,0,0,0,0,101,101,6,6,89,0,0,0,0,0,0,0,0,0,49450
16441,3960,498,1566,1325,422,149,294,163,139,16,6,117,24,14,7,5,2,10,3,7,0,131,120,22,8,90,11,11,8,0,3,0,0,0,0,49451
16442,1139,123,471,466,58,21,88,50,37,16,2,19,13,9,9,0,0,4,4,0,0,38,25,15,2,8,13,8,6,2,0,5,5,0,0,49452
16443,1953,120,317,636,625,255,73,31,31,0,0,31,0,0,0,0,0,0,0,0,0,42,42,4,0,38,0,0,0,0,0,0,0,0,0,49453
16444,3029,378,986,1180,306,179,339,203,173,48,16,109,30,11,9,2,0,19,0,0,19,136,103,50,0,53,33,8,8,0,0,25,8,14,3,49454
16445,3056,552,1031,942,338,193,237,137,91,19,7,65,46,33,23,5,5,13,5,0,8,100,97,12,0,85,3,0,0,0,0,3,0,0,3,49455
16446,13541,987,3232,4441,2961,1920,901,471,365,111,13,241,106,78,67,0,11,28,0,17,11,430,375,126,12,237,55,50,14,0,36,5,0,0,5,49456
16447,7215,626,2579,2849,820,341,669,384,323,75,2,246,61,51,21,16,14,10,0,0,10,285,210,38,27,145,75,64,50,3,11,11,0,11,0,49457
16448,49,0,36,13,0,0,3,3,0,0,0,0,3,0,0,0,0,3,0,0,3,0,0,0,0,0,0,0,0,0,0,0,0,0,0,49458
16449,929,218,370,280,56,5,80,40,18,3,0,15,22,9,8,0,1,13,0,0,13,40,35,0,2,33,5,3,3,0,0,2,0,0,2,49459
16450,5645,587,1750,1771,1003,534,520,337,275,140,13,122,62,41,30,0,11,21,0,3,18,183,151,56,0,95,32,17,9,8,0,15,3,0,12,49460
16451,6339,535,1837,2269,1197,501,475,280,249,61,19,169,31,23,7,11,5,8,8,0,0,195,168,56,6,106,27,22,15,4,3,5,0,0,5,49461
16452,17066,1518,5552,5186,3337,1473,1900,992,761,335,53,373,231,111,111,0,0,120,46,0,74,908,816,352,115,349,92,87,87,0,0,5,0,5,0,49464
16453,21192,4249,4343,5976,4538,2086,1901,989,777,189,57,531,212,79,23,25,31,133,11,35,87,912,751,265,74,412,161,76,40,26,10,85,0,11,74,49503
16454,25402,3287,7596,8124,4449,1946,1889,911,816,235,158,423,95,52,32,16,4,43,0,5,38,978,723,196,131,396,255,186,166,13,7,69,0,26,43,49504
16455,21439,2325,5261,7197,4582,2074,1278,559,483,125,90,268,76,76,39,20,17,0,0,0,0,719,613,201,73,339,106,52,34,12,6,54,9,15,30,49505
16456,20416,1392,2866,4592,6921,4645,2735,1261,1094,239,66,789,167,107,35,40,32,60,6,20,34,1474,1406,359,84,963,68,68,59,0,9,0,0,0,0,49506
16457,20607,5373,5219,6032,2370,1613,2123,1219,965,168,62,735,254,92,47,0,45,162,58,27,77,904,778,159,202,417,126,78,1,22,55,48,0,34,14,49507
16458,26578,3210,6961,8705,5286,2416,2166,1196,1145,172,219,754,51,17,4,13,0,34,19,4,11,970,845,367,123,355,125,100,51,49,0,25,0,9,16,49508
16459,16681,3532,5708,5221,1694,526,1458,846,694,259,92,343,152,85,11,24,50,67,0,0,67,612,508,29,89,390,104,45,26,19,0,59,14,35,10,49509
16460,10241,599,2743,2791,2876,1232,851,460,366,95,83,188,94,82,44,15,23,12,0,0,12,391,280,39,43,198,111,111,63,14,34,0,0,0,0,49512
16461,18145,1881,5948,6176,3164,976,1220,675,485,122,51,312,190,190,136,29,25,0,0,0,0,545,445,262,47,136,100,69,55,4,10,31,10,0,21,49519
16462,18094,722,4557,6003,4394,2418,1792,921,865,224,117,524,56,46,34,7,5,10,0,0,10,871,816,326,73,417,55,55,38,17,0,0,0,0,0,49525
16463,14187,891,4179,4878,3165,1074,1093,561,531,218,84,229,30,15,15,0,0,15,0,2,13,532,462,179,54,229,70,67,67,0,0,3,3,0,0,49534
16464,6191,660,1877,2315,947,392,506,329,318,42,65,211,11,11,11,0,0,0,0,0,0,177,103,37,0,66,74,49,49,0,0,25,0,25,0,49544
16465,19804,1087,3416,4553,6040,4708,2417,1092,1035,265,74,696,57,33,33,0,0,24,12,12,0,1325,1313,566,177,570,12,9,0,0,9,3,0,0,3,49546
16466,18886,3168,7089,6305,1758,566,1657,854,709,81,125,503,145,85,73,0,12,60,17,0,43,803,624,190,31,403,179,88,72,0,16,91,65,5,21,49548
16467,14659,1543,5368,4752,1842,1154,948,398,248,56,30,162,150,125,42,41,42,25,0,4,21,550,483,158,79,246,67,58,11,8,39,9,9,0,0,49601
16468,169,49,89,31,0,0,2,2,2,0,2,0,0,0,0,0,0,0,0,0,0,0,0,0,0,0,0,0,0,0,0,0,0,0,0,49611
16469,876,59,297,248,145,127,52,27,17,0,3,14,10,10,7,0,3,0,0,0,0,25,14,4,0,10,11,11,11,0,0,0,0,0,0,49612
16470,502,30,125,172,99,76,9,6,6,3,3,0,0,0,0,0,0,0,0,0,0,3,3,0,3,0,0,0,0,0,0,0,0,0,0,49613
16471,2112,230,791,624,269,198,158,86,72,27,0,45,14,6,6,0,0,8,4,4,0,72,68,29,15,24,4,4,4,0,0,0,0,0,0,49614
16472,3288,188,1072,1190,488,350,180,69,52,17,5,30,17,10,10,0,0,7,0,0,7,111,82,8,25,49,29,20,0,20,0,9,3,6,0,49615
16473,1324,187,572,365,114,86,81,34,34,23,2,9,0,0,0,0,0,0,0,0,0,47,47,19,3,25,0,0,0,0,0,0,0,0,0,49616
16474,2575,263,840,815,374,283,123,72,70,17,11,42,2,0,0,0,0,2,0,0,2,51,51,13,0,38,0,0,0,0,0,0,0,0,0,49617
16475,571,72,277,182,37,3,40,22,7,6,0,1,15,15,3,0,12,0,0,0,0,18,12,3,0,9,6,0,0,0,0,6,0,6,0,49618
16476,825,163,332,259,52,19,43,20,15,10,0,5,5,5,0,5,0,0,0,0,0,23,23,3,0,20,0,0,0,0,0,0,0,0,0,49619
16477,1507,138,574,580,169,46,91,44,24,4,0,20,20,13,0,13,0,7,2,3,2,47,47,19,3,25,0,0,0,0,0,0,0,0,0,49620
16478,2178,150,616,672,413,327,191,95,89,41,6,42,6,6,3,3,0,0,0,0,0,96,83,31,6,46,13,13,4,0,9,0,0,0,0,49621
16479,1893,134,732,616,270,141,107,44,38,9,6,23,6,6,6,0,0,0,0,0,0,63,54,8,8,38,9,0,0,0,0,9,0,9,0,49622
16480,854,132,464,200,44,14,19,10,10,0,0,10,0,0,0,0,0,0,0,0,0,9,5,0,0,5,4,0,0,0,0,4,4,0,0,49623
16481,969,119,427,310,86,27,89,38,10,0,0,10,28,22,19,0,3,6,0,3,3,51,24,8,0,16,27,26,4,18,4,1,1,0,0,49625
16482,357,34,183,123,2,15,46,8,0,0,0,0,8,2,0,2,0,6,0,0,6,38,33,17,0,16,5,5,0,5,0,0,0,0,0,49626
16483,117,0,61,31,15,10,0,0,0,0,0,0,0,0,0,0,0,0,0,0,0,0,0,0,0,0,0,0,0,0,0,0,0,0,0,49627
16484,181,44,58,47,14,18,14,14,4,0,4,0,10,10,10,0,0,0,0,0,0,0,0,0,0,0,0,0,0,0,0,0,0,0,0,49628
16485,1606,79,380,526,350,271,121,74,35,15,7,13,39,39,37,2,0,0,0,0,0,47,42,21,0,21,5,5,5,0,0,0,0,0,0,49629
16486,1163,48,258,300,325,232,50,39,39,6,0,33,0,0,0,0,0,0,0,0,0,11,11,6,0,5,0,0,0,0,0,0,0,0,0,49630
16487,4065,516,1974,1129,310,136,291,158,108,18,12,78,50,21,2,5,14,29,2,3,24,133,101,16,5,80,32,26,21,2,3,6,0,0,6,49631
16488,795,133,367,248,28,19,69,21,21,8,10,3,0,0,0,0,0,0,0,0,0,48,38,1,11,26,10,10,6,2,2,0,0,0,0,49632
16489,2528,389,919,829,195,196,159,91,53,13,9,31,38,23,11,0,12,15,0,0,15,68,60,16,0,44,8,2,2,0,0,6,0,6,0,49633
16490,81,13,49,19,0,0,27,14,10,0,6,4,4,4,0,0,4,0,0,0,0,13,6,2,4,0,7,7,4,0,3,0,0,0,0,49634
16491,2860,274,859,749,494,484,176,89,89,33,6,50,0,0,0,0,0,0,0,0,0,87,81,22,9,50,6,0,0,0,0,6,0,6,0,49635
16492,348,3,59,76,104,106,23,23,15,9,0,6,8,0,0,0,0,8,8,0,0,0,0,0,0,0,0,0,0,0,0,0,0,0,0,49636
16493,2038,226,1083,459,134,136,151,92,57,13,30,14,35,35,35,0,0,0,0,0,0,59,59,32,0,27,0,0,0,0,0,0,0,0,0,49637
16494,649,137,262,185,49,16,26,14,10,4,0,6,4,4,1,0,3,0,0,0,0,12,11,3,6,2,1,1,1,0,0,0,0,0,0,49638
16495,1738,168,780,526,181,83,140,77,65,21,12,32,12,9,9,0,0,3,0,0,3,63,43,16,16,11,20,17,7,0,10,3,0,0,3,49639
16496,1090,87,358,370,148,127,70,48,25,10,0,15,23,17,17,0,0,6,0,0,6,22,22,6,0,16,0,0,0,0,0,0,0,0,0,49640
16497,750,199,208,272,20,51,22,3,0,0,0,0,3,0,0,0,0,3,0,3,0,19,10,3,0,7,9,0,0,0,0,9,0,0,9,49642
16498,4011,374,1534,1412,424,267,431,224,124,40,12,72,100,29,0,7,22,71,11,0,60,207,151,88,7,56,56,25,25,0,0,31,0,0,31,49643
16499,1450,245,611,458,93,43,95,59,45,14,2,29,14,14,7,7,0,0,0,0,0,36,31,2,0,29,5,4,0,4,0,1,0,0,1,49644
16500,1134,200,449,348,101,36,118,95,36,0,2,34,59,3,0,3,0,56,11,45,0,23,16,6,3,7,7,7,2,2,3,0,0,0,0,49645
16501,5813,866,2598,1746,404,199,376,209,175,19,19,137,34,21,9,12,0,13,0,3,10,167,133,28,6,99,34,15,10,5,0,19,0,15,4,49646
16502,1557,102,374,449,320,312,84,52,48,15,4,29,4,0,0,0,0,4,0,0,4,32,32,19,0,13,0,0,0,0,0,0,0,0,0,49648
16503,5218,503,2298,1743,485,189,696,394,327,100,24,203,67,63,10,27,26,4,0,0,4,302,240,42,45,153,62,51,21,0,30,11,0,0,11,49649
16504,2386,123,696,818,411,338,117,84,84,19,0,65,0,0,0,0,0,0,0,0,0,33,17,6,0,11,16,16,0,0,16,0,0,0,0,49650
16505,5467,805,2289,1564,570,239,363,155,94,16,7,71,61,55,9,37,9,6,3,2,1,208,174,75,13,86,34,33,24,2,7,1,0,0,1,49651
16506,1443,88,446,500,213,196,133,38,38,17,0,21,0,0,0,0,0,0,0,0,0,95,64,30,0,34,31,31,12,0,19,0,0,0,0,49653
16507,535,70,56,134,205,70,30,24,16,12,0,4,8,8,8,0,0,0,0,0,0,6,6,0,0,6,0,0,0,0,0,0,0,0,0,49654
16508,2170,379,877,707,134,73,189,99,75,8,14,53,24,3,3,0,0,21,18,0,3,90,67,14,0,53,23,4,4,0,0,19,7,9,3,49655
16509,1074,279,431,309,36,19,64,30,23,0,3,20,7,4,0,4,0,3,0,0,3,34,34,4,0,30,0,0,0,0,0,0,0,0,0,49656
16510,2394,283,1095,719,200,97,220,152,128,43,28,57,24,14,7,3,4,10,7,2,1,68,54,27,2,25,14,14,9,0,5,0,0,0,0,49657
16511,4752,742,2163,1308,420,119,447,275,245,62,43,140,30,2,2,0,0,28,7,13,8,172,124,16,22,86,48,42,42,0,0,6,0,0,6,49659
16512,10176,900,3679,3483,1268,846,579,311,257,41,44,172,54,19,11,4,4,35,2,0,33,268,232,40,71,121,36,16,16,0,0,20,9,0,11,49660
16513,4017,612,1683,1313,289,120,476,277,207,17,20,170,70,38,14,0,24,32,17,2,13,199,147,12,8,127,52,41,30,11,0,11,0,3,8,49663
16514,1551,97,489,499,323,143,106,68,64,11,0,53,4,0,0,0,0,4,0,0,4,38,38,4,3,31,0,0,0,0,0,0,0,0,0,49664
16515,2998,360,1322,970,216,130,251,133,92,24,16,52,41,6,3,0,3,35,18,8,9,118,105,42,5,58,13,0,0,0,0,13,0,0,13,49665
16516,86,0,35,51,0,0,0,0,0,0,0,0,0,0,0,0,0,0,0,0,0,0,0,0,0,0,0,0,0,0,0,0,0,0,0,49666
16517,394,43,201,130,10,10,24,17,15,7,0,8,2,2,0,2,0,0,0,0,0,7,7,2,0,5,0,0,0,0,0,0,0,0,0,49667
16518,2392,366,983,779,181,83,121,71,58,11,1,46,13,7,7,0,0,6,6,0,0,50,46,21,3,22,4,4,4,0,0,0,0,0,0,49668
16519,1628,45,325,375,515,368,88,36,24,6,0,18,12,0,0,0,0,12,12,0,0,52,47,28,0,19,5,5,5,0,0,0,0,0,0,49670
16520,70,5,12,32,21,0,0,0,0,0,0,0,0,0,0,0,0,0,0,0,0,0,0,0,0,0,0,0,0,0,0,0,0,0,0,49674
16521,878,70,240,267,175,126,34,19,19,7,0,12,0,0,0,0,0,0,0,0,0,15,15,0,0,15,0,0,0,0,0,0,0,0,0,49675
16522,2428,220,822,846,355,185,211,93,70,5,14,51,23,23,15,0,8,0,0,0,0,118,84,12,44,28,34,21,11,0,10,13,0,0,13,49676
16523,4796,562,2222,1385,399,228,385,175,141,16,7,118,34,21,10,0,11,13,4,0,9,210,159,38,0,121,51,13,9,4,0,38,0,23,15,49677
16524,1040,138,488,327,77,10,96,59,49,0,10,39,10,0,0,0,0,10,7,0,3,37,27,0,8,19,10,2,2,0,0,8,2,0,6,49679
16525,1334,134,615,462,90,33,118,71,55,27,8,20,16,16,16,0,0,0,0,0,0,47,43,18,10,15,4,2,2,0,0,2,0,0,2,49680
16526,3083,229,829,1015,659,351,256,152,125,33,9,83,27,3,0,0,3,24,0,10,14,104,98,34,2,62,6,6,0,0,6,0,0,0,0,49682
16527,1467,213,591,467,116,80,100,51,39,18,2,19,12,0,0,0,0,12,2,0,10,49,40,12,3,25,9,9,9,0,0,0,0,0,0,49683
16528,27459,1673,7248,9570,5592,3376,1485,761,542,284,18,240,219,123,99,11,13,96,52,0,44,724,613,246,72,295,111,77,59,0,18,34,34,0,0,49684
16529,23396,1487,5047,8390,4835,3637,1434,672,621,208,71,342,51,43,10,33,0,8,0,0,8,762,678,329,105,244,84,46,7,39,0,38,0,0,38,49686
16530,1870,246,771,557,223,73,124,72,66,13,2,51,6,0,0,0,0,6,3,3,0,52,51,9,3,39,1,1,0,1,0,0,0,0,0,49688
16531,1214,226,426,442,94,26,38,21,21,6,0,15,0,0,0,0,0,0,0,0,0,17,14,0,4,10,3,3,0,0,3,0,0,0,0,49689
16532,4593,149,1119,1594,937,794,572,314,257,34,53,170,57,57,48,0,9,0,0,0,0,258,241,80,6,155,17,7,7,0,0,10,0,0,10,49690
16533,666,53,214,199,126,74,41,22,22,19,0,3,0,0,0,0,0,0,0,0,0,19,19,6,0,13,0,0,0,0,0,0,0,0,0,49701
16534,559,93,232,174,27,33,68,38,38,7,0,31,0,0,0,0,0,0,0,0,0,30,29,4,0,25,1,1,1,0,0,0,0,0,0,49705
16535,3129,341,1156,1103,310,219,256,157,100,16,20,64,57,57,51,6,0,0,0,0,0,99,72,40,0,32,27,27,7,20,0,0,0,0,0,49706
16536,16290,1800,5289,6346,1487,1368,1144,671,574,215,68,291,97,71,32,8,31,26,0,0,26,473,421,160,22,239,52,30,22,2,6,22,0,0,22,49707
16537,2935,571,1191,899,172,102,149,69,50,10,12,28,19,5,5,0,0,14,0,14,0,80,62,30,20,12,18,18,18,0,0,0,0,0,0,49709
16538,395,38,141,140,58,18,0,0,0,0,0,0,0,0,0,0,0,0,0,0,0,0,0,0,0,0,0,0,0,0,0,0,0,0,0,49710
16539,5451,393,1752,2017,692,597,342,199,169,67,17,85,30,30,25,0,5,0,0,0,0,143,137,36,5,96,6,0,0,0,0,6,0,0,6,49712
16540,1360,103,527,441,160,129,97,59,29,19,0,10,30,30,29,1,0,0,0,0,0,38,35,5,0,30,3,3,1,0,2,0,0,0,0,49713
16541,2148,221,608,822,307,190,155,90,74,20,1,53,16,5,1,0,4,11,2,0,9,65,62,15,3,44,3,3,0,0,3,0,0,0,0,49715
16542,606,31,208,218,82,67,36,12,12,0,0,12,0,0,0,0,0,0,0,0,0,24,22,13,0,9,2,0,0,0,0,2,0,0,2,49716
16543,142,0,85,5,52,0,0,0,0,0,0,0,0,0,0,0,0,0,0,0,0,0,0,0,0,0,0,0,0,0,0,0,0,0,0,49717
16544,644,75,181,298,70,20,41,17,17,3,0,14,0,0,0,0,0,0,0,0,0,24,24,16,4,4,0,0,0,0,0,0,0,0,0,49718
16545,1101,67,421,305,186,122,35,24,17,0,0,17,7,0,0,0,0,7,0,0,7,11,11,0,0,11,0,0,0,0,0,0,0,0,0,49719
16546,6726,446,1850,2128,1410,892,504,244,219,116,8,95,25,20,1,17,2,5,0,0,5,260,241,117,8,116,19,19,7,9,3,0,0,0,0,49720
16547,10594,1334,4342,3263,980,675,750,366,285,78,26,181,81,64,45,0,19,17,0,2,15,384,295,58,47,190,89,64,30,28,6,25,0,2,23,49721
16548,155,16,35,85,19,0,0,0,0,0,0,0,0,0,0,0,0,0,0,0,0,0,0,0,0,0,0,0,0,0,0,0,0,0,0,49722
16549,754,81,266,293,65,49,84,50,34,6,0,28,16,16,12,4,0,0,0,0,0,34,25,9,0,16,9,9,9,0,0,0,0,0,0,49724
16550,574,51,222,158,69,74,23,21,19,0,0,19,2,0,0,0,0,2,0,0,2,2,0,0,0,0,2,0,0,0,0,2,0,0,2,49725
16551,875,52,360,276,132,55,19,14,14,6,0,8,0,0,0,0,0,0,0,0,0,5,3,0,0,3,2,2,0,2,0,0,0,0,0,49726
16552,5269,698,2023,1565,630,353,410,226,197,32,4,161,29,25,19,0,6,4,0,1,3,184,151,46,8,97,33,15,0,12,3,18,0,0,18,49727
16553,258,28,132,74,7,17,11,2,2,0,0,2,0,0,0,0,0,0,0,0,0,9,7,2,0,5,2,2,0,2,0,0,0,0,0,49728
16554,1123,123,438,362,135,65,61,17,12,5,2,5,5,5,0,5,0,0,0,0,0,44,37,3,0,34,7,7,0,7,0,0,0,0,0,49729
16555,1368,166,517,469,151,65,144,99,79,1,7,71,20,20,9,11,0,0,0,0,0,45,45,19,0,26,0,0,0,0,0,0,0,0,0,49730
16556,1474,173,591,504,119,87,103,45,36,21,1,14,9,9,5,0,4,0,0,0,0,58,56,28,11,17,2,2,0,0,2,0,0,0,0,49733
16557,13628,1136,5102,4530,1951,909,1113,539,462,150,37,275,77,41,36,0,5,36,10,23,3,574,487,226,56,205,87,47,47,0,0,40,31,9,0,49735
16558,420,51,185,131,42,11,3,3,3,0,0,3,0,0,0,0,0,0,0,0,0,0,0,0,0,0,0,0,0,0,0,0,0,0,0,49736
16559,7208,1070,2750,2200,823,365,432,267,197,63,30,104,70,34,14,4,16,36,20,10,6,165,119,33,10,76,46,42,19,13,10,4,0,4,0,49738
16560,5256,217,1075,1757,1304,903,286,151,137,58,14,65,14,14,14,0,0,0,0,0,0,135,109,37,21,51,26,22,0,0,22,4,0,0,4,49740
16561,563,64,225,206,40,28,55,23,21,5,0,16,2,2,2,0,0,0,0,0,0,32,31,0,2,29,1,1,1,0,0,0,0,0,0,49743
16562,635,67,287,214,40,27,38,21,17,0,0,17,4,0,0,0,0,4,0,4,0,17,17,0,0,17,0,0,0,0,0,0,0,0,0,49744
16563,936,68,294,346,152,76,67,37,29,0,0,29,8,2,0,0,2,6,0,6,0,30,27,27,0,0,3,3,0,0,3,0,0,0,0,49745
16564,2887,404,1170,1008,217,88,155,88,84,16,11,57,4,4,0,0,4,0,0,0,0,67,67,14,10,43,0,0,0,0,0,0,0,0,0,49746
16565,1420,211,603,462,81,63,51,35,30,0,5,25,5,5,0,0,5,0,0,0,0,16,10,0,8,2,6,6,0,0,6,0,0,0,0,49747
16566,101,24,37,31,5,4,0,0,0,0,0,0,0,0,0,0,0,0,0,0,0,0,0,0,0,0,0,0,0,0,0,0,0,0,0,49748
16567,3196,335,1190,1055,405,211,176,120,108,15,46,47,12,12,0,12,0,0,0,0,0,56,53,15,7,31,3,3,0,0,3,0,0,0,0,49749
16568,1318,113,554,452,146,53,76,44,40,13,3,24,4,2,0,0,2,2,0,2,0,32,21,7,0,14,11,3,3,0,0,8,0,0,8,49751
16569,652,65,233,229,90,35,17,17,17,5,5,7,0,0,0,0,0,0,0,0,0,0,0,0,0,0,0,0,0,0,0,0,0,0,0,49752
16570,1522,180,721,494,57,70,111,31,23,8,2,13,8,2,2,0,0,6,4,2,0,80,61,12,13,36,19,11,11,0,0,8,0,0,8,49753
16571,1395,165,533,426,145,126,96,49,43,10,4,29,6,0,0,0,0,6,0,2,4,47,47,21,5,21,0,0,0,0,0,0,0,0,0,49755
16572,2921,386,1244,993,177,121,130,57,35,20,0,15,22,9,0,6,3,13,0,13,0,73,65,0,6,59,8,0,0,0,0,8,0,3,5,49756
16573,366,20,122,122,54,48,45,7,7,3,0,4,0,0,0,0,0,0,0,0,0,38,8,0,1,7,30,30,30,0,0,0,0,0,0,49757
16574,1268,233,470,299,194,72,53,43,38,9,2,27,5,0,0,0,0,5,0,0,5,10,6,0,0,6,4,4,0,0,4,0,0,0,0,49759
16575,481,87,211,114,40,29,17,14,10,0,0,10,4,4,0,0,4,0,0,0,0,3,3,0,0,3,0,0,0,0,0,0,0,0,0,49760
16576,471,64,188,121,45,53,21,15,6,3,0,3,9,9,0,9,0,0,0,0,0,6,6,3,0,3,0,0,0,0,0,0,0,0,0,49762
16577,83,21,42,14,6,0,9,9,0,0,0,0,9,9,9,0,0,0,0,0,0,0,0,0,0,0,0,0,0,0,0,0,0,0,0,49764
16578,2960,440,1385,864,175,96,163,71,69,11,10,48,2,0,0,0,0,2,2,0,0,92,80,13,2,65,12,2,1,0,1,10,0,0,10,49765
16579,1684,281,576,542,224,61,109,24,4,0,0,4,20,5,0,5,0,15,12,0,3,85,53,31,1,21,32,5,0,5,0,27,17,10,0,49766
16580,402,42,185,106,48,21,5,0,0,0,0,0,0,0,0,0,0,0,0,0,0,5,5,0,0,5,0,0,0,0,0,0,0,0,0,49768
16581,1154,131,493,380,107,43,163,87,56,31,0,25,31,21,6,10,5,10,10,0,0,76,66,40,3,23,10,10,10,0,0,0,0,0,0,49769
16582,11624,556,3025,3875,2561,1607,963,541,480,165,34,281,61,33,33,0,0,28,13,0,15,422,367,135,0,232,55,25,25,0,0,30,30,0,0,49770
16583,1580,127,590,607,191,65,105,53,42,2,11,29,11,8,8,0,0,3,0,3,0,52,52,10,0,42,0,0,0,0,0,0,0,0,0,49774
16584,76,5,29,31,4,7,0,0,0,0,0,0,0,0,0,0,0,0,0,0,0,0,0,0,0,0,0,0,0,0,0,0,0,0,0,49775
16585,1415,231,649,419,84,32,80,45,45,2,8,35,0,0,0,0,0,0,0,0,0,35,32,8,1,23,3,3,1,2,0,0,0,0,0,49776
16586,1468,69,397,610,271,121,39,23,20,3,0,17,3,3,3,0,0,0,0,0,0,16,16,0,2,14,0,0,0,0,0,0,0,0,0,49777
16587,3648,495,1513,1007,410,223,164,105,101,47,6,48,4,4,0,0,4,0,0,0,0,59,57,2,21,34,2,0,0,0,0,2,0,0,2,49779
16588,1221,97,483,379,172,90,78,38,38,3,0,35,0,0,0,0,0,0,0,0,0,40,40,12,0,28,0,0,0,0,0,0,0,0,0,49780
16589,3049,371,1211,981,327,159,240,132,83,35,17,31,49,33,25,5,3,16,1,1,14,108,98,48,9,41,10,4,4,0,0,6,0,0,6,49781
16590,484,32,129,148,101,74,45,27,27,0,3,24,0,0,0,0,0,0,0,0,0,18,15,8,2,5,3,3,0,3,0,0,0,0,0,49782
16591,12872,1306,4432,4313,1738,1083,1499,679,533,91,82,360,146,99,45,25,29,47,3,17,27,820,685,285,66,334,135,125,46,9,70,10,2,0,8,49783
16592,4603,554,2266,1479,196,108,303,185,110,5,8,97,75,58,6,0,52,17,7,0,10,118,88,16,9,63,30,16,16,0,0,14,8,0,6,49788
16593,193,17,66,60,31,19,6,4,0,0,0,0,4,4,4,0,0,0,0,0,0,2,0,0,0,0,2,2,2,0,0,0,0,0,0,49791
16594,287,26,114,92,40,15,31,16,16,0,10,6,0,0,0,0,0,0,0,0,0,15,15,0,0,15,0,0,0,0,0,0,0,0,0,49793
16595,1503,259,632,463,103,46,110,83,63,22,10,31,20,14,14,0,0,6,0,6,0,27,22,4,3,15,5,5,2,0,3,0,0,0,0,49795
16596,304,31,76,84,70,43,17,0,0,0,0,0,0,0,0,0,0,0,0,0,0,17,17,0,0,17,0,0,0,0,0,0,0,0,0,49796
16597,1711,222,796,508,129,56,131,68,50,22,4,24,18,2,0,0,2,16,0,0,16,63,46,8,14,24,17,11,5,6,0,6,0,0,6,49799
16598,8277,488,3036,2610,1506,637,382,183,177,70,0,107,6,6,0,0,6,0,0,0,0,199,199,33,8,158,0,0,0,0,0,0,0,0,0,49801
16599,4627,266,2204,1390,558,209,292,138,122,54,9,59,16,0,0,0,0,16,0,0,16,154,135,46,25,64,19,19,19,0,0,0,0,0,0,49802
16600,234,19,86,65,54,10,17,9,9,6,0,3,0,0,0,0,0,0,0,0,0,8,5,5,0,0,3,0,0,0,0,3,0,0,3,49805
16601,477,29,178,129,91,50,7,3,3,3,0,0,0,0,0,0,0,0,0,0,0,4,4,0,0,4,0,0,0,0,0,0,0,0,0,49806
16602,2413,185,981,852,280,115,176,75,64,16,9,39,11,0,0,0,0,11,0,0,11,101,94,13,23,58,7,3,3,0,0,4,0,4,0,49807
16603,226,27,86,58,40,15,10,10,10,6,0,4,0,0,0,0,0,0,0,0,0,0,0,0,0,0,0,0,0,0,0,0,0,0,0,49808
16604,709,79,325,199,72,34,44,20,14,0,0,14,6,6,0,0,6,0,0,0,0,24,24,0,6,18,0,0,0,0,0,0,0,0,0,49812
16605,1016,64,515,241,158,38,101,65,52,17,3,32,13,13,3,3,7,0,0,0,0,36,30,6,0,24,6,6,6,0,0,0,0,0,0,49814
16606,420,38,188,141,33,20,61,50,46,3,5,38,4,4,0,4,0,0,0,0,0,11,11,11,0,0,0,0,0,0,0,0,0,0,0,49815
16607,666,69,343,153,76,25,32,20,20,0,0,20,0,0,0,0,0,0,0,0,0,12,12,0,0,12,0,0,0,0,0,0,0,0,0,49816
16608,381,46,170,119,30,16,42,14,11,4,0,7,3,3,3,0,0,0,0,0,0,28,28,11,0,17,0,0,0,0,0,0,0,0,0,49817
16609,744,62,390,205,72,15,51,23,20,2,0,18,3,3,3,0,0,0,0,0,0,28,25,2,2,21,3,3,3,0,0,0,0,0,0,49818
16610,21,0,13,4,0,4,0,0,0,0,0,0,0,0,0,0,0,0,0,0,0,0,0,0,0,0,0,0,0,0,0,0,0,0,0,49819
16611,190,54,79,39,15,3,3,3,3,0,0,3,0,0,0,0,0,0,0,0,0,0,0,0,0,0,0,0,0,0,0,0,0,0,0,49820
16612,990,89,476,297,100,28,62,36,36,9,0,27,0,0,0,0,0,0,0,0,0,26,19,6,0,13,7,7,0,3,4,0,0,0,0,49821
16613,197,3,94,64,18,18,0,0,0,0,0,0,0,0,0,0,0,0,0,0,0,0,0,0,0,0,0,0,0,0,0,0,0,0,0,49822
16614,232,11,79,88,41,13,21,16,16,0,0,16,0,0,0,0,0,0,0,0,0,5,5,0,0,5,0,0,0,0,0,0,0,0,0,49825
16615,125,16,53,33,13,10,0,0,0,0,0,0,0,0,0,0,0,0,0,0,0,0,0,0,0,0,0,0,0,0,0,0,0,0,0,49826
16616,686,112,270,199,63,42,36,21,8,3,0,5,13,4,0,0,4,9,0,0,9,15,15,3,0,12,0,0,0,0,0,0,0,0,0,49827
16617,12198,1194,4740,4251,1548,465,798,370,313,152,32,129,57,40,26,4,10,17,0,0,17,428,396,161,31,204,32,23,9,0,14,9,9,0,0,49829
16618,531,45,256,146,65,19,50,22,22,5,3,14,0,0,0,0,0,0,0,0,0,28,26,5,3,18,2,2,0,0,2,0,0,0,0,49831
16619,110,0,61,33,16,0,0,0,0,0,0,0,0,0,0,0,0,0,0,0,0,0,0,0,0,0,0,0,0,0,0,0,0,0,0,49833
16620,193,18,99,66,10,0,13,9,7,0,0,7,2,0,0,0,0,2,0,0,2,4,4,0,0,4,0,0,0,0,0,0,0,0,0,49834
16621,635,83,227,211,81,33,52,38,36,6,2,28,2,2,2,0,0,0,0,0,0,14,14,2,0,12,0,0,0,0,0,0,0,0,0,49835
16622,690,105,326,206,29,24,64,31,28,2,0,26,3,3,0,3,0,0,0,0,0,33,24,5,8,11,9,9,0,0,9,0,0,0,0,49836
16623,7031,479,2335,2667,1066,484,336,204,183,106,0,77,21,7,0,7,0,14,0,0,14,132,116,15,17,84,16,16,16,0,0,0,0,0,0,49837
16624,377,49,193,92,26,17,13,3,3,3,0,0,0,0,0,0,0,0,0,0,0,10,2,0,0,2,8,8,1,7,0,0,0,0,0,49838
16625,239,17,96,86,25,15,4,4,4,4,0,0,0,0,0,0,0,0,0,0,0,0,0,0,0,0,0,0,0,0,0,0,0,0,0,49839
16626,665,67,355,145,52,46,9,9,9,3,0,6,0,0,0,0,0,0,0,0,0,0,0,0,0,0,0,0,0,0,0,0,0,0,0,49840
16627,5204,296,2068,1843,678,319,400,278,255,62,60,133,23,14,6,0,8,9,0,9,0,122,115,12,24,79,7,7,0,0,7,0,0,0,0,49841
16628,695,78,336,222,56,3,47,22,15,6,0,9,7,7,0,7,0,0,0,0,0,25,21,13,0,8,4,4,4,0,0,0,0,0,0,49847
16629,127,36,36,53,2,0,0,0,0,0,0,0,0,0,0,0,0,0,0,0,0,0,0,0,0,0,0,0,0,0,0,0,0,0,0,49848
16630,8906,564,3535,2994,1450,363,481,221,217,41,15,161,4,4,4,0,0,0,0,0,0,260,236,101,38,97,24,24,6,18,0,0,0,0,0,49849
16631,92,3,54,24,8,3,0,0,0,0,0,0,0,0,0,0,0,0,0,0,0,0,0,0,0,0,0,0,0,0,0,0,0,0,0,49852
16632,1033,110,345,355,180,43,56,32,32,15,3,14,0,0,0,0,0,0,0,0,0,24,24,11,5,8,0,0,0,0,0,0,0,0,0,49853
16633,4808,465,2422,1300,433,188,315,167,135,19,4,112,32,20,9,0,11,12,0,0,12,148,133,21,17,95,15,0,0,0,0,15,0,11,4,49854
16634,20984,1298,5457,6340,5173,2716,2791,1224,1178,365,93,720,46,44,19,21,4,2,0,0,2,1567,1507,640,125,742,60,49,34,13,2,11,0,0,11,49855
16635,8610,738,3558,2984,1095,235,525,248,224,71,18,135,24,24,0,16,8,0,0,0,0,277,270,97,38,135,7,7,0,7,0,0,0,0,0,49858
16636,386,44,146,81,76,39,13,6,4,0,2,2,2,2,2,0,0,0,0,0,0,7,7,0,0,7,0,0,0,0,0,0,0,0,0,49861
16637,3510,349,1614,945,451,151,254,133,123,14,0,109,10,0,0,0,0,10,0,0,10,121,108,53,5,50,13,0,0,0,0,13,13,0,0,49862
16638,71,3,21,34,1,12,3,0,0,0,0,0,0,0,0,0,0,0,0,0,0,3,0,0,0,0,3,0,0,0,0,3,0,3,0,49863
16639,47,4,34,7,2,0,0,0,0,0,0,0,0,0,0,0,0,0,0,0,0,0,0,0,0,0,0,0,0,0,0,0,0,0,0,49864
16640,5449,335,1849,1788,1042,435,467,191,135,43,19,73,56,43,5,5,33,13,5,8,0,276,265,125,8,132,11,11,11,0,0,0,0,0,0,49866
16641,3950,601,1813,1128,282,126,158,103,83,17,10,56,20,8,6,0,2,12,0,0,12,55,55,12,10,33,0,0,0,0,0,0,0,0,0,49868
16642,2233,191,1039,670,207,126,239,111,99,30,18,51,12,0,0,0,0,12,0,12,0,128,111,2,32,77,17,17,17,0,0,0,0,0,0,49870
16643,418,83,196,88,44,7,22,22,22,0,0,22,0,0,0,0,0,0,0,0,0,0,0,0,0,0,0,0,0,0,0,0,0,0,0,49871
16644,122,10,36,60,16,0,7,5,5,5,0,0,0,0,0,0,0,0,0,0,0,2,2,0,0,2,0,0,0,0,0,0,0,0,0,49872
16645,77,24,27,22,0,4,3,0,0,0,0,0,0,0,0,0,0,0,0,0,0,3,3,0,0,3,0,0,0,0,0,0,0,0,0,49873
16646,912,120,421,248,84,39,51,23,23,11,6,6,0,0,0,0,0,0,0,0,0,28,24,5,0,19,4,4,4,0,0,0,0,0,0,49874
16647,751,51,377,216,46,61,82,57,57,57,0,0,0,0,0,0,0,0,0,0,0,25,25,7,0,18,0,0,0,0,0,0,0,0,0,49876
16648,28,5,12,5,2,4,6,4,4,2,0,2,0,0,0,0,0,0,0,0,0,2,2,0,0,2,0,0,0,0,0,0,0,0,0,49877
16649,2742,199,1090,843,470,140,224,87,82,35,9,38,5,5,5,0,0,0,0,0,0,137,127,44,6,77,10,10,3,0,7,0,0,0,0,49878
16650,734,56,281,264,94,39,42,22,13,4,0,9,9,9,0,0,9,0,0,0,0,20,20,20,0,0,0,0,0,0,0,0,0,0,0,49879
16651,836,86,385,264,65,36,26,10,10,2,8,0,0,0,0,0,0,0,0,0,0,16,15,8,0,7,1,1,0,0,1,0,0,0,0,49880
16652,289,18,169,90,12,0,16,10,10,3,0,7,0,0,0,0,0,0,0,0,0,6,6,2,0,4,0,0,0,0,0,0,0,0,0,49881
16653,67,0,32,29,3,3,2,0,0,0,0,0,0,0,0,0,0,0,0,0,0,2,0,0,0,0,2,2,0,0,2,0,0,0,0,49883
16654,570,143,338,65,9,15,29,5,5,0,0,5,0,0,0,0,0,0,0,0,0,24,24,12,0,12,0,0,0,0,0,0,0,0,0,49884
16655,1222,97,461,359,201,104,63,36,28,12,4,12,8,8,4,0,4,0,0,0,0,27,27,3,4,20,0,0,0,0,0,0,0,0,0,49885
16656,355,46,146,125,34,4,12,6,6,0,0,6,0,0,0,0,0,0,0,0,0,6,6,0,0,6,0,0,0,0,0,0,0,0,0,49886
16657,1926,223,837,568,205,93,131,59,46,13,13,20,13,13,4,3,6,0,0,0,0,72,72,29,3,40,0,0,0,0,0,0,0,0,0,49887
16658,583,56,263,159,83,22,24,10,3,0,0,3,7,7,0,0,7,0,0,0,0,14,0,0,0,0,14,6,6,0,0,8,3,0,5,49891
16659,1482,54,584,572,188,84,119,80,76,25,7,44,4,0,0,0,0,4,0,0,4,39,35,10,2,23,4,0,0,0,0,4,4,0,0,49892
16660,1449,112,574,538,147,78,200,131,90,8,3,79,41,14,5,0,9,27,27,0,0,69,69,15,0,54,0,0,0,0,0,0,0,0,0,49893
16661,512,57,247,190,18,0,61,20,10,10,0,0,10,10,10,0,0,0,0,0,0,41,41,0,0,41,0,0,0,0,0,0,0,0,0,49894
16662,676,81,298,176,92,29,6,4,4,0,0,4,0,0,0,0,0,0,0,0,0,2,2,0,0,2,0,0,0,0,0,0,0,0,0,49895
16663,1035,114,425,397,78,21,75,45,42,14,0,28,3,3,0,0,3,0,0,0,0,30,21,2,1,18,9,7,2,0,5,2,2,0,0,49896
16664,218,15,73,102,20,8,5,1,1,0,0,1,0,0,0,0,0,0,0,0,0,4,4,1,1,2,0,0,0,0,0,0,0,0,0,49901
16665,86,21,39,22,1,3,1,1,1,0,0,1,0,0,0,0,0,0,0,0,0,0,0,0,0,0,0,0,0,0,0,0,0,0,0,49902
16666,107,4,53,31,14,5,12,3,3,3,0,0,0,0,0,0,0,0,0,0,0,9,9,0,0,9,0,0,0,0,0,0,0,0,0,49903
16667,1109,135,366,359,180,69,93,77,71,21,3,47,6,6,6,0,0,0,0,0,0,16,16,9,0,7,0,0,0,0,0,0,0,0,0,49905
16668,2850,766,1480,459,118,27,62,34,28,1,1,26,6,3,0,0,3,3,3,0,0,28,26,10,1,15,2,1,0,0,1,1,1,0,0,49908
16669,305,17,110,129,42,7,10,4,0,0,0,0,4,4,4,0,0,0,0,0,0,6,6,0,0,6,0,0,0,0,0,0,0,0,0,49910
16670,1943,158,741,655,291,98,176,111,97,6,5,86,14,4,4,0,0,10,10,0,0,65,47,29,5,13,18,18,16,0,2,0,0,0,0,49911
16671,772,104,343,250,55,20,53,25,17,0,3,14,8,0,0,0,0,8,8,0,0,28,25,18,4,3,3,0,0,0,0,3,0,3,0,49912
16672,4966,650,1941,1455,651,269,536,340,203,61,49,93,137,104,69,4,31,33,0,0,33,196,174,99,8,67,22,16,5,11,0,6,0,6,0,49913
16673,380,46,185,119,21,9,14,2,2,0,0,2,0,0,0,0,0,0,0,0,0,12,12,5,0,7,0,0,0,0,0,0,0,0,0,49915
16674,1658,69,472,461,374,282,159,138,118,27,0,91,20,20,20,0,0,0,0,0,0,21,21,12,0,9,0,0,0,0,0,0,0,0,0,49916
16675,155,31,44,60,11,9,9,7,7,0,0,7,0,0,0,0,0,0,0,0,0,2,2,0,2,0,0,0,0,0,0,0,0,0,0,49917
16676,117,0,17,55,36,9,1,1,1,1,0,0,0,0,0,0,0,0,0,0,0,0,0,0,0,0,0,0,0,0,0,0,0,0,0,49918
16677,199,33,82,75,4,5,14,11,0,0,0,0,11,11,11,0,0,0,0,0,0,3,3,0,0,3,0,0,0,0,0,0,0,0,0,49919
16678,3343,319,1441,919,407,257,124,58,58,19,2,37,0,0,0,0,0,0,0,0,0,66,62,31,0,31,4,4,4,0,0,0,0,0,0,49920
16679,223,22,60,86,46,9,0,0,0,0,0,0,0,0,0,0,0,0,0,0,0,0,0,0,0,0,0,0,0,0,0,0,0,0,0,49921
16680,531,15,248,154,98,16,39,31,12,9,0,3,19,1,1,0,0,18,0,18,0,8,8,8,0,0,0,0,0,0,0,0,0,0,0,49922
16681,358,21,155,109,46,27,30,11,7,7,0,0,4,4,4,0,0,0,0,0,0,19,19,0,0,19,0,0,0,0,0,0,0,0,0,49925
16682,330,35,148,106,27,14,15,6,6,0,6,0,0,0,0,0,0,0,0,0,0,9,7,7,0,0,2,0,0,0,0,2,2,0,0,49927
16683,170,18,69,59,15,9,3,3,0,0,0,0,3,3,3,0,0,0,0,0,0,0,0,0,0,0,0,0,0,0,0,0,0,0,0,49929
16684,4467,375,1461,1151,943,537,333,161,122,63,9,50,39,39,16,6,17,0,0,0,0,172,143,91,0,52,29,27,17,10,0,2,2,0,0,49930
16685,4001,208,975,938,933,947,1575,1036,1023,233,27,763,13,0,0,0,0,13,0,0,13,539,537,253,21,263,2,2,0,2,0,0,0,0,0,49931
16686,651,98,279,194,58,22,35,9,9,0,0,9,0,0,0,0,0,0,0,0,0,26,16,0,0,16,10,0,0,0,0,10,0,0,10,49934
16687,4850,562,1936,1441,655,256,323,223,215,39,0,176,8,8,4,4,0,0,0,0,0,100,70,42,0,28,30,6,4,0,2,24,6,0,18,49935
16688,5645,453,1989,2136,749,318,360,152,75,27,0,48,77,49,49,0,0,28,0,0,28,208,195,66,45,84,13,13,5,8,0,0,0,0,0,49938
16689,63,13,15,0,27,8,0,0,0,0,0,0,0,0,0,0,0,0,0,0,0,0,0,0,0,0,0,0,0,0,0,0,0,0,0,49942
16690,1789,117,695,560,258,159,53,35,29,3,8,18,6,6,6,0,0,0,0,0,0,18,18,6,0,12,0,0,0,0,0,0,0,0,0,49945
16691,2851,361,1075,951,339,125,173,95,95,27,4,64,0,0,0,0,0,0,0,0,0,78,55,12,0,43,23,23,0,4,19,0,0,0,0,49946
16692,1579,197,841,383,96,62,20,15,2,0,0,2,13,9,0,0,9,4,0,0,4,5,5,5,0,0,0,0,0,0,0,0,0,0,0,49947
16693,428,67,168,154,20,19,15,8,8,0,0,8,0,0,0,0,0,0,0,0,0,7,4,0,0,4,3,3,0,3,0,0,0,0,0,49948
16694,986,80,342,340,129,95,64,50,35,4,0,31,15,9,9,0,0,6,0,0,6,14,6,6,0,0,8,3,3,0,0,5,0,0,5,49950
16695,85,8,47,20,8,2,13,13,13,10,0,3,0,0,0,0,0,0,0,0,0,0,0,0,0,0,0,0,0,0,0,0,0,0,0,49952
16696,2368,284,938,713,306,127,133,61,46,9,6,31,15,14,14,0,0,1,0,0,1,72,72,25,3,44,0,0,0,0,0,0,0,0,0,49953
16697,259,20,148,75,7,9,97,24,6,0,0,6,18,18,18,0,0,0,0,0,0,73,41,4,0,37,32,16,0,0,16,16,0,0,16,49955
16698,823,45,342,225,145,66,48,22,18,0,0,18,4,4,4,0,0,0,0,0,0,26,23,9,0,14,3,0,0,0,0,3,3,0,0,49958
16699,243,18,89,105,22,9,20,10,10,0,0,10,0,0,0,0,0,0,0,0,0,10,10,0,0,10,0,0,0,0,0,0,0,0,0,49959
16700,106,12,60,21,6,7,9,7,7,2,0,5,0,0,0,0,0,0,0,0,0,2,2,0,0,2,0,0,0,0,0,0,0,0,0,49960
16701,83,15,30,35,3,0,3,3,3,0,0,3,0,0,0,0,0,0,0,0,0,0,0,0,0,0,0,0,0,0,0,0,0,0,0,49961
16702,137,15,49,43,26,4,0,0,0,0,0,0,0,0,0,0,0,0,0,0,0,0,0,0,0,0,0,0,0,0,0,0,0,0,0,49962
16703,602,85,226,181,82,28,71,54,54,4,21,29,0,0,0,0,0,0,0,0,0,17,12,7,3,2,5,5,5,0,0,0,0,0,0,49963
16704,408,25,174,123,54,32,11,5,5,4,0,1,0,0,0,0,0,0,0,0,0,6,6,0,2,4,0,0,0,0,0,0,0,0,0,49965
16705,422,62,200,111,22,27,6,2,2,0,0,2,0,0,0,0,0,0,0,0,0,4,4,0,4,0,0,0,0,0,0,0,0,0,0,49967
16706,1799,138,660,680,204,117,68,29,29,2,0,27,0,0,0,0,0,0,0,0,0,39,36,19,0,17,3,0,0,0,0,3,0,0,3,49968
16707,1097,57,414,335,191,100,36,15,10,5,0,5,5,5,0,0,5,0,0,0,0,21,11,1,0,10,10,0,0,0,0,10,0,0,10,49969
16708,207,9,99,66,18,15,14,9,3,0,0,3,6,4,4,0,0,2,0,2,0,5,3,0,0,3,2,0,0,0,0,2,2,0,0,49970
16709,350,39,154,119,33,5,8,3,3,0,0,3,0,0,0,0,0,0,0,0,0,5,4,0,0,4,1,1,0,0,1,0,0,0,0,49971
16710,529,60,219,172,42,36,50,39,36,0,0,36,3,3,0,3,0,0,0,0,0,11,11,1,0,10,0,0,0,0,0,0,0,0,0,50001
16711,946,88,388,323,125,22,60,35,35,24,0,11,0,0,0,0,0,0,0,0,0,25,25,9,0,16,0,0,0,0,0,0,0,0,0,50002
16712,4712,227,1588,1304,1167,426,387,196,136,23,0,113,60,60,60,0,0,0,0,0,0,191,158,72,0,86,33,33,33,0,0,0,0,0,0,50003
16713,475,48,207,135,71,14,43,18,18,0,5,13,0,0,0,0,0,0,0,0,0,25,22,5,0,17,3,3,3,0,0,0,0,0,0,50005
16714,1048,61,484,353,123,27,81,33,23,6,0,17,10,4,2,2,0,6,0,2,4,48,48,25,0,23,0,0,0,0,0,0,0,0,0,50006
16715,434,9,101,175,108,41,28,15,15,8,3,4,0,0,0,0,0,0,0,0,0,13,13,5,0,8,0,0,0,0,0,0,0,0,0,50007
16716,615,67,277,185,69,17,39,13,3,0,0,3,10,0,0,0,0,10,10,0,0,26,8,8,0,0,18,14,14,0,0,4,0,0,4,50008
16717,11103,550,3191,3812,2627,923,797,427,326,89,94,143,101,42,0,0,42,59,10,39,10,370,284,179,0,105,86,41,41,0,0,45,45,0,0,50009
16718,17755,649,2483,4402,5697,4524,1013,476,443,79,25,339,33,33,21,0,12,0,0,0,0,537,491,219,10,262,46,22,22,0,0,24,13,0,11,50010
16719,0,0,0,0,0,0,1780,803,803,180,100,523,0,0,0,0,0,0,0,0,0,977,977,289,55,633,0,0,0,0,0,0,0,0,0,50011
16720,26,0,4,22,0,0,3007,1802,1802,429,155,1218,0,0,0,0,0,0,0,0,0,1205,1205,363,201,641,0,0,0,0,0,0,0,0,0,50012
16721,11426,255,1030,2755,4056,3330,2092,1240,1153,234,184,735,87,49,10,10,29,38,38,0,0,852,817,333,69,415,35,35,9,0,26,0,0,0,0,50014
16722,1057,76,394,359,171,57,61,16,13,2,0,11,3,3,0,3,0,0,0,0,0,45,45,24,5,16,0,0,0,0,0,0,0,0,0,50020
16723,14821,363,2647,4821,4955,2035,651,444,377,96,54,227,67,67,51,16,0,0,0,0,0,207,186,127,0,59,21,21,7,0,14,0,0,0,0,50021
16724,5747,475,2628,1531,768,345,409,235,176,105,0,71,59,27,15,0,12,32,0,0,32,174,140,64,35,41,34,19,19,0,0,15,0,0,15,50022
16725,17704,495,3031,6298,5748,2132,1716,902,767,398,80,289,135,135,56,79,0,0,0,0,0,814,772,391,22,359,42,31,31,0,0,11,11,0,0,50023
16726,2430,216,945,763,401,105,164,98,90,59,0,31,8,8,8,0,0,0,0,0,0,66,45,24,2,19,21,15,15,0,0,6,6,0,0,50025
16727,463,43,179,194,35,12,6,2,2,0,0,2,0,0,0,0,0,0,0,0,0,4,4,2,0,2,0,0,0,0,0,0,0,0,0,50026
16728,216,23,85,93,13,2,16,7,7,2,0,5,0,0,0,0,0,0,0,0,0,9,8,7,0,1,1,1,1,0,0,0,0,0,0,50027
16729,1121,71,519,351,135,45,70,42,38,0,0,38,4,4,0,0,4,0,0,0,0,28,23,8,0,15,5,0,0,0,0,5,3,0,2,50028
16730,574,62,220,215,40,37,36,26,23,20,0,3,3,3,0,0,3,0,0,0,0,10,10,0,7,3,0,0,0,0,0,0,0,0,0,50029
16731,238,0,115,63,11,49,0,0,0,0,0,0,0,0,0,0,0,0,0,0,0,0,0,0,0,0,0,0,0,0,0,0,0,0,0,50032
16732,28,3,15,6,4,0,5,5,5,5,0,0,0,0,0,0,0,0,0,0,0,0,0,0,0,0,0,0,0,0,0,0,0,0,0,50033
16733,258,8,95,112,29,14,18,16,16,5,0,11,0,0,0,0,0,0,0,0,0,2,2,2,0,0,0,0,0,0,0,0,0,0,0,50034
16734,3035,103,701,1148,885,198,236,136,87,43,7,37,49,40,0,40,0,9,0,9,0,100,85,57,0,28,15,15,15,0,0,0,0,0,0,50035
16735,11058,717,3800,4197,1789,555,908,400,359,103,5,251,41,41,41,0,0,0,0,0,0,508,458,177,57,224,50,46,46,0,0,4,1,2,1,50036
16736,89,0,5,76,3,5,0,0,0,0,0,0,0,0,0,0,0,0,0,0,0,0,0,0,0,0,0,0,0,0,0,0,0,0,0,50038
16737,358,8,185,125,24,16,22,8,8,0,0,8,0,0,0,0,0,0,0,0,0,14,14,0,9,5,0,0,0,0,0,0,0,0,0,50039
16738,78,7,52,10,9,0,0,0,0,0,0,0,0,0,0,0,0,0,0,0,0,0,0,0,0,0,0,0,0,0,0,0,0,0,0,50041
16739,231,30,113,77,8,3,29,0,0,0,0,0,0,0,0,0,0,0,0,0,0,29,29,13,0,16,0,0,0,0,0,0,0,0,0,50042
16740,775,102,423,191,27,32,93,49,47,9,0,38,2,2,1,1,0,0,0,0,0,44,39,6,23,10,5,5,0,0,5,0,0,0,0,50044
16741,981,55,271,297,284,74,45,28,22,3,4,15,6,6,2,4,0,0,0,0,0,17,9,5,2,2,8,8,5,0,3,0,0,0,0,50046
16742,3489,137,1359,1165,648,180,333,175,169,82,0,87,6,0,0,0,0,6,0,0,6,158,122,35,8,79,36,36,25,4,7,0,0,0,0,50047
16743,581,34,250,230,60,7,59,41,41,9,0,32,0,0,0,0,0,0,0,0,0,18,18,1,9,8,0,0,0,0,0,0,0,0,0,50048
16744,4555,453,2248,1333,385,136,422,187,115,40,10,65,72,72,55,8,9,0,0,0,0,235,181,48,15,118,54,33,13,20,0,21,5,0,16,50049
16745,396,28,151,141,54,22,28,20,19,2,0,17,1,1,1,0,0,0,0,0,0,8,8,3,0,5,0,0,0,0,0,0,0,0,0,50050
16746,307,12,199,96,0,0,38,6,3,3,0,0,3,0,0,0,0,3,0,0,3,32,28,0,0,28,4,4,2,0,2,0,0,0,0,50051
16747,179,20,116,21,15,7,10,6,6,6,0,0,0,0,0,0,0,0,0,0,0,4,4,4,0,0,0,0,0,0,0,0,0,0,0,50052
16748,2050,126,881,753,203,87,314,162,155,42,0,113,7,7,1,6,0,0,0,0,0,152,104,20,2,82,48,33,33,0,0,15,0,0,15,50054
16749,604,13,236,259,76,20,34,18,18,0,0,18,0,0,0,0,0,0,0,0,0,16,16,9,0,7,0,0,0,0,0,0,0,0,0,50055
16750,902,80,327,305,126,64,73,30,21,6,7,8,9,0,0,0,0,9,0,9,0,43,43,5,7,31,0,0,0,0,0,0,0,0,0,50056
16751,147,11,76,17,28,15,7,4,4,0,0,4,0,0,0,0,0,0,0,0,0,3,3,0,0,3,0,0,0,0,0,0,0,0,0,50057
16752,1453,117,551,519,209,57,84,50,48,29,0,19,2,2,0,2,0,0,0,0,0,34,27,6,0,21,7,3,3,0,0,4,0,0,4,50058
16753,1573,164,641,494,176,98,153,61,53,17,0,36,8,3,3,0,0,5,0,0,5,92,61,11,4,46,31,4,4,0,0,27,27,0,0,50060
16754,1284,46,286,271,512,169,53,29,29,8,0,21,0,0,0,0,0,0,0,0,0,24,24,8,0,16,0,0,0,0,0,0,0,0,0,50061
16755,485,70,244,118,40,13,45,15,10,0,4,6,5,4,4,0,0,1,0,1,0,30,30,3,0,27,0,0,0,0,0,0,0,0,0,50062
16756,1870,68,632,731,292,147,184,102,94,47,0,47,8,8,8,0,0,0,0,0,0,82,80,44,0,36,2,2,0,0,2,0,0,0,0,50063
16757,58,6,21,19,10,2,0,0,0,0,0,0,0,0,0,0,0,0,0,0,0,0,0,0,0,0,0,0,0,0,0,0,0,0,0,50064
16758,359,52,147,85,65,10,18,5,5,2,0,3,0,0,0,0,0,0,0,0,0,13,13,4,0,9,0,0,0,0,0,0,0,0,0,50065
16759,175,19,56,77,23,0,16,14,14,6,0,8,0,0,0,0,0,0,0,0,0,2,2,0,0,2,0,0,0,0,0,0,0,0,0,50066
16760,224,57,103,50,14,0,3,0,0,0,0,0,0,0,0,0,0,0,0,0,0,3,3,0,0,3,0,0,0,0,0,0,0,0,0,50067
16761,287,19,56,198,1,13,15,0,0,0,0,0,0,0,0,0,0,0,0,0,0,15,15,6,3,6,0,0,0,0,0,0,0,0,0,50068
16762,780,71,294,279,120,16,97,47,39,8,4,27,8,8,4,4,0,0,0,0,0,50,50,11,2,37,0,0,0,0,0,0,0,0,0,50069
16763,1022,37,328,439,177,41,72,54,44,6,17,21,10,0,0,0,0,10,0,0,10,18,18,10,0,8,0,0,0,0,0,0,0,0,0,50070
16764,696,51,300,226,99,20,36,19,19,2,17,0,0,0,0,0,0,0,0,0,0,17,14,0,0,14,3,0,0,0,0,3,0,0,3,50071
16765,1833,65,607,698,351,112,217,111,108,37,29,42,3,3,3,0,0,0,0,0,0,106,100,31,0,69,6,6,6,0,0,0,0,0,0,50072
16766,697,46,155,315,138,43,42,23,23,13,0,10,0,0,0,0,0,0,0,0,0,19,19,3,0,16,0,0,0,0,0,0,0,0,0,50073
16767,275,8,147,63,17,40,0,0,0,0,0,0,0,0,0,0,0,0,0,0,0,0,0,0,0,0,0,0,0,0,0,0,0,0,0,50074
16768,578,26,217,197,119,19,51,42,35,14,0,21,7,0,0,0,0,7,0,0,7,9,2,2,0,0,7,0,0,0,0,7,0,0,7,50075
16769,1013,96,471,341,89,16,54,19,16,5,3,8,3,3,0,3,0,0,0,0,0,35,26,20,2,4,9,9,0,0,9,0,0,0,0,50076
16770,104,42,28,31,3,0,0,0,0,0,0,0,0,0,0,0,0,0,0,0,0,0,0,0,0,0,0,0,0,0,0,0,0,0,0,50078
16771,62,2,30,19,0,11,1,1,1,0,0,1,0,0,0,0,0,0,0,0,0,0,0,0,0,0,0,0,0,0,0,0,0,0,0,50101
16772,44,0,9,13,22,0,0,0,0,0,0,0,0,0,0,0,0,0,0,0,0,0,0,0,0,0,0,0,0,0,0,0,0,0,0,50102
16773,279,37,95,114,28,5,19,2,2,0,0,2,0,0,0,0,0,0,0,0,0,17,17,3,1,13,0,0,0,0,0,0,0,0,0,50103
16774,83,0,22,49,11,1,14,1,1,0,0,1,0,0,0,0,0,0,0,0,0,13,11,7,3,1,2,2,0,2,0,0,0,0,0,50104
16775,809,17,184,283,242,83,87,56,51,22,10,19,5,5,5,0,0,0,0,0,0,31,25,12,2,11,6,6,4,2,0,0,0,0,0,50105
16776,700,54,281,234,121,10,18,7,7,7,0,0,0,0,0,0,0,0,0,0,0,11,11,0,0,11,0,0,0,0,0,0,0,0,0,50106
16777,710,78,335,204,81,12,114,75,53,10,18,25,22,19,6,0,13,3,0,3,0,39,27,16,0,11,12,12,2,10,0,0,0,0,0,50107
16778,400,56,209,103,32,0,9,3,2,0,0,2,1,1,1,0,0,0,0,0,0,6,4,0,0,4,2,2,0,2,0,0,0,0,0,50108
16779,1809,61,396,721,452,179,192,136,113,48,11,54,23,23,7,9,7,0,0,0,0,56,50,6,0,44,6,0,0,0,0,6,0,0,6,50109
16780,6577,176,1055,2288,2393,665,411,174,174,58,0,116,0,0,0,0,0,0,0,0,0,237,222,86,23,113,15,15,15,0,0,0,0,0,0,50111
16781,7106,497,2405,2218,1155,831,1151,538,537,297,49,191,1,0,0,0,0,1,0,0,1,613,595,404,47,144,18,18,18,0,0,0,0,0,0,50112
16782,1812,232,786,517,198,79,150,95,95,26,17,52,0,0,0,0,0,0,0,0,0,55,51,16,3,32,4,4,4,0,0,0,0,0,0,50115
16783,132,12,104,14,2,0,4,4,4,0,0,4,0,0,0,0,0,0,0,0,0,0,0,0,0,0,0,0,0,0,0,0,0,0,0,50116
16784,135,9,75,14,16,21,38,20,8,8,0,0,12,12,12,0,0,0,0,0,0,18,18,7,0,11,0,0,0,0,0,0,0,0,0,50117
16785,692,48,342,256,40,6,65,40,26,18,0,8,14,14,14,0,0,0,0,0,0,25,23,16,0,7,2,2,1,1,0,0,0,0,0,50118
16786,456,54,241,146,13,2,14,0,0,0,0,0,0,0,0,0,0,0,0,0,0,14,7,6,0,1,7,0,0,0,0,7,0,0,7,50119
16787,207,14,84,86,22,1,24,18,14,10,0,4,4,4,4,0,0,0,0,0,0,6,6,3,2,1,0,0,0,0,0,0,0,0,0,50120
16788,1156,101,386,458,159,52,62,32,20,17,0,3,12,12,3,9,0,0,0,0,0,30,30,19,0,11,0,0,0,0,0,0,0,0,0,50122
16789,585,37,293,181,48,26,18,11,11,4,0,7,0,0,0,0,0,0,0,0,0,7,7,0,4,3,0,0,0,0,0,0,0,0,0,50123
16790,2240,118,610,716,636,160,195,123,115,52,28,35,8,8,8,0,0,0,0,0,0,72,62,8,0,54,10,0,0,0,0,10,0,0,10,50124
16791,12350,529,4021,4224,2469,1107,1411,612,555,279,48,228,57,46,36,10,0,11,0,0,11,799,724,465,80,179,75,68,61,0,7,7,7,0,0,50125
16792,4684,384,1462,1978,573,287,389,239,199,95,4,100,40,10,10,0,0,30,0,0,30,150,150,35,59,56,0,0,0,0,0,0,0,0,0,50126
16793,0,0,0,0,0,0,0,0,0,0,0,0,0,0,0,0,0,0,0,0,0,0,0,0,0,0,0,0,0,0,0,0,0,0,0,50127
16794,234,29,106,73,7,19,23,7,7,5,0,2,0,0,0,0,0,0,0,0,0,16,7,4,0,3,9,9,0,0,9,0,0,0,0,50128
16795,3772,507,1221,1302,608,134,193,103,90,21,0,69,13,13,13,0,0,0,0,0,0,90,79,40,9,30,11,11,0,11,0,0,0,0,0,50129
16796,995,68,260,403,181,83,96,35,33,7,5,21,2,2,2,0,0,0,0,0,0,61,61,19,0,42,0,0,0,0,0,0,0,0,0,50130
16797,11938,381,1995,2842,4257,2463,1118,503,473,222,10,241,30,30,0,0,30,0,0,0,0,615,609,276,31,302,6,6,6,0,0,0,0,0,0,50131
16798,244,27,117,88,9,3,8,1,1,0,0,1,0,0,0,0,0,0,0,0,0,7,5,0,0,5,2,0,0,0,0,2,0,2,0,50132
16799,341,58,148,99,28,8,37,35,35,6,27,2,0,0,0,0,0,0,0,0,0,2,2,0,0,2,0,0,0,0,0,0,0,0,0,50133
16800,460,37,112,201,88,22,35,15,15,1,0,14,0,0,0,0,0,0,0,0,0,20,20,3,0,17,0,0,0,0,0,0,0,0,0,50134
16801,1225,73,447,549,129,27,59,30,25,5,2,18,5,5,3,2,0,0,0,0,0,29,13,8,0,5,16,7,7,0,0,9,0,9,0,50135
16802,271,23,122,93,29,4,24,14,7,3,0,4,7,7,7,0,0,0,0,0,0,10,10,3,0,7,0,0,0,0,0,0,0,0,0,50136
16803,7950,721,3027,2935,1028,239,374,211,187,69,0,118,24,19,16,3,0,5,5,0,0,163,126,45,0,81,37,20,15,5,0,17,17,0,0,50138
16804,958,56,518,188,116,80,77,46,43,0,13,30,3,0,0,0,0,3,3,0,0,31,22,0,2,20,9,9,0,0,9,0,0,0,0,50139
16805,1548,150,452,445,280,221,476,209,184,72,12,100,25,16,0,16,0,9,6,0,3,267,241,137,38,66,26,7,0,0,7,19,0,0,19,50140
16806,380,21,208,95,42,14,30,26,24,7,0,17,2,2,2,0,0,0,0,0,0,4,4,0,0,4,0,0,0,0,0,0,0,0,0,50141
16807,636,43,230,268,56,39,37,34,31,6,4,21,3,3,0,0,3,0,0,0,0,3,3,0,0,3,0,0,0,0,0,0,0,0,0,50142
16808,438,21,217,82,117,1,27,10,8,4,1,3,2,2,0,2,0,0,0,0,0,17,17,1,0,16,0,0,0,0,0,0,0,0,0,50143
16809,1832,294,757,541,185,55,207,68,49,9,15,25,19,16,0,0,16,3,0,0,3,139,82,30,10,42,57,41,26,0,15,16,9,0,7,50144
16810,257,21,80,95,50,11,16,5,5,3,0,2,0,0,0,0,0,0,0,0,0,11,9,5,4,0,2,2,0,2,0,0,0,0,0,50146
16811,368,60,184,88,26,10,44,32,30,16,2,12,2,2,2,0,0,0,0,0,0,12,12,0,9,3,0,0,0,0,0,0,0,0,0,50147
16812,274,43,129,87,7,8,20,14,14,0,0,14,0,0,0,0,0,0,0,0,0,6,6,4,0,2,0,0,0,0,0,0,0,0,0,50148
16813,533,32,323,146,19,13,52,23,23,11,0,12,0,0,0,0,0,0,0,0,0,29,13,0,8,5,16,16,16,0,0,0,0,0,0,50149
16814,687,73,338,154,78,44,36,17,17,3,0,14,0,0,0,0,0,0,0,0,0,19,13,0,0,13,6,2,0,0,2,4,0,4,0,50150
16815,478,91,165,172,50,0,14,12,11,9,0,2,1,1,0,1,0,0,0,0,0,2,0,0,0,0,2,2,2,0,0,0,0,0,0,50151
16816,624,41,346,196,34,7,60,35,14,6,0,8,21,21,21,0,0,0,0,0,0,25,25,1,0,24,0,0,0,0,0,0,0,0,0,50153
16817,339,29,107,143,48,12,15,5,4,4,0,0,1,1,0,0,1,0,0,0,0,10,10,8,0,2,0,0,0,0,0,0,0,0,0,50154
16818,196,10,79,81,21,5,18,1,1,0,0,1,0,0,0,0,0,0,0,0,0,17,7,0,0,7,10,10,10,0,0,0,0,0,0,50155
16819,2958,218,1221,992,402,125,151,99,79,27,11,41,20,20,20,0,0,0,0,0,0,52,44,17,4,23,8,5,0,5,0,3,3,0,0,50156
16820,496,46,291,85,57,17,9,7,6,2,0,4,1,1,1,0,0,0,0,0,0,2,2,0,0,2,0,0,0,0,0,0,0,0,0,50157
16821,20775,3550,6573,6554,2911,1187,1849,926,821,461,93,267,105,59,23,34,2,46,11,0,35,923,764,368,36,360,159,80,65,15,0,79,57,0,22,50158
16822,339,32,114,155,24,14,6,0,0,0,0,0,0,0,0,0,0,0,0,0,0,6,5,3,2,0,1,1,1,0,0,0,0,0,0,50160
16823,1496,46,392,730,279,49,77,40,34,4,2,28,6,6,6,0,0,0,0,0,0,37,37,13,16,8,0,0,0,0,0,0,0,0,0,50161
16824,846,38,316,337,133,22,65,38,38,13,8,17,0,0,0,0,0,0,0,0,0,27,27,6,2,19,0,0,0,0,0,0,0,0,0,50162
16825,560,61,229,212,51,7,10,6,6,0,2,4,0,0,0,0,0,0,0,0,0,4,4,0,0,4,0,0,0,0,0,0,0,0,0,50163
16826,352,44,173,92,42,1,21,7,7,3,0,4,0,0,0,0,0,0,0,0,0,14,14,2,8,4,0,0,0,0,0,0,0,0,0,50164
16827,51,4,15,21,11,0,0,0,0,0,0,0,0,0,0,0,0,0,0,0,0,0,0,0,0,0,0,0,0,0,0,0,0,0,0,50165
16828,1029,70,425,338,170,26,119,63,54,20,9,25,9,9,7,2,0,0,0,0,0,56,56,22,6,28,0,0,0,0,0,0,0,0,0,50166
16829,439,32,193,140,68,6,37,24,18,8,0,10,6,6,6,0,0,0,0,0,0,13,11,6,0,5,2,2,0,0,2,0,0,0,0,50167
16830,457,45,167,157,70,18,37,31,31,14,0,17,0,0,0,0,0,0,0,0,0,6,5,2,0,3,1,1,1,0,0,0,0,0,0,50168
16831,2563,159,1242,742,286,134,115,81,31,3,4,24,50,27,11,0,16,23,23,0,0,34,31,19,0,12,3,3,0,0,3,0,0,0,0,50169
16832,1883,175,687,728,240,53,170,60,35,17,0,18,25,17,0,4,13,8,0,3,5,110,101,12,0,89,9,9,9,0,0,0,0,0,0,50170
16833,2114,197,878,686,226,127,105,63,54,0,16,38,9,4,4,0,0,5,4,0,1,42,39,18,2,19,3,3,3,0,0,0,0,0,0,50171
16834,612,74,249,216,57,16,33,24,22,11,0,11,2,0,0,0,0,2,0,0,2,9,9,4,0,5,0,0,0,0,0,0,0,0,0,50173
16835,934,80,439,316,72,27,54,35,29,2,5,22,6,0,0,0,0,6,0,6,0,19,19,5,5,9,0,0,0,0,0,0,0,0,0,50174
16836,5754,467,1791,2097,967,432,241,136,129,50,20,59,7,2,0,0,2,5,0,0,5,105,74,28,0,46,31,0,0,0,0,31,22,0,9,50201
16837,306,21,143,74,43,25,21,5,5,2,3,0,0,0,0,0,0,0,0,0,0,16,12,0,12,0,4,0,0,0,0,4,4,0,0,50206
16838,1657,128,695,622,155,57,161,90,82,37,0,45,8,8,0,0,8,0,0,0,0,71,71,26,2,43,0,0,0,0,0,0,0,0,0,50207
16839,14919,1383,5805,4840,2153,738,933,462,393,158,11,224,69,54,39,0,15,15,9,0,6,471,421,237,27,157,50,47,32,15,0,3,0,0,3,50208
16840,1129,85,395,364,254,31,107,32,32,4,23,5,0,0,0,0,0,0,0,0,0,75,67,59,0,8,8,8,8,0,0,0,0,0,0,50210
16841,7584,300,1980,2871,1827,606,642,358,282,159,54,69,76,76,66,10,0,0,0,0,0,284,284,124,9,151,0,0,0,0,0,0,0,0,0,50211
16842,2422,151,1040,821,282,128,245,182,157,63,0,94,25,25,25,0,0,0,0,0,0,63,62,26,0,36,1,1,1,0,0,0,0,0,0,50212
16843,4660,671,2217,1115,466,191,354,173,142,86,0,56,31,31,18,0,13,0,0,0,0,181,156,83,25,48,25,25,11,0,14,0,0,0,0,50213
16844,586,16,127,178,203,62,36,22,22,0,0,22,0,0,0,0,0,0,0,0,0,14,14,14,0,0,0,0,0,0,0,0,0,0,0,50214
16845,1961,109,657,706,342,147,138,51,48,34,0,14,3,0,0,0,0,3,0,0,3,87,84,31,0,53,3,3,3,0,0,0,0,0,0,50216
16846,466,38,226,156,44,2,37,16,16,3,10,3,0,0,0,0,0,0,0,0,0,21,20,4,0,16,1,1,1,0,0,0,0,0,0,50217
16847,78,8,48,19,3,0,7,4,4,2,0,2,0,0,0,0,0,0,0,0,0,3,3,1,0,2,0,0,0,0,0,0,0,0,0,50218
16848,8404,414,2206,2530,2266,988,1461,722,722,299,54,369,0,0,0,0,0,0,0,0,0,739,739,440,49,250,0,0,0,0,0,0,0,0,0,50219
16849,5797,1225,2148,1567,659,198,542,274,236,85,33,118,38,38,38,0,0,0,0,0,0,268,268,81,10,177,0,0,0,0,0,0,0,0,0,50220
16850,461,24,193,183,52,9,23,8,8,8,0,0,0,0,0,0,0,0,0,0,0,15,15,15,0,0,0,0,0,0,0,0,0,0,0,50222
16851,297,21,148,91,17,20,3,2,2,0,0,2,0,0,0,0,0,0,0,0,0,1,1,1,0,0,0,0,0,0,0,0,0,0,0,50223
16852,1856,156,694,638,300,68,164,91,86,4,0,82,5,5,0,0,5,0,0,0,0,73,53,15,0,38,20,17,8,9,0,3,0,0,3,50225
16853,3455,44,772,932,1218,489,274,128,128,90,0,38,0,0,0,0,0,0,0,0,0,146,146,68,13,65,0,0,0,0,0,0,0,0,0,50226
16854,18,4,8,4,2,0,0,0,0,0,0,0,0,0,0,0,0,0,0,0,0,0,0,0,0,0,0,0,0,0,0,0,0,0,0,50227
16855,1481,95,624,480,239,43,70,57,55,13,3,39,2,2,2,0,0,0,0,0,0,13,13,12,0,1,0,0,0,0,0,0,0,0,0,50228
16856,525,17,178,183,122,25,45,21,21,0,0,21,0,0,0,0,0,0,0,0,0,24,24,4,0,20,0,0,0,0,0,0,0,0,0,50229
16857,885,96,338,294,120,37,54,32,32,11,0,21,0,0,0,0,0,0,0,0,0,22,22,6,0,16,0,0,0,0,0,0,0,0,0,50230
16858,126,4,38,37,31,16,4,2,2,0,0,2,0,0,0,0,0,0,0,0,0,2,2,2,0,0,0,0,0,0,0,0,0,0,0,50231
16859,342,29,175,72,48,18,41,30,28,19,1,8,2,0,0,0,0,2,0,0,2,11,11,11,0,0,0,0,0,0,0,0,0,0,0,50232
16860,994,84,470,282,135,23,84,43,31,19,0,12,12,9,9,0,0,3,0,0,3,41,38,8,7,23,3,3,0,3,0,0,0,0,0,50233
16861,424,51,141,149,58,25,14,12,10,4,0,6,2,0,0,0,0,2,0,0,2,2,2,0,0,2,0,0,0,0,0,0,0,0,0,50234
16862,262,17,100,69,69,7,12,3,1,0,0,1,2,2,0,2,0,0,0,0,0,9,8,8,0,0,1,0,0,0,0,1,0,0,1,50235
16863,1061,24,249,397,292,99,71,18,18,10,0,8,0,0,0,0,0,0,0,0,0,53,50,17,0,33,3,3,3,0,0,0,0,0,0,50236
16864,2188,176,853,710,322,127,230,152,128,42,4,82,24,22,22,0,0,2,0,0,2,78,78,19,0,59,0,0,0,0,0,0,0,0,0,50237
16865,677,38,311,231,70,27,62,44,29,8,8,13,15,5,0,3,2,10,10,0,0,18,14,7,0,7,4,4,4,0,0,0,0,0,0,50238
16866,89,9,32,40,8,0,5,2,2,0,0,2,0,0,0,0,0,0,0,0,0,3,3,3,0,0,0,0,0,0,0,0,0,0,0,50239
16867,1714,103,665,599,269,78,155,105,94,11,11,72,11,11,4,0,7,0,0,0,0,50,50,10,4,36,0,0,0,0,0,0,0,0,0,50240
16868,238,11,77,99,43,8,16,8,7,3,0,4,1,1,1,0,0,0,0,0,0,8,8,4,0,4,0,0,0,0,0,0,0,0,0,50242
16869,170,13,85,53,19,0,22,7,7,3,0,4,0,0,0,0,0,0,0,0,0,15,13,2,11,0,2,2,2,0,0,0,0,0,0,50243
16870,1324,65,253,481,413,112,100,72,72,30,6,36,0,0,0,0,0,0,0,0,0,28,26,8,0,18,2,2,2,0,0,0,0,0,0,50244
16871,550,34,194,249,62,11,27,7,7,0,0,7,0,0,0,0,0,0,0,0,0,20,20,8,0,12,0,0,0,0,0,0,0,0,0,50246
16872,1569,118,479,555,337,80,80,55,51,31,4,16,4,4,4,0,0,0,0,0,0,25,25,13,12,0,0,0,0,0,0,0,0,0,0,50247
16873,3166,319,1009,929,750,159,234,85,69,41,0,28,16,16,7,9,0,0,0,0,0,149,134,100,34,0,15,0,0,0,0,15,15,0,0,50248
16874,839,81,414,245,78,21,67,51,40,17,0,23,11,7,7,0,0,4,0,0,4,16,16,4,8,4,0,0,0,0,0,0,0,0,0,50249
16875,1876,193,829,604,169,81,84,56,44,17,4,23,12,5,5,0,0,7,0,0,7,28,24,4,8,12,4,4,4,0,0,0,0,0,0,50250
16876,912,94,426,216,124,52,69,45,39,15,0,24,6,3,0,3,0,3,3,0,0,24,24,2,10,12,0,0,0,0,0,0,0,0,0,50251
16877,118,6,64,32,0,16,5,2,2,0,0,2,0,0,0,0,0,0,0,0,0,3,3,0,0,3,0,0,0,0,0,0,0,0,0,50252
16878,244,36,102,69,29,8,44,11,11,11,0,0,0,0,0,0,0,0,0,0,0,33,22,20,0,2,11,11,11,0,0,0,0,0,0,50254
16879,46,4,24,13,5,0,4,0,0,0,0,0,0,0,0,0,0,0,0,0,0,4,4,0,0,4,0,0,0,0,0,0,0,0,0,50255
16880,424,30,238,109,42,5,25,25,25,20,5,0,0,0,0,0,0,0,0,0,0,0,0,0,0,0,0,0,0,0,0,0,0,0,0,50256
16881,591,60,236,203,82,10,58,29,21,7,2,12,8,5,2,0,3,3,3,0,0,29,29,21,0,8,0,0,0,0,0,0,0,0,0,50257
16882,671,34,287,226,77,47,48,1,1,0,0,1,0,0,0,0,0,0,0,0,0,47,45,5,1,39,2,0,0,0,0,2,2,0,0,50258
16883,1355,27,348,472,425,83,211,88,84,40,0,44,4,4,4,0,0,0,0,0,0,123,123,57,0,66,0,0,0,0,0,0,0,0,0,50261
16884,404,84,119,142,41,18,17,10,10,10,0,0,0,0,0,0,0,0,0,0,0,7,7,1,0,6,0,0,0,0,0,0,0,0,0,50262
16885,11160,386,1755,3315,4366,1338,621,338,282,149,0,133,56,56,33,0,23,0,0,0,0,283,228,111,0,117,55,55,55,0,0,0,0,0,0,50263
16886,254,23,106,87,29,9,10,10,4,3,0,1,6,5,5,0,0,1,0,1,0,0,0,0,0,0,0,0,0,0,0,0,0,0,0,50264
16887,21318,812,4124,6005,7231,3146,1513,753,529,190,30,309,224,163,131,32,0,61,61,0,0,760,735,308,122,305,25,14,0,0,14,11,11,0,0,50265
16888,16843,718,2072,4466,6913,2674,897,517,499,145,63,291,18,18,13,0,5,0,0,0,0,380,356,136,0,220,24,24,24,0,0,0,0,0,0,50266
16889,678,138,312,174,41,13,69,26,25,1,5,19,1,1,0,1,0,0,0,0,0,43,43,33,0,10,0,0,0,0,0,0,0,0,0,50268
16890,506,27,229,176,60,14,33,14,7,0,0,7,7,7,7,0,0,0,0,0,0,19,19,6,0,13,0,0,0,0,0,0,0,0,0,50271
16891,90,20,31,29,9,1,2,2,0,0,0,0,2,2,0,2,0,0,0,0,0,0,0,0,0,0,0,0,0,0,0,0,0,0,0,50272
16892,5585,338,2452,1560,924,311,290,129,111,58,7,46,18,12,12,0,0,6,0,0,6,161,119,44,0,75,42,0,0,0,0,42,34,0,8,50273
16893,271,19,124,73,46,9,4,4,3,0,0,3,1,0,0,0,0,1,1,0,0,0,0,0,0,0,0,0,0,0,0,0,0,0,0,50274
16894,382,40,171,147,24,0,14,11,11,0,0,11,0,0,0,0,0,0,0,0,0,3,1,0,0,1,2,2,2,0,0,0,0,0,0,50275
16895,1722,269,524,540,309,80,274,201,167,9,21,137,34,14,14,0,0,20,14,0,6,73,70,4,6,60,3,3,0,0,3,0,0,0,0,50276
16896,316,22,110,104,78,2,27,16,16,10,0,6,0,0,0,0,0,0,0,0,0,11,11,5,0,6,0,0,0,0,0,0,0,0,0,50277
16897,661,45,237,278,70,31,55,33,33,4,0,29,0,0,0,0,0,0,0,0,0,22,22,7,0,15,0,0,0,0,0,0,0,0,0,50278
16898,4003,510,826,952,1147,568,308,59,19,0,0,19,40,26,16,0,10,14,0,0,14,249,147,95,0,52,102,102,40,0,62,0,0,0,0,50309
16899,21093,1826,5184,6967,5047,2069,1104,614,567,338,82,147,47,47,13,34,0,0,0,0,0,490,329,182,31,116,161,79,54,0,25,82,46,27,9,50310
16900,8324,838,1761,2359,2246,1120,1909,892,804,222,72,510,88,80,56,0,24,8,8,0,0,1017,1017,420,90,507,0,0,0,0,0,0,0,0,0,50311
16901,10916,565,1847,2795,3517,2192,475,251,194,33,46,115,57,34,22,12,0,23,0,0,23,224,224,99,0,125,0,0,0,0,0,0,0,0,0,50312
16902,11525,1559,4590,3646,1191,539,815,364,265,116,31,118,99,91,45,0,46,8,0,0,8,451,402,199,53,150,49,49,6,38,5,0,0,0,0,50313
16903,6947,1882,2203,1769,800,293,566,277,187,30,33,124,90,90,38,52,0,0,0,0,0,289,189,37,28,124,100,73,14,14,45,27,9,18,0,50314
16904,22955,2759,9033,7738,2717,708,1875,950,786,278,115,393,164,67,46,14,7,97,36,24,37,925,744,245,73,426,181,129,76,0,53,52,42,10,0,50315
16905,9983,2146,3831,2744,987,275,1305,786,627,224,92,311,159,120,72,18,30,39,32,0,7,519,441,165,56,220,78,36,24,0,12,42,0,34,8,50316
16906,23877,3436,9647,7973,2227,594,1736,1049,794,296,110,388,255,143,80,63,0,112,16,96,0,687,593,199,23,371,94,80,65,7,8,14,14,0,0,50317
16907,0,0,0,0,0,0,0,0,0,0,0,0,0,0,0,0,0,0,0,0,0,0,0,0,0,0,0,0,0,0,0,0,0,0,0,50319
16908,12771,1663,4149,3965,2397,597,922,388,287,150,37,100,101,76,44,0,32,25,25,0,0,534,402,198,52,152,132,99,99,0,0,33,7,0,26,50320
16909,5409,350,1075,1978,1415,591,342,158,146,90,4,52,12,12,12,0,0,0,0,0,0,184,158,119,4,35,26,26,26,0,0,0,0,0,0,50321
16910,21709,982,4763,6963,6492,2509,1526,651,592,251,21,320,59,34,24,0,10,25,25,0,0,875,717,423,9,285,158,148,129,0,19,10,0,0,10,50322
16911,6782,124,855,1370,3194,1239,388,141,141,28,0,113,0,0,0,0,0,0,0,0,0,247,217,88,0,129,30,30,30,0,0,0,0,0,0,50323
16912,3469,105,625,1149,1191,399,193,142,107,37,0,70,35,35,19,16,0,0,0,0,0,51,51,25,0,26,0,0,0,0,0,0,0,0,0,50324
16913,10581,553,1506,2689,3783,2050,978,311,301,128,0,173,10,10,10,0,0,0,0,0,0,667,510,238,15,257,157,124,124,0,0,33,0,0,33,50325
16914,7414,557,1840,2633,1718,666,634,319,285,114,40,131,34,34,19,0,15,0,0,0,0,315,263,112,21,130,52,52,12,0,40,0,0,0,0,50327
16915,20343,1739,6437,8135,2890,1142,1677,866,754,445,20,289,112,84,65,13,6,28,0,7,21,811,691,272,33,386,120,94,85,8,1,26,26,0,0,50401
16916,292,22,128,101,29,12,20,10,6,6,0,0,4,4,4,0,0,0,0,0,0,10,9,8,0,1,1,1,0,0,1,0,0,0,0,50420
16917,2088,171,654,886,272,105,44,28,20,6,0,14,8,8,8,0,0,0,0,0,0,16,16,16,0,0,0,0,0,0,0,0,0,0,0,50421
16918,2289,254,815,854,230,136,90,39,37,9,0,28,2,0,0,0,0,2,0,0,2,51,51,14,3,34,0,0,0,0,0,0,0,0,0,50423
16919,972,53,370,346,164,39,28,23,23,5,0,18,0,0,0,0,0,0,0,0,0,5,5,0,0,5,0,0,0,0,0,0,0,0,0,50424
16920,31,2,10,11,8,0,0,0,0,0,0,0,0,0,0,0,0,0,0,0,0,0,0,0,0,0,0,0,0,0,0,0,0,0,0,50426
16921,6903,522,1997,2516,1333,535,286,118,118,45,0,73,0,0,0,0,0,0,0,0,0,168,168,91,0,77,0,0,0,0,0,0,0,0,0,50428
16922,343,35,132,120,37,19,27,18,18,13,0,5,0,0,0,0,0,0,0,0,0,9,9,3,4,2,0,0,0,0,0,0,0,0,0,50430
16923,232,62,79,76,8,7,21,10,10,3,0,7,0,0,0,0,0,0,0,0,0,11,11,1,0,10,0,0,0,0,0,0,0,0,0,50431
16924,168,4,93,59,8,4,0,0,0,0,0,0,0,0,0,0,0,0,0,0,0,0,0,0,0,0,0,0,0,0,0,0,0,0,0,50432
16925,148,16,49,44,29,10,12,3,3,0,0,3,0,0,0,0,0,0,0,0,0,9,9,0,0,9,0,0,0,0,0,0,0,0,0,50433
16926,319,32,167,66,47,7,2,2,2,0,0,2,0,0,0,0,0,0,0,0,0,0,0,0,0,0,0,0,0,0,0,0,0,0,0,50434
16927,417,58,198,131,28,2,54,22,17,11,0,6,5,5,0,0,5,0,0,0,0,32,32,3,3,26,0,0,0,0,0,0,0,0,0,50435
16928,4032,340,1372,1440,678,202,428,220,197,87,32,78,23,10,10,0,0,13,0,0,13,208,206,110,2,94,2,2,0,0,2,0,0,0,0,50436
16929,2637,180,834,1083,398,142,155,65,65,42,0,23,0,0,0,0,0,0,0,0,0,90,75,46,0,29,15,15,15,0,0,0,0,0,0,50438
16930,324,28,194,48,54,0,30,30,30,0,0,30,0,0,0,0,0,0,0,0,0,0,0,0,0,0,0,0,0,0,0,0,0,0,0,50439
16931,338,31,79,170,47,11,43,26,26,2,0,24,0,0,0,0,0,0,0,0,0,17,17,2,0,15,0,0,0,0,0,0,0,0,0,50440
16932,4069,760,1433,1322,405,149,222,161,120,9,14,97,41,13,13,0,0,28,0,0,28,61,60,18,7,35,1,1,1,0,0,0,0,0,0,50441
16933,244,14,108,95,20,7,5,0,0,0,0,0,0,0,0,0,0,0,0,0,0,5,5,2,0,3,0,0,0,0,0,0,0,0,0,50444
16934,433,11,98,232,48,44,47,26,18,9,0,9,8,3,0,3,0,5,5,0,0,21,21,12,0,9,0,0,0,0,0,0,0,0,0,50446
16935,830,84,431,207,95,13,107,75,75,32,0,43,0,0,0,0,0,0,0,0,0,32,18,3,0,15,14,6,0,0,6,8,8,0,0,50447
16936,550,30,205,249,48,18,44,37,35,35,0,0,2,2,2,0,0,0,0,0,0,7,7,7,0,0,0,0,0,0,0,0,0,0,0,50448
16937,426,44,214,137,26,5,44,21,17,3,0,14,4,4,0,0,4,0,0,0,0,23,19,19,0,0,4,0,0,0,0,4,4,0,0,50449
16938,2010,228,685,759,289,49,120,50,50,26,0,24,0,0,0,0,0,0,0,0,0,70,63,37,0,26,7,7,0,7,0,0,0,0,0,50450
16939,363,42,155,126,23,17,19,3,3,3,0,0,0,0,0,0,0,0,0,0,0,16,11,1,0,10,5,2,2,0,0,3,0,0,3,50451
16940,539,71,137,215,93,23,85,64,58,28,4,26,6,6,6,0,0,0,0,0,0,21,21,16,0,5,0,0,0,0,0,0,0,0,0,50452
16941,500,15,245,224,13,3,25,24,18,3,0,15,6,5,5,0,0,1,0,0,1,1,1,0,0,1,0,0,0,0,0,0,0,0,0,50453
16942,124,12,68,34,10,0,0,0,0,0,0,0,0,0,0,0,0,0,0,0,0,0,0,0,0,0,0,0,0,0,0,0,0,0,0,50454
16943,215,34,87,89,4,1,49,32,32,22,0,10,0,0,0,0,0,0,0,0,0,17,17,0,0,17,0,0,0,0,0,0,0,0,0,50455
16944,1197,110,519,463,77,28,67,13,13,13,0,0,0,0,0,0,0,0,0,0,0,54,54,32,3,19,0,0,0,0,0,0,0,0,0,50456
16945,265,27,106,101,27,4,8,5,3,2,0,1,2,2,2,0,0,0,0,0,0,3,3,0,3,0,0,0,0,0,0,0,0,0,0,50457
16946,1506,77,545,636,155,93,151,103,90,39,0,51,13,5,5,0,0,8,0,0,8,48,48,16,0,32,0,0,0,0,0,0,0,0,0,50458
16947,2119,149,635,877,348,110,161,103,81,63,0,18,22,0,0,0,0,22,0,0,22,58,51,19,0,32,7,0,0,0,0,7,7,0,0,50459
16948,180,18,87,71,4,0,11,9,9,0,9,0,0,0,0,0,0,0,0,0,0,2,2,0,0,2,0,0,0,0,0,0,0,0,0,50460
16949,4053,314,1712,1252,590,185,247,123,103,14,0,89,20,8,8,0,0,12,0,0,12,124,107,67,0,40,17,6,6,0,0,11,0,11,0,50461
16950,478,43,176,200,32,27,34,26,25,2,0,23,1,1,0,0,1,0,0,0,0,8,8,4,0,4,0,0,0,0,0,0,0,0,0,50464
16951,158,10,60,63,8,17,4,0,0,0,0,0,0,0,0,0,0,0,0,0,0,4,4,0,0,4,0,0,0,0,0,0,0,0,0,50465
16952,1237,183,565,342,116,31,122,81,48,14,0,34,33,0,0,0,0,33,19,0,14,41,32,6,0,26,9,0,0,0,0,9,3,0,6,50466
16953,63,1,14,45,3,0,4,2,2,0,0,2,0,0,0,0,0,0,0,0,0,2,2,2,0,0,0,0,0,0,0,0,0,0,0,50467
16954,1075,59,424,426,124,42,117,59,57,5,0,52,2,2,0,2,0,0,0,0,0,58,47,17,0,30,11,11,0,9,2,0,0,0,0,50468
16955,1257,71,464,521,150,51,85,57,57,27,0,30,0,0,0,0,0,0,0,0,0,28,28,8,3,17,0,0,0,0,0,0,0,0,0,50469
16956,169,20,83,49,17,0,5,3,2,0,0,2,1,1,0,0,1,0,0,0,0,2,2,2,0,0,0,0,0,0,0,0,0,0,0,50470
16957,581,60,282,145,91,3,44,37,20,19,0,1,17,17,17,0,0,0,0,0,0,7,7,2,0,5,0,0,0,0,0,0,0,0,0,50471
16958,1627,142,659,604,170,52,134,58,51,38,0,13,7,7,7,0,0,0,0,0,0,76,76,41,0,35,0,0,0,0,0,0,0,0,0,50472
16959,143,18,52,64,7,2,13,3,3,0,0,3,0,0,0,0,0,0,0,0,0,10,10,4,0,6,0,0,0,0,0,0,0,0,0,50473
16960,1138,90,413,427,161,47,111,50,50,29,0,21,0,0,0,0,0,0,0,0,0,61,61,26,0,35,0,0,0,0,0,0,0,0,0,50475
16961,491,47,255,155,26,8,40,6,6,4,0,2,0,0,0,0,0,0,0,0,0,34,34,15,0,19,0,0,0,0,0,0,0,0,0,50476
16962,285,24,174,54,33,0,32,15,12,0,0,12,3,3,3,0,0,0,0,0,0,17,17,11,0,6,0,0,0,0,0,0,0,0,0,50477
16963,667,47,331,202,87,0,40,19,19,11,0,8,0,0,0,0,0,0,0,0,0,21,18,0,2,16,3,3,3,0,0,0,0,0,0,50478
16964,425,42,153,174,45,11,27,12,6,0,0,6,6,6,0,0,6,0,0,0,0,15,7,0,0,7,8,8,8,0,0,0,0,0,0,50479
16965,630,74,246,215,84,11,47,30,30,21,0,9,0,0,0,0,0,0,0,0,0,17,13,8,0,5,4,0,0,0,0,4,4,0,0,50480
16966,693,24,198,291,133,47,32,23,23,20,0,3,0,0,0,0,0,0,0,0,0,9,9,9,0,0,0,0,0,0,0,0,0,0,0,50482
16967,555,58,197,219,78,3,39,14,14,6,0,8,0,0,0,0,0,0,0,0,0,25,25,5,0,20,0,0,0,0,0,0,0,0,0,50483
16968,254,9,106,115,17,7,22,18,18,0,0,18,0,0,0,0,0,0,0,0,0,4,4,2,0,2,0,0,0,0,0,0,0,0,0,50484
16969,18962,2334,5955,6696,2669,1308,2100,1237,970,353,172,445,267,157,59,38,60,110,57,9,44,863,814,420,110,284,49,49,14,35,0,0,0,0,0,50501
16970,728,40,240,276,152,20,66,34,34,7,0,27,0,0,0,0,0,0,0,0,0,32,27,0,9,18,5,0,0,0,0,5,0,0,5,50510
16971,5255,360,1946,1734,890,325,346,160,127,81,0,46,33,11,11,0,0,22,13,0,9,186,145,47,8,90,41,0,0,0,0,41,11,0,30,50511
16972,1063,100,364,471,95,33,60,34,29,5,0,24,5,5,5,0,0,0,0,0,0,26,21,12,0,9,5,0,0,0,0,5,0,0,5,50514
16973,162,6,100,41,13,2,9,8,8,6,0,2,0,0,0,0,0,0,0,0,0,1,1,1,0,0,0,0,0,0,0,0,0,0,0,50515
16974,414,33,159,167,38,17,23,20,20,14,2,4,0,0,0,0,0,0,0,0,0,3,1,1,0,0,2,2,2,0,0,0,0,0,0,50516
16975,738,88,276,279,66,29,67,20,20,8,0,12,0,0,0,0,0,0,0,0,0,47,42,34,0,8,5,5,5,0,0,0,0,0,0,50517
16976,254,12,104,101,22,15,18,8,8,2,0,6,0,0,0,0,0,0,0,0,0,10,10,0,0,10,0,0,0,0,0,0,0,0,0,50518
16977,398,53,172,136,27,10,29,8,8,2,0,6,0,0,0,0,0,0,0,0,0,21,21,11,6,4,0,0,0,0,0,0,0,0,0,50519
16978,110,12,65,27,3,3,4,2,2,2,0,0,0,0,0,0,0,0,0,0,0,2,2,0,2,0,0,0,0,0,0,0,0,0,0,50520
16979,30,0,21,9,0,0,0,0,0,0,0,0,0,0,0,0,0,0,0,0,0,0,0,0,0,0,0,0,0,0,0,0,0,0,0,50521
16980,511,41,234,168,61,7,37,22,20,4,0,16,2,0,0,0,0,2,0,0,2,15,15,4,0,11,0,0,0,0,0,0,0,0,0,50522
16981,589,28,262,225,70,4,35,16,15,0,0,15,1,0,0,0,0,1,0,0,1,19,19,1,0,18,0,0,0,0,0,0,0,0,0,50523
16982,376,17,166,154,35,4,27,8,8,0,6,2,0,0,0,0,0,0,0,0,0,19,19,11,0,8,0,0,0,0,0,0,0,0,0,50524
16983,2256,206,968,721,266,95,216,148,139,59,23,57,9,9,8,0,1,0,0,0,0,68,68,9,0,59,0,0,0,0,0,0,0,0,0,50525
16984,190,14,88,45,43,0,0,0,0,0,0,0,0,0,0,0,0,0,0,0,0,0,0,0,0,0,0,0,0,0,0,0,0,0,0,50527
16985,369,15,102,213,33,6,50,42,42,14,0,28,0,0,0,0,0,0,0,0,0,8,8,8,0,0,0,0,0,0,0,0,0,0,0,50528
16986,576,66,251,219,34,6,54,25,22,11,0,11,3,3,3,0,0,0,0,0,0,29,15,6,0,9,14,4,4,0,0,10,0,0,10,50529
16987,881,69,307,384,95,26,82,36,36,16,4,16,0,0,0,0,0,0,0,0,0,46,42,6,9,27,4,4,4,0,0,0,0,0,0,50530
16988,235,30,121,62,14,8,8,5,5,2,0,3,0,0,0,0,0,0,0,0,0,3,3,0,0,3,0,0,0,0,0,0,0,0,0,50531
16989,658,81,257,270,43,7,25,0,0,0,0,0,0,0,0,0,0,0,0,0,0,25,24,23,0,1,1,0,0,0,0,1,1,0,0,50532
16990,2789,505,978,839,262,205,184,126,91,23,0,68,35,0,0,0,0,35,0,18,17,58,51,13,15,23,7,7,7,0,0,0,0,0,0,50533
16991,553,28,245,174,86,20,43,12,5,0,0,5,7,7,7,0,0,0,0,0,0,31,23,13,0,10,8,8,8,0,0,0,0,0,0,50535
16992,3024,354,802,1292,423,153,282,169,169,105,0,64,0,0,0,0,0,0,0,0,0,113,102,68,0,34,11,11,11,0,0,0,0,0,0,50536
16993,328,8,144,117,56,3,36,3,0,0,0,0,3,3,3,0,0,0,0,0,0,33,33,0,0,33,0,0,0,0,0,0,0,0,0,50538
16994,417,24,149,177,38,29,17,10,10,0,0,10,0,0,0,0,0,0,0,0,0,7,7,0,4,3,0,0,0,0,0,0,0,0,0,50539
16995,655,25,309,236,68,17,45,27,27,16,0,11,0,0,0,0,0,0,0,0,0,18,18,8,0,10,0,0,0,0,0,0,0,0,0,50540
16996,574,30,282,186,66,10,54,18,18,5,0,13,0,0,0,0,0,0,0,0,0,36,27,21,0,6,9,6,6,0,0,3,0,0,3,50541
16997,766,45,294,360,44,23,62,40,38,2,2,34,2,2,2,0,0,0,0,0,0,22,22,15,7,0,0,0,0,0,0,0,0,0,0,50542
16998,1048,93,271,451,176,57,68,36,29,0,0,29,7,7,2,5,0,0,0,0,0,32,32,16,0,16,0,0,0,0,0,0,0,0,0,50543
16999,367,28,119,130,89,1,39,29,12,0,0,12,17,17,17,0,0,0,0,0,0,10,8,3,0,5,2,0,0,0,0,2,0,2,0,50544
17000,121,13,42,50,10,6,21,5,5,5,0,0,0,0,0,0,0,0,0,0,0,16,16,12,0,4,0,0,0,0,0,0,0,0,0,50545
17001,279,10,97,131,32,9,28,21,21,0,0,21,0,0,0,0,0,0,0,0,0,7,2,0,0,2,5,4,4,0,0,1,1,0,0,50546
17002,4061,383,1390,1304,762,222,214,105,96,77,0,19,9,0,0,0,0,9,9,0,0,109,96,0,0,96,13,13,0,13,0,0,0,0,0,50548
17003,101,4,39,15,43,0,0,0,0,0,0,0,0,0,0,0,0,0,0,0,0,0,0,0,0,0,0,0,0,0,0,0,0,0,0,50551
17004,1132,125,400,390,175,42,83,69,69,37,3,29,0,0,0,0,0,0,0,0,0,14,12,10,0,2,2,2,2,0,0,0,0,0,0,50554
17005,210,15,122,62,9,2,7,4,4,2,0,2,0,0,0,0,0,0,0,0,0,3,3,3,0,0,0,0,0,0,0,0,0,0,0,50556
17006,565,60,271,191,32,11,46,25,12,0,0,12,13,13,13,0,0,0,0,0,0,21,21,0,9,12,0,0,0,0,0,0,0,0,0,50557
17007,514,43,189,210,69,3,41,22,22,11,1,10,0,0,0,0,0,0,0,0,0,19,19,6,3,10,0,0,0,0,0,0,0,0,0,50558
17008,235,28,86,80,32,9,7,7,7,0,0,7,0,0,0,0,0,0,0,0,0,0,0,0,0,0,0,0,0,0,0,0,0,0,0,50559
17009,406,34,195,141,28,8,26,23,23,19,0,4,0,0,0,0,0,0,0,0,0,3,3,0,0,3,0,0,0,0,0,0,0,0,0,50560
17010,458,23,151,122,145,17,38,23,17,8,2,7,6,6,6,0,0,0,0,0,0,15,13,4,0,9,2,2,0,2,0,0,0,0,0,50561
17011,420,35,180,166,35,4,7,2,2,2,0,0,0,0,0,0,0,0,0,0,0,5,0,0,0,0,5,0,0,0,0,5,5,0,0,50562
17012,1759,113,723,609,217,97,139,55,49,15,3,31,6,6,6,0,0,0,0,0,0,84,84,31,6,47,0,0,0,0,0,0,0,0,0,50563
17013,396,36,135,173,50,2,14,11,4,0,0,4,7,0,0,0,0,7,0,0,7,3,3,3,0,0,0,0,0,0,0,0,0,0,0,50565
17014,270,13,109,112,36,0,11,3,3,3,0,0,0,0,0,0,0,0,0,0,0,8,7,0,0,7,1,0,0,0,0,1,0,1,0,50566
17015,138,18,78,21,19,2,4,0,0,0,0,0,0,0,0,0,0,0,0,0,0,4,4,4,0,0,0,0,0,0,0,0,0,0,0,50567
17016,1031,97,381,383,142,28,66,24,20,14,0,6,4,4,4,0,0,0,0,0,0,42,32,17,4,11,10,10,10,0,0,0,0,0,0,50568
17017,581,62,211,283,25,0,56,36,26,6,3,17,10,10,3,5,2,0,0,0,0,20,20,4,0,16,0,0,0,0,0,0,0,0,0,50569
17018,167,14,88,54,11,0,16,0,0,0,0,0,0,0,0,0,0,0,0,0,0,16,16,11,0,5,0,0,0,0,0,0,0,0,0,50570
17019,236,27,112,78,13,6,16,1,1,0,0,1,0,0,0,0,0,0,0,0,0,15,13,4,0,9,2,2,0,2,0,0,0,0,0,50571
17020,36,2,11,22,1,0,1,1,1,0,0,1,0,0,0,0,0,0,0,0,0,0,0,0,0,0,0,0,0,0,0,0,0,0,0,50573
17021,1626,134,644,507,287,54,65,23,23,11,0,12,0,0,0,0,0,0,0,0,0,42,42,24,0,18,0,0,0,0,0,0,0,0,0,50574
17022,806,129,305,257,84,31,44,19,19,5,0,14,0,0,0,0,0,0,0,0,0,25,25,13,0,12,0,0,0,0,0,0,0,0,0,50575
17023,290,43,84,53,109,1,22,13,13,0,0,13,0,0,0,0,0,0,0,0,0,9,9,9,0,0,0,0,0,0,0,0,0,0,0,50576
17024,310,21,134,105,42,8,5,5,5,5,0,0,0,0,0,0,0,0,0,0,0,0,0,0,0,0,0,0,0,0,0,0,0,0,0,50577
17025,479,38,178,175,77,11,22,16,15,7,0,8,1,1,1,0,0,0,0,0,0,6,6,0,0,6,0,0,0,0,0,0,0,0,0,50578
17026,1964,122,703,720,310,109,130,113,70,25,0,45,43,26,8,0,18,17,17,0,0,17,17,5,0,12,0,0,0,0,0,0,0,0,0,50579
17027,608,40,240,211,99,18,42,25,20,6,7,7,5,0,0,0,0,5,5,0,0,17,17,6,0,11,0,0,0,0,0,0,0,0,0,50581
17028,133,11,66,43,5,8,14,3,3,0,0,3,0,0,0,0,0,0,0,0,0,11,11,7,0,4,0,0,0,0,0,0,0,0,0,50582
17029,2036,209,793,677,223,134,99,53,41,17,4,20,12,5,5,0,0,7,0,0,7,46,40,26,7,7,6,6,0,0,6,0,0,0,0,50583
17030,679,54,270,262,70,23,45,24,24,6,0,18,0,0,0,0,0,0,0,0,0,21,14,7,0,7,7,7,5,0,2,0,0,0,0,50585
17031,194,13,82,88,11,0,6,1,1,0,0,1,0,0,0,0,0,0,0,0,0,5,3,0,0,3,2,2,0,2,0,0,0,0,0,50586
17032,7643,2193,2161,1839,864,586,922,517,475,202,36,237,42,41,13,21,7,1,1,0,0,405,335,171,11,153,70,27,27,0,0,43,43,0,0,50588
17033,633,47,206,270,90,20,79,39,22,0,0,22,17,15,8,0,7,2,2,0,0,40,34,15,0,19,6,2,2,0,0,4,4,0,0,50590
17034,156,4,70,56,16,10,9,5,0,0,0,0,5,2,2,0,0,3,0,3,0,4,4,0,0,4,0,0,0,0,0,0,0,0,0,50591
17035,56,14,28,6,4,4,2,0,0,0,0,0,0,0,0,0,0,0,0,0,0,2,2,2,0,0,0,0,0,0,0,0,0,0,0,50593
17036,148,19,60,43,5,21,4,0,0,0,0,0,0,0,0,0,0,0,0,0,0,4,4,2,0,2,0,0,0,0,0,0,0,0,0,50594
17037,6451,795,2095,2430,861,270,452,226,212,95,18,99,14,14,14,0,0,0,0,0,0,226,172,104,0,68,54,54,37,0,17,0,0,0,0,50595
17038,790,84,286,328,85,7,50,22,16,9,0,7,6,0,0,0,0,6,0,6,0,28,28,28,0,0,0,0,0,0,0,0,0,0,0,50597
17039,658,23,250,284,63,38,53,27,27,20,5,2,0,0,0,0,0,0,0,0,0,26,26,13,6,7,0,0,0,0,0,0,0,0,0,50598
17040,354,8,176,118,50,2,18,5,3,0,0,3,2,0,0,0,0,2,2,0,0,13,13,6,0,7,0,0,0,0,0,0,0,0,0,50599
17041,1743,202,543,696,230,72,74,40,37,15,0,22,3,3,0,3,0,0,0,0,0,34,29,17,0,12,5,0,0,0,0,5,0,0,5,50601
17042,1205,143,499,402,127,34,94,48,38,19,5,14,10,4,0,4,0,6,6,0,0,46,43,11,0,32,3,3,3,0,0,0,0,0,0,50602
17043,453,96,200,134,17,6,32,10,6,0,0,6,4,1,0,0,1,3,3,0,0,22,20,4,0,16,2,2,2,0,0,0,0,0,0,50603
17044,1242,182,531,377,107,45,69,39,32,0,0,32,7,0,0,0,0,7,0,7,0,30,30,0,0,30,0,0,0,0,0,0,0,0,0,50604
17045,91,14,47,28,2,0,8,2,2,0,0,2,0,0,0,0,0,0,0,0,0,6,6,0,3,3,0,0,0,0,0,0,0,0,0,50605
17046,680,59,313,195,70,43,71,41,39,19,0,20,2,2,2,0,0,0,0,0,0,30,30,1,0,29,0,0,0,0,0,0,0,0,0,50606
17047,471,49,276,82,44,20,45,24,23,0,14,9,1,1,1,0,0,0,0,0,0,21,21,2,0,19,0,0,0,0,0,0,0,0,0,50607
17048,259,26,81,124,26,2,9,5,5,0,0,5,0,0,0,0,0,0,0,0,0,4,4,0,0,4,0,0,0,0,0,0,0,0,0,50609
17049,263,12,117,92,42,0,27,20,12,0,0,12,8,8,0,5,3,0,0,0,0,7,4,4,0,0,3,0,0,0,0,3,0,0,3,50611
17050,252,0,48,122,47,35,5,5,5,5,0,0,0,0,0,0,0,0,0,0,0,0,0,0,0,0,0,0,0,0,0,0,0,0,0,50612
17051,22987,1176,5473,6348,6094,3896,4113,1593,1507,416,268,823,86,68,27,0,41,18,5,0,13,2520,2418,866,307,1245,102,85,75,0,10,17,7,0,10,50613
17052,7070,772,2820,2319,829,330,601,295,255,80,37,138,40,30,19,11,0,10,0,0,10,306,182,34,4,144,124,21,21,0,0,103,10,43,50,50616
17053,1588,170,779,473,126,40,54,25,25,0,0,25,0,0,0,0,0,0,0,0,0,29,26,4,2,20,3,3,3,0,0,0,0,0,0,50619
17054,33,1,15,12,3,2,2,1,1,1,0,0,0,0,0,0,0,0,0,0,0,1,1,0,0,1,0,0,0,0,0,0,0,0,0,50620
17055,1126,80,331,487,152,76,121,82,79,13,0,66,3,3,3,0,0,0,0,0,0,39,21,3,3,15,18,18,4,0,14,0,0,0,0,50621
17056,2299,38,708,849,469,235,146,92,92,17,0,75,0,0,0,0,0,0,0,0,0,54,54,29,0,25,0,0,0,0,0,0,0,0,0,50622
17057,1209,56,356,420,273,104,136,46,46,15,4,27,0,0,0,0,0,0,0,0,0,90,90,9,0,81,0,0,0,0,0,0,0,0,0,50624
17058,845,74,441,249,66,15,66,13,6,0,0,6,7,3,3,0,0,4,0,0,4,53,53,43,0,10,0,0,0,0,0,0,0,0,0,50625
17059,1385,73,675,414,156,67,79,48,48,28,11,9,0,0,0,0,0,0,0,0,0,31,29,7,0,22,2,2,2,0,0,0,0,0,0,50626
17060,2332,208,797,748,317,262,300,182,156,43,10,103,26,26,21,5,0,0,0,0,0,118,100,21,0,79,18,0,0,0,0,18,18,0,0,50627
17061,907,165,460,218,38,26,102,50,21,9,0,12,29,19,17,0,2,10,10,0,0,52,10,8,0,2,42,1,0,0,1,41,27,0,14,50628
17062,1538,103,695,424,259,57,46,24,11,0,0,11,13,13,8,5,0,0,0,0,0,22,22,15,0,7,0,0,0,0,0,0,0,0,0,50629
17063,1256,132,544,397,123,60,85,42,26,20,0,6,16,3,3,0,0,13,13,0,0,43,18,7,0,11,25,4,4,0,0,21,0,0,21,50630
17064,731,15,309,296,93,18,51,23,23,3,9,11,0,0,0,0,0,0,0,0,0,28,23,10,5,8,5,5,0,0,5,0,0,0,0,50632
17065,301,9,145,51,44,52,60,35,31,0,2,29,4,4,0,4,0,0,0,0,0,25,24,23,1,0,1,1,0,1,0,0,0,0,0,50633
17066,533,36,254,192,32,19,34,25,16,8,0,8,9,0,0,0,0,9,9,0,0,9,9,2,0,7,0,0,0,0,0,0,0,0,0,50634
17067,1302,54,537,448,205,58,133,66,60,15,12,33,6,6,0,6,0,0,0,0,0,67,67,35,0,32,0,0,0,0,0,0,0,0,0,50635
17068,1353,138,498,480,193,44,82,59,53,17,0,36,6,6,6,0,0,0,0,0,0,23,23,2,0,21,0,0,0,0,0,0,0,0,0,50636
17069,2282,175,755,807,417,128,125,78,66,12,0,54,12,6,6,0,0,6,0,0,6,47,47,9,0,38,0,0,0,0,0,0,0,0,0,50638
17070,1153,249,429,399,69,7,170,57,46,27,0,19,11,4,2,0,2,7,7,0,0,113,113,17,3,93,0,0,0,0,0,0,0,0,0,50641
17071,441,22,236,151,27,5,85,41,39,13,11,15,2,0,0,0,0,2,2,0,0,44,33,29,2,2,11,11,11,0,0,0,0,0,0,50642
17072,1865,63,580,589,467,166,140,100,90,21,9,60,10,10,0,10,0,0,0,0,0,40,40,9,8,23,0,0,0,0,0,0,0,0,0,50643
17073,5662,572,2307,1516,889,378,488,297,260,82,53,125,37,27,19,8,0,10,4,0,6,191,145,71,14,60,46,46,46,0,0,0,0,0,0,50644
17074,787,89,412,225,27,34,32,7,7,1,0,6,0,0,0,0,0,0,0,0,0,25,21,1,1,19,4,4,4,0,0,0,0,0,0,50645
17075,1295,67,477,348,314,89,131,93,89,10,6,73,4,4,4,0,0,0,0,0,0,38,38,32,0,6,0,0,0,0,0,0,0,0,0,50647
17076,2817,169,1148,1046,302,152,279,164,126,51,15,60,38,38,20,18,0,0,0,0,0,115,115,31,9,75,0,0,0,0,0,0,0,0,0,50648
17077,396,31,241,91,32,1,24,8,8,4,0,4,0,0,0,0,0,0,0,0,0,16,16,2,0,14,0,0,0,0,0,0,0,0,0,50650
17078,2596,182,1239,787,277,111,167,108,97,19,26,52,11,6,0,0,6,5,0,5,0,59,55,11,0,44,4,4,4,0,0,0,0,0,0,50651
17079,67,4,38,19,4,2,10,4,2,2,0,0,2,0,0,0,0,2,2,0,0,6,6,6,0,0,0,0,0,0,0,0,0,0,0,50652
17080,480,36,183,225,19,17,46,31,31,4,24,3,0,0,0,0,0,0,0,0,0,15,6,1,0,5,9,9,0,9,0,0,0,0,0,50653
17081,289,32,141,57,59,0,10,8,8,2,4,2,0,0,0,0,0,0,0,0,0,2,2,0,0,2,0,0,0,0,0,0,0,0,0,50654
17082,553,41,240,161,94,17,36,13,12,7,0,5,1,1,0,1,0,0,0,0,0,23,23,7,0,16,0,0,0,0,0,0,0,0,0,50655
17083,1753,120,770,546,223,94,117,55,43,3,4,36,12,12,11,0,1,0,0,0,0,62,43,8,0,35,19,19,15,4,0,0,0,0,0,50658
17084,3916,432,1777,1090,464,153,402,256,223,116,7,100,33,28,6,22,0,5,5,0,0,146,146,53,4,89,0,0,0,0,0,0,0,0,0,50659
17085,971,61,420,330,84,76,54,5,5,0,2,3,0,0,0,0,0,0,0,0,0,49,49,14,0,35,0,0,0,0,0,0,0,0,0,50660
17086,4859,592,2057,1480,491,239,450,243,209,70,43,96,34,20,11,9,0,14,14,0,0,207,207,193,0,14,0,0,0,0,0,0,0,0,0,50662
17087,18,0,0,13,0,5,0,0,0,0,0,0,0,0,0,0,0,0,0,0,0,0,0,0,0,0,0,0,0,0,0,0,0,0,0,50664
17088,1871,99,701,661,368,42,137,90,69,42,0,27,21,21,12,9,0,0,0,0,0,47,47,16,2,29,0,0,0,0,0,0,0,0,0,50665
17089,617,46,284,165,91,31,39,28,28,2,3,23,0,0,0,0,0,0,0,0,0,11,11,11,0,0,0,0,0,0,0,0,0,0,0,50666
17090,593,34,257,209,72,21,36,16,16,7,0,9,0,0,0,0,0,0,0,0,0,20,20,3,3,14,0,0,0,0,0,0,0,0,0,50667
17091,849,63,355,306,100,25,66,36,30,18,0,12,6,3,3,0,0,3,3,0,0,30,29,0,0,29,1,0,0,0,0,1,1,0,0,50668
17092,1878,82,775,715,226,80,124,66,35,17,0,18,31,31,5,26,0,0,0,0,0,58,53,32,10,11,5,5,0,0,5,0,0,0,0,50669
17093,1482,61,700,562,114,45,96,49,49,2,0,47,0,0,0,0,0,0,0,0,0,47,47,13,4,30,0,0,0,0,0,0,0,0,0,50670
17094,136,9,63,63,1,0,19,2,2,1,0,1,0,0,0,0,0,0,0,0,0,17,17,1,0,16,0,0,0,0,0,0,0,0,0,50671
17095,380,19,114,163,52,32,41,36,36,3,0,33,0,0,0,0,0,0,0,0,0,5,5,3,0,2,0,0,0,0,0,0,0,0,0,50672
17096,188,17,74,88,8,1,14,11,11,0,2,9,0,0,0,0,0,0,0,0,0,3,3,3,0,0,0,0,0,0,0,0,0,0,0,50673
17097,2488,164,1150,717,319,138,163,67,67,35,4,28,0,0,0,0,0,0,0,0,0,96,81,43,16,22,15,0,0,0,0,15,15,0,0,50674
17098,1743,163,594,575,317,94,140,80,74,11,3,60,6,6,6,0,0,0,0,0,0,60,60,27,8,25,0,0,0,0,0,0,0,0,0,50675
17099,1522,169,620,483,188,62,132,58,55,16,4,35,3,3,3,0,0,0,0,0,0,74,62,14,0,48,12,8,3,0,5,4,0,0,4,50676
17100,7400,465,2068,2248,1837,782,1313,523,508,205,75,228,15,15,15,0,0,0,0,0,0,790,782,501,7,274,8,8,0,0,8,0,0,0,0,50677
17101,849,39,296,342,124,48,45,13,13,0,5,8,0,0,0,0,0,0,0,0,0,32,32,14,15,3,0,0,0,0,0,0,0,0,0,50680
17102,362,30,166,124,24,18,27,6,2,0,0,2,4,0,0,0,0,4,4,0,0,21,21,6,0,15,0,0,0,0,0,0,0,0,0,50681
17103,1199,98,463,418,177,43,72,22,22,4,0,18,0,0,0,0,0,0,0,0,0,50,39,13,0,26,11,11,11,0,0,0,0,0,0,50682
17104,19863,1457,6677,6459,3641,1629,1118,599,467,120,122,225,132,103,77,25,1,29,7,10,12,519,450,302,46,102,69,60,30,10,20,9,9,0,0,50701
17105,13143,2053,4856,4059,1709,466,865,575,402,81,60,261,173,113,28,55,30,60,35,24,1,290,261,103,11,147,29,8,8,0,0,21,21,0,0,50702
17106,12950,2595,5199,3949,869,338,1218,542,353,50,125,178,189,60,38,0,22,129,38,0,91,676,655,259,62,334,21,4,2,0,2,17,17,0,0,50703
17107,5697,957,2668,1477,458,137,233,118,104,28,23,53,14,4,4,0,0,10,0,10,0,115,104,24,7,73,11,0,0,0,0,11,0,0,11,50707
17108,6442,537,2276,2437,909,283,502,275,246,91,23,132,29,0,0,0,0,29,0,10,19,227,227,42,0,185,0,0,0,0,0,0,0,0,0,50801
17109,1276,113,514,478,162,9,130,61,41,13,4,24,20,20,8,0,12,0,0,0,0,69,66,35,0,31,3,0,0,0,0,3,0,3,0,50830
17110,1646,128,734,542,194,48,115,46,39,7,5,27,7,7,7,0,0,0,0,0,0,69,69,51,7,11,0,0,0,0,0,0,0,0,0,50833
17111,96,14,52,20,10,0,1,1,1,0,0,1,0,0,0,0,0,0,0,0,0,0,0,0,0,0,0,0,0,0,0,0,0,0,0,50835
17112,241,24,82,97,20,18,11,6,4,0,0,4,2,0,0,0,0,2,2,0,0,5,1,0,0,1,4,0,0,0,0,4,0,0,4,50836
17113,227,4,103,79,34,7,22,17,17,0,0,17,0,0,0,0,0,0,0,0,0,5,5,2,0,3,0,0,0,0,0,0,0,0,0,50837
17114,21,0,12,4,5,0,0,0,0,0,0,0,0,0,0,0,0,0,0,0,0,0,0,0,0,0,0,0,0,0,0,0,0,0,0,50839
17115,423,55,144,162,57,5,23,6,2,0,0,2,4,2,0,2,0,2,0,0,2,17,17,1,0,16,0,0,0,0,0,0,0,0,0,50840
17116,2131,222,852,760,216,81,133,64,55,22,3,30,9,6,4,2,0,3,0,0,3,69,69,31,5,33,0,0,0,0,0,0,0,0,0,50841
17117,67,2,37,23,2,3,3,1,1,1,0,0,0,0,0,0,0,0,0,0,0,2,2,2,0,0,0,0,0,0,0,0,0,0,0,50842
17118,363,26,186,85,63,3,25,9,9,2,0,7,0,0,0,0,0,0,0,0,0,16,11,7,0,4,5,5,5,0,0,0,0,0,0,50843
17119,598,62,261,200,57,18,35,13,11,0,0,11,2,2,0,2,0,0,0,0,0,22,22,8,0,14,0,0,0,0,0,0,0,0,0,50845
17120,855,104,390,232,121,8,44,29,29,8,5,16,0,0,0,0,0,0,0,0,0,15,14,5,0,9,1,1,1,0,0,0,0,0,0,50846
17121,49,4,25,18,2,0,0,0,0,0,0,0,0,0,0,0,0,0,0,0,0,0,0,0,0,0,0,0,0,0,0,0,0,0,0,50847
17122,298,41,139,107,4,7,27,10,10,3,0,7,0,0,0,0,0,0,0,0,0,17,17,2,0,15,0,0,0,0,0,0,0,0,0,50848
17123,1891,155,806,606,235,89,205,61,54,8,3,43,7,7,0,7,0,0,0,0,0,144,122,68,0,54,22,13,13,0,0,9,9,0,0,50849
17124,1335,195,559,395,128,58,68,36,25,5,4,16,11,11,11,0,0,0,0,0,0,32,20,11,0,9,12,0,0,0,0,12,12,0,0,50851
17125,545,30,246,214,36,19,17,5,5,3,0,2,0,0,0,0,0,0,0,0,0,12,12,8,0,4,0,0,0,0,0,0,0,0,0,50853
17126,1556,122,575,538,220,101,61,24,24,15,0,9,0,0,0,0,0,0,0,0,0,37,33,20,0,13,4,4,1,3,0,0,0,0,0,50854
17127,149,16,29,78,22,4,8,5,5,0,0,5,0,0,0,0,0,0,0,0,0,3,1,1,0,0,2,2,2,0,0,0,0,0,0,50857
17128,535,31,224,190,83,7,29,21,21,9,0,12,0,0,0,0,0,0,0,0,0,8,8,8,0,0,0,0,0,0,0,0,0,0,0,50858
17129,489,27,213,188,42,19,39,12,12,3,0,9,0,0,0,0,0,0,0,0,0,27,20,12,0,8,7,2,2,0,0,5,5,0,0,50859
17130,323,117,109,55,34,8,42,7,0,0,0,0,7,0,0,0,0,7,7,0,0,35,27,6,0,21,8,8,8,0,0,0,0,0,0,50860
17131,202,7,88,83,20,4,34,22,22,22,0,0,0,0,0,0,0,0,0,0,0,12,12,8,0,4,0,0,0,0,0,0,0,0,0,50861
17132,98,5,18,54,13,8,11,5,2,0,0,2,3,0,0,0,0,3,3,0,0,6,6,6,0,0,0,0,0,0,0,0,0,0,0,50862
17133,172,13,68,60,29,2,2,2,2,0,0,2,0,0,0,0,0,0,0,0,0,0,0,0,0,0,0,0,0,0,0,0,0,0,0,50863
17134,1452,139,486,549,224,54,137,84,76,0,15,61,8,8,8,0,0,0,0,0,0,53,36,17,2,17,17,17,17,0,0,0,0,0,0,50864
17135,1601,179,611,497,242,72,127,60,47,14,0,33,13,13,13,0,0,0,0,0,0,67,67,43,4,20,0,0,0,0,0,0,0,0,0,51001
17136,1907,230,593,560,430,94,138,73,66,20,0,46,7,7,7,0,0,0,0,0,0,65,33,14,4,15,32,20,20,0,0,12,8,0,4,51002
17137,1170,88,496,367,130,89,88,24,15,13,0,2,9,6,6,0,0,3,0,3,0,64,51,26,0,25,13,13,13,0,0,0,0,0,0,51003
17138,858,71,367,260,115,45,69,28,17,6,0,11,11,3,0,3,0,8,0,0,8,41,33,8,5,20,8,8,6,2,0,0,0,0,0,51004
17139,1119,86,371,474,162,26,97,46,37,14,0,23,9,9,3,0,6,0,0,0,0,51,51,28,0,23,0,0,0,0,0,0,0,0,0,51005
17140,723,96,353,202,51,21,80,39,39,19,0,20,0,0,0,0,0,0,0,0,0,41,29,16,0,13,12,12,12,0,0,0,0,0,0,51006
17141,496,47,143,184,106,16,34,28,27,21,0,6,1,1,1,0,0,0,0,0,0,6,6,4,2,0,0,0,0,0,0,0,0,0,0,51007
17142,86,7,39,23,15,2,3,1,0,0,0,0,1,1,1,0,0,0,0,0,0,2,0,0,0,0,2,2,2,0,0,0,0,0,0,51008
17143,155,17,65,55,18,0,28,9,9,9,0,0,0,0,0,0,0,0,0,0,0,19,19,19,0,0,0,0,0,0,0,0,0,0,0,51009
17144,176,38,54,69,13,2,7,2,2,0,0,2,0,0,0,0,0,0,0,0,0,5,5,0,0,5,0,0,0,0,0,0,0,0,0,51010
17145,43,14,16,11,2,0,6,0,0,0,0,0,0,0,0,0,0,0,0,0,0,6,6,0,6,0,0,0,0,0,0,0,0,0,0,51011
17146,4601,407,1738,1518,668,270,222,88,87,55,0,32,1,1,0,0,1,0,0,0,0,134,50,6,0,44,84,84,84,0,0,0,0,0,0,51012
17147,372,29,82,149,86,26,28,7,7,2,0,5,0,0,0,0,0,0,0,0,0,21,21,0,0,21,0,0,0,0,0,0,0,0,0,51014
17148,1003,167,395,285,119,37,39,23,20,8,2,10,3,3,3,0,0,0,0,0,0,16,8,8,0,0,8,8,8,0,0,0,0,0,0,51016
17149,271,15,106,109,41,0,9,8,8,6,0,2,0,0,0,0,0,0,0,0,0,1,1,0,0,1,0,0,0,0,0,0,0,0,0,51018
17150,538,60,190,216,62,10,39,13,13,0,0,13,0,0,0,0,0,0,0,0,0,26,24,14,0,10,2,2,0,0,2,0,0,0,0,51019
17151,423,28,187,157,37,14,26,12,11,2,0,9,1,1,1,0,0,0,0,0,0,14,14,7,1,6,0,0,0,0,0,0,0,0,0,51020
17152,505,33,180,235,48,9,50,36,35,17,0,18,1,0,0,0,0,1,1,0,0,14,14,5,0,9,0,0,0,0,0,0,0,0,0,51022
17153,2144,378,878,603,207,78,248,78,72,20,10,42,6,3,3,0,0,3,3,0,0,170,117,47,12,58,53,53,53,0,0,0,0,0,0,51023
17154,1291,65,413,527,227,59,131,47,37,7,0,30,10,10,0,10,0,0,0,0,0,84,79,9,10,60,5,5,5,0,0,0,0,0,0,51024
17155,1319,90,476,379,261,113,79,40,40,19,5,16,0,0,0,0,0,0,0,0,0,39,31,7,0,24,8,8,2,6,0,0,0,0,0,51025
17156,551,38,206,228,52,27,53,33,33,21,0,12,0,0,0,0,0,0,0,0,0,20,19,0,10,9,1,1,1,0,0,0,0,0,0,51026
17157,696,46,312,244,83,11,51,22,22,3,2,17,0,0,0,0,0,0,0,0,0,29,29,11,0,18,0,0,0,0,0,0,0,0,0,51027
17158,1434,98,512,503,204,117,123,66,59,46,2,11,7,5,5,0,0,2,0,0,2,57,57,16,0,41,0,0,0,0,0,0,0,0,0,51028
17159,273,10,96,138,29,0,61,59,58,58,0,0,1,1,1,0,0,0,0,0,0,2,2,2,0,0,0,0,0,0,0,0,0,0,0,51029
17160,1274,64,472,439,224,75,74,57,44,15,3,26,13,6,6,0,0,7,7,0,0,17,15,4,0,11,2,2,0,0,2,0,0,0,0,51030
17161,8334,711,3076,2772,1306,469,652,355,343,198,0,145,12,4,0,0,4,8,0,0,8,297,297,227,4,66,0,0,0,0,0,0,0,0,0,51031
17162,335,45,107,125,47,11,6,0,0,0,0,0,0,0,0,0,0,0,0,0,0,6,6,0,0,6,0,0,0,0,0,0,0,0,0,51033
17163,1295,167,585,336,125,82,112,65,46,31,3,12,19,19,9,0,10,0,0,0,0,47,35,23,0,12,12,0,0,0,0,12,12,0,0,51034
17164,1157,100,413,393,208,43,127,99,99,66,0,33,0,0,0,0,0,0,0,0,0,28,28,15,0,13,0,0,0,0,0,0,0,0,0,51035
17165,394,31,169,152,37,5,20,8,8,1,1,6,0,0,0,0,0,0,0,0,0,12,12,11,1,0,0,0,0,0,0,0,0,0,0,51036
17166,245,11,139,67,15,13,15,7,7,5,0,2,0,0,0,0,0,0,0,0,0,8,8,0,0,8,0,0,0,0,0,0,0,0,0,51037
17167,1259,53,541,413,190,62,111,51,36,13,0,23,15,15,2,9,4,0,0,0,0,60,60,38,0,22,0,0,0,0,0,0,0,0,0,51038
17168,1630,62,641,489,303,135,161,93,93,38,4,51,0,0,0,0,0,0,0,0,0,68,68,41,0,27,0,0,0,0,0,0,0,0,0,51039
17169,2687,201,1159,938,336,53,154,77,45,0,18,27,32,24,4,0,20,8,8,0,0,77,74,43,24,7,3,3,0,0,3,0,0,0,0,51040
17170,4054,323,1184,1027,1000,520,790,375,345,223,8,114,30,0,0,0,0,30,0,0,30,415,395,295,0,100,20,1,0,0,1,19,0,0,19,51041
17171,152,16,61,57,11,7,8,2,2,2,0,0,0,0,0,0,0,0,0,0,0,6,6,3,0,3,0,0,0,0,0,0,0,0,0,51044
17172,1058,57,455,347,154,45,66,49,49,32,12,5,0,0,0,0,0,0,0,0,0,17,17,3,0,14,0,0,0,0,0,0,0,0,0,51046
17173,546,23,266,173,64,20,92,67,49,2,0,47,18,18,1,0,17,0,0,0,0,25,23,6,0,17,2,2,0,2,0,0,0,0,0,51047
17174,459,33,135,188,86,17,16,5,5,5,0,0,0,0,0,0,0,0,0,0,0,11,4,2,0,2,7,7,7,0,0,0,0,0,0,51048
17175,357,35,172,78,67,5,14,8,5,3,2,0,3,3,1,0,2,0,0,0,0,6,6,4,2,0,0,0,0,0,0,0,0,0,0,51049
17176,1787,109,734,656,233,55,203,117,103,83,11,9,14,14,14,0,0,0,0,0,0,86,84,67,11,6,2,2,0,0,2,0,0,0,0,51050
17177,67,13,46,8,0,0,5,0,0,0,0,0,0,0,0,0,0,0,0,0,0,5,5,1,0,4,0,0,0,0,0,0,0,0,0,51051
17178,571,27,277,163,92,12,21,0,0,0,0,0,0,0,0,0,0,0,0,0,0,21,21,3,8,10,0,0,0,0,0,0,0,0,0,51052
17179,771,58,340,195,147,31,77,36,13,5,0,8,23,21,8,13,0,2,0,2,0,41,41,16,2,23,0,0,0,0,0,0,0,0,0,51053
17180,3004,214,722,951,818,299,229,91,91,40,0,51,0,0,0,0,0,0,0,0,0,138,132,98,9,25,6,6,6,0,0,0,0,0,0,51054
17181,846,30,298,290,155,73,71,53,50,43,0,7,3,3,0,3,0,0,0,0,0,18,18,0,2,16,0,0,0,0,0,0,0,0,0,51055
17182,398,43,146,174,33,2,16,12,10,9,0,1,2,2,2,0,0,0,0,0,0,4,0,0,0,0,4,4,3,0,1,0,0,0,0,51056
17183,734,45,304,313,66,6,42,27,27,4,0,23,0,0,0,0,0,0,0,0,0,15,15,6,0,9,0,0,0,0,0,0,0,0,0,51058
17184,417,87,182,131,17,0,27,16,7,2,2,3,9,4,0,4,0,5,0,5,0,11,11,2,2,7,0,0,0,0,0,0,0,0,0,51060
17185,411,45,166,153,39,8,32,12,12,0,0,12,0,0,0,0,0,0,0,0,0,20,19,2,2,15,1,1,0,0,1,0,0,0,0,51061
17186,377,20,203,97,6,51,20,8,6,2,0,4,2,2,2,0,0,0,0,0,0,12,12,10,0,2,0,0,0,0,0,0,0,0,0,51062
17187,834,66,361,226,139,42,67,23,23,7,4,12,0,0,0,0,0,0,0,0,0,44,44,27,0,17,0,0,0,0,0,0,0,0,0,51063
17188,593,177,144,231,41,0,16,7,4,0,0,4,3,0,0,0,0,3,0,0,3,9,9,0,0,9,0,0,0,0,0,0,0,0,0,51101
17189,10654,2566,4097,3030,639,322,1161,673,480,122,46,312,193,101,69,0,32,92,37,36,19,488,341,142,29,170,147,82,68,0,14,65,21,0,44,51103
17190,14197,1921,3745,4174,2905,1452,1168,552,511,279,24,208,41,16,13,3,0,25,17,0,8,616,579,278,39,262,37,22,19,0,3,15,0,0,15,51104
17191,5376,1846,1984,1183,301,62,454,243,156,13,41,102,87,25,0,9,16,62,32,0,30,211,168,41,40,87,43,38,22,0,16,5,0,0,5,51105
17192,16324,1104,5750,5911,2305,1254,1938,1121,966,537,56,373,155,155,155,0,0,0,0,0,0,817,736,418,65,253,81,71,40,0,31,10,0,10,0,51106
17193,4291,680,1169,1498,519,425,438,178,98,25,0,73,80,80,80,0,0,0,0,0,0,260,243,53,13,177,17,17,0,0,17,0,0,0,0,51108
17194,2017,274,960,594,131,58,149,82,66,59,0,7,16,16,0,0,16,0,0,0,0,67,67,35,0,32,0,0,0,0,0,0,0,0,0,51109
17195,137,0,37,85,15,0,0,0,0,0,0,0,0,0,0,0,0,0,0,0,0,0,0,0,0,0,0,0,0,0,0,0,0,0,0,51111
17196,4393,372,1609,1324,746,342,461,204,198,54,17,127,6,0,0,0,0,6,0,0,6,257,257,210,0,47,0,0,0,0,0,0,0,0,0,51201
17197,298,25,116,118,26,13,99,39,39,35,2,2,0,0,0,0,0,0,0,0,0,60,57,19,0,38,3,0,0,0,0,3,3,0,0,51230
17198,177,6,83,66,20,2,13,13,13,10,0,3,0,0,0,0,0,0,0,0,0,0,0,0,0,0,0,0,0,0,0,0,0,0,0,51231
17199,658,53,264,251,85,5,37,26,26,4,0,22,0,0,0,0,0,0,0,0,0,11,11,10,0,1,0,0,0,0,0,0,0,0,0,51232
17200,780,59,303,293,94,31,33,15,15,15,0,0,0,0,0,0,0,0,0,0,0,18,18,4,0,14,0,0,0,0,0,0,0,0,0,51234
17201,663,65,381,181,28,8,62,26,19,16,0,3,7,7,0,7,0,0,0,0,0,36,36,24,0,12,0,0,0,0,0,0,0,0,0,51235
17202,1097,208,369,335,137,48,99,55,55,12,5,38,0,0,0,0,0,0,0,0,0,44,13,4,0,9,31,31,8,23,0,0,0,0,0,51237
17203,816,80,302,304,113,17,49,28,28,19,0,9,0,0,0,0,0,0,0,0,0,21,21,11,0,10,0,0,0,0,0,0,0,0,0,51238
17204,2007,304,660,697,292,54,164,63,62,21,3,38,1,1,0,1,0,0,0,0,0,101,101,84,0,17,0,0,0,0,0,0,0,0,0,51239
17205,1145,71,463,446,105,60,85,52,52,19,0,33,0,0,0,0,0,0,0,0,0,33,18,6,0,12,15,15,15,0,0,0,0,0,0,51240
17206,1071,78,418,302,164,109,24,15,14,0,0,14,1,0,0,0,0,1,0,0,1,9,9,2,0,7,0,0,0,0,0,0,0,0,0,51241
17207,155,8,84,52,8,3,9,0,0,0,0,0,0,0,0,0,0,0,0,0,0,9,4,2,0,2,5,0,0,0,0,5,5,0,0,51242
17208,543,80,229,157,66,11,45,30,20,14,0,6,10,10,10,0,0,0,0,0,0,15,12,0,0,12,3,2,2,0,0,1,0,1,0,51243
17209,54,12,20,22,0,0,9,4,2,1,0,1,2,2,2,0,0,0,0,0,0,5,5,5,0,0,0,0,0,0,0,0,0,0,0,51244
17210,914,142,343,283,126,20,117,83,81,29,0,52,2,2,2,0,0,0,0,0,0,34,29,25,0,4,5,5,0,0,5,0,0,0,0,51245
17211,2504,292,918,771,401,122,172,115,84,37,8,39,31,15,0,6,9,16,9,0,7,57,57,38,0,19,0,0,0,0,0,0,0,0,0,51246
17212,2884,389,1111,961,310,113,306,167,167,142,0,25,0,0,0,0,0,0,0,0,0,139,107,106,0,1,32,32,32,0,0,0,0,0,0,51247
17213,1089,111,461,343,130,44,56,44,32,15,0,17,12,0,0,0,0,12,0,12,0,12,7,5,0,2,5,5,5,0,0,0,0,0,0,51248
17214,2372,399,874,652,341,106,131,75,74,47,0,27,1,1,0,0,1,0,0,0,0,56,52,20,0,32,4,4,4,0,0,0,0,0,0,51249
17215,4637,551,1472,1166,961,487,715,483,397,253,12,132,86,60,47,0,13,26,0,0,26,232,215,155,14,46,17,0,0,0,0,17,0,0,17,51250
17216,9113,610,3499,3324,1365,315,545,306,295,99,47,149,11,10,10,0,0,1,0,0,1,239,239,119,0,120,0,0,0,0,0,0,0,0,0,51301
17217,836,67,307,248,130,84,61,2,2,0,0,2,0,0,0,0,0,0,0,0,0,59,3,3,0,0,56,0,0,0,0,56,25,0,31,51331
17218,316,25,129,140,14,8,28,14,13,5,0,8,1,0,0,0,0,1,1,0,0,14,6,3,0,3,8,8,8,0,0,0,0,0,0,51333
17219,5041,621,1584,2067,530,239,408,190,178,82,9,87,12,0,0,0,0,12,12,0,0,218,206,155,17,34,12,12,12,0,0,0,0,0,0,51334
17220,605,62,198,211,111,23,44,26,23,14,0,9,3,3,2,0,1,0,0,0,0,18,18,9,0,9,0,0,0,0,0,0,0,0,0,51338
17221,37,6,13,16,2,0,7,7,7,0,5,2,0,0,0,0,0,0,0,0,0,0,0,0,0,0,0,0,0,0,0,0,0,0,0,51341
17222,819,79,298,260,137,45,57,45,23,4,2,17,22,22,4,0,18,0,0,0,0,12,12,8,0,4,0,0,0,0,0,0,0,0,0,51342
17223,128,9,35,73,10,1,5,2,2,0,1,1,0,0,0,0,0,0,0,0,0,3,1,0,0,1,2,2,2,0,0,0,0,0,0,51343
17224,271,31,127,104,9,0,31,17,17,17,0,0,0,0,0,0,0,0,0,0,0,14,6,0,0,6,8,8,8,0,0,0,0,0,0,51345
17225,1654,169,613,636,189,47,122,37,37,22,0,15,0,0,0,0,0,0,0,0,0,85,85,39,1,45,0,0,0,0,0,0,0,0,0,51346
17226,920,45,381,355,103,36,46,35,32,14,0,18,3,3,0,3,0,0,0,0,0,11,11,5,0,6,0,0,0,0,0,0,0,0,0,51347
17227,369,38,103,178,42,8,41,27,24,17,0,7,3,3,3,0,0,0,0,0,0,14,12,10,0,2,2,2,0,0,2,0,0,0,0,51350
17228,3416,215,1237,1227,528,209,100,45,40,33,0,7,5,5,5,0,0,0,0,0,0,55,55,25,0,30,0,0,0,0,0,0,0,0,0,51351
17229,809,81,381,268,75,4,46,16,12,8,0,4,4,4,4,0,0,0,0,0,0,30,30,21,0,9,0,0,0,0,0,0,0,0,0,51354
17230,611,16,156,174,163,102,47,21,21,0,0,21,0,0,0,0,0,0,0,0,0,26,4,0,3,1,22,21,21,0,0,1,0,0,1,51355
17231,493,38,193,170,62,30,68,21,21,6,0,15,0,0,0,0,0,0,0,0,0,47,47,16,20,11,0,0,0,0,0,0,0,0,0,51357
17232,915,71,363,344,112,25,45,12,12,9,0,3,0,0,0,0,0,0,0,0,0,33,26,4,2,20,7,0,0,0,0,7,0,0,7,51358
17233,6378,476,1614,2471,1279,538,365,226,221,147,54,20,5,2,2,0,0,3,0,0,3,139,100,39,0,61,39,39,16,0,23,0,0,0,0,51360
17234,111,9,59,38,5,0,10,9,9,7,0,2,0,0,0,0,0,0,0,0,0,1,0,0,0,0,1,0,0,0,0,1,1,0,0,51363
17235,359,24,121,170,31,13,19,8,8,6,0,2,0,0,0,0,0,0,0,0,0,11,10,1,0,9,1,1,0,0,1,0,0,0,0,51364
17236,240,10,67,114,37,12,85,15,15,1,0,14,0,0,0,0,0,0,0,0,0,70,70,4,0,66,0,0,0,0,0,0,0,0,0,51365
17237,265,17,83,94,63,8,10,9,9,7,0,2,0,0,0,0,0,0,0,0,0,1,1,0,1,0,0,0,0,0,0,0,0,0,0,51366
17238,8305,763,3290,2621,1292,339,573,320,292,175,12,105,28,25,25,0,0,3,3,0,0,253,238,181,6,51,15,15,15,0,0,0,0,0,0,51401
17239,498,36,280,107,52,23,45,23,12,4,2,6,11,11,0,11,0,0,0,0,0,22,22,10,0,12,0,0,0,0,0,0,0,0,0,51430
17240,268,29,113,64,50,12,12,1,1,0,0,1,0,0,0,0,0,0,0,0,0,11,7,2,0,5,4,4,0,4,0,0,0,0,0,51431
17241,443,48,235,144,4,12,33,13,13,0,0,13,0,0,0,0,0,0,0,0,0,20,20,11,1,8,0,0,0,0,0,0,0,0,0,51433
17242,591,22,266,188,72,43,38,13,13,3,0,10,0,0,0,0,0,0,0,0,0,25,19,11,0,8,6,0,0,0,0,6,0,6,0,51436
17243,769,67,359,236,78,29,53,29,21,14,0,7,8,8,8,0,0,0,0,0,0,24,23,5,0,18,1,0,0,0,0,1,0,0,1,51439
17244,243,26,104,87,23,3,9,6,6,0,0,6,0,0,0,0,0,0,0,0,0,3,2,2,0,0,1,1,1,0,0,0,0,0,0,51440
17245,242,63,92,82,3,2,1,1,1,0,1,0,0,0,0,0,0,0,0,0,0,0,0,0,0,0,0,0,0,0,0,0,0,0,0,51441
17246,5717,1687,1785,1349,605,291,796,445,376,127,19,230,69,61,22,0,39,8,0,0,8,351,319,190,15,114,32,32,20,9,3,0,0,0,0,51442
17247,1247,79,538,401,173,56,53,27,23,19,0,4,4,0,0,0,0,4,0,0,4,26,26,22,0,4,0,0,0,0,0,0,0,0,0,51443
17248,130,15,45,52,14,4,19,2,2,2,0,0,0,0,0,0,0,0,0,0,0,17,17,15,0,2,0,0,0,0,0,0,0,0,0,51444
17249,2140,272,871,615,283,99,99,42,39,27,0,12,3,3,3,0,0,0,0,0,0,57,48,25,0,23,9,5,5,0,0,4,4,0,0,51445
17250,373,41,152,97,65,18,19,0,0,0,0,0,0,0,0,0,0,0,0,0,0,19,19,10,0,9,0,0,0,0,0,0,0,0,0,51446
17251,131,14,65,50,2,0,7,7,2,0,0,2,5,5,0,5,0,0,0,0,0,0,0,0,0,0,0,0,0,0,0,0,0,0,0,51447
17252,461,39,222,144,44,12,13,2,2,2,0,0,0,0,0,0,0,0,0,0,0,11,10,0,0,10,1,0,0,0,0,1,0,0,1,51448
17253,1520,244,428,574,167,107,130,57,57,34,16,7,0,0,0,0,0,0,0,0,0,73,73,29,25,19,0,0,0,0,0,0,0,0,0,51449
17254,1309,124,465,454,193,73,102,34,34,16,0,18,0,0,0,0,0,0,0,0,0,68,54,34,0,20,14,0,0,0,0,14,0,0,14,51450
17255,69,9,32,21,1,6,12,5,4,4,0,0,1,1,1,0,0,0,0,0,0,7,7,0,0,7,0,0,0,0,0,0,0,0,0,51451
17256,568,48,260,145,101,14,35,13,11,4,0,7,2,0,0,0,0,2,0,0,2,22,22,2,3,17,0,0,0,0,0,0,0,0,0,51453
17257,1012,127,431,301,133,20,87,39,22,13,0,9,17,4,4,0,0,13,13,0,0,48,39,24,0,15,9,9,9,0,0,0,0,0,0,51454
17258,1691,112,758,530,230,61,175,79,72,24,10,38,7,0,0,0,0,7,7,0,0,96,84,44,10,30,12,12,7,5,0,0,0,0,0,51455
17259,1101,68,469,321,191,52,71,46,46,8,0,38,0,0,0,0,0,0,0,0,0,25,25,7,0,18,0,0,0,0,0,0,0,0,0,51458
17260,64,7,32,15,10,0,0,0,0,0,0,0,0,0,0,0,0,0,0,0,0,0,0,0,0,0,0,0,0,0,0,0,0,0,0,51459
17261,837,71,382,232,134,18,74,50,21,5,0,16,29,23,23,0,0,6,0,6,0,24,19,13,0,6,5,4,0,0,4,1,1,0,0,51461
17262,741,76,304,287,55,19,18,7,7,3,0,4,0,0,0,0,0,0,0,0,0,11,10,4,0,6,1,1,1,0,0,0,0,0,0,51462
17263,444,52,223,104,55,10,48,26,6,1,0,5,20,20,20,0,0,0,0,0,0,22,6,3,0,3,16,16,0,0,16,0,0,0,0,51463
17264,532,60,251,186,26,9,61,34,34,0,0,34,0,0,0,0,0,0,0,0,0,27,27,16,2,9,0,0,0,0,0,0,0,0,0,51465
17265,647,75,242,202,98,30,53,22,22,1,7,14,0,0,0,0,0,0,0,0,0,31,17,1,12,4,14,14,14,0,0,0,0,0,0,51466
17266,516,35,220,137,80,44,14,9,9,0,0,9,0,0,0,0,0,0,0,0,0,5,5,2,0,3,0,0,0,0,0,0,0,0,0,51467
17267,22575,3488,9445,7190,1915,537,1704,943,747,192,113,442,196,78,31,4,43,118,42,26,50,761,626,184,54,388,135,83,69,14,0,52,28,9,15,51501
17268,24646,2007,7221,8820,4533,2065,2497,1326,1183,406,90,687,143,78,69,9,0,65,6,50,9,1171,969,438,117,414,202,167,109,41,17,35,0,23,12,51503
17269,2455,271,1001,928,182,73,208,91,66,16,0,50,25,0,0,0,0,25,0,0,25,117,89,17,14,58,28,28,15,13,0,0,0,0,0,51510
17270,146,30,57,51,8,0,14,10,10,10,0,0,0,0,0,0,0,0,0,0,0,4,3,3,0,0,1,0,0,0,0,1,0,0,1,51520
17271,1349,107,574,423,179,66,75,40,40,2,0,38,0,0,0,0,0,0,0,0,0,35,30,16,4,10,5,2,2,0,0,3,3,0,0,51521
17272,284,42,100,81,45,16,19,4,4,2,2,0,0,0,0,0,0,0,0,0,0,15,13,2,3,8,2,2,2,0,0,0,0,0,0,51523
17273,719,45,260,281,98,35,56,36,30,0,0,30,6,6,6,0,0,0,0,0,0,20,20,9,0,11,0,0,0,0,0,0,0,0,0,51525
17274,1264,137,460,461,113,93,70,22,22,2,9,11,0,0,0,0,0,0,0,0,0,48,48,32,0,16,0,0,0,0,0,0,0,0,0,51526
17275,280,12,159,97,9,3,21,6,6,2,3,1,0,0,0,0,0,0,0,0,0,15,12,5,0,7,3,3,3,0,0,0,0,0,0,51527
17276,657,151,313,159,27,7,18,3,3,0,0,3,0,0,0,0,0,0,0,0,0,15,15,12,3,0,0,0,0,0,0,0,0,0,0,51528
17277,1322,162,530,330,260,40,151,104,97,29,0,68,7,3,3,0,0,4,0,0,4,47,47,19,6,22,0,0,0,0,0,0,0,0,0,51529
17278,737,80,341,208,100,8,49,27,24,4,1,19,3,3,3,0,0,0,0,0,0,22,8,4,0,4,14,0,0,0,0,14,14,0,0,51530
17279,658,52,309,195,76,26,42,26,26,14,0,12,0,0,0,0,0,0,0,0,0,16,16,10,2,4,0,0,0,0,0,0,0,0,0,51531
17280,460,45,195,140,50,30,43,12,12,1,0,11,0,0,0,0,0,0,0,0,0,31,31,25,0,6,0,0,0,0,0,0,0,0,0,51532
17281,746,68,308,250,100,20,67,35,35,4,0,31,0,0,0,0,0,0,0,0,0,32,24,5,0,19,8,1,0,1,0,7,0,0,7,51533
17282,6272,469,2028,2104,1167,504,722,348,258,97,0,161,90,89,66,0,23,1,0,0,1,374,347,101,28,218,27,8,8,0,0,19,0,0,19,51534
17283,1286,92,472,509,157,56,102,50,41,12,12,17,9,0,0,0,0,9,9,0,0,52,52,10,0,42,0,0,0,0,0,0,0,0,0,51535
17284,397,22,211,103,61,0,5,0,0,0,0,0,0,0,0,0,0,0,0,0,0,5,5,5,0,0,0,0,0,0,0,0,0,0,0,51536
17285,4745,473,1769,1500,717,286,293,177,142,57,13,72,35,27,27,0,0,8,0,0,8,116,82,39,0,43,34,16,16,0,0,18,18,0,0,51537
17286,367,36,196,87,32,16,11,3,0,0,0,0,3,0,0,0,0,3,3,0,0,8,8,0,2,6,0,0,0,0,0,0,0,0,0,51540
17287,244,11,118,88,24,3,4,0,0,0,0,0,0,0,0,0,0,0,0,0,0,4,2,0,0,2,2,2,2,0,0,0,0,0,0,51541
17288,766,67,231,237,212,19,43,29,29,17,0,12,0,0,0,0,0,0,0,0,0,14,14,14,0,0,0,0,0,0,0,0,0,0,0,51542
17289,303,43,125,98,31,6,22,12,10,3,2,5,2,2,2,0,0,0,0,0,0,10,8,5,0,3,2,0,0,0,0,2,2,0,0,51543
17290,616,39,299,166,106,6,97,74,32,29,0,3,42,37,37,0,0,5,5,0,0,23,18,18,0,0,5,0,0,0,0,5,0,0,5,51544
17291,243,39,111,69,24,0,11,2,2,2,0,0,0,0,0,0,0,0,0,0,0,9,2,0,0,2,7,7,0,0,7,0,0,0,0,51545
17292,1797,132,632,624,324,85,186,82,82,21,0,61,0,0,0,0,0,0,0,0,0,104,90,36,2,52,14,11,11,0,0,3,0,0,3,51546
17293,256,15,87,109,27,18,43,18,18,12,0,6,0,0,0,0,0,0,0,0,0,25,25,19,0,6,0,0,0,0,0,0,0,0,0,51548
17294,300,21,116,126,25,12,21,12,12,0,6,6,0,0,0,0,0,0,0,0,0,9,9,4,0,5,0,0,0,0,0,0,0,0,0,51549
17295,118,14,81,15,4,4,10,5,5,2,0,3,0,0,0,0,0,0,0,0,0,5,0,0,0,0,5,5,2,0,3,0,0,0,0,51550
17296,1192,81,437,435,165,74,88,68,56,8,2,46,12,3,2,0,1,9,0,0,9,20,20,0,0,20,0,0,0,0,0,0,0,0,0,51551
17297,246,1,127,55,53,10,12,0,0,0,0,0,0,0,0,0,0,0,0,0,0,12,12,12,0,0,0,0,0,0,0,0,0,0,0,51552
17298,777,41,264,312,115,45,55,12,12,0,2,10,0,0,0,0,0,0,0,0,0,43,43,36,3,4,0,0,0,0,0,0,0,0,0,51553
17299,135,14,25,62,22,12,0,0,0,0,0,0,0,0,0,0,0,0,0,0,0,0,0,0,0,0,0,0,0,0,0,0,0,0,0,51554
17300,3729,321,1510,1301,437,160,298,168,130,42,28,60,38,38,38,0,0,0,0,0,0,130,96,50,4,42,34,14,14,0,0,20,0,20,0,51555
17301,331,36,142,104,46,3,61,41,35,18,2,15,6,6,6,0,0,0,0,0,0,20,20,17,0,3,0,0,0,0,0,0,0,0,0,51556
17302,605,60,257,207,61,20,58,34,32,3,2,27,2,2,0,2,0,0,0,0,0,24,22,2,0,20,2,2,2,0,0,0,0,0,0,51557
17303,474,43,223,174,28,6,14,0,0,0,0,0,0,0,0,0,0,0,0,0,0,14,14,0,0,14,0,0,0,0,0,0,0,0,0,51558
17304,1182,56,448,406,226,46,42,17,17,7,0,10,0,0,0,0,0,0,0,0,0,25,25,10,0,15,0,0,0,0,0,0,0,0,0,51559
17305,1497,154,539,495,232,77,70,22,22,17,0,5,0,0,0,0,0,0,0,0,0,48,48,38,0,10,0,0,0,0,0,0,0,0,0,51560
17306,885,126,306,257,126,70,16,8,8,0,0,8,0,0,0,0,0,0,0,0,0,8,8,4,0,4,0,0,0,0,0,0,0,0,0,51561
17307,278,26,112,93,37,10,8,3,3,0,0,3,0,0,0,0,0,0,0,0,0,5,4,2,0,2,1,1,1,0,0,0,0,0,0,51562
17308,489,20,237,155,47,30,12,8,8,4,0,4,0,0,0,0,0,0,0,0,0,4,4,2,1,1,0,0,0,0,0,0,0,0,0,51563
17309,325,24,137,118,33,13,29,9,7,3,0,4,2,2,2,0,0,0,0,0,0,20,11,0,0,11,9,9,7,2,0,0,0,0,0,51564
17310,400,15,159,201,18,7,28,12,12,0,0,12,0,0,0,0,0,0,0,0,0,16,16,15,0,1,0,0,0,0,0,0,0,0,0,51565
17311,4825,672,1725,1783,475,170,404,175,163,37,18,108,12,8,0,8,0,4,4,0,0,229,227,43,49,135,2,2,2,0,0,0,0,0,0,51566
17312,548,64,230,168,67,19,26,7,5,2,0,3,2,2,2,0,0,0,0,0,0,19,10,10,0,0,9,9,5,4,0,0,0,0,0,51570
17313,502,30,154,183,111,24,13,1,0,0,0,0,1,1,1,0,0,0,0,0,0,12,12,0,0,12,0,0,0,0,0,0,0,0,0,51571
17314,283,17,127,116,22,1,4,1,1,1,0,0,0,0,0,0,0,0,0,0,0,3,3,3,0,0,0,0,0,0,0,0,0,0,0,51572
17315,832,64,292,315,109,52,54,41,32,15,0,17,9,0,0,0,0,9,9,0,0,13,13,0,4,9,0,0,0,0,0,0,0,0,0,51573
17316,1117,8,335,459,212,103,72,53,50,27,0,23,3,3,3,0,0,0,0,0,0,19,19,6,0,13,0,0,0,0,0,0,0,0,0,51575
17317,1210,52,418,437,199,104,96,59,56,19,0,37,3,3,0,0,3,0,0,0,0,37,37,9,13,15,0,0,0,0,0,0,0,0,0,51576
17318,913,86,403,306,74,44,70,33,20,9,0,11,13,2,2,0,0,11,0,0,11,37,37,11,0,26,0,0,0,0,0,0,0,0,0,51577
17319,59,5,22,25,5,2,3,3,3,3,0,0,0,0,0,0,0,0,0,0,0,0,0,0,0,0,0,0,0,0,0,0,0,0,0,51578
17320,1668,120,699,512,261,76,135,67,52,30,0,22,15,4,4,0,0,11,0,0,11,68,59,19,7,33,9,9,9,0,0,0,0,0,0,51579
17321,4354,494,1718,1376,556,210,278,143,100,69,0,31,43,7,0,0,7,36,12,0,24,135,116,48,0,68,19,0,0,0,0,19,0,0,19,51601
17322,128,10,63,35,17,3,2,2,2,0,0,2,0,0,0,0,0,0,0,0,0,0,0,0,0,0,0,0,0,0,0,0,0,0,0,51630
17323,222,13,122,63,15,9,0,0,0,0,0,0,0,0,0,0,0,0,0,0,0,0,0,0,0,0,0,0,0,0,0,0,0,0,0,51631
17324,5007,542,1713,1876,612,264,385,226,208,42,4,162,18,14,4,0,10,4,2,0,2,159,121,33,4,84,38,30,30,0,0,8,8,0,0,51632
17325,391,42,210,106,15,18,45,20,17,5,0,12,3,3,0,0,3,0,0,0,0,25,25,23,0,2,0,0,0,0,0,0,0,0,0,51636
17326,150,13,59,52,19,7,20,9,1,0,0,1,8,8,8,0,0,0,0,0,0,11,10,1,0,9,1,1,0,0,1,0,0,0,0,51637
17327,1009,70,405,337,136,61,51,22,18,5,4,9,4,4,0,0,4,0,0,0,0,29,26,5,0,21,3,3,0,3,0,0,0,0,0,51638
17328,713,35,320,223,107,28,38,22,19,4,0,15,3,3,0,0,3,0,0,0,0,16,16,0,4,12,0,0,0,0,0,0,0,0,0,51639
17329,1082,93,450,303,174,62,74,25,7,3,0,4,18,13,13,0,0,5,0,0,5,49,45,12,6,27,4,4,2,2,0,0,0,0,0,51640
17330,209,13,85,68,43,0,3,3,3,0,0,3,0,0,0,0,0,0,0,0,0,0,0,0,0,0,0,0,0,0,0,0,0,0,0,51645
17331,570,29,270,186,64,21,23,11,8,6,0,2,3,0,0,0,0,3,3,0,0,12,12,10,0,2,0,0,0,0,0,0,0,0,0,51646
17332,68,10,21,20,9,8,48,24,24,0,0,24,0,0,0,0,0,0,0,0,0,24,24,0,0,24,0,0,0,0,0,0,0,0,0,51647
17333,99,0,41,29,23,6,0,0,0,0,0,0,0,0,0,0,0,0,0,0,0,0,0,0,0,0,0,0,0,0,0,0,0,0,0,51648
17334,224,11,85,61,46,21,13,4,4,4,0,0,0,0,0,0,0,0,0,0,0,9,9,0,0,9,0,0,0,0,0,0,0,0,0,51649
17335,295,23,150,85,37,0,11,3,3,0,0,3,0,0,0,0,0,0,0,0,0,8,8,5,0,3,0,0,0,0,0,0,0,0,0,51650
17336,1208,118,502,380,140,68,54,39,29,6,0,23,10,7,5,0,2,3,0,3,0,15,15,4,0,11,0,0,0,0,0,0,0,0,0,51652
17337,920,96,298,332,153,41,114,61,56,2,0,54,5,0,0,0,0,5,0,0,5,53,53,35,4,14,0,0,0,0,0,0,0,0,0,51653
17338,367,51,182,62,51,21,25,4,2,0,0,2,2,2,0,0,2,0,0,0,0,21,21,7,0,14,0,0,0,0,0,0,0,0,0,51654
17339,40,9,14,10,6,1,0,0,0,0,0,0,0,0,0,0,0,0,0,0,0,0,0,0,0,0,0,0,0,0,0,0,0,0,0,51656
17340,28398,3049,10683,7752,4698,2216,3267,1522,1261,460,121,680,261,177,61,55,61,84,8,25,51,1745,1541,697,258,586,204,88,87,0,1,116,59,11,46,52001
17341,10184,627,2656,2980,2340,1581,646,431,359,231,10,118,72,49,40,0,9,23,13,0,10,215,207,120,9,78,8,8,0,0,8,0,0,0,0,52002
17342,9423,407,3104,2564,1985,1363,582,270,270,141,1,128,0,0,0,0,0,0,0,0,0,312,259,126,6,127,53,46,31,0,15,7,7,0,0,52003
17343,256,44,133,59,16,4,22,11,11,8,0,3,0,0,0,0,0,0,0,0,0,11,10,6,3,1,1,1,1,0,0,0,0,0,0,52030
17344,3900,422,1704,1021,498,255,285,180,124,68,0,56,56,17,7,10,0,39,7,0,32,105,88,63,0,25,17,4,0,0,4,13,0,0,13,52031
17345,992,71,439,312,127,43,56,26,14,1,0,13,12,12,12,0,0,0,0,0,0,30,30,9,0,21,0,0,0,0,0,0,0,0,0,52032
17346,2019,149,831,658,298,83,172,96,96,34,8,54,0,0,0,0,0,0,0,0,0,76,66,16,8,42,10,5,5,0,0,5,5,0,0,52033
17347,719,110,365,197,46,1,68,59,53,19,6,28,6,5,5,0,0,1,0,0,1,9,9,8,0,1,0,0,0,0,0,0,0,0,0,52035
17348,885,64,361,284,144,32,64,39,19,7,4,8,20,20,16,0,4,0,0,0,0,25,23,7,2,14,2,2,2,0,0,0,0,0,0,52037
17349,310,10,189,95,15,1,17,15,12,3,0,9,3,3,0,3,0,0,0,0,0,2,2,1,0,1,0,0,0,0,0,0,0,0,0,52038
17350,675,86,305,180,93,11,39,31,5,4,0,1,26,0,0,0,0,26,26,0,0,8,8,7,0,1,0,0,0,0,0,0,0,0,0,52039
17351,3762,454,1632,1023,509,144,215,108,98,37,7,54,10,10,10,0,0,0,0,0,0,107,91,52,8,31,16,0,0,0,0,16,0,0,16,52040
17352,991,114,452,335,85,5,115,48,39,10,3,26,9,9,8,0,1,0,0,0,0,67,62,52,0,10,5,3,0,0,3,2,0,0,2,52041
17353,1157,100,573,334,102,48,92,30,30,12,0,18,0,0,0,0,0,0,0,0,0,62,44,31,0,13,18,6,6,0,0,12,12,0,0,52042
17354,1736,105,858,358,322,93,114,77,71,48,0,23,6,6,2,4,0,0,0,0,0,37,33,29,0,4,4,0,0,0,0,4,0,4,0,52043
17355,142,25,47,27,1,42,2,2,2,2,0,0,0,0,0,0,0,0,0,0,0,0,0,0,0,0,0,0,0,0,0,0,0,0,0,52044
17356,1631,99,626,559,265,82,195,131,131,63,3,65,0,0,0,0,0,0,0,0,0,64,61,28,0,33,3,3,3,0,0,0,0,0,0,52045
17357,1388,130,651,365,137,105,148,123,111,43,10,58,12,12,12,0,0,0,0,0,0,25,25,9,2,14,0,0,0,0,0,0,0,0,0,52046
17358,331,38,151,98,25,19,22,15,15,0,0,15,0,0,0,0,0,0,0,0,0,7,7,3,1,3,0,0,0,0,0,0,0,0,0,52047
17359,251,27,169,52,0,3,59,35,12,4,2,6,23,23,0,23,0,0,0,0,0,24,24,16,0,8,0,0,0,0,0,0,0,0,0,52048
17360,1010,76,456,316,95,67,52,18,16,7,0,9,2,2,2,0,0,0,0,0,0,34,20,9,0,11,14,14,14,0,0,0,0,0,0,52049
17361,363,32,157,137,30,7,65,32,22,22,0,0,10,6,6,0,0,4,4,0,0,33,26,26,0,0,7,4,4,0,0,3,0,0,3,52050
17362,2048,167,959,666,185,71,185,60,38,5,4,29,22,22,15,0,7,0,0,0,0,125,114,34,0,80,11,11,3,0,8,0,0,0,0,52052
17363,639,75,396,118,43,7,81,20,20,7,0,13,0,0,0,0,0,0,0,0,0,61,40,33,0,7,21,21,19,2,0,0,0,0,0,52053
17364,647,79,314,131,100,23,38,14,11,7,0,4,3,0,0,0,0,3,0,0,3,24,24,21,0,3,0,0,0,0,0,0,0,0,0,52054
17365,5413,449,2180,1807,637,340,401,233,201,97,22,82,32,32,32,0,0,0,0,0,0,168,149,125,0,24,19,0,0,0,0,19,7,0,12,52057
17366,5917,609,2812,1685,585,226,582,325,252,129,15,108,73,31,31,0,0,42,0,5,37,257,201,101,13,87,56,32,32,0,0,24,4,20,0,52060
17367,584,63,234,203,41,43,58,34,27,4,0,23,7,2,0,0,2,5,0,0,5,24,22,6,3,13,2,2,0,0,2,0,0,0,0,52064
17368,835,77,431,232,91,4,97,27,18,2,2,14,9,9,9,0,0,0,0,0,0,70,64,31,0,33,6,6,6,0,0,0,0,0,0,52065
17369,78,10,61,4,3,0,0,0,0,0,0,0,0,0,0,0,0,0,0,0,0,0,0,0,0,0,0,0,0,0,0,0,0,0,0,52066
17370,2533,101,755,953,473,251,166,90,88,26,8,54,2,0,0,0,0,2,0,0,2,76,76,50,0,26,0,0,0,0,0,0,0,0,0,52068
17371,1084,126,505,348,81,24,69,43,40,20,4,16,3,3,3,0,0,0,0,0,0,26,26,14,3,9,0,0,0,0,0,0,0,0,0,52069
17372,710,74,351,206,50,29,20,16,16,11,0,5,0,0,0,0,0,0,0,0,0,4,4,0,4,0,0,0,0,0,0,0,0,0,0,52070
17373,218,26,89,85,14,4,11,9,9,0,0,9,0,0,0,0,0,0,0,0,0,2,2,2,0,0,0,0,0,0,0,0,0,0,0,52072
17374,722,71,378,213,34,26,53,42,30,23,0,7,12,12,12,0,0,0,0,0,0,11,11,1,0,10,0,0,0,0,0,0,0,0,0,52073
17375,294,34,147,64,46,3,15,6,6,3,0,3,0,0,0,0,0,0,0,0,0,9,9,0,2,7,0,0,0,0,0,0,0,0,0,52074
17376,1817,184,817,522,200,94,118,56,52,24,0,28,4,4,4,0,0,0,0,0,0,62,49,18,0,31,13,13,13,0,0,0,0,0,0,52076
17377,275,34,131,57,53,0,25,18,16,5,2,9,2,0,0,0,0,2,0,0,2,7,0,0,0,0,7,7,7,0,0,0,0,0,0,52077
17378,693,39,363,223,40,28,39,9,9,9,0,0,0,0,0,0,0,0,0,0,0,30,29,15,0,14,1,1,0,1,0,0,0,0,0,52078
17379,561,71,297,140,53,0,39,24,22,0,0,22,2,0,0,0,0,2,2,0,0,15,15,2,0,13,0,0,0,0,0,0,0,0,0,52079
17380,8487,502,3046,2177,1695,1067,1511,633,615,420,24,171,18,13,12,0,1,5,5,0,0,878,873,584,4,285,5,0,0,0,0,5,0,5,0,52101
17381,1337,85,461,537,212,42,83,29,20,11,0,9,9,9,9,0,0,0,0,0,0,54,50,44,0,6,4,4,4,0,0,0,0,0,0,52132
17382,428,31,237,83,34,43,15,6,5,0,0,5,1,1,1,0,0,0,0,0,0,9,9,9,0,0,0,0,0,0,0,0,0,0,0,52133
17383,242,43,87,102,10,0,30,8,4,0,0,4,4,1,0,1,0,3,3,0,0,22,22,19,0,3,0,0,0,0,0,0,0,0,0,52134
17384,535,87,207,170,54,17,56,16,10,3,0,7,6,0,0,0,0,6,0,6,0,40,32,8,2,22,8,0,0,0,0,8,0,0,8,52135
17385,4124,419,1839,1308,359,199,272,145,135,99,17,19,10,10,7,0,3,0,0,0,0,127,106,87,0,19,21,8,0,8,0,13,13,0,0,52136
17386,360,28,165,117,50,0,9,9,9,0,0,9,0,0,0,0,0,0,0,0,0,0,0,0,0,0,0,0,0,0,0,0,0,0,0,52140
17387,912,81,365,302,110,54,101,71,67,23,4,40,4,0,0,0,0,4,0,0,4,30,20,16,0,4,10,10,7,0,3,0,0,0,0,52141
17388,857,88,273,224,124,148,288,170,170,69,15,86,0,0,0,0,0,0,0,0,0,118,118,75,11,32,0,0,0,0,0,0,0,0,0,52142
17389,817,40,345,316,73,43,78,48,43,28,2,13,5,5,5,0,0,0,0,0,0,30,30,7,1,22,0,0,0,0,0,0,0,0,0,52144
17390,896,109,376,263,132,16,34,21,18,18,0,0,3,3,0,0,3,0,0,0,0,13,13,7,0,6,0,0,0,0,0,0,0,0,0,52146
17391,811,83,378,233,68,49,43,16,16,2,0,14,0,0,0,0,0,0,0,0,0,27,27,16,2,9,0,0,0,0,0,0,0,0,0,52147
17392,1486,120,637,437,193,99,120,23,15,15,0,0,8,8,0,8,0,0,0,0,0,97,84,24,25,35,13,13,7,6,0,0,0,0,0,52151
17393,617,89,286,186,43,13,42,6,6,6,0,0,0,0,0,0,0,0,0,0,0,36,36,11,8,17,0,0,0,0,0,0,0,0,0,52154
17394,815,127,457,171,32,28,40,33,24,24,0,0,9,2,2,0,0,7,0,0,7,7,7,5,0,2,0,0,0,0,0,0,0,0,0,52155
17395,481,13,224,190,25,29,17,0,0,0,0,0,0,0,0,0,0,0,0,0,0,17,4,4,0,0,13,6,0,6,0,7,0,7,0,52156
17396,1286,107,474,463,155,87,52,25,22,5,0,17,3,3,3,0,0,0,0,0,0,27,18,18,0,0,9,6,6,0,0,3,3,0,0,52157
17397,196,21,70,79,23,3,5,4,4,2,0,2,0,0,0,0,0,0,0,0,0,1,1,1,0,0,0,0,0,0,0,0,0,0,0,52158
17398,1819,129,757,706,165,62,147,96,89,30,0,59,7,7,3,4,0,0,0,0,0,51,51,29,0,22,0,0,0,0,0,0,0,0,0,52159
17399,713,48,350,236,70,9,40,12,12,4,0,8,0,0,0,0,0,0,0,0,0,28,19,8,0,11,9,9,9,0,0,0,0,0,0,52160
17400,1128,68,458,432,121,49,123,88,73,14,0,59,15,12,12,0,0,3,0,3,0,35,35,20,0,15,0,0,0,0,0,0,0,0,0,52161
17401,2160,372,822,674,229,63,130,95,68,6,0,62,27,27,0,0,27,0,0,0,0,35,35,7,22,6,0,0,0,0,0,0,0,0,0,52162
17402,193,24,65,74,24,6,7,1,1,1,0,0,0,0,0,0,0,0,0,0,0,6,4,4,0,0,2,2,2,0,0,0,0,0,0,52163
17403,98,15,39,29,12,3,7,6,4,0,0,4,2,0,0,0,0,2,0,0,2,1,1,1,0,0,0,0,0,0,0,0,0,0,0,52164
17404,560,42,252,175,59,32,47,8,8,8,0,0,0,0,0,0,0,0,0,0,0,39,39,31,0,8,0,0,0,0,0,0,0,0,0,52165
17405,83,17,25,27,11,3,0,0,0,0,0,0,0,0,0,0,0,0,0,0,0,0,0,0,0,0,0,0,0,0,0,0,0,0,0,52166
17406,123,20,51,28,23,1,1,0,0,0,0,0,0,0,0,0,0,0,0,0,0,1,1,0,0,1,0,0,0,0,0,0,0,0,0,52168
17407,282,30,100,100,35,17,20,10,10,1,0,9,0,0,0,0,0,0,0,0,0,10,10,0,0,10,0,0,0,0,0,0,0,0,0,52169
17408,375,34,132,121,32,56,45,36,29,2,0,27,7,7,7,0,0,0,0,0,0,9,9,6,0,3,0,0,0,0,0,0,0,0,0,52170
17409,722,100,310,213,62,37,32,12,12,0,2,10,0,0,0,0,0,0,0,0,0,20,20,7,0,13,0,0,0,0,0,0,0,0,0,52171
17410,4180,436,1969,1204,429,142,335,187,126,87,0,39,61,47,13,31,3,14,14,0,0,148,139,81,34,24,9,9,9,0,0,0,0,0,0,52172
17411,2674,299,812,916,456,191,196,73,62,31,5,26,11,11,7,0,4,0,0,0,0,123,101,55,8,38,22,22,0,22,0,0,0,0,0,52175
17412,823,72,357,247,85,62,44,31,8,0,0,8,23,14,14,0,0,9,0,9,0,13,13,0,0,13,0,0,0,0,0,0,0,0,0,52201
17413,682,29,235,287,97,34,69,54,45,10,5,30,9,7,7,0,0,2,2,0,0,15,10,2,0,8,5,5,5,0,0,0,0,0,0,52202
17414,1440,76,406,412,397,149,88,26,15,0,0,15,11,11,0,0,11,0,0,0,0,62,62,46,0,16,0,0,0,0,0,0,0,0,0,52203
17415,6244,589,2483,2163,746,263,539,272,221,144,28,49,51,22,19,0,3,29,15,0,14,267,224,82,34,108,43,12,12,0,0,31,17,14,0,52205
17416,1552,44,469,621,344,74,100,63,59,44,3,12,4,4,4,0,0,0,0,0,0,37,27,19,0,8,10,10,10,0,0,0,0,0,0,52206
17417,246,21,104,72,45,4,0,0,0,0,0,0,0,0,0,0,0,0,0,0,0,0,0,0,0,0,0,0,0,0,0,0,0,0,0,52207
17418,2266,340,985,591,311,39,125,88,48,25,11,12,40,32,29,0,3,8,0,0,8,37,37,8,0,29,0,0,0,0,0,0,0,0,0,52208
17419,787,61,344,258,94,30,72,45,45,2,28,15,0,0,0,0,0,0,0,0,0,27,24,13,0,11,3,0,0,0,0,3,3,0,0,52209
17420,600,63,244,181,77,35,5,3,3,0,0,3,0,0,0,0,0,0,0,0,0,2,2,2,0,0,0,0,0,0,0,0,0,0,0,52210
17421,1866,140,800,478,350,98,78,55,47,4,28,15,8,5,5,0,0,3,0,0,3,23,22,3,12,7,1,1,0,0,1,0,0,0,0,52211
17422,139,21,45,58,15,0,7,7,7,0,0,7,0,0,0,0,0,0,0,0,0,0,0,0,0,0,0,0,0,0,0,0,0,0,0,52212
17423,3093,159,1042,973,699,220,106,64,55,21,0,34,9,9,9,0,0,0,0,0,0,42,42,18,6,18,0,0,0,0,0,0,0,0,0,52213
17424,2079,158,779,801,247,94,100,80,68,22,2,44,12,12,12,0,0,0,0,0,0,20,15,4,1,10,5,5,5,0,0,0,0,0,0,52214
17425,476,42,257,166,7,4,34,8,2,0,0,2,6,6,6,0,0,0,0,0,0,26,26,13,0,13,0,0,0,0,0,0,0,0,0,52215
17426,1023,112,316,349,160,86,49,30,14,5,0,9,16,0,0,0,0,16,8,8,0,19,19,7,3,9,0,0,0,0,0,0,0,0,0,52216
17427,325,49,108,141,24,3,32,12,6,4,0,2,6,0,0,0,0,6,0,6,0,20,18,2,0,16,2,2,0,2,0,0,0,0,0,52217
17428,1261,111,538,465,105,42,110,51,51,11,6,34,0,0,0,0,0,0,0,0,0,59,54,40,3,11,5,5,5,0,0,0,0,0,0,52218
17429,127,21,44,60,0,2,0,0,0,0,0,0,0,0,0,0,0,0,0,0,0,0,0,0,0,0,0,0,0,0,0,0,0,0,0,52219
17430,207,9,102,56,13,27,52,0,0,0,0,0,0,0,0,0,0,0,0,0,0,52,52,28,0,24,0,0,0,0,0,0,0,0,0,52220
17431,116,6,66,35,9,0,7,5,5,5,0,0,0,0,0,0,0,0,0,0,0,2,2,0,0,2,0,0,0,0,0,0,0,0,0,52221
17432,566,45,234,218,61,8,11,3,3,3,0,0,0,0,0,0,0,0,0,0,0,8,8,0,0,8,0,0,0,0,0,0,0,0,0,52222
17433,1163,42,483,345,265,28,71,16,1,0,1,0,15,15,15,0,0,0,0,0,0,55,55,28,26,1,0,0,0,0,0,0,0,0,0,52223
17434,1600,73,513,678,268,68,156,97,74,45,9,20,23,23,15,8,0,0,0,0,0,59,59,27,2,30,0,0,0,0,0,0,0,0,0,52224
17435,241,23,142,73,3,0,12,4,4,0,0,4,0,0,0,0,0,0,0,0,0,8,6,3,0,3,2,0,0,0,0,2,2,0,0,52225
17436,1883,41,459,787,411,185,110,64,53,19,3,31,11,11,6,0,5,0,0,0,0,46,43,19,3,21,3,3,3,0,0,0,0,0,0,52227
17437,1896,62,401,827,449,157,123,60,48,38,4,6,12,0,0,0,0,12,12,0,0,63,43,18,0,25,20,13,0,0,13,7,4,0,3,52228
17438,611,96,240,188,77,10,36,13,11,4,4,3,2,2,2,0,0,0,0,0,0,23,22,3,0,19,1,1,0,1,0,0,0,0,0,52229
17439,210,17,76,80,36,1,21,0,0,0,0,0,0,0,0,0,0,0,0,0,0,21,21,0,0,21,0,0,0,0,0,0,0,0,0,52231
17440,126,4,86,27,7,2,1,0,0,0,0,0,0,0,0,0,0,0,0,0,0,1,1,1,0,0,0,0,0,0,0,0,0,0,0,52232
17441,4931,363,1405,1647,1117,399,301,143,130,41,0,89,13,13,13,0,0,0,0,0,0,158,158,51,0,107,0,0,0,0,0,0,0,0,0,52233
17442,525,40,209,176,79,21,32,9,9,6,0,3,0,0,0,0,0,0,0,0,0,23,23,10,0,13,0,0,0,0,0,0,0,0,0,52235
17443,492,69,142,163,92,26,32,12,12,0,0,12,0,0,0,0,0,0,0,0,0,20,20,11,0,9,0,0,0,0,0,0,0,0,0,52236
17444,878,80,446,266,65,21,136,64,64,43,4,17,0,0,0,0,0,0,0,0,0,72,72,25,14,33,0,0,0,0,0,0,0,0,0,52237
17445,17873,1471,3689,5356,4075,3282,1568,771,671,275,96,300,100,96,4,26,66,4,0,0,4,797,763,342,47,374,34,18,18,0,0,16,0,0,16,52240
17446,12269,522,1924,2713,4071,3039,651,291,226,111,0,115,65,41,15,0,26,24,0,0,24,360,360,101,40,219,0,0,0,0,0,0,0,0,0,52241
17447,19,0,16,3,0,0,1326,655,655,141,8,506,0,0,0,0,0,0,0,0,0,671,671,168,51,452,0,0,0,0,0,0,0,0,0,52242
17448,12138,499,1402,2632,3613,3992,3505,1483,1467,323,48,1096,16,16,8,8,0,0,0,0,0,2022,2000,713,111,1176,22,22,22,0,0,0,0,0,0,52245
17449,12653,357,1075,2499,3542,5180,1361,702,674,129,47,498,28,28,28,0,0,0,0,0,0,659,627,181,58,388,32,32,24,0,8,0,0,0,0,52246
17450,3516,1006,1063,783,547,117,277,159,67,42,0,25,92,17,8,0,9,75,31,0,44,118,55,27,0,28,63,0,0,0,0,63,7,0,56,52247
17451,1288,113,532,422,158,63,56,34,34,13,0,21,0,0,0,0,0,0,0,0,0,22,15,12,0,3,7,0,0,0,0,7,7,0,0,52248
17452,807,67,299,334,89,18,60,28,28,14,3,11,0,0,0,0,0,0,0,0,0,32,32,25,0,7,0,0,0,0,0,0,0,0,0,52249
17453,391,20,227,108,27,9,22,9,7,0,1,6,2,2,2,0,0,0,0,0,0,13,10,4,0,6,3,0,0,0,0,3,0,0,3,52251
17454,1845,130,542,659,324,190,169,77,77,40,0,37,0,0,0,0,0,0,0,0,0,92,88,37,0,51,4,0,0,0,0,4,4,0,0,52253
17455,509,54,236,139,58,22,42,18,18,5,0,13,0,0,0,0,0,0,0,0,0,24,24,8,5,11,0,0,0,0,0,0,0,0,0,52254
17456,806,76,332,304,70,24,56,7,3,0,0,3,4,4,4,0,0,0,0,0,0,49,47,37,0,10,2,0,0,0,0,2,2,0,0,52255
17457,152,3,68,67,14,0,7,2,2,0,0,2,0,0,0,0,0,0,0,0,0,5,3,2,0,1,2,2,0,0,2,0,0,0,0,52257
17458,2391,237,999,831,244,80,264,147,105,35,0,70,42,28,28,0,0,14,14,0,0,117,81,37,24,20,36,36,0,0,36,0,0,0,0,52301
17459,25229,1168,6334,9114,6168,2445,1594,807,710,323,47,340,97,61,39,20,2,36,20,0,16,787,669,329,19,321,118,68,68,0,0,50,0,0,50,52302
17460,499,32,158,211,52,46,27,17,17,3,3,11,0,0,0,0,0,0,0,0,0,10,10,0,2,8,0,0,0,0,0,0,0,0,0,52305
17461,1306,108,579,426,177,16,85,50,22,4,0,18,28,28,18,0,10,0,0,0,0,35,17,8,4,5,18,18,12,3,3,0,0,0,0,52306
17462,34,0,0,9,16,9,12,12,12,0,0,12,0,0,0,0,0,0,0,0,0,0,0,0,0,0,0,0,0,0,0,0,0,0,0,52307
17463,100,7,57,30,4,2,3,0,0,0,0,0,0,0,0,0,0,0,0,0,0,3,3,0,1,2,0,0,0,0,0,0,0,0,0,52308
17464,301,57,147,41,38,18,30,26,26,0,0,26,0,0,0,0,0,0,0,0,0,4,4,2,0,2,0,0,0,0,0,0,0,0,0,52309
17465,4573,403,2001,1262,722,185,245,119,100,51,0,49,19,0,0,0,0,19,0,0,19,126,126,82,0,44,0,0,0,0,0,0,0,0,0,52310
17466,84,11,29,35,9,0,3,2,2,2,0,0,0,0,0,0,0,0,0,0,0,1,1,1,0,0,0,0,0,0,0,0,0,0,0,52312
17467,299,4,168,99,18,10,19,9,0,0,0,0,9,9,9,0,0,0,0,0,0,10,8,0,0,8,2,2,2,0,0,0,0,0,0,52313
17468,3309,90,572,969,998,680,835,417,417,179,6,232,0,0,0,0,0,0,0,0,0,418,418,256,0,162,0,0,0,0,0,0,0,0,0,52314
17469,670,30,215,295,85,45,52,24,16,4,0,12,8,2,2,0,0,6,6,0,0,28,25,4,0,21,3,3,3,0,0,0,0,0,0,52315
17470,1092,56,463,390,140,43,122,62,47,4,0,43,15,15,4,11,0,0,0,0,0,60,60,46,0,14,0,0,0,0,0,0,0,0,0,52316
17471,10102,267,1583,3352,3158,1742,383,237,223,67,0,156,14,14,14,0,0,0,0,0,0,146,106,0,16,90,40,22,22,0,0,18,18,0,0,52317
17472,795,35,368,311,48,33,135,67,66,2,56,8,1,1,1,0,0,0,0,0,0,68,68,58,0,10,0,0,0,0,0,0,0,0,0,52318
17473,796,65,387,234,73,37,56,33,31,9,0,22,2,2,2,0,0,0,0,0,0,23,23,5,0,18,0,0,0,0,0,0,0,0,0,52320
17474,391,26,145,151,69,0,5,3,3,0,0,3,0,0,0,0,0,0,0,0,0,2,2,0,0,2,0,0,0,0,0,0,0,0,0,52321
17475,1773,83,663,684,286,57,65,28,26,10,0,16,2,2,2,0,0,0,0,0,0,37,34,30,0,4,3,3,3,0,0,0,0,0,0,52322
17476,806,55,423,247,67,14,83,43,36,18,4,14,7,7,7,0,0,0,0,0,0,40,31,0,0,31,9,5,2,3,0,4,0,4,0,52323
17477,1216,24,460,496,184,52,164,78,34,20,7,7,44,44,2,0,42,0,0,0,0,86,86,31,0,55,0,0,0,0,0,0,0,0,0,52324
17478,687,25,179,322,102,59,34,16,16,16,0,0,0,0,0,0,0,0,0,0,0,18,3,3,0,0,15,15,15,0,0,0,0,0,0,52325
17479,318,37,160,84,34,3,10,8,5,0,0,5,3,0,0,0,0,3,3,0,0,2,0,0,0,0,2,0,0,0,0,2,2,0,0,52326
17480,2321,110,881,717,290,323,133,56,56,28,0,28,0,0,0,0,0,0,0,0,0,77,53,16,0,37,24,21,18,0,3,3,0,0,3,52327
17481,1784,62,279,562,609,272,148,63,63,40,6,17,0,0,0,0,0,0,0,0,0,85,85,27,5,53,0,0,0,0,0,0,0,0,0,52328
17482,493,5,301,128,51,8,25,19,17,9,0,8,2,2,0,0,2,0,0,0,0,6,0,0,0,0,6,6,0,0,6,0,0,0,0,52329
17483,621,67,236,238,59,21,25,2,2,0,0,2,0,0,0,0,0,0,0,0,0,23,23,22,0,1,0,0,0,0,0,0,0,0,0,52330
17484,1388,65,612,535,139,37,73,52,36,16,0,20,16,16,15,1,0,0,0,0,0,21,21,4,0,17,0,0,0,0,0,0,0,0,0,52332
17485,4612,80,1082,1482,1269,699,431,218,204,130,14,60,14,12,12,0,0,2,0,2,0,213,205,102,0,103,8,8,8,0,0,0,0,0,0,52333
17486,166,8,103,46,9,0,9,9,9,0,0,9,0,0,0,0,0,0,0,0,0,0,0,0,0,0,0,0,0,0,0,0,0,0,0,52334
17487,454,31,217,128,60,18,38,13,10,2,3,5,3,3,3,0,0,0,0,0,0,25,25,16,0,9,0,0,0,0,0,0,0,0,0,52335
17488,1637,91,592,707,170,77,137,45,39,11,0,28,6,2,0,0,2,4,4,0,0,92,90,16,0,74,2,2,2,0,0,0,0,0,0,52336
17489,573,35,261,182,86,9,99,68,30,4,0,26,38,38,17,18,3,0,0,0,0,31,20,11,0,9,11,11,3,8,0,0,0,0,0,52337
17490,2137,44,527,761,560,245,141,88,84,41,0,43,4,4,0,4,0,0,0,0,0,53,52,16,4,32,1,1,1,0,0,0,0,0,0,52338
17491,2785,424,1102,814,304,141,283,175,133,26,21,86,42,16,0,0,16,26,22,4,0,108,84,40,0,44,24,6,6,0,0,18,11,3,4,52339
17492,1464,78,321,613,281,171,80,46,41,0,18,23,5,5,5,0,0,0,0,0,0,34,15,11,4,0,19,0,0,0,0,19,19,0,0,52340
17493,804,65,268,251,180,40,24,14,14,0,0,14,0,0,0,0,0,0,0,0,0,10,10,0,0,10,0,0,0,0,0,0,0,0,0,52341
17494,2004,279,804,656,159,106,235,102,87,12,13,62,15,15,15,0,0,0,0,0,0,133,91,28,0,63,42,42,0,42,0,0,0,0,0,52342
17495,944,107,347,321,136,33,44,15,9,3,0,6,6,3,3,0,0,3,0,0,3,29,20,0,0,20,9,9,0,9,0,0,0,0,0,52345
17496,706,39,240,272,122,33,60,30,30,22,2,6,0,0,0,0,0,0,0,0,0,30,29,2,2,25,1,1,1,0,0,0,0,0,0,52346
17497,1103,56,515,368,134,30,54,31,29,12,0,17,2,0,0,0,0,2,0,0,2,23,23,17,0,6,0,0,0,0,0,0,0,0,0,52347
17498,40,1,18,19,2,0,1,0,0,0,0,0,0,0,0,0,0,0,0,0,0,1,1,1,0,0,0,0,0,0,0,0,0,0,0,52348
17499,4910,434,1827,1739,709,201,447,219,185,31,19,135,34,7,0,0,7,27,27,0,0,228,228,138,26,64,0,0,0,0,0,0,0,0,0,52349
17500,932,50,215,344,214,109,112,64,61,40,0,21,3,3,0,3,0,0,0,0,0,48,48,32,0,16,0,0,0,0,0,0,0,0,0,52351
17501,1156,89,496,358,160,53,75,60,60,12,0,48,0,0,0,0,0,0,0,0,0,15,15,3,0,12,0,0,0,0,0,0,0,0,0,52352
17502,6246,679,2126,2085,975,381,623,260,238,143,35,60,22,15,15,0,0,7,7,0,0,363,265,92,74,99,98,98,68,14,16,0,0,0,0,52353
17503,234,17,118,71,15,13,10,10,10,10,0,0,0,0,0,0,0,0,0,0,0,0,0,0,0,0,0,0,0,0,0,0,0,0,0,52354
17504,187,8,87,74,16,2,3,2,2,0,0,2,0,0,0,0,0,0,0,0,0,1,1,1,0,0,0,0,0,0,0,0,0,0,0,52355
17505,1956,140,738,695,295,88,180,144,144,70,0,74,0,0,0,0,0,0,0,0,0,36,32,4,0,28,4,4,4,0,0,0,0,0,0,52356
17506,2586,100,919,908,405,254,201,117,117,38,17,62,0,0,0,0,0,0,0,0,0,84,84,22,10,52,0,0,0,0,0,0,0,0,0,52358
17507,200,27,64,62,34,13,9,0,0,0,0,0,0,0,0,0,0,0,0,0,0,9,9,9,0,0,0,0,0,0,0,0,0,0,0,52359
17508,3000,208,860,1104,558,270,190,97,93,14,12,67,4,0,0,0,0,4,0,0,4,93,89,37,0,52,4,0,0,0,0,4,0,0,4,52361
17509,514,55,182,188,68,21,25,5,5,3,0,2,0,0,0,0,0,0,0,0,0,20,12,4,0,8,8,8,8,0,0,0,0,0,0,52362
17510,1690,282,538,591,166,113,24,7,7,0,0,7,0,0,0,0,0,0,0,0,0,17,17,17,0,0,0,0,0,0,0,0,0,0,0,52401
17511,26017,1651,5627,8974,6964,2801,2632,1303,1103,483,45,575,200,135,76,22,37,65,65,0,0,1329,1244,637,53,554,85,27,27,0,0,58,0,0,58,52402
17512,15977,989,3694,5292,3438,2564,757,385,332,116,22,194,53,10,0,0,10,43,0,0,43,372,300,116,0,184,72,46,12,14,20,26,11,15,0,52403
17513,23583,2046,8088,8834,3423,1192,3039,1573,1342,530,108,704,231,153,77,59,17,78,51,0,27,1466,1305,668,147,490,161,115,48,57,10,46,21,0,25,52404
17514,16891,921,5273,6535,2938,1224,991,508,487,286,71,130,21,21,9,8,4,0,0,0,0,483,445,235,42,168,38,29,29,0,0,9,0,0,9,52405
17515,4769,104,780,1291,1828,766,464,276,261,106,11,144,15,15,15,0,0,0,0,0,0,188,188,65,7,116,0,0,0,0,0,0,0,0,0,52411
17516,20105,3308,7218,6206,2124,1249,1783,872,688,255,71,362,184,82,25,46,11,102,41,11,50,911,744,227,86,431,167,90,58,14,18,77,50,2,25,52501
17517,704,71,328,199,68,38,54,20,20,3,1,16,0,0,0,0,0,0,0,0,0,34,26,12,0,14,8,0,0,0,0,8,8,0,0,52530
17518,4084,561,1642,1072,589,220,332,181,180,46,49,85,1,1,0,0,1,0,0,0,0,151,151,116,0,35,0,0,0,0,0,0,0,0,0,52531
17519,1110,116,532,399,54,9,107,44,44,0,0,44,0,0,0,0,0,0,0,0,0,63,47,30,0,17,16,3,0,0,3,13,0,13,0,52533
17520,153,34,84,32,3,0,3,3,0,0,0,0,3,3,0,3,0,0,0,0,0,0,0,0,0,0,0,0,0,0,0,0,0,0,0,52534
17521,671,126,278,155,61,51,28,6,3,1,0,2,3,3,0,1,2,0,0,0,0,22,22,19,0,3,0,0,0,0,0,0,0,0,0,52535
17522,738,57,328,241,88,24,15,13,13,11,0,2,0,0,0,0,0,0,0,0,0,2,0,0,0,0,2,2,2,0,0,0,0,0,0,52536
17523,4185,612,1464,1424,517,168,371,176,45,0,0,45,131,11,11,0,0,120,96,0,24,195,143,64,12,67,52,14,14,0,0,38,0,15,23,52537
17524,948,71,463,311,70,33,114,46,35,9,0,26,11,3,3,0,0,8,8,0,0,68,68,12,44,12,0,0,0,0,0,0,0,0,0,52540
17525,273,67,112,59,12,23,34,29,24,4,2,18,5,0,0,0,0,5,5,0,0,5,3,3,0,0,2,0,0,0,0,2,2,0,0,52542
17526,329,5,91,105,87,41,20,13,8,0,0,8,5,5,5,0,0,0,0,0,0,7,7,0,0,7,0,0,0,0,0,0,0,0,0,52543
17527,5395,672,1883,1762,754,324,318,157,125,45,29,51,32,20,0,20,0,12,0,10,2,161,112,74,0,38,49,42,27,0,15,7,0,7,0,52544
17528,57,10,25,10,12,0,10,3,3,1,0,2,0,0,0,0,0,0,0,0,0,7,4,0,0,4,3,3,0,0,3,0,0,0,0,52548
17529,415,121,150,106,27,11,22,11,8,0,2,6,3,3,3,0,0,0,0,0,0,11,8,5,1,2,3,3,0,3,0,0,0,0,0,52549
17530,357,43,223,74,15,2,21,10,8,0,2,6,2,0,0,0,0,2,0,2,0,11,11,1,0,10,0,0,0,0,0,0,0,0,0,52550
17531,506,39,218,108,99,42,32,16,16,9,0,7,0,0,0,0,0,0,0,0,0,16,16,0,0,16,0,0,0,0,0,0,0,0,0,52551
17532,689,58,232,276,108,15,66,19,16,16,0,0,3,0,0,0,0,3,3,0,0,47,19,1,0,18,28,0,0,0,0,28,2,0,26,52552
17533,1248,92,596,350,169,41,86,53,53,14,0,39,0,0,0,0,0,0,0,0,0,33,22,4,0,18,11,7,7,0,0,4,0,0,4,52553
17534,945,129,452,329,27,8,22,16,16,2,2,12,0,0,0,0,0,0,0,0,0,6,6,6,0,0,0,0,0,0,0,0,0,0,0,52554
17535,252,35,121,58,17,21,15,6,2,0,0,2,4,4,4,0,0,0,0,0,0,9,9,7,0,2,0,0,0,0,0,0,0,0,0,52555
17536,9111,399,2574,2749,1757,1632,683,379,333,89,17,227,46,46,9,13,24,0,0,0,0,304,274,66,0,208,30,17,17,0,0,13,13,0,0,52556
17537,34,0,16,10,8,0,6,6,6,0,0,6,0,0,0,0,0,0,0,0,0,0,0,0,0,0,0,0,0,0,0,0,0,0,0,52557
17538,350,32,144,94,62,18,27,27,27,0,0,27,0,0,0,0,0,0,0,0,0,0,0,0,0,0,0,0,0,0,0,0,0,0,0,52560
17539,560,56,268,161,65,10,23,8,5,2,0,3,3,3,3,0,0,0,0,0,0,15,13,1,3,9,2,2,2,0,0,0,0,0,0,52561
17540,1245,136,497,417,172,23,91,61,50,6,16,28,11,0,0,0,0,11,0,8,3,30,30,10,0,20,0,0,0,0,0,0,0,0,0,52563
17541,1379,159,523,464,179,54,70,42,35,15,12,8,7,2,0,0,2,5,0,0,5,28,28,4,0,24,0,0,0,0,0,0,0,0,0,52565
17542,109,9,57,30,6,7,4,3,3,0,0,3,0,0,0,0,0,0,0,0,0,1,1,0,0,1,0,0,0,0,0,0,0,0,0,52566
17543,498,21,227,167,78,5,6,2,2,2,0,0,0,0,0,0,0,0,0,0,0,4,3,3,0,0,1,0,0,0,0,1,0,1,0,52567
17544,494,97,203,127,34,33,15,7,7,7,0,0,0,0,0,0,0,0,0,0,0,8,8,2,0,6,0,0,0,0,0,0,0,0,0,52569
17545,598,128,240,202,26,2,62,25,9,3,0,6,16,1,1,0,0,15,6,0,9,37,31,9,0,22,6,0,0,0,0,6,0,0,6,52570
17546,1141,34,498,413,157,39,68,25,25,2,13,10,0,0,0,0,0,0,0,0,0,43,43,2,0,41,0,0,0,0,0,0,0,0,0,52571
17547,815,111,322,233,115,34,78,22,19,7,0,12,3,3,3,0,0,0,0,0,0,56,43,3,0,40,13,0,0,0,0,13,0,0,13,52572
17548,71,12,15,28,16,0,0,0,0,0,0,0,0,0,0,0,0,0,0,0,0,0,0,0,0,0,0,0,0,0,0,0,0,0,0,52573
17549,458,65,214,120,46,13,84,50,12,12,0,0,38,33,33,0,0,5,0,2,3,34,28,7,0,21,6,6,6,0,0,0,0,0,0,52574
17550,377,58,199,97,23,0,12,9,8,0,0,8,1,1,0,1,0,0,0,0,0,3,3,3,0,0,0,0,0,0,0,0,0,0,0,52576
17551,10084,997,3867,2837,1796,587,831,452,423,195,73,155,29,29,29,0,0,0,0,0,0,379,319,195,30,94,60,44,0,23,21,16,0,16,0,52577
17552,286,9,118,97,50,12,23,3,0,0,0,0,3,3,3,0,0,0,0,0,0,20,20,0,0,20,0,0,0,0,0,0,0,0,0,52580
17553,429,56,119,165,76,13,0,0,0,0,0,0,0,0,0,0,0,0,0,0,0,0,0,0,0,0,0,0,0,0,0,0,0,0,0,52581
17554,282,21,140,109,12,0,27,18,0,0,0,0,18,18,18,0,0,0,0,0,0,9,9,0,3,6,0,0,0,0,0,0,0,0,0,52583
17555,310,56,124,86,25,19,27,21,18,6,2,10,3,3,3,0,0,0,0,0,0,6,6,6,0,0,0,0,0,0,0,0,0,0,0,52584
17556,583,41,202,222,89,29,69,33,30,13,0,17,3,3,3,0,0,0,0,0,0,36,28,10,6,12,8,3,0,0,3,5,3,0,2,52585
17557,364,82,144,81,48,9,3,0,0,0,0,0,0,0,0,0,0,0,0,0,0,3,1,0,0,1,2,2,0,0,2,0,0,0,0,52586
17558,57,16,29,0,12,0,0,0,0,0,0,0,0,0,0,0,0,0,0,0,0,0,0,0,0,0,0,0,0,0,0,0,0,0,0,52588
17559,763,140,328,214,77,4,64,30,20,5,0,15,10,6,0,6,0,4,0,0,4,34,11,0,4,7,23,0,0,0,0,23,0,12,11,52590
17560,2281,299,936,749,178,119,93,62,56,16,0,40,6,6,6,0,0,0,0,0,0,31,31,4,27,0,0,0,0,0,0,0,0,0,0,52591
17561,95,11,28,33,13,10,10,9,9,4,0,5,0,0,0,0,0,0,0,0,0,1,0,0,0,0,1,1,1,0,0,0,0,0,0,52593
17562,341,22,148,130,33,8,4,0,0,0,0,0,0,0,0,0,0,0,0,0,0,4,0,0,0,0,4,4,4,0,0,0,0,0,0,52594
17563,277,18,90,104,59,6,21,3,0,0,0,0,3,3,1,2,0,0,0,0,0,18,18,16,1,1,0,0,0,0,0,0,0,0,0,52595
17564,20588,1970,7071,7445,2801,1301,1614,870,687,136,94,457,183,155,123,32,0,28,0,0,28,744,681,290,99,292,63,63,63,0,0,0,0,0,0,52601
17565,314,50,126,130,8,0,24,9,9,0,0,9,0,0,0,0,0,0,0,0,0,15,9,9,0,0,6,6,0,6,0,0,0,0,0,52619
17566,607,58,298,209,25,17,11,9,2,0,0,2,7,3,0,3,0,4,0,0,4,2,2,2,0,0,0,0,0,0,0,0,0,0,0,52620
17567,512,39,149,208,95,21,31,25,20,2,0,18,5,5,3,2,0,0,0,0,0,6,6,4,1,1,0,0,0,0,0,0,0,0,0,52621
17568,1342,75,522,501,176,68,95,58,50,30,5,15,8,8,8,0,0,0,0,0,0,37,35,30,2,3,2,0,0,0,0,2,0,2,0,52623
17569,148,12,35,69,21,11,0,0,0,0,0,0,0,0,0,0,0,0,0,0,0,0,0,0,0,0,0,0,0,0,0,0,0,0,0,52624
17570,1937,88,907,620,251,71,76,42,30,23,3,4,12,12,5,7,0,0,0,0,0,34,27,2,0,25,7,7,7,0,0,0,0,0,0,52625
17571,1088,128,506,282,145,27,109,55,48,28,0,20,7,0,0,0,0,7,7,0,0,54,46,32,6,8,8,3,0,3,0,5,5,0,0,52626
17572,9444,967,3802,3181,996,498,721,324,254,112,12,130,70,70,28,42,0,0,0,0,0,397,287,161,44,82,110,82,47,35,0,28,0,12,16,52627
17573,315,34,144,113,24,0,47,47,47,6,0,41,0,0,0,0,0,0,0,0,0,0,0,0,0,0,0,0,0,0,0,0,0,0,0,52630
17574,9050,1053,3548,2885,1033,531,606,323,261,69,23,169,62,36,36,0,0,26,9,0,17,283,196,32,65,99,87,47,7,0,40,40,11,8,21,52632
17575,500,39,195,196,65,5,38,17,16,3,0,13,1,1,0,0,1,0,0,0,0,21,19,18,0,1,2,1,0,1,0,1,0,0,1,52635
17576,1762,159,639,633,251,80,100,77,72,50,2,20,5,5,5,0,0,0,0,0,0,23,20,9,0,11,3,3,3,0,0,0,0,0,0,52637
17577,365,13,178,122,29,23,20,17,17,9,0,8,0,0,0,0,0,0,0,0,0,3,3,3,0,0,0,0,0,0,0,0,0,0,0,52638
17578,1382,174,675,412,73,48,85,17,13,0,0,13,4,0,0,0,0,4,0,0,4,68,58,25,4,29,10,8,4,0,4,2,0,0,2,52639
17579,1087,75,455,361,154,42,102,34,20,6,14,0,14,6,0,0,6,8,0,0,8,68,57,17,0,40,11,9,2,0,7,2,0,0,2,52640
17580,8160,543,3218,2613,1268,518,703,344,316,63,10,243,28,10,10,0,0,18,0,0,18,359,306,120,6,180,53,48,48,0,0,5,5,0,0,52641
17581,234,8,64,102,54,6,3,1,1,1,0,0,0,0,0,0,0,0,0,0,0,2,2,0,0,2,0,0,0,0,0,0,0,0,0,52644
17582,2215,164,869,786,310,86,90,60,57,9,0,48,3,0,0,0,0,3,0,0,3,30,13,0,0,13,17,17,0,0,17,0,0,0,0,52645
17583,191,14,70,98,3,6,9,7,6,0,0,6,1,1,1,0,0,0,0,0,0,2,2,2,0,0,0,0,0,0,0,0,0,0,0,52646
17584,152,22,53,43,25,9,17,7,7,1,2,4,0,0,0,0,0,0,0,0,0,10,10,10,0,0,0,0,0,0,0,0,0,0,0,52647
17585,695,107,245,246,93,4,46,7,7,0,0,7,0,0,0,0,0,0,0,0,0,39,39,33,0,6,0,0,0,0,0,0,0,0,0,52649
17586,586,14,258,251,36,27,51,46,46,46,0,0,0,0,0,0,0,0,0,0,0,5,0,0,0,0,5,5,0,5,0,0,0,0,0,52650
17587,557,35,237,233,40,12,22,6,6,1,0,5,0,0,0,0,0,0,0,0,0,16,6,0,0,6,10,10,2,2,6,0,0,0,0,52651
17588,2435,299,1051,690,314,81,162,62,41,0,0,41,21,21,16,0,5,0,0,0,0,100,45,22,0,23,55,55,4,0,51,0,0,0,0,52653
17589,1286,196,424,452,143,71,104,71,71,3,5,63,0,0,0,0,0,0,0,0,0,33,26,2,0,24,7,3,3,0,0,4,0,0,4,52654
17590,3052,259,1339,1043,275,136,176,100,100,28,0,72,0,0,0,0,0,0,0,0,0,76,64,48,10,6,12,12,12,0,0,0,0,0,0,52655
17591,1759,121,787,648,131,72,118,73,63,15,0,48,10,0,0,0,0,10,0,0,10,45,39,24,0,15,6,6,0,3,3,0,0,0,0,52656
17592,34,2,10,16,3,3,0,0,0,0,0,0,0,0,0,0,0,0,0,0,0,0,0,0,0,0,0,0,0,0,0,0,0,0,0,52657
17593,656,13,303,175,133,32,71,28,28,0,0,28,0,0,0,0,0,0,0,0,0,43,43,26,0,17,0,0,0,0,0,0,0,0,0,52658
17594,986,147,287,333,177,42,60,40,27,3,0,24,13,13,0,3,10,0,0,0,0,20,20,8,0,12,0,0,0,0,0,0,0,0,0,52659
17595,126,0,55,52,19,0,0,0,0,0,0,0,0,0,0,0,0,0,0,0,0,0,0,0,0,0,0,0,0,0,0,0,0,0,0,52660
17596,69,6,41,13,8,1,1,0,0,0,0,0,0,0,0,0,0,0,0,0,0,1,1,1,0,0,0,0,0,0,0,0,0,0,0,52701
17597,669,119,350,128,52,20,60,40,40,0,0,40,0,0,0,0,0,0,0,0,0,20,14,12,0,2,6,6,0,6,0,0,0,0,0,52720
17598,545,58,209,184,74,20,35,22,11,9,0,2,11,11,11,0,0,0,0,0,0,13,13,8,0,5,0,0,0,0,0,0,0,0,0,52721
17599,24742,915,5135,7268,7104,4320,1603,871,722,201,29,492,149,121,64,26,31,28,0,27,1,732,685,273,41,371,47,2,0,0,2,45,0,0,45,52722
17600,3138,317,976,1041,474,330,183,74,63,48,0,15,11,7,3,4,0,4,4,0,0,109,100,62,0,38,9,9,0,0,9,0,0,0,0,52726
17601,295,10,137,122,26,0,27,11,11,0,0,11,0,0,0,0,0,0,0,0,0,16,16,6,0,10,0,0,0,0,0,0,0,0,0,52727
17602,655,79,325,219,26,6,54,26,21,0,4,17,5,0,0,0,0,5,0,2,3,28,24,0,7,17,4,0,0,0,0,4,4,0,0,52728
17603,580,17,241,238,66,18,30,15,15,2,0,13,0,0,0,0,0,0,0,0,0,15,15,5,0,10,0,0,0,0,0,0,0,0,0,52729
17604,3489,298,1300,1377,374,140,314,88,88,30,0,58,0,0,0,0,0,0,0,0,0,226,151,61,0,90,75,22,0,22,0,53,0,53,0,52730
17605,454,33,158,201,54,8,55,52,34,17,0,17,18,16,16,0,0,2,0,0,2,3,3,3,0,0,0,0,0,0,0,0,0,0,0,52731
17606,19453,2383,7017,6685,2444,924,1459,845,689,258,84,347,156,124,74,32,18,32,0,0,32,614,534,264,39,231,80,48,24,16,8,32,11,21,0,52732
17607,272,92,103,53,16,8,33,12,4,0,0,4,8,3,0,0,3,5,5,0,0,21,14,0,3,11,7,4,4,0,0,3,0,0,3,52737
17608,2208,566,763,643,160,76,226,104,85,4,22,59,19,0,0,0,0,19,19,0,0,122,110,55,4,51,12,12,2,0,10,0,0,0,0,52738
17609,576,160,220,188,6,2,65,47,44,17,0,27,3,0,0,0,0,3,0,0,3,18,18,0,0,18,0,0,0,0,0,0,0,0,0,52739
17610,5299,278,1814,1974,888,345,466,197,188,67,20,101,9,0,0,0,0,9,0,9,0,269,269,70,28,171,0,0,0,0,0,0,0,0,0,52742
17611,329,18,148,82,61,20,71,6,4,1,0,3,2,2,2,0,0,0,0,0,0,65,63,48,0,15,2,2,2,0,0,0,0,0,0,52745
17612,757,162,235,245,108,7,21,10,10,6,0,4,0,0,0,0,0,0,0,0,0,11,10,6,0,4,1,1,1,0,0,0,0,0,0,52746
17613,1479,135,588,511,175,70,128,71,71,16,4,51,0,0,0,0,0,0,0,0,0,57,54,31,0,23,3,0,0,0,0,3,3,0,0,52747
17614,5769,225,1399,2193,1388,564,588,299,267,112,21,134,32,32,10,22,0,0,0,0,0,289,247,186,0,61,42,42,0,0,42,0,0,0,0,52748
17615,785,105,282,290,85,23,101,66,66,46,7,13,0,0,0,0,0,0,0,0,0,35,35,23,0,12,0,0,0,0,0,0,0,0,0,52749
17616,372,31,170,124,32,15,67,39,39,8,0,31,0,0,0,0,0,0,0,0,0,28,16,4,0,12,12,1,1,0,0,11,11,0,0,52750
17617,602,12,278,212,69,31,71,48,36,12,0,24,12,3,3,0,0,9,0,0,9,23,11,4,0,7,12,12,12,0,0,0,0,0,0,52751
17618,335,37,131,128,39,0,13,7,7,3,0,4,0,0,0,0,0,0,0,0,0,6,2,0,0,2,4,4,4,0,0,0,0,0,0,52752
17619,4030,103,1111,1341,880,595,211,158,158,21,29,108,0,0,0,0,0,0,0,0,0,53,53,23,10,20,0,0,0,0,0,0,0,0,0,52753
17620,953,107,313,330,179,24,116,62,26,13,0,13,36,0,0,0,0,36,0,36,0,54,53,2,0,51,1,1,1,0,0,0,0,0,0,52754
17621,1344,68,493,501,233,49,125,88,88,18,0,70,0,0,0,0,0,0,0,0,0,37,37,8,2,27,0,0,0,0,0,0,0,0,0,52755
17622,1375,20,330,508,325,192,92,59,52,11,3,38,7,7,0,7,0,0,0,0,0,33,33,7,3,23,0,0,0,0,0,0,0,0,0,52756
17623,100,10,59,22,8,1,3,3,3,1,0,2,0,0,0,0,0,0,0,0,0,0,0,0,0,0,0,0,0,0,0,0,0,0,0,52757
17624,150,13,43,75,16,3,6,1,1,1,0,0,0,0,0,0,0,0,0,0,0,5,5,0,0,5,0,0,0,0,0,0,0,0,0,52758
17625,325,51,218,37,19,0,0,0,0,0,0,0,0,0,0,0,0,0,0,0,0,0,0,0,0,0,0,0,0,0,0,0,0,0,0,52760
17626,20161,3188,6548,6982,2422,1021,1553,669,614,250,34,330,55,26,13,0,13,29,0,17,12,884,679,399,123,157,205,201,159,24,18,4,0,0,4,52761
17627,254,2,110,85,39,18,25,15,15,0,0,15,0,0,0,0,0,0,0,0,0,10,10,6,0,4,0,0,0,0,0,0,0,0,0,52765
17628,624,85,195,291,49,4,57,56,52,2,2,48,4,4,4,0,0,0,0,0,0,1,1,0,0,1,0,0,0,0,0,0,0,0,0,52766
17629,134,14,46,38,18,18,0,0,0,0,0,0,0,0,0,0,0,0,0,0,0,0,0,0,0,0,0,0,0,0,0,0,0,0,0,52767
17630,837,32,294,312,130,69,38,28,28,2,0,26,0,0,0,0,0,0,0,0,0,10,10,6,2,2,0,0,0,0,0,0,0,0,0,52768
17631,515,37,179,192,82,25,82,69,66,35,0,31,3,3,3,0,0,0,0,0,0,13,13,12,1,0,0,0,0,0,0,0,0,0,0,52769
17632,3626,370,1475,1073,544,164,246,129,122,32,0,90,7,7,0,0,7,0,0,0,0,117,107,81,0,26,10,0,0,0,0,10,0,0,10,52772
17633,1555,94,627,503,276,55,127,58,48,33,8,7,10,10,10,0,0,0,0,0,0,69,57,35,5,17,12,9,9,0,0,3,0,0,3,52773
17634,71,2,32,32,5,0,4,0,0,0,0,0,0,0,0,0,0,0,0,0,0,4,4,1,0,3,0,0,0,0,0,0,0,0,0,52774
17635,2960,604,1007,1040,207,102,206,101,73,7,0,66,28,28,0,28,0,0,0,0,0,105,105,30,22,53,0,0,0,0,0,0,0,0,0,52776
17636,968,116,362,362,106,22,91,48,46,6,0,40,2,0,0,0,0,2,2,0,0,43,42,0,2,40,1,1,1,0,0,0,0,0,0,52777
17637,2604,120,1033,929,388,134,288,154,147,53,0,94,7,7,0,7,0,0,0,0,0,134,134,18,51,65,0,0,0,0,0,0,0,0,0,52778
17638,750,124,293,227,91,15,47,47,7,0,0,7,40,6,0,0,6,34,0,0,34,0,0,0,0,0,0,0,0,0,0,0,0,0,0,52801
17639,6647,1308,2480,2357,377,125,624,263,160,52,14,94,103,59,19,14,26,44,35,0,9,361,313,89,37,187,48,11,6,5,0,37,8,0,29,52802
17640,14920,1305,3695,5009,3412,1499,1265,724,619,161,58,400,105,54,9,27,18,51,4,5,42,541,478,140,0,338,63,30,24,0,6,33,9,0,24,52803
17641,18086,1714,5796,7059,2407,1110,1845,929,852,319,12,521,77,62,62,0,0,15,0,0,15,916,839,330,63,446,77,55,55,0,0,22,13,9,0,52804
17642,18319,1566,5974,6039,3435,1305,1360,674,602,142,20,440,72,51,11,15,25,21,0,11,10,686,530,202,30,298,156,127,97,0,30,29,0,0,29,52806
17643,9140,610,1866,2278,2912,1474,569,240,213,73,14,126,27,27,27,0,0,0,0,0,0,329,298,131,0,167,31,31,31,0,0,0,0,0,0,52807
17644,1358,134,503,460,209,52,70,30,23,5,6,12,7,5,0,5,0,2,2,0,0,40,37,12,0,25,3,0,0,0,0,3,0,3,0,53001
17645,1685,178,664,592,238,13,186,121,106,34,17,55,15,15,12,3,0,0,0,0,0,65,65,20,0,45,0,0,0,0,0,0,0,0,0,53002
17646,92,0,14,59,0,19,0,0,0,0,0,0,0,0,0,0,0,0,0,0,0,0,0,0,0,0,0,0,0,0,0,0,0,0,0,53003
17647,2162,145,687,707,420,203,248,146,125,83,11,31,21,15,15,0,0,6,6,0,0,102,88,64,0,24,14,14,14,0,0,0,0,0,0,53004
17648,13865,459,2587,3516,4802,2501,991,519,500,160,34,306,19,19,10,9,0,0,0,0,0,472,454,177,0,277,18,18,18,0,0,0,0,0,0,53005
17649,1217,117,534,336,146,84,70,31,29,16,0,13,2,2,2,0,0,0,0,0,0,39,39,24,0,15,0,0,0,0,0,0,0,0,0,53006
17650,1405,167,496,455,238,49,48,21,21,21,0,0,0,0,0,0,0,0,0,0,0,27,27,11,4,12,0,0,0,0,0,0,0,0,0,53007
17651,5514,536,2387,1700,633,258,352,202,175,90,8,77,27,23,21,0,2,4,4,0,0,150,146,79,10,57,4,4,4,0,0,0,0,0,0,53010
17652,1650,138,666,624,176,46,153,95,68,21,5,42,27,18,8,7,3,9,9,0,0,58,41,14,3,24,17,17,4,0,13,0,0,0,0,53011
17653,12954,305,2529,3831,4362,1927,997,547,527,209,0,318,20,20,10,0,10,0,0,0,0,450,434,176,30,228,16,16,16,0,0,0,0,0,0,53012
17654,2193,117,735,731,384,226,172,98,98,71,0,27,0,0,0,0,0,0,0,0,0,74,64,41,5,18,10,10,10,0,0,0,0,0,0,53013
17655,5765,657,2696,1558,683,171,373,250,204,82,0,122,46,27,22,0,5,19,13,0,6,123,113,60,3,50,10,2,0,0,2,8,8,0,0,53014
17656,1736,156,686,494,287,113,205,108,92,38,3,51,16,13,3,0,10,3,3,0,0,97,69,30,3,36,28,15,13,0,2,13,13,0,0,53015
17657,265,50,121,82,11,1,6,6,6,2,2,2,0,0,0,0,0,0,0,0,0,0,0,0,0,0,0,0,0,0,0,0,0,0,0,53016
17658,3900,158,1005,1403,880,454,320,183,139,36,24,79,44,44,44,0,0,0,0,0,0,137,137,104,0,33,0,0,0,0,0,0,0,0,0,53017
17659,5443,116,974,1489,1904,960,599,376,336,146,0,190,40,39,8,0,31,1,0,0,1,223,206,75,18,113,17,0,0,0,0,17,17,0,0,53018
17660,1289,198,552,362,126,51,87,54,37,14,0,23,17,17,12,0,5,0,0,0,0,33,31,18,0,13,2,2,0,0,2,0,0,0,0,53019
17661,2647,152,1072,796,429,198,160,74,66,20,0,46,8,5,5,0,0,3,0,0,3,86,77,33,9,35,9,9,3,6,0,0,0,0,0,53020
17662,3145,239,1233,1111,415,147,409,299,205,74,11,120,94,88,25,7,56,6,0,0,6,110,102,27,6,69,8,8,8,0,0,0,0,0,0,53021
17663,13016,735,3553,3794,3183,1751,836,372,347,139,56,152,25,11,0,11,0,14,14,0,0,464,426,201,12,213,38,9,9,0,0,29,0,29,0,53022
17664,1710,248,789,491,112,70,121,98,66,15,0,51,32,25,4,0,21,7,0,0,7,23,17,6,1,10,6,6,0,0,6,0,0,0,0,53023
17665,11536,526,2693,3689,2859,1769,900,352,316,124,19,173,36,19,0,0,19,17,0,17,0,548,459,122,23,314,89,89,89,0,0,0,0,0,0,53024
17666,15008,1196,5118,5146,2491,1057,1146,505,466,262,22,182,39,39,34,0,5,0,0,0,0,641,620,274,0,346,21,10,10,0,0,11,0,11,0,53027
17667,13784,497,2866,4024,4241,2156,1333,626,576,206,40,330,50,17,0,17,0,33,23,0,10,707,673,339,33,301,34,2,2,0,0,32,26,6,0,53029
17668,23,0,6,12,5,0,0,0,0,0,0,0,0,0,0,0,0,0,0,0,0,0,0,0,0,0,0,0,0,0,0,0,0,0,0,53031
17669,3275,414,1300,1068,356,137,230,92,92,25,23,44,0,0,0,0,0,0,0,0,0,138,114,40,0,74,24,18,11,0,7,6,0,6,0,53032
17670,3487,112,1079,1265,799,232,257,116,104,38,11,55,12,0,0,0,0,12,12,0,0,141,141,57,19,65,0,0,0,0,0,0,0,0,0,53033
17671,1344,118,633,415,138,40,142,82,61,25,0,36,21,13,3,0,10,8,8,0,0,60,60,41,9,10,0,0,0,0,0,0,0,0,0,53034
17672,1583,171,666,509,172,65,183,116,109,42,11,56,7,6,0,0,6,1,0,1,0,67,61,34,4,23,6,4,0,4,0,2,0,0,2,53035
17673,1731,96,521,737,274,103,111,77,58,32,16,10,19,19,9,0,10,0,0,0,0,34,34,21,0,13,0,0,0,0,0,0,0,0,0,53036
17674,6344,573,1858,2268,1195,450,258,174,153,50,0,103,21,0,0,0,0,21,0,0,21,84,65,65,0,0,19,19,19,0,0,0,0,0,0,53037
17675,2670,202,826,921,500,221,260,142,105,31,18,56,37,37,2,35,0,0,0,0,0,118,118,53,8,57,0,0,0,0,0,0,0,0,0,53038
17676,3428,464,1398,1156,313,97,304,127,101,41,8,52,26,24,13,0,11,2,0,0,2,177,153,75,17,61,24,19,19,0,0,5,5,0,0,53039
17677,5550,643,1989,1846,814,258,541,209,200,122,0,78,9,9,9,0,0,0,0,0,0,332,308,191,0,117,24,24,24,0,0,0,0,0,0,53040
17678,4909,451,2006,1610,558,284,361,216,172,67,37,68,44,37,27,4,6,7,7,0,0,145,130,68,0,62,15,3,0,3,0,12,0,0,12,53042
17679,1619,28,228,427,570,366,131,64,64,22,20,22,0,0,0,0,0,0,0,0,0,67,67,27,0,40,0,0,0,0,0,0,0,0,0,53044
17680,15159,585,2685,3523,5276,3090,1072,585,508,222,71,215,77,53,0,29,24,24,0,0,24,487,468,139,19,310,19,19,9,0,10,0,0,0,0,53045
17681,820,68,346,262,110,34,41,17,13,4,9,0,4,4,0,4,0,0,0,0,0,24,24,13,0,11,0,0,0,0,0,0,0,0,0,53046
17682,81,2,27,26,23,3,14,14,14,0,0,14,0,0,0,0,0,0,0,0,0,0,0,0,0,0,0,0,0,0,0,0,0,0,0,53047
17683,2056,192,815,779,185,85,153,93,80,32,0,48,13,5,5,0,0,8,0,0,8,60,53,34,2,17,7,7,7,0,0,0,0,0,0,53048
17684,1585,113,601,533,265,73,119,59,52,43,3,6,7,7,7,0,0,0,0,0,0,60,48,19,17,12,12,0,0,0,0,12,0,0,12,53049
17685,4669,779,1914,1251,586,139,288,141,106,52,0,54,35,17,17,0,0,18,0,0,18,147,109,42,0,67,38,38,7,31,0,0,0,0,0,53050
17686,25601,1547,6716,7222,6927,3189,1791,875,776,264,81,431,99,71,63,8,0,28,0,0,28,916,873,415,31,427,43,16,0,0,16,27,21,0,6,53051
17687,1246,178,538,330,133,67,58,44,37,20,0,17,7,5,5,0,0,2,0,2,0,14,14,8,0,6,0,0,0,0,0,0,0,0,0,53057
17688,2335,21,470,783,742,319,235,140,133,50,10,73,7,4,4,0,0,3,0,0,3,95,88,47,2,39,7,7,7,0,0,0,0,0,0,53058
17689,1320,129,552,477,122,40,76,27,20,10,5,5,7,7,3,0,4,0,0,0,0,49,43,17,7,19,6,6,3,3,0,0,0,0,0,53059
17690,3727,457,1667,920,478,205,296,167,143,69,5,69,24,21,14,4,3,3,0,0,3,129,125,49,0,76,4,4,4,0,0,0,0,0,0,53061
17691,1160,172,441,375,124,48,83,43,41,14,0,27,2,2,0,0,2,0,0,0,0,40,40,17,0,23,0,0,0,0,0,0,0,0,0,53063
17692,1566,102,675,508,193,88,124,67,65,33,3,29,2,2,2,0,0,0,0,0,0,57,53,31,0,22,4,4,2,2,0,0,0,0,0,53065
17693,23597,1110,6213,7366,5994,2914,1651,858,762,308,50,404,96,78,55,7,16,18,7,3,8,793,743,336,71,336,50,47,6,33,8,3,0,3,0,53066
17694,457,0,88,163,173,33,0,0,0,0,0,0,0,0,0,0,0,0,0,0,0,0,0,0,0,0,0,0,0,0,0,0,0,0,0,53069
17695,3299,260,1244,982,616,197,253,88,77,12,5,60,11,11,6,5,0,0,0,0,0,165,141,76,0,65,24,24,24,0,0,0,0,0,0,53070
17696,17109,413,3963,4966,4910,2857,1206,525,418,191,0,227,107,91,69,8,14,16,0,16,0,681,591,271,53,267,90,90,40,11,39,0,0,0,0,53072
17697,9957,890,3204,3002,2054,807,1148,775,684,287,11,386,91,90,80,0,10,1,0,0,1,373,354,189,0,165,19,3,0,0,3,16,16,0,0,53073
17698,8677,557,2663,2642,1818,997,730,427,402,231,30,141,25,4,0,0,4,21,0,11,10,303,288,180,9,99,15,15,15,0,0,0,0,0,0,53074
17699,2214,200,864,745,303,102,152,75,47,17,0,30,28,8,8,0,0,20,6,14,0,77,69,30,0,39,8,5,0,0,5,3,3,0,0,53075
17700,2157,128,461,619,733,216,237,139,139,61,6,72,0,0,0,0,0,0,0,0,0,98,87,55,12,20,11,8,8,0,0,3,3,0,0,53076
17701,1486,126,624,496,183,57,141,71,61,50,0,11,10,7,7,0,0,3,0,0,3,70,66,32,0,34,4,4,4,0,0,0,0,0,0,53078
17702,998,93,492,281,110,22,68,25,20,5,3,12,5,2,2,0,0,3,0,0,3,43,40,20,0,20,3,3,3,0,0,0,0,0,0,53079
17703,3833,283,1384,1246,609,311,316,239,217,41,44,132,22,19,0,0,19,3,0,0,3,77,77,49,0,28,0,0,0,0,0,0,0,0,0,53080
17704,28737,3812,10920,8759,3585,1661,2003,779,584,227,37,320,195,142,86,27,29,53,31,0,22,1224,1071,528,148,395,153,128,81,27,20,25,15,0,10,53081
17705,14103,649,5363,4385,2458,1248,1126,581,494,255,59,180,87,68,50,0,18,19,0,0,19,545,452,256,49,147,93,67,57,0,10,26,25,0,1,53083
17706,8051,661,3185,2497,1221,487,513,231,218,51,21,146,13,13,2,11,0,0,0,0,0,282,272,145,21,106,10,10,10,0,0,0,0,0,0,53085
17707,5564,355,2012,1715,1005,477,598,371,257,60,61,136,114,114,101,13,0,0,0,0,0,227,218,58,9,151,9,9,9,0,0,0,0,0,0,53086
17708,344,25,173,118,13,15,22,18,15,2,0,13,3,3,3,0,0,0,0,0,0,4,4,0,4,0,0,0,0,0,0,0,0,0,0,53088
17709,12450,701,3534,4244,2862,1109,849,360,339,142,6,191,21,21,7,0,14,0,0,0,0,489,460,245,15,200,29,10,10,0,0,19,19,0,0,53089
17710,15305,1120,5242,5673,2248,1022,1079,540,466,159,75,232,74,52,30,6,16,22,0,0,22,539,460,263,50,147,79,79,61,18,0,0,0,0,0,53090
17711,1492,174,653,478,150,37,120,48,45,31,0,14,3,3,3,0,0,0,0,0,0,72,68,51,0,17,4,4,4,0,0,0,0,0,0,53091
17712,15042,250,2188,3602,5291,3711,1019,470,433,169,0,264,37,37,37,0,0,0,0,0,0,549,531,179,13,339,18,18,18,0,0,0,0,0,0,53092
17713,1334,89,542,472,183,48,133,56,27,10,3,14,29,25,12,7,6,4,0,0,4,77,70,18,14,38,7,7,7,0,0,0,0,0,0,53093
17714,12360,1191,4831,3583,1802,953,1406,611,522,212,56,254,89,47,35,12,0,42,0,0,42,795,746,355,75,316,49,37,12,0,25,12,12,0,0,53094
17715,19130,1701,5769,6182,3771,1707,1252,691,600,257,26,317,91,72,63,6,3,19,0,19,0,561,548,462,35,51,13,13,13,0,0,0,0,0,0,53095
17716,3680,66,559,921,1432,702,603,241,241,91,16,134,0,0,0,0,0,0,0,0,0,362,351,114,33,204,11,11,11,0,0,0,0,0,0,53097
17717,8473,982,2895,2720,1292,584,623,403,324,154,41,129,79,32,29,3,0,47,0,47,0,220,185,105,7,73,35,35,11,0,24,0,0,0,0,53098
17718,2547,93,747,893,584,230,181,104,90,29,9,52,14,14,0,0,14,0,0,0,0,77,71,42,5,24,6,3,3,0,0,3,3,0,0,53103
17719,3718,313,1434,1183,522,266,337,188,159,48,7,104,29,28,13,14,1,1,0,0,1,149,135,45,19,71,14,14,14,0,0,0,0,0,0,53104
17720,20461,1758,7984,6735,2709,1275,1466,838,662,205,71,386,176,141,104,37,0,35,10,14,11,628,539,170,54,315,89,41,22,19,0,48,48,0,0,53105
17721,2399,180,951,811,301,156,94,64,64,10,32,22,0,0,0,0,0,0,0,0,0,30,30,10,0,20,0,0,0,0,0,0,0,0,0,53108
17722,12497,1572,4246,3895,2267,517,700,394,314,43,37,234,80,80,80,0,0,0,0,0,0,306,290,126,11,153,16,16,16,0,0,0,0,0,0,53110
17723,1800,255,691,557,188,109,165,62,51,39,4,8,11,11,2,9,0,0,0,0,0,103,94,30,5,59,9,9,6,3,0,0,0,0,0,53114
17724,10560,1410,3841,3359,1442,508,873,504,362,98,14,250,142,125,114,11,0,17,3,0,14,369,302,137,56,109,67,63,44,3,16,4,4,0,0,53115
17725,5317,262,1714,1650,1025,666,373,191,174,50,12,112,17,17,10,0,7,0,0,0,0,182,157,70,9,78,25,25,25,0,0,0,0,0,0,53118
17726,3536,83,1349,1170,615,319,396,202,187,43,21,123,15,15,0,0,15,0,0,0,0,194,176,67,14,95,18,18,8,6,4,0,0,0,0,53119
17727,6769,367,2308,2274,1236,584,473,279,258,112,12,134,21,21,6,0,15,0,0,0,0,194,154,42,31,81,40,40,17,0,23,0,0,0,0,53120
17728,12791,969,4203,4343,2294,982,1075,542,447,222,49,176,95,88,64,12,12,7,7,0,0,533,421,157,84,180,112,95,47,48,0,17,0,17,0,53121
17729,4248,42,404,596,1731,1475,321,175,161,42,0,119,14,14,14,0,0,0,0,0,0,146,113,14,0,99,33,33,17,0,16,0,0,0,0,53122
17730,1297,37,178,378,404,300,57,26,23,10,0,13,3,3,0,0,3,0,0,0,0,31,31,14,0,17,0,0,0,0,0,0,0,0,0,53125
17731,4626,415,1488,1552,697,474,329,194,176,83,20,73,18,6,6,0,0,12,0,0,12,135,133,29,30,74,2,2,2,0,0,0,0,0,0,53126
17732,5705,596,1982,1941,855,331,570,342,306,105,48,153,36,36,3,33,0,0,0,0,0,228,170,55,28,87,58,58,43,15,0,0,0,0,0,53128
17733,10344,496,2822,3042,2690,1294,433,248,228,27,27,174,20,0,0,0,0,20,12,0,8,185,175,79,0,96,10,10,10,0,0,0,0,0,0,53129
17734,5664,385,1762,1548,1365,604,469,247,194,84,20,90,53,41,41,0,0,12,0,0,12,222,217,144,32,41,5,5,5,0,0,0,0,0,0,53130
17735,24597,1909,6414,7719,5559,2996,1857,1121,992,298,29,665,129,62,36,0,26,67,0,0,67,736,694,214,43,437,42,30,23,0,7,12,0,0,12,53132
17736,1370,95,482,530,162,101,181,113,79,42,0,37,34,34,17,0,17,0,0,0,0,68,41,17,3,21,27,27,18,0,9,0,0,0,0,53137
17737,2073,280,653,644,322,174,207,95,32,3,13,16,63,14,14,0,0,49,49,0,0,112,104,62,26,16,8,8,8,0,0,0,0,0,0,53139
17738,18731,3018,6323,5941,2260,1189,2488,1264,1052,191,198,663,212,173,128,39,6,39,0,20,19,1224,1012,357,87,568,212,172,134,0,38,40,40,0,0,53140
17739,21218,1894,6480,7205,3849,1790,1796,994,889,424,87,378,105,70,43,27,0,35,35,0,0,802,711,317,43,351,91,91,41,50,0,0,0,0,0,53142
17740,15222,1955,5808,4341,2005,1113,1315,582,432,72,92,268,150,82,57,13,12,68,0,0,68,733,634,120,8,506,99,66,52,14,0,33,18,11,4,53143
17741,16880,2116,5441,5323,3092,908,1839,926,784,213,134,437,142,119,91,18,10,23,0,0,23,913,890,199,163,528,23,23,4,0,19,0,0,0,0,53144
17742,5372,167,1638,1773,1433,361,427,346,296,130,0,166,50,50,50,0,0,0,0,0,0,81,81,46,0,35,0,0,0,0,0,0,0,0,0,53146
17743,11980,1602,3531,3420,2184,1243,816,311,306,78,17,211,5,5,3,2,0,0,0,0,0,505,499,155,84,260,6,3,3,0,0,3,0,0,3,53147
17744,13333,615,3780,4700,2755,1483,1236,666,635,286,0,349,31,31,11,0,20,0,0,0,0,570,528,228,45,255,42,42,33,0,9,0,0,0,0,53149
17745,17366,603,5488,5713,3932,1630,1415,736,604,272,17,315,132,122,89,33,0,10,0,0,10,679,644,413,0,231,35,13,0,13,0,22,22,0,0,53150
17746,23194,896,5622,6718,7119,2839,1544,735,728,291,43,394,7,7,7,0,0,0,0,0,0,809,755,299,53,403,54,42,14,0,28,12,0,0,12,53151
17747,1506,62,476,504,307,157,134,45,45,23,0,22,0,0,0,0,0,0,0,0,0,89,83,46,0,37,6,3,0,0,3,3,0,0,3,53153
17748,23775,1605,7293,7781,4923,2173,1683,983,810,315,121,374,173,119,96,23,0,54,0,0,54,700,608,278,0,330,92,32,32,0,0,60,18,19,23,53154
17749,2146,204,894,714,207,127,156,98,88,22,16,50,10,7,0,0,7,3,0,3,0,58,51,25,10,16,7,7,4,3,0,0,0,0,0,53156
17750,10332,776,2800,3080,2251,1425,978,518,419,121,30,268,99,76,40,0,36,23,9,14,0,460,434,152,39,243,26,12,0,0,12,14,0,0,14,53158
17751,417,64,212,8,118,15,0,0,0,0,0,0,0,0,0,0,0,0,0,0,0,0,0,0,0,0,0,0,0,0,0,0,0,0,0,53167
17752,5824,526,1974,2261,669,394,417,224,191,73,0,118,33,33,18,15,0,0,0,0,0,193,183,31,23,129,10,0,0,0,0,10,10,0,0,53168
17753,1390,153,584,432,132,89,90,42,41,9,8,24,1,0,0,0,0,1,0,0,1,48,48,17,8,23,0,0,0,0,0,0,0,0,0,53170
17754,14796,1595,5463,5064,1934,740,965,483,362,114,53,195,121,69,36,21,12,52,9,0,43,482,376,138,39,199,106,52,30,14,8,54,0,10,44,53172
17755,6208,902,2355,2100,605,246,370,178,104,7,12,85,74,12,12,0,0,62,0,32,30,192,185,44,21,120,7,7,7,0,0,0,0,0,0,53177
17756,1987,155,864,705,209,54,114,65,44,23,0,21,21,21,10,0,11,0,0,0,0,49,34,8,5,21,15,15,9,6,0,0,0,0,0,53178
17757,4085,402,1632,1238,618,195,333,167,132,32,12,88,35,28,11,17,0,7,7,0,0,166,77,33,0,44,89,89,17,14,58,0,0,0,0,53179
17758,4950,377,1621,1736,856,360,425,252,161,8,0,153,91,79,23,0,56,12,12,0,0,173,140,62,30,48,33,33,6,0,27,0,0,0,0,53181
17759,6568,816,2531,1972,924,325,595,177,125,12,15,98,52,18,15,0,3,34,27,7,0,418,398,96,7,295,20,20,20,0,0,0,0,0,0,53182
17760,2148,12,467,646,614,409,169,127,118,19,14,85,9,9,9,0,0,0,0,0,0,42,37,15,4,18,5,5,0,5,0,0,0,0,0,53183
17761,2771,326,931,812,485,217,263,117,96,23,18,55,21,12,5,7,0,9,0,7,2,146,137,63,2,72,9,9,7,2,0,0,0,0,0,53184
17762,12682,727,4287,4292,2298,1078,1031,568,527,194,57,276,41,41,41,0,0,0,0,0,0,463,399,139,30,230,64,64,12,52,0,0,0,0,0,53185
17763,22503,1848,5756,7422,5232,2245,2333,1225,1024,560,53,411,201,150,135,15,0,51,39,12,0,1108,1045,617,15,413,63,41,0,0,41,22,9,0,13,53186
17764,24130,1384,6156,7905,6025,2660,1583,743,651,215,15,421,92,92,61,0,31,0,0,0,0,840,765,380,80,305,75,62,62,0,0,13,13,0,0,53188
17765,17400,564,4551,5732,4636,1917,1647,821,735,312,94,329,86,86,8,43,35,0,0,0,0,826,767,313,34,420,59,59,38,7,14,0,0,0,0,53189
17766,8984,911,2397,2800,1496,1380,3021,1488,1428,439,36,953,60,60,54,6,0,0,0,0,0,1533,1503,630,77,796,30,30,12,18,0,0,0,0,0,53190
17767,2107,80,409,695,574,349,115,70,63,14,0,49,7,7,0,0,7,0,0,0,0,45,45,28,0,17,0,0,0,0,0,0,0,0,0,53191
17768,108,14,76,18,0,0,0,0,0,0,0,0,0,0,0,0,0,0,0,0,0,0,0,0,0,0,0,0,0,0,0,0,0,0,0,53192
17769,76,15,20,10,22,9,0,0,0,0,0,0,0,0,0,0,0,0,0,0,0,0,0,0,0,0,0,0,0,0,0,0,0,0,0,53195
17770,17711,809,1762,3722,6922,4496,1192,592,592,223,9,360,0,0,0,0,0,0,0,0,0,600,600,315,17,268,0,0,0,0,0,0,0,0,0,53202
17771,774,37,65,136,294,242,30,30,10,8,0,2,20,20,20,0,0,0,0,0,0,0,0,0,0,0,0,0,0,0,0,0,0,0,0,53203
17772,22547,10157,6420,4075,1319,576,2695,1392,1084,194,102,788,308,127,78,49,0,181,57,62,62,1303,1113,75,143,895,190,92,40,0,52,98,11,15,72,53204
17773,5218,1506,1774,1540,261,137,741,225,194,35,13,146,31,29,0,29,0,2,0,0,2,516,415,67,30,318,101,81,12,15,54,20,0,20,0,53205
17774,15529,4563,5942,4014,775,235,2457,1101,831,18,120,693,270,155,47,49,59,115,43,31,41,1356,1175,77,180,918,181,139,45,35,59,42,14,28,0,53206
17775,26582,2284,7409,8014,6185,2690,1042,416,367,115,59,193,49,49,26,19,4,0,0,0,0,626,558,162,58,338,68,42,42,0,0,26,4,0,22,53207
17776,18883,3910,5101,5409,2846,1617,2248,1294,977,112,68,797,317,198,39,36,123,119,12,43,64,954,783,130,104,549,171,152,55,14,83,19,0,0,19,53208
17777,28124,4507,8625,9022,3677,2293,2884,1645,1303,270,48,985,342,209,134,62,13,133,8,12,113,1239,1010,140,120,750,229,141,91,22,28,88,0,19,69,53209
17778,15038,2828,5050,4249,1797,1114,1790,867,730,65,111,554,137,112,78,10,24,25,9,0,16,923,775,252,96,427,148,110,29,51,30,38,16,18,4,53210
17779,19901,716,2342,3751,6699,6393,3513,1723,1689,572,58,1059,34,32,32,0,0,2,0,0,2,1790,1776,693,15,1068,14,14,14,0,0,0,0,0,0,53211
17780,18891,3665,4756,5359,3439,1672,2024,1039,864,115,104,645,175,155,54,86,15,20,0,7,13,985,681,159,40,482,304,179,90,39,50,125,6,46,73,53212
17781,17954,400,2725,4741,6240,3848,1087,532,478,169,21,288,54,50,29,10,11,4,0,0,4,555,452,212,29,211,103,76,49,0,27,27,0,0,27,53213
17782,24224,3065,8693,7372,3994,1100,1461,719,555,178,14,363,164,90,42,37,11,74,0,10,64,742,507,151,16,340,235,208,130,7,71,27,0,10,17,53214
17783,34404,12013,11835,7297,2359,900,3696,1848,1450,350,179,921,398,197,122,43,32,201,69,30,102,1848,1554,289,84,1181,294,167,71,47,49,127,25,17,85,53215
17784,19814,3111,6722,6943,2054,984,1966,937,776,88,137,551,161,100,30,43,27,61,0,6,55,1029,864,230,67,567,165,147,46,25,76,18,0,11,7,53216
17785,20103,387,1945,3221,7939,6611,1294,680,678,97,44,537,2,0,0,0,0,2,0,0,2,614,593,248,46,299,21,21,14,7,0,0,0,0,0,53217
17786,22672,4357,7911,7738,1961,705,3104,1382,1132,227,72,833,250,220,66,55,99,30,0,17,13,1722,1496,186,130,1180,226,150,31,30,89,76,54,0,22,53218
17787,25617,2821,9052,7881,4262,1601,1248,589,475,125,83,267,114,53,8,0,45,61,32,6,23,659,558,221,64,273,101,87,58,19,10,14,5,0,9,53219
17788,19446,1986,7119,6048,3067,1226,999,401,335,180,12,143,66,25,11,0,14,41,15,0,26,598,491,170,21,300,107,72,59,0,13,35,35,0,0,53220
17789,26363,3336,9634,7713,3695,1985,1526,828,712,234,94,384,116,82,68,10,4,34,0,30,4,698,621,183,34,404,77,21,9,0,12,56,19,0,37,53221
17790,18109,1202,4810,5560,4421,2116,1396,765,597,133,56,408,168,102,51,0,51,66,0,15,51,631,620,216,23,381,11,0,0,0,0,11,0,0,11,53222
17791,18871,2162,5642,6264,3138,1665,1534,720,574,105,33,436,146,12,12,0,0,134,0,55,79,814,762,277,38,447,52,52,11,20,21,0,0,0,0,53223
17792,13108,1761,3831,4139,2111,1266,1322,509,452,85,88,279,57,52,17,0,35,5,0,0,5,813,703,95,19,589,110,39,10,29,0,71,6,4,61,53224
17793,15237,1935,5432,5156,1908,806,1244,696,594,187,25,382,102,27,0,21,6,75,7,0,68,548,513,96,81,336,35,35,31,0,4,0,0,0,0,53225
17794,13506,532,2562,3707,4118,2587,1060,655,637,228,29,380,18,9,9,0,0,9,7,0,2,405,358,189,15,154,47,36,17,0,19,11,0,0,11,53226
17795,16630,1518,5984,5218,2705,1205,887,491,379,211,20,148,112,99,29,40,30,13,0,7,6,396,350,184,85,81,46,22,14,8,0,24,0,0,24,53227
17796,10882,1026,3150,3503,2139,1064,584,292,282,191,35,56,10,10,10,0,0,0,0,0,0,292,242,42,68,132,50,21,21,0,0,29,0,0,29,53228
17797,4998,1120,1434,1175,750,519,3468,1585,1463,415,78,970,122,50,13,0,37,72,24,0,48,1883,1824,628,70,1126,59,33,10,0,23,26,0,0,26,53233
17798,7281,997,2172,2252,1338,522,378,239,179,46,93,40,60,60,60,0,0,0,0,0,0,139,139,23,0,116,0,0,0,0,0,0,0,0,0,53235
17799,130,27,49,32,13,9,0,0,0,0,0,0,0,0,0,0,0,0,0,0,0,0,0,0,0,0,0,0,0,0,0,0,0,0,0,53295
17800,21969,1976,6514,6638,4564,2277,1613,939,761,111,97,553,178,134,108,5,21,44,0,17,27,674,556,154,97,305,118,99,56,16,27,19,0,0,19,53402
17801,17426,3820,5379,5202,1912,1113,1763,1006,824,154,137,533,182,121,29,41,51,61,0,25,36,757,568,206,47,315,189,127,94,24,9,62,30,10,22,53403
17802,8884,2367,3003,2305,887,322,900,335,263,64,58,141,72,19,0,9,10,53,13,21,19,565,425,52,83,290,140,104,104,0,0,36,36,0,0,53404
17803,16753,1921,5549,5797,2171,1315,1253,705,653,61,151,441,52,38,7,12,19,14,0,0,14,548,473,228,22,223,75,40,40,0,0,35,20,15,0,53405
17804,18271,1520,5344,5957,3430,2020,1169,605,520,244,69,207,85,39,9,0,30,46,46,0,0,564,526,156,78,292,38,38,25,0,13,0,0,0,0,53406
17805,0,0,0,0,0,0,0,0,0,0,0,0,0,0,0,0,0,0,0,0,0,0,0,0,0,0,0,0,0,0,0,0,0,0,0,53501
17806,1655,194,634,514,227,86,116,66,44,21,0,23,22,22,9,4,9,0,0,0,0,50,29,4,14,11,21,3,0,3,0,18,0,0,18,53502
17807,1345,124,515,469,168,69,67,28,20,10,0,10,8,8,8,0,0,0,0,0,0,39,33,10,18,5,6,6,0,6,0,0,0,0,0,53503
17808,1407,111,664,393,163,76,135,95,66,8,2,56,29,26,18,6,2,3,3,0,0,40,39,26,0,13,1,0,0,0,0,1,0,0,1,53504
17809,319,31,160,81,32,15,22,15,15,3,1,11,0,0,0,0,0,0,0,0,0,7,7,4,3,0,0,0,0,0,0,0,0,0,0,53505
17810,854,87,422,243,52,50,51,17,17,0,2,15,0,0,0,0,0,0,0,0,0,34,34,10,0,24,0,0,0,0,0,0,0,0,0,53506
17811,1533,149,480,526,275,103,72,37,33,20,0,13,4,4,4,0,0,0,0,0,0,35,31,13,0,18,4,0,0,0,0,4,0,4,0,53507
17812,3547,147,1166,1345,677,212,225,129,122,53,2,67,7,3,3,0,0,4,4,0,0,96,88,49,2,37,8,8,8,0,0,0,0,0,0,53508
17813,960,73,422,278,134,53,78,41,28,10,10,8,13,4,4,0,0,9,0,4,5,37,35,22,0,13,2,0,0,0,0,2,0,0,2,53510
17814,31131,5991,11904,8381,3170,1685,3388,1891,1506,426,129,951,385,349,183,86,80,36,0,36,0,1497,1198,468,117,613,299,287,163,94,30,12,12,0,0,53511
17815,1703,101,603,490,344,165,105,48,40,17,1,22,8,8,8,0,0,0,0,0,0,57,54,32,0,22,3,3,3,0,0,0,0,0,0,53515
17816,1508,75,588,510,220,115,101,54,48,14,2,32,6,6,6,0,0,0,0,0,0,47,47,9,2,36,0,0,0,0,0,0,0,0,0,53516
17817,1153,59,352,364,251,127,57,33,29,15,3,11,4,4,0,0,4,0,0,0,0,24,21,14,0,7,3,3,0,0,3,0,0,0,0,53517
17818,897,75,371,288,104,59,48,21,16,8,1,7,5,1,0,1,0,4,0,0,4,27,27,11,0,16,0,0,0,0,0,0,0,0,0,53518
17819,4596,331,1970,1541,520,234,431,243,211,125,10,76,32,23,10,0,13,9,2,5,2,188,118,60,0,58,70,62,52,7,3,8,6,0,2,53520
17820,2465,112,832,882,492,147,137,65,51,17,5,29,14,6,6,0,0,8,0,0,8,72,68,30,17,21,4,4,4,0,0,0,0,0,0,53521
17821,910,73,409,327,62,39,60,39,37,21,2,14,2,2,0,0,2,0,0,0,0,21,21,10,0,11,0,0,0,0,0,0,0,0,0,53522
17822,3624,229,1114,1160,748,373,262,137,114,46,7,61,23,17,17,0,0,6,3,0,3,125,115,65,3,47,10,10,2,8,0,0,0,0,0,53523
17823,2577,310,1080,763,291,133,227,134,98,32,6,60,36,13,6,7,0,23,5,16,2,93,76,27,22,27,17,16,13,3,0,1,0,0,1,53525
17824,393,12,146,167,52,16,23,15,15,4,0,11,0,0,0,0,0,0,0,0,0,8,8,2,0,6,0,0,0,0,0,0,0,0,0,53526
17825,7019,187,1694,2349,1894,895,482,168,146,91,16,39,22,22,22,0,0,0,0,0,0,314,291,104,50,137,23,13,13,0,0,10,10,0,0,53527
17826,3808,239,1109,1101,905,454,195,94,91,37,19,35,3,3,3,0,0,0,0,0,0,101,101,54,5,42,0,0,0,0,0,0,0,0,0,53528
17827,1457,163,553,451,240,50,126,79,61,24,9,28,18,16,12,4,0,2,2,0,0,47,35,24,0,11,12,12,12,0,0,0,0,0,0,53529
17828,3228,427,1377,839,440,145,262,147,120,25,8,87,27,0,0,0,0,27,20,0,7,115,88,33,0,55,27,14,7,0,7,13,13,0,0,53530
17829,2979,134,920,986,698,241,270,130,115,48,5,62,15,6,6,0,0,9,5,0,4,140,140,69,11,60,0,0,0,0,0,0,0,0,0,53531
17830,9348,410,2461,3400,2109,968,620,310,257,84,57,116,53,53,37,16,0,0,0,0,0,310,264,80,23,161,46,37,22,15,0,9,0,0,9,53532
17831,4904,362,1547,1797,869,329,386,205,149,66,0,83,56,12,3,0,9,44,0,0,44,181,135,75,8,52,46,5,5,0,0,41,0,0,41,53533
17832,8451,936,2860,3076,1195,384,410,305,257,103,65,89,48,29,20,9,0,19,0,0,19,105,91,26,16,49,14,14,14,0,0,0,0,0,0,53534
17833,5803,500,1895,2051,894,463,374,218,194,84,18,92,24,21,18,3,0,3,0,3,0,156,150,54,22,74,6,6,6,0,0,0,0,0,0,53536
17834,489,81,278,59,55,16,15,13,9,9,0,0,4,4,0,4,0,0,0,0,0,2,2,0,0,2,0,0,0,0,0,0,0,0,0,53537
17835,13032,1178,4597,3800,2235,1222,920,551,471,324,16,131,80,67,23,0,44,13,0,0,13,369,345,113,28,204,24,24,0,10,14,0,0,0,0,53538
17836,127,10,39,65,13,0,7,3,3,0,0,3,0,0,0,0,0,0,0,0,0,4,4,4,0,0,0,0,0,0,0,0,0,0,0,53540
17837,530,52,251,164,49,14,31,15,15,2,0,13,0,0,0,0,0,0,0,0,0,16,10,7,1,2,6,3,2,1,0,3,0,0,3,53541
17838,1112,69,471,384,131,57,56,34,26,10,0,16,8,8,8,0,0,0,0,0,0,22,19,9,0,10,3,3,0,3,0,0,0,0,0,53543
17839,522,19,234,154,84,31,9,7,5,0,0,5,2,0,0,0,0,2,0,0,2,2,2,0,0,2,0,0,0,0,0,0,0,0,0,53544
17840,15602,1249,6035,4935,2144,1239,852,308,235,62,13,160,73,23,9,7,7,50,24,0,26,544,444,132,41,271,100,82,75,7,0,18,6,11,1,53545
17841,21407,1702,7681,7244,3348,1432,1469,675,611,327,44,240,64,41,39,0,2,23,0,13,10,794,695,332,123,240,99,69,54,15,0,30,0,13,17,53546
17842,11970,1698,4269,3977,1281,745,1002,528,445,179,29,237,83,53,18,35,0,30,8,0,22,474,388,171,38,179,86,73,22,17,34,13,0,0,13,53548
17843,6973,728,3204,1845,884,312,383,180,137,63,0,74,43,26,14,0,12,17,7,0,10,203,159,59,9,91,44,36,36,0,0,8,0,0,8,53549
17844,870,65,428,304,46,27,97,41,32,9,4,19,9,5,5,0,0,4,0,0,4,56,52,14,4,34,4,0,0,0,0,4,0,4,0,53550
17845,5740,234,1712,2037,1270,487,281,122,103,50,6,47,19,19,19,0,0,0,0,0,0,159,159,61,18,80,0,0,0,0,0,0,0,0,0,53551
17846,373,48,154,147,16,8,33,22,17,0,0,17,5,5,3,0,2,0,0,0,0,11,11,4,0,7,0,0,0,0,0,0,0,0,0,53553
17847,739,72,273,238,114,42,48,23,19,3,0,16,4,0,0,0,0,4,2,0,2,25,21,9,1,11,4,4,1,3,0,0,0,0,0,53554
17848,5950,332,1743,2132,1116,627,556,244,208,71,26,111,36,26,10,16,0,10,0,0,10,312,297,130,28,139,15,3,3,0,0,12,0,0,12,53555
17849,1849,205,926,540,118,60,169,102,79,36,7,36,23,23,12,11,0,0,0,0,0,67,63,13,3,47,4,4,2,0,2,0,0,0,0,53556
17850,343,65,150,94,29,5,13,9,9,1,0,8,0,0,0,0,0,0,0,0,0,4,3,0,0,3,1,1,1,0,0,0,0,0,0,53557
17851,7755,104,1707,2181,2359,1404,605,341,284,62,0,222,57,14,12,0,2,43,43,0,0,264,190,136,0,54,74,63,63,0,0,11,0,11,0,53558
17852,4041,359,1255,1471,645,311,180,109,101,29,3,69,8,1,1,0,0,7,7,0,0,71,69,36,2,31,2,2,0,0,2,0,0,0,0,53559
17853,2478,156,846,809,455,212,145,47,32,4,0,28,15,13,4,6,3,2,0,0,2,98,86,34,10,42,12,4,4,0,0,8,8,0,0,53560
17854,1237,50,462,415,189,121,44,26,26,11,3,12,0,0,0,0,0,0,0,0,0,18,15,9,0,6,3,3,3,0,0,0,0,0,0,53561
17855,17139,629,2478,4153,5637,4242,1069,408,363,83,0,280,45,45,32,13,0,0,0,0,0,661,661,195,66,400,0,0,0,0,0,0,0,0,0,53562
17856,7272,418,2582,2371,1250,651,516,254,210,97,13,100,44,44,44,0,0,0,0,0,0,262,219,77,17,125,43,43,43,0,0,0,0,0,0,53563
17857,3342,296,1142,1078,490,336,260,147,124,13,22,89,23,15,0,15,0,8,8,0,0,113,83,28,3,52,30,6,4,2,0,24,5,0,19,53565
17858,10554,1166,4210,3111,1289,778,684,314,240,100,12,128,74,74,47,27,0,0,0,0,0,370,306,124,71,111,64,59,26,0,33,5,0,4,1,53566
17859,766,49,307,254,120,36,51,22,21,8,2,11,1,1,1,0,0,0,0,0,0,29,27,16,2,9,2,2,2,0,0,0,0,0,0,53569
17860,1854,109,805,618,233,89,121,37,32,16,4,12,5,5,5,0,0,0,0,0,0,84,78,43,0,35,6,6,2,0,4,0,0,0,0,53570
17861,175,0,0,64,95,16,12,0,0,0,0,0,0,0,0,0,0,0,0,0,0,12,12,12,0,0,0,0,0,0,0,0,0,0,0,53571
17862,6814,336,1882,2154,1729,713,525,234,232,111,3,118,2,0,0,0,0,2,2,0,0,291,270,137,3,130,21,10,10,0,0,11,0,11,0,53572
17863,2197,334,917,678,183,85,136,57,40,11,4,25,17,12,9,3,0,5,5,0,0,79,54,21,4,29,25,5,1,2,2,20,2,0,18,53573
17864,2738,206,861,779,638,254,140,75,75,26,2,47,0,0,0,0,0,0,0,0,0,65,65,26,10,29,0,0,0,0,0,0,0,0,0,53574
17865,10841,399,2651,3691,2624,1476,668,329,303,93,35,175,26,21,21,0,0,5,5,0,0,339,325,77,32,216,14,14,14,0,0,0,0,0,0,53575
17866,1556,167,529,569,201,90,158,84,62,25,3,34,22,18,10,0,8,4,4,0,0,74,60,13,3,44,14,14,4,0,10,0,0,0,0,53576
17867,955,69,434,274,146,32,108,57,57,14,3,40,0,0,0,0,0,0,0,0,0,51,41,4,2,35,10,10,4,0,6,0,0,0,0,53577
17868,4150,175,1407,1258,928,382,262,130,89,59,6,24,41,34,31,3,0,7,0,0,7,132,118,86,9,23,14,10,10,0,0,4,4,0,0,53578
17869,1321,169,651,359,115,27,109,41,41,13,11,17,0,0,0,0,0,0,0,0,0,68,68,49,4,15,0,0,0,0,0,0,0,0,0,53579
17870,411,26,225,115,32,13,69,7,5,3,0,2,2,2,2,0,0,0,0,0,0,62,62,2,0,60,0,0,0,0,0,0,0,0,0,53580
17871,7504,826,2957,2470,754,497,527,274,227,134,0,93,47,36,22,3,11,11,7,4,0,253,238,121,0,117,15,2,0,0,2,13,3,0,10,53581
17872,751,43,333,243,103,29,58,25,22,12,5,5,3,3,0,0,3,0,0,0,0,33,25,15,0,10,8,6,0,0,6,2,0,0,2,53582
17873,3940,339,1569,1201,571,260,186,73,71,25,0,46,2,2,0,2,0,0,0,0,0,113,74,56,4,14,39,39,10,29,0,0,0,0,0,53583
17874,1308,186,515,434,127,46,106,55,43,20,9,14,12,12,6,6,0,0,0,0,0,51,46,7,3,36,5,5,3,0,2,0,0,0,0,53585
17875,1555,162,730,421,172,70,80,50,43,17,0,26,7,5,0,0,5,2,0,0,2,30,26,5,5,16,4,4,4,0,0,0,0,0,0,53586
17876,841,101,383,271,79,7,82,38,29,8,3,18,9,7,4,0,3,2,1,0,1,44,34,4,2,28,10,3,1,2,0,7,1,0,6,53587
17877,2704,201,854,774,582,293,237,88,78,30,2,46,10,10,10,0,0,0,0,0,0,149,132,55,3,74,17,2,2,0,0,15,0,0,15,53588
17878,13891,1206,3896,4343,2969,1477,948,546,461,131,52,278,85,68,55,13,0,17,0,0,17,402,319,186,0,133,83,83,69,0,14,0,0,0,0,53589
17879,23743,1081,5101,7625,6913,3023,1834,959,884,366,156,362,75,64,39,14,11,11,11,0,0,875,741,336,57,348,134,106,106,0,0,28,28,0,0,53590
17880,13736,249,2263,3526,4685,3013,926,556,545,220,3,322,11,5,2,3,0,6,0,0,6,370,344,149,3,192,26,18,18,0,0,8,8,0,0,53593
17881,3444,379,1432,1121,369,143,277,126,108,32,3,73,18,18,18,0,0,0,0,0,0,151,132,84,2,46,19,0,0,0,0,19,0,0,19,53594
17882,11359,309,2594,3400,3219,1837,984,478,446,197,0,249,32,10,2,8,0,22,0,0,22,506,472,180,10,282,34,34,8,17,9,0,0,0,0,53597
17883,1804,88,520,650,335,211,75,29,29,9,0,20,0,0,0,0,0,0,0,0,0,46,46,31,0,15,0,0,0,0,0,0,0,0,0,53598
17884,59,11,34,14,0,0,0,0,0,0,0,0,0,0,0,0,0,0,0,0,0,0,0,0,0,0,0,0,0,0,0,0,0,0,0,53599
17885,38,0,0,38,0,0,0,0,0,0,0,0,0,0,0,0,0,0,0,0,0,0,0,0,0,0,0,0,0,0,0,0,0,0,0,53702
17886,12769,557,1121,2690,4569,3832,2131,973,878,283,67,528,95,95,79,0,16,0,0,0,0,1158,1068,576,118,374,90,90,66,0,24,0,0,0,0,53703
17887,31588,2430,6285,9792,8012,5069,1484,838,776,217,40,519,62,30,23,7,0,32,0,25,7,646,584,198,78,308,62,24,6,0,18,38,25,0,13,53704
17888,17387,314,1333,2505,5409,7826,619,282,249,82,15,152,33,20,20,0,0,13,13,0,0,337,324,102,46,176,13,13,9,0,4,0,0,0,0,53705
17889,51,0,0,35,0,16,4855,2466,2466,699,90,1677,0,0,0,0,0,0,0,0,0,2389,2389,749,65,1575,0,0,0,0,0,0,0,0,0,53706
17890,30021,1733,4469,6619,8780,8420,2194,1111,1026,260,179,587,85,35,12,23,0,50,0,13,37,1083,1000,371,76,553,83,62,62,0,0,21,12,0,9,53711
17891,13840,2196,4234,3806,2207,1397,1189,761,720,172,176,372,41,11,6,0,5,30,0,30,0,428,392,103,41,248,36,36,36,0,0,0,0,0,0,53713
17892,11406,897,3165,3912,2344,1088,684,273,224,83,0,141,49,29,17,12,0,20,20,0,0,411,374,186,55,133,37,37,0,14,23,0,0,0,0,53714
17893,4370,265,458,1022,1513,1112,1876,756,756,155,43,558,0,0,0,0,0,0,0,0,0,1120,1096,370,50,676,24,0,0,0,0,24,0,0,24,53715
17894,13588,546,3248,4715,3110,1969,523,268,252,99,19,134,16,15,15,0,0,1,0,0,1,255,237,145,42,50,18,0,0,0,0,18,0,18,0,53716
17895,8566,270,841,1528,3332,2595,406,179,171,77,0,94,8,8,8,0,0,0,0,0,0,227,227,114,0,113,0,0,0,0,0,0,0,0,0,53717
17896,8902,325,1537,2979,2625,1436,229,151,129,27,25,77,22,22,22,0,0,0,0,0,0,78,78,45,0,33,0,0,0,0,0,0,0,0,0,53718
17897,20205,898,2888,4866,7181,4372,948,511,477,59,116,302,34,21,8,13,0,13,13,0,0,437,356,145,23,188,81,29,29,0,0,52,40,0,12,53719
17898,2017,0,35,136,662,1184,639,414,414,233,6,175,0,0,0,0,0,0,0,0,0,225,220,58,14,148,5,4,0,0,4,1,0,0,1,53726
17899,0,0,0,0,0,0,0,0,0,0,0,0,0,0,0,0,0,0,0,0,0,0,0,0,0,0,0,0,0,0,0,0,0,0,0,53792
17900,753,83,387,181,73,29,49,30,25,12,4,9,5,5,5,0,0,0,0,0,0,19,19,11,0,8,0,0,0,0,0,0,0,0,0,53801
17901,38,2,30,6,0,0,0,0,0,0,0,0,0,0,0,0,0,0,0,0,0,0,0,0,0,0,0,0,0,0,0,0,0,0,0,53802
17902,988,78,414,352,105,39,63,42,42,23,0,19,0,0,0,0,0,0,0,0,0,21,14,2,0,12,7,4,4,0,0,3,3,0,0,53803
17903,928,78,447,314,70,19,68,26,26,4,0,22,0,0,0,0,0,0,0,0,0,42,23,11,0,12,19,7,3,2,2,12,5,0,7,53804
17904,3597,562,1397,1148,303,187,232,124,113,23,2,88,11,4,0,4,0,7,0,0,7,108,84,14,4,66,24,24,22,0,2,0,0,0,0,53805
17905,1262,99,622,366,111,64,75,52,50,15,0,35,2,2,0,0,2,0,0,0,0,23,20,6,0,14,3,3,1,2,0,0,0,0,0,53806
17906,3227,251,1426,993,443,114,232,131,114,51,0,63,17,17,8,5,4,0,0,0,0,101,81,27,4,50,20,11,9,0,2,9,7,0,2,53807
17907,754,65,400,183,94,12,41,22,22,9,0,13,0,0,0,0,0,0,0,0,0,19,19,4,0,15,0,0,0,0,0,0,0,0,0,53808
17908,2715,211,1075,1008,272,149,138,82,62,28,3,31,20,19,15,4,0,1,1,0,0,56,52,39,0,13,4,0,0,0,0,4,4,0,0,53809
17909,321,17,184,86,26,8,18,11,11,3,2,6,0,0,0,0,0,0,0,0,0,7,7,3,0,4,0,0,0,0,0,0,0,0,0,53810
17910,2328,176,973,677,301,201,86,31,29,16,0,13,2,2,2,0,0,0,0,0,0,55,52,25,2,25,3,3,3,0,0,0,0,0,0,53811
17911,4081,453,1712,1100,504,312,207,93,67,25,1,41,26,13,10,0,3,13,1,0,12,114,91,29,2,60,23,4,4,0,0,19,0,0,19,53813
17912,538,60,236,201,25,16,64,20,17,4,0,13,3,3,2,0,1,0,0,0,0,44,26,9,1,16,18,3,2,0,1,15,9,0,6,53816
17913,134,15,61,43,14,1,9,9,1,1,0,0,8,0,0,0,0,8,4,0,4,0,0,0,0,0,0,0,0,0,0,0,0,0,0,53817
17914,6678,533,1957,2107,1059,1022,2544,1555,1530,436,23,1071,25,7,5,2,0,18,10,0,8,989,934,468,29,437,55,33,32,1,0,22,3,0,19,53818
17915,1822,209,808,525,187,93,152,96,85,34,2,49,11,4,1,0,3,7,4,3,0,56,54,18,3,33,2,1,1,0,0,1,0,0,1,53820
17916,5866,517,2611,1784,649,305,525,252,252,113,8,131,0,0,0,0,0,0,0,0,0,273,262,130,15,117,11,11,4,3,4,0,0,0,0,53821
17917,322,65,127,94,31,5,32,14,9,1,0,8,5,0,0,0,0,5,3,0,2,18,5,0,0,5,13,0,0,0,0,13,0,0,13,53825
17918,892,79,412,292,63,46,76,60,57,30,2,25,3,3,3,0,0,0,0,0,0,16,16,3,1,12,0,0,0,0,0,0,0,0,0,53826
17919,173,45,50,61,11,6,6,3,3,3,0,0,0,0,0,0,0,0,0,0,0,3,3,2,0,1,0,0,0,0,0,0,0,0,0,53827
17920,10578,994,3813,3764,1382,625,807,388,301,140,10,151,87,16,5,2,9,71,0,54,17,419,399,229,20,150,20,14,14,0,0,6,0,0,6,53901
17921,2176,401,1054,533,144,44,122,73,52,21,5,26,21,21,15,6,0,0,0,0,0,49,35,15,10,10,14,14,5,5,4,0,0,0,0,53910
17922,908,46,348,300,135,79,55,34,34,10,6,18,0,0,0,0,0,0,0,0,0,21,17,14,0,3,4,4,0,0,4,0,0,0,0,53911
17923,13785,1719,4967,4014,1993,1092,1010,619,500,236,29,235,119,113,107,0,6,6,0,0,6,391,302,225,6,71,89,73,14,59,0,16,16,0,0,53913
17924,15593,1742,5788,5001,1990,1072,1095,474,406,179,57,170,68,59,38,0,21,9,0,0,9,621,567,170,50,347,54,40,19,0,21,14,7,7,0,53916
17925,1744,199,795,517,198,35,224,96,86,50,3,33,10,4,2,2,0,6,0,6,0,128,101,57,9,35,27,9,6,3,0,18,0,18,0,53919
17926,295,19,137,92,25,22,18,16,16,4,0,12,0,0,0,0,0,0,0,0,0,2,2,2,0,0,0,0,0,0,0,0,0,0,0,53920
17927,704,82,367,178,55,22,48,31,17,9,3,5,14,11,11,0,0,3,3,0,0,17,9,5,0,4,8,5,3,2,0,3,0,0,3,53922
17928,1346,155,591,435,127,38,89,24,22,8,0,14,2,0,0,0,0,2,2,0,0,65,46,11,0,35,19,8,6,0,2,11,0,0,11,53923
17929,875,106,436,258,51,24,42,19,16,4,0,12,3,0,0,0,0,3,1,0,2,23,17,9,2,6,6,5,0,0,5,1,0,1,0,53924
17930,5633,384,2094,1718,963,474,373,193,172,55,26,91,21,12,8,4,0,9,9,0,0,180,163,80,4,79,17,17,14,3,0,0,0,0,0,53925
17931,841,218,344,172,92,15,83,51,24,2,3,19,27,7,1,6,0,20,11,0,9,32,14,7,2,5,18,6,3,0,3,12,10,0,2,53926
17932,131,16,61,53,1,0,9,5,5,0,0,5,0,0,0,0,0,0,0,0,0,4,1,1,0,0,3,3,0,3,0,0,0,0,0,53928
17933,1855,231,808,561,192,63,109,46,46,12,0,34,0,0,0,0,0,0,0,0,0,63,49,16,8,25,14,14,14,0,0,0,0,0,0,53929
17934,900,102,401,243,122,32,70,27,22,5,3,14,5,5,0,3,2,0,0,0,0,43,41,20,5,16,2,2,2,0,0,0,0,0,0,53930
17935,148,8,78,46,13,3,3,3,3,3,0,0,0,0,0,0,0,0,0,0,0,0,0,0,0,0,0,0,0,0,0,0,0,0,0,53931
17936,1566,115,578,548,233,92,121,62,51,42,0,9,11,0,0,0,0,11,3,0,8,59,45,21,3,21,14,7,2,0,5,7,0,0,7,53932
17937,3280,472,1232,1187,300,89,63,27,23,8,10,5,4,4,0,0,4,0,0,0,0,36,28,25,0,3,8,8,8,0,0,0,0,0,0,53933
17938,3621,578,1553,1070,272,148,167,62,41,23,0,18,21,21,21,0,0,0,0,0,0,105,82,53,0,29,23,19,3,0,16,4,0,0,4,53934
17939,210,38,80,69,20,3,25,14,12,0,0,12,2,2,2,0,0,0,0,0,0,11,11,0,0,11,0,0,0,0,0,0,0,0,0,53935
17940,2075,396,880,615,105,79,55,21,18,4,0,14,3,0,0,0,0,3,0,0,3,34,26,18,0,8,8,5,0,5,0,3,3,0,0,53936
17941,643,64,304,180,68,27,100,58,39,13,3,23,19,8,4,4,0,11,2,0,9,42,27,13,9,5,15,4,2,2,0,11,8,0,3,53937
17942,156,26,64,50,10,6,7,7,7,0,0,7,0,0,0,0,0,0,0,0,0,0,0,0,0,0,0,0,0,0,0,0,0,0,0,53939
17943,2068,295,787,640,232,114,142,82,52,31,4,17,30,12,7,3,2,18,0,0,18,60,49,27,4,18,11,5,2,3,0,6,0,0,6,53941
17944,775,113,338,233,59,32,38,7,7,5,0,2,0,0,0,0,0,0,0,0,0,31,29,18,0,11,2,2,0,0,2,0,0,0,0,53943
17945,1717,354,695,473,163,32,86,66,66,29,17,20,0,0,0,0,0,0,0,0,0,20,11,3,0,8,9,3,3,0,0,6,0,0,6,53944
17946,3081,442,1308,881,337,113,261,108,86,35,16,35,22,11,4,0,7,11,11,0,0,153,111,62,8,41,42,31,0,7,24,11,11,0,0,53946
17947,62,13,20,22,5,2,1,1,1,0,0,1,0,0,0,0,0,0,0,0,0,0,0,0,0,0,0,0,0,0,0,0,0,0,0,53947
17948,6049,857,2555,1775,634,228,381,221,193,56,20,117,28,11,6,0,5,17,0,0,17,160,151,75,19,57,9,5,0,0,5,4,0,0,4,53948
17949,4635,677,2051,1379,391,137,252,112,81,21,19,41,31,29,5,21,3,2,0,0,2,140,103,31,16,56,37,37,28,7,2,0,0,0,0,53949
17950,4153,694,1502,1461,343,153,272,153,127,44,19,64,26,23,5,12,6,3,3,0,0,119,97,35,19,43,22,22,9,13,0,0,0,0,0,53950
17951,1753,274,716,558,142,63,140,57,43,4,7,32,14,14,7,0,7,0,0,0,0,83,70,38,7,25,13,13,13,0,0,0,0,0,0,53951
17952,2624,363,1072,882,204,103,153,93,88,24,4,60,5,5,0,5,0,0,0,0,0,60,36,3,9,24,24,24,19,0,5,0,0,0,0,53952
17953,191,51,58,79,3,0,0,0,0,0,0,0,0,0,0,0,0,0,0,0,0,0,0,0,0,0,0,0,0,0,0,0,0,0,0,53953
17954,4868,356,1928,1709,610,265,373,213,179,55,7,117,34,7,7,0,0,27,4,23,0,160,116,37,31,48,44,20,20,0,0,24,6,0,18,53954
17955,3910,257,1386,1487,598,182,161,85,85,37,7,41,0,0,0,0,0,0,0,0,0,76,63,49,0,14,13,13,13,0,0,0,0,0,0,53955
17956,2293,285,1074,678,196,60,202,124,120,37,12,71,4,1,1,0,0,3,0,0,3,78,78,19,3,56,0,0,0,0,0,0,0,0,0,53956
17957,9178,980,3596,3165,933,504,763,412,281,113,6,162,131,66,55,11,0,65,6,0,59,351,284,165,29,90,67,24,21,0,3,43,23,0,20,53959
17958,2300,211,962,797,231,99,182,96,79,17,6,56,17,17,17,0,0,0,0,0,0,86,86,55,0,31,0,0,0,0,0,0,0,0,0,53960
17959,537,69,226,150,78,14,45,30,26,13,0,13,4,4,1,3,0,0,0,0,0,15,15,6,9,0,0,0,0,0,0,0,0,0,0,53961
17960,9940,1724,4233,2993,694,296,617,256,134,85,6,43,122,104,54,29,21,18,0,0,18,361,261,122,22,117,100,61,13,0,48,39,0,0,39,53963
17961,2449,316,1017,749,214,153,170,103,74,26,0,48,29,23,20,3,0,6,2,0,4,67,58,25,0,33,9,7,6,0,1,2,2,0,0,53964
17962,7403,880,2484,2498,994,547,479,280,235,109,21,105,45,21,15,4,2,24,24,0,0,199,175,49,6,120,24,3,0,0,3,21,18,3,0,53965
17963,1686,239,757,499,139,52,132,41,34,8,0,26,7,3,3,0,0,4,4,0,0,91,82,37,6,39,9,2,0,0,2,7,2,0,5,53968
17964,288,54,120,95,8,11,2,0,0,0,0,0,0,0,0,0,0,0,0,0,0,2,2,0,0,2,0,0,0,0,0,0,0,0,0,53969
17965,6047,677,2247,1899,751,473,394,148,132,43,16,73,16,15,8,7,0,1,0,0,1,246,182,105,4,73,64,64,54,0,10,0,0,0,0,54001
17966,4174,319,1364,1559,684,248,342,186,169,76,18,75,17,15,15,0,0,2,2,0,0,156,124,37,4,83,32,32,17,15,0,0,0,0,0,54002
17967,686,23,250,261,101,51,35,12,12,9,3,0,0,0,0,0,0,0,0,0,0,23,21,11,5,5,2,2,2,0,0,0,0,0,0,54003
17968,1618,206,732,484,138,58,116,72,57,18,7,32,15,15,13,2,0,0,0,0,0,44,44,26,5,13,0,0,0,0,0,0,0,0,0,54004
17969,2010,139,971,602,190,108,142,87,67,34,0,33,20,10,7,1,2,10,3,0,7,55,47,13,0,34,8,8,8,0,0,0,0,0,0,54005
17970,515,26,223,179,76,11,22,14,12,6,3,3,2,2,2,0,0,0,0,0,0,8,8,2,0,6,0,0,0,0,0,0,0,0,0,54006
17971,925,135,378,306,81,25,89,27,27,20,0,7,0,0,0,0,0,0,0,0,0,62,51,37,0,14,11,11,0,0,11,0,0,0,0,54007
17972,1609,64,564,615,259,107,89,15,13,8,0,5,2,2,2,0,0,0,0,0,0,74,56,32,4,20,18,11,11,0,0,7,0,0,7,54009
17973,34,6,21,7,0,0,0,0,0,0,0,0,0,0,0,0,0,0,0,0,0,0,0,0,0,0,0,0,0,0,0,0,0,0,0,54010
17974,4345,412,1708,1470,569,186,318,155,127,69,3,55,28,15,15,0,0,13,0,0,13,163,151,70,2,79,12,12,12,0,0,0,0,0,0,54011
17975,2231,222,888,672,292,157,207,128,112,50,3,59,16,10,10,0,0,6,0,6,0,79,74,27,2,45,5,5,5,0,0,0,0,0,0,54013
17976,1687,111,606,643,236,91,107,71,67,33,6,28,4,4,4,0,0,0,0,0,0,36,33,15,0,18,3,3,3,0,0,0,0,0,0,54014
17977,2291,84,660,920,438,189,198,122,109,65,5,39,13,13,13,0,0,0,0,0,0,76,70,25,13,32,6,6,3,0,3,0,0,0,0,54015
17978,20954,499,4285,6519,6748,2903,1433,757,735,361,82,292,22,22,22,0,0,0,0,0,0,676,634,266,24,344,42,23,23,0,0,19,19,0,0,54016
17979,10559,628,3434,3934,1910,653,1050,576,513,204,96,213,63,63,10,13,40,0,0,0,0,474,394,204,20,170,80,18,18,0,0,62,62,0,0,54017
17980,4901,292,1793,1562,891,363,622,343,315,140,25,150,28,20,10,3,7,8,5,3,0,279,244,92,24,128,35,12,5,0,7,23,13,0,10,54020
17981,4411,193,1221,1843,831,323,380,237,233,125,7,101,4,4,4,0,0,0,0,0,0,143,132,75,3,54,11,11,11,0,0,0,0,0,0,54021
17982,12100,480,2731,4162,2984,1743,2316,850,735,291,35,409,115,115,100,11,4,0,0,0,0,1466,1456,759,68,629,10,3,0,0,3,7,6,0,1,54022
17983,2445,124,761,910,474,176,261,129,104,51,8,45,25,0,0,0,0,25,25,0,0,132,104,61,6,37,28,0,0,0,0,28,0,11,17,54023
17984,3253,232,974,1215,512,320,188,122,115,41,7,67,7,7,3,4,0,0,0,0,0,66,56,42,0,14,10,10,10,0,0,0,0,0,0,54024
17985,4607,411,1525,1649,805,217,260,131,122,54,25,43,9,9,9,0,0,0,0,0,0,129,121,82,0,39,8,8,8,0,0,0,0,0,0,54025
17986,1281,111,464,471,182,53,143,105,96,28,0,68,9,9,9,0,0,0,0,0,0,38,36,4,0,32,2,0,0,0,0,2,0,2,0,54026
17987,698,36,296,244,79,43,50,35,35,7,12,16,0,0,0,0,0,0,0,0,0,15,15,4,0,11,0,0,0,0,0,0,0,0,0,54027
17988,1470,127,539,522,222,60,116,51,45,21,4,20,6,6,6,0,0,0,0,0,0,65,58,27,12,19,7,7,7,0,0,0,0,0,0,54028
17989,1279,102,230,532,186,229,85,55,55,0,20,35,0,0,0,0,0,0,0,0,0,30,30,14,0,16,0,0,0,0,0,0,0,0,0,54082
17990,1876,131,884,603,195,63,137,54,35,17,0,18,19,16,13,3,0,3,3,0,0,83,74,36,0,38,9,9,0,4,5,0,0,0,0,54101
17991,635,52,369,155,38,21,33,18,18,4,0,14,0,0,0,0,0,0,0,0,0,15,15,5,0,10,0,0,0,0,0,0,0,0,0,54102
17992,292,49,109,79,24,31,6,5,4,4,0,0,1,1,1,0,0,0,0,0,0,1,1,0,0,1,0,0,0,0,0,0,0,0,0,54103
17993,1074,175,513,296,59,31,35,21,21,14,3,4,0,0,0,0,0,0,0,0,0,14,14,7,0,7,0,0,0,0,0,0,0,0,0,54104
17994,3238,313,1545,978,330,72,322,203,114,46,10,58,89,69,28,29,12,20,0,0,20,119,113,47,9,57,6,3,3,0,0,3,0,0,3,54106
17995,2312,176,1108,698,224,106,151,57,52,32,0,20,5,4,4,0,0,1,1,0,0,94,71,30,0,41,23,11,1,10,0,12,0,0,12,54107
17996,3528,290,1650,993,418,177,282,142,131,75,0,56,11,6,3,3,0,5,0,5,0,140,74,58,0,16,66,60,60,0,0,6,6,0,0,54110
17997,1720,152,877,453,190,48,88,46,30,13,0,17,16,16,16,0,0,0,0,0,0,42,31,24,0,7,11,5,0,0,5,6,0,6,0,54111
17998,1485,185,631,467,151,51,81,33,33,6,3,24,0,0,0,0,0,0,0,0,0,48,36,8,10,18,12,8,8,0,0,4,4,0,0,54112
17999,2278,94,807,897,377,103,190,101,101,53,23,25,0,0,0,0,0,0,0,0,0,89,89,11,14,64,0,0,0,0,0,0,0,0,0,54113
18000,4127,628,1740,1266,334,159,133,79,76,22,11,43,3,3,3,0,0,0,0,0,0,54,41,17,0,24,13,13,3,10,0,0,0,0,0,54114
18001,25818,1249,7218,8122,6738,2491,2706,1372,1161,487,99,575,211,140,57,83,0,71,55,0,16,1334,1293,512,134,647,41,30,30,0,0,11,0,0,11,54115
18002,475,31,168,143,73,60,239,68,64,34,12,18,4,4,0,0,4,0,0,0,0,171,171,37,4,130,0,0,0,0,0,0,0,0,0,54119
18003,96,4,62,20,10,0,2,0,0,0,0,0,0,0,0,0,0,0,0,0,0,2,0,0,0,0,2,2,0,2,0,0,0,0,0,54120
18004,2365,239,943,796,262,125,169,64,36,8,1,27,28,28,8,0,20,0,0,0,0,105,100,56,5,39,5,5,5,0,0,0,0,0,0,54121
18005,159,9,47,69,31,3,6,0,0,0,0,0,0,0,0,0,0,0,0,0,0,6,6,3,0,3,0,0,0,0,0,0,0,0,0,54123
18006,2731,387,1269,790,218,67,216,100,69,11,12,46,31,16,3,13,0,15,9,3,3,116,87,24,7,56,29,29,3,17,9,0,0,0,0,54124
18007,461,63,226,132,36,4,20,14,11,0,3,8,3,3,3,0,0,0,0,0,0,6,0,0,0,0,6,6,0,0,6,0,0,0,0,54125
18008,2482,274,1156,705,265,82,238,117,96,48,4,44,21,18,12,2,4,3,3,0,0,121,111,39,3,69,10,7,3,0,4,3,3,0,0,54126
18009,21,5,16,0,0,0,0,0,0,0,0,0,0,0,0,0,0,0,0,0,0,0,0,0,0,0,0,0,0,0,0,0,0,0,0,54127
18010,1217,141,502,423,113,38,76,45,38,12,3,23,7,7,5,0,2,0,0,0,0,31,23,7,3,13,8,8,1,7,0,0,0,0,0,54128
18011,2172,258,1007,591,264,52,171,81,66,26,0,40,15,7,7,0,0,8,8,0,0,90,54,15,2,37,36,24,24,0,0,12,12,0,0,54129
18012,16658,1156,7018,5252,2389,843,1380,783,649,366,24,259,134,117,100,17,0,17,14,0,3,597,528,293,33,202,69,63,50,13,0,6,6,0,0,54130
18013,1949,141,717,734,264,93,292,156,96,15,0,81,60,33,0,0,33,27,15,0,12,136,88,17,16,55,48,37,18,0,19,11,11,0,0,54135
18014,4626,384,1963,1277,781,221,259,154,139,97,0,42,15,15,15,0,0,0,0,0,0,105,105,43,0,62,0,0,0,0,0,0,0,0,0,54136
18015,765,109,392,184,70,10,40,10,10,7,0,3,0,0,0,0,0,0,0,0,0,30,16,10,3,3,14,14,0,0,14,0,0,0,0,54137
18016,716,83,339,209,51,34,29,21,21,3,10,8,0,0,0,0,0,0,0,0,0,8,8,3,0,5,0,0,0,0,0,0,0,0,0,54138
18017,2128,246,924,667,228,63,147,81,64,25,14,25,17,15,8,5,2,2,0,2,0,66,60,28,10,22,6,3,0,0,3,3,0,0,3,54139
18018,5881,359,2404,1916,971,231,452,242,184,64,0,120,58,58,58,0,0,0,0,0,0,210,210,80,32,98,0,0,0,0,0,0,0,0,0,54140
18019,1792,60,666,599,355,112,170,106,106,24,21,61,0,0,0,0,0,0,0,0,0,64,64,34,0,30,0,0,0,0,0,0,0,0,0,54141
18020,10443,792,4349,3740,990,572,700,379,321,143,8,170,58,58,9,46,3,0,0,0,0,321,315,165,74,76,6,6,6,0,0,0,0,0,0,54143
18021,1059,186,456,297,79,41,21,5,5,3,0,2,0,0,0,0,0,0,0,0,0,16,12,0,0,12,4,4,4,0,0,0,0,0,0,54149
18022,450,69,219,121,30,11,51,36,30,0,3,27,6,6,0,6,0,0,0,0,0,15,9,0,0,9,6,6,3,0,3,0,0,0,0,54150
18023,2435,179,1018,876,283,79,137,62,57,21,0,36,5,5,0,4,1,0,0,0,0,75,75,20,15,40,0,0,0,0,0,0,0,0,0,54151
18024,5128,572,2246,1574,486,250,370,235,222,102,31,89,13,10,10,0,0,3,3,0,0,135,115,58,0,57,20,14,3,11,0,6,0,0,6,54153
18025,3931,500,1659,1161,430,181,294,136,122,34,0,88,14,8,0,8,0,6,6,0,0,158,155,97,0,58,3,3,3,0,0,0,0,0,0,54154
18026,4049,348,1209,1273,877,342,362,227,204,53,0,151,23,14,0,0,14,9,5,0,4,135,124,52,7,65,11,0,0,0,0,11,0,0,11,54155
18027,1203,141,592,321,113,36,127,46,19,3,0,16,27,24,14,0,10,3,3,0,0,81,70,6,10,54,11,11,8,3,0,0,0,0,0,54156
18028,4284,481,1659,1580,388,176,346,182,160,77,42,41,22,22,6,0,16,0,0,0,0,164,161,60,3,98,3,0,0,0,0,3,0,3,0,54157
18029,1136,112,572,311,102,39,79,46,36,14,0,22,10,7,0,7,0,3,0,3,0,33,31,17,2,12,2,0,0,0,0,2,0,0,2,54159
18030,149,22,59,49,11,8,23,12,10,8,0,2,2,2,0,2,0,0,0,0,0,11,8,4,2,2,3,3,3,0,0,0,0,0,0,54160
18031,2110,339,935,607,180,49,130,85,72,32,8,32,13,11,7,0,4,2,2,0,0,45,35,11,0,24,10,10,10,0,0,0,0,0,0,54161
18032,5680,291,2249,2024,828,288,448,208,193,98,9,86,15,11,2,6,3,4,4,0,0,240,208,91,13,104,32,16,16,0,0,16,16,0,0,54162
18033,5051,432,2185,1544,643,247,398,158,144,80,2,62,14,10,10,0,0,4,0,0,4,240,215,104,36,75,25,24,15,9,0,1,0,0,1,54165
18034,12374,1228,5170,3620,1709,647,818,442,387,154,38,195,55,52,39,3,10,3,3,0,0,376,319,176,33,110,57,54,51,0,3,3,0,0,3,54166
18035,1711,11,398,499,533,270,107,22,22,14,0,8,0,0,0,0,0,0,0,0,0,85,85,27,7,51,0,0,0,0,0,0,0,0,0,54169
18036,2388,237,1189,630,219,113,222,118,91,28,0,63,27,13,2,11,0,14,0,0,14,104,97,40,8,49,7,7,0,4,3,0,0,0,0,54170
18037,2370,99,743,1034,365,129,91,34,34,18,0,16,0,0,0,0,0,0,0,0,0,57,57,43,0,14,0,0,0,0,0,0,0,0,0,54171
18038,2762,90,957,871,598,246,232,107,87,10,11,66,20,20,20,0,0,0,0,0,0,125,125,73,0,52,0,0,0,0,0,0,0,0,0,54173
18039,2160,266,1019,611,175,89,148,88,69,25,0,44,19,19,8,11,0,0,0,0,0,60,60,43,0,17,0,0,0,0,0,0,0,0,0,54174
18040,837,110,381,241,65,40,33,21,13,3,0,10,8,8,8,0,0,0,0,0,0,12,12,9,0,3,0,0,0,0,0,0,0,0,0,54175
18041,2210,274,997,699,175,65,127,90,82,43,15,24,8,8,0,8,0,0,0,0,0,37,37,18,3,16,0,0,0,0,0,0,0,0,0,54177
18042,1962,177,518,681,415,171,97,56,51,34,0,17,5,5,0,5,0,0,0,0,0,41,36,24,0,12,5,5,5,0,0,0,0,0,0,54180
18043,3827,417,1857,1103,306,144,293,155,138,46,0,92,17,17,17,0,0,0,0,0,0,138,118,80,11,27,20,0,0,0,0,20,20,0,0,54201
18044,1200,19,319,392,296,174,69,26,26,8,3,15,0,0,0,0,0,0,0,0,0,43,36,15,0,21,7,2,2,0,0,5,0,5,0,54202
18045,1194,99,508,339,167,81,97,52,47,31,4,12,5,5,2,3,0,0,0,0,0,45,25,15,0,10,20,20,0,20,0,0,0,0,0,54204
18046,1517,172,688,437,164,56,112,75,56,34,0,22,19,6,6,0,0,13,13,0,0,37,27,15,0,12,10,10,3,0,7,0,0,0,0,54205
18047,139,15,74,30,13,7,2,0,0,0,0,0,0,0,0,0,0,0,0,0,0,2,2,0,0,2,0,0,0,0,0,0,0,0,0,54207
18048,4228,448,1856,1260,540,124,406,193,162,102,19,41,31,28,25,3,0,3,0,3,0,213,209,116,14,79,4,4,4,0,0,0,0,0,0,54208
18049,988,56,271,309,207,145,39,24,21,20,0,1,3,3,0,0,3,0,0,0,0,15,14,3,9,2,1,1,1,0,0,0,0,0,0,54209
18050,723,37,232,137,209,108,46,31,24,18,5,1,7,0,0,0,0,7,0,0,7,15,15,1,5,9,0,0,0,0,0,0,0,0,0,54210
18051,176,7,19,49,77,24,14,8,5,0,0,5,3,3,0,0,3,0,0,0,0,6,6,3,0,3,0,0,0,0,0,0,0,0,0,54211
18052,928,30,292,196,242,168,40,23,23,10,0,13,0,0,0,0,0,0,0,0,0,17,17,4,0,13,0,0,0,0,0,0,0,0,0,54212
18053,871,71,454,236,88,22,148,86,38,11,0,27,48,5,5,0,0,43,43,0,0,62,60,50,3,7,2,2,0,0,2,0,0,0,0,54213
18054,166,7,79,52,21,7,32,20,8,0,0,8,12,6,6,0,0,6,6,0,0,12,2,0,2,0,10,10,10,0,0,0,0,0,0,54214
18055,4613,354,2223,1398,429,209,216,120,109,60,0,49,11,4,4,0,0,7,0,5,2,96,53,26,10,17,43,43,2,0,41,0,0,0,0,54216
18056,4896,433,1962,1700,618,183,414,233,230,68,35,127,3,3,3,0,0,0,0,0,0,181,169,91,13,65,12,2,2,0,0,10,0,0,10,54217
18057,28294,2958,10755,8628,4182,1771,2197,1119,901,353,183,365,218,145,63,42,40,73,29,12,32,1078,867,402,25,440,211,127,112,7,8,84,10,0,74,54220
18058,1098,61,506,328,165,38,87,53,42,26,0,16,11,8,8,0,0,3,0,0,3,34,25,15,0,10,9,9,9,0,0,0,0,0,0,54227
18059,1821,192,770,606,187,66,159,89,77,52,0,25,12,12,6,3,3,0,0,0,0,70,68,25,9,34,2,0,0,0,0,2,0,0,2,54228
18060,2885,292,1057,1007,362,167,95,38,38,13,2,23,0,0,0,0,0,0,0,0,0,57,54,22,0,32,3,3,3,0,0,0,0,0,0,54229
18061,3122,261,1482,912,284,183,226,107,93,45,5,43,14,9,4,5,0,5,0,0,5,119,101,53,12,36,18,18,9,0,9,0,0,0,0,54230
18062,539,63,234,163,72,7,35,16,11,2,0,9,5,5,5,0,0,0,0,0,0,19,19,10,0,9,0,0,0,0,0,0,0,0,0,54232
18063,1336,56,374,348,404,154,43,29,29,3,0,26,0,0,0,0,0,0,0,0,0,14,14,6,0,8,0,0,0,0,0,0,0,0,0,54234
18064,12858,833,4609,4147,2219,1050,687,374,296,139,0,157,78,77,56,0,21,1,1,0,0,313,231,161,4,66,82,82,77,0,5,0,0,0,0,54235
18065,10631,974,4739,3170,1280,468,753,438,352,105,33,214,86,74,52,8,14,12,0,12,0,315,290,127,32,131,25,7,5,0,2,18,3,0,15,54241
18066,1524,129,622,533,164,76,171,74,69,35,16,18,5,5,5,0,0,0,0,0,0,97,94,59,17,18,3,3,0,0,3,0,0,0,0,54245
18067,678,20,188,188,178,104,44,20,18,4,0,14,2,0,0,0,0,2,2,0,0,24,22,6,0,16,2,0,0,0,0,2,0,0,2,54246
18068,1555,159,669,507,163,57,150,86,78,30,0,48,8,8,4,0,4,0,0,0,0,64,62,21,6,35,2,2,2,0,0,0,0,0,0,54247
18069,15092,1853,3788,4104,3826,1521,1275,759,594,131,110,353,165,123,67,25,31,42,21,0,21,516,484,234,56,194,32,23,16,7,0,9,0,0,9,54301
18070,18310,3755,6232,5154,2265,904,1327,588,540,183,101,256,48,48,48,0,0,0,0,0,0,739,559,319,16,224,180,136,44,57,35,44,0,44,0,54302
18071,19226,2532,7466,5894,2632,702,1175,498,355,89,47,219,143,79,53,26,0,64,3,38,23,677,558,211,22,325,119,61,61,0,0,58,10,0,48,54303
18072,19296,1715,6871,6554,3155,1001,1636,987,869,338,99,432,118,118,111,0,7,0,0,0,0,649,565,336,52,177,84,45,20,0,25,39,19,0,20,54304
18073,941,310,586,40,5,0,25,25,9,0,0,9,16,13,0,0,13,3,0,0,3,0,0,0,0,0,0,0,0,0,0,0,0,0,0,54307
18074,21737,1698,6233,7504,4346,1956,2423,1241,1149,493,62,594,92,42,42,0,0,50,36,0,14,1182,1141,537,69,535,41,13,13,0,0,28,17,0,11,54311
18075,24558,994,7717,7961,5596,2290,2037,1073,1002,437,69,496,71,61,32,8,21,10,10,0,0,964,896,462,75,359,68,60,60,0,0,8,0,0,8,54313
18076,20929,2085,6939,6448,3694,1763,1590,745,642,321,41,280,103,65,45,8,12,38,32,0,6,845,834,387,39,408,11,11,11,0,0,0,0,0,0,54401
18077,16829,2002,5642,5111,2467,1607,1472,997,840,190,188,462,157,132,114,0,18,25,4,3,18,475,440,206,18,216,35,32,32,0,0,3,0,0,3,54403
18078,1822,481,732,437,111,61,167,110,54,18,5,31,56,13,3,7,3,43,32,0,11,57,34,22,5,7,23,0,0,0,0,23,23,0,0,54405
18079,2294,163,840,723,410,158,169,90,86,37,7,42,4,4,4,0,0,0,0,0,0,79,77,21,4,52,2,2,0,2,0,0,0,0,0,54406
18080,1113,108,371,298,223,113,52,29,26,2,2,22,3,3,0,0,3,0,0,0,0,23,23,10,0,13,0,0,0,0,0,0,0,0,0,54407
18081,758,97,374,218,53,16,61,41,37,8,6,23,4,4,0,4,0,0,0,0,0,20,16,5,3,8,4,2,0,0,2,2,0,0,2,54408
18082,9246,1055,4032,2839,928,392,697,403,340,165,62,113,63,60,46,0,14,3,0,0,3,294,267,102,19,146,27,27,25,2,0,0,0,0,0,54409
18083,1589,204,674,526,132,53,144,74,56,19,3,34,18,6,6,0,0,12,0,0,12,70,52,19,6,27,18,7,7,0,0,11,0,0,11,54410
18084,3588,594,1782,822,265,125,345,198,158,77,6,75,40,14,10,4,0,26,8,0,18,147,120,52,3,65,27,18,3,4,11,9,6,3,0,54411
18085,1390,181,624,384,157,44,111,70,47,10,8,29,23,17,15,2,0,6,6,0,0,41,40,20,3,17,1,0,0,0,0,1,1,0,0,54412
18086,82,12,46,18,5,1,0,0,0,0,0,0,0,0,0,0,0,0,0,0,0,0,0,0,0,0,0,0,0,0,0,0,0,0,0,54413
18087,2320,244,1193,631,162,90,169,97,59,17,9,33,38,32,23,4,5,6,6,0,0,72,69,25,0,44,3,1,1,0,0,2,0,0,2,54414
18088,1268,158,629,333,103,45,112,63,40,4,7,29,23,15,6,7,2,8,2,0,6,49,40,7,1,32,9,9,9,0,0,0,0,0,0,54416
18089,56,2,49,5,0,0,12,2,2,0,2,0,0,0,0,0,0,0,0,0,0,10,10,10,0,0,0,0,0,0,0,0,0,0,0,54417
18090,779,87,374,229,73,16,53,24,24,10,0,14,0,0,0,0,0,0,0,0,0,29,21,14,0,7,8,8,8,0,0,0,0,0,0,54418
18091,850,117,330,202,150,51,76,34,25,9,2,14,9,0,0,0,0,9,0,0,9,42,42,12,0,30,0,0,0,0,0,0,0,0,0,54420
18092,1985,366,861,577,140,41,159,72,37,10,2,25,35,13,10,0,3,22,14,0,8,87,54,17,0,37,33,13,10,0,3,20,10,0,10,54421
18093,707,230,267,138,65,7,65,46,40,16,2,22,6,3,3,0,0,3,2,0,1,19,14,7,6,1,5,1,0,1,0,4,4,0,0,54422
18094,1611,135,680,461,243,92,107,70,70,16,0,54,0,0,0,0,0,0,0,0,0,37,26,6,9,11,11,11,7,4,0,0,0,0,0,54423
18095,1337,126,606,425,100,80,79,42,30,8,0,22,12,11,0,3,8,1,0,0,1,37,35,16,3,16,2,0,0,0,0,2,0,0,2,54424
18096,1296,253,672,270,76,25,129,78,67,21,3,43,11,6,2,0,4,5,0,0,5,51,40,16,0,24,11,2,2,0,0,9,4,0,5,54425
18097,2824,328,1324,801,323,48,198,113,99,24,19,56,14,9,9,0,0,5,5,0,0,85,76,34,9,33,9,0,0,0,0,9,3,0,6,54426
18098,862,131,460,201,60,10,56,20,17,1,0,16,3,3,0,1,2,0,0,0,0,36,34,23,0,11,2,2,0,2,0,0,0,0,0,54427
18099,935,150,405,286,65,29,42,17,14,3,0,11,3,0,0,0,0,3,0,0,3,25,25,22,0,3,0,0,0,0,0,0,0,0,0,54428
18100,79,8,49,22,0,0,14,9,9,0,0,9,0,0,0,0,0,0,0,0,0,5,5,0,0,5,0,0,0,0,0,0,0,0,0,54430
18101,1157,139,567,307,100,44,91,59,42,6,1,35,17,5,2,3,0,12,6,0,6,32,23,3,1,19,9,5,2,0,3,4,0,0,4,54433
18102,1555,212,693,483,118,49,164,110,60,27,0,33,50,32,28,4,0,18,15,0,3,54,44,8,7,29,10,4,4,0,0,6,2,0,4,54435
18103,1371,260,628,374,73,36,159,96,59,19,7,33,37,7,7,0,0,30,18,0,12,63,42,24,2,16,21,6,6,0,0,15,2,0,13,54436
18104,1840,304,707,568,161,100,232,111,68,30,0,38,43,18,14,0,4,25,15,0,10,121,81,19,0,62,40,15,12,0,3,25,13,0,12,54437
18105,2146,219,1089,514,232,92,134,77,72,39,10,23,5,2,2,0,0,3,3,0,0,57,57,41,0,16,0,0,0,0,0,0,0,0,0,54440
18106,536,25,176,172,101,62,34,16,16,10,0,6,0,0,0,0,0,0,0,0,0,18,18,10,0,8,0,0,0,0,0,0,0,0,0,54441
18107,718,79,321,215,66,37,176,122,93,15,4,74,29,21,9,3,9,8,0,0,8,54,49,22,0,27,5,3,0,3,0,2,0,0,2,54442
18108,1591,146,694,455,221,75,98,56,44,11,0,33,12,6,6,0,0,6,0,0,6,42,40,15,5,20,2,0,0,0,0,2,2,0,0,54443
18109,1823,306,846,451,178,42,140,85,60,27,2,31,25,2,2,0,0,23,20,0,3,55,35,15,2,18,20,2,0,0,2,18,8,0,10,54446
18110,349,95,153,59,26,16,35,18,16,1,0,15,2,2,2,0,0,0,0,0,0,17,3,1,0,2,14,14,9,0,5,0,0,0,0,54447
18111,3108,250,1393,957,388,120,274,141,139,55,0,84,2,2,2,0,0,0,0,0,0,133,128,67,2,59,5,5,5,0,0,0,0,0,0,54448
18112,18322,1856,6305,5343,2873,1945,1258,667,556,159,17,380,111,110,90,20,0,1,0,1,0,591,488,246,56,186,103,101,87,0,14,2,2,0,0,54449
18113,250,65,112,52,15,6,20,17,13,0,0,13,4,4,1,3,0,0,0,0,0,3,3,1,0,2,0,0,0,0,0,0,0,0,0,54450
18114,8213,1007,3693,2345,809,359,598,295,264,87,28,149,31,29,10,18,1,2,2,0,0,303,268,115,15,138,35,13,10,3,0,22,6,2,14,54451
18115,13764,1606,5482,4516,1518,642,992,551,515,141,55,319,36,22,6,0,16,14,4,0,10,441,366,142,16,208,75,67,67,0,0,8,0,7,1,54452
18116,821,99,448,194,67,13,77,46,32,14,2,16,14,11,11,0,0,3,3,0,0,31,25,11,0,14,6,3,0,3,0,3,0,0,3,54454
18117,11556,679,4380,3515,2189,793,912,482,417,175,44,198,65,40,32,2,6,25,14,9,2,430,361,181,28,152,69,55,42,13,0,14,0,0,14,54455
18118,4293,541,1955,1180,417,200,387,190,125,60,5,60,65,47,37,10,0,18,7,0,11,197,160,94,0,66,37,26,24,0,2,11,4,0,7,54456
18119,6231,562,2618,2060,648,343,411,214,178,41,35,102,36,31,4,25,2,5,0,0,5,197,185,52,31,102,12,12,6,0,6,0,0,0,0,54457
18120,97,4,43,26,17,7,14,7,7,0,0,7,0,0,0,0,0,0,0,0,0,7,1,0,0,1,6,6,6,0,0,0,0,0,0,54458
18121,906,120,413,253,97,23,30,16,13,0,0,13,3,1,1,0,0,2,0,2,0,14,13,12,0,1,1,1,0,1,0,0,0,0,0,54459
18122,1794,371,730,451,186,56,151,80,52,11,2,39,28,16,13,3,0,12,4,0,8,71,34,13,11,10,37,15,7,0,8,22,12,0,10,54460
18123,275,60,154,49,9,3,14,9,6,4,0,2,3,3,0,3,0,0,0,0,0,5,5,0,0,5,0,0,0,0,0,0,0,0,0,54462
18124,618,50,253,204,88,23,23,18,14,6,0,8,4,4,4,0,0,0,0,0,0,5,5,0,0,5,0,0,0,0,0,0,0,0,0,54463
18125,560,43,249,202,45,21,11,5,5,2,0,3,0,0,0,0,0,0,0,0,0,6,6,0,0,6,0,0,0,0,0,0,0,0,0,54465
18126,2024,205,988,541,213,77,145,77,71,13,1,57,6,6,6,0,0,0,0,0,0,68,54,22,2,30,14,14,9,0,5,0,0,0,0,54466
18127,8977,774,2912,2593,2081,617,714,411,283,103,47,133,128,124,124,0,0,4,0,0,4,303,219,95,18,106,84,84,20,23,41,0,0,0,0,54467
18128,1299,65,516,482,118,118,130,104,100,2,7,91,4,4,4,0,0,0,0,0,0,26,26,13,0,13,0,0,0,0,0,0,0,0,0,54469
18129,1542,220,742,385,127,68,81,60,56,18,0,38,4,0,0,0,0,4,4,0,0,21,17,8,0,9,4,4,4,0,0,0,0,0,0,54470
18130,1265,100,566,346,154,99,101,70,67,35,13,19,3,0,0,0,0,3,0,0,3,31,24,19,0,5,7,7,4,3,0,0,0,0,0,54471
18131,1821,207,922,436,195,61,97,46,34,3,4,27,12,12,3,0,9,0,0,0,0,51,51,19,2,30,0,0,0,0,0,0,0,0,0,54473
18132,2630,157,929,948,442,154,260,134,128,76,17,35,6,6,6,0,0,0,0,0,0,126,100,37,0,63,26,26,18,0,8,0,0,0,0,54474
18133,1127,76,533,368,114,36,96,44,41,27,3,11,3,3,3,0,0,0,0,0,0,52,51,19,9,23,1,1,0,0,1,0,0,0,0,54475
18134,12727,1135,4502,4276,1799,1015,940,460,361,88,38,235,99,99,99,0,0,0,0,0,0,480,442,232,25,185,38,38,24,14,0,0,0,0,0,54476
18135,2721,385,1203,783,254,96,247,117,108,36,4,68,9,9,9,0,0,0,0,0,0,130,114,37,5,72,16,2,2,0,0,14,6,0,8,54479
18136,854,132,360,226,71,65,84,43,20,2,2,16,23,23,23,0,0,0,0,0,0,41,36,16,10,10,5,5,5,0,0,0,0,0,0,54480
18137,16047,1132,4975,4910,3244,1786,2985,1384,1328,363,136,829,56,32,13,4,15,24,0,21,3,1601,1544,853,141,550,57,56,38,6,12,1,0,0,1,54481
18138,6472,366,2276,1893,1281,656,434,286,247,96,28,123,39,39,39,0,0,0,0,0,0,148,134,52,10,72,14,0,0,0,0,14,14,0,0,54482
18139,3410,300,1540,940,441,189,259,155,140,55,10,75,15,15,15,0,0,0,0,0,0,104,96,52,3,41,8,3,3,0,0,5,0,0,5,54484
18140,237,30,123,50,15,19,14,14,10,4,0,6,4,4,0,4,0,0,0,0,0,0,0,0,0,0,0,0,0,0,0,0,0,0,0,54485
18141,1686,222,846,429,138,51,116,61,53,18,4,31,8,4,4,0,0,4,4,0,0,55,44,23,0,21,11,4,2,2,0,7,0,0,7,54486
18142,7233,714,2758,2625,790,346,402,180,165,60,23,82,15,15,14,0,1,0,0,0,0,222,187,84,13,90,35,29,3,0,26,6,0,2,4,54487
18143,743,130,353,180,65,15,67,46,35,6,5,24,11,6,5,1,0,5,5,0,0,21,14,9,0,5,7,1,0,1,0,6,6,0,0,54488
18144,1071,53,480,386,110,42,72,42,38,8,6,24,4,4,4,0,0,0,0,0,0,30,26,5,0,21,4,0,0,0,0,4,0,0,4,54489
18145,597,51,269,178,78,21,56,29,26,1,0,25,3,3,3,0,0,0,0,0,0,27,27,2,0,25,0,0,0,0,0,0,0,0,0,54490
18146,1171,156,480,392,111,32,57,26,21,7,4,10,5,5,0,0,5,0,0,0,0,31,31,15,0,16,0,0,0,0,0,0,0,0,0,54491
18147,511,45,257,145,57,7,35,17,9,5,0,4,8,8,8,0,0,0,0,0,0,18,13,11,0,2,5,5,3,0,2,0,0,0,0,54493
18148,19325,1339,7359,7022,2320,1285,1148,526,472,105,9,358,54,54,31,14,9,0,0,0,0,622,572,184,33,355,50,26,21,1,4,24,9,0,15,54494
18149,5319,586,2383,1674,537,139,455,215,178,35,3,140,37,37,16,21,0,0,0,0,0,240,135,68,22,45,105,103,51,40,12,2,0,0,2,54495
18150,1388,286,635,381,46,40,115,55,19,11,0,8,36,2,2,0,0,34,27,0,7,60,35,16,2,17,25,5,4,1,0,20,16,0,4,54498
18151,2041,252,985,523,179,102,192,106,78,23,12,43,28,13,13,0,0,15,0,0,15,86,81,36,6,39,5,5,2,0,3,0,0,0,0,54499
18152,14606,1204,5048,5238,1819,1297,1074,577,503,240,11,252,74,67,59,5,3,7,4,0,3,497,453,240,63,150,44,37,11,19,7,7,0,0,7,54501
18153,912,91,461,284,49,27,35,21,13,4,0,9,8,3,3,0,0,5,0,5,0,14,14,5,0,9,0,0,0,0,0,0,0,0,0,54511
18154,793,32,251,252,173,85,23,9,9,3,0,6,0,0,0,0,0,0,0,0,0,14,14,5,0,9,0,0,0,0,0,0,0,0,0,54512
18155,320,28,134,109,38,11,8,5,5,4,0,1,0,0,0,0,0,0,0,0,0,3,3,2,0,1,0,0,0,0,0,0,0,0,0,54513
18156,1505,132,683,444,195,51,101,33,30,13,0,17,3,3,1,0,2,0,0,0,0,68,60,29,0,31,8,6,6,0,0,2,0,0,2,54514
18157,341,36,148,99,49,9,17,6,6,0,0,6,0,0,0,0,0,0,0,0,0,11,11,3,0,8,0,0,0,0,0,0,0,0,0,54515
18158,152,9,68,59,8,8,0,0,0,0,0,0,0,0,0,0,0,0,0,0,0,0,0,0,0,0,0,0,0,0,0,0,0,0,0,54517
18159,915,81,316,314,139,65,38,23,20,15,0,5,3,3,0,3,0,0,0,0,0,15,15,2,0,13,0,0,0,0,0,0,0,0,0,54519
18160,2908,461,1111,946,257,133,232,101,78,38,4,36,23,20,19,1,0,3,0,0,3,131,102,28,9,65,29,26,13,8,5,3,0,0,3,54520
18161,5594,513,1940,1901,851,389,233,139,124,25,25,74,15,11,8,3,0,4,0,0,4,94,80,30,0,50,14,11,11,0,0,3,0,0,3,54521
18162,588,94,255,178,49,12,49,24,13,4,0,9,11,0,0,0,0,11,11,0,0,25,5,5,0,0,20,20,20,0,0,0,0,0,0,54524
18163,156,17,68,50,21,0,9,2,2,0,0,2,0,0,0,0,0,0,0,0,0,7,7,2,3,2,0,0,0,0,0,0,0,0,0,54525
18164,582,95,264,169,49,5,44,24,18,3,5,10,6,6,6,0,0,0,0,0,0,20,17,2,2,13,3,3,3,0,0,0,0,0,0,54526
18165,701,127,278,204,69,23,59,30,23,1,0,22,7,7,2,0,5,0,0,0,0,29,24,8,5,11,5,0,0,0,0,5,5,0,0,54527
18166,952,90,302,336,152,72,22,9,9,0,0,9,0,0,0,0,0,0,0,0,0,13,10,2,3,5,3,3,3,0,0,0,0,0,0,54529
18167,639,89,290,213,40,7,14,7,7,3,0,4,0,0,0,0,0,0,0,0,0,7,7,0,0,7,0,0,0,0,0,0,0,0,0,54530
18168,1159,39,388,373,213,146,46,18,15,0,0,15,3,3,3,0,0,0,0,0,0,28,28,11,0,17,0,0,0,0,0,0,0,0,0,54531
18169,1818,164,586,710,229,129,81,42,41,2,8,31,1,1,1,0,0,0,0,0,0,39,32,13,5,14,7,7,2,5,0,0,0,0,0,54534
18170,162,6,66,52,36,2,37,25,4,2,0,2,21,21,0,0,21,0,0,0,0,12,5,1,0,4,7,7,0,0,7,0,0,0,0,54536
18171,395,46,187,115,37,10,27,10,7,1,1,5,3,2,2,0,0,1,0,0,1,17,15,2,2,11,2,2,2,0,0,0,0,0,0,54537
18172,2145,254,788,721,248,134,132,68,46,8,0,38,22,22,14,3,5,0,0,0,0,64,63,19,14,30,1,1,0,1,0,0,0,0,0,54538
18173,1023,69,313,388,192,61,29,7,7,3,4,0,0,0,0,0,0,0,0,0,0,22,22,9,0,13,0,0,0,0,0,0,0,0,0,54539
18174,778,63,241,254,164,56,130,91,40,11,3,26,51,51,51,0,0,0,0,0,0,39,39,14,0,25,0,0,0,0,0,0,0,0,0,54540
18175,1013,131,486,288,84,24,86,55,25,3,0,22,30,24,11,5,8,6,3,0,3,31,31,5,7,19,0,0,0,0,0,0,0,0,0,54541
18176,449,89,224,100,34,2,4,0,0,0,0,0,0,0,0,0,0,0,0,0,0,4,4,4,0,0,0,0,0,0,0,0,0,0,0,54542
18177,717,37,151,257,161,111,46,9,9,6,0,3,0,0,0,0,0,0,0,0,0,37,37,4,0,33,0,0,0,0,0,0,0,0,0,54545
18178,943,100,401,342,79,21,29,4,3,0,0,3,1,1,1,0,0,0,0,0,0,25,20,0,0,20,5,5,5,0,0,0,0,0,0,54546
18179,1064,98,460,295,137,74,33,30,30,5,0,25,0,0,0,0,0,0,0,0,0,3,3,0,0,3,0,0,0,0,0,0,0,0,0,54547
18180,3741,176,1193,1077,740,555,189,151,106,10,12,84,45,45,45,0,0,0,0,0,0,38,38,10,0,28,0,0,0,0,0,0,0,0,0,54548
18181,480,38,120,201,81,40,33,21,20,14,0,6,1,1,0,1,0,0,0,0,0,12,12,6,0,6,0,0,0,0,0,0,0,0,0,54550
18182,3283,333,1419,999,373,159,243,126,76,16,2,58,50,44,26,6,12,6,4,0,2,117,114,83,0,31,3,3,2,0,1,0,0,0,0,54552
18183,1040,80,377,352,157,74,35,24,24,1,0,23,0,0,0,0,0,0,0,0,0,11,8,2,3,3,3,0,0,0,0,3,0,0,3,54554
18184,3794,349,1601,1177,471,196,151,90,79,41,6,32,11,11,5,6,0,0,0,0,0,61,56,15,8,33,5,5,0,1,4,0,0,0,0,54555
18185,891,105,402,303,60,21,45,24,16,5,1,10,8,3,2,1,0,5,3,0,2,21,19,5,0,14,2,2,0,0,2,0,0,0,0,54556
18186,810,29,234,262,194,91,26,21,19,16,0,3,2,2,2,0,0,0,0,0,0,5,5,2,0,3,0,0,0,0,0,0,0,0,0,54557
18187,1865,134,734,582,299,116,76,36,36,21,0,15,0,0,0,0,0,0,0,0,0,40,35,13,0,22,5,2,0,0,2,3,3,0,0,54558
18188,451,45,182,152,37,35,55,18,16,6,0,10,2,2,0,0,2,0,0,0,0,37,27,2,1,24,10,10,7,3,0,0,0,0,0,54559
18189,427,28,158,122,94,25,4,4,4,2,0,2,0,0,0,0,0,0,0,0,0,0,0,0,0,0,0,0,0,0,0,0,0,0,0,54560
18190,17,0,7,0,10,0,0,0,0,0,0,0,0,0,0,0,0,0,0,0,0,0,0,0,0,0,0,0,0,0,0,0,0,0,0,54561
18191,1388,119,404,381,280,204,126,56,23,0,0,23,33,33,33,0,0,0,0,0,0,70,70,14,0,56,0,0,0,0,0,0,0,0,0,54562
18192,532,82,223,156,46,25,34,15,13,6,0,7,2,2,2,0,0,0,0,0,0,19,18,10,0,8,1,1,1,0,0,0,0,0,0,54563
18193,396,33,221,125,12,5,9,9,5,2,0,3,4,2,2,0,0,2,0,0,2,0,0,0,0,0,0,0,0,0,0,0,0,0,0,54564
18194,89,24,6,44,9,6,10,9,8,8,0,0,1,1,0,1,0,0,0,0,0,1,1,0,0,1,0,0,0,0,0,0,0,0,0,54565
18195,892,141,379,290,60,22,113,55,55,5,0,50,0,0,0,0,0,0,0,0,0,58,32,18,6,8,26,11,4,0,7,15,0,0,15,54566
18196,3770,263,1287,1483,405,332,272,113,101,45,0,56,12,12,12,0,0,0,0,0,0,159,142,50,0,92,17,0,0,0,0,17,17,0,0,54568
18197,28505,1774,7285,9461,5964,4021,5066,2011,1855,654,155,1046,156,114,101,13,0,42,18,0,24,3055,3013,1267,175,1571,42,39,32,0,7,3,3,0,0,54601
18198,10218,1065,3615,3423,1546,569,673,351,272,81,53,138,79,28,25,0,3,51,51,0,0,322,267,167,10,90,55,55,31,0,24,0,0,0,0,54603
18199,1341,155,534,430,147,75,51,25,25,11,3,11,0,0,0,0,0,0,0,0,0,26,26,6,3,17,0,0,0,0,0,0,0,0,0,54610
18200,769,85,341,194,102,47,72,28,28,10,0,18,0,0,0,0,0,0,0,0,0,44,43,10,2,31,1,1,1,0,0,0,0,0,0,54611
18201,3441,564,1487,863,331,196,186,117,70,41,0,29,47,2,2,0,0,45,36,9,0,69,62,20,0,42,7,0,0,0,0,7,4,0,3,54612
18202,1622,287,744,464,85,42,135,84,73,18,0,55,11,11,0,11,0,0,0,0,0,51,36,22,11,3,15,15,0,15,0,0,0,0,0,54613
18203,1912,143,803,639,238,89,199,125,120,32,8,80,5,0,0,0,0,5,5,0,0,74,70,19,0,51,4,0,0,0,0,4,0,0,4,54614
18204,7818,1001,3241,2379,761,436,458,240,176,58,13,105,64,55,26,19,10,9,2,0,7,218,127,75,11,41,91,59,42,2,15,32,17,0,15,54615
18205,1727,279,736,483,177,52,166,103,69,22,0,47,34,34,23,11,0,0,0,0,0,63,57,46,3,8,6,6,6,0,0,0,0,0,0,54616
18206,1612,180,726,517,135,54,103,51,38,11,6,21,13,13,8,2,3,0,0,0,0,52,36,24,7,5,16,16,6,10,0,0,0,0,0,54618
18207,2086,463,871,506,159,87,277,158,63,27,0,36,95,15,15,0,0,80,34,0,46,119,62,28,0,34,57,8,8,0,0,49,19,0,30,54619
18208,764,88,271,286,84,35,35,25,16,5,0,11,9,8,8,0,0,1,0,0,1,10,10,2,0,8,0,0,0,0,0,0,0,0,0,54621
18209,1537,121,805,418,148,45,104,63,62,18,7,37,1,1,1,0,0,0,0,0,0,41,39,21,0,18,2,0,0,0,0,2,2,0,0,54622
18210,1426,54,587,422,228,135,76,39,34,22,0,12,5,5,5,0,0,0,0,0,0,37,32,13,3,16,5,2,0,0,2,3,0,0,3,54623
18211,1036,90,446,340,87,73,42,21,21,5,0,16,0,0,0,0,0,0,0,0,0,21,21,12,0,9,0,0,0,0,0,0,0,0,0,54624
18212,183,15,91,43,32,2,14,9,4,0,0,4,5,5,5,0,0,0,0,0,0,5,5,5,0,0,0,0,0,0,0,0,0,0,0,54625
18213,877,64,421,268,78,46,61,36,32,1,6,25,4,4,0,4,0,0,0,0,0,25,25,4,0,21,0,0,0,0,0,0,0,0,0,54626
18214,1360,135,553,445,143,84,87,51,49,19,3,27,2,2,2,0,0,0,0,0,0,36,33,12,0,21,3,3,3,0,0,0,0,0,0,54627
18215,912,121,399,251,71,70,36,19,17,0,0,17,2,2,2,0,0,0,0,0,0,17,17,5,0,12,0,0,0,0,0,0,0,0,0,54628
18216,1797,153,643,529,366,106,82,48,46,20,6,20,2,2,2,0,0,0,0,0,0,34,31,16,1,14,3,3,3,0,0,0,0,0,0,54629
18217,2796,218,1013,921,399,245,210,102,95,24,3,68,7,7,0,7,0,0,0,0,0,108,105,33,8,64,3,3,3,0,0,0,0,0,0,54630
18218,1358,147,502,466,148,95,80,40,29,9,0,20,11,11,9,2,0,0,0,0,0,40,34,8,6,20,6,3,3,0,0,3,3,0,0,54631
18219,830,93,299,265,123,50,34,17,14,4,0,10,3,3,3,0,0,0,0,0,0,17,17,2,1,14,0,0,0,0,0,0,0,0,0,54632
18220,2698,472,1182,696,210,138,237,120,73,40,6,27,47,16,15,0,1,31,10,0,21,117,66,7,0,59,51,18,10,0,8,33,3,0,30,54634
18221,1265,144,590,370,117,44,62,32,25,9,4,12,7,7,3,4,0,0,0,0,0,30,28,9,0,19,2,0,0,0,0,2,2,0,0,54635
18222,9264,350,2861,3699,1533,821,757,462,372,155,31,186,90,57,45,0,12,33,0,0,33,295,295,118,80,97,0,0,0,0,0,0,0,0,0,54636
18223,125,18,36,57,5,9,1,0,0,0,0,0,0,0,0,0,0,0,0,0,0,1,1,0,0,1,0,0,0,0,0,0,0,0,0,54637
18224,955,119,430,268,105,33,60,22,20,13,0,7,2,0,0,0,0,2,2,0,0,38,34,9,0,25,4,0,0,0,0,4,4,0,0,54638
18225,1748,357,714,384,162,131,129,44,28,13,2,13,16,2,0,2,0,14,7,2,5,85,44,16,0,28,41,0,0,0,0,41,14,0,27,54639
18226,0,0,0,0,0,0,0,0,0,0,0,0,0,0,0,0,0,0,0,0,0,0,0,0,0,0,0,0,0,0,0,0,0,0,0,54641
18227,1419,109,649,393,169,99,97,53,45,10,1,34,8,4,2,2,0,4,4,0,0,44,39,8,1,30,5,2,2,0,0,3,3,0,0,54642
18228,6,1,3,2,0,0,0,0,0,0,0,0,0,0,0,0,0,0,0,0,0,0,0,0,0,0,0,0,0,0,0,0,0,0,0,54643
18229,880,72,415,268,92,33,49,46,39,16,23,0,7,7,3,4,0,0,0,0,0,3,3,3,0,0,0,0,0,0,0,0,0,0,0,54644
18230,51,1,26,18,0,6,0,0,0,0,0,0,0,0,0,0,0,0,0,0,0,0,0,0,0,0,0,0,0,0,0,0,0,0,0,54645
18231,2577,372,1115,811,178,101,237,92,47,12,22,13,45,29,29,0,0,16,16,0,0,145,107,12,12,83,38,36,10,10,16,2,0,0,2,54646
18232,979,273,412,197,74,23,102,43,19,7,3,9,24,10,10,0,0,14,13,0,1,59,58,18,2,38,1,0,0,0,0,1,0,0,1,54648
18233,15835,744,4187,5546,3281,2077,1111,568,452,168,20,264,116,116,101,0,15,0,0,0,0,543,467,222,60,185,76,50,45,5,0,26,0,0,26,54650
18234,901,163,398,259,58,23,71,19,16,6,0,10,3,3,3,0,0,0,0,0,0,52,40,10,6,24,12,0,0,0,0,12,3,0,9,54651
18235,631,125,221,197,59,29,54,14,10,2,3,5,4,2,2,0,0,2,0,2,0,40,37,8,0,29,3,3,2,0,1,0,0,0,0,54652
18236,549,27,239,239,39,5,42,13,6,3,1,2,7,0,0,0,0,7,0,0,7,29,26,8,0,18,3,3,0,0,3,0,0,0,0,54653
18237,125,11,69,30,15,0,3,3,3,0,0,3,0,0,0,0,0,0,0,0,0,0,0,0,0,0,0,0,0,0,0,0,0,0,0,54654
18238,1240,195,516,332,120,77,46,31,28,1,0,27,3,3,3,0,0,0,0,0,0,15,10,2,0,8,5,0,0,0,0,5,0,0,5,54655
18239,11946,1367,4634,3650,1548,747,881,504,406,140,34,232,98,80,49,31,0,18,7,0,11,377,302,130,22,150,75,62,58,4,0,13,3,0,10,54656
18240,285,34,126,103,18,4,29,17,17,5,0,12,0,0,0,0,0,0,0,0,0,12,11,7,0,4,1,1,1,0,0,0,0,0,0,54657
18241,1580,105,454,673,270,78,70,37,24,12,3,9,13,13,10,3,0,0,0,0,0,33,31,20,2,9,2,2,2,0,0,0,0,0,0,54658
18242,918,199,355,247,88,29,89,36,12,10,0,2,24,7,0,0,7,17,15,0,2,53,27,11,0,16,26,4,4,0,0,22,9,0,13,54659
18243,10801,1043,4017,3738,1476,527,886,425,341,104,14,223,84,34,10,11,13,50,9,0,41,461,324,163,4,157,137,108,92,0,16,29,4,0,25,54660
18244,2399,166,842,858,331,202,176,84,78,49,0,29,6,6,6,0,0,0,0,0,0,92,90,23,11,56,2,2,2,0,0,0,0,0,0,54661
18245,1091,133,458,331,104,65,82,36,26,6,3,17,10,10,10,0,0,0,0,0,0,46,36,23,2,11,10,2,0,0,2,8,0,0,8,54664
18246,6032,553,2180,1889,897,513,522,283,239,112,11,116,44,35,13,0,22,9,4,0,5,239,202,80,0,122,37,25,25,0,0,12,0,0,12,54665
18247,1863,166,868,584,164,81,105,40,30,11,1,18,10,9,9,0,0,1,0,0,1,65,41,11,0,30,24,15,15,0,0,9,0,4,5,54666
18248,3004,370,969,948,475,242,178,88,70,27,2,41,18,16,13,3,0,2,0,0,2,90,69,21,4,44,21,21,9,1,11,0,0,0,0,54667
18249,5222,318,1708,1772,1049,375,340,205,182,77,0,105,23,16,6,0,10,7,0,0,7,135,123,91,7,25,12,12,4,3,5,0,0,0,0,54669
18250,1058,229,461,260,70,38,142,83,34,15,0,19,49,10,6,0,4,39,0,0,39,59,26,8,0,18,33,10,3,0,7,23,0,0,23,54670
18251,24019,1029,5446,7873,5972,3699,4140,1836,1694,620,157,917,142,134,110,13,11,8,8,0,0,2304,2213,919,155,1139,91,57,12,30,15,34,3,0,31,54701
18252,26251,1678,8454,9377,4754,1988,2313,1070,772,385,83,304,298,262,70,138,54,36,34,0,2,1243,1123,612,56,455,120,120,99,21,0,0,0,0,0,54703
18253,4736,280,1441,1596,923,496,230,98,68,0,45,23,30,30,0,30,0,0,0,0,0,132,78,40,0,38,54,54,29,25,0,0,0,0,0,54720
18254,989,61,469,327,93,39,59,40,40,14,2,24,0,0,0,0,0,0,0,0,0,19,16,4,6,6,3,3,3,0,0,0,0,0,0,54721
18255,2565,616,891,723,244,91,205,123,74,26,2,46,49,15,4,0,11,34,28,0,6,82,60,32,0,28,22,6,3,3,0,16,0,0,16,54722
18256,885,117,381,274,85,28,56,35,22,12,3,7,13,13,3,10,0,0,0,0,0,21,19,14,0,5,2,2,2,0,0,0,0,0,0,54723
18257,4868,346,2012,1697,581,232,417,165,117,50,2,65,48,46,43,3,0,2,2,0,0,252,207,102,5,100,45,39,36,3,0,6,4,2,0,54724
18258,2007,199,887,576,232,113,96,54,44,9,7,28,10,7,6,1,0,3,0,1,2,42,42,19,0,23,0,0,0,0,0,0,0,0,0,54725
18259,1149,222,512,281,103,31,84,60,50,38,9,3,10,6,4,2,0,4,4,0,0,24,19,9,3,7,5,2,0,0,2,3,1,0,2,54726
18260,3366,391,1411,1057,392,115,280,175,150,36,15,99,25,25,12,11,2,0,0,0,0,105,92,34,3,55,13,11,11,0,0,2,0,0,2,54727
18261,4605,598,1863,1480,355,309,183,105,89,46,2,41,16,9,7,2,0,7,7,0,0,78,43,18,5,20,35,13,10,3,0,22,8,0,14,54728
18262,22009,1580,7856,7480,3713,1380,1466,880,777,250,28,499,103,53,42,4,7,50,15,35,0,586,480,266,25,189,106,58,35,23,0,48,44,0,4,54729
18263,3235,228,1189,1131,453,234,212,108,89,26,8,55,19,9,2,7,0,10,10,0,0,104,79,19,14,46,25,16,10,2,4,9,0,0,9,54730
18264,539,134,241,118,34,12,48,32,12,5,0,7,20,6,6,0,0,14,4,0,10,16,11,0,0,11,5,0,0,0,0,5,0,0,5,54731
18265,2108,308,948,592,185,75,211,148,115,20,0,95,33,33,9,2,22,0,0,0,0,63,53,21,15,17,10,10,2,0,8,0,0,0,0,54732
18266,900,124,347,298,86,45,71,42,29,18,4,7,13,13,9,3,1,0,0,0,0,29,27,19,0,8,2,2,0,2,0,0,0,0,0,54733
18267,542,76,258,143,58,7,48,35,35,3,0,32,0,0,0,0,0,0,0,0,0,13,13,6,4,3,0,0,0,0,0,0,0,0,0,54734
18268,2789,277,1252,833,313,114,210,127,109,46,0,63,18,12,12,0,0,6,0,0,6,83,77,45,0,32,6,3,3,0,0,3,0,0,3,54736
18269,365,68,116,109,49,23,22,11,11,5,2,4,0,0,0,0,0,0,0,0,0,11,11,2,0,9,0,0,0,0,0,0,0,0,0,54737
18270,1983,162,698,651,343,129,151,98,95,21,16,58,3,3,3,0,0,0,0,0,0,53,45,19,0,26,8,5,5,0,0,3,0,0,3,54738
18271,3098,187,1090,1112,486,223,176,76,61,21,3,37,15,11,8,3,0,4,0,0,4,100,92,35,8,49,8,8,5,0,3,0,0,0,0,54739
18272,1574,128,756,487,153,50,101,50,46,9,5,32,4,4,4,0,0,0,0,0,0,51,42,20,0,22,9,2,0,0,2,7,0,7,0,54740
18273,974,235,426,212,71,30,88,58,27,13,0,14,31,2,0,0,2,29,17,0,12,30,16,5,0,11,14,5,4,0,1,9,0,0,9,54741
18274,2766,251,861,1003,458,193,161,84,80,27,15,38,4,4,0,4,0,0,0,0,0,77,77,48,0,29,0,0,0,0,0,0,0,0,0,54742
18275,1540,214,619,459,200,48,50,11,7,0,0,7,4,2,2,0,0,2,2,0,0,39,36,12,5,19,3,0,0,0,0,3,0,0,3,54745
18276,536,96,270,134,27,9,22,11,6,0,0,6,5,0,0,0,0,5,5,0,0,11,8,0,0,8,3,3,3,0,0,0,0,0,0,54746
18277,1732,248,751,504,173,56,99,44,39,2,0,37,5,5,5,0,0,0,0,0,0,55,47,17,0,30,8,0,0,0,0,8,0,0,8,54747
18278,849,113,435,221,47,33,28,21,21,15,6,0,0,0,0,0,0,0,0,0,0,7,7,7,0,0,0,0,0,0,0,0,0,0,0,54748
18279,899,78,428,271,74,48,21,12,12,5,0,7,0,0,0,0,0,0,0,0,0,9,9,4,0,5,0,0,0,0,0,0,0,0,0,54749
18280,690,84,291,199,88,28,59,40,40,9,0,31,0,0,0,0,0,0,0,0,0,19,19,13,0,6,0,0,0,0,0,0,0,0,0,54750
18281,13934,1010,4496,4315,2503,1610,3015,1437,1412,568,138,706,25,25,15,0,10,0,0,0,0,1578,1556,633,110,813,22,22,7,10,5,0,0,0,0,54751
18282,1199,244,521,336,64,34,117,45,28,7,0,21,17,17,4,0,13,0,0,0,0,72,72,18,13,41,0,0,0,0,0,0,0,0,0,54754
18283,4989,565,2017,1563,605,239,453,192,157,69,5,83,35,23,17,6,0,12,2,0,10,261,184,62,10,112,77,55,25,1,29,22,6,0,16,54755
18284,680,75,318,205,62,20,46,20,15,9,0,6,5,0,0,0,0,5,5,0,0,26,26,9,0,17,0,0,0,0,0,0,0,0,0,54756
18285,2466,321,944,825,248,128,152,78,55,13,0,42,23,15,3,11,1,8,8,0,0,74,55,21,0,34,19,7,7,0,0,12,4,2,6,54757
18286,3245,358,1243,1012,427,205,269,164,125,39,8,78,39,35,35,0,0,4,0,2,2,105,96,61,4,31,9,9,9,0,0,0,0,0,0,54758
18287,1188,120,445,384,183,56,48,29,29,18,0,11,0,0,0,0,0,0,0,0,0,19,19,3,0,16,0,0,0,0,0,0,0,0,0,54759
18288,159,45,51,41,8,14,2,0,0,0,0,0,0,0,0,0,0,0,0,0,0,2,2,2,0,0,0,0,0,0,0,0,0,0,0,54760
18289,900,66,391,300,101,42,53,40,31,10,2,19,9,6,3,0,3,3,0,0,3,13,13,2,3,8,0,0,0,0,0,0,0,0,0,54761
18290,836,97,359,228,115,37,50,25,23,6,2,15,2,2,2,0,0,0,0,0,0,25,21,7,0,14,4,4,4,0,0,0,0,0,0,54762
18291,900,104,401,260,89,46,52,20,20,5,0,15,0,0,0,0,0,0,0,0,0,32,28,8,2,18,4,4,4,0,0,0,0,0,0,54763
18292,17,0,0,10,0,7,0,0,0,0,0,0,0,0,0,0,0,0,0,0,0,0,0,0,0,0,0,0,0,0,0,0,0,0,0,54765
18293,1022,231,455,230,80,26,86,54,42,6,5,31,12,9,8,0,1,3,1,0,2,32,28,4,3,21,4,3,3,0,0,1,1,0,0,54766
18294,2174,176,846,677,358,117,141,94,90,26,4,60,4,4,2,0,2,0,0,0,0,47,47,19,3,25,0,0,0,0,0,0,0,0,0,54767
18295,4189,695,2020,1148,218,108,387,178,112,33,10,69,66,49,30,5,14,17,8,2,7,209,176,79,9,88,33,25,25,0,0,8,3,0,5,54768
18296,327,28,102,88,60,49,15,6,6,4,0,2,0,0,0,0,0,0,0,0,0,9,9,0,0,9,0,0,0,0,0,0,0,0,0,54769
18297,1466,172,630,434,150,80,97,40,38,13,4,21,2,2,2,0,0,0,0,0,0,57,39,10,4,25,18,14,5,9,0,4,0,0,4,54770
18298,2701,614,1191,656,151,89,248,127,66,16,0,50,61,19,19,0,0,42,23,2,17,121,76,43,9,24,45,19,19,0,0,26,11,0,15,54771
18299,715,105,263,228,100,19,48,21,17,2,2,13,4,4,2,0,2,0,0,0,0,27,16,2,2,12,11,11,6,5,0,0,0,0,0,54772
18300,2283,367,1013,592,202,109,187,95,85,21,11,53,10,8,2,0,6,2,0,0,2,92,61,30,5,26,31,31,9,22,0,0,0,0,0,54773
18301,4744,457,1749,1539,656,343,267,164,155,76,4,75,9,4,4,0,0,5,0,0,5,103,90,26,0,64,13,13,10,0,3,0,0,0,0,54801
18302,1012,203,441,275,85,8,70,32,22,9,0,13,10,1,0,1,0,9,7,2,0,38,18,12,0,6,20,7,7,0,0,13,2,0,11,54805
18303,7891,645,2418,2782,1369,677,704,463,367,114,42,211,96,75,30,0,45,21,21,0,0,241,223,112,34,77,18,18,0,14,4,0,0,0,0,54806
18304,1692,143,735,510,218,86,114,51,34,0,0,34,17,14,0,0,14,3,0,0,3,63,63,37,4,22,0,0,0,0,0,0,0,0,0,54810
18305,3628,737,1387,1064,345,95,298,208,135,41,4,90,73,50,22,28,0,23,20,0,3,90,67,28,30,9,23,6,2,4,0,17,9,8,0,54812
18306,437,47,220,116,45,9,10,5,5,0,0,5,0,0,0,0,0,0,0,0,0,5,5,5,0,0,0,0,0,0,0,0,0,0,0,54813
18307,1847,139,443,726,331,208,146,85,71,10,16,45,14,4,2,2,0,10,2,0,8,61,53,3,5,45,8,4,2,2,0,4,0,0,4,54814
18308,1714,123,628,544,277,142,63,33,29,16,2,11,4,4,0,0,4,0,0,0,0,30,30,17,4,9,0,0,0,0,0,0,0,0,0,54817
18309,1877,212,941,486,146,92,159,91,74,27,15,32,17,4,4,0,0,13,5,0,8,68,68,23,11,34,0,0,0,0,0,0,0,0,0,54819
18310,520,36,193,179,81,31,42,22,19,6,0,13,3,3,3,0,0,0,0,0,0,20,18,7,3,8,2,2,2,0,0,0,0,0,0,54820
18311,1127,80,430,354,160,103,49,22,22,7,0,15,0,0,0,0,0,0,0,0,0,27,27,0,12,15,0,0,0,0,0,0,0,0,0,54821
18312,3126,323,1376,999,287,141,283,153,140,71,29,40,13,13,13,0,0,0,0,0,0,130,103,27,9,67,27,21,18,3,0,6,3,0,3,54822
18313,1479,182,584,520,114,79,89,43,32,8,2,22,11,8,5,3,0,3,3,0,0,46,27,6,9,12,19,19,15,4,0,0,0,0,0,54824
18314,642,69,265,193,83,32,31,9,9,3,0,6,0,0,0,0,0,0,0,0,0,22,18,12,0,6,4,0,0,0,0,4,0,0,4,54826
18315,153,8,48,44,21,32,3,3,3,3,0,0,0,0,0,0,0,0,0,0,0,0,0,0,0,0,0,0,0,0,0,0,0,0,0,54827
18316,608,105,232,191,52,28,52,26,3,0,0,3,23,23,23,0,0,0,0,0,0,26,22,10,0,12,4,1,0,0,1,3,0,0,3,54828
18317,3612,319,1431,1116,490,256,240,146,111,28,4,79,35,26,24,0,2,9,9,0,0,94,85,26,6,53,9,6,6,0,0,3,2,0,1,54829
18318,2664,289,1043,817,338,177,60,31,21,11,2,8,10,10,10,0,0,0,0,0,0,29,29,7,4,18,0,0,0,0,0,0,0,0,0,54830
18319,368,31,85,133,84,35,26,11,4,0,0,4,7,2,0,0,2,5,5,0,0,15,15,15,0,0,0,0,0,0,0,0,0,0,0,54832
18320,718,60,346,248,50,14,24,7,7,0,1,6,0,0,0,0,0,0,0,0,0,17,17,3,2,12,0,0,0,0,0,0,0,0,0,54835
18321,761,58,243,301,112,47,35,26,20,6,0,14,6,3,3,0,0,3,3,0,0,9,9,2,5,2,0,0,0,0,0,0,0,0,0,54836
18322,2546,205,1208,748,276,109,160,107,85,32,3,50,22,22,18,4,0,0,0,0,0,53,49,16,5,28,4,4,4,0,0,0,0,0,0,54837
18323,1153,57,403,472,153,68,41,24,17,10,0,7,7,0,0,0,0,7,0,0,7,17,17,6,8,3,0,0,0,0,0,0,0,0,0,54838
18324,227,27,82,93,15,10,18,9,9,0,0,9,0,0,0,0,0,0,0,0,0,9,9,0,0,9,0,0,0,0,0,0,0,0,0,54839
18325,3080,283,1244,1038,336,179,258,100,81,21,0,60,19,8,8,0,0,11,0,9,2,158,76,23,3,50,82,79,76,3,0,3,0,0,3,54840
18326,198,13,79,94,6,6,4,2,2,2,0,0,0,0,0,0,0,0,0,0,0,2,2,0,0,2,0,0,0,0,0,0,0,0,0,54841
18327,61,3,13,25,9,11,0,0,0,0,0,0,0,0,0,0,0,0,0,0,0,0,0,0,0,0,0,0,0,0,0,0,0,0,0,54842
18328,8029,753,2362,2916,1275,723,507,271,206,25,28,153,65,45,17,22,6,20,0,4,16,236,218,47,0,171,18,15,7,4,4,3,3,0,0,54843
18329,207,2,63,63,39,40,2,0,0,0,0,0,0,0,0,0,0,0,0,0,0,2,2,0,0,2,0,0,0,0,0,0,0,0,0,54844
18330,120,24,53,41,2,0,5,3,3,0,0,3,0,0,0,0,0,0,0,0,0,2,0,0,0,0,2,2,2,0,0,0,0,0,0,54845
18331,424,49,171,149,43,12,23,7,7,3,3,1,0,0,0,0,0,0,0,0,0,16,16,0,0,16,0,0,0,0,0,0,0,0,0,54846
18332,1728,116,594,537,317,164,122,68,64,10,0,54,4,4,4,0,0,0,0,0,0,54,44,4,2,38,10,5,5,0,0,5,0,0,5,54847
18333,4214,470,1768,1212,556,208,350,164,127,22,25,80,37,16,16,0,0,21,2,0,19,186,115,43,8,64,71,22,17,5,0,49,10,0,39,54848
18334,1546,70,450,561,308,157,64,26,25,9,0,16,1,1,0,1,0,0,0,0,0,38,35,7,6,22,3,3,3,0,0,0,0,0,0,54849
18335,167,0,12,21,81,53,0,0,0,0,0,0,0,0,0,0,0,0,0,0,0,0,0,0,0,0,0,0,0,0,0,0,0,0,0,54850
18336,3037,253,1191,1079,387,127,189,90,66,33,11,22,24,24,20,0,4,0,0,0,0,99,90,19,20,51,9,9,5,4,0,0,0,0,0,54853
18337,703,53,223,286,105,36,40,20,18,1,0,17,2,0,0,0,0,2,2,0,0,20,13,3,0,10,7,7,2,5,0,0,0,0,0,54854
18338,457,44,203,171,20,19,80,23,15,4,0,11,8,2,2,0,0,6,6,0,0,57,31,12,0,19,26,26,26,0,0,0,0,0,0,54855
18339,1100,90,486,333,131,60,55,31,26,10,2,14,5,2,0,0,2,3,2,1,0,24,21,7,0,14,3,1,1,0,0,2,2,0,0,54856
18340,19,0,10,9,0,0,0,0,0,0,0,0,0,0,0,0,0,0,0,0,0,0,0,0,0,0,0,0,0,0,0,0,0,0,0,54857
18341,1143,92,540,391,81,39,108,74,55,21,4,30,19,19,19,0,0,0,0,0,0,34,32,13,0,19,2,2,2,0,0,0,0,0,0,54858
18342,1284,88,553,406,158,79,58,37,33,4,0,29,4,4,0,0,4,0,0,0,0,21,21,2,2,17,0,0,0,0,0,0,0,0,0,54859
18343,76,9,21,46,0,0,2,2,2,0,0,2,0,0,0,0,0,0,0,0,0,0,0,0,0,0,0,0,0,0,0,0,0,0,0,54861
18344,226,57,105,39,13,12,2,2,0,0,0,0,2,1,1,0,0,1,1,0,0,0,0,0,0,0,0,0,0,0,0,0,0,0,0,54862
18345,925,51,322,364,142,46,82,38,38,19,5,14,0,0,0,0,0,0,0,0,0,44,44,2,4,38,0,0,0,0,0,0,0,0,0,54864
18346,363,25,119,123,59,37,11,9,9,9,0,0,0,0,0,0,0,0,0,0,0,2,2,0,0,2,0,0,0,0,0,0,0,0,0,54865
18347,211,29,102,56,17,7,5,5,3,1,0,2,2,2,2,0,0,0,0,0,0,0,0,0,0,0,0,0,0,0,0,0,0,0,0,54867
18348,11354,1035,4368,3848,1360,743,852,461,376,173,67,136,85,61,34,25,2,24,0,0,24,391,327,177,42,108,64,64,57,4,3,0,0,0,0,54868
18349,1313,92,553,404,193,71,91,35,30,11,2,17,5,4,4,0,0,1,1,0,0,56,51,18,0,33,5,5,5,0,0,0,0,0,0,54870
18350,2249,195,817,764,321,152,142,74,55,22,5,28,19,5,5,0,0,14,4,0,10,68,62,15,0,47,6,4,3,0,1,2,2,0,0,54871
18351,1837,224,784,523,217,89,78,49,41,2,3,36,8,6,0,0,6,2,0,0,2,29,22,9,0,13,7,7,0,0,7,0,0,0,0,54872
18352,2092,155,736,729,292,180,84,44,39,11,5,23,5,5,2,0,3,0,0,0,0,40,36,21,0,15,4,4,4,0,0,0,0,0,0,54873
18353,2585,260,904,909,394,118,157,100,73,28,4,41,27,27,18,9,0,0,0,0,0,57,50,13,12,25,7,7,6,0,1,0,0,0,0,54874
18354,805,87,378,217,93,30,29,13,8,6,0,2,5,5,5,0,0,0,0,0,0,16,5,2,0,3,11,11,0,6,5,0,0,0,0,54875
18355,1233,150,483,301,194,105,55,17,14,2,2,10,3,0,0,0,0,3,0,0,3,38,24,20,0,4,14,6,0,0,6,8,0,8,0,54876
18356,20505,1508,6540,8030,2957,1470,1666,864,690,261,51,378,174,152,58,84,10,22,0,0,22,802,787,331,133,323,15,4,4,0,0,11,9,2,0,54880
18357,1116,130,408,374,137,67,69,17,15,3,0,12,2,2,0,2,0,0,0,0,0,52,42,21,5,16,10,10,6,1,3,0,0,0,0,54888
18358,2000,184,906,610,194,106,84,47,29,19,5,5,18,18,9,9,0,0,0,0,0,37,30,5,2,23,7,7,4,3,0,0,0,0,0,54889
18359,2544,139,717,694,629,365,123,60,48,20,0,28,12,8,4,0,4,4,0,0,4,63,41,21,0,20,22,16,10,0,6,6,3,0,3,54891
18360,2717,345,996,953,317,106,208,110,101,22,2,77,9,8,5,1,2,1,0,1,0,98,64,33,5,26,34,17,15,1,1,17,0,1,16,54893
18361,804,61,380,259,61,43,52,34,29,10,3,16,5,3,3,0,0,2,0,0,2,18,18,7,0,11,0,0,0,0,0,0,0,0,0,54895
18362,1193,108,557,352,108,68,82,31,30,8,0,22,1,1,0,0,1,0,0,0,0,51,44,23,4,17,7,7,4,0,3,0,0,0,0,54896
18363,22292,3161,8117,6382,3091,1541,3947,1869,1645,521,74,1050,224,150,80,18,52,74,8,33,33,2078,1866,723,89,1054,212,212,144,34,34,0,0,0,0,54901
18364,15613,1684,6236,4309,2420,964,1090,395,358,163,13,182,37,22,7,7,8,15,0,15,0,695,637,304,113,220,58,58,51,0,7,0,0,0,0,54902
18365,14164,466,3958,4309,3606,1825,1008,616,442,172,50,220,174,166,164,0,2,8,0,8,0,392,365,151,30,184,27,25,4,0,21,2,0,0,2,54904
18366,1616,159,712,482,187,76,175,83,68,28,0,40,15,11,2,0,9,4,3,0,1,92,86,28,9,49,6,2,0,0,2,4,0,2,2,54909
18367,16945,1256,5319,5619,3161,1590,1956,968,894,368,83,443,74,66,34,14,18,8,0,0,8,988,907,400,36,471,81,81,72,9,0,0,0,0,0,54911
18368,12233,381,2823,3888,3395,1746,802,398,388,101,3,284,10,10,0,0,10,0,0,0,0,404,391,160,32,199,13,3,3,0,0,10,0,10,0,54913
18369,20784,1806,6550,6557,4053,1818,1555,659,498,255,9,234,161,146,102,16,28,15,15,0,0,896,737,426,27,284,159,144,144,0,0,15,15,0,0,54914
18370,27609,1896,8080,8519,6504,2610,2253,1199,1063,291,77,695,136,97,61,0,36,39,22,17,0,1054,1017,531,54,432,37,28,28,0,0,9,9,0,0,54915
18371,888,171,453,166,76,22,79,44,38,20,8,10,6,6,0,2,4,0,0,0,0,35,33,4,0,29,2,2,2,0,0,0,0,0,0,54921
18372,1065,137,497,327,71,33,74,50,25,12,0,13,25,10,8,2,0,15,7,0,8,24,15,4,0,11,9,9,9,0,0,0,0,0,0,54922
18373,6305,831,2849,1751,576,298,450,204,165,37,14,114,39,39,12,0,27,0,0,0,0,246,201,64,55,82,45,39,35,0,4,6,0,0,6,54923
18374,319,10,75,176,43,15,8,8,8,8,0,0,0,0,0,0,0,0,0,0,0,0,0,0,0,0,0,0,0,0,0,0,0,0,0,54927
18375,304,25,143,78,32,26,18,7,3,0,0,3,4,4,4,0,0,0,0,0,0,11,11,4,3,4,0,0,0,0,0,0,0,0,0,54928
18376,6127,748,2724,1820,641,194,500,273,224,49,48,127,49,42,8,29,5,7,5,0,2,227,137,88,7,42,90,66,15,3,48,24,0,0,24,54929
18377,1254,199,564,326,105,60,101,50,41,13,3,25,9,2,0,2,0,7,4,0,3,51,46,28,0,18,5,3,2,0,1,2,0,0,2,54930
18378,161,0,55,101,5,0,5,0,0,0,0,0,0,0,0,0,0,0,0,0,0,5,5,0,0,5,0,0,0,0,0,0,0,0,0,54931
18379,856,40,337,271,134,74,86,35,31,15,0,16,4,4,4,0,0,0,0,0,0,51,32,16,0,16,19,19,19,0,0,0,0,0,0,54932
18380,223,11,88,101,17,6,6,1,1,1,0,0,0,0,0,0,0,0,0,0,0,5,5,2,3,0,0,0,0,0,0,0,0,0,0,54933
18381,85,3,45,29,8,0,6,6,6,0,3,3,0,0,0,0,0,0,0,0,0,0,0,0,0,0,0,0,0,0,0,0,0,0,0,54934
18382,28900,3032,10575,9406,4032,1855,1961,1030,893,476,109,308,137,130,88,1,41,7,0,0,7,931,767,356,120,291,164,164,164,0,0,0,0,0,0,54935
18383,13341,1098,4906,4158,2075,1104,815,342,326,158,30,138,16,16,13,3,0,0,0,0,0,473,425,266,22,137,48,48,41,7,0,0,0,0,0,54937
18384,2797,299,1128,932,325,113,158,98,88,43,3,42,10,10,10,0,0,0,0,0,0,60,49,36,2,11,11,11,11,0,0,0,0,0,0,54940
18385,1803,81,526,586,396,214,67,52,26,18,0,8,26,2,2,0,0,24,0,0,24,15,13,6,4,3,2,0,0,0,0,2,2,0,0,54941
18386,5813,222,1634,1639,1776,542,330,130,130,35,0,95,0,0,0,0,0,0,0,0,0,200,192,87,22,83,8,8,8,0,0,0,0,0,0,54942
18387,1375,245,602,341,125,62,76,36,21,6,2,13,15,7,3,4,0,8,8,0,0,40,28,8,10,10,12,0,0,0,0,12,10,0,2,54943
18388,5527,253,2297,1823,887,267,586,305,240,76,21,143,65,65,65,0,0,0,0,0,0,281,270,156,11,103,11,7,7,0,0,4,0,4,0,54944
18389,2584,241,998,814,387,144,194,92,79,25,3,51,13,9,2,4,3,4,0,4,0,102,88,36,26,26,14,10,5,0,5,4,4,0,0,54945
18390,56,14,35,4,3,0,0,0,0,0,0,0,0,0,0,0,0,0,0,0,0,0,0,0,0,0,0,0,0,0,0,0,0,0,0,54946
18391,1946,112,762,669,305,98,116,31,18,9,0,9,13,5,2,3,0,8,8,0,0,85,78,41,0,37,7,2,2,0,0,5,0,3,2,54947
18392,156,39,66,28,10,13,18,9,9,7,0,2,0,0,0,0,0,0,0,0,0,9,9,6,0,3,0,0,0,0,0,0,0,0,0,54948
18393,2291,253,1002,717,230,89,163,73,65,16,16,33,8,8,8,0,0,0,0,0,0,90,81,29,15,37,9,8,8,0,0,1,0,0,1,54949
18394,2189,248,1190,560,161,30,136,69,41,11,0,30,28,28,13,6,9,0,0,0,0,67,54,24,0,30,13,7,3,0,4,6,0,3,3,54950
18395,17626,1463,6230,5988,2722,1223,1305,673,510,157,28,325,163,142,108,34,0,21,0,14,7,632,560,212,81,267,72,72,71,0,1,0,0,0,0,54952
18396,29343,1811,9302,9321,6489,2420,2068,961,790,317,79,394,171,100,90,8,2,71,46,11,14,1107,927,457,60,410,180,89,69,7,13,91,42,0,49,54956
18397,2093,175,950,643,220,105,122,87,85,32,3,50,2,2,2,0,0,0,0,0,0,35,24,2,2,20,11,11,2,9,0,0,0,0,0,54960
18398,10048,991,4729,2672,1133,523,713,349,301,135,34,132,48,35,10,25,0,13,0,3,10,364,325,170,1,154,39,36,23,7,6,3,0,0,3,54961
18399,850,112,446,223,40,29,59,33,21,2,0,19,12,12,7,0,5,0,0,0,0,26,20,7,0,13,6,6,6,0,0,0,0,0,0,54962
18400,4866,591,1870,1478,712,215,298,150,145,92,18,35,5,5,3,2,0,0,0,0,0,148,148,75,0,73,0,0,0,0,0,0,0,0,0,54963
18401,757,77,305,202,129,44,51,38,38,25,4,9,0,0,0,0,0,0,0,0,0,13,13,2,11,0,0,0,0,0,0,0,0,0,0,54964
18402,1045,121,499,297,99,29,61,42,25,18,3,4,17,17,17,0,0,0,0,0,0,19,11,7,0,4,8,8,0,0,8,0,0,0,0,54965
18403,1317,201,588,397,105,26,168,90,78,21,17,40,12,7,2,0,5,5,5,0,0,78,74,24,13,37,4,0,0,0,0,4,4,0,0,54966
18404,303,63,107,107,15,11,26,19,19,3,0,16,0,0,0,0,0,0,0,0,0,7,7,3,0,4,0,0,0,0,0,0,0,0,0,54967
18405,2195,197,1004,721,205,68,106,75,64,34,11,19,11,11,11,0,0,0,0,0,0,31,26,10,0,16,5,5,2,3,0,0,0,0,0,54968
18406,3154,512,1342,991,239,70,157,108,93,31,7,55,15,12,12,0,0,3,3,0,0,49,28,12,0,16,21,13,3,0,10,8,0,4,4,54970
18407,7136,661,2793,2119,1049,514,952,542,499,118,18,363,43,43,38,5,0,0,0,0,0,410,397,248,8,141,13,13,13,0,0,0,0,0,0,54971
18408,983,53,428,302,146,54,51,29,29,13,0,16,0,0,0,0,0,0,0,0,0,22,22,15,7,0,0,0,0,0,0,0,0,0,0,54974
18409,987,83,419,282,150,53,65,54,34,4,4,26,20,15,13,2,0,5,3,0,2,11,9,2,0,7,2,2,2,0,0,0,0,0,0,54977
18410,947,65,429,273,149,31,107,68,64,46,0,18,4,4,4,0,0,0,0,0,0,39,39,22,0,17,0,0,0,0,0,0,0,0,0,54979
18411,101,0,36,58,3,4,7,0,0,0,0,0,0,0,0,0,0,0,0,0,0,7,7,0,0,7,0,0,0,0,0,0,0,0,0,54980
18412,11189,999,4361,3470,1719,640,750,417,221,105,7,109,196,188,174,0,14,8,4,0,4,333,243,114,13,116,90,71,68,3,0,19,4,0,15,54981
18413,5042,624,1997,1629,528,264,254,139,123,70,0,53,16,5,5,0,0,11,6,0,5,115,84,36,7,41,31,15,15,0,0,16,0,0,16,54982
18414,3132,373,1527,851,265,116,300,192,167,68,15,84,25,12,12,0,0,13,0,7,6,108,108,71,6,31,0,0,0,0,0,0,0,0,0,54983
18415,2564,267,1062,746,335,154,145,96,48,18,7,23,48,11,0,0,11,37,33,0,4,49,44,12,2,30,5,4,1,0,3,1,1,0,0,54984
18416,237,126,64,31,16,0,21,14,6,0,0,6,8,0,0,0,0,8,0,0,8,7,4,0,0,4,3,0,0,0,0,3,0,0,3,54985
18417,3372,140,1318,1111,555,248,180,93,68,39,17,12,25,23,21,2,0,2,0,0,2,87,87,34,10,43,0,0,0,0,0,0,0,0,0,54986
18418,2148,74,372,616,616,470,172,54,49,9,5,35,5,5,5,0,0,0,0,0,0,118,118,35,4,79,0,0,0,0,0,0,0,0,0,55001
18419,2897,159,1317,819,306,296,137,64,51,9,0,42,13,13,0,0,13,0,0,0,0,73,73,52,0,21,0,0,0,0,0,0,0,0,0,55003
18420,2934,352,992,1129,313,148,214,119,107,18,25,64,12,0,0,0,0,12,0,12,0,95,82,26,7,49,13,0,0,0,0,13,0,0,13,55005
18421,2614,246,1169,932,193,74,219,124,107,42,3,62,17,9,5,4,0,8,4,0,4,95,85,29,6,50,10,10,0,3,7,0,0,0,0,55006
18422,1795,224,854,581,73,63,122,63,52,9,5,38,11,4,2,2,0,7,7,0,0,59,56,35,3,18,3,3,3,0,0,0,0,0,0,55007
18423,9809,961,3668,3398,1225,557,927,504,419,167,60,192,85,52,8,26,18,33,20,0,13,423,383,228,5,150,40,40,18,0,22,0,0,0,0,55008
18424,5763,457,1910,2195,875,326,391,233,204,47,37,120,29,29,29,0,0,0,0,0,0,158,145,44,9,92,13,13,13,0,0,0,0,0,0,55009
18425,6701,263,2387,2806,1036,209,598,304,283,119,32,132,21,21,21,0,0,0,0,0,0,294,232,129,0,103,62,62,30,0,32,0,0,0,0,55011
18426,1515,132,471,499,274,139,104,40,36,15,8,13,4,4,0,0,4,0,0,0,0,64,54,26,3,25,10,8,8,0,0,2,0,0,2,55012
18427,4664,330,1601,1580,714,439,321,164,110,43,7,60,54,26,26,0,0,28,28,0,0,157,157,71,0,86,0,0,0,0,0,0,0,0,0,55013
18428,18199,957,5236,6147,4394,1465,1631,922,883,317,106,460,39,30,21,0,9,9,9,0,0,709,655,208,112,335,54,34,34,0,0,20,9,0,11,55014
18429,21672,951,6091,7908,4825,1897,2157,1134,1028,413,120,495,106,72,19,41,12,34,0,0,34,1023,910,337,75,498,113,66,58,0,8,47,19,8,20,55016
18430,522,80,234,162,29,17,36,18,13,5,2,6,5,5,0,5,0,0,0,0,0,18,17,3,7,7,1,0,0,0,0,1,0,0,1,55017
18431,672,45,189,259,136,43,35,19,19,7,0,12,0,0,0,0,0,0,0,0,0,16,16,10,0,6,0,0,0,0,0,0,0,0,0,55018
18432,1279,56,376,461,240,146,65,41,25,6,4,15,16,13,13,0,0,3,3,0,0,24,24,20,0,4,0,0,0,0,0,0,0,0,0,55019
18433,2224,51,589,867,502,215,245,100,85,26,9,50,15,0,0,0,0,15,0,0,15,145,127,78,42,7,18,18,18,0,0,0,0,0,0,55020
18434,20021,2446,7500,6157,2638,1280,1419,698,656,174,96,386,42,27,25,0,2,15,3,0,12,721,607,258,132,217,114,13,13,0,0,101,11,23,67,55021
18435,20150,1050,4554,8031,4989,1526,1396,569,457,163,71,223,112,88,33,55,0,24,20,0,4,827,750,276,62,412,77,69,68,0,1,8,8,0,0,55024
18436,16104,923,4962,5890,3084,1245,1335,592,548,254,45,249,44,44,36,8,0,0,0,0,0,743,565,219,37,309,178,159,109,40,10,19,0,0,19,55025
18437,322,32,104,112,48,26,10,8,8,2,0,6,0,0,0,0,0,0,0,0,0,2,2,2,0,0,0,0,0,0,0,0,0,0,0,55026
18438,1758,171,631,653,255,48,185,62,55,22,10,23,7,4,1,0,3,3,0,0,3,123,112,53,16,43,11,4,4,0,0,7,0,0,7,55027
18439,17,13,0,4,0,0,0,0,0,0,0,0,0,0,0,0,0,0,0,0,0,0,0,0,0,0,0,0,0,0,0,0,0,0,0,55029
18440,969,149,455,304,48,13,75,36,31,11,0,20,5,5,5,0,0,0,0,0,0,39,26,20,0,6,13,13,0,13,0,0,0,0,0,55030
18441,1395,86,531,485,191,102,83,40,33,18,0,15,7,7,4,3,0,0,0,0,0,43,43,13,8,22,0,0,0,0,0,0,0,0,0,55031
18442,2259,190,826,903,254,86,196,111,86,18,10,58,25,21,17,0,4,4,0,0,4,85,72,19,8,45,13,13,10,0,3,0,0,0,0,55032
18443,20086,1144,6393,7105,3823,1621,1558,868,780,342,87,351,88,86,40,41,5,2,0,0,2,690,624,250,54,320,66,40,36,4,0,26,21,0,5,55033
18444,40,8,17,14,0,1,0,0,0,0,0,0,0,0,0,0,0,0,0,0,0,0,0,0,0,0,0,0,0,0,0,0,0,0,0,55036
18445,3341,409,1463,1069,303,97,255,131,108,29,8,71,23,16,14,2,0,7,3,0,4,124,121,39,27,55,3,0,0,0,0,3,3,0,0,55037
18446,12972,484,2935,4582,3478,1493,1321,675,555,261,13,281,120,108,88,20,0,12,0,0,12,646,609,305,8,296,37,22,22,0,0,15,0,0,15,55038
18447,8406,560,3475,3066,976,329,642,248,238,139,13,86,10,9,4,0,5,1,0,0,1,394,383,190,42,151,11,11,0,11,0,0,0,0,0,55040
18448,5580,364,2268,1746,829,373,334,157,150,69,15,66,7,7,7,0,0,0,0,0,0,177,149,91,8,50,28,28,28,0,0,0,0,0,0,55041
18449,5778,233,1077,1822,1838,808,499,213,181,60,8,113,32,32,32,0,0,0,0,0,0,286,286,90,11,185,0,0,0,0,0,0,0,0,0,55042
18450,2458,75,712,933,495,243,159,78,69,22,9,38,9,9,4,0,5,0,0,0,0,81,75,50,5,20,6,4,4,0,0,2,0,0,2,55043
18451,30521,1005,5680,9722,9871,4243,3135,1547,1346,498,96,752,201,104,87,8,9,97,20,75,2,1588,1464,681,97,686,124,111,98,0,13,13,0,0,13,55044
18452,5218,283,1573,1683,1232,447,445,212,212,60,35,117,0,0,0,0,0,0,0,0,0,233,217,61,10,146,16,10,10,0,0,6,0,0,6,55045
18453,3361,203,1058,1357,627,116,239,147,140,82,13,45,7,7,7,0,0,0,0,0,0,92,83,61,2,20,9,7,0,7,0,2,2,0,0,55046
18454,2119,41,493,666,560,359,217,170,170,65,8,97,0,0,0,0,0,0,0,0,0,47,47,14,0,33,0,0,0,0,0,0,0,0,0,55047
18455,1613,139,591,618,201,64,124,71,58,24,0,34,13,13,11,0,2,0,0,0,0,53,42,33,2,7,11,7,4,0,3,4,4,0,0,55049
18456,6901,931,2644,2246,693,387,448,230,176,58,10,108,54,49,27,17,5,5,0,0,5,218,218,102,32,84,0,0,0,0,0,0,0,0,0,55051
18457,1292,144,567,429,113,39,114,78,69,33,6,30,9,9,9,0,0,0,0,0,0,36,30,9,0,21,6,5,3,0,2,1,0,1,0,55052
18458,659,55,211,185,140,68,64,46,44,7,0,37,2,2,2,0,0,0,0,0,0,18,16,3,5,8,2,2,2,0,0,0,0,0,0,55053
18459,1389,0,254,510,457,168,45,25,25,0,0,25,0,0,0,0,0,0,0,0,0,20,20,0,0,20,0,0,0,0,0,0,0,0,0,55054
18460,2489,194,936,905,313,141,195,129,129,22,25,82,0,0,0,0,0,0,0,0,0,66,53,29,0,24,13,13,0,13,0,0,0,0,0,55055
18461,8627,544,3394,3214,1112,363,841,390,352,91,29,232,38,35,12,0,23,3,0,3,0,451,379,165,4,210,72,71,71,0,0,1,0,0,1,55056
18462,13369,824,2917,3505,3554,2569,3161,1483,1430,813,54,563,53,39,20,0,19,14,5,0,9,1678,1652,1019,78,555,26,26,17,0,9,0,0,0,0,55057
18463,19261,1457,6538,6091,3792,1383,1634,753,641,293,19,329,112,91,58,14,19,21,2,13,6,881,761,337,64,360,120,75,27,0,48,45,42,0,3,55060
18464,6625,712,2801,2192,568,352,391,263,177,63,15,99,86,53,9,32,12,33,0,0,33,128,99,35,5,59,29,24,19,5,0,5,0,0,5,55063
18465,785,57,298,295,101,34,84,48,42,9,0,33,6,6,3,0,3,0,0,0,0,36,30,15,3,12,6,4,4,0,0,2,0,0,2,55065
18466,12896,1026,4123,4573,2296,878,916,643,568,193,58,317,75,58,9,41,8,17,0,16,1,273,216,117,16,83,57,15,10,5,0,42,40,0,2,55066
18467,17727,904,3733,6073,4969,2048,1630,801,702,204,120,378,99,79,72,7,0,20,0,6,14,829,719,408,37,274,110,102,63,17,22,8,0,0,8,55068
18468,3759,458,1593,1281,329,98,204,141,129,37,0,92,12,2,2,0,0,10,0,4,6,63,42,19,2,21,21,6,6,0,0,15,15,0,0,55069
18469,4674,340,1806,1883,453,192,296,174,140,78,0,62,34,34,15,10,9,0,0,0,0,122,101,29,10,62,21,9,0,0,9,12,0,12,0,55070
18470,3847,423,1440,1245,496,243,253,168,121,30,13,78,47,47,43,4,0,0,0,0,0,85,75,45,0,30,10,10,10,0,0,0,0,0,0,55071
18471,3466,362,1687,1018,299,100,181,86,84,27,13,44,2,0,0,0,0,2,0,0,2,95,88,29,5,54,7,7,0,0,7,0,0,0,0,55072
18472,2267,58,679,898,411,221,112,32,32,11,0,21,0,0,0,0,0,0,0,0,0,80,65,55,0,10,15,15,15,0,0,0,0,0,0,55073
18473,1372,72,483,604,138,75,100,53,42,14,4,24,11,4,4,0,0,7,0,0,7,47,47,26,0,21,0,0,0,0,0,0,0,0,0,55074
18474,13974,1243,4225,5421,2227,858,1037,649,522,180,90,252,127,81,0,58,23,46,46,0,0,388,318,119,27,172,70,70,34,19,17,0,0,0,0,55075
18475,15027,1170,4467,5085,3050,1255,1236,566,549,194,30,325,17,9,0,0,9,8,0,0,8,670,644,215,40,389,26,26,26,0,0,0,0,0,0,55076
18476,7403,409,1577,2424,2104,889,883,461,365,110,70,185,96,57,57,0,0,39,39,0,0,422,348,135,26,187,74,44,44,0,0,30,30,0,0,55077
18477,5681,345,2123,2230,769,214,346,180,130,42,6,82,50,44,35,7,2,6,3,3,0,166,155,63,0,92,11,11,11,0,0,0,0,0,0,55079
18478,1748,138,655,681,220,54,94,51,51,30,4,17,0,0,0,0,0,0,0,0,0,43,43,18,7,18,0,0,0,0,0,0,0,0,0,55080
18479,24248,757,5216,7703,6988,3584,1822,1007,911,325,50,536,96,82,66,6,10,14,0,13,1,815,769,215,83,471,46,26,20,0,6,20,0,0,20,55082
18480,1188,39,386,457,191,115,103,41,41,16,5,20,0,0,0,0,0,0,0,0,0,62,43,8,0,35,19,10,10,0,0,9,0,9,0,55084
18481,336,20,146,116,43,11,24,14,11,7,2,2,3,3,0,3,0,0,0,0,0,10,8,6,0,2,2,2,2,0,0,0,0,0,0,55085
18482,316,31,131,115,39,0,11,9,9,9,0,0,0,0,0,0,0,0,0,0,0,2,0,0,0,0,2,2,0,2,0,0,0,0,0,55087
18483,1138,54,389,349,233,113,83,47,47,8,12,27,0,0,0,0,0,0,0,0,0,36,33,17,0,16,3,3,0,0,3,0,0,0,0,55088
18484,1298,96,406,492,227,77,145,80,64,44,4,16,16,16,16,0,0,0,0,0,0,65,59,22,2,35,6,0,0,0,0,6,0,6,0,55089
18485,335,24,100,105,89,17,12,4,4,4,0,0,0,0,0,0,0,0,0,0,0,8,8,6,2,0,0,0,0,0,0,0,0,0,0,55090
18486,7676,303,2575,3145,1272,381,612,285,216,70,14,132,69,34,34,0,0,35,0,0,35,327,296,152,43,101,31,0,0,0,0,31,0,0,31,55092
18487,4974,399,707,1329,1680,859,166,43,31,0,9,22,12,0,0,0,0,12,0,0,12,123,109,27,0,82,14,9,0,9,0,5,0,0,5,55101
18488,13098,825,2600,3651,3582,2440,577,334,263,43,47,173,71,21,3,0,18,50,7,0,43,243,232,113,16,103,11,11,4,7,0,0,0,0,0,55102
18489,7442,1863,2096,2152,886,445,836,388,335,15,137,183,53,50,20,0,30,3,0,0,3,448,448,146,105,197,0,0,0,0,0,0,0,0,0,55103
18490,26493,2904,5478,7118,6494,4499,3041,1506,1311,375,192,744,195,134,62,50,22,61,2,21,38,1535,1401,638,171,592,134,73,49,24,0,61,11,12,38,55104
18491,17598,347,1539,3159,6566,5987,3125,1466,1433,485,97,851,33,14,7,0,7,19,0,0,19,1659,1640,974,104,562,19,19,8,11,0,0,0,0,0,55105
18492,30938,6528,9288,8481,4726,1915,3592,1915,1425,239,171,1015,490,298,179,51,68,192,16,70,106,1677,1407,369,114,924,270,208,97,47,64,62,27,0,35,55106
18493,9213,1966,2836,2143,1417,851,616,269,264,45,89,130,5,5,5,0,0,0,0,0,0,347,319,96,16,207,28,15,15,0,0,13,0,0,13,55107
18494,9477,388,912,1557,3034,3586,1485,770,731,269,67,395,39,5,0,0,5,34,22,0,12,715,673,316,69,288,42,30,0,24,6,12,0,12,0,55108
18495,21450,2116,6898,6945,4056,1435,1248,683,537,165,98,274,146,98,31,17,50,48,31,10,7,565,493,183,27,283,72,59,59,0,0,13,3,0,10,55109
18496,26713,1110,6412,9124,6620,3447,1945,1206,1073,291,137,645,133,92,54,27,11,41,0,0,41,739,656,206,56,394,83,83,63,12,8,0,0,0,0,55110
18497,0,0,0,0,0,0,0,0,0,0,0,0,0,0,0,0,0,0,0,0,0,0,0,0,0,0,0,0,0,0,0,0,0,0,0,55111
18498,29058,1799,6264,8817,7551,4627,2816,1390,1302,479,110,713,88,56,28,8,20,32,0,14,18,1426,1372,669,96,607,54,26,13,7,6,28,17,0,11,55112
18499,28124,1688,6138,7129,7589,5580,1868,899,851,236,56,559,48,29,24,5,0,19,0,0,19,969,913,428,63,422,56,25,7,0,18,31,0,0,31,55113
18500,1910,40,256,502,762,350,209,108,80,39,0,41,28,0,0,0,0,28,28,0,0,101,101,63,0,38,0,0,0,0,0,0,0,0,0,55114
18501,5885,204,936,1771,1740,1234,781,415,376,92,22,262,39,25,8,17,0,14,0,0,14,366,365,176,25,164,1,1,1,0,0,0,0,0,0,55115
18502,17276,1026,2666,3797,5311,4476,1114,530,489,96,75,318,41,32,0,18,14,9,9,0,0,584,549,288,17,244,35,16,16,0,0,19,19,0,0,55116
18503,25936,3754,7274,7504,4741,2663,2974,1421,1239,254,52,933,182,104,8,52,44,78,14,5,59,1553,1446,298,117,1031,107,34,29,0,5,73,35,11,27,55117
18504,19904,1715,4982,5988,4680,2539,1283,766,686,252,73,361,80,51,43,0,8,29,29,0,0,517,458,196,14,248,59,51,43,0,8,8,0,8,0,55118
18505,25704,2929,7974,7764,4912,2125,2258,1296,1091,176,78,837,205,166,101,33,32,39,24,0,15,962,801,214,90,497,161,101,54,24,23,60,38,0,22,55119
18506,3016,155,458,700,938,765,373,143,143,42,10,91,0,0,0,0,0,0,0,0,0,230,220,110,12,98,10,0,0,0,0,10,0,0,10,55120
18507,5578,332,1147,1864,1420,815,334,204,157,76,35,46,47,47,0,47,0,0,0,0,0,130,91,75,4,12,39,29,29,0,0,10,7,0,3,55121
18508,20969,660,3904,6847,6451,3107,1348,764,734,278,102,354,30,18,0,18,0,12,0,0,12,584,530,166,44,320,54,54,27,0,27,0,0,0,0,55122
18509,16735,482,2062,4518,6121,3552,1804,1021,896,277,25,594,125,113,86,27,0,12,0,0,12,783,700,304,10,386,83,83,61,13,9,0,0,0,0,55123
18510,32907,1216,5972,10800,9962,4957,2544,1342,1226,476,101,649,116,64,26,20,18,52,34,0,18,1202,1157,332,121,704,45,31,31,0,0,14,13,0,1,55124
18511,28198,827,4320,8233,9237,5581,2183,1028,969,233,141,595,59,40,24,16,0,19,0,7,12,1155,1094,404,127,563,61,56,13,43,0,5,0,0,5,55125
18512,18396,542,3341,5004,5850,3659,1044,503,495,161,30,304,8,8,8,0,0,0,0,0,0,541,495,131,62,302,46,46,15,0,31,0,0,0,0,55126
18513,12941,750,2555,3227,4054,2355,699,228,202,83,6,113,26,26,14,12,0,0,0,0,0,471,471,202,0,269,0,0,0,0,0,0,0,0,0,55127
18514,18464,1129,4898,7059,3979,1399,1881,1120,950,312,127,511,170,124,108,16,0,46,0,36,10,761,719,287,71,361,42,32,24,0,8,10,0,10,0,55128
18515,12956,208,1790,2623,5513,2822,768,485,460,63,94,303,25,25,0,25,0,0,0,0,0,283,267,154,0,113,16,16,0,0,16,0,0,0,0,55129
18516,8824,3002,2082,2373,914,453,1089,584,482,113,27,342,102,66,14,38,14,36,0,0,36,505,350,56,95,199,155,155,46,49,60,0,0,0,0,55130
18517,142,12,35,73,15,7,12,8,6,0,0,6,2,2,2,0,0,0,0,0,0,4,4,2,0,2,0,0,0,0,0,0,0,0,0,55150
18518,0,0,0,0,0,0,0,0,0,0,0,0,0,0,0,0,0,0,0,0,0,0,0,0,0,0,0,0,0,0,0,0,0,0,0,55155
18519,6029,234,1265,2358,1702,470,477,327,293,89,92,112,34,34,34,0,0,0,0,0,0,150,138,38,44,56,12,12,8,4,0,0,0,0,0,55301
18520,5106,519,1849,1570,817,351,279,155,115,45,22,48,40,32,26,0,6,8,0,0,8,124,124,76,20,28,0,0,0,0,0,0,0,0,0,55302
18521,31138,2158,8809,12592,5470,2109,2458,1220,1049,392,97,560,171,131,102,12,17,40,23,17,0,1238,1105,473,125,507,133,97,61,14,22,36,4,0,32,55303
18522,29599,1299,8292,10919,6551,2538,3177,1670,1548,571,173,804,122,101,49,10,42,21,20,0,1,1507,1375,579,77,719,132,119,89,16,14,13,0,0,13,55304
18523,14054,281,2116,3760,5052,2845,468,264,264,27,7,230,0,0,0,0,0,0,0,0,0,204,177,52,13,112,27,7,7,0,0,20,0,20,0,55305
18524,10849,677,2330,3986,2633,1223,1090,634,522,191,66,265,112,63,7,45,11,49,18,31,0,456,445,108,10,327,11,0,0,0,0,11,0,0,11,55306
18525,2228,275,852,816,212,73,136,113,109,36,2,71,4,4,4,0,0,0,0,0,0,23,23,13,0,10,0,0,0,0,0,0,0,0,0,55307
18526,5451,318,1218,2371,1244,300,434,292,256,134,6,116,36,36,0,15,21,0,0,0,0,142,127,38,0,89,15,15,15,0,0,0,0,0,0,55308
18527,11617,652,3303,4734,2176,752,1022,465,411,122,50,239,54,54,54,0,0,0,0,0,0,557,514,183,29,302,43,43,43,0,0,0,0,0,0,55309
18528,1090,114,375,416,163,22,95,60,59,27,0,32,1,0,0,0,0,1,0,0,1,35,29,18,0,11,6,6,0,6,0,0,0,0,0,55310
18529,21933,411,3093,6177,8284,3968,1719,828,784,335,34,415,44,32,9,13,10,12,0,0,12,891,869,224,96,549,22,12,0,0,12,10,10,0,0,55311
18530,1157,97,462,456,111,31,93,21,19,3,0,16,2,2,2,0,0,0,0,0,0,72,72,9,0,63,0,0,0,0,0,0,0,0,0,55312
18531,15186,986,4795,5702,2794,909,1413,702,591,293,83,215,111,96,54,19,23,15,4,0,11,711,659,349,31,279,52,45,45,0,0,7,0,4,3,55313
18532,1015,108,472,286,119,30,47,16,11,5,0,6,5,5,0,0,5,0,0,0,0,31,24,4,0,20,7,0,0,0,0,7,0,0,7,55314
18533,2970,94,673,889,902,412,239,160,144,93,4,47,16,16,4,0,12,0,0,0,0,79,75,22,8,45,4,4,4,0,0,0,0,0,0,55315
18534,15859,604,3604,6407,3760,1484,1686,728,676,254,57,365,52,52,52,0,0,0,0,0,0,958,857,413,9,435,101,60,60,0,0,41,0,0,41,55316
18535,12830,399,1505,3152,5403,2371,994,408,408,187,11,210,0,0,0,0,0,0,0,0,0,586,558,213,0,345,28,18,18,0,0,10,10,0,0,55317
18536,16347,961,3519,4996,4964,1907,1571,907,735,198,52,485,172,172,82,90,0,0,0,0,0,664,583,237,23,323,81,63,37,0,26,18,18,0,0,55318
18537,3502,208,1070,1382,532,310,282,144,127,46,15,66,17,8,8,0,0,9,0,0,9,138,128,84,19,25,10,10,10,0,0,0,0,0,0,55319
18538,3019,237,947,1242,442,151,238,120,106,48,7,51,14,11,5,6,0,3,0,3,0,118,115,85,0,30,3,3,0,3,0,0,0,0,0,55320
18539,3333,210,1410,1116,410,187,357,203,175,68,3,104,28,17,14,0,3,11,0,5,6,154,146,97,28,21,8,6,6,0,0,2,2,0,0,55321
18540,2026,101,744,686,341,154,192,106,97,45,11,41,9,5,3,2,0,4,4,0,0,86,82,40,2,40,4,4,4,0,0,0,0,0,0,55322
18541,978,57,376,395,102,48,51,39,37,16,2,19,2,2,2,0,0,0,0,0,0,12,12,4,0,8,0,0,0,0,0,0,0,0,0,55324
18542,2940,192,938,1124,492,194,233,134,127,48,30,49,7,7,4,0,3,0,0,0,0,99,86,25,6,55,13,13,13,0,0,0,0,0,0,55325
18543,2510,77,791,980,450,212,143,73,63,32,0,31,10,10,0,10,0,0,0,0,0,70,63,19,9,35,7,7,7,0,0,0,0,0,0,55327
18544,5541,234,1972,1513,1356,466,559,340,321,85,13,223,19,19,0,0,19,0,0,0,0,219,207,86,0,121,12,0,0,0,0,12,12,0,0,55328
18545,1271,128,588,377,142,36,96,54,45,17,3,25,9,6,3,0,3,3,3,0,0,42,34,9,0,25,8,8,8,0,0,0,0,0,0,55329
18546,23717,1394,6658,9303,4614,1748,1860,1031,892,237,172,483,139,130,72,17,41,9,0,0,9,829,713,404,45,264,116,99,99,0,0,17,0,0,17,55330
18547,11999,192,1528,3186,4752,2341,1214,696,653,233,46,374,43,35,35,0,0,8,0,0,8,518,488,167,16,305,30,30,10,0,20,0,0,0,0,55331
18548,1210,177,505,377,118,33,90,41,41,20,3,18,0,0,0,0,0,0,0,0,0,49,49,18,0,31,0,0,0,0,0,0,0,0,0,55332
18549,671,90,320,198,60,3,50,38,36,11,2,23,2,1,1,0,0,1,0,0,1,12,12,1,2,9,0,0,0,0,0,0,0,0,0,55333
18550,2132,338,974,543,211,66,118,70,65,7,31,27,5,5,5,0,0,0,0,0,0,48,35,18,4,13,13,13,13,0,0,0,0,0,0,55334
18551,1039,106,427,353,128,25,64,36,36,12,0,24,0,0,0,0,0,0,0,0,0,28,22,12,2,8,6,6,2,0,4,0,0,0,0,55335
18552,5312,695,1814,1959,642,202,462,261,241,131,30,80,20,3,3,0,0,17,17,0,0,201,162,55,3,104,39,23,20,0,3,16,0,0,16,55336
18553,29969,1656,6928,10807,7534,3044,2159,974,769,229,123,417,205,179,134,29,16,26,18,0,8,1185,1024,450,123,451,161,56,56,0,0,105,34,0,71,55337
18554,696,66,310,232,78,10,68,22,20,2,6,12,2,2,2,0,0,0,0,0,0,46,35,25,3,7,11,11,11,0,0,0,0,0,0,55338
18555,705,47,342,184,108,24,71,45,42,11,5,26,3,3,3,0,0,0,0,0,0,26,20,5,0,15,6,6,6,0,0,0,0,0,0,55339
18556,4135,240,989,1132,1282,492,472,263,245,75,68,102,18,18,9,0,9,0,0,0,0,209,209,87,11,111,0,0,0,0,0,0,0,0,0,55340
18557,1698,6,367,600,568,157,145,69,51,26,2,23,18,15,5,0,10,3,3,0,0,76,59,35,18,6,17,11,11,0,0,6,6,0,0,55341
18558,1424,156,553,546,145,24,121,64,55,11,0,44,9,6,6,0,0,3,0,0,3,57,53,22,0,31,4,0,0,0,0,4,2,2,0,55342
18559,17509,1196,3215,5346,5518,2234,999,544,407,139,60,208,137,30,0,0,30,107,53,33,21,455,429,152,2,275,26,26,26,0,0,0,0,0,0,55343
18560,10050,767,1392,2549,3481,1861,412,230,213,61,14,138,17,0,0,0,0,17,17,0,0,182,182,50,0,132,0,0,0,0,0,0,0,0,0,55344
18561,15399,366,2374,4272,5644,2743,1133,610,570,154,36,380,40,21,16,0,5,19,0,0,19,523,480,179,17,284,43,43,36,0,7,0,0,0,0,55345
18562,11160,185,1201,3051,4595,2128,845,408,408,110,14,284,0,0,0,0,0,0,0,0,0,437,415,145,38,232,22,14,14,0,0,8,0,0,8,55346
18563,19765,347,1663,4998,8365,4392,1530,808,737,173,94,470,71,71,44,0,27,0,0,0,0,722,700,182,25,493,22,22,0,22,0,0,0,0,0,55347
18564,2630,222,1205,808,304,91,226,116,90,42,10,38,26,20,16,0,4,6,0,6,0,110,88,44,10,34,22,22,22,0,0,0,0,0,0,55349
18565,12228,847,4223,4625,1784,749,929,556,438,234,18,186,118,94,72,22,0,24,0,0,24,373,333,154,45,134,40,31,27,4,0,9,0,0,9,55350
18566,5681,311,1522,2048,1389,411,440,215,189,94,9,86,26,23,23,0,0,3,0,0,3,225,166,111,0,55,59,59,37,22,0,0,0,0,0,55352
18567,2127,166,831,692,349,89,165,83,61,20,0,41,22,18,15,3,0,4,0,0,4,82,79,31,7,41,3,3,3,0,0,0,0,0,0,55353
18568,1827,211,708,658,183,67,149,60,43,26,4,13,17,14,11,3,0,3,3,0,0,89,86,29,6,51,3,3,3,0,0,0,0,0,0,55354
18569,6808,738,2548,2177,995,350,506,262,248,100,27,121,14,2,2,0,0,12,12,0,0,244,220,101,0,119,24,22,10,12,0,2,0,0,2,55355
18570,3932,90,650,1003,1330,859,265,108,108,32,0,76,0,0,0,0,0,0,0,0,0,157,157,65,0,92,0,0,0,0,0,0,0,0,0,55356
18571,2207,65,669,712,531,230,213,108,97,22,6,69,11,6,6,0,0,5,5,0,0,105,95,20,7,68,10,4,4,0,0,6,0,0,6,55357
18572,3306,322,1230,1087,438,229,272,140,102,43,16,43,38,27,20,5,2,11,0,0,11,132,114,60,0,54,18,14,13,0,1,4,0,0,4,55358
18573,4259,183,1032,1535,1141,368,548,268,256,72,27,157,12,12,12,0,0,0,0,0,0,280,268,98,11,159,12,0,0,0,0,12,12,0,0,55359
18574,1713,70,514,641,392,96,224,147,137,68,29,40,10,7,7,0,0,3,0,0,3,77,73,45,0,28,4,4,4,0,0,0,0,0,0,55360
18575,11680,708,3636,4229,2319,788,1075,459,398,124,60,214,61,28,7,13,8,33,0,0,33,616,477,231,50,196,139,139,139,0,0,0,0,0,0,55362
18576,2722,385,790,1102,349,96,303,165,22,4,13,5,143,63,47,3,13,80,67,0,13,138,128,16,5,107,10,10,4,0,6,0,0,0,0,55363
18577,10335,301,2391,3242,3223,1178,555,290,252,82,32,138,38,13,0,0,13,25,15,10,0,265,221,153,0,68,44,18,18,0,0,26,26,0,0,55364
18578,313,21,154,113,25,0,38,17,16,8,6,2,1,1,0,1,0,0,0,0,0,21,19,2,15,2,2,2,2,0,0,0,0,0,0,55366
18579,679,74,301,194,75,35,74,38,32,20,4,8,6,6,6,0,0,0,0,0,0,36,32,12,0,20,4,2,2,0,0,2,2,0,0,55367
18580,1364,119,636,388,172,49,104,69,69,44,0,25,0,0,0,0,0,0,0,0,0,35,33,16,0,17,2,2,2,0,0,0,0,0,0,55368
18581,23629,847,5500,7896,6803,2583,1303,682,601,224,70,307,81,32,26,0,6,49,16,18,15,621,550,303,109,138,71,71,59,0,12,0,0,0,0,55369
18582,619,29,262,200,102,26,27,19,17,5,0,12,2,0,0,0,0,2,2,0,0,8,8,5,0,3,0,0,0,0,0,0,0,0,0,55370
18583,10983,1057,3990,4128,1371,437,766,420,399,167,25,207,21,21,9,0,12,0,0,0,0,346,298,139,9,150,48,48,45,3,0,0,0,0,0,55371
18584,19736,641,4172,6804,5984,2135,1691,944,849,363,42,444,95,41,41,0,0,54,54,0,0,747,642,202,93,347,105,86,59,27,0,19,0,19,0,55372
18585,3414,302,891,1099,840,282,268,149,112,38,5,69,37,32,32,0,0,5,5,0,0,119,97,47,0,50,22,22,0,22,0,0,0,0,0,55373
18586,8338,254,1938,3014,2302,830,702,354,343,230,29,84,11,11,5,0,6,0,0,0,0,348,323,143,0,180,25,25,13,12,0,0,0,0,0,55374
18587,2647,111,639,760,834,303,384,264,231,80,25,126,33,10,0,10,0,23,23,0,0,120,120,57,0,63,0,0,0,0,0,0,0,0,0,55375
18588,10615,273,2281,4329,2811,921,758,356,356,221,14,121,0,0,0,0,0,0,0,0,0,402,391,217,0,174,11,11,11,0,0,0,0,0,0,55376
18589,17105,933,3207,5616,5613,1736,1670,781,720,217,47,456,61,61,43,18,0,0,0,0,0,889,811,374,99,338,78,64,32,6,26,14,14,0,0,55378
18590,26179,1978,6757,7700,6865,2879,2241,1193,951,269,60,622,242,165,58,77,30,77,74,0,3,1048,892,299,72,521,156,150,105,45,0,6,0,0,6,55379
18591,1393,114,674,430,126,49,79,52,47,26,0,21,5,3,3,0,0,2,0,2,0,27,25,14,7,4,2,2,2,0,0,0,0,0,0,55381
18592,2424,205,898,833,350,138,181,52,45,28,0,17,7,7,5,0,2,0,0,0,0,129,113,70,3,40,16,10,2,8,0,6,0,3,3,55382
18593,1512,71,418,490,396,137,33,0,0,0,0,0,0,0,0,0,0,0,0,0,0,33,33,0,0,33,0,0,0,0,0,0,0,0,0,55384
18594,916,112,400,295,85,24,83,57,52,18,5,29,5,3,3,0,0,2,0,0,2,26,26,21,0,5,0,0,0,0,0,0,0,0,0,55385
18595,3973,46,417,1136,1807,567,458,256,256,140,15,101,0,0,0,0,0,0,0,0,0,202,202,74,32,96,0,0,0,0,0,0,0,0,0,55386
18596,8143,352,1857,2380,2495,1059,664,374,321,150,30,141,53,53,40,13,0,0,0,0,0,290,261,102,0,159,29,16,12,4,0,13,13,0,0,55387
18597,3766,299,1302,1211,749,205,301,67,60,29,0,31,7,7,0,0,7,0,0,0,0,234,173,87,18,68,61,7,4,0,3,54,0,54,0,55388
18598,1655,190,795,533,110,27,150,85,63,22,0,41,22,22,8,12,2,0,0,0,0,65,60,31,0,29,5,2,0,0,2,3,3,0,0,55389
18599,1747,173,602,695,194,83,103,55,49,18,0,31,6,6,4,0,2,0,0,0,0,48,48,8,0,40,0,0,0,0,0,0,0,0,0,55390
18600,10870,231,1489,2731,4306,2113,543,332,330,99,38,193,2,0,0,0,0,2,2,0,0,211,209,49,11,149,2,0,0,0,0,2,0,0,2,55391
18601,1917,221,756,656,209,75,125,42,34,7,0,27,8,8,8,0,0,0,0,0,0,83,79,49,0,30,4,4,4,0,0,0,0,0,0,55395
18602,1486,213,595,438,185,55,87,30,30,16,8,6,0,0,0,0,0,0,0,0,0,57,53,19,16,18,4,4,4,0,0,0,0,0,0,55396
18603,1926,110,686,741,310,79,174,101,101,16,6,79,0,0,0,0,0,0,0,0,0,73,56,12,19,25,17,17,4,0,13,0,0,0,0,55397
18604,9575,870,2793,4495,1097,320,975,485,477,95,50,332,8,0,0,0,0,8,8,0,0,490,440,111,52,277,50,47,11,0,36,3,0,0,3,55398
18605,6695,416,466,966,2950,1897,26,17,17,17,0,0,0,0,0,0,0,0,0,0,0,9,9,9,0,0,0,0,0,0,0,0,0,0,0,55401
18606,346,11,88,43,83,121,0,0,0,0,0,0,0,0,0,0,0,0,0,0,0,0,0,0,0,0,0,0,0,0,0,0,0,0,0,55402
18607,11469,519,1448,2414,4642,2446,203,140,61,52,0,9,79,79,0,79,0,0,0,0,0,63,56,0,12,44,7,7,0,0,7,0,0,0,0,55403
18608,17922,4170,4137,4464,3572,1579,1500,567,492,137,117,238,75,46,17,0,29,29,0,0,29,933,832,352,121,359,101,60,37,0,23,41,0,41,0,55404
18609,10466,819,1157,2556,3660,2274,416,209,156,65,41,50,53,46,16,30,0,7,0,0,7,207,103,20,0,83,104,98,57,17,24,6,0,0,6,55405
18610,24204,1929,4696,5739,6909,4931,1040,604,488,175,8,305,116,108,34,25,49,8,0,8,0,436,385,157,40,188,51,51,51,0,0,0,0,0,0,55406
18611,24430,4476,4230,6150,6201,3373,1664,758,582,126,137,319,176,58,31,20,7,118,56,0,62,906,749,188,72,489,157,80,38,0,42,77,12,25,40,55407
18612,21000,3094,3096,5223,6204,3383,907,527,418,100,0,318,109,20,20,0,0,89,28,25,36,380,333,61,36,236,47,47,9,15,23,0,0,0,0,55408
18613,8698,717,1503,1919,2676,1883,421,201,189,29,44,116,12,4,4,0,0,8,0,0,8,220,214,95,32,87,6,0,0,0,0,6,0,6,0,55409
18614,14155,163,1134,2790,5799,4269,717,372,296,89,56,151,76,76,16,60,0,0,0,0,0,345,337,88,5,244,8,8,8,0,0,0,0,0,0,55410
18615,14242,3278,4278,4386,1624,676,2373,1100,817,254,110,453,283,126,0,97,29,157,25,53,79,1273,1187,261,175,751,86,65,26,33,6,21,13,2,6,55411
18616,12989,1959,3687,3969,2425,949,1111,569,436,26,28,382,133,76,4,46,26,57,0,30,27,542,428,75,52,301,114,58,24,14,20,56,0,24,32,55412
18617,9436,1221,1942,2643,2464,1166,435,213,177,20,12,145,36,29,15,0,14,7,0,7,0,222,200,28,22,150,22,22,22,0,0,0,0,0,0,55413
18618,9868,527,1063,2390,2896,2992,5072,2604,2564,818,285,1461,40,40,0,0,40,0,0,0,0,2468,2436,1074,366,996,32,32,32,0,0,0,0,0,0,55414
18619,2396,511,525,537,493,330,111,86,60,0,0,60,26,0,0,0,0,26,0,0,26,25,25,0,9,16,0,0,0,0,0,0,0,0,0,55415
18620,22535,642,2263,4831,9083,5716,610,303,285,86,8,191,18,0,0,0,0,18,0,14,4,307,307,112,52,143,0,0,0,0,0,0,0,0,0,55416
18621,19473,1348,3084,5400,6360,3281,770,464,452,166,61,225,12,0,0,0,0,12,0,12,0,306,252,95,31,126,54,54,42,0,12,0,0,0,0,55417
18622,22052,2353,4604,6886,5512,2697,1020,527,420,83,13,324,107,50,16,28,6,57,11,11,35,493,472,165,54,253,21,21,21,0,0,0,0,0,0,55418
18623,18478,698,2013,4002,6521,5244,1015,505,451,86,34,331,54,54,8,46,0,0,0,0,0,510,406,81,59,266,104,93,93,0,0,11,11,0,0,55419
18624,15639,1768,4908,4941,3083,939,1044,555,457,102,106,249,98,92,56,24,12,6,6,0,0,489,465,125,80,260,24,24,0,0,24,0,0,0,0,55420
18625,18879,2294,5506,6458,3080,1541,1465,630,451,68,47,336,179,133,90,23,20,46,29,0,17,835,655,130,107,418,180,109,92,8,9,71,37,0,34,55421
18626,20481,1186,4509,6496,5679,2611,1027,512,472,119,100,253,40,27,27,0,0,13,0,0,13,515,433,194,65,174,82,82,66,14,2,0,0,0,0,55422
18627,25229,3295,5803,7675,5946,2510,1544,741,603,188,81,334,138,74,27,32,15,64,60,4,0,803,722,355,142,225,81,38,26,12,0,43,29,14,0,55423
18628,6270,41,351,857,2611,2410,568,356,345,68,10,267,11,0,0,0,0,11,0,0,11,212,212,58,0,154,0,0,0,0,0,0,0,0,0,55424
18629,6169,689,1659,2224,1207,390,503,294,248,98,42,108,46,20,20,0,0,26,0,0,26,209,201,116,0,85,8,0,0,0,0,8,0,0,8,55425
18630,17893,842,3073,5372,5807,2799,939,531,489,204,25,260,42,29,0,29,0,13,4,9,0,408,339,127,25,187,69,38,25,9,4,31,29,0,2,55426
18631,16330,1225,3199,4872,4653,2381,848,455,395,110,14,271,60,18,18,0,0,42,14,3,25,393,340,139,23,178,53,53,27,26,0,0,0,0,0,55427
18632,19865,2447,5733,7011,3611,1063,1217,652,545,145,85,315,107,61,25,17,19,46,0,9,37,565,452,272,46,134,113,71,61,0,10,42,42,0,0,55428
18633,17880,3009,5610,5840,2630,791,1320,650,516,149,35,332,134,56,8,0,48,78,26,52,0,670,610,173,100,337,60,41,26,0,15,19,0,17,2,55429
18634,14620,2552,4419,4761,2105,783,1172,652,617,129,31,457,35,22,0,0,22,13,0,0,13,520,382,145,35,202,138,105,74,31,0,33,0,10,23,55430
18635,13660,1067,3096,4211,3659,1627,612,285,261,131,6,124,24,17,17,0,0,7,0,0,7,327,319,130,63,126,8,8,8,0,0,0,0,0,0,55431
18636,21088,2076,6686,7083,3680,1563,1428,796,680,39,102,539,116,36,36,0,0,80,10,36,34,632,546,203,33,310,86,38,20,18,0,48,9,7,32,55432
18637,22648,1706,6763,9000,3630,1549,1807,972,837,334,181,322,135,81,30,0,51,54,22,11,21,835,757,243,129,385,78,65,43,13,9,13,0,0,13,55433
18638,19171,1445,5983,7911,2575,1257,1426,745,653,149,55,449,92,8,8,0,0,84,53,0,31,681,627,243,61,323,54,31,31,0,0,23,0,0,23,55434
18639,9562,476,1496,2357,3094,2139,502,242,185,16,24,145,57,22,11,0,11,35,35,0,0,260,224,137,17,70,36,0,0,0,0,36,0,0,36,55435
18640,9005,112,913,1961,3678,2341,512,185,185,45,11,129,0,0,0,0,0,0,0,0,0,327,271,73,11,187,56,27,0,0,27,29,29,0,0,55436
18641,13279,433,2555,3694,4181,2416,633,287,234,115,0,119,53,31,31,0,0,22,0,0,22,346,324,87,33,204,22,22,22,0,0,0,0,0,0,55437
18642,12346,384,1406,3714,4396,2446,623,268,231,42,0,189,37,37,14,0,23,0,0,0,0,355,340,117,13,210,15,15,15,0,0,0,0,0,0,55438
18643,6023,105,472,902,2721,1823,551,328,322,59,0,263,6,6,0,6,0,0,0,0,0,223,214,45,7,162,9,9,0,0,9,0,0,0,0,55439
18644,12708,350,2226,4131,3889,2112,678,333,321,77,38,206,12,12,0,0,12,0,0,0,0,345,336,100,26,210,9,0,0,0,0,9,9,0,0,55441
18645,9302,151,1321,2692,3316,1822,467,278,268,70,15,183,10,10,0,10,0,0,0,0,0,189,183,90,20,73,6,6,6,0,0,0,0,0,0,55442
18646,20437,1744,4527,6719,5284,2163,2016,979,813,127,40,646,166,118,43,58,17,48,32,0,16,1037,972,308,23,641,65,42,42,0,0,23,23,0,0,55443
18647,9455,787,1919,3562,2313,874,1027,555,480,182,28,270,75,69,36,8,25,6,0,0,6,472,458,106,54,298,14,14,14,0,0,0,0,0,0,55444
18648,6196,508,1363,2028,1691,606,315,235,235,66,0,169,0,0,0,0,0,0,0,0,0,80,80,43,0,37,0,0,0,0,0,0,0,0,0,55445
18649,13777,430,1378,3005,5613,3351,840,608,562,210,7,345,46,30,0,30,0,16,0,16,0,232,226,31,0,195,6,6,6,0,0,0,0,0,0,55446
18650,15013,608,2198,3859,5455,2893,1025,408,390,138,36,216,18,18,18,0,0,0,0,0,0,617,595,294,23,278,22,6,0,0,6,16,14,0,2,55447
18651,18634,914,5581,6857,3836,1446,1270,592,520,139,38,343,72,28,19,9,0,44,32,12,0,678,630,235,84,311,48,32,23,9,0,16,9,0,7,55448
18652,16034,570,2940,4923,5128,2473,1087,615,586,114,13,459,29,23,16,2,5,6,6,0,0,472,471,250,42,179,1,0,0,0,0,1,0,0,1,55449
18653,53,0,53,0,0,0,0,0,0,0,0,0,0,0,0,0,0,0,0,0,0,0,0,0,0,0,0,0,0,0,0,0,0,0,0,55450
18654,3139,1031,493,729,533,353,1708,1045,1045,337,153,555,0,0,0,0,0,0,0,0,0,663,663,235,40,388,0,0,0,0,0,0,0,0,0,55454
18655,14,0,0,0,14,0,1535,570,570,98,76,396,0,0,0,0,0,0,0,0,0,965,965,279,148,538,0,0,0,0,0,0,0,0,0,55455
18656,62,3,20,21,9,9,8,8,1,0,1,0,7,0,0,0,0,7,0,7,0,0,0,0,0,0,0,0,0,0,0,0,0,0,0,55601
18657,146,3,73,41,24,5,1,1,0,0,0,0,1,0,0,0,0,1,0,0,1,0,0,0,0,0,0,0,0,0,0,0,0,0,0,55602
18658,389,35,160,131,51,12,51,33,33,0,10,23,0,0,0,0,0,0,0,0,0,18,18,5,12,1,0,0,0,0,0,0,0,0,0,55603
18659,2720,102,776,698,662,482,106,59,59,42,0,17,0,0,0,0,0,0,0,0,0,47,47,30,0,17,0,0,0,0,0,0,0,0,0,55604
18660,333,53,131,120,12,17,10,5,4,1,0,3,1,0,0,0,0,1,1,0,0,5,4,1,1,2,1,1,1,0,0,0,0,0,0,55605
18661,161,13,11,74,35,28,0,0,0,0,0,0,0,0,0,0,0,0,0,0,0,0,0,0,0,0,0,0,0,0,0,0,0,0,0,55606
18662,90,18,40,20,7,5,5,3,3,0,0,3,0,0,0,0,0,0,0,0,0,2,2,0,0,2,0,0,0,0,0,0,0,0,0,55607
18663,220,5,58,42,75,40,0,0,0,0,0,0,0,0,0,0,0,0,0,0,0,0,0,0,0,0,0,0,0,0,0,0,0,0,0,55609
18664,439,29,66,176,127,41,9,8,8,4,0,4,0,0,0,0,0,0,0,0,0,1,1,0,0,1,0,0,0,0,0,0,0,0,0,55612
18665,193,9,65,70,34,15,8,6,5,2,0,3,1,1,0,0,1,0,0,0,0,2,2,0,0,2,0,0,0,0,0,0,0,0,0,55613
18666,2099,192,749,839,220,99,114,69,61,5,3,53,8,4,0,4,0,4,0,0,4,45,45,30,6,9,0,0,0,0,0,0,0,0,0,55614
18667,163,1,62,55,30,15,24,15,15,15,0,0,0,0,0,0,0,0,0,0,0,9,9,4,0,5,0,0,0,0,0,0,0,0,0,55615
18668,4960,257,1877,1791,670,365,325,150,125,67,2,56,25,13,13,0,0,12,11,0,1,175,104,35,25,44,71,57,31,1,25,14,14,0,0,55616
18669,347,35,105,169,27,11,18,12,12,4,0,8,0,0,0,0,0,0,0,0,0,6,5,2,0,3,1,1,1,0,0,0,0,0,0,55702
18670,626,58,265,201,66,36,33,6,6,2,2,2,0,0,0,0,0,0,0,0,0,27,25,2,0,23,2,0,0,0,0,2,0,0,2,55703
18671,856,79,362,253,118,44,35,16,14,0,0,14,2,2,2,0,0,0,0,0,0,19,19,8,2,9,0,0,0,0,0,0,0,0,0,55704
18672,2511,189,1073,905,217,127,137,70,37,4,7,26,33,33,32,0,1,0,0,0,0,67,47,29,6,12,20,20,9,0,11,0,0,0,0,55705
18673,1290,147,476,461,119,87,72,39,29,7,9,13,10,2,0,0,2,8,0,2,6,33,33,9,0,24,0,0,0,0,0,0,0,0,0,55706
18674,2343,173,862,842,340,126,222,132,107,28,3,76,25,9,7,0,2,16,7,4,5,90,78,11,3,64,12,10,8,2,0,2,2,0,0,55707
18675,792,83,261,326,97,25,19,13,13,4,2,7,0,0,0,0,0,0,0,0,0,6,0,0,0,0,6,3,3,0,0,3,3,0,0,55708
18676,2869,210,1035,1143,365,116,247,167,141,43,0,98,26,26,0,7,19,0,0,0,0,80,77,41,2,34,3,3,3,0,0,0,0,0,0,55709
18677,863,25,246,378,129,85,51,21,21,1,0,20,0,0,0,0,0,0,0,0,0,30,30,20,0,10,0,0,0,0,0,0,0,0,0,55710
18678,402,89,131,137,33,12,26,14,12,7,0,5,2,2,0,0,2,0,0,0,0,12,10,4,0,6,2,2,0,2,0,0,0,0,0,55711
18679,422,34,163,152,57,16,21,11,11,7,0,4,0,0,0,0,0,0,0,0,0,10,10,0,0,10,0,0,0,0,0,0,0,0,0,55712
18680,759,76,281,312,68,22,51,51,43,24,0,19,8,4,0,0,4,4,0,0,4,0,0,0,0,0,0,0,0,0,0,0,0,0,0,55713
18681,227,26,91,98,12,0,27,12,12,2,1,9,0,0,0,0,0,0,0,0,0,15,15,3,0,12,0,0,0,0,0,0,0,0,0,55716
18682,184,19,50,77,19,19,5,5,5,1,1,3,0,0,0,0,0,0,0,0,0,0,0,0,0,0,0,0,0,0,0,0,0,0,0,55717
18683,2330,222,827,787,343,151,145,94,85,18,12,55,9,5,5,0,0,4,4,0,0,51,50,30,3,17,1,1,0,0,1,0,0,0,0,55718
18684,4106,284,1407,1473,778,164,305,136,124,31,2,91,12,0,0,0,0,12,0,12,0,169,140,49,0,91,29,26,12,0,14,3,0,3,0,55719
18685,11412,879,4052,4012,1652,817,1028,468,386,156,41,189,82,36,2,20,14,46,16,10,20,560,436,166,47,223,124,88,55,26,7,36,0,19,17,55720
18686,2521,132,712,968,479,230,141,25,25,12,4,9,0,0,0,0,0,0,0,0,0,116,112,92,0,20,4,4,4,0,0,0,0,0,0,55721
18687,696,45,139,336,137,39,56,43,32,11,0,21,11,11,11,0,0,0,0,0,0,13,10,0,4,6,3,3,0,3,0,0,0,0,0,55722
18688,1934,170,746,607,308,103,120,88,82,5,0,77,6,2,0,0,2,4,2,0,2,32,30,10,0,20,2,0,0,0,0,2,0,0,2,55723
18689,657,32,274,209,89,53,47,16,5,2,2,1,11,11,8,2,1,0,0,0,0,31,21,9,0,12,10,1,1,0,0,9,9,0,0,55724
18690,91,0,24,41,16,10,1,1,1,0,0,1,0,0,0,0,0,0,0,0,0,0,0,0,0,0,0,0,0,0,0,0,0,0,0,55725
18691,616,61,269,198,70,18,35,24,24,10,0,14,0,0,0,0,0,0,0,0,0,11,11,4,0,7,0,0,0,0,0,0,0,0,0,55726
18692,4493,247,937,1629,1109,571,383,241,241,43,33,165,0,0,0,0,0,0,0,0,0,142,134,68,17,49,8,8,8,0,0,0,0,0,0,55731
18693,964,67,386,392,103,16,52,20,20,10,4,6,0,0,0,0,0,0,0,0,0,32,21,3,0,18,11,6,6,0,0,5,5,0,0,55732
18694,3241,116,964,1224,613,324,238,141,121,56,0,65,20,0,0,0,0,20,0,0,20,97,84,69,0,15,13,13,8,0,5,0,0,0,0,55733
18695,4761,298,1330,2103,780,250,216,103,78,34,0,44,25,25,8,17,0,0,0,0,0,113,113,44,10,59,0,0,0,0,0,0,0,0,0,55734
18696,1322,136,565,415,165,41,168,103,79,13,46,20,24,23,3,0,20,1,0,0,1,65,57,13,5,39,8,5,0,0,5,3,0,0,3,55735
18697,1082,121,425,387,134,15,51,18,16,7,0,9,2,2,0,2,0,0,0,0,0,33,29,4,0,25,4,4,0,1,3,0,0,0,0,55736
18698,397,34,137,178,36,12,22,14,12,1,1,10,2,2,2,0,0,0,0,0,0,8,8,0,3,5,0,0,0,0,0,0,0,0,0,55738
18699,2491,122,946,927,371,125,111,46,43,32,0,11,3,3,0,3,0,0,0,0,0,65,34,0,5,29,31,31,2,13,16,0,0,0,0,55741
18700,214,8,76,88,35,7,13,12,12,4,6,2,0,0,0,0,0,0,0,0,0,1,1,0,1,0,0,0,0,0,0,0,0,0,0,55742
18701,14652,875,4592,5397,2425,1363,937,545,456,179,25,252,89,79,68,8,3,10,0,4,6,392,376,181,4,191,16,13,13,0,0,3,0,0,3,55744
18702,11983,1354,4004,4687,1346,592,789,425,356,168,30,158,69,39,31,8,0,30,15,0,15,364,284,120,25,139,80,73,57,1,15,7,7,0,0,55746
18703,1021,84,403,398,107,29,74,43,33,4,6,23,10,8,7,1,0,2,0,0,2,31,29,14,0,15,2,0,0,0,0,2,0,0,2,55748
18704,434,40,193,144,47,10,18,15,13,0,0,13,2,2,0,0,2,0,0,0,0,3,3,2,0,1,0,0,0,0,0,0,0,0,0,55749
18705,1632,102,595,655,228,52,69,55,45,0,3,42,10,10,0,5,5,0,0,0,0,14,14,8,0,6,0,0,0,0,0,0,0,0,0,55750
18706,1088,58,398,467,136,29,56,29,25,2,3,20,4,2,2,0,0,2,2,0,0,27,24,15,0,9,3,3,3,0,0,0,0,0,0,55751
18707,317,22,106,152,19,18,16,15,12,3,0,9,3,3,0,0,3,0,0,0,0,1,1,0,0,1,0,0,0,0,0,0,0,0,0,55752
18708,649,81,199,297,53,19,31,10,6,2,0,4,4,0,0,0,0,4,4,0,0,21,18,0,12,6,3,0,0,0,0,3,0,0,3,55753
18709,335,39,135,104,38,19,14,4,4,4,0,0,0,0,0,0,0,0,0,0,0,10,10,3,0,7,0,0,0,0,0,0,0,0,0,55756
18710,667,77,264,214,88,24,43,23,19,3,0,16,4,4,4,0,0,0,0,0,0,20,15,2,0,13,5,1,1,0,0,4,0,0,4,55757
18711,115,15,48,42,5,5,2,2,2,1,0,1,0,0,0,0,0,0,0,0,0,0,0,0,0,0,0,0,0,0,0,0,0,0,0,55758
18712,2340,264,1041,713,254,68,179,104,67,42,6,19,37,33,3,28,2,4,0,3,1,75,65,31,12,22,10,10,3,4,3,0,0,0,0,55760
18713,449,17,140,222,50,20,36,18,18,14,0,4,0,0,0,0,0,0,0,0,0,18,2,0,0,2,16,16,0,16,0,0,0,0,0,55763
18714,443,33,203,180,22,5,17,5,5,0,0,5,0,0,0,0,0,0,0,0,0,12,12,6,0,6,0,0,0,0,0,0,0,0,0,55764
18715,547,57,222,203,61,4,22,14,10,0,0,10,4,4,1,3,0,0,0,0,0,8,8,1,0,7,0,0,0,0,0,0,0,0,0,55765
18716,35,2,6,26,1,0,0,0,0,0,0,0,0,0,0,0,0,0,0,0,0,0,0,0,0,0,0,0,0,0,0,0,0,0,0,55766
18717,3547,406,1222,1338,406,175,139,104,99,37,6,56,5,0,0,0,0,5,0,0,5,35,25,14,0,11,10,10,7,0,3,0,0,0,0,55767
18718,2155,126,599,965,350,115,127,44,44,22,1,21,0,0,0,0,0,0,0,0,0,83,83,38,0,45,0,0,0,0,0,0,0,0,0,55768
18719,1863,141,701,793,195,33,141,81,61,6,0,55,20,20,20,0,0,0,0,0,0,60,60,24,3,33,0,0,0,0,0,0,0,0,0,55769
18720,1275,136,448,465,140,86,69,34,30,16,0,14,4,2,1,0,1,2,0,2,0,35,30,24,0,6,5,2,1,1,0,3,3,0,0,55771
18721,61,15,31,15,0,0,6,1,1,0,0,1,0,0,0,0,0,0,0,0,0,5,0,0,0,0,5,4,2,0,2,1,0,1,0,55772
18722,935,67,250,412,137,69,39,5,5,2,0,3,0,0,0,0,0,0,0,0,0,34,34,30,0,4,0,0,0,0,0,0,0,0,0,55775
18723,2765,165,969,1054,462,115,155,96,92,31,0,61,4,0,0,0,0,4,0,0,4,59,55,21,10,24,4,4,4,0,0,0,0,0,0,55779
18724,136,15,59,42,20,0,15,0,0,0,0,0,0,0,0,0,0,0,0,0,0,15,15,2,0,13,0,0,0,0,0,0,0,0,0,55780
18725,450,3,115,204,92,36,18,9,8,3,0,5,1,0,0,0,0,1,0,0,1,9,9,2,0,7,0,0,0,0,0,0,0,0,0,55781
18726,341,6,91,168,61,15,18,2,2,2,0,0,0,0,0,0,0,0,0,0,0,16,16,6,0,10,0,0,0,0,0,0,0,0,0,55782
18727,1693,202,653,526,207,105,105,46,38,21,0,17,8,8,4,4,0,0,0,0,0,59,51,31,0,20,8,5,5,0,0,3,3,0,0,55783
18728,64,9,16,36,3,0,0,0,0,0,0,0,0,0,0,0,0,0,0,0,0,0,0,0,0,0,0,0,0,0,0,0,0,0,0,55784
18729,169,5,78,72,9,5,22,6,6,0,0,6,0,0,0,0,0,0,0,0,0,16,15,2,0,13,1,1,1,0,0,0,0,0,0,55785
18730,177,3,53,117,4,0,9,7,5,2,0,3,2,2,2,0,0,0,0,0,0,2,2,0,0,2,0,0,0,0,0,0,0,0,0,55786
18731,346,44,129,123,34,16,10,3,3,3,0,0,0,0,0,0,0,0,0,0,0,7,3,3,0,0,4,3,3,0,0,1,0,1,0,55787
18732,1493,72,434,589,249,149,45,33,27,20,0,7,6,6,6,0,0,0,0,0,0,12,12,5,2,5,0,0,0,0,0,0,0,0,0,55790
18733,7302,586,2231,3173,925,387,550,347,319,76,41,202,28,28,13,0,15,0,0,0,0,203,152,37,21,94,51,43,34,0,9,8,0,0,8,55792
18734,389,37,134,132,48,38,13,4,4,2,0,2,0,0,0,0,0,0,0,0,0,9,9,6,0,3,0,0,0,0,0,0,0,0,0,55793
18735,1085,159,469,297,115,45,32,26,22,11,5,6,4,0,0,0,0,4,2,0,2,6,6,0,0,6,0,0,0,0,0,0,0,0,0,55795
18736,1026,61,362,372,182,49,63,44,43,7,9,27,1,1,1,0,0,0,0,0,0,19,19,7,0,12,0,0,0,0,0,0,0,0,0,55797
18737,392,19,198,114,37,24,9,6,6,2,0,4,0,0,0,0,0,0,0,0,0,3,3,0,0,3,0,0,0,0,0,0,0,0,0,55798
18738,1941,266,389,631,381,274,69,44,44,8,13,23,0,0,0,0,0,0,0,0,0,25,21,3,12,6,4,4,4,0,0,0,0,0,0,55802
18739,11867,545,2743,4111,2803,1665,865,336,311,128,37,146,25,25,21,4,0,0,0,0,0,529,507,190,25,292,22,17,16,1,0,5,5,0,0,55803
18740,9891,304,1980,3012,2737,1858,767,308,291,97,44,150,17,17,7,10,0,0,0,0,0,459,391,138,50,203,68,49,35,0,14,19,0,0,19,55804
18741,5390,459,1141,2264,1034,492,465,299,198,75,11,112,101,67,23,26,18,34,0,31,3,166,130,102,18,10,36,1,0,0,1,35,4,14,17,55805
18742,5910,526,1806,2212,986,380,492,235,211,42,57,112,24,20,0,20,0,4,0,0,4,257,196,65,13,118,61,46,35,7,4,15,0,3,12,55806
18743,6972,508,2436,2762,953,313,490,258,233,106,14,113,25,25,4,21,0,0,0,0,0,232,210,117,28,65,22,17,11,0,6,5,0,0,5,55807
18744,3876,328,1600,1297,486,165,272,195,178,59,0,119,17,9,5,4,0,8,6,0,2,77,70,21,0,49,7,7,7,0,0,0,0,0,0,55808
18745,6312,450,2358,2232,905,367,377,194,154,37,23,94,40,16,15,0,1,24,24,0,0,183,171,76,24,71,12,10,10,0,0,2,2,0,0,55810
18746,17029,1137,4855,5722,3754,1561,2347,1014,909,275,112,522,105,87,27,60,0,18,8,0,10,1333,1290,607,137,546,43,23,14,9,0,20,8,12,0,55811
18747,4432,150,718,1323,1297,944,2595,1405,1333,286,186,861,72,31,31,0,0,41,0,0,41,1190,1180,441,147,592,10,0,0,0,0,10,10,0,0,55812
18748,699,67,252,261,75,44,0,0,0,0,0,0,0,0,0,0,0,0,0,0,0,0,0,0,0,0,0,0,0,0,0,0,0,0,0,55814
18749,34686,1561,6607,10799,9590,6129,2476,993,873,313,69,491,120,119,99,13,7,1,0,0,1,1483,1312,711,48,553,171,47,46,0,1,124,61,29,34,55901
18750,15854,360,2408,4140,4507,4439,1094,569,491,100,117,274,78,3,3,0,0,75,48,0,27,525,488,192,7,289,37,28,12,0,16,9,6,3,0,55902
18751,17487,1929,5032,6156,3047,1323,1083,624,536,214,33,289,88,76,47,28,1,12,0,0,12,459,389,174,53,162,70,70,70,0,0,0,0,0,0,55904
18752,0,0,0,0,0,0,0,0,0,0,0,0,0,0,0,0,0,0,0,0,0,0,0,0,0,0,0,0,0,0,0,0,0,0,0,55905
18753,12640,848,2505,3855,3336,2096,802,366,351,158,25,168,15,15,15,0,0,0,0,0,0,436,407,230,10,167,29,29,20,9,0,0,0,0,0,55906
18754,947,47,344,367,167,22,81,35,33,7,0,26,2,1,1,0,0,1,0,1,0,46,46,14,3,29,0,0,0,0,0,0,0,0,0,55909
18755,1003,124,335,372,140,32,59,32,19,5,3,11,13,11,11,0,0,2,0,0,2,27,25,7,0,18,2,2,2,0,0,0,0,0,0,55910
18756,18964,2750,5912,7076,2296,930,1754,899,729,261,204,264,170,91,56,16,19,79,62,0,17,855,774,412,126,236,81,36,31,0,5,45,23,0,22,55912
18757,2589,200,1000,892,347,150,234,96,93,45,0,48,3,0,0,0,0,3,0,0,3,138,103,52,10,41,35,2,0,2,0,33,33,0,0,55917
18758,758,54,306,253,108,37,45,14,7,5,0,2,7,7,7,0,0,0,0,0,0,31,29,7,0,22,2,2,2,0,0,0,0,0,0,55918
18759,751,54,344,222,91,40,50,26,17,1,0,16,9,9,9,0,0,0,0,0,0,24,24,19,0,5,0,0,0,0,0,0,0,0,0,55919
18760,4482,144,1249,1680,955,454,543,346,323,117,0,206,23,6,6,0,0,17,3,0,14,197,189,80,0,109,8,0,0,0,0,8,5,0,3,55920
18761,3356,363,1302,1097,433,161,316,197,176,22,38,116,21,13,3,10,0,8,0,0,8,119,94,43,0,51,25,25,25,0,0,0,0,0,0,55921
18762,482,114,164,139,44,21,42,23,10,2,0,8,13,0,0,0,0,13,7,0,6,19,10,5,0,5,9,2,0,2,0,7,0,0,7,55922
18763,2985,238,995,970,505,277,223,124,104,32,2,70,20,3,1,0,2,17,8,0,9,99,99,49,9,41,0,0,0,0,0,0,0,0,0,55923
18764,896,136,383,276,78,23,57,48,44,13,0,31,4,4,4,0,0,0,0,0,0,9,8,7,0,1,1,1,0,0,1,0,0,0,0,55924
18765,715,87,288,220,92,28,41,30,29,14,0,15,1,1,0,1,0,0,0,0,0,11,11,4,3,4,0,0,0,0,0,0,0,0,0,55925
18766,494,53,228,155,48,10,46,24,22,7,3,12,2,2,1,1,0,0,0,0,0,22,21,13,2,6,1,1,0,0,1,0,0,0,0,55926
18767,2557,296,864,900,411,86,273,156,118,40,2,76,38,38,20,18,0,0,0,0,0,117,90,46,0,44,27,16,0,3,13,11,3,0,8,55927
18768,821,37,338,277,117,52,33,16,12,0,3,9,4,4,4,0,0,0,0,0,0,17,14,6,2,6,3,3,0,0,3,0,0,0,0,55929
18769,242,25,115,73,24,5,12,8,8,4,0,4,0,0,0,0,0,0,0,0,0,4,4,0,2,2,0,0,0,0,0,0,0,0,0,55931
18770,1388,65,506,518,218,81,193,108,108,33,4,71,0,0,0,0,0,0,0,0,0,85,79,31,16,32,6,3,3,0,0,3,0,0,3,55932
18771,175,13,35,91,28,8,7,5,5,3,1,1,0,0,0,0,0,0,0,0,0,2,2,0,0,2,0,0,0,0,0,0,0,0,0,55933
18772,2202,119,705,866,329,183,150,97,65,19,0,46,32,26,20,0,6,6,0,0,6,53,53,38,0,15,0,0,0,0,0,0,0,0,0,55934
18773,615,37,240,241,73,24,55,28,25,4,5,16,3,0,0,0,0,3,0,1,2,27,27,19,2,6,0,0,0,0,0,0,0,0,0,55935
18774,1204,122,500,382,152,48,98,56,48,20,0,28,8,4,3,1,0,4,1,0,3,42,39,18,1,20,3,0,0,0,0,3,0,0,3,55936
18775,1446,247,559,424,162,54,100,60,43,9,0,34,17,6,1,0,5,11,3,0,8,40,33,12,0,21,7,0,0,0,0,7,0,0,7,55939
18776,1643,132,586,593,275,57,125,73,64,20,5,39,9,9,9,0,0,0,0,0,0,52,48,26,2,20,4,4,4,0,0,0,0,0,0,55940
18777,660,35,267,234,81,43,43,35,25,5,4,16,10,10,10,0,0,0,0,0,0,8,8,7,0,1,0,0,0,0,0,0,0,0,0,55941
18778,2175,188,878,646,300,163,177,65,62,17,2,43,3,3,0,3,0,0,0,0,0,112,98,33,25,40,14,14,8,6,0,0,0,0,0,55943
18779,4656,262,1474,1761,830,329,323,167,167,73,0,94,0,0,0,0,0,0,0,0,0,156,152,82,2,68,4,4,0,0,4,0,0,0,0,55944
18780,983,91,414,350,118,10,56,24,20,3,2,15,4,4,4,0,0,0,0,0,0,32,27,19,3,5,5,3,3,0,0,2,2,0,0,55945
18781,2246,151,812,840,329,114,156,56,54,33,0,21,2,0,0,0,0,2,2,0,0,100,95,19,9,67,5,5,2,3,0,0,0,0,0,55946
18782,5331,274,1505,1921,1010,621,334,132,117,49,2,66,15,15,11,0,4,0,0,0,0,202,169,106,19,44,33,33,31,0,2,0,0,0,0,55947
18783,1232,101,385,430,217,99,86,52,50,33,0,17,2,0,0,0,0,2,2,0,0,34,30,15,0,15,4,4,4,0,0,0,0,0,0,55949
18784,104,17,49,38,0,0,1,1,0,0,0,0,1,1,1,0,0,0,0,0,0,0,0,0,0,0,0,0,0,0,0,0,0,0,0,55950
18785,1090,118,495,340,90,47,68,46,42,21,0,21,4,4,4,0,0,0,0,0,0,22,21,18,0,3,1,1,0,1,0,0,0,0,0,55951
18786,1628,153,560,609,220,86,149,93,72,27,0,45,21,17,0,7,10,4,0,0,4,56,49,21,2,26,7,7,7,0,0,0,0,0,0,55952
18787,577,58,165,267,80,7,21,16,16,7,0,9,0,0,0,0,0,0,0,0,0,5,5,0,0,5,0,0,0,0,0,0,0,0,0,55953
18788,1040,168,429,315,103,25,59,13,11,4,0,7,2,2,0,0,2,0,0,0,0,46,37,24,0,13,9,0,0,0,0,9,4,0,5,55954
18789,1749,73,460,565,455,196,177,86,86,23,7,56,0,0,0,0,0,0,0,0,0,91,89,22,7,60,2,2,2,0,0,0,0,0,0,55955
18790,1313,131,518,413,179,72,92,71,53,17,5,31,18,18,0,18,0,0,0,0,0,21,19,10,3,6,2,1,1,0,0,1,0,0,1,55956
18791,467,47,219,149,41,11,47,32,22,13,3,6,10,9,2,7,0,1,1,0,0,15,14,7,0,7,1,1,1,0,0,0,0,0,0,55957
18792,1528,229,488,499,219,93,118,73,69,20,0,49,4,0,0,0,0,4,4,0,0,45,45,30,0,15,0,0,0,0,0,0,0,0,0,55959
18793,2180,80,527,712,572,289,147,98,92,57,0,35,6,6,6,0,0,0,0,0,0,49,49,20,6,23,0,0,0,0,0,0,0,0,0,55960
18794,325,26,140,139,19,1,21,6,6,1,0,5,0,0,0,0,0,0,0,0,0,15,15,7,0,8,0,0,0,0,0,0,0,0,0,55961
18795,598,44,232,210,91,21,34,26,19,6,0,13,7,1,1,0,0,6,0,0,6,8,5,1,1,3,3,0,0,0,0,3,0,0,3,55962
18796,3574,265,958,1276,798,277,362,157,157,116,19,22,0,0,0,0,0,0,0,0,0,205,168,97,13,58,37,25,15,10,0,12,8,0,4,55963
18797,2814,133,1109,990,408,174,196,76,61,59,0,2,15,15,12,0,3,0,0,0,0,120,103,67,12,24,17,17,17,0,0,0,0,0,0,55964
18798,1615,166,624,501,240,84,64,30,22,12,5,5,8,0,0,0,0,8,4,0,4,34,32,11,1,20,2,0,0,0,0,2,0,2,0,55965
18799,627,48,248,244,66,21,52,24,22,14,2,6,2,0,0,0,0,2,0,0,2,28,26,7,0,19,2,0,0,0,0,2,2,0,0,55967
18800,96,0,68,21,6,1,4,4,0,0,0,0,4,4,4,0,0,0,0,0,0,0,0,0,0,0,0,0,0,0,0,0,0,0,0,55968
18801,859,57,340,253,176,33,55,41,35,16,0,19,6,6,6,0,0,0,0,0,0,14,12,5,0,7,2,2,2,0,0,0,0,0,0,55969
18802,718,57,265,300,71,25,39,19,19,2,1,16,0,0,0,0,0,0,0,0,0,20,18,5,0,13,2,2,2,0,0,0,0,0,0,55970
18803,2214,189,751,807,320,147,190,112,92,36,3,53,20,20,20,0,0,0,0,0,0,78,66,43,3,20,12,12,12,0,0,0,0,0,0,55971
18804,2850,394,808,979,483,186,232,133,117,41,2,74,16,11,0,0,11,5,0,0,5,99,70,13,2,55,29,0,0,0,0,29,4,0,25,55972
18805,208,16,89,79,14,10,20,8,8,5,1,2,0,0,0,0,0,0,0,0,0,12,12,1,0,11,0,0,0,0,0,0,0,0,0,55973
18806,1583,200,615,497,202,69,96,54,36,24,0,12,18,7,7,0,0,11,0,0,11,42,34,16,0,18,8,5,0,0,5,3,0,0,3,55974
18807,2987,265,1147,1084,360,131,227,132,103,49,12,42,29,10,10,0,0,19,0,0,19,95,86,41,0,45,9,9,9,0,0,0,0,0,0,55975
18808,4967,362,1461,2007,879,258,343,152,138,80,0,58,14,14,14,0,0,0,0,0,0,191,168,114,13,41,23,20,17,0,3,3,0,3,0,55976
18809,118,7,58,45,8,0,4,1,1,1,0,0,0,0,0,0,0,0,0,0,0,3,3,1,0,2,0,0,0,0,0,0,0,0,0,55977
18810,637,73,241,197,100,26,28,18,15,5,3,7,3,0,0,0,0,3,0,0,3,10,10,3,4,3,0,0,0,0,0,0,0,0,0,55979
18811,3191,279,1189,1083,381,259,130,92,89,43,3,43,3,3,3,0,0,0,0,0,0,38,38,15,0,23,0,0,0,0,0,0,0,0,0,55981
18812,316,30,106,124,44,12,12,6,6,5,0,1,0,0,0,0,0,0,0,0,0,6,6,1,0,5,0,0,0,0,0,0,0,0,0,55982
18813,1042,111,404,333,164,30,57,30,25,7,9,9,5,2,2,0,0,3,0,0,3,27,18,8,2,8,9,7,0,7,0,2,0,0,2,55983
18814,1238,113,450,454,186,35,154,49,46,18,0,28,3,3,3,0,0,0,0,0,0,105,71,21,0,50,34,25,15,2,8,9,0,0,9,55985
18815,20570,1889,6177,6457,3672,2375,3877,1637,1461,441,299,721,176,142,116,2,24,34,21,0,13,2240,2216,844,504,868,24,24,16,8,0,0,0,0,0,55987
18816,590,47,286,180,52,25,38,5,5,0,0,5,0,0,0,0,0,0,0,0,0,33,33,8,0,25,0,0,0,0,0,0,0,0,0,55990
18817,903,86,320,304,136,57,59,34,32,22,0,10,2,2,2,0,0,0,0,0,0,25,25,15,0,10,0,0,0,0,0,0,0,0,0,55991
18818,3297,306,1017,1187,560,227,232,93,79,18,17,44,14,14,14,0,0,0,0,0,0,139,139,59,3,77,0,0,0,0,0,0,0,0,0,55992
18819,25573,1580,6594,8637,5978,2784,4419,2051,1777,672,196,909,274,242,160,0,82,32,13,0,19,2368,2239,1050,275,914,129,96,65,1,30,33,29,0,4,56001
18820,9772,400,2131,3693,2500,1048,517,215,185,73,17,95,30,30,13,10,7,0,0,0,0,302,250,133,21,96,52,52,41,11,0,0,0,0,0,56003
18821,15041,2091,5451,5187,1620,692,960,473,363,141,14,208,110,48,16,15,17,62,14,32,16,487,448,263,36,149,39,37,37,0,0,2,0,0,2,56007
18822,1148,81,441,474,114,38,95,49,36,21,4,11,13,9,9,0,0,4,0,4,0,46,46,8,0,38,0,0,0,0,0,0,0,0,0,56009
18823,885,77,355,312,113,28,39,20,17,5,0,12,3,0,0,0,0,3,0,0,3,19,19,13,0,6,0,0,0,0,0,0,0,0,0,56010
18824,5724,270,1989,1958,1204,303,342,203,133,52,5,76,70,35,35,0,0,35,15,1,19,139,128,82,19,27,11,11,8,3,0,0,0,0,0,56011
18825,3122,252,1304,992,420,154,213,131,114,47,4,63,17,14,14,0,0,3,0,0,3,82,82,54,0,28,0,0,0,0,0,0,0,0,0,56013
18826,498,37,183,192,66,20,30,11,10,3,0,7,1,1,1,0,0,0,0,0,0,19,19,4,0,15,0,0,0,0,0,0,0,0,0,56014
18827,615,37,217,276,43,42,39,12,12,7,0,5,0,0,0,0,0,0,0,0,0,27,27,23,0,4,0,0,0,0,0,0,0,0,0,56016
18828,1146,59,448,439,143,57,84,39,39,23,0,16,0,0,0,0,0,0,0,0,0,45,45,17,10,18,0,0,0,0,0,0,0,0,0,56017
18829,691,76,296,227,74,18,56,25,23,5,0,18,2,2,2,0,0,0,0,0,0,31,31,15,2,14,0,0,0,0,0,0,0,0,0,56019
18830,81,4,28,39,9,1,3,0,0,0,0,0,0,0,0,0,0,0,0,0,0,3,3,0,0,3,0,0,0,0,0,0,0,0,0,56020
18831,750,48,285,206,163,48,43,25,25,22,0,3,0,0,0,0,0,0,0,0,0,18,10,8,0,2,8,8,8,0,0,0,0,0,0,56021
18832,52,32,12,5,2,1,4,0,0,0,0,0,0,0,0,0,0,0,0,0,0,4,3,0,3,0,1,1,0,0,1,0,0,0,0,56022
18833,411,30,162,153,54,12,24,14,12,6,3,3,2,0,0,0,0,2,2,0,0,10,10,10,0,0,0,0,0,0,0,0,0,0,0,56023
18834,1761,113,518,628,427,75,114,61,61,42,0,19,0,0,0,0,0,0,0,0,0,53,53,14,0,39,0,0,0,0,0,0,0,0,0,56024
18835,363,15,125,128,73,22,19,5,5,3,0,2,0,0,0,0,0,0,0,0,0,14,14,5,0,9,0,0,0,0,0,0,0,0,0,56025
18836,1297,82,519,477,182,37,78,27,27,15,2,10,0,0,0,0,0,0,0,0,0,51,47,15,7,25,4,4,4,0,0,0,0,0,0,56026
18837,658,111,250,198,92,7,60,41,41,3,0,38,0,0,0,0,0,0,0,0,0,19,13,8,0,5,6,6,6,0,0,0,0,0,0,56027
18838,902,55,313,296,119,119,36,11,11,7,0,4,0,0,0,0,0,0,0,0,0,25,25,10,9,6,0,0,0,0,0,0,0,0,0,56028
18839,505,34,173,216,57,25,25,12,12,0,1,11,0,0,0,0,0,0,0,0,0,13,13,6,0,7,0,0,0,0,0,0,0,0,0,56029
18840,8918,1151,3225,2711,1401,430,562,242,228,110,23,95,14,13,8,5,0,1,1,0,0,320,289,173,0,116,31,31,31,0,0,0,0,0,0,56031
18841,216,8,80,97,25,6,14,4,4,4,0,0,0,0,0,0,0,0,0,0,0,10,10,5,4,1,0,0,0,0,0,0,0,0,0,56032
18842,267,31,86,128,19,3,25,8,8,5,0,3,0,0,0,0,0,0,0,0,0,17,7,2,0,5,10,10,10,0,0,0,0,0,0,56033
18843,414,28,150,144,52,40,43,27,18,14,0,4,9,9,5,4,0,0,0,0,0,16,16,4,7,5,0,0,0,0,0,0,0,0,0,56034
18844,350,14,189,121,18,8,12,5,5,3,0,2,0,0,0,0,0,0,0,0,0,7,7,7,0,0,0,0,0,0,0,0,0,0,0,56035
18845,1410,130,638,503,91,48,92,37,32,10,0,22,5,4,4,0,0,1,0,0,1,55,55,19,9,27,0,0,0,0,0,0,0,0,0,56036
18846,1086,60,395,377,181,73,73,34,34,20,0,14,0,0,0,0,0,0,0,0,0,39,35,14,7,14,4,2,0,2,0,2,2,0,0,56037
18847,638,45,239,264,79,11,45,26,26,15,0,11,0,0,0,0,0,0,0,0,0,19,13,6,1,6,6,2,0,0,2,4,4,0,0,56039
18848,707,43,313,197,125,29,53,14,14,8,2,4,0,0,0,0,0,0,0,0,0,39,37,14,0,23,2,2,2,0,0,0,0,0,0,56041
18849,494,50,186,187,45,26,28,18,18,14,2,2,0,0,0,0,0,0,0,0,0,10,10,6,0,4,0,0,0,0,0,0,0,0,0,56042
18850,348,39,134,123,39,13,17,9,7,1,0,6,2,0,0,0,0,2,2,0,0,8,8,0,0,8,0,0,0,0,0,0,0,0,0,56043
18851,1498,122,642,490,172,72,151,84,74,29,4,41,10,10,10,0,0,0,0,0,0,67,62,46,0,16,5,5,1,0,4,0,0,0,0,56044
18852,541,69,188,205,60,19,50,28,26,2,3,21,2,2,2,0,0,0,0,0,0,22,22,21,0,1,0,0,0,0,0,0,0,0,0,56045
18853,48,5,21,19,0,3,0,0,0,0,0,0,0,0,0,0,0,0,0,0,0,0,0,0,0,0,0,0,0,0,0,0,0,0,0,56046
18854,105,7,47,36,4,11,14,11,10,8,0,2,1,0,0,0,0,1,0,1,0,3,3,1,0,2,0,0,0,0,0,0,0,0,0,56047
18855,2470,207,868,901,346,148,203,121,98,32,5,61,23,9,5,0,4,14,11,0,3,82,81,56,12,13,1,1,0,0,1,0,0,0,0,56048
18856,1109,78,448,412,147,24,71,26,22,5,17,0,4,4,4,0,0,0,0,0,0,45,45,26,3,16,0,0,0,0,0,0,0,0,0,56050
18857,552,44,250,181,67,10,44,22,13,8,0,5,9,0,0,0,0,9,6,0,3,22,22,12,8,2,0,0,0,0,0,0,0,0,0,56051
18858,555,39,258,194,54,10,33,9,4,4,0,0,5,5,0,5,0,0,0,0,0,24,22,7,0,15,2,2,0,2,0,0,0,0,0,56052
18859,647,62,261,219,79,26,36,14,14,5,1,8,0,0,0,0,0,0,0,0,0,22,22,13,0,9,0,0,0,0,0,0,0,0,0,56054
18860,2614,98,970,979,493,74,197,97,91,12,8,71,6,6,6,0,0,0,0,0,0,100,76,48,0,28,24,24,24,0,0,0,0,0,0,56055
18861,49,0,23,13,9,4,0,0,0,0,0,0,0,0,0,0,0,0,0,0,0,0,0,0,0,0,0,0,0,0,0,0,0,0,0,56056
18862,2663,316,1098,867,314,68,165,72,58,22,0,36,14,14,8,0,6,0,0,0,0,93,72,41,0,31,21,6,0,0,6,15,0,15,0,56057
18863,4020,490,1321,1222,755,232,269,145,141,76,19,46,4,4,2,2,0,0,0,0,0,124,122,36,9,77,2,2,2,0,0,0,0,0,0,56058
18864,334,26,175,100,20,13,24,15,7,2,0,5,8,6,0,4,2,2,2,0,0,9,9,2,0,7,0,0,0,0,0,0,0,0,0,56060
18865,2127,249,885,631,279,83,172,75,63,14,5,44,12,12,4,8,0,0,0,0,0,97,77,30,5,42,20,2,2,0,0,18,0,7,11,56062
18866,2041,102,630,638,467,204,98,42,38,10,4,24,4,4,4,0,0,0,0,0,0,56,49,29,0,20,7,7,7,0,0,0,0,0,0,56063
18867,1871,159,727,624,281,80,140,89,89,26,0,63,0,0,0,0,0,0,0,0,0,51,49,18,6,25,2,2,2,0,0,0,0,0,0,56065
18868,767,70,319,272,86,20,35,19,19,7,4,8,0,0,0,0,0,0,0,0,0,16,16,7,3,6,0,0,0,0,0,0,0,0,0,56068
18869,2934,400,1145,895,411,83,222,124,87,54,4,29,37,22,10,0,12,15,9,4,2,98,78,4,10,64,20,20,20,0,0,0,0,0,0,56069
18870,7610,544,2320,2393,1541,812,693,334,262,126,24,112,72,59,39,18,2,13,7,0,6,359,346,188,43,115,13,13,3,0,10,0,0,0,0,56071
18871,1462,170,550,510,190,42,93,41,32,12,0,20,9,9,4,5,0,0,0,0,0,52,45,26,3,16,7,1,0,0,1,6,0,6,0,56072
18872,11395,898,4247,3529,1757,964,994,558,497,294,31,172,61,46,4,0,42,15,1,10,4,436,414,309,24,81,22,10,8,0,2,12,12,0,0,56073
18873,1447,101,606,508,176,56,98,65,43,8,8,27,22,22,13,0,9,0,0,0,0,33,27,8,6,13,6,4,4,0,0,2,0,0,2,56074
18874,135,9,55,62,9,0,21,15,15,0,0,15,0,0,0,0,0,0,0,0,0,6,6,0,0,6,0,0,0,0,0,0,0,0,0,56075
18875,325,16,136,140,28,5,25,22,9,4,0,5,13,13,0,0,13,0,0,0,0,3,3,1,0,2,0,0,0,0,0,0,0,0,0,56078
18876,358,15,131,135,70,7,57,31,29,22,0,7,2,0,0,0,0,2,2,0,0,26,24,13,0,11,2,2,0,2,0,0,0,0,0,56080
18877,4070,738,1479,1178,488,187,250,131,99,60,0,39,32,30,25,5,0,2,2,0,0,119,99,63,2,34,20,13,11,0,2,7,7,0,0,56081
18878,7595,715,2031,2338,1650,861,1615,679,634,298,48,288,45,44,44,0,0,1,0,0,1,936,912,590,9,313,24,2,2,0,0,22,0,22,0,56082
18879,635,65,280,215,63,12,67,18,18,8,0,10,0,0,0,0,0,0,0,0,0,49,49,29,0,20,0,0,0,0,0,0,0,0,0,56083
18880,3587,423,1507,1106,414,137,252,135,122,33,2,87,13,13,11,2,0,0,0,0,0,117,115,43,8,64,2,0,0,0,0,2,0,0,2,56085
18881,2252,308,839,773,274,58,136,56,47,18,0,29,9,9,0,9,0,0,0,0,0,80,73,25,0,48,7,0,0,0,0,7,2,0,5,56087
18882,1379,152,513,474,201,39,120,79,66,41,0,25,13,13,11,2,0,0,0,0,0,41,39,19,0,20,2,2,2,0,0,0,0,0,0,56088
18883,129,12,50,61,6,0,23,15,15,13,0,2,0,0,0,0,0,0,0,0,0,8,2,2,0,0,6,0,0,0,0,6,6,0,0,56089
18884,518,48,222,175,50,23,39,12,8,4,0,4,4,2,0,2,0,2,0,0,2,27,26,8,2,16,1,1,0,1,0,0,0,0,0,56090
18885,205,27,92,58,23,5,5,4,4,3,0,1,0,0,0,0,0,0,0,0,0,1,1,0,0,1,0,0,0,0,0,0,0,0,0,56091
18886,9365,734,3520,3299,1336,476,653,316,251,127,16,108,65,14,14,0,0,51,1,35,15,337,290,142,13,135,47,36,24,0,12,11,11,0,0,56093
18887,2209,199,893,690,301,126,129,71,64,28,2,34,7,5,2,0,3,2,0,0,2,58,54,27,17,10,4,4,4,0,0,0,0,0,0,56096
18888,2618,339,1051,796,344,88,236,109,105,33,4,68,4,0,0,0,0,4,4,0,0,127,95,29,0,66,32,21,21,0,0,11,11,0,0,56097
18889,1536,159,620,494,214,49,70,40,36,6,3,27,4,2,2,0,0,2,2,0,0,30,28,25,0,3,2,2,0,0,2,0,0,0,0,56098
18890,4195,406,1597,1393,484,315,273,108,92,35,0,57,16,16,16,0,0,0,0,0,0,165,160,88,1,71,5,4,4,0,0,1,0,1,0,56101
18891,1358,155,553,515,115,20,107,60,60,29,0,31,0,0,0,0,0,0,0,0,0,47,31,5,1,25,16,8,0,3,5,8,7,0,1,56110
18892,298,7,145,118,20,8,20,5,3,2,0,1,2,2,2,0,0,0,0,0,0,15,15,15,0,0,0,0,0,0,0,0,0,0,0,56111
18893,177,19,81,44,30,3,4,4,4,0,0,4,0,0,0,0,0,0,0,0,0,0,0,0,0,0,0,0,0,0,0,0,0,0,0,56113
18894,283,18,129,101,25,10,6,1,1,1,0,0,0,0,0,0,0,0,0,0,0,5,5,5,0,0,0,0,0,0,0,0,0,0,0,56114
18895,873,59,326,333,120,35,40,18,16,9,2,5,2,1,1,0,0,1,1,0,0,22,20,8,2,10,2,2,2,0,0,0,0,0,0,56115
18896,406,49,127,142,66,22,27,14,14,4,0,10,0,0,0,0,0,0,0,0,0,13,11,5,0,6,2,2,0,0,2,0,0,0,0,56116
18897,289,71,98,91,24,5,11,4,4,2,0,2,0,0,0,0,0,0,0,0,0,7,7,2,2,3,0,0,0,0,0,0,0,0,0,56117
18898,277,20,110,101,33,13,22,17,17,0,0,17,0,0,0,0,0,0,0,0,0,5,5,3,0,2,0,0,0,0,0,0,0,0,0,56118
18899,720,113,231,269,90,17,111,63,53,32,11,10,10,7,2,0,5,3,0,0,3,48,33,15,0,18,15,15,12,3,0,0,0,0,0,56119
18900,798,127,329,241,76,25,36,21,21,13,0,8,0,0,0,0,0,0,0,0,0,15,7,2,2,3,8,8,0,0,8,0,0,0,0,56120
18901,458,57,158,178,53,12,28,20,20,10,0,10,0,0,0,0,0,0,0,0,0,8,6,3,0,3,2,0,0,0,0,2,0,2,0,56121
18902,376,46,158,113,41,18,30,18,18,13,0,5,0,0,0,0,0,0,0,0,0,12,12,9,0,3,0,0,0,0,0,0,0,0,0,56122
18903,357,38,159,123,30,7,11,9,9,5,0,4,0,0,0,0,0,0,0,0,0,2,2,2,0,0,0,0,0,0,0,0,0,0,0,56123
18904,61,7,21,25,4,4,0,0,0,0,0,0,0,0,0,0,0,0,0,0,0,0,0,0,0,0,0,0,0,0,0,0,0,0,0,56125
18905,331,17,148,126,31,9,28,20,17,4,0,13,3,0,0,0,0,3,0,3,0,8,8,3,0,5,0,0,0,0,0,0,0,0,0,56127
18906,1434,267,445,448,180,94,88,65,64,30,13,21,1,1,1,0,0,0,0,0,0,23,22,15,0,7,1,1,1,0,0,0,0,0,0,56128
18907,527,57,213,209,36,12,49,31,29,16,0,13,2,2,0,0,2,0,0,0,0,18,16,13,0,3,2,0,0,0,0,2,0,0,2,56129
18908,1670,176,774,516,141,63,158,82,74,16,4,54,8,8,6,0,2,0,0,0,0,76,76,45,5,26,0,0,0,0,0,0,0,0,0,56131
18909,387,39,169,105,52,22,32,11,8,3,0,5,3,3,2,0,1,0,0,0,0,21,21,13,0,8,0,0,0,0,0,0,0,0,0,56132
18910,281,43,99,84,50,5,32,23,23,13,0,10,0,0,0,0,0,0,0,0,0,9,9,5,0,4,0,0,0,0,0,0,0,0,0,56134
18911,768,73,328,219,124,24,68,36,36,25,0,11,0,0,0,0,0,0,0,0,0,32,32,24,0,8,0,0,0,0,0,0,0,0,0,56136
18912,735,49,244,318,111,13,62,31,26,12,0,14,5,3,0,0,3,2,2,0,0,31,31,20,0,11,0,0,0,0,0,0,0,0,0,56137
18913,594,60,255,190,78,11,50,20,16,8,2,6,4,0,0,0,0,4,0,0,4,30,26,19,0,7,4,4,0,0,4,0,0,0,0,56138
18914,309,40,150,82,25,12,15,9,9,2,1,6,0,0,0,0,0,0,0,0,0,6,6,0,0,6,0,0,0,0,0,0,0,0,0,56139
18915,39,7,23,2,5,2,2,0,0,0,0,0,0,0,0,0,0,0,0,0,0,2,2,2,0,0,0,0,0,0,0,0,0,0,0,56140
18916,227,33,95,77,16,6,30,6,6,0,0,6,0,0,0,0,0,0,0,0,0,24,24,19,1,4,0,0,0,0,0,0,0,0,0,56141
18917,728,111,303,206,95,13,51,30,19,17,0,2,11,11,11,0,0,0,0,0,0,21,13,10,0,3,8,8,8,0,0,0,0,0,0,56142
18918,3273,339,1061,1235,472,166,213,95,88,53,0,35,7,7,2,0,5,0,0,0,0,118,118,85,0,33,0,0,0,0,0,0,0,0,0,56143
18919,736,109,295,214,94,24,58,27,27,9,2,16,0,0,0,0,0,0,0,0,0,31,28,21,2,5,3,3,0,3,0,0,0,0,0,56144
18920,378,41,168,135,27,7,34,24,16,2,0,14,8,8,4,4,0,0,0,0,0,10,8,1,0,7,2,2,0,2,0,0,0,0,0,56145
18921,35,0,18,12,5,0,2,0,0,0,0,0,0,0,0,0,0,0,0,0,0,2,2,2,0,0,0,0,0,0,0,0,0,0,0,56146
18922,96,5,44,46,1,0,12,4,4,0,0,4,0,0,0,0,0,0,0,0,0,8,8,4,0,4,0,0,0,0,0,0,0,0,0,56147
18923,915,42,391,301,139,42,39,25,21,15,2,4,4,4,4,0,0,0,0,0,0,14,14,7,0,7,0,0,0,0,0,0,0,0,0,56149
18924,1849,119,724,683,262,61,149,101,74,27,0,47,27,3,3,0,0,24,0,24,0,48,48,31,6,11,0,0,0,0,0,0,0,0,0,56150
18925,590,51,263,194,71,11,33,21,20,6,0,14,1,1,1,0,0,0,0,0,0,12,12,12,0,0,0,0,0,0,0,0,0,0,0,56151
18926,1137,157,493,354,115,18,80,35,35,8,0,27,0,0,0,0,0,0,0,0,0,45,42,17,6,19,3,3,3,0,0,0,0,0,0,56152
18927,114,21,48,31,7,7,8,2,2,2,0,0,0,0,0,0,0,0,0,0,0,6,6,4,0,2,0,0,0,0,0,0,0,0,0,56153
18928,328,21,136,138,25,8,29,17,17,8,0,9,0,0,0,0,0,0,0,0,0,12,12,7,0,5,0,0,0,0,0,0,0,0,0,56155
18929,4219,413,1669,1333,576,228,263,123,122,74,27,21,1,0,0,0,0,1,1,0,0,140,129,70,0,59,11,0,0,0,0,11,0,0,11,56156
18930,513,50,206,133,85,39,39,27,26,7,1,18,1,1,1,0,0,0,0,0,0,12,12,8,0,4,0,0,0,0,0,0,0,0,0,56157
18931,324,49,153,93,9,20,50,33,19,2,0,17,14,11,6,5,0,3,1,0,2,17,17,11,0,6,0,0,0,0,0,0,0,0,0,56158
18932,1886,326,712,572,211,65,155,54,48,16,0,32,6,0,0,0,0,6,5,0,1,101,85,79,0,6,16,9,9,0,0,7,0,0,7,56159
18933,132,17,43,45,23,4,6,0,0,0,0,0,0,0,0,0,0,0,0,0,0,6,6,5,0,1,0,0,0,0,0,0,0,0,0,56160
18934,253,9,79,128,29,8,8,7,7,5,0,2,0,0,0,0,0,0,0,0,0,1,1,0,0,1,0,0,0,0,0,0,0,0,0,56161
18935,251,30,116,86,18,1,10,5,5,0,0,5,0,0,0,0,0,0,0,0,0,5,5,2,0,3,0,0,0,0,0,0,0,0,0,56162
18936,4071,510,1403,1493,457,208,341,165,142,64,15,63,23,8,2,6,0,15,0,0,15,176,134,55,1,78,42,38,27,11,0,4,4,0,0,56164
18937,257,26,101,97,23,10,17,6,6,2,0,4,0,0,0,0,0,0,0,0,0,11,11,4,0,7,0,0,0,0,0,0,0,0,0,56165
18938,187,24,81,45,34,3,9,6,6,4,0,2,0,0,0,0,0,0,0,0,0,3,3,0,0,3,0,0,0,0,0,0,0,0,0,56166
18939,481,37,184,191,48,21,24,8,3,2,0,1,5,0,0,0,0,5,1,0,4,16,12,3,0,9,4,2,2,0,0,2,0,0,2,56167
18940,640,90,265,202,50,33,39,24,23,7,1,15,1,1,0,1,0,0,0,0,0,15,13,2,0,11,2,2,2,0,0,0,0,0,0,56168
18941,528,42,230,187,54,15,34,22,19,13,0,6,3,2,1,1,0,1,1,0,0,12,10,5,0,5,2,2,0,2,0,0,0,0,0,56169
18942,385,47,188,96,46,8,34,11,11,5,0,6,0,0,0,0,0,0,0,0,0,23,23,13,0,10,0,0,0,0,0,0,0,0,0,56170
18943,1203,88,507,393,170,45,71,40,22,6,0,16,18,18,14,0,4,0,0,0,0,31,31,18,2,11,0,0,0,0,0,0,0,0,0,56171
18944,2296,233,811,753,357,142,141,78,35,18,5,12,43,14,5,2,7,29,29,0,0,63,45,31,0,14,18,18,18,0,0,0,0,0,0,56172
18945,265,14,117,102,22,10,49,26,26,9,4,13,0,0,0,0,0,0,0,0,0,23,21,6,0,15,2,2,2,0,0,0,0,0,0,56173
18946,256,25,102,77,45,7,17,12,12,3,0,9,0,0,0,0,0,0,0,0,0,5,5,1,0,4,0,0,0,0,0,0,0,0,0,56174
18947,2094,257,831,642,309,55,179,91,67,10,24,33,24,24,15,9,0,0,0,0,0,88,80,52,16,12,8,8,3,0,5,0,0,0,0,56175
18948,750,77,266,259,116,32,51,26,18,10,3,5,8,2,0,2,0,6,2,0,4,25,25,8,3,14,0,0,0,0,0,0,0,0,0,56176
18949,32,4,3,15,10,0,1,0,0,0,0,0,0,0,0,0,0,0,0,0,0,1,1,0,0,1,0,0,0,0,0,0,0,0,0,56177
18950,1196,88,435,409,217,47,68,39,39,22,4,13,0,0,0,0,0,0,0,0,0,29,29,22,3,4,0,0,0,0,0,0,0,0,0,56178
18951,838,159,330,191,119,39,73,36,26,2,3,21,10,8,5,3,0,2,2,0,0,37,22,4,2,16,15,11,11,0,0,4,0,0,4,56180
18952,780,88,359,254,57,22,42,18,17,11,0,6,1,1,0,1,0,0,0,0,0,24,15,7,0,8,9,9,9,0,0,0,0,0,0,56181
18953,884,119,315,302,103,45,78,34,33,8,1,24,1,1,1,0,0,0,0,0,0,44,27,8,0,19,17,10,3,7,0,7,7,0,0,56183
18954,364,45,131,147,31,10,18,14,14,8,0,6,0,0,0,0,0,0,0,0,0,4,3,2,0,1,1,1,1,0,0,0,0,0,0,56185
18955,221,23,89,89,11,9,12,4,3,0,0,3,1,0,0,0,0,1,0,0,1,8,4,2,0,2,4,4,4,0,0,0,0,0,0,56186
18956,8772,2322,2538,2493,1013,406,864,481,304,56,59,189,177,27,11,0,16,150,85,65,0,383,310,159,11,140,73,49,24,0,25,24,0,0,24,56187
18957,14821,2254,4173,5338,2071,985,1240,756,647,228,65,354,109,80,61,19,0,29,14,0,15,484,390,197,28,165,94,51,51,0,0,43,8,0,35,56201
18958,160,17,61,63,13,6,16,10,10,4,1,5,0,0,0,0,0,0,0,0,0,6,6,0,0,6,0,0,0,0,0,0,0,0,0,56207
18959,1548,169,615,498,200,66,120,55,35,11,0,24,20,0,0,0,0,20,20,0,0,65,28,14,7,7,37,37,37,0,0,0,0,0,0,56208
18960,1571,121,582,631,192,45,69,35,26,15,0,11,9,6,3,3,0,3,0,0,3,34,34,7,3,24,0,0,0,0,0,0,0,0,0,56209
18961,14,0,3,7,4,0,0,0,0,0,0,0,0,0,0,0,0,0,0,0,0,0,0,0,0,0,0,0,0,0,0,0,0,0,0,56210
18962,336,29,157,122,22,6,22,12,5,0,0,5,7,7,7,0,0,0,0,0,0,10,7,5,0,2,3,3,3,0,0,0,0,0,0,56211
18963,385,52,175,115,29,14,28,21,21,9,0,12,0,0,0,0,0,0,0,0,0,7,7,2,0,5,0,0,0,0,0,0,0,0,0,56212
18964,482,58,175,200,37,12,40,27,15,7,0,8,12,12,12,0,0,0,0,0,0,13,13,4,0,9,0,0,0,0,0,0,0,0,0,56214
18965,3181,400,1150,977,445,209,203,119,117,70,15,32,2,2,2,0,0,0,0,0,0,84,84,15,27,42,0,0,0,0,0,0,0,0,0,56215
18966,438,43,138,188,55,14,46,35,29,24,0,5,6,6,0,6,0,0,0,0,0,11,9,2,0,7,2,2,1,1,0,0,0,0,0,56216
18967,370,56,140,108,56,10,33,8,8,1,0,7,0,0,0,0,0,0,0,0,0,25,25,17,0,8,0,0,0,0,0,0,0,0,0,56218
18968,618,54,237,231,76,20,58,14,14,0,0,14,0,0,0,0,0,0,0,0,0,44,33,7,0,26,11,5,0,0,5,6,0,0,6,56219
18969,2153,305,808,682,270,88,191,97,62,24,17,21,35,23,0,23,0,12,0,12,0,94,89,66,0,23,5,5,2,3,0,0,0,0,0,56220
18970,551,62,182,186,106,15,57,38,38,22,0,16,0,0,0,0,0,0,0,0,0,19,17,2,0,15,2,2,0,0,2,0,0,0,0,56221
18971,1326,163,540,451,152,20,82,50,48,12,0,36,2,0,0,0,0,2,2,0,0,32,28,9,5,14,4,4,0,0,4,0,0,0,0,56222
18972,918,71,383,341,95,28,62,31,31,27,0,4,0,0,0,0,0,0,0,0,0,31,31,19,0,12,0,0,0,0,0,0,0,0,0,56223
18973,248,35,114,84,14,1,15,8,8,0,0,8,0,0,0,0,0,0,0,0,0,7,7,2,0,5,0,0,0,0,0,0,0,0,0,56224
18974,511,66,213,167,52,13,27,20,12,6,0,6,8,8,8,0,0,0,0,0,0,7,4,2,0,2,3,0,0,0,0,3,3,0,0,56225
18975,218,38,88,68,24,0,16,13,9,9,0,0,4,4,4,0,0,0,0,0,0,3,3,3,0,0,0,0,0,0,0,0,0,0,0,56226
18976,169,11,82,62,14,0,6,5,5,5,0,0,0,0,0,0,0,0,0,0,0,1,1,1,0,0,0,0,0,0,0,0,0,0,0,56227
18977,735,69,313,282,53,18,22,9,5,1,0,4,4,4,0,0,4,0,0,0,0,13,11,4,1,6,2,2,2,0,0,0,0,0,0,56228
18978,1174,50,495,337,213,79,99,55,41,5,1,35,14,12,11,0,1,2,0,0,2,44,44,14,1,29,0,0,0,0,0,0,0,0,0,56229
18979,560,46,223,211,58,22,58,14,14,10,0,4,0,0,0,0,0,0,0,0,0,44,43,6,0,37,1,0,0,0,0,1,0,0,1,56230
18980,303,27,157,85,24,10,20,13,13,6,0,7,0,0,0,0,0,0,0,0,0,7,7,2,0,5,0,0,0,0,0,0,0,0,0,56231
18981,1762,128,668,607,288,71,136,53,47,12,0,35,6,0,0,0,0,6,6,0,0,83,69,45,0,24,14,14,14,0,0,0,0,0,0,56232
18982,368,32,138,127,56,15,24,11,11,8,0,3,0,0,0,0,0,0,0,0,0,13,13,7,2,4,0,0,0,0,0,0,0,0,0,56235
18983,226,12,97,86,30,1,27,12,12,8,0,4,0,0,0,0,0,0,0,0,0,15,15,4,0,11,0,0,0,0,0,0,0,0,0,56236
18984,409,37,163,145,50,14,51,32,30,16,0,14,2,0,0,0,0,2,0,0,2,19,16,7,0,9,3,1,1,0,0,2,2,0,0,56237
18985,360,22,101,161,60,16,26,13,13,9,0,4,0,0,0,0,0,0,0,0,0,13,13,6,0,7,0,0,0,0,0,0,0,0,0,56239
18986,657,70,254,254,60,19,41,26,20,9,0,11,6,0,0,0,0,6,5,0,1,15,9,5,0,4,6,0,0,0,0,6,0,0,6,56240
18987,2911,211,1172,987,423,118,155,100,100,43,0,57,0,0,0,0,0,0,0,0,0,55,46,22,0,24,9,9,7,0,2,0,0,0,0,56241
18988,1103,84,516,389,76,38,95,49,41,23,0,18,8,3,0,0,3,5,1,0,4,46,42,12,8,22,4,1,1,0,0,3,3,0,0,56243
18989,888,82,267,371,121,47,51,26,23,13,0,10,3,0,0,0,0,3,3,0,0,25,15,6,2,7,10,8,4,4,0,2,2,0,0,56244
18990,346,39,141,103,52,11,37,29,26,8,0,18,3,0,0,0,0,3,3,0,0,8,8,6,0,2,0,0,0,0,0,0,0,0,0,56245
18991,584,55,227,202,76,24,27,13,13,5,0,8,0,0,0,0,0,0,0,0,0,14,14,10,0,4,0,0,0,0,0,0,0,0,0,56248
18992,233,15,138,55,20,5,23,10,10,0,0,10,0,0,0,0,0,0,0,0,0,13,12,4,0,8,1,0,0,0,0,1,0,0,1,56249
18993,691,37,231,319,80,24,54,33,30,9,0,21,3,3,3,0,0,0,0,0,0,21,19,10,0,9,2,2,2,0,0,0,0,0,0,56251
18994,768,70,281,298,84,35,64,42,32,20,0,12,10,10,0,9,1,0,0,0,0,22,22,10,0,12,0,0,0,0,0,0,0,0,0,56252
18995,687,68,273,262,73,11,84,45,28,14,0,14,17,8,8,0,0,9,0,1,8,39,33,22,5,6,6,0,0,0,0,6,0,0,6,56253
18996,221,15,94,79,28,5,14,6,6,2,0,4,0,0,0,0,0,0,0,0,0,8,8,6,0,2,0,0,0,0,0,0,0,0,0,56255
18997,1912,196,706,705,228,77,102,70,55,27,2,26,15,9,8,0,1,6,2,0,4,32,32,13,0,19,0,0,0,0,0,0,0,0,0,56256
18998,374,28,150,159,35,2,41,9,9,0,0,9,0,0,0,0,0,0,0,0,0,32,30,1,0,29,2,2,2,0,0,0,0,0,0,56257
18999,9371,715,2884,2750,2154,868,1136,499,459,159,21,279,40,34,34,0,0,6,6,0,0,637,576,344,36,196,61,52,21,16,15,9,1,0,8,56258
19000,631,85,264,199,56,27,40,19,17,10,0,7,2,2,2,0,0,0,0,0,0,21,18,4,0,14,3,0,0,0,0,3,0,0,3,56260
19001,519,45,189,171,76,38,41,5,5,2,0,3,0,0,0,0,0,0,0,0,0,36,34,12,0,22,2,2,2,0,0,0,0,0,0,56262
19002,336,14,136,141,42,3,16,9,7,2,0,5,2,2,2,0,0,0,0,0,0,7,7,2,0,5,0,0,0,0,0,0,0,0,0,56263
19003,1558,162,553,513,266,64,77,46,46,10,5,31,0,0,0,0,0,0,0,0,0,31,31,26,0,5,0,0,0,0,0,0,0,0,0,56264
19004,5342,672,1680,1961,776,253,408,222,206,102,24,80,16,16,11,5,0,0,0,0,0,186,178,72,0,106,8,8,0,8,0,0,0,0,0,56265
19005,1060,110,426,343,160,21,102,56,41,24,0,17,15,15,0,0,15,0,0,0,0,46,37,5,5,27,9,9,6,0,3,0,0,0,0,56266
19006,3931,298,1129,1268,819,417,745,330,324,142,82,100,6,6,6,0,0,0,0,0,0,415,415,158,50,207,0,0,0,0,0,0,0,0,0,56267
19007,537,95,204,167,60,11,88,62,44,1,0,43,18,13,1,0,12,5,0,0,5,26,18,8,0,10,8,0,0,0,0,8,0,0,8,56270
19008,830,78,316,332,87,17,62,23,22,12,2,8,1,1,0,1,0,0,0,0,0,39,30,11,3,16,9,9,7,0,2,0,0,0,0,56271
19009,3427,317,1032,1277,635,166,230,123,104,30,4,70,19,19,11,0,8,0,0,0,0,107,103,80,13,10,4,4,3,1,0,0,0,0,0,56273
19010,106,19,19,50,16,2,3,3,3,0,0,3,0,0,0,0,0,0,0,0,0,0,0,0,0,0,0,0,0,0,0,0,0,0,0,56274
19011,239,20,115,75,28,1,16,13,13,10,0,3,0,0,0,0,0,0,0,0,0,3,3,1,0,2,0,0,0,0,0,0,0,0,0,56276
19012,2081,197,779,753,275,77,157,92,85,36,0,49,7,2,2,0,0,5,0,0,5,65,62,41,0,21,3,3,3,0,0,0,0,0,0,56277
19013,2083,177,859,577,343,127,122,57,45,18,0,27,12,12,12,0,0,0,0,0,0,65,65,7,9,49,0,0,0,0,0,0,0,0,0,56278
19014,884,74,259,426,90,35,65,32,30,13,0,17,2,2,0,2,0,0,0,0,0,33,33,23,0,10,0,0,0,0,0,0,0,0,0,56279
19015,405,20,192,120,53,20,38,24,24,10,0,14,0,0,0,0,0,0,0,0,0,14,14,8,0,6,0,0,0,0,0,0,0,0,0,56280
19016,403,40,98,165,76,24,13,5,5,2,0,3,0,0,0,0,0,0,0,0,0,8,8,5,0,3,0,0,0,0,0,0,0,0,0,56281
19017,958,81,328,411,117,21,110,69,64,22,0,42,5,5,5,0,0,0,0,0,0,41,28,5,3,20,13,13,13,0,0,0,0,0,0,56282
19018,4659,426,1652,1707,612,262,310,149,137,58,5,74,12,8,7,0,1,4,0,0,4,161,138,65,9,64,23,23,23,0,0,0,0,0,0,56283
19019,1470,191,569,490,193,27,107,67,52,15,12,25,15,8,4,0,4,7,0,3,4,40,38,23,0,15,2,2,0,0,2,0,0,0,0,56284
19020,772,62,306,268,115,21,57,21,21,15,0,6,0,0,0,0,0,0,0,0,0,36,26,5,0,21,10,10,0,0,10,0,0,0,0,56285
19021,56,4,36,13,3,0,11,11,11,6,5,0,0,0,0,0,0,0,0,0,0,0,0,0,0,0,0,0,0,0,0,0,0,0,0,56287
19022,3500,140,987,1347,664,362,210,111,94,38,22,34,17,17,14,3,0,0,0,0,0,99,78,18,11,49,21,6,6,0,0,15,15,0,0,56288
19023,499,38,194,213,42,12,61,45,45,28,0,17,0,0,0,0,0,0,0,0,0,16,16,1,0,15,0,0,0,0,0,0,0,0,0,56289
19024,348,29,139,126,48,6,21,19,13,2,0,11,6,6,6,0,0,0,0,0,0,2,2,2,0,0,0,0,0,0,0,0,0,0,0,56291
19025,408,44,212,108,37,7,36,18,12,5,2,5,6,6,0,0,6,0,0,0,0,18,13,4,1,8,5,5,2,0,3,0,0,0,0,56292
19026,814,74,304,263,156,17,43,25,24,11,0,13,1,0,0,0,0,1,1,0,0,18,18,6,0,12,0,0,0,0,0,0,0,0,0,56293
19027,57,4,28,18,7,0,0,0,0,0,0,0,0,0,0,0,0,0,0,0,0,0,0,0,0,0,0,0,0,0,0,0,0,0,0,56294
19028,226,35,85,62,40,4,24,7,7,5,0,2,0,0,0,0,0,0,0,0,0,17,15,8,2,5,2,0,0,0,0,2,2,0,0,56295
19029,1518,167,612,488,182,69,117,78,57,21,4,32,21,21,19,0,2,0,0,0,0,39,39,17,3,19,0,0,0,0,0,0,0,0,0,56296
19030,557,26,208,225,75,23,18,12,6,1,0,5,6,6,6,0,0,0,0,0,0,6,6,5,0,1,0,0,0,0,0,0,0,0,0,56297
19031,16299,1053,4187,5563,3571,1925,3701,1744,1591,558,158,875,153,80,48,32,0,73,14,0,59,1957,1866,1028,200,638,91,68,65,0,3,23,9,0,14,56301
19032,17811,1949,4616,6949,2889,1408,981,570,543,279,22,242,27,8,0,0,8,19,19,0,0,411,335,172,32,131,76,61,33,0,28,15,0,3,12,56303
19033,10207,1056,2933,3459,1687,1072,930,480,394,194,66,134,86,16,16,0,0,70,0,0,70,450,402,174,67,161,48,15,8,0,7,33,3,14,16,56304
19034,3433,381,1270,1296,365,121,212,81,69,38,0,31,12,9,9,0,0,3,3,0,0,131,124,77,2,45,7,7,0,0,7,0,0,0,0,56307
19035,16871,1185,4769,6283,3202,1432,1238,654,610,352,110,148,44,30,8,4,18,14,1,0,13,584,543,357,10,176,41,41,21,10,10,0,0,0,0,56308
19036,921,78,284,387,131,41,60,30,20,10,0,10,10,3,3,0,0,7,0,0,7,30,30,8,2,20,0,0,0,0,0,0,0,0,0,56309
19037,3514,253,1293,1294,438,236,253,156,114,38,2,74,42,24,16,0,8,18,0,0,18,97,80,33,11,36,17,5,5,0,0,12,3,9,0,56310
19038,541,67,201,184,60,29,28,7,7,0,0,7,0,0,0,0,0,0,0,0,0,21,10,1,0,9,11,11,8,3,0,0,0,0,0,56311
19039,1583,165,645,588,133,52,128,72,61,39,2,20,11,6,2,2,2,5,1,0,4,56,46,20,2,24,10,3,2,0,1,7,1,4,2,56312
19040,60,16,31,7,6,0,4,1,1,0,1,0,0,0,0,0,0,0,0,0,0,3,3,3,0,0,0,0,0,0,0,0,0,0,0,56313
19041,893,98,397,288,72,38,98,40,23,10,7,6,17,10,4,6,0,7,0,7,0,58,55,32,0,23,3,3,3,0,0,0,0,0,0,56314
19042,1211,87,463,508,103,50,68,41,41,26,0,15,0,0,0,0,0,0,0,0,0,27,27,13,0,14,0,0,0,0,0,0,0,0,0,56315
19043,964,106,398,300,113,47,58,37,28,8,7,13,9,0,0,0,0,9,4,3,2,21,17,5,0,12,4,2,2,0,0,2,0,0,2,56316
19044,853,101,375,269,65,43,40,13,11,7,0,4,2,0,0,0,0,2,0,0,2,27,24,8,0,16,3,3,3,0,0,0,0,0,0,56318
19045,1024,65,266,452,178,63,58,21,19,16,2,1,2,2,2,0,0,0,0,0,0,37,26,9,5,12,11,7,1,6,0,4,0,4,0,56319
19046,5158,427,1765,1740,817,409,370,205,199,83,41,75,6,6,0,5,1,0,0,0,0,165,150,71,0,79,15,10,10,0,0,5,0,0,5,56320
19047,114,0,9,42,10,53,896,845,845,373,6,466,0,0,0,0,0,0,0,0,0,51,51,39,4,8,0,0,0,0,0,0,0,0,0,56321
19048,413,53,193,123,39,5,41,22,16,5,8,3,6,4,4,0,0,2,2,0,0,19,18,10,0,8,1,0,0,0,0,1,1,0,0,56323
19049,812,54,292,309,105,52,60,32,32,15,0,17,0,0,0,0,0,0,0,0,0,28,25,17,4,4,3,3,0,0,3,0,0,0,0,56324
19050,109,28,38,34,9,0,8,6,6,4,0,2,0,0,0,0,0,0,0,0,0,2,2,2,0,0,0,0,0,0,0,0,0,0,0,56325
19051,1098,93,457,442,72,34,49,26,22,9,0,13,4,0,0,0,0,4,0,4,0,23,20,14,0,6,3,3,3,0,0,0,0,0,0,56326
19052,514,37,162,161,113,41,22,6,6,2,2,2,0,0,0,0,0,0,0,0,0,16,16,6,0,10,0,0,0,0,0,0,0,0,0,56327
19053,64,5,35,19,5,0,5,0,0,0,0,0,0,0,0,0,0,0,0,0,0,5,5,2,2,1,0,0,0,0,0,0,0,0,0,56328
19054,4884,565,2019,1707,403,190,402,210,178,77,36,65,32,8,6,0,2,24,1,1,22,192,180,82,15,83,12,12,12,0,0,0,0,0,0,56329
19055,1175,111,472,422,135,35,84,55,53,34,0,19,2,0,0,0,0,2,0,2,0,29,20,7,5,8,9,4,4,0,0,5,0,0,5,56330
19056,1153,125,549,329,116,34,112,59,52,33,0,19,7,7,7,0,0,0,0,0,0,53,50,23,0,27,3,3,0,0,3,0,0,0,0,56331
19057,905,51,326,341,154,33,45,40,40,5,4,31,0,0,0,0,0,0,0,0,0,5,5,0,0,5,0,0,0,0,0,0,0,0,0,56332
19058,3950,234,1320,1428,726,242,219,120,105,43,1,61,15,11,0,11,0,4,4,0,0,99,84,34,1,49,15,15,15,0,0,0,0,0,0,56334
19059,153,18,88,46,0,1,6,2,2,2,0,0,0,0,0,0,0,0,0,0,0,4,4,2,0,2,0,0,0,0,0,0,0,0,0,56335
19060,1168,131,491,353,132,61,95,33,31,12,9,10,2,2,2,0,0,0,0,0,0,62,62,50,0,12,0,0,0,0,0,0,0,0,0,56336
19061,1289,167,605,410,75,32,109,72,67,29,14,24,5,5,2,2,1,0,0,0,0,37,37,22,0,15,0,0,0,0,0,0,0,0,0,56338
19062,769,110,293,248,96,22,38,19,17,4,5,8,2,2,2,0,0,0,0,0,0,19,19,11,0,8,0,0,0,0,0,0,0,0,0,56339
19063,1531,165,686,474,155,51,170,72,55,18,14,23,17,17,13,0,4,0,0,0,0,98,76,36,3,37,22,22,22,0,0,0,0,0,0,56340
19064,2028,238,804,704,190,92,139,78,70,23,16,31,8,4,0,0,4,4,4,0,0,61,61,40,2,19,0,0,0,0,0,0,0,0,0,56342
19065,688,65,226,305,67,25,30,13,10,2,3,5,3,3,2,1,0,0,0,0,0,17,17,10,4,3,0,0,0,0,0,0,0,0,0,56343
19066,10485,1254,3801,3405,1316,709,752,385,297,174,36,87,88,59,35,2,22,29,5,11,13,367,329,168,23,138,38,38,23,3,12,0,0,0,0,56345
19067,4535,815,1678,1362,494,186,404,256,201,49,5,147,55,21,19,2,0,34,34,0,0,148,136,82,6,48,12,12,2,7,3,0,0,0,0,56347
19068,519,32,155,268,57,7,37,19,19,12,1,6,0,0,0,0,0,0,0,0,0,18,15,8,0,7,3,3,3,0,0,0,0,0,0,56349
19069,460,48,223,169,14,6,24,9,9,0,0,9,0,0,0,0,0,0,0,0,0,15,11,7,0,4,4,4,0,0,4,0,0,0,0,56350
19070,3969,857,1396,1157,404,155,269,137,116,84,1,31,21,9,9,0,0,12,6,6,0,132,127,62,16,49,5,5,3,0,2,0,0,0,0,56352
19071,5748,602,1930,2260,640,316,435,247,217,88,5,124,30,27,18,0,9,3,0,0,3,188,145,85,9,51,43,43,27,7,9,0,0,0,0,56353
19072,1016,92,386,349,150,39,61,28,20,8,2,10,8,8,0,8,0,0,0,0,0,33,32,20,0,12,1,0,0,0,0,1,0,1,0,56354
19073,360,24,147,158,21,10,34,21,21,13,0,8,0,0,0,0,0,0,0,0,0,13,13,9,0,4,0,0,0,0,0,0,0,0,0,56355
19074,215,47,115,39,14,0,13,7,7,2,0,5,0,0,0,0,0,0,0,0,0,6,6,0,0,6,0,0,0,0,0,0,0,0,0,56356
19075,685,59,364,205,37,20,30,20,19,7,8,4,1,1,1,0,0,0,0,0,0,10,10,4,4,2,0,0,0,0,0,0,0,0,0,56357
19076,2233,345,882,798,136,72,208,130,115,27,19,69,15,13,3,0,10,2,2,0,0,78,72,34,10,28,6,4,4,0,0,2,0,0,2,56358
19077,2678,431,1041,876,236,94,204,107,95,11,4,80,12,12,11,0,1,0,0,0,0,97,77,20,2,55,20,13,9,0,4,7,1,0,6,56359
19078,2957,260,1112,1154,312,119,182,108,102,32,4,66,6,3,3,0,0,3,0,0,3,74,60,24,3,33,14,11,11,0,0,3,0,3,0,56360
19079,1627,178,744,535,142,28,117,46,46,21,0,25,0,0,0,0,0,0,0,0,0,71,37,17,0,20,34,25,12,0,13,9,0,4,5,56361
19080,4111,465,1516,1354,578,198,235,120,97,56,0,41,23,19,15,4,0,4,0,2,2,115,108,55,0,53,7,2,2,0,0,5,0,0,5,56362
19081,68,10,26,29,3,0,14,6,0,0,0,0,6,6,6,0,0,0,0,0,0,8,1,0,0,1,7,4,0,0,4,3,0,0,3,56363
19082,3374,464,1464,1098,236,112,254,128,119,28,15,76,9,7,3,1,3,2,0,0,2,126,112,63,11,38,14,14,12,2,0,0,0,0,0,56364
19083,4412,268,1337,1921,537,349,237,164,123,33,31,59,41,41,17,20,4,0,0,0,0,73,73,18,6,49,0,0,0,0,0,0,0,0,0,56367
19084,3031,333,1182,1039,376,101,250,168,159,79,12,68,9,6,3,0,3,3,0,0,3,82,71,36,5,30,11,11,8,3,0,0,0,0,0,56368
19085,293,72,138,61,18,4,16,3,3,0,0,3,0,0,0,0,0,0,0,0,0,13,0,0,0,0,13,0,0,0,0,13,0,0,13,56369
19086,101,8,54,39,0,0,2,2,1,0,0,1,1,1,0,1,0,0,0,0,0,0,0,0,0,0,0,0,0,0,0,0,0,0,0,56371
19087,1869,156,718,744,197,54,126,66,52,30,20,2,14,10,10,0,0,4,1,3,0,60,57,24,10,23,3,0,0,0,0,3,0,0,3,56373
19088,4966,276,1430,1827,908,525,1587,385,380,169,48,163,5,5,3,2,0,0,0,0,0,1202,1188,748,109,331,14,14,0,14,0,0,0,0,0,56374
19089,557,43,187,240,65,22,47,25,21,12,0,9,4,4,4,0,0,0,0,0,0,22,22,13,2,7,0,0,0,0,0,0,0,0,0,56375
19090,215,9,107,88,11,0,25,19,19,8,5,6,0,0,0,0,0,0,0,0,0,6,2,1,0,1,4,4,4,0,0,0,0,0,0,56376
19091,11248,600,2342,4072,3009,1225,739,359,303,120,15,168,56,56,48,8,0,0,0,0,0,380,368,194,60,114,12,12,7,0,5,0,0,0,0,56377
19092,5364,517,2110,1860,674,203,372,241,188,89,0,99,53,15,7,8,0,38,36,0,2,131,124,64,0,60,7,2,2,0,0,5,0,0,5,56378
19093,10445,837,2835,4060,1932,781,743,438,373,99,75,199,65,62,56,6,0,3,3,0,0,305,241,121,13,107,64,46,20,9,17,18,0,0,18,56379
19094,1806,220,598,694,219,75,85,40,35,9,9,17,5,2,2,0,0,3,3,0,0,45,36,29,0,7,9,5,0,0,5,4,4,0,0,56381
19095,1042,92,490,351,100,9,108,55,45,20,1,24,10,3,2,0,1,7,0,3,4,53,47,19,0,28,6,6,6,0,0,0,0,0,0,56382
19096,238,38,84,76,34,6,21,15,13,8,5,0,2,2,2,0,0,0,0,0,0,6,4,0,0,4,2,2,2,0,0,0,0,0,0,56384
19097,699,53,265,255,93,33,70,22,18,16,0,2,4,4,0,4,0,0,0,0,0,48,35,22,4,9,13,5,3,2,0,8,8,0,0,56385
19098,606,68,286,180,56,16,16,3,3,0,0,3,0,0,0,0,0,0,0,0,0,13,13,6,0,7,0,0,0,0,0,0,0,0,0,56386
19099,4395,404,1421,1692,539,339,401,182,173,65,95,13,9,0,0,0,0,9,0,0,9,219,157,95,43,19,62,17,17,0,0,45,15,30,0,56387
19100,70,4,20,38,8,0,15,11,11,0,5,6,0,0,0,0,0,0,0,0,0,4,4,2,0,2,0,0,0,0,0,0,0,0,0,56389
19101,19780,1729,6237,7678,2855,1281,1633,864,643,234,72,337,221,180,77,13,90,41,33,0,8,769,721,351,57,313,48,45,32,4,9,3,0,0,3,56401
19102,4770,257,1181,1964,852,516,380,148,96,71,0,25,52,52,34,0,18,0,0,0,0,232,181,119,0,62,51,51,29,22,0,0,0,0,0,56425
19103,7018,632,2813,2352,805,416,318,170,160,79,6,75,10,0,0,0,0,10,5,5,0,148,126,64,0,62,22,22,6,8,8,0,0,0,0,56431
19104,1197,88,415,434,179,81,75,34,25,2,2,21,9,0,0,0,0,9,0,0,9,41,31,12,1,18,10,8,0,8,0,2,2,0,0,56433
19105,152,30,52,60,8,2,19,10,0,0,0,0,10,0,0,0,0,10,10,0,0,9,4,0,0,4,5,0,0,0,0,5,0,0,5,56434
19106,1927,256,804,666,157,44,187,83,52,13,7,32,31,31,28,3,0,0,0,0,0,104,87,61,0,26,17,17,17,0,0,0,0,0,0,56435
19107,43,12,23,8,0,0,0,0,0,0,0,0,0,0,0,0,0,0,0,0,0,0,0,0,0,0,0,0,0,0,0,0,0,0,0,56436
19108,862,129,307,323,91,12,95,48,32,2,0,30,16,5,5,0,0,11,2,0,9,47,40,7,0,33,7,3,3,0,0,4,0,0,4,56437
19109,1974,253,766,681,210,64,163,94,84,24,15,45,10,6,6,0,0,4,3,0,1,69,43,12,1,30,26,6,5,1,0,20,20,0,0,56438
19110,928,165,369,320,50,24,72,36,28,2,4,22,8,3,1,0,2,5,5,0,0,36,22,12,0,10,14,1,1,0,0,13,0,0,13,56440
19111,2558,354,960,937,220,87,121,57,55,19,12,24,2,0,0,0,0,2,0,2,0,64,45,31,3,11,19,19,19,0,0,0,0,0,0,56441
19112,1930,85,483,759,435,168,43,37,37,9,19,9,0,0,0,0,0,0,0,0,0,6,2,0,2,0,4,4,4,0,0,0,0,0,0,56442
19113,1163,91,452,387,184,49,53,37,35,18,2,15,2,0,0,0,0,2,2,0,0,16,16,2,2,12,0,0,0,0,0,0,0,0,0,56443
19114,2361,206,833,783,352,187,97,62,51,9,2,40,11,11,8,3,0,0,0,0,0,35,28,14,7,7,7,7,7,0,0,0,0,0,0,56444
19115,1060,129,448,382,68,33,71,41,26,9,0,17,15,7,4,3,0,8,0,0,8,30,25,20,0,5,5,2,2,0,0,3,0,0,3,56446
19116,902,123,289,301,150,39,42,15,15,5,0,10,0,0,0,0,0,0,0,0,0,27,25,2,0,23,2,2,2,0,0,0,0,0,0,56447
19117,321,21,104,125,42,29,4,4,4,4,0,0,0,0,0,0,0,0,0,0,0,0,0,0,0,0,0,0,0,0,0,0,0,0,0,56448
19118,1323,92,474,566,126,65,76,48,39,12,9,18,9,6,3,0,3,3,3,0,0,28,28,24,0,4,0,0,0,0,0,0,0,0,0,56449
19119,803,103,287,299,71,43,39,21,14,8,0,6,7,7,7,0,0,0,0,0,0,18,3,1,0,2,15,6,0,2,4,9,0,9,0,56450
19120,1494,97,530,462,266,139,110,93,53,10,1,42,40,0,0,0,0,40,40,0,0,17,17,10,0,7,0,0,0,0,0,0,0,0,0,56452
19121,579,63,263,194,51,8,50,23,17,6,0,11,6,6,6,0,0,0,0,0,0,27,26,21,0,5,1,0,0,0,0,1,1,0,0,56453
19122,1085,115,408,374,139,49,72,27,17,7,5,5,10,3,3,0,0,7,0,0,7,45,45,37,3,5,0,0,0,0,0,0,0,0,0,56455
19123,26,6,6,9,5,0,1,0,0,0,0,0,0,0,0,0,0,0,0,0,0,1,1,0,0,1,0,0,0,0,0,0,0,0,0,56456
19124,262,20,110,89,36,7,13,13,13,1,0,12,0,0,0,0,0,0,0,0,0,0,0,0,0,0,0,0,0,0,0,0,0,0,0,56458
19125,2292,213,766,716,429,168,166,68,45,17,3,25,23,17,16,1,0,6,6,0,0,98,78,25,0,53,20,0,0,0,0,20,20,0,0,56461
19126,2862,373,1179,896,311,103,215,102,92,52,7,33,10,9,5,0,4,1,0,0,1,113,95,43,2,50,18,15,15,0,0,3,3,0,0,56464
19127,1494,97,444,572,290,91,123,56,56,24,13,19,0,0,0,0,0,0,0,0,0,67,50,27,7,16,17,4,0,4,0,13,0,6,7,56465
19128,2094,200,823,805,215,51,216,97,65,15,13,37,32,16,6,4,6,16,13,0,3,119,100,25,2,73,19,2,2,0,0,17,0,0,17,56466
19129,1785,119,619,572,318,157,107,64,59,8,4,47,5,5,0,5,0,0,0,0,0,43,34,23,0,11,9,6,6,0,0,3,0,0,3,56467
19130,3941,110,969,1598,886,378,197,96,96,56,10,30,0,0,0,0,0,0,0,0,0,101,100,47,7,46,1,1,1,0,0,0,0,0,0,56468
19131,770,101,296,292,56,25,34,21,19,2,11,6,2,2,2,0,0,0,0,0,0,13,13,9,0,4,0,0,0,0,0,0,0,0,0,56469
19132,7634,581,2512,2830,1133,578,476,253,199,77,23,99,54,38,19,4,15,16,12,0,4,223,178,88,0,90,45,39,34,0,5,6,0,2,4,56470
19133,5125,302,1527,1951,1032,313,404,217,186,95,11,80,31,29,27,0,2,2,0,0,2,187,173,80,18,75,14,7,5,2,0,7,0,0,7,56472
19134,2430,257,847,948,262,116,173,105,95,20,11,64,10,7,5,2,0,3,0,0,3,68,54,27,8,19,14,14,11,3,0,0,0,0,0,56473
19135,2547,254,1020,853,307,113,94,38,28,6,11,11,10,10,10,0,0,0,0,0,0,56,51,28,2,21,5,5,5,0,0,0,0,0,0,56474
19136,1067,78,443,379,123,44,77,48,39,17,6,16,9,6,0,4,2,3,0,0,3,29,15,6,3,6,14,8,0,0,8,6,3,0,3,56475
19137,1725,218,682,590,163,72,168,77,71,29,2,40,6,6,3,3,0,0,0,0,0,91,72,38,2,32,19,16,2,0,14,3,0,0,3,56477
19138,3290,469,949,1373,319,180,327,214,187,42,0,145,27,16,16,0,0,11,10,0,1,113,87,22,3,62,26,11,5,0,6,15,15,0,0,56479
19139,1599,183,652,650,83,31,130,78,66,34,4,28,12,12,12,0,0,0,0,0,0,52,49,24,10,15,3,3,3,0,0,0,0,0,0,56481
19140,4458,402,1572,1878,433,173,316,144,129,62,17,50,15,8,8,0,0,7,5,0,2,172,123,31,0,92,49,38,36,2,0,11,0,0,11,56482
19141,2390,175,800,786,450,179,109,49,45,26,8,11,4,4,3,0,1,0,0,0,0,60,37,4,9,24,23,22,3,0,19,1,0,0,1,56484
19142,11505,1004,3398,4257,1930,916,789,376,363,141,23,199,13,13,13,0,0,0,0,0,0,413,387,185,0,202,26,6,0,0,6,20,0,20,0,56501
19143,1551,165,588,522,236,40,144,77,68,19,4,45,9,2,0,2,0,7,4,0,3,67,64,5,0,59,3,3,3,0,0,0,0,0,0,56510
19144,1325,59,421,548,218,79,83,54,41,10,0,31,13,12,12,0,0,1,0,1,0,29,29,14,5,10,0,0,0,0,0,0,0,0,0,56511
19145,2446,208,814,833,464,127,164,76,59,36,0,23,17,13,7,6,0,4,4,0,0,88,80,66,1,13,8,2,0,0,2,6,5,1,0,56514
19146,2456,132,616,947,473,288,140,85,68,22,2,44,17,4,4,0,0,13,0,11,2,55,50,27,0,23,5,5,5,0,0,0,0,0,0,56515
19147,174,23,72,65,11,3,9,8,8,5,0,3,0,0,0,0,0,0,0,0,0,1,1,1,0,0,0,0,0,0,0,0,0,0,0,56516
19148,225,8,83,105,26,3,10,6,6,4,0,2,0,0,0,0,0,0,0,0,0,4,4,0,0,4,0,0,0,0,0,0,0,0,0,56517
19149,223,26,112,71,6,8,17,8,3,3,0,0,5,3,3,0,0,2,0,0,2,9,9,6,0,3,0,0,0,0,0,0,0,0,0,56518
19150,246,20,116,75,27,8,17,14,14,6,0,8,0,0,0,0,0,0,0,0,0,3,3,0,0,3,0,0,0,0,0,0,0,0,0,56519
19151,2809,242,847,1251,313,156,175,87,64,22,0,42,23,22,10,12,0,1,0,0,1,88,71,42,0,29,17,17,17,0,0,0,0,0,0,56520
19152,569,66,235,182,76,10,57,23,8,8,0,0,15,11,11,0,0,4,0,0,4,34,31,18,0,13,3,0,0,0,0,3,3,0,0,56521
19153,441,61,146,172,44,18,41,11,11,2,0,9,0,0,0,0,0,0,0,0,0,30,30,29,0,1,0,0,0,0,0,0,0,0,0,56522
19154,352,21,120,138,63,10,36,18,12,0,0,12,6,0,0,0,0,6,0,6,0,18,18,5,0,13,0,0,0,0,0,0,0,0,0,56523
19155,575,68,173,167,128,39,44,27,19,0,0,19,8,8,8,0,0,0,0,0,0,17,14,8,0,6,3,3,0,0,3,0,0,0,0,56524
19156,123,9,36,44,19,15,1,1,1,1,0,0,0,0,0,0,0,0,0,0,0,0,0,0,0,0,0,0,0,0,0,0,0,0,0,56525
19157,554,81,233,184,42,14,50,29,17,7,0,10,12,0,0,0,0,12,0,1,11,21,19,5,0,14,2,2,2,0,0,0,0,0,0,56527
19158,1223,84,420,424,227,68,54,29,15,9,0,6,14,2,2,0,0,12,0,0,12,25,22,0,0,22,3,2,2,0,0,1,0,0,1,56528
19159,2500,177,715,1025,411,172,145,105,88,70,8,10,17,17,17,0,0,0,0,0,0,40,23,15,0,8,17,17,17,0,0,0,0,0,0,56529
19160,1389,103,431,559,236,60,109,51,49,20,6,23,2,2,2,0,0,0,0,0,0,58,58,41,3,14,0,0,0,0,0,0,0,0,0,56531
19161,195,11,63,90,26,5,15,3,3,3,0,0,0,0,0,0,0,0,0,0,0,12,10,3,0,7,2,2,2,0,0,0,0,0,0,56533
19162,857,125,266,343,96,27,62,30,28,19,0,9,2,2,0,2,0,0,0,0,0,32,28,16,0,12,4,4,2,2,0,0,0,0,0,56534
19163,1030,192,322,327,164,25,51,29,27,1,0,26,2,2,0,2,0,0,0,0,0,22,22,12,0,10,0,0,0,0,0,0,0,0,0,56535
19164,344,14,133,118,66,13,18,8,7,2,1,4,1,1,1,0,0,0,0,0,0,10,10,1,0,9,0,0,0,0,0,0,0,0,0,56536
19165,12959,1252,3377,4733,2542,1055,1095,540,403,199,22,182,137,77,20,31,26,60,0,15,45,555,527,332,33,162,28,26,26,0,0,2,0,0,2,56537
19166,1385,183,422,489,217,74,123,70,62,17,12,33,8,8,8,0,0,0,0,0,0,53,50,18,5,27,3,3,3,0,0,0,0,0,0,56540
19167,31,0,17,12,0,2,0,0,0,0,0,0,0,0,0,0,0,0,0,0,0,0,0,0,0,0,0,0,0,0,0,0,0,0,0,56541
19168,2030,216,757,655,288,114,156,82,75,27,0,48,7,6,6,0,0,1,1,0,0,74,63,49,0,14,11,8,8,0,0,3,2,0,1,56542
19169,180,26,63,79,9,3,10,4,4,4,0,0,0,0,0,0,0,0,0,0,0,6,6,2,3,1,0,0,0,0,0,0,0,0,0,56543
19170,3426,426,1188,1177,443,192,261,127,92,31,0,61,35,9,5,0,4,26,17,0,9,134,96,60,0,36,38,19,3,15,1,19,15,0,4,56544
19171,476,53,189,174,55,5,33,23,20,2,0,18,3,3,0,0,3,0,0,0,0,10,10,6,0,4,0,0,0,0,0,0,0,0,0,56545
19172,269,16,114,85,46,8,20,16,16,5,0,11,0,0,0,0,0,0,0,0,0,4,4,1,0,3,0,0,0,0,0,0,0,0,0,56546
19173,1768,81,606,666,338,77,134,78,78,7,0,71,0,0,0,0,0,0,0,0,0,56,54,30,3,21,2,2,2,0,0,0,0,0,0,56547
19174,513,85,217,154,47,10,59,37,24,3,10,11,13,2,0,2,0,11,0,0,11,22,22,12,0,10,0,0,0,0,0,0,0,0,0,56548
19175,2965,130,1012,1044,563,216,172,80,79,29,2,48,1,1,1,0,0,0,0,0,0,92,74,36,0,38,18,11,8,1,2,7,0,0,7,56549
19176,266,21,106,93,39,7,6,1,1,0,0,1,0,0,0,0,0,0,0,0,0,5,5,4,0,1,0,0,0,0,0,0,0,0,0,56550
19177,1576,200,552,538,205,81,92,32,29,10,3,16,3,2,2,0,0,1,0,0,1,60,49,25,0,24,11,10,10,0,0,1,0,0,1,56551
19178,317,21,112,123,44,17,22,17,17,0,4,13,0,0,0,0,0,0,0,0,0,5,5,2,0,3,0,0,0,0,0,0,0,0,0,56552
19179,183,21,61,43,45,13,11,3,3,0,0,3,0,0,0,0,0,0,0,0,0,8,8,4,0,4,0,0,0,0,0,0,0,0,0,56553
19180,1792,145,587,641,306,113,87,54,36,14,0,22,18,14,14,0,0,4,2,2,0,33,24,13,0,11,9,9,7,0,2,0,0,0,0,56554
19181,675,58,283,227,76,31,13,3,3,1,0,2,0,0,0,0,0,0,0,0,0,10,10,5,0,5,0,0,0,0,0,0,0,0,0,56556
19182,1841,294,648,674,193,32,137,74,56,8,0,48,18,10,8,2,0,8,0,8,0,63,45,22,5,18,18,10,3,3,4,8,0,0,8,56557
19183,23533,1501,6319,7829,5572,2312,3900,1676,1445,689,119,637,231,126,88,38,0,105,18,86,1,2224,2122,1177,88,857,102,65,52,0,13,37,22,0,15,56560
19184,107,21,56,18,12,0,7,5,5,0,1,4,0,0,0,0,0,0,0,0,0,2,2,0,0,2,0,0,0,0,0,0,0,0,0,56565
19185,278,51,98,118,11,0,18,13,13,8,0,5,0,0,0,0,0,0,0,0,0,5,2,0,2,0,3,0,0,0,0,3,0,3,0,56566
19186,2445,252,910,936,260,87,156,96,75,24,7,44,21,12,12,0,0,9,3,2,4,60,48,35,2,11,12,12,12,0,0,0,0,0,0,56567
19187,138,11,53,63,6,5,5,5,5,0,0,5,0,0,0,0,0,0,0,0,0,0,0,0,0,0,0,0,0,0,0,0,0,0,0,56568
19188,759,115,281,282,66,15,78,26,24,3,0,21,2,2,2,0,0,0,0,0,0,52,45,28,7,10,7,7,7,0,0,0,0,0,0,56569
19189,883,62,388,327,72,34,40,25,21,2,0,19,4,2,0,0,2,2,0,0,2,15,15,9,0,6,0,0,0,0,0,0,0,0,0,56570
19190,1282,83,470,475,202,52,90,60,49,23,0,26,11,11,2,7,2,0,0,0,0,30,30,20,0,10,0,0,0,0,0,0,0,0,0,56571
19191,3963,585,1166,1276,638,298,173,91,83,56,0,27,8,8,2,0,6,0,0,0,0,82,71,14,4,53,11,11,9,0,2,0,0,0,0,56572
19192,4417,516,1567,1497,575,262,288,165,139,50,7,82,26,12,11,0,1,14,0,12,2,123,103,85,0,18,20,16,3,13,0,4,4,0,0,56573
19193,190,29,57,80,21,3,12,5,5,2,0,3,0,0,0,0,0,0,0,0,0,7,7,2,0,5,0,0,0,0,0,0,0,0,0,56574
19194,472,49,188,147,57,31,27,21,15,0,0,15,6,1,0,0,1,5,0,0,5,6,6,2,0,4,0,0,0,0,0,0,0,0,0,56575
19195,643,62,259,204,79,39,38,3,3,0,1,2,0,0,0,0,0,0,0,0,0,35,35,11,0,24,0,0,0,0,0,0,0,0,0,56576
19196,17,0,5,3,6,3,0,0,0,0,0,0,0,0,0,0,0,0,0,0,0,0,0,0,0,0,0,0,0,0,0,0,0,0,0,56577
19197,618,61,187,253,89,28,59,27,27,12,0,15,0,0,0,0,0,0,0,0,0,32,32,12,10,10,0,0,0,0,0,0,0,0,0,56578
19198,688,88,250,255,73,22,36,25,24,6,0,18,1,1,0,0,1,0,0,0,0,11,11,5,0,6,0,0,0,0,0,0,0,0,0,56579
19199,801,27,225,323,180,46,60,24,20,12,1,7,4,3,3,0,0,1,1,0,0,36,30,13,1,16,6,5,5,0,0,1,1,0,0,56580
19200,231,16,124,60,27,4,20,16,16,4,6,6,0,0,0,0,0,0,0,0,0,4,4,1,0,3,0,0,0,0,0,0,0,0,0,56581
19201,113,6,56,41,8,2,4,4,4,2,0,2,0,0,0,0,0,0,0,0,0,0,0,0,0,0,0,0,0,0,0,0,0,0,0,56583
19202,1112,141,427,413,109,22,85,52,44,5,0,39,8,8,1,0,7,0,0,0,0,33,33,12,0,21,0,0,0,0,0,0,0,0,0,56584
19203,758,105,314,245,81,13,45,20,18,11,1,6,2,2,1,0,1,0,0,0,0,25,15,7,0,8,10,1,0,1,0,9,9,0,0,56585
19204,1370,85,496,470,243,76,83,58,58,26,2,30,0,0,0,0,0,0,0,0,0,25,25,19,1,5,0,0,0,0,0,0,0,0,0,56586
19205,1184,70,512,414,128,60,62,56,53,26,0,27,3,0,0,0,0,3,0,0,3,6,4,2,0,2,2,2,2,0,0,0,0,0,0,56587
19206,426,42,177,131,47,29,13,9,9,3,0,6,0,0,0,0,0,0,0,0,0,4,4,1,0,3,0,0,0,0,0,0,0,0,0,56588
19207,1473,188,547,446,211,81,103,50,37,13,2,22,13,2,2,0,0,11,11,0,0,53,50,18,2,30,3,3,3,0,0,0,0,0,0,56589
19208,288,17,110,126,31,4,15,10,10,0,0,10,0,0,0,0,0,0,0,0,0,5,5,3,0,2,0,0,0,0,0,0,0,0,0,56590
19209,127,16,65,33,9,4,6,5,5,0,0,5,0,0,0,0,0,0,0,0,0,1,1,0,0,1,0,0,0,0,0,0,0,0,0,56591
19210,360,85,91,108,59,17,55,26,26,18,6,2,0,0,0,0,0,0,0,0,0,29,26,18,0,8,3,3,3,0,0,0,0,0,0,56592
19211,9,0,3,6,0,0,0,0,0,0,0,0,0,0,0,0,0,0,0,0,0,0,0,0,0,0,0,0,0,0,0,0,0,0,0,56593
19212,278,17,98,112,46,5,9,5,5,2,0,3,0,0,0,0,0,0,0,0,0,4,4,2,0,2,0,0,0,0,0,0,0,0,0,56594
19213,20632,1606,5123,7350,4254,2299,2466,1241,1022,288,134,600,219,131,113,3,15,88,20,29,39,1225,1159,571,73,515,66,34,31,0,3,32,11,0,21,56601
19214,3236,496,1308,1029,310,93,202,102,87,28,6,53,15,13,10,3,0,2,0,0,2,100,82,45,3,34,18,16,11,0,5,2,1,0,1,56621
19215,1842,163,762,624,258,35,147,36,36,15,0,21,0,0,0,0,0,0,0,0,0,111,71,35,5,31,40,16,5,0,11,24,24,0,0,56623
19216,145,21,64,45,9,6,61,8,8,0,0,8,0,0,0,0,0,0,0,0,0,53,13,0,0,13,40,40,40,0,0,0,0,0,0,56626
19217,222,28,96,69,21,8,2,1,1,1,0,0,0,0,0,0,0,0,0,0,0,1,1,0,1,0,0,0,0,0,0,0,0,0,0,56627
19218,1231,116,470,372,172,101,21,11,11,0,0,11,0,0,0,0,0,0,0,0,0,10,9,0,4,5,1,0,0,0,0,1,0,1,0,56628
19219,206,10,78,67,37,14,14,9,9,0,0,9,0,0,0,0,0,0,0,0,0,5,5,0,0,5,0,0,0,0,0,0,0,0,0,56629
19220,1237,136,600,376,99,26,94,54,38,7,3,28,16,16,2,14,0,0,0,0,0,40,36,14,5,17,4,4,4,0,0,0,0,0,0,56630
19221,2740,357,812,1126,320,125,184,85,45,10,13,22,40,24,14,6,4,16,0,11,5,99,93,7,3,83,6,2,2,0,0,4,0,1,3,56633
19222,1161,119,471,401,138,32,58,26,16,6,1,9,10,10,9,0,1,0,0,0,0,32,32,20,2,10,0,0,0,0,0,0,0,0,0,56634
19223,3294,324,1245,1215,385,125,317,174,162,84,3,75,12,7,4,3,0,5,2,0,3,143,110,36,0,74,33,19,4,7,8,14,3,0,11,56636
19224,151,10,70,63,2,6,29,10,10,2,2,6,0,0,0,0,0,0,0,0,0,19,19,9,3,7,0,0,0,0,0,0,0,0,0,56637
19225,316,54,132,105,25,0,20,6,6,4,0,2,0,0,0,0,0,0,0,0,0,14,14,4,2,8,0,0,0,0,0,0,0,0,0,56639
19226,237,40,85,89,12,11,10,9,8,0,0,8,1,1,1,0,0,0,0,0,0,1,1,0,0,1,0,0,0,0,0,0,0,0,0,56641
19227,579,124,207,171,48,29,67,31,25,6,0,19,6,3,1,0,2,3,0,0,3,36,34,18,1,15,2,2,2,0,0,0,0,0,0,56644
19228,247,17,94,111,20,5,14,9,7,0,0,7,2,0,0,0,0,2,0,0,2,5,5,2,0,3,0,0,0,0,0,0,0,0,0,56646
19229,589,56,167,218,103,45,16,7,7,6,0,1,0,0,0,0,0,0,0,0,0,9,9,3,0,6,0,0,0,0,0,0,0,0,0,56647
19230,7097,728,2597,2415,1083,274,508,268,251,83,21,147,17,5,5,0,0,12,0,0,12,240,199,113,23,63,41,41,41,0,0,0,0,0,0,56649
19231,505,66,191,170,58,20,44,31,26,0,3,23,5,5,5,0,0,0,0,0,0,13,13,4,0,9,0,0,0,0,0,0,0,0,0,56650
19232,359,47,176,95,31,10,14,4,4,0,0,4,0,0,0,0,0,0,0,0,0,10,10,4,0,6,0,0,0,0,0,0,0,0,0,56651
19233,313,40,120,123,24,6,22,10,9,2,1,6,1,0,0,0,0,1,0,0,1,12,10,2,0,8,2,0,0,0,0,2,0,0,2,56652
19234,1090,133,451,391,103,12,83,58,52,8,3,41,6,0,0,0,0,6,6,0,0,25,23,12,0,11,2,2,2,0,0,0,0,0,0,56653
19235,89,7,50,22,8,2,8,8,8,0,0,8,0,0,0,0,0,0,0,0,0,0,0,0,0,0,0,0,0,0,0,0,0,0,0,56654
19236,1101,82,425,374,142,78,26,18,16,3,7,6,2,2,2,0,0,0,0,0,0,8,8,3,0,5,0,0,0,0,0,0,0,0,0,56655
19237,183,13,79,52,25,14,4,0,0,0,0,0,0,0,0,0,0,0,0,0,0,4,4,0,0,4,0,0,0,0,0,0,0,0,0,56657
19238,0,0,0,0,0,0,0,0,0,0,0,0,0,0,0,0,0,0,0,0,0,0,0,0,0,0,0,0,0,0,0,0,0,0,0,56658
19239,48,5,19,14,0,10,0,0,0,0,0,0,0,0,0,0,0,0,0,0,0,0,0,0,0,0,0,0,0,0,0,0,0,0,0,56659
19240,191,28,105,50,8,0,44,28,19,4,6,9,9,9,9,0,0,0,0,0,0,16,16,13,0,3,0,0,0,0,0,0,0,0,0,56660
19241,676,74,250,260,74,18,40,20,20,10,5,5,0,0,0,0,0,0,0,0,0,20,18,4,7,7,2,2,2,0,0,0,0,0,0,56661
19242,432,29,157,153,57,36,7,7,0,0,0,0,7,7,3,4,0,0,0,0,0,0,0,0,0,0,0,0,0,0,0,0,0,0,0,56662
19243,169,44,52,61,6,6,3,3,3,0,0,3,0,0,0,0,0,0,0,0,0,0,0,0,0,0,0,0,0,0,0,0,0,0,0,56663
19244,386,151,112,112,11,0,72,45,17,0,0,17,28,0,0,0,0,28,0,12,16,27,27,0,0,27,0,0,0,0,0,0,0,0,0,56666
19245,516,70,183,146,95,22,29,20,16,7,0,9,4,4,4,0,0,0,0,0,0,9,9,3,0,6,0,0,0,0,0,0,0,0,0,56667
19246,124,0,47,57,15,5,1,0,0,0,0,0,0,0,0,0,0,0,0,0,0,1,1,1,0,0,0,0,0,0,0,0,0,0,0,56668
19247,280,33,108,90,37,12,6,0,0,0,0,0,0,0,0,0,0,0,0,0,0,6,6,6,0,0,0,0,0,0,0,0,0,0,0,56669
19248,687,150,303,168,46,20,116,67,53,0,32,21,14,0,0,0,0,14,0,13,1,49,24,0,0,24,25,0,0,0,0,25,16,0,9,56670
19249,1478,249,468,673,70,18,340,157,101,0,27,74,56,0,0,0,0,56,15,31,10,183,72,34,0,38,111,75,27,48,0,36,0,15,21,56671
19250,1594,160,667,532,174,61,86,21,17,9,2,6,4,3,0,0,3,1,0,0,1,65,52,12,0,40,13,13,13,0,0,0,0,0,0,56672
19251,606,75,185,207,128,11,21,2,2,2,0,0,0,0,0,0,0,0,0,0,0,19,4,4,0,0,15,15,15,0,0,0,0,0,0,56673
19252,1124,138,405,370,145,66,50,27,22,3,1,18,5,3,2,0,1,2,0,1,1,23,15,7,0,8,8,8,6,2,0,0,0,0,0,56676
19253,802,99,266,267,135,35,52,22,18,2,0,16,4,2,2,0,0,2,0,0,2,30,16,12,0,4,14,7,4,0,3,7,5,0,2,56678
19254,94,8,32,32,17,5,1,0,0,0,0,0,0,0,0,0,0,0,0,0,0,1,1,0,0,1,0,0,0,0,0,0,0,0,0,56680
19255,197,29,95,46,18,9,13,6,6,3,0,3,0,0,0,0,0,0,0,0,0,7,5,5,0,0,2,0,0,0,0,2,0,0,2,56681
19256,517,26,186,191,91,23,31,22,17,3,0,14,5,5,0,3,2,0,0,0,0,9,9,4,0,5,0,0,0,0,0,0,0,0,0,56683
19257,189,23,83,65,11,7,9,4,4,0,0,4,0,0,0,0,0,0,0,0,0,5,5,5,0,0,0,0,0,0,0,0,0,0,0,56684
19258,132,27,61,34,10,0,1,1,1,0,0,1,0,0,0,0,0,0,0,0,0,0,0,0,0,0,0,0,0,0,0,0,0,0,0,56685
19259,840,136,346,298,50,10,116,109,109,65,0,44,0,0,0,0,0,0,0,0,0,7,4,0,0,4,3,3,0,0,3,0,0,0,0,56686
19260,45,9,3,21,7,5,3,2,2,0,0,2,0,0,0,0,0,0,0,0,0,1,0,0,0,0,1,1,1,0,0,0,0,0,0,56687
19261,108,10,47,28,18,5,4,4,2,0,0,2,2,2,0,2,0,0,0,0,0,0,0,0,0,0,0,0,0,0,0,0,0,0,0,56688
19262,8570,823,2920,3372,996,459,673,359,306,111,16,179,53,50,45,1,4,3,0,0,3,314,268,143,23,102,46,45,42,0,3,1,0,0,1,56701
19263,340,39,108,118,54,21,18,6,6,0,0,6,0,0,0,0,0,0,0,0,0,12,12,2,0,10,0,0,0,0,0,0,0,0,0,56710
19264,39,0,24,15,0,0,0,0,0,0,0,0,0,0,0,0,0,0,0,0,0,0,0,0,0,0,0,0,0,0,0,0,0,0,0,56711
19265,703,77,290,220,101,15,56,29,29,4,0,25,0,0,0,0,0,0,0,0,0,27,27,21,0,6,0,0,0,0,0,0,0,0,0,56713
19266,851,75,308,377,76,15,40,27,16,5,2,9,11,11,0,4,7,0,0,0,0,13,11,8,0,3,2,0,0,0,0,2,0,0,2,56714
19267,183,33,58,69,22,1,6,0,0,0,0,0,0,0,0,0,0,0,0,0,0,6,6,4,0,2,0,0,0,0,0,0,0,0,0,56715
19268,5753,658,1688,1973,916,518,637,335,329,52,92,185,6,4,2,0,2,2,0,0,2,302,203,116,49,38,99,99,91,8,0,0,0,0,0,56716
19269,34,6,13,12,3,0,0,0,0,0,0,0,0,0,0,0,0,0,0,0,0,0,0,0,0,0,0,0,0,0,0,0,0,0,0,56720
19270,6554,609,1643,2744,1021,537,607,349,280,160,18,102,69,23,23,0,0,46,0,0,46,258,231,148,5,78,27,15,15,0,0,12,0,0,12,56721
19271,317,27,131,133,22,4,10,10,10,9,0,1,0,0,0,0,0,0,0,0,0,0,0,0,0,0,0,0,0,0,0,0,0,0,0,56722
19272,546,26,142,243,102,33,51,27,22,9,2,11,5,5,5,0,0,0,0,0,0,24,24,12,2,10,0,0,0,0,0,0,0,0,0,56723
19273,108,2,67,25,8,6,5,1,1,1,0,0,0,0,0,0,0,0,0,0,0,4,4,0,0,4,0,0,0,0,0,0,0,0,0,56724
19274,703,99,294,259,34,17,29,15,15,8,0,7,0,0,0,0,0,0,0,0,0,14,11,5,3,3,3,3,3,0,0,0,0,0,0,56725
19275,1076,107,425,389,140,15,114,57,43,8,2,33,14,14,3,0,11,0,0,0,0,57,52,24,4,24,5,2,2,0,0,3,0,0,3,56726
19276,559,72,226,180,73,8,47,27,20,6,4,10,7,5,0,5,0,2,1,0,1,20,18,0,1,17,2,0,0,0,0,2,0,2,0,56727
19277,998,87,285,378,219,29,63,29,29,8,0,21,0,0,0,0,0,0,0,0,0,34,34,25,0,9,0,0,0,0,0,0,0,0,0,56728
19278,102,17,37,28,8,12,9,9,9,5,2,2,0,0,0,0,0,0,0,0,0,0,0,0,0,0,0,0,0,0,0,0,0,0,0,56729
19279,54,3,13,22,11,5,3,3,0,0,0,0,3,3,3,0,0,0,0,0,0,0,0,0,0,0,0,0,0,0,0,0,0,0,0,56731
19280,739,117,274,203,100,45,60,36,31,19,0,12,5,5,5,0,0,0,0,0,0,24,15,8,0,7,9,7,4,3,0,2,0,0,2,56732
19281,311,24,77,137,68,5,29,22,18,3,0,15,4,4,4,0,0,0,0,0,0,7,7,3,0,4,0,0,0,0,0,0,0,0,0,56733
19282,334,36,154,109,26,9,12,8,8,0,0,8,0,0,0,0,0,0,0,0,0,4,4,2,0,2,0,0,0,0,0,0,0,0,0,56734
19283,622,77,238,199,97,11,16,7,7,0,2,5,0,0,0,0,0,0,0,0,0,9,4,0,2,2,5,0,0,0,0,5,2,0,3,56735
19284,797,101,294,249,98,55,46,9,7,6,0,1,2,2,2,0,0,0,0,0,0,37,33,28,0,5,4,0,0,0,0,4,1,0,3,56736
19285,636,51,312,198,54,21,39,32,29,6,3,20,3,2,0,0,2,1,0,0,1,7,7,0,0,7,0,0,0,0,0,0,0,0,0,56737
19286,950,79,372,353,112,34,68,41,38,13,9,16,3,2,2,0,0,1,0,0,1,27,27,18,3,6,0,0,0,0,0,0,0,0,0,56738
19287,17,0,10,7,0,0,0,0,0,0,0,0,0,0,0,0,0,0,0,0,0,0,0,0,0,0,0,0,0,0,0,0,0,0,0,56741
19288,599,79,273,185,52,10,45,39,30,16,0,14,9,9,9,0,0,0,0,0,0,6,6,3,0,3,0,0,0,0,0,0,0,0,0,56742
19289,395,60,148,113,62,12,43,29,12,4,0,8,17,3,0,3,0,14,0,0,14,14,8,2,0,6,6,0,0,0,0,6,0,6,0,56744
19290,539,60,190,191,72,26,48,20,14,11,0,3,6,0,0,0,0,6,0,0,6,28,20,12,0,8,8,8,6,0,2,0,0,0,0,56748
19291,1798,207,691,589,242,69,133,79,68,31,7,30,11,11,11,0,0,0,0,0,0,54,41,14,2,25,13,7,7,0,0,6,0,4,2,56750
19292,3712,301,1367,1204,591,249,384,247,204,113,18,73,43,39,35,0,4,4,0,0,4,137,120,57,0,63,17,17,15,0,2,0,0,0,0,56751
19293,343,49,124,124,36,10,34,14,11,4,0,7,3,0,0,0,0,3,0,3,0,20,11,5,6,0,9,2,2,0,0,7,4,0,3,56754
19294,96,8,34,25,23,6,4,4,0,0,0,0,4,0,0,0,0,4,0,0,4,0,0,0,0,0,0,0,0,0,0,0,0,0,0,56755
19295,522,47,294,127,51,3,15,0,0,0,0,0,0,0,0,0,0,0,0,0,0,15,12,6,0,6,3,3,3,0,0,0,0,0,0,56756
19296,724,110,250,247,79,38,47,29,29,10,3,16,0,0,0,0,0,0,0,0,0,18,14,11,0,3,4,3,3,0,0,1,1,0,0,56757
19297,303,73,118,78,28,6,11,2,0,0,0,0,2,2,0,0,2,0,0,0,0,9,7,0,0,7,2,0,0,0,0,2,2,0,0,56758
19298,298,39,134,79,43,3,13,11,11,6,3,2,0,0,0,0,0,0,0,0,0,2,2,0,2,0,0,0,0,0,0,0,0,0,0,56759
19299,250,20,98,89,41,2,29,18,18,12,0,6,0,0,0,0,0,0,0,0,0,11,11,3,0,8,0,0,0,0,0,0,0,0,0,56760
19300,353,43,170,107,27,6,32,21,21,0,0,21,0,0,0,0,0,0,0,0,0,11,11,8,0,3,0,0,0,0,0,0,0,0,0,56761
19301,1754,239,527,592,301,95,131,60,60,28,4,28,0,0,0,0,0,0,0,0,0,71,51,17,13,21,20,20,20,0,0,0,0,0,0,56762
19302,3437,313,1352,1166,458,148,320,154,147,50,11,86,7,7,7,0,0,0,0,0,0,166,136,63,0,73,30,30,13,0,17,0,0,0,0,56763
19303,1241,102,546,389,156,48,45,36,31,6,0,25,5,0,0,0,0,5,0,0,5,9,9,7,0,2,0,0,0,0,0,0,0,0,0,57001
19304,579,22,229,176,130,22,11,5,5,5,0,0,0,0,0,0,0,0,0,0,0,6,6,1,0,5,0,0,0,0,0,0,0,0,0,57002
19305,1256,74,429,448,228,77,125,59,59,31,1,27,0,0,0,0,0,0,0,0,0,66,59,24,14,21,7,7,7,0,0,0,0,0,0,57003
19306,2365,141,878,778,358,210,256,117,117,20,0,97,0,0,0,0,0,0,0,0,0,139,131,61,0,70,8,0,0,0,0,8,0,0,8,57004
19307,6493,193,1950,2348,1529,473,683,364,344,206,14,124,20,20,20,0,0,0,0,0,0,319,298,111,74,113,21,21,21,0,0,0,0,0,0,57005
19308,12037,681,2666,3054,3442,2194,3018,1458,1438,679,154,605,20,11,0,0,11,9,8,0,1,1560,1555,684,59,812,5,5,5,0,0,0,0,0,0,57006
19309,373,7,79,163,80,44,20,20,20,0,0,20,0,0,0,0,0,0,0,0,0,0,0,0,0,0,0,0,0,0,0,0,0,0,0,57010
19310,703,73,243,233,113,41,51,31,28,0,8,20,3,3,3,0,0,0,0,0,0,20,12,3,0,9,8,8,8,0,0,0,0,0,0,57012
19311,3087,288,1099,982,410,308,360,272,233,100,0,133,39,39,28,11,0,0,0,0,0,88,50,12,0,38,38,34,19,15,0,4,0,4,0,57013
19312,1062,103,361,327,229,42,41,17,15,2,0,13,2,2,2,0,0,0,0,0,0,24,21,9,0,12,3,0,0,0,0,3,3,0,0,57014
19313,494,47,209,172,48,18,66,43,27,14,0,13,16,1,1,0,0,15,2,13,0,23,23,9,0,14,0,0,0,0,0,0,0,0,0,57015
19314,536,38,190,206,85,17,17,3,3,0,0,3,0,0,0,0,0,0,0,0,0,14,14,8,0,6,0,0,0,0,0,0,0,0,0,57016
19315,970,22,388,369,156,35,69,29,23,2,10,11,6,0,0,0,0,6,6,0,0,40,40,23,7,10,0,0,0,0,0,0,0,0,0,57017
19316,1023,49,408,389,129,48,69,22,20,2,0,18,2,2,2,0,0,0,0,0,0,47,47,26,0,21,0,0,0,0,0,0,0,0,0,57018
19317,1184,71,384,492,194,43,90,48,34,12,0,22,14,0,0,0,0,14,9,0,5,42,42,40,0,2,0,0,0,0,0,0,0,0,0,57020
19318,251,15,86,105,44,1,0,0,0,0,0,0,0,0,0,0,0,0,0,0,0,0,0,0,0,0,0,0,0,0,0,0,0,0,0,57021
19319,3111,205,1145,937,711,113,279,140,127,80,19,28,13,0,0,0,0,13,0,0,13,139,128,73,10,45,11,11,0,11,0,0,0,0,0,57022
19320,338,39,159,106,31,3,25,6,6,6,0,0,0,0,0,0,0,0,0,0,0,19,19,4,0,15,0,0,0,0,0,0,0,0,0,57024
19321,1913,239,623,510,377,164,187,127,118,37,22,59,9,0,0,0,0,9,0,0,9,60,48,10,0,38,12,12,12,0,0,0,0,0,0,57025
19322,863,67,360,279,109,48,66,27,18,4,0,14,9,9,9,0,0,0,0,0,0,39,35,17,0,18,4,4,0,0,4,0,0,0,0,57026
19323,70,9,23,30,8,0,21,15,15,9,0,6,0,0,0,0,0,0,0,0,0,6,6,6,0,0,0,0,0,0,0,0,0,0,0,57027
19324,2118,279,608,605,381,245,151,49,34,13,0,21,15,11,6,4,1,4,4,0,0,102,67,26,1,40,35,34,23,11,0,1,1,0,0,57028
19325,1388,182,427,362,308,109,61,46,46,33,0,13,0,0,0,0,0,0,0,0,0,15,15,8,0,7,0,0,0,0,0,0,0,0,0,57029
19326,2260,111,740,775,454,180,242,104,100,27,4,69,4,0,0,0,0,4,4,0,0,138,134,55,7,72,4,4,4,0,0,0,0,0,0,57030
19327,457,26,160,152,83,36,43,25,20,10,0,10,5,2,0,2,0,3,3,0,0,18,16,11,0,5,2,0,0,0,0,2,2,0,0,57031
19328,3869,30,783,1520,1096,440,466,131,120,99,0,21,11,0,0,0,0,11,11,0,0,335,316,89,13,214,19,19,0,0,19,0,0,0,0,57032
19329,3207,206,948,1048,788,217,365,161,143,105,0,38,18,7,0,7,0,11,0,0,11,204,204,138,0,66,0,0,0,0,0,0,0,0,0,57033
19330,479,87,232,121,36,3,40,29,24,1,0,23,5,2,2,0,0,3,0,3,0,11,11,8,0,3,0,0,0,0,0,0,0,0,0,57034
19331,891,26,244,407,199,15,54,9,9,7,0,2,0,0,0,0,0,0,0,0,0,45,42,27,0,15,3,0,0,0,0,3,0,0,3,57035
19332,456,20,176,166,70,24,28,15,9,2,0,7,6,6,6,0,0,0,0,0,0,13,13,8,2,3,0,0,0,0,0,0,0,0,0,57036
19333,705,70,246,245,139,5,46,26,21,6,0,15,5,0,0,0,0,5,5,0,0,20,15,2,4,9,5,5,0,0,5,0,0,0,0,57037
19334,1078,87,379,316,122,174,89,37,28,0,0,28,9,2,0,0,2,7,0,7,0,52,37,7,5,25,15,4,4,0,0,11,0,0,11,57038
19335,2053,156,687,715,349,146,101,55,35,5,0,30,20,20,15,5,0,0,0,0,0,46,39,10,0,29,7,7,7,0,0,0,0,0,0,57039
19336,275,31,140,59,37,8,11,2,2,0,0,2,0,0,0,0,0,0,0,0,0,9,9,4,0,5,0,0,0,0,0,0,0,0,0,57040
19337,48,0,6,23,19,0,0,0,0,0,0,0,0,0,0,0,0,0,0,0,0,0,0,0,0,0,0,0,0,0,0,0,0,0,0,57041
19338,5645,365,1926,1702,1138,514,744,403,388,172,36,180,15,0,0,0,0,15,14,0,1,341,325,185,21,119,16,16,16,0,0,0,0,0,0,57042
19339,1018,97,380,345,156,40,55,33,29,5,0,24,4,4,4,0,0,0,0,0,0,22,20,12,0,8,2,2,2,0,0,0,0,0,0,57043
19340,790,184,236,175,147,48,43,36,36,18,0,18,0,0,0,0,0,0,0,0,0,7,7,7,0,0,0,0,0,0,0,0,0,0,0,57045
19341,413,23,153,132,92,13,26,8,4,2,0,2,4,4,4,0,0,0,0,0,0,18,18,0,0,18,0,0,0,0,0,0,0,0,0,57046
19342,202,16,83,71,27,5,14,3,3,3,0,0,0,0,0,0,0,0,0,0,0,11,11,6,0,5,0,0,0,0,0,0,0,0,0,57047
19343,806,27,312,236,114,117,60,44,40,37,0,3,4,4,4,0,0,0,0,0,0,16,16,4,0,12,0,0,0,0,0,0,0,0,0,57048
19344,3972,173,941,1183,939,736,279,154,133,35,0,98,21,10,10,0,0,11,11,0,0,125,101,6,26,69,24,24,0,24,0,0,0,0,0,57049
19345,152,14,60,35,35,8,8,8,8,6,0,2,0,0,0,0,0,0,0,0,0,0,0,0,0,0,0,0,0,0,0,0,0,0,0,57050
19346,199,2,92,67,31,7,8,3,3,2,0,1,0,0,0,0,0,0,0,0,0,5,0,0,0,0,5,0,0,0,0,5,5,0,0,57051
19347,249,26,103,44,31,45,12,5,5,0,0,5,0,0,0,0,0,0,0,0,0,7,7,0,0,7,0,0,0,0,0,0,0,0,0,57052
19348,1294,101,495,380,244,74,115,57,57,36,4,17,0,0,0,0,0,0,0,0,0,58,58,43,0,15,0,0,0,0,0,0,0,0,0,57053
19349,447,44,199,120,62,22,13,13,10,0,0,10,3,3,3,0,0,0,0,0,0,0,0,0,0,0,0,0,0,0,0,0,0,0,0,57054
19350,722,56,294,210,128,34,52,30,30,30,0,0,0,0,0,0,0,0,0,0,0,22,22,22,0,0,0,0,0,0,0,0,0,0,0,57055
19351,91,5,44,26,13,3,4,3,3,0,0,3,0,0,0,0,0,0,0,0,0,1,1,0,0,1,0,0,0,0,0,0,0,0,0,57057
19352,1453,116,591,444,232,70,101,52,47,32,0,15,5,0,0,0,0,5,0,0,5,49,49,33,8,8,0,0,0,0,0,0,0,0,0,57058
19353,939,94,376,213,192,64,67,25,23,15,0,8,2,0,0,0,0,2,0,0,2,42,22,12,0,10,20,17,17,0,0,3,0,0,3,57059
19354,59,3,32,15,8,1,8,8,8,0,0,8,0,0,0,0,0,0,0,0,0,0,0,0,0,0,0,0,0,0,0,0,0,0,0,57061
19355,1799,185,748,621,183,62,56,41,24,0,0,24,17,6,0,0,6,11,0,0,11,15,15,2,0,13,0,0,0,0,0,0,0,0,0,57062
19356,706,81,253,251,74,47,49,24,23,21,0,2,1,1,1,0,0,0,0,0,0,25,24,1,0,23,1,1,1,0,0,0,0,0,0,57063
19357,2869,185,791,926,695,272,344,292,249,117,0,132,43,32,32,0,0,11,11,0,0,52,35,29,0,6,17,0,0,0,0,17,17,0,0,57064
19358,270,30,112,108,20,0,32,28,26,19,7,0,2,2,2,0,0,0,0,0,0,4,4,4,0,0,0,0,0,0,0,0,0,0,0,57065
19359,1151,130,417,371,193,40,104,59,57,17,0,40,2,2,2,0,0,0,0,0,0,45,45,18,0,27,0,0,0,0,0,0,0,0,0,57066
19360,340,22,34,161,106,17,12,12,12,0,0,12,0,0,0,0,0,0,0,0,0,0,0,0,0,0,0,0,0,0,0,0,0,0,0,57067
19361,957,59,389,273,165,71,56,10,10,5,0,5,0,0,0,0,0,0,0,0,0,46,46,43,2,1,0,0,0,0,0,0,0,0,0,57068
19362,5476,250,1511,1229,1422,1064,1984,918,843,196,70,577,75,62,50,0,12,13,0,13,0,1066,1066,484,117,465,0,0,0,0,0,0,0,0,0,57069
19363,1077,159,450,294,132,42,57,20,20,6,0,14,0,0,0,0,0,0,0,0,0,37,37,25,7,5,0,0,0,0,0,0,0,0,0,57070
19364,1875,165,550,618,437,105,104,43,43,16,0,27,0,0,0,0,0,0,0,0,0,61,54,24,3,27,7,2,2,0,0,5,5,0,0,57071
19365,480,27,147,143,118,45,46,19,11,2,0,9,8,8,0,0,8,0,0,0,0,27,21,16,0,5,6,6,3,3,0,0,0,0,0,57072
19366,673,100,182,260,74,57,27,20,12,3,0,9,8,8,2,6,0,0,0,0,0,7,7,0,0,7,0,0,0,0,0,0,0,0,0,57073
19367,633,32,268,167,128,38,18,9,6,0,0,6,3,3,3,0,0,0,0,0,0,9,4,0,0,4,5,0,0,0,0,5,0,0,5,57075
19368,215,12,68,65,54,16,12,10,10,0,0,10,0,0,0,0,0,0,0,0,0,2,0,0,0,0,2,2,2,0,0,0,0,0,0,57076
19369,821,98,299,268,124,32,72,48,48,42,5,1,0,0,0,0,0,0,0,0,0,24,24,0,0,24,0,0,0,0,0,0,0,0,0,57077
19370,13276,1228,4648,3863,2475,1062,1035,542,469,154,66,249,73,35,0,35,0,38,38,0,0,493,382,202,14,166,111,92,92,0,0,19,11,2,6,57078
19371,22847,2885,6677,6699,4198,2388,1645,839,667,284,60,323,172,140,80,40,20,32,32,0,0,806,703,269,79,355,103,25,0,17,8,78,0,0,78,57103
19372,17034,3021,5657,5079,2530,747,1178,594,394,139,15,240,200,119,114,0,5,81,0,79,2,584,499,314,24,161,85,58,15,43,0,27,25,0,2,57104
19373,14596,472,4213,4480,3333,2098,1290,682,557,194,65,298,125,59,59,0,0,66,34,0,32,608,523,204,36,283,85,85,29,0,56,0,0,0,0,57105
19374,27177,1892,6800,9172,6731,2582,1709,807,727,403,77,247,80,68,57,0,11,12,12,0,0,902,756,464,62,230,146,91,80,0,11,55,55,0,0,57106
19375,5341,506,1479,2119,957,280,430,204,150,64,44,42,54,0,0,0,0,54,29,0,25,226,223,102,0,121,3,3,3,0,0,0,0,0,0,57107
19376,12061,254,2012,3407,3886,2502,392,204,178,60,8,110,26,19,19,0,0,7,0,0,7,188,188,79,15,94,0,0,0,0,0,0,0,0,0,57108
19377,8417,802,2297,2783,1943,592,827,415,367,225,0,142,48,28,17,0,11,20,14,0,6,412,395,188,16,191,17,17,17,0,0,0,0,0,0,57110
19378,50,21,29,0,0,0,0,0,0,0,0,0,0,0,0,0,0,0,0,0,0,0,0,0,0,0,0,0,0,0,0,0,0,0,0,57117
19379,15,0,0,14,0,1,389,120,120,33,5,82,0,0,0,0,0,0,0,0,0,269,269,133,14,122,0,0,0,0,0,0,0,0,0,57197
19380,16464,1538,5977,5247,2713,989,1260,622,538,236,14,288,84,40,37,0,3,44,22,19,3,638,585,326,9,250,53,53,53,0,0,0,0,0,0,57201
19381,1357,150,517,426,235,29,87,67,63,0,0,63,4,0,0,0,0,4,0,4,0,20,20,3,0,17,0,0,0,0,0,0,0,0,0,57212
19382,311,27,102,105,64,13,35,22,22,0,9,13,0,0,0,0,0,0,0,0,0,13,13,2,5,6,0,0,0,0,0,0,0,0,0,57213
19383,50,2,26,20,1,1,1,0,0,0,0,0,0,0,0,0,0,0,0,0,0,1,1,1,0,0,0,0,0,0,0,0,0,0,0,57214
19384,754,51,369,253,77,4,62,30,21,13,0,8,9,6,6,0,0,3,0,0,3,32,32,20,0,12,0,0,0,0,0,0,0,0,0,57216
19385,192,13,80,81,11,7,7,2,2,0,0,2,0,0,0,0,0,0,0,0,0,5,5,0,0,5,0,0,0,0,0,0,0,0,0,57217
19386,269,16,88,97,53,15,6,0,0,0,0,0,0,0,0,0,0,0,0,0,0,6,6,4,0,2,0,0,0,0,0,0,0,0,0,57218
19387,488,55,166,213,50,4,17,15,5,2,0,3,10,10,10,0,0,0,0,0,0,2,2,1,0,1,0,0,0,0,0,0,0,0,0,57219
19388,399,20,112,156,103,8,52,18,7,1,0,6,11,11,5,0,6,0,0,0,0,34,31,19,0,12,3,3,0,0,3,0,0,0,0,57220
19389,498,66,253,141,33,5,18,16,16,9,6,1,0,0,0,0,0,0,0,0,0,2,2,2,0,0,0,0,0,0,0,0,0,0,0,57221
19390,901,62,331,280,159,69,81,49,49,17,2,30,0,0,0,0,0,0,0,0,0,32,31,29,0,2,1,1,0,0,1,0,0,0,0,57223
19391,135,11,53,56,15,0,17,15,13,0,0,13,2,0,0,0,0,2,2,0,0,2,2,2,0,0,0,0,0,0,0,0,0,0,0,57224
19392,1234,186,452,395,165,36,56,34,34,31,0,3,0,0,0,0,0,0,0,0,0,22,22,19,0,3,0,0,0,0,0,0,0,0,0,57225
19393,1512,184,591,468,182,87,94,58,52,20,0,32,6,6,0,6,0,0,0,0,0,36,28,10,8,10,8,8,8,0,0,0,0,0,0,57226
19394,247,33,85,69,54,6,0,0,0,0,0,0,0,0,0,0,0,0,0,0,0,0,0,0,0,0,0,0,0,0,0,0,0,0,0,57227
19395,1268,98,461,416,200,93,30,10,4,4,0,0,6,0,0,0,0,6,6,0,0,20,19,0,0,19,1,1,0,1,0,0,0,0,0,57231
19396,210,22,79,63,23,23,23,0,0,0,0,0,0,0,0,0,0,0,0,0,0,23,23,14,0,9,0,0,0,0,0,0,0,0,0,57232
19397,84,3,42,36,1,2,9,0,0,0,0,0,0,0,0,0,0,0,0,0,0,9,9,9,0,0,0,0,0,0,0,0,0,0,0,57233
19398,775,125,280,210,109,51,105,59,45,7,0,38,14,14,14,0,0,0,0,0,0,46,25,17,0,8,21,0,0,0,0,21,0,0,21,57234
19399,686,37,331,216,97,5,45,26,26,6,5,15,0,0,0,0,0,0,0,0,0,19,13,11,0,2,6,2,1,1,0,4,4,0,0,57235
19400,52,7,26,15,4,0,7,0,0,0,0,0,0,0,0,0,0,0,0,0,0,7,4,0,0,4,3,3,0,0,3,0,0,0,0,57236
19401,399,42,173,103,55,26,15,3,3,3,0,0,0,0,0,0,0,0,0,0,0,12,12,12,0,0,0,0,0,0,0,0,0,0,0,57237
19402,249,37,96,91,25,0,38,10,10,10,0,0,0,0,0,0,0,0,0,0,0,28,28,28,0,0,0,0,0,0,0,0,0,0,0,57238
19403,181,43,61,36,34,7,20,7,7,0,0,7,0,0,0,0,0,0,0,0,0,13,13,0,0,13,0,0,0,0,0,0,0,0,0,57239
19404,494,31,219,169,60,15,83,41,41,19,0,22,0,0,0,0,0,0,0,0,0,42,42,13,0,29,0,0,0,0,0,0,0,0,0,57241
19405,168,8,69,46,45,0,8,8,8,5,0,3,0,0,0,0,0,0,0,0,0,0,0,0,0,0,0,0,0,0,0,0,0,0,0,57242
19406,483,43,243,141,56,0,37,17,17,8,0,9,0,0,0,0,0,0,0,0,0,20,18,8,0,10,2,2,0,1,1,0,0,0,0,57243
19407,78,11,25,23,19,0,4,4,4,4,0,0,0,0,0,0,0,0,0,0,0,0,0,0,0,0,0,0,0,0,0,0,0,0,0,57245
19408,106,6,34,52,11,3,20,16,16,12,0,4,0,0,0,0,0,0,0,0,0,4,4,0,0,4,0,0,0,0,0,0,0,0,0,57246
19409,187,25,41,51,38,32,28,21,21,5,0,16,0,0,0,0,0,0,0,0,0,7,7,3,0,4,0,0,0,0,0,0,0,0,0,57247
19410,846,81,393,213,97,62,92,36,36,17,5,14,0,0,0,0,0,0,0,0,0,56,53,49,0,4,3,3,3,0,0,0,0,0,0,57248
19411,682,46,308,195,92,41,49,18,17,8,0,9,1,1,0,0,1,0,0,0,0,31,20,1,0,19,11,11,11,0,0,0,0,0,0,57249
19412,108,35,27,43,1,2,16,9,9,9,0,0,0,0,0,0,0,0,0,0,0,7,3,3,0,0,4,4,0,0,4,0,0,0,0,57251
19413,3228,432,1461,758,513,64,224,95,54,34,0,20,41,41,41,0,0,0,0,0,0,129,63,63,0,0,66,43,43,0,0,23,0,0,23,57252
19414,286,27,117,106,34,2,27,17,17,6,0,11,0,0,0,0,0,0,0,0,0,10,9,0,0,9,1,0,0,0,0,1,0,0,1,57255
19415,72,7,27,21,17,0,0,0,0,0,0,0,0,0,0,0,0,0,0,0,0,0,0,0,0,0,0,0,0,0,0,0,0,0,0,57256
19416,520,77,236,141,34,32,74,21,21,0,0,21,0,0,0,0,0,0,0,0,0,53,29,0,0,29,24,12,12,0,0,12,0,0,12,57257
19417,281,83,110,30,16,42,8,7,7,7,0,0,0,0,0,0,0,0,0,0,0,1,1,0,0,1,0,0,0,0,0,0,0,0,0,57258
19418,350,65,120,89,64,12,38,36,32,10,0,22,4,2,2,0,0,2,0,2,0,2,2,2,0,0,0,0,0,0,0,0,0,0,0,57259
19419,816,79,251,307,100,79,75,49,49,22,9,18,0,0,0,0,0,0,0,0,0,26,24,4,0,20,2,2,0,2,0,0,0,0,0,57260
19420,197,50,94,33,17,3,1,0,0,0,0,0,0,0,0,0,0,0,0,0,0,1,1,1,0,0,0,0,0,0,0,0,0,0,0,57261
19421,3288,404,1261,1100,324,199,222,85,69,12,0,57,16,0,0,0,0,16,0,0,16,137,122,61,7,54,15,15,15,0,0,0,0,0,0,57262
19422,301,60,133,62,37,9,13,5,5,0,0,5,0,0,0,0,0,0,0,0,0,8,8,2,0,6,0,0,0,0,0,0,0,0,0,57263
19423,166,14,121,21,10,0,20,17,17,13,0,4,0,0,0,0,0,0,0,0,0,3,3,0,0,3,0,0,0,0,0,0,0,0,0,57264
19424,155,39,68,24,21,3,20,16,12,0,3,9,4,4,4,0,0,0,0,0,0,4,4,2,0,2,0,0,0,0,0,0,0,0,0,57265
19425,383,87,118,129,40,9,60,28,13,11,0,2,15,6,6,0,0,9,9,0,0,32,32,11,0,21,0,0,0,0,0,0,0,0,0,57266
19426,308,22,130,78,75,3,25,21,21,0,0,21,0,0,0,0,0,0,0,0,0,4,4,0,0,4,0,0,0,0,0,0,0,0,0,57268
19427,355,24,159,134,38,0,15,0,0,0,0,0,0,0,0,0,0,0,0,0,0,15,15,7,0,8,0,0,0,0,0,0,0,0,0,57269
19428,460,82,134,160,60,24,13,13,8,8,0,0,5,0,0,0,0,5,0,4,1,0,0,0,0,0,0,0,0,0,0,0,0,0,0,57270
19429,191,38,65,58,30,0,20,16,9,0,0,9,7,0,0,0,0,7,1,0,6,4,1,0,0,1,3,3,3,0,0,0,0,0,0,57271
19430,112,2,44,40,25,1,5,0,0,0,0,0,0,0,0,0,0,0,0,0,0,5,3,0,0,3,2,0,0,0,0,2,0,0,2,57272
19431,801,83,354,241,79,44,43,21,13,13,0,0,8,3,3,0,0,5,5,0,0,22,19,3,0,16,3,3,3,0,0,0,0,0,0,57273
19432,2033,218,771,657,294,93,149,84,78,43,0,35,6,0,0,0,0,6,6,0,0,65,58,53,0,5,7,3,3,0,0,4,0,0,4,57274
19433,873,123,314,261,151,24,63,17,16,6,0,10,1,1,1,0,0,0,0,0,0,46,46,32,0,14,0,0,0,0,0,0,0,0,0,57276
19434,554,59,198,157,104,36,78,18,7,5,0,2,11,11,11,0,0,0,0,0,0,60,60,30,0,30,0,0,0,0,0,0,0,0,0,57278
19435,738,92,343,173,103,27,53,25,19,8,0,11,6,6,0,6,0,0,0,0,0,28,24,24,0,0,4,0,0,0,0,4,0,0,4,57279
19436,12060,1190,3566,4059,2370,875,1041,613,443,226,31,186,170,103,103,0,0,67,36,10,21,428,385,230,24,131,43,43,30,0,13,0,0,0,0,57301
19437,985,117,320,265,186,97,88,51,26,7,0,19,25,0,0,0,0,25,25,0,0,37,33,7,0,26,4,0,0,0,0,4,0,0,4,57311
19438,292,78,134,59,15,6,29,12,12,7,0,5,0,0,0,0,0,0,0,0,0,17,14,5,0,9,3,0,0,0,0,3,0,0,3,57312
19439,838,112,309,235,138,44,33,17,13,7,0,6,4,4,4,0,0,0,0,0,0,16,16,7,0,9,0,0,0,0,0,0,0,0,0,57313
19440,550,108,198,155,69,20,48,24,21,2,0,19,3,3,0,3,0,0,0,0,0,24,17,2,0,15,7,0,0,0,0,7,0,0,7,57314
19441,719,101,283,180,113,42,51,38,31,11,7,13,7,7,7,0,0,0,0,0,0,13,13,10,0,3,0,0,0,0,0,0,0,0,0,57315
19442,427,56,182,96,80,13,27,4,3,0,0,3,1,1,0,0,1,0,0,0,0,23,20,5,0,15,3,2,0,2,0,1,0,0,1,57317
19443,744,67,249,280,122,26,69,37,35,18,5,12,2,2,0,0,2,0,0,0,0,32,32,3,2,27,0,0,0,0,0,0,0,0,0,57319
19444,260,24,91,104,30,11,11,5,5,5,0,0,0,0,0,0,0,0,0,0,0,6,6,0,0,6,0,0,0,0,0,0,0,0,0,57321
19445,228,20,40,127,37,4,15,12,4,4,0,0,8,8,8,0,0,0,0,0,0,3,3,0,3,0,0,0,0,0,0,0,0,0,0,57322
19446,170,27,47,64,30,2,10,7,0,0,0,0,7,3,3,0,0,4,0,0,4,3,3,0,0,3,0,0,0,0,0,0,0,0,0,57323
19447,268,9,108,75,76,0,12,5,5,3,0,2,0,0,0,0,0,0,0,0,0,7,5,5,0,0,2,2,2,0,0,0,0,0,0,57324
19448,2349,251,820,660,446,172,147,89,50,7,0,43,39,32,0,0,32,7,0,5,2,58,52,10,0,42,6,0,0,0,0,6,6,0,0,57325
19449,812,174,359,194,69,16,75,21,17,5,0,12,4,4,0,4,0,0,0,0,0,54,46,19,0,27,8,7,1,0,6,1,0,0,1,57328
19450,267,38,82,123,24,0,10,10,10,0,0,10,0,0,0,0,0,0,0,0,0,0,0,0,0,0,0,0,0,0,0,0,0,0,0,57329
19451,516,125,158,107,80,46,48,38,26,26,0,0,12,2,0,2,0,10,10,0,0,10,5,0,0,5,5,0,0,0,0,5,0,0,5,57330
19452,413,33,164,139,39,38,63,15,15,3,0,12,0,0,0,0,0,0,0,0,0,48,48,6,0,42,0,0,0,0,0,0,0,0,0,57331
19453,446,39,163,164,54,26,34,9,3,0,0,3,6,0,0,0,0,6,6,0,0,25,23,15,6,2,2,0,0,0,0,2,0,0,2,57332
19454,540,54,242,147,81,16,18,5,5,0,0,5,0,0,0,0,0,0,0,0,0,13,13,8,1,4,0,0,0,0,0,0,0,0,0,57334
19455,216,20,109,60,23,4,5,0,0,0,0,0,0,0,0,0,0,0,0,0,0,5,5,5,0,0,0,0,0,0,0,0,0,0,0,57335
19456,74,6,34,13,16,5,0,0,0,0,0,0,0,0,0,0,0,0,0,0,0,0,0,0,0,0,0,0,0,0,0,0,0,0,0,57337
19457,656,161,267,149,47,32,76,34,34,6,0,28,0,0,0,0,0,0,0,0,0,42,38,0,0,38,4,4,0,0,4,0,0,0,0,57339
19458,228,21,138,41,22,6,11,1,1,1,0,0,0,0,0,0,0,0,0,0,0,10,0,0,0,0,10,0,0,0,0,10,0,0,10,57340
19459,91,4,55,26,0,6,6,0,0,0,0,0,0,0,0,0,0,0,0,0,0,6,6,0,0,6,0,0,0,0,0,0,0,0,0,57341
19460,369,48,127,117,57,20,36,12,12,10,0,2,0,0,0,0,0,0,0,0,0,24,24,0,0,24,0,0,0,0,0,0,0,0,0,57342
19461,128,25,18,36,24,25,4,4,4,0,0,4,0,0,0,0,0,0,0,0,0,0,0,0,0,0,0,0,0,0,0,0,0,0,0,57344
19462,887,88,387,226,159,27,83,56,56,41,0,15,0,0,0,0,0,0,0,0,0,27,22,10,0,12,5,5,5,0,0,0,0,0,0,57345
19463,10,0,2,5,0,3,0,0,0,0,0,0,0,0,0,0,0,0,0,0,0,0,0,0,0,0,0,0,0,0,0,0,0,0,0,57346
19464,402,42,172,100,67,21,9,0,0,0,0,0,0,0,0,0,0,0,0,0,0,9,9,0,0,9,0,0,0,0,0,0,0,0,0,57348
19465,1090,91,475,280,189,55,79,41,39,0,6,33,2,2,2,0,0,0,0,0,0,38,36,6,0,30,2,2,2,0,0,0,0,0,0,57349
19466,9982,1773,3229,3140,1401,439,768,393,302,135,38,129,91,31,31,0,0,60,34,23,3,375,294,210,30,54,81,69,44,0,25,12,12,0,0,57350
19467,541,81,158,162,130,10,42,31,29,5,0,24,2,0,0,0,0,2,0,0,2,11,11,5,0,6,0,0,0,0,0,0,0,0,0,57353
19468,727,102,288,236,93,8,62,26,26,12,0,14,0,0,0,0,0,0,0,0,0,36,36,9,0,27,0,0,0,0,0,0,0,0,0,57355
19469,996,130,360,384,90,32,94,39,34,3,1,30,5,0,0,0,0,5,0,5,0,55,53,9,3,41,2,0,0,0,0,2,0,0,2,57356
19470,26,4,8,0,14,0,13,13,13,13,0,0,0,0,0,0,0,0,0,0,0,0,0,0,0,0,0,0,0,0,0,0,0,0,0,57358
19471,457,24,227,110,63,33,34,25,25,20,0,5,0,0,0,0,0,0,0,0,0,9,9,4,0,5,0,0,0,0,0,0,0,0,0,57359
19472,95,20,20,55,0,0,16,8,8,0,8,0,0,0,0,0,0,0,0,0,0,8,8,8,0,0,0,0,0,0,0,0,0,0,0,57361
19473,1610,192,568,482,295,73,117,69,69,33,4,32,0,0,0,0,0,0,0,0,0,48,46,28,0,18,2,2,2,0,0,0,0,0,0,57362
19474,714,57,212,292,126,27,52,33,31,14,0,17,2,2,0,2,0,0,0,0,0,19,19,15,0,4,0,0,0,0,0,0,0,0,0,57363
19475,43,22,9,12,0,0,13,0,0,0,0,0,0,0,0,0,0,0,0,0,0,13,13,13,0,0,0,0,0,0,0,0,0,0,0,57364
19476,442,37,189,125,61,30,26,17,15,9,0,6,2,0,0,0,0,2,0,0,2,9,2,2,0,0,7,7,0,7,0,0,0,0,0,57365
19477,1596,270,547,463,238,78,139,60,60,46,0,14,0,0,0,0,0,0,0,0,0,79,53,27,0,26,26,7,7,0,0,19,0,0,19,57366
19478,147,4,36,66,33,8,5,0,0,0,0,0,0,0,0,0,0,0,0,0,0,5,5,0,0,5,0,0,0,0,0,0,0,0,0,57367
19479,805,80,304,237,102,82,57,30,30,10,3,17,0,0,0,0,0,0,0,0,0,27,23,16,0,7,4,4,2,2,0,0,0,0,0,57368
19480,1597,256,616,478,172,75,191,59,48,45,1,2,11,4,4,0,0,7,7,0,0,132,101,65,0,36,31,8,0,0,8,23,0,0,23,57369
19481,609,70,233,239,49,18,72,47,40,9,17,14,7,7,0,7,0,0,0,0,0,25,15,9,0,6,10,4,0,4,0,6,0,0,6,57370
19482,98,36,54,8,0,0,0,0,0,0,0,0,0,0,0,0,0,0,0,0,0,0,0,0,0,0,0,0,0,0,0,0,0,0,0,57371
19483,392,45,172,142,14,19,24,11,4,2,0,2,7,0,0,0,0,7,7,0,0,13,13,7,0,6,0,0,0,0,0,0,0,0,0,57373
19484,154,17,68,48,15,6,9,0,0,0,0,0,0,0,0,0,0,0,0,0,0,9,9,3,0,6,0,0,0,0,0,0,0,0,0,57374
19485,464,74,176,150,63,1,23,4,4,1,0,3,0,0,0,0,0,0,0,0,0,19,19,9,0,10,0,0,0,0,0,0,0,0,0,57375
19486,716,142,224,216,113,21,38,24,24,11,0,13,0,0,0,0,0,0,0,0,0,14,9,0,0,9,5,0,0,0,0,5,5,0,0,57376
19487,42,11,17,10,4,0,6,0,0,0,0,0,0,0,0,0,0,0,0,0,0,6,6,0,0,6,0,0,0,0,0,0,0,0,0,57379
19488,2178,341,841,647,255,94,229,123,107,79,0,28,16,13,0,7,6,3,0,0,3,106,90,14,3,73,16,11,11,0,0,5,0,0,5,57380
19489,390,41,175,101,56,17,13,3,3,3,0,0,0,0,0,0,0,0,0,0,0,10,10,5,0,5,0,0,0,0,0,0,0,0,0,57381
19490,1093,139,422,347,127,58,90,64,64,37,0,27,0,0,0,0,0,0,0,0,0,26,24,0,3,21,2,0,0,0,0,2,2,0,0,57382
19491,534,51,244,177,39,23,39,19,17,8,0,9,2,2,2,0,0,0,0,0,0,20,16,13,0,3,4,0,0,0,0,4,0,0,4,57383
19492,604,38,314,148,95,9,30,25,25,9,0,16,0,0,0,0,0,0,0,0,0,5,5,1,0,4,0,0,0,0,0,0,0,0,0,57384
19493,892,80,442,232,114,24,37,23,19,17,0,2,4,2,2,0,0,2,0,0,2,14,14,9,0,5,0,0,0,0,0,0,0,0,0,57385
19494,119,23,44,41,11,0,8,4,4,4,0,0,0,0,0,0,0,0,0,0,0,4,4,4,0,0,0,0,0,0,0,0,0,0,0,57386
19495,19945,1645,6832,5928,3963,1577,1757,768,715,309,21,385,53,44,27,0,17,9,0,0,9,989,875,525,23,327,114,97,36,7,54,17,7,0,10,57401
19496,93,14,28,16,25,10,0,0,0,0,0,0,0,0,0,0,0,0,0,0,0,0,0,0,0,0,0,0,0,0,0,0,0,0,0,57420
19497,48,6,42,0,0,0,9,9,9,9,0,0,0,0,0,0,0,0,0,0,0,0,0,0,0,0,0,0,0,0,0,0,0,0,0,57421
19498,184,25,64,64,29,2,2,2,2,0,0,2,0,0,0,0,0,0,0,0,0,0,0,0,0,0,0,0,0,0,0,0,0,0,0,57422
19499,207,17,94,56,33,7,33,21,15,3,6,6,6,6,2,4,0,0,0,0,0,12,12,3,4,5,0,0,0,0,0,0,0,0,0,57424
19500,51,0,28,15,8,0,0,0,0,0,0,0,0,0,0,0,0,0,0,0,0,0,0,0,0,0,0,0,0,0,0,0,0,0,0,57426
19501,371,24,118,193,30,6,19,7,7,7,0,0,0,0,0,0,0,0,0,0,0,12,6,6,0,0,6,6,6,0,0,0,0,0,0,57427
19502,547,87,246,139,58,17,20,8,8,0,0,8,0,0,0,0,0,0,0,0,0,12,12,7,0,5,0,0,0,0,0,0,0,0,0,57428
19503,67,1,20,29,15,2,0,0,0,0,0,0,0,0,0,0,0,0,0,0,0,0,0,0,0,0,0,0,0,0,0,0,0,0,0,57429
19504,1639,134,582,630,215,78,110,54,54,49,0,5,0,0,0,0,0,0,0,0,0,56,41,21,0,20,15,15,15,0,0,0,0,0,0,57430
19505,406,44,135,135,89,3,22,10,4,0,0,4,6,6,6,0,0,0,0,0,0,12,12,12,0,0,0,0,0,0,0,0,0,0,0,57432
19506,323,13,96,147,47,20,23,6,6,0,0,6,0,0,0,0,0,0,0,0,0,17,17,0,0,17,0,0,0,0,0,0,0,0,0,57433
19507,414,46,144,125,67,32,18,11,11,0,0,11,0,0,0,0,0,0,0,0,0,7,7,7,0,0,0,0,0,0,0,0,0,0,0,57434
19508,192,16,56,83,24,13,21,10,10,0,0,10,0,0,0,0,0,0,0,0,0,11,11,8,0,3,0,0,0,0,0,0,0,0,0,57435
19509,340,38,155,82,52,13,34,23,20,13,0,7,3,3,3,0,0,0,0,0,0,11,8,0,0,8,3,0,0,0,0,3,0,0,3,57436
19510,973,240,241,262,207,23,55,18,18,15,0,3,0,0,0,0,0,0,0,0,0,37,37,16,0,21,0,0,0,0,0,0,0,0,0,57437
19511,931,99,373,303,99,57,48,12,12,1,0,11,0,0,0,0,0,0,0,0,0,36,24,18,0,6,12,12,12,0,0,0,0,0,0,57438
19512,60,0,60,0,0,0,0,0,0,0,0,0,0,0,0,0,0,0,0,0,0,0,0,0,0,0,0,0,0,0,0,0,0,0,0,57439
19513,349,108,95,82,38,26,23,0,0,0,0,0,0,0,0,0,0,0,0,0,0,23,18,5,0,13,5,5,0,0,5,0,0,0,0,57440
19514,505,43,215,151,85,11,51,22,20,1,0,19,2,2,2,0,0,0,0,0,0,29,27,8,0,19,2,2,2,0,0,0,0,0,0,57441
19515,1280,126,478,383,218,75,63,38,21,10,0,11,17,4,4,0,0,13,13,0,0,25,25,7,4,14,0,0,0,0,0,0,0,0,0,57442
19516,1445,75,513,491,304,62,156,103,98,48,0,50,5,5,5,0,0,0,0,0,0,53,53,19,0,34,0,0,0,0,0,0,0,0,0,57445
19517,317,42,116,101,46,12,5,0,0,0,0,0,0,0,0,0,0,0,0,0,0,5,5,0,0,5,0,0,0,0,0,0,0,0,0,57446
19518,290,66,112,99,12,1,11,9,9,7,0,2,0,0,0,0,0,0,0,0,0,2,2,2,0,0,0,0,0,0,0,0,0,0,0,57448
19519,86,9,45,15,17,0,14,0,0,0,0,0,0,0,0,0,0,0,0,0,0,14,14,0,0,14,0,0,0,0,0,0,0,0,0,57449
19520,503,78,240,151,25,9,31,14,14,10,0,4,0,0,0,0,0,0,0,0,0,17,17,1,2,14,0,0,0,0,0,0,0,0,0,57450
19521,1697,139,558,555,288,157,134,74,57,39,4,14,17,17,16,0,1,0,0,0,0,60,51,32,0,19,9,0,0,0,0,9,9,0,0,57451
19522,180,41,76,35,15,13,14,7,7,0,0,7,0,0,0,0,0,0,0,0,0,7,7,7,0,0,0,0,0,0,0,0,0,0,0,57452
19523,417,38,164,137,68,10,46,22,15,0,0,15,7,7,7,0,0,0,0,0,0,24,24,13,0,11,0,0,0,0,0,0,0,0,0,57454
19524,52,7,27,18,0,0,0,0,0,0,0,0,0,0,0,0,0,0,0,0,0,0,0,0,0,0,0,0,0,0,0,0,0,0,0,57455
19525,589,87,168,227,71,36,35,29,11,4,0,7,18,18,18,0,0,0,0,0,0,6,6,0,0,6,0,0,0,0,0,0,0,0,0,57456
19526,47,16,15,10,3,3,12,6,6,0,0,6,0,0,0,0,0,0,0,0,0,6,6,6,0,0,0,0,0,0,0,0,0,0,0,57457
19527,260,19,67,97,56,21,20,11,11,11,0,0,0,0,0,0,0,0,0,0,0,9,9,0,4,5,0,0,0,0,0,0,0,0,0,57460
19528,301,11,95,112,82,1,42,18,15,0,3,12,3,3,3,0,0,0,0,0,0,24,20,0,0,20,4,4,4,0,0,0,0,0,0,57461
19529,256,16,94,74,68,4,23,12,12,0,0,12,0,0,0,0,0,0,0,0,0,11,11,3,0,8,0,0,0,0,0,0,0,0,0,57465
19530,82,4,31,36,11,0,0,0,0,0,0,0,0,0,0,0,0,0,0,0,0,0,0,0,0,0,0,0,0,0,0,0,0,0,0,57466
19531,225,9,130,69,11,6,0,0,0,0,0,0,0,0,0,0,0,0,0,0,0,0,0,0,0,0,0,0,0,0,0,0,0,0,0,57467
19532,149,11,56,54,25,3,15,0,0,0,0,0,0,0,0,0,0,0,0,0,0,15,10,0,0,10,5,0,0,0,0,5,0,0,5,57468
19533,2288,265,916,724,291,92,133,80,80,18,0,62,0,0,0,0,0,0,0,0,0,53,48,30,0,18,5,0,0,0,0,5,0,0,5,57469
19534,93,0,64,26,3,0,0,0,0,0,0,0,0,0,0,0,0,0,0,0,0,0,0,0,0,0,0,0,0,0,0,0,0,0,0,57470
19535,445,60,172,136,69,8,39,14,13,7,0,6,1,1,1,0,0,0,0,0,0,25,20,17,0,3,5,5,5,0,0,0,0,0,0,57471
19536,806,99,349,256,92,10,26,8,8,0,3,5,0,0,0,0,0,0,0,0,0,18,11,8,0,3,7,7,0,7,0,0,0,0,0,57472
19537,148,14,43,36,54,1,23,0,0,0,0,0,0,0,0,0,0,0,0,0,0,23,23,4,9,10,0,0,0,0,0,0,0,0,0,57473
19538,117,7,48,45,17,0,7,7,7,2,0,5,0,0,0,0,0,0,0,0,0,0,0,0,0,0,0,0,0,0,0,0,0,0,0,57474
19539,73,9,23,25,16,0,0,0,0,0,0,0,0,0,0,0,0,0,0,0,0,0,0,0,0,0,0,0,0,0,0,0,0,0,0,57475
19540,272,5,130,87,37,13,40,29,20,10,0,10,9,9,9,0,0,0,0,0,0,11,11,4,0,7,0,0,0,0,0,0,0,0,0,57476
19541,97,6,21,40,25,5,5,5,5,0,0,5,0,0,0,0,0,0,0,0,0,0,0,0,0,0,0,0,0,0,0,0,0,0,0,57477
19542,486,14,169,127,153,23,59,10,10,0,2,8,0,0,0,0,0,0,0,0,0,49,47,34,0,13,2,0,0,0,0,2,2,0,0,57479
19543,428,109,112,111,87,9,13,7,7,7,0,0,0,0,0,0,0,0,0,0,0,6,3,3,0,0,3,3,0,0,3,0,0,0,0,57481
19544,11364,818,2904,3853,2589,1200,823,386,366,189,6,171,20,0,0,0,0,20,16,0,4,437,409,219,82,108,28,28,28,0,0,0,0,0,0,57501
19545,152,39,50,27,33,3,0,0,0,0,0,0,0,0,0,0,0,0,0,0,0,0,0,0,0,0,0,0,0,0,0,0,0,0,0,57520
19546,133,0,31,95,7,0,17,6,6,0,0,6,0,0,0,0,0,0,0,0,0,11,11,0,11,0,0,0,0,0,0,0,0,0,0,57521
19547,329,29,170,94,27,9,6,2,2,0,0,2,0,0,0,0,0,0,0,0,0,4,4,0,0,4,0,0,0,0,0,0,0,0,0,57522
19548,861,64,326,317,130,24,51,29,29,7,0,22,0,0,0,0,0,0,0,0,0,22,22,5,0,17,0,0,0,0,0,0,0,0,0,57523
19549,574,19,219,222,86,28,43,10,10,5,0,5,0,0,0,0,0,0,0,0,0,33,33,22,1,10,0,0,0,0,0,0,0,0,0,57528
19550,381,40,155,109,77,0,49,31,8,0,0,8,23,23,23,0,0,0,0,0,0,18,0,0,0,0,18,18,18,0,0,0,0,0,0,57529
19551,221,30,80,89,20,2,11,6,6,6,0,0,0,0,0,0,0,0,0,0,0,5,5,3,0,2,0,0,0,0,0,0,0,0,0,57531
19552,1961,203,566,643,339,210,139,55,42,39,3,0,13,8,8,0,0,5,5,0,0,84,80,57,3,20,4,0,0,0,0,4,0,0,4,57532
19553,1341,219,453,404,196,69,26,11,8,7,0,1,3,3,0,0,3,0,0,0,0,15,11,4,0,7,4,4,4,0,0,0,0,0,0,57533
19554,108,40,11,17,34,6,0,0,0,0,0,0,0,0,0,0,0,0,0,0,0,0,0,0,0,0,0,0,0,0,0,0,0,0,0,57534
19555,444,98,192,113,37,4,64,33,19,2,0,17,14,12,0,12,0,2,0,0,2,31,14,0,0,14,17,17,9,8,0,0,0,0,0,57536
19556,123,0,68,27,0,28,0,0,0,0,0,0,0,0,0,0,0,0,0,0,0,0,0,0,0,0,0,0,0,0,0,0,0,0,0,57537
19557,186,42,86,43,15,0,2,2,2,0,0,2,0,0,0,0,0,0,0,0,0,0,0,0,0,0,0,0,0,0,0,0,0,0,0,57538
19558,66,11,33,15,7,0,7,4,4,0,0,4,0,0,0,0,0,0,0,0,0,3,3,0,0,3,0,0,0,0,0,0,0,0,0,57540
19559,39,12,7,20,0,0,2,2,2,0,0,2,0,0,0,0,0,0,0,0,0,0,0,0,0,0,0,0,0,0,0,0,0,0,0,57541
19560,746,45,273,243,147,38,25,12,12,5,0,7,0,0,0,0,0,0,0,0,0,13,13,6,0,7,0,0,0,0,0,0,0,0,0,57543
19561,300,19,123,81,73,4,31,27,22,8,0,14,5,5,5,0,0,0,0,0,0,4,4,0,0,4,0,0,0,0,0,0,0,0,0,57544
19562,165,0,32,95,35,3,9,0,0,0,0,0,0,0,0,0,0,0,0,0,0,9,9,0,0,9,0,0,0,0,0,0,0,0,0,57547
19563,700,149,211,290,37,13,119,67,54,0,6,48,13,7,0,0,7,6,4,0,2,52,27,3,6,18,25,7,5,2,0,18,4,11,3,57548
19564,1227,187,360,438,149,93,122,71,58,12,0,46,13,3,3,0,0,10,0,2,8,51,38,9,0,29,13,13,13,0,0,0,0,0,0,57551
19565,382,12,154,141,69,6,23,18,12,12,0,0,6,6,3,3,0,0,0,0,0,5,2,1,0,1,3,0,0,0,0,3,0,0,3,57552
19566,179,18,56,72,24,9,31,28,28,0,0,28,0,0,0,0,0,0,0,0,0,3,3,0,0,3,0,0,0,0,0,0,0,0,0,57553
19567,1872,527,438,648,158,101,162,76,60,21,10,29,16,0,0,0,0,16,0,16,0,86,81,18,17,46,5,5,0,5,0,0,0,0,0,57555
19568,418,24,158,148,77,11,18,2,2,0,0,2,0,0,0,0,0,0,0,0,0,16,16,3,11,2,0,0,0,0,0,0,0,0,0,57559
19569,167,34,82,35,16,0,26,18,18,5,9,4,0,0,0,0,0,0,0,0,0,8,3,0,0,3,5,0,0,0,0,5,0,0,5,57560
19570,35,0,14,21,0,0,1,0,0,0,0,0,0,0,0,0,0,0,0,0,0,1,1,0,0,1,0,0,0,0,0,0,0,0,0,57562
19571,143,37,25,55,26,0,7,0,0,0,0,0,0,0,0,0,0,0,0,0,0,7,7,0,7,0,0,0,0,0,0,0,0,0,0,57563
19572,663,26,266,146,185,40,71,39,31,14,0,17,8,1,1,0,0,7,0,6,1,32,27,15,5,7,5,0,0,0,0,5,5,0,0,57564
19573,654,100,155,339,60,0,43,0,0,0,0,0,0,0,0,0,0,0,0,0,0,43,39,0,0,39,4,4,0,4,0,0,0,0,0,57566
19574,887,73,329,303,146,36,41,12,12,12,0,0,0,0,0,0,0,0,0,0,0,29,29,6,0,23,0,0,0,0,0,0,0,0,0,57567
19575,468,28,186,140,69,45,14,2,2,0,0,2,0,0,0,0,0,0,0,0,0,12,5,0,0,5,7,0,0,0,0,7,7,0,0,57568
19576,227,8,92,58,47,22,36,19,19,14,0,5,0,0,0,0,0,0,0,0,0,17,17,12,0,5,0,0,0,0,0,0,0,0,0,57569
19577,976,189,266,390,104,27,186,81,56,8,0,48,25,0,0,0,0,25,0,25,0,105,61,13,25,23,44,12,0,0,12,32,0,5,27,57570
19578,23,11,10,2,0,0,0,0,0,0,0,0,0,0,0,0,0,0,0,0,0,0,0,0,0,0,0,0,0,0,0,0,0,0,0,57571
19579,872,200,262,359,43,8,239,161,111,27,2,82,50,33,3,30,0,17,0,0,17,78,63,12,0,51,15,0,0,0,0,15,0,2,13,57572
19580,68,0,14,31,23,0,8,0,0,0,0,0,0,0,0,0,0,0,0,0,0,8,0,0,0,0,8,8,8,0,0,0,0,0,0,57574
19581,100,13,19,41,13,14,13,13,13,6,0,7,0,0,0,0,0,0,0,0,0,0,0,0,0,0,0,0,0,0,0,0,0,0,0,57576
19582,463,62,146,201,45,9,72,27,24,3,12,9,3,3,3,0,0,0,0,0,0,45,38,0,0,38,7,0,0,0,0,7,0,0,7,57577
19583,840,133,265,294,114,34,81,35,35,7,0,28,0,0,0,0,0,0,0,0,0,46,36,0,12,24,10,7,0,7,0,3,3,0,0,57579
19584,3039,457,958,993,513,118,126,60,57,23,3,31,3,3,0,0,3,0,0,0,0,66,27,25,0,2,39,20,0,20,0,19,0,0,19,57580
19585,50,5,27,9,5,4,0,0,0,0,0,0,0,0,0,0,0,0,0,0,0,0,0,0,0,0,0,0,0,0,0,0,0,0,0,57584
19586,212,7,73,98,32,2,10,0,0,0,0,0,0,0,0,0,0,0,0,0,0,10,10,0,0,10,0,0,0,0,0,0,0,0,0,57585
19587,2832,351,1005,807,523,146,133,57,57,40,0,17,0,0,0,0,0,0,0,0,0,76,70,46,0,24,6,0,0,0,0,6,0,0,6,57601
19588,370,42,161,111,52,4,11,3,3,0,0,3,0,0,0,0,0,0,0,0,0,8,8,0,0,8,0,0,0,0,0,0,0,0,0,57620
19589,211,45,96,45,23,2,55,25,22,0,0,22,3,3,0,0,3,0,0,0,0,30,10,0,0,10,20,0,0,0,0,20,0,3,17,57621
19590,130,46,41,40,3,0,14,6,0,0,0,0,6,6,0,6,0,0,0,0,0,8,8,0,0,8,0,0,0,0,0,0,0,0,0,57622
19591,605,92,198,179,102,34,97,49,41,5,5,31,8,8,0,3,5,0,0,0,0,48,48,9,0,39,0,0,0,0,0,0,0,0,0,57623
19592,2202,396,871,691,164,80,301,121,98,7,5,86,23,6,3,3,0,17,0,10,7,180,118,9,18,91,62,29,5,19,5,33,0,22,11,57625
19593,627,84,209,237,63,34,47,26,23,14,0,9,3,1,1,0,0,2,0,2,0,21,12,1,0,11,9,9,0,4,5,0,0,0,0,57626
19594,46,0,31,12,0,3,0,0,0,0,0,0,0,0,0,0,0,0,0,0,0,0,0,0,0,0,0,0,0,0,0,0,0,0,0,57630
19595,227,22,92,46,52,15,24,20,20,11,0,9,0,0,0,0,0,0,0,0,0,4,4,4,0,0,0,0,0,0,0,0,0,0,0,57631
19596,462,65,210,127,49,11,48,26,16,4,3,9,10,10,10,0,0,0,0,0,0,22,22,5,0,17,0,0,0,0,0,0,0,0,0,57632
19597,344,41,111,115,51,26,27,10,10,4,0,6,0,0,0,0,0,0,0,0,0,17,15,7,0,8,2,0,0,0,0,2,0,0,2,57633
19598,45,13,4,0,28,0,14,7,7,0,0,7,0,0,0,0,0,0,0,0,0,7,7,0,0,7,0,0,0,0,0,0,0,0,0,57634
19599,46,5,15,26,0,0,0,0,0,0,0,0,0,0,0,0,0,0,0,0,0,0,0,0,0,0,0,0,0,0,0,0,0,0,0,57636
19600,1486,243,571,422,192,58,63,25,21,3,0,18,4,4,4,0,0,0,0,0,0,38,35,13,0,22,3,0,0,0,0,3,0,0,3,57638
19601,177,31,50,96,0,0,21,15,3,0,0,3,12,0,0,0,0,12,0,12,0,6,6,0,0,6,0,0,0,0,0,0,0,0,0,57639
19602,163,3,44,71,21,24,8,8,0,0,0,0,8,8,8,0,0,0,0,0,0,0,0,0,0,0,0,0,0,0,0,0,0,0,0,57640
19603,212,23,78,51,41,19,13,13,13,2,8,3,0,0,0,0,0,0,0,0,0,0,0,0,0,0,0,0,0,0,0,0,0,0,0,57641
19604,1059,226,278,412,80,63,141,68,53,8,3,42,15,0,0,0,0,15,0,4,11,73,48,4,9,35,25,8,0,8,0,17,0,8,9,57642
19605,137,7,50,51,22,7,7,7,7,0,0,7,0,0,0,0,0,0,0,0,0,0,0,0,0,0,0,0,0,0,0,0,0,0,0,57644
19606,146,13,51,59,20,3,9,7,5,5,0,0,2,2,2,0,0,0,0,0,0,2,2,0,0,2,0,0,0,0,0,0,0,0,0,57645
19607,174,18,68,35,49,4,15,3,2,2,0,0,1,1,1,0,0,0,0,0,0,12,12,12,0,0,0,0,0,0,0,0,0,0,0,57646
19608,231,46,101,58,25,1,2,2,2,1,0,1,0,0,0,0,0,0,0,0,0,0,0,0,0,0,0,0,0,0,0,0,0,0,0,57648
19609,175,3,71,56,33,12,19,0,0,0,0,0,0,0,0,0,0,0,0,0,0,19,19,4,0,15,0,0,0,0,0,0,0,0,0,57649
19610,68,0,14,20,22,12,0,0,0,0,0,0,0,0,0,0,0,0,0,0,0,0,0,0,0,0,0,0,0,0,0,0,0,0,0,57650
19611,95,9,28,32,23,3,6,0,0,0,0,0,0,0,0,0,0,0,0,0,0,6,6,3,0,3,0,0,0,0,0,0,0,0,0,57651
19612,188,35,76,35,7,35,26,16,6,0,0,6,10,0,0,0,0,10,0,0,10,10,5,0,0,5,5,0,0,0,0,5,0,0,5,57652
19613,469,86,159,135,56,33,27,21,19,1,5,13,2,0,0,0,0,2,2,0,0,6,6,5,0,1,0,0,0,0,0,0,0,0,0,57656
19614,163,13,67,67,13,3,9,4,0,0,0,0,4,0,0,0,0,4,0,0,4,5,5,0,0,5,0,0,0,0,0,0,0,0,0,57657
19615,197,24,104,56,10,3,19,12,12,0,0,12,0,0,0,0,0,0,0,0,0,7,7,0,0,7,0,0,0,0,0,0,0,0,0,57658
19616,53,2,29,15,5,2,9,6,6,6,0,0,0,0,0,0,0,0,0,0,0,3,3,0,1,2,0,0,0,0,0,0,0,0,0,57660
19617,53,11,11,18,13,0,18,18,0,0,0,0,18,18,0,0,18,0,0,0,0,0,0,0,0,0,0,0,0,0,0,0,0,0,0,57661
19618,27946,3145,8683,10248,4065,1805,2129,1182,1033,332,128,573,149,102,74,21,7,47,0,0,47,947,700,308,137,255,247,195,154,24,17,52,24,0,28,57701
19619,23905,1057,5197,7748,6130,3773,1467,731,598,233,43,322,133,106,77,29,0,27,0,0,27,736,678,418,27,233,58,33,18,15,0,25,0,18,7,57702
19620,9106,674,2845,3762,1302,523,922,463,425,140,39,246,38,37,25,0,12,1,0,0,1,459,343,163,24,156,116,64,42,22,0,52,41,0,11,57703
19621,834,19,210,523,54,28,137,113,14,4,4,6,99,99,99,0,0,0,0,0,0,24,3,0,0,3,21,21,17,0,4,0,0,0,0,57706
19622,423,187,92,128,16,0,102,61,61,6,0,55,0,0,0,0,0,0,0,0,0,41,41,0,0,41,0,0,0,0,0,0,0,0,0,57714
19623,253,33,59,134,27,0,28,9,9,0,0,9,0,0,0,0,0,0,0,0,0,19,9,0,9,0,10,8,0,0,8,2,0,0,2,57716
19624,5075,606,1730,1866,684,189,359,175,147,49,9,89,28,14,14,0,0,14,0,0,14,184,72,38,0,34,112,81,81,0,0,31,30,0,1,57717
19625,4667,251,1322,2169,714,211,507,238,208,83,32,93,30,27,27,0,0,3,0,3,0,269,227,161,39,27,42,24,2,0,22,18,0,7,11,57718
19626,4202,598,1407,1538,350,309,289,138,51,5,22,24,87,70,70,0,0,17,4,0,13,151,127,23,16,88,24,24,8,10,6,0,0,0,0,57719
19627,411,37,113,130,104,27,38,14,14,6,0,8,0,0,0,0,0,0,0,0,0,24,22,8,0,14,2,0,0,0,0,2,2,0,0,57720
19628,366,25,203,45,69,24,17,15,15,0,0,15,0,0,0,0,0,0,0,0,0,2,2,0,0,2,0,0,0,0,0,0,0,0,0,57722
19629,140,16,30,26,52,16,29,26,21,4,4,13,5,5,5,0,0,0,0,0,0,3,3,0,0,3,0,0,0,0,0,0,0,0,0,57724
19630,90,17,3,41,9,20,7,7,7,3,4,0,0,0,0,0,0,0,0,0,0,0,0,0,0,0,0,0,0,0,0,0,0,0,0,57725
19631,4359,282,1127,1672,861,417,281,125,91,1,15,75,34,22,8,14,0,12,0,0,12,156,151,54,0,97,5,5,0,5,0,0,0,0,0,57730
19632,1790,120,686,665,235,84,88,27,14,7,0,7,13,8,8,0,0,5,0,0,5,61,57,35,0,22,4,4,0,0,4,0,0,0,0,57732
19633,1205,131,557,391,88,38,30,9,9,0,0,9,0,0,0,0,0,0,0,0,0,21,14,14,0,0,7,0,0,0,0,7,7,0,0,57735
19634,57,5,23,13,16,0,4,4,4,0,0,4,0,0,0,0,0,0,0,0,0,0,0,0,0,0,0,0,0,0,0,0,0,0,0,57738
19635,67,11,23,11,22,0,1,1,0,0,0,0,1,1,1,0,0,0,0,0,0,0,0,0,0,0,0,0,0,0,0,0,0,0,0,57741
19636,1327,127,332,620,161,87,77,34,29,16,0,13,5,5,5,0,0,0,0,0,0,43,38,8,0,30,5,5,5,0,0,0,0,0,0,57744
19637,1566,147,480,557,261,121,112,67,58,2,7,49,9,9,9,0,0,0,0,0,0,45,41,1,0,40,4,0,0,0,0,4,4,0,0,57745
19638,4095,340,1163,1496,760,336,222,130,82,42,23,17,48,11,0,0,11,37,37,0,0,92,92,76,0,16,0,0,0,0,0,0,0,0,0,57747
19639,197,37,79,41,13,27,29,10,10,0,0,10,0,0,0,0,0,0,0,0,0,19,11,0,0,11,8,8,0,0,8,0,0,0,0,57748
19640,274,72,84,87,30,1,56,35,12,0,0,12,23,0,0,0,0,23,0,23,0,21,21,0,0,21,0,0,0,0,0,0,0,0,0,57750
19641,543,51,164,205,79,44,37,15,9,3,0,6,6,6,6,0,0,0,0,0,0,22,22,18,0,4,0,0,0,0,0,0,0,0,0,57751
19642,949,217,223,358,146,5,216,122,70,0,2,68,52,20,10,0,10,32,0,18,14,94,85,0,9,76,9,9,0,0,9,0,0,0,0,57752
19643,2604,165,1065,796,488,90,118,49,47,6,0,41,2,2,2,0,0,0,0,0,0,69,61,12,0,49,8,7,0,7,0,1,0,0,1,57754
19644,70,3,46,0,13,8,19,4,4,0,0,4,0,0,0,0,0,0,0,0,0,15,12,0,0,12,3,0,0,0,0,3,3,0,0,57755
19645,580,131,176,258,15,0,34,34,24,0,0,24,10,0,0,0,0,10,0,0,10,0,0,0,0,0,0,0,0,0,0,0,0,0,0,57756
19646,130,6,56,42,26,0,0,0,0,0,0,0,0,0,0,0,0,0,0,0,0,0,0,0,0,0,0,0,0,0,0,0,0,0,0,57758
19647,269,20,81,64,86,18,164,124,105,35,9,61,19,19,12,0,7,0,0,0,0,40,34,25,0,9,6,6,6,0,0,0,0,0,0,57759
19648,1097,145,420,331,146,55,81,17,15,4,0,11,2,2,2,0,0,0,0,0,0,64,64,11,0,53,0,0,0,0,0,0,0,0,0,57760
19649,813,78,294,339,79,23,48,30,30,17,0,13,0,0,0,0,0,0,0,0,0,18,18,14,0,4,0,0,0,0,0,0,0,0,0,57761
19650,421,72,116,160,59,14,46,15,15,0,0,15,0,0,0,0,0,0,0,0,0,31,18,0,0,18,13,0,0,0,0,13,13,0,0,57762
19651,239,33,96,76,30,4,10,6,4,4,0,0,2,2,2,0,0,0,0,0,0,4,4,4,0,0,0,0,0,0,0,0,0,0,0,57763
19652,811,234,149,372,42,14,188,38,24,0,0,24,14,0,0,0,0,14,0,0,14,150,117,0,0,117,33,16,16,0,0,17,0,0,17,57764
19653,212,19,80,67,35,11,0,0,0,0,0,0,0,0,0,0,0,0,0,0,0,0,0,0,0,0,0,0,0,0,0,0,0,0,0,57766
19654,106,8,20,39,30,9,3,0,0,0,0,0,0,0,0,0,0,0,0,0,0,3,3,0,0,3,0,0,0,0,0,0,0,0,0,57767
19655,2313,86,856,680,530,161,123,23,8,0,0,8,15,15,15,0,0,0,0,0,0,100,100,67,0,33,0,0,0,0,0,0,0,0,0,57769
19656,2625,351,870,984,309,111,573,260,210,16,43,151,50,38,6,12,20,12,0,0,12,313,233,40,26,167,80,9,0,0,9,71,0,0,71,57770
19657,958,221,328,311,66,32,116,38,30,0,6,24,8,0,0,0,0,8,0,0,8,78,78,12,0,66,0,0,0,0,0,0,0,0,0,57772
19658,277,2,81,69,104,21,66,65,65,65,0,0,0,0,0,0,0,0,0,0,0,1,1,0,0,1,0,0,0,0,0,0,0,0,0,57773
19659,222,6,101,106,8,1,39,23,23,12,0,11,0,0,0,0,0,0,0,0,0,16,12,7,0,5,4,0,0,0,0,4,0,0,4,57775
19660,0,0,0,0,0,0,0,0,0,0,0,0,0,0,0,0,0,0,0,0,0,0,0,0,0,0,0,0,0,0,0,0,0,0,0,57776
19661,185,22,63,25,75,0,0,0,0,0,0,0,0,0,0,0,0,0,0,0,0,0,0,0,0,0,0,0,0,0,0,0,0,0,0,57779
19662,104,15,43,37,3,6,6,3,3,3,0,0,0,0,0,0,0,0,0,0,0,3,3,3,0,0,0,0,0,0,0,0,0,0,0,57780
19663,56,4,22,13,14,3,3,0,0,0,0,0,0,0,0,0,0,0,0,0,0,3,3,0,0,3,0,0,0,0,0,0,0,0,0,57782
19664,9608,664,2625,3115,2116,1088,710,395,338,166,1,171,57,21,16,5,0,36,11,0,25,315,242,109,36,97,73,56,56,0,0,17,0,0,17,57783
19665,6553,640,2389,2256,880,388,521,208,173,97,0,76,35,10,10,0,0,25,21,0,4,313,245,102,13,130,68,68,68,0,0,0,0,0,0,57785
19666,256,14,175,16,51,0,0,0,0,0,0,0,0,0,0,0,0,0,0,0,0,0,0,0,0,0,0,0,0,0,0,0,0,0,0,57787
19667,422,68,230,91,27,6,31,31,0,0,0,0,31,0,0,0,0,31,0,31,0,0,0,0,0,0,0,0,0,0,0,0,0,0,0,57788
19668,802,23,278,304,159,38,81,33,31,10,0,21,2,2,2,0,0,0,0,0,0,48,37,30,0,7,11,9,9,0,0,2,2,0,0,57790
19669,152,2,81,41,25,3,22,22,0,0,0,0,22,22,22,0,0,0,0,0,0,0,0,0,0,0,0,0,0,0,0,0,0,0,0,57791
19670,50,0,19,31,0,0,8,8,8,0,0,8,0,0,0,0,0,0,0,0,0,0,0,0,0,0,0,0,0,0,0,0,0,0,0,57792
19671,1453,61,707,391,187,107,152,127,121,58,0,63,6,6,6,0,0,0,0,0,0,25,17,13,4,0,8,6,6,0,0,2,0,0,2,57793
19672,566,217,198,147,4,0,68,58,33,0,0,33,25,16,0,0,16,9,0,9,0,10,0,0,0,0,10,0,0,0,0,10,0,0,10,57794
19673,10,0,0,5,0,5,394,147,147,59,17,71,0,0,0,0,0,0,0,0,0,247,247,106,25,116,0,0,0,0,0,0,0,0,0,57799
19674,67,1,18,34,14,0,5,3,3,0,0,3,0,0,0,0,0,0,0,0,0,2,2,0,0,2,0,0,0,0,0,0,0,0,0,58001
19675,18,0,0,18,0,0,0,0,0,0,0,0,0,0,0,0,0,0,0,0,0,0,0,0,0,0,0,0,0,0,0,0,0,0,0,58002
19676,147,7,61,31,48,0,40,25,25,6,0,19,0,0,0,0,0,0,0,0,0,15,15,7,0,8,0,0,0,0,0,0,0,0,0,58004
19677,431,26,117,143,104,41,25,16,16,2,0,14,0,0,0,0,0,0,0,0,0,9,9,3,0,6,0,0,0,0,0,0,0,0,0,58005
19678,333,16,69,124,93,31,8,4,4,2,0,2,0,0,0,0,0,0,0,0,0,4,3,1,0,2,1,1,1,0,0,0,0,0,0,58006
19679,43,1,5,22,4,11,0,0,0,0,0,0,0,0,0,0,0,0,0,0,0,0,0,0,0,0,0,0,0,0,0,0,0,0,0,58007
19680,207,7,82,71,39,8,14,2,2,1,0,1,0,0,0,0,0,0,0,0,0,12,12,7,0,5,0,0,0,0,0,0,0,0,0,58008
19681,14,8,0,6,0,0,0,0,0,0,0,0,0,0,0,0,0,0,0,0,0,0,0,0,0,0,0,0,0,0,0,0,0,0,0,58009
19682,277,7,91,116,51,12,10,2,2,2,0,0,0,0,0,0,0,0,0,0,0,8,8,8,0,0,0,0,0,0,0,0,0,0,0,58011
19683,1653,92,445,609,339,168,198,133,133,75,0,58,0,0,0,0,0,0,0,0,0,65,65,18,7,40,0,0,0,0,0,0,0,0,0,58012
19684,91,8,49,27,7,0,10,6,6,0,0,6,0,0,0,0,0,0,0,0,0,4,4,0,0,4,0,0,0,0,0,0,0,0,0,58013
19685,220,22,58,84,43,13,10,10,10,4,0,6,0,0,0,0,0,0,0,0,0,0,0,0,0,0,0,0,0,0,0,0,0,0,0,58015
19686,84,0,19,18,47,0,4,4,4,0,0,4,0,0,0,0,0,0,0,0,0,0,0,0,0,0,0,0,0,0,0,0,0,0,0,58016
19687,263,48,108,64,41,2,14,4,4,0,0,4,0,0,0,0,0,0,0,0,0,10,10,4,0,6,0,0,0,0,0,0,0,0,0,58017
19688,212,12,46,92,48,14,6,0,0,0,0,0,0,0,0,0,0,0,0,0,0,6,6,0,0,6,0,0,0,0,0,0,0,0,0,58018
19689,274,8,94,133,27,12,38,24,24,20,0,4,0,0,0,0,0,0,0,0,0,14,14,4,0,10,0,0,0,0,0,0,0,0,0,58021
19690,892,105,284,378,99,26,36,17,12,12,0,0,5,2,0,2,0,3,0,3,0,19,19,6,4,9,0,0,0,0,0,0,0,0,0,58027
19691,113,18,33,44,18,0,17,12,12,0,0,12,0,0,0,0,0,0,0,0,0,5,5,5,0,0,0,0,0,0,0,0,0,0,0,58029
19692,366,20,155,142,44,5,24,11,11,7,0,4,0,0,0,0,0,0,0,0,0,13,10,2,1,7,3,3,3,0,0,0,0,0,0,58030
19693,296,17,88,131,52,8,5,4,2,2,0,0,2,2,0,0,2,0,0,0,0,1,1,0,1,0,0,0,0,0,0,0,0,0,0,58031
19694,553,58,194,201,87,13,25,25,25,11,0,14,0,0,0,0,0,0,0,0,0,0,0,0,0,0,0,0,0,0,0,0,0,0,0,58032
19695,349,10,185,100,33,21,36,25,22,19,0,3,3,0,0,0,0,3,3,0,0,11,11,0,0,11,0,0,0,0,0,0,0,0,0,58033
19696,131,8,29,70,23,1,4,4,4,0,0,4,0,0,0,0,0,0,0,0,0,0,0,0,0,0,0,0,0,0,0,0,0,0,0,58035
19697,206,13,50,97,46,0,16,9,9,5,0,4,0,0,0,0,0,0,0,0,0,7,7,3,0,4,0,0,0,0,0,0,0,0,0,58036
19698,240,9,107,84,33,7,13,4,4,2,0,2,0,0,0,0,0,0,0,0,0,9,9,2,0,7,0,0,0,0,0,0,0,0,0,58038
19699,588,62,204,216,86,20,41,24,20,7,0,13,4,4,2,2,0,0,0,0,0,17,17,10,0,7,0,0,0,0,0,0,0,0,0,58040
19700,1229,189,455,435,123,27,84,32,32,22,0,10,0,0,0,0,0,0,0,0,0,52,52,30,3,19,0,0,0,0,0,0,0,0,0,58041
19701,996,39,239,453,213,52,112,69,65,42,0,23,4,4,4,0,0,0,0,0,0,43,43,22,0,21,0,0,0,0,0,0,0,0,0,58042
19702,133,24,55,41,13,0,9,3,3,3,0,0,0,0,0,0,0,0,0,0,0,6,6,1,0,5,0,0,0,0,0,0,0,0,0,58043
19703,1622,145,378,618,353,128,117,87,80,58,0,22,7,7,7,0,0,0,0,0,0,30,28,0,0,28,2,2,0,0,2,0,0,0,0,58045
19704,401,38,131,177,52,3,32,19,19,5,0,14,0,0,0,0,0,0,0,0,0,13,13,9,0,4,0,0,0,0,0,0,0,0,0,58046
19705,2283,86,438,752,658,349,157,101,88,37,4,47,13,8,3,5,0,5,0,0,5,56,54,38,2,14,2,0,0,0,0,2,0,0,2,58047
19706,373,16,70,178,85,24,35,13,13,3,0,10,0,0,0,0,0,0,0,0,0,22,22,16,0,6,0,0,0,0,0,0,0,0,0,58048
19707,210,22,91,76,11,10,10,8,8,0,0,8,0,0,0,0,0,0,0,0,0,2,2,0,0,2,0,0,0,0,0,0,0,0,0,58049
19708,928,34,248,427,199,20,67,40,26,12,0,14,14,14,14,0,0,0,0,0,0,27,27,2,0,25,0,0,0,0,0,0,0,0,0,58051
19709,468,17,159,188,94,10,27,19,15,7,0,8,4,4,0,0,4,0,0,0,0,8,8,2,0,6,0,0,0,0,0,0,0,0,0,58052
19710,951,126,386,289,118,32,91,52,50,26,2,22,2,2,2,0,0,0,0,0,0,39,27,14,0,13,12,12,12,0,0,0,0,0,0,58053
19711,2162,258,706,843,297,58,233,113,108,53,7,48,5,5,5,0,0,0,0,0,0,120,112,112,0,0,8,0,0,0,0,8,0,0,8,58054
19712,162,1,73,29,59,0,4,0,0,0,0,0,0,0,0,0,0,0,0,0,0,4,4,0,0,4,0,0,0,0,0,0,0,0,0,58056
19713,109,7,32,21,46,3,0,0,0,0,0,0,0,0,0,0,0,0,0,0,0,0,0,0,0,0,0,0,0,0,0,0,0,0,0,58057
19714,84,3,57,22,2,0,0,0,0,0,0,0,0,0,0,0,0,0,0,0,0,0,0,0,0,0,0,0,0,0,0,0,0,0,0,58058
19715,745,29,207,333,157,19,78,50,41,10,0,31,9,3,0,0,3,6,0,2,4,28,27,11,4,12,1,1,1,0,0,0,0,0,0,58059
19716,897,135,276,312,138,36,45,39,37,5,0,32,2,0,0,0,0,2,0,2,0,6,6,2,0,4,0,0,0,0,0,0,0,0,0,58060
19717,239,8,39,125,51,16,52,13,13,6,0,7,0,0,0,0,0,0,0,0,0,39,39,4,0,35,0,0,0,0,0,0,0,0,0,58061
19718,147,12,61,62,1,11,8,6,0,0,0,0,6,0,0,0,0,6,0,0,6,2,2,1,1,0,0,0,0,0,0,0,0,0,0,58062
19719,232,14,64,114,34,6,18,12,12,0,0,12,0,0,0,0,0,0,0,0,0,6,5,1,0,4,1,0,0,0,0,1,1,0,0,58063
19720,296,38,61,120,71,6,7,1,1,1,0,0,0,0,0,0,0,0,0,0,0,6,6,4,0,2,0,0,0,0,0,0,0,0,0,58064
19721,40,15,16,9,0,0,0,0,0,0,0,0,0,0,0,0,0,0,0,0,0,0,0,0,0,0,0,0,0,0,0,0,0,0,0,58065
19722,179,17,79,54,19,10,15,7,7,2,0,5,0,0,0,0,0,0,0,0,0,8,8,3,0,5,0,0,0,0,0,0,0,0,0,58067
19723,281,53,113,77,35,3,44,5,5,3,0,2,0,0,0,0,0,0,0,0,0,39,39,8,0,31,0,0,0,0,0,0,0,0,0,58068
19724,84,6,23,31,20,4,8,2,2,0,0,2,0,0,0,0,0,0,0,0,0,6,6,0,0,6,0,0,0,0,0,0,0,0,0,58069
19725,304,16,88,154,41,5,23,12,12,8,0,4,0,0,0,0,0,0,0,0,0,11,9,8,0,1,2,0,0,0,0,2,2,0,0,58071
19726,5572,640,1777,1496,1265,394,553,247,247,98,0,149,0,0,0,0,0,0,0,0,0,306,232,136,0,96,74,74,65,9,0,0,0,0,0,58072
19727,5639,556,1224,2621,812,426,748,424,373,146,7,220,51,31,5,10,16,20,0,0,20,324,265,84,8,173,59,58,44,0,14,1,0,0,1,58075
19728,16,0,1,15,0,0,177,134,134,55,17,62,0,0,0,0,0,0,0,0,0,43,43,21,7,15,0,0,0,0,0,0,0,0,0,58076
19729,479,55,130,174,104,16,13,11,11,2,0,9,0,0,0,0,0,0,0,0,0,2,2,1,0,1,0,0,0,0,0,0,0,0,0,58077
19730,17962,1045,3669,7200,4702,1346,1491,930,872,409,0,463,58,58,0,23,35,0,0,0,0,561,421,160,1,260,140,122,122,0,0,18,0,0,18,58078
19731,379,34,83,94,118,50,11,11,11,0,0,11,0,0,0,0,0,0,0,0,0,0,0,0,0,0,0,0,0,0,0,0,0,0,0,58079
19732,555,69,148,210,116,12,61,23,16,3,0,13,7,7,0,0,7,0,0,0,0,38,25,13,0,12,13,13,0,0,13,0,0,0,0,58081
19733,18216,1001,4005,5750,4784,2676,2440,1043,977,389,56,532,66,52,15,37,0,14,0,0,14,1397,1274,700,144,430,123,90,49,31,10,33,16,17,0,58102
19734,30606,2057,6783,11937,6901,2928,1778,964,680,383,63,234,284,230,193,24,13,54,22,12,20,814,648,313,27,308,166,159,116,37,6,7,0,7,0,58103
19735,18300,540,2477,6259,6036,2988,1185,443,402,100,1,301,41,41,0,41,0,0,0,0,0,742,693,334,38,321,49,1,1,0,0,48,20,28,0,58104
19736,25,0,0,12,7,6,1544,954,954,240,67,647,0,0,0,0,0,0,0,0,0,590,590,265,27,298,0,0,0,0,0,0,0,0,0,58105
19737,22802,1594,5071,7706,5107,3324,1741,799,662,191,94,377,137,122,82,31,9,15,0,0,15,942,830,482,34,314,112,86,86,0,0,26,0,0,26,58201
19738,6,0,0,6,0,0,1415,857,857,152,13,692,0,0,0,0,0,0,0,0,0,558,558,225,8,325,0,0,0,0,0,0,0,0,0,58202
19739,8487,701,2176,3098,1570,942,1745,952,884,247,3,634,68,45,22,23,0,23,0,0,23,793,764,377,30,357,29,29,26,3,0,0,0,0,0,58203
19740,811,28,156,421,100,106,74,42,19,10,0,9,23,23,23,0,0,0,0,0,0,32,14,11,0,3,18,6,3,0,3,12,0,12,0,58204
19741,35,0,12,17,6,0,45,22,1,1,0,0,21,21,21,0,0,0,0,0,0,23,0,0,0,0,23,23,23,0,0,0,0,0,0,58205
19742,240,26,75,96,35,8,7,5,5,3,2,0,0,0,0,0,0,0,0,0,0,2,2,2,0,0,0,0,0,0,0,0,0,0,0,58210
19743,421,60,156,126,52,27,15,6,6,2,0,4,0,0,0,0,0,0,0,0,0,9,9,5,0,4,0,0,0,0,0,0,0,0,0,58212
19744,211,8,44,117,18,24,5,0,0,0,0,0,0,0,0,0,0,0,0,0,0,5,5,0,0,5,0,0,0,0,0,0,0,0,0,58214
19745,75,4,25,17,21,8,0,0,0,0,0,0,0,0,0,0,0,0,0,0,0,0,0,0,0,0,0,0,0,0,0,0,0,0,0,58216
19746,456,23,154,194,70,15,28,11,11,3,0,8,0,0,0,0,0,0,0,0,0,17,17,10,4,3,0,0,0,0,0,0,0,0,0,58218
19747,29,0,16,13,0,0,0,0,0,0,0,0,0,0,0,0,0,0,0,0,0,0,0,0,0,0,0,0,0,0,0,0,0,0,0,58219
19748,1763,135,589,621,369,49,99,45,43,14,0,29,2,2,2,0,0,0,0,0,0,54,54,27,0,27,0,0,0,0,0,0,0,0,0,58220
19749,252,22,51,133,32,14,9,2,2,2,0,0,0,0,0,0,0,0,0,0,0,7,7,3,0,4,0,0,0,0,0,0,0,0,0,58222
19750,168,17,43,85,23,0,27,6,6,3,0,3,0,0,0,0,0,0,0,0,0,21,21,9,0,12,0,0,0,0,0,0,0,0,0,58223
19751,12,0,7,5,0,0,0,0,0,0,0,0,0,0,0,0,0,0,0,0,0,0,0,0,0,0,0,0,0,0,0,0,0,0,0,58224
19752,756,89,253,271,120,23,23,6,6,0,0,6,0,0,0,0,0,0,0,0,0,17,14,9,0,5,3,3,0,0,3,0,0,0,0,58225
19753,348,24,111,124,69,20,14,3,3,3,0,0,0,0,0,0,0,0,0,0,0,11,11,6,0,5,0,0,0,0,0,0,0,0,0,58227
19754,599,49,197,260,72,21,24,6,6,0,0,6,0,0,0,0,0,0,0,0,0,18,17,0,0,17,1,1,1,0,0,0,0,0,0,58228
19755,129,4,32,51,40,2,29,9,9,0,0,9,0,0,0,0,0,0,0,0,0,20,20,10,0,10,0,0,0,0,0,0,0,0,0,58229
19756,425,45,131,183,55,11,31,21,19,7,0,12,2,0,0,0,0,2,0,2,0,10,10,1,7,2,0,0,0,0,0,0,0,0,0,58230
19757,440,129,135,123,41,12,13,7,7,0,0,7,0,0,0,0,0,0,0,0,0,6,6,4,0,2,0,0,0,0,0,0,0,0,0,58231
19758,159,23,20,87,25,4,12,9,9,2,0,7,0,0,0,0,0,0,0,0,0,3,3,3,0,0,0,0,0,0,0,0,0,0,0,58233
19759,294,32,56,121,67,18,26,8,8,7,1,0,0,0,0,0,0,0,0,0,0,18,17,10,0,7,1,1,0,1,0,0,0,0,0,58235
19760,3782,708,1296,1125,437,216,249,108,100,58,0,42,8,1,0,0,1,7,7,0,0,141,99,59,0,40,42,10,10,0,0,32,6,0,26,58237
19761,135,3,40,58,33,1,6,0,0,0,0,0,0,0,0,0,0,0,0,0,0,6,4,4,0,0,2,2,2,0,0,0,0,0,0,58238
19762,23,0,9,14,0,0,0,0,0,0,0,0,0,0,0,0,0,0,0,0,0,0,0,0,0,0,0,0,0,0,0,0,0,0,0,58239
19763,959,135,268,319,196,41,56,24,24,10,0,14,0,0,0,0,0,0,0,0,0,32,30,17,0,13,2,2,2,0,0,0,0,0,0,58240
19764,70,2,32,28,8,0,0,0,0,0,0,0,0,0,0,0,0,0,0,0,0,0,0,0,0,0,0,0,0,0,0,0,0,0,0,58241
19765,435,80,87,139,109,20,36,18,18,0,0,18,0,0,0,0,0,0,0,0,0,18,14,0,0,14,4,0,0,0,0,4,0,0,4,58243
19766,121,10,29,52,21,9,7,7,7,0,0,7,0,0,0,0,0,0,0,0,0,0,0,0,0,0,0,0,0,0,0,0,0,0,0,58244
19767,1862,246,519,765,225,107,76,43,43,6,11,26,0,0,0,0,0,0,0,0,0,33,33,14,0,19,0,0,0,0,0,0,0,0,0,58249
19768,193,36,52,73,32,0,4,2,2,2,0,0,0,0,0,0,0,0,0,0,0,2,2,0,0,2,0,0,0,0,0,0,0,0,0,58250
19769,1623,115,510,643,284,71,122,67,65,18,0,47,2,0,0,0,0,2,0,0,2,55,48,17,0,31,7,7,0,0,7,0,0,0,0,58251
19770,366,30,101,168,47,20,8,0,0,0,0,0,0,0,0,0,0,0,0,0,0,8,8,2,0,6,0,0,0,0,0,0,0,0,0,58254
19771,603,34,161,254,119,35,36,22,22,4,3,15,0,0,0,0,0,0,0,0,0,14,14,10,0,4,0,0,0,0,0,0,0,0,0,58256
19772,1275,111,306,417,345,96,177,94,94,15,3,76,0,0,0,0,0,0,0,0,0,83,83,35,0,48,0,0,0,0,0,0,0,0,0,58257
19773,191,26,79,42,26,18,11,5,5,2,0,3,0,0,0,0,0,0,0,0,0,6,2,2,0,0,4,4,4,0,0,0,0,0,0,58258
19774,307,39,96,137,31,4,21,14,14,10,0,4,0,0,0,0,0,0,0,0,0,7,7,0,0,7,0,0,0,0,0,0,0,0,0,58259
19775,161,29,41,70,16,5,7,0,0,0,0,0,0,0,0,0,0,0,0,0,0,7,7,1,6,0,0,0,0,0,0,0,0,0,0,58260
19776,778,116,307,233,105,17,51,44,29,19,3,7,15,12,12,0,0,3,3,0,0,7,7,4,0,3,0,0,0,0,0,0,0,0,0,58261
19777,90,19,36,26,8,1,0,0,0,0,0,0,0,0,0,0,0,0,0,0,0,0,0,0,0,0,0,0,0,0,0,0,0,0,0,58262
19778,355,22,171,130,26,6,7,1,1,1,0,0,0,0,0,0,0,0,0,0,0,6,6,4,0,2,0,0,0,0,0,0,0,0,0,58265
19779,218,40,67,71,31,9,14,13,13,6,0,7,0,0,0,0,0,0,0,0,0,1,1,0,0,1,0,0,0,0,0,0,0,0,0,58266
19780,901,78,314,333,159,17,46,23,20,2,0,18,3,3,3,0,0,0,0,0,0,23,23,11,0,12,0,0,0,0,0,0,0,0,0,58267
19781,152,21,72,51,8,0,3,0,0,0,0,0,0,0,0,0,0,0,0,0,0,3,3,0,0,3,0,0,0,0,0,0,0,0,0,58269
19782,1475,235,390,529,248,73,73,35,32,17,0,15,3,3,0,0,3,0,0,0,0,38,35,27,0,8,3,3,0,0,3,0,0,0,0,58270
19783,499,23,235,172,54,15,23,18,18,15,0,3,0,0,0,0,0,0,0,0,0,5,5,3,0,2,0,0,0,0,0,0,0,0,0,58271
19784,260,9,90,112,37,12,14,12,12,2,0,10,0,0,0,0,0,0,0,0,0,2,2,0,0,2,0,0,0,0,0,0,0,0,0,58272
19785,140,35,50,42,8,5,8,8,8,0,0,8,0,0,0,0,0,0,0,0,0,0,0,0,0,0,0,0,0,0,0,0,0,0,0,58273
19786,771,72,178,241,210,70,63,25,25,14,0,11,0,0,0,0,0,0,0,0,0,38,31,31,0,0,7,0,0,0,0,7,7,0,0,58274
19787,564,30,186,224,101,23,32,16,15,3,0,12,1,1,1,0,0,0,0,0,0,16,16,5,3,8,0,0,0,0,0,0,0,0,0,58275
19788,366,34,133,124,66,9,17,15,10,7,0,3,5,3,3,0,0,2,0,0,2,2,2,2,0,0,0,0,0,0,0,0,0,0,0,58276
19789,194,20,64,86,18,6,2,2,2,2,0,0,0,0,0,0,0,0,0,0,0,0,0,0,0,0,0,0,0,0,0,0,0,0,0,58277
19790,1256,96,275,553,244,88,89,35,35,20,3,12,0,0,0,0,0,0,0,0,0,54,45,22,0,23,9,9,9,0,0,0,0,0,0,58278
19791,71,4,15,49,0,3,0,0,0,0,0,0,0,0,0,0,0,0,0,0,0,0,0,0,0,0,0,0,0,0,0,0,0,0,0,58281
19792,1088,252,407,273,128,28,14,6,6,2,0,4,0,0,0,0,0,0,0,0,0,8,8,8,0,0,0,0,0,0,0,0,0,0,0,58282
19793,6631,808,1824,2587,1097,315,544,294,278,102,0,176,16,7,1,0,6,9,0,5,4,250,235,131,0,104,15,15,15,0,0,0,0,0,0,58301
19794,43,0,16,20,7,0,18,5,2,0,0,2,3,0,0,0,0,3,3,0,0,13,13,1,0,12,0,0,0,0,0,0,0,0,0,58311
19795,3512,695,697,1382,524,214,488,317,126,5,11,110,191,69,15,0,54,122,16,0,106,171,76,0,0,76,95,40,32,0,8,55,0,0,55,58316
19796,181,8,74,87,4,8,0,0,0,0,0,0,0,0,0,0,0,0,0,0,0,0,0,0,0,0,0,0,0,0,0,0,0,0,0,58317
19797,2634,278,635,1072,467,182,248,154,141,36,28,77,13,13,11,2,0,0,0,0,0,94,85,32,0,53,9,9,8,0,1,0,0,0,0,58318
19798,157,11,53,79,12,2,15,1,1,1,0,0,0,0,0,0,0,0,0,0,0,14,14,6,0,8,0,0,0,0,0,0,0,0,0,58321
19799,31,0,14,3,14,0,0,0,0,0,0,0,0,0,0,0,0,0,0,0,0,0,0,0,0,0,0,0,0,0,0,0,0,0,0,58323
19800,981,63,277,393,214,34,33,10,10,5,0,5,0,0,0,0,0,0,0,0,0,23,23,23,0,0,0,0,0,0,0,0,0,0,0,58324
19801,83,3,51,15,14,0,0,0,0,0,0,0,0,0,0,0,0,0,0,0,0,0,0,0,0,0,0,0,0,0,0,0,0,0,0,58325
19802,306,17,115,119,47,8,29,19,19,1,0,18,0,0,0,0,0,0,0,0,0,10,10,0,0,10,0,0,0,0,0,0,0,0,0,58327
19803,1839,423,448,706,163,99,171,58,14,0,0,14,44,9,0,0,9,35,0,0,35,113,72,0,0,72,41,26,0,0,26,15,0,0,15,58329
19804,281,38,61,109,60,13,20,8,8,0,0,8,0,0,0,0,0,0,0,0,0,12,12,12,0,0,0,0,0,0,0,0,0,0,0,58330
19805,96,12,41,14,21,8,9,9,9,0,0,9,0,0,0,0,0,0,0,0,0,0,0,0,0,0,0,0,0,0,0,0,0,0,0,58331
19806,265,34,102,102,15,12,12,0,0,0,0,0,0,0,0,0,0,0,0,0,0,12,12,12,0,0,0,0,0,0,0,0,0,0,0,58332
19807,660,175,213,228,21,23,86,48,44,13,0,31,4,4,0,0,4,0,0,0,0,38,18,0,0,18,20,20,0,0,20,0,0,0,0,58335
19808,73,5,30,35,1,2,3,1,1,1,0,0,0,0,0,0,0,0,0,0,0,2,2,2,0,0,0,0,0,0,0,0,0,0,0,58338
19809,24,1,3,6,9,5,1,1,1,0,0,1,0,0,0,0,0,0,0,0,0,0,0,0,0,0,0,0,0,0,0,0,0,0,0,58339
19810,1909,350,593,636,280,50,99,52,48,27,0,21,4,0,0,0,0,4,0,0,4,47,47,47,0,0,0,0,0,0,0,0,0,0,0,58341
19811,63,7,46,10,0,0,0,0,0,0,0,0,0,0,0,0,0,0,0,0,0,0,0,0,0,0,0,0,0,0,0,0,0,0,0,58343
19812,654,97,164,212,157,24,19,13,8,0,0,8,5,1,1,0,0,4,0,0,4,6,3,0,0,3,3,3,3,0,0,0,0,0,0,58344
19813,121,39,24,40,12,6,5,2,2,0,0,2,0,0,0,0,0,0,0,0,0,3,3,3,0,0,0,0,0,0,0,0,0,0,0,58345
19814,461,36,159,166,87,13,20,10,4,0,0,4,6,6,6,0,0,0,0,0,0,10,10,0,0,10,0,0,0,0,0,0,0,0,0,58346
19815,498,29,187,211,60,11,39,11,11,4,0,7,0,0,0,0,0,0,0,0,0,28,26,16,0,10,2,0,0,0,0,2,0,0,2,58348
19816,296,35,104,90,62,5,27,12,12,7,0,5,0,0,0,0,0,0,0,0,0,15,11,6,0,5,4,0,0,0,0,4,4,0,0,58351
19817,365,37,113,154,56,5,14,6,6,0,0,6,0,0,0,0,0,0,0,0,0,8,8,5,0,3,0,0,0,0,0,0,0,0,0,58352
19818,42,7,15,20,0,0,0,0,0,0,0,0,0,0,0,0,0,0,0,0,0,0,0,0,0,0,0,0,0,0,0,0,0,0,0,58353
19819,50,0,19,21,10,0,2,0,0,0,0,0,0,0,0,0,0,0,0,0,0,2,2,2,0,0,0,0,0,0,0,0,0,0,0,58355
19820,1278,157,413,465,189,54,106,52,27,10,0,17,25,25,25,0,0,0,0,0,0,54,54,32,7,15,0,0,0,0,0,0,0,0,0,58356
19821,209,49,67,70,19,4,29,22,18,0,0,18,4,4,4,0,0,0,0,0,0,7,2,0,0,2,5,0,0,0,0,5,0,0,5,58357
19822,226,21,50,76,44,35,7,7,7,5,0,2,0,0,0,0,0,0,0,0,0,0,0,0,0,0,0,0,0,0,0,0,0,0,0,58361
19823,32,0,32,0,0,0,0,0,0,0,0,0,0,0,0,0,0,0,0,0,0,0,0,0,0,0,0,0,0,0,0,0,0,0,0,58362
19824,94,0,32,47,15,0,10,8,8,2,0,6,0,0,0,0,0,0,0,0,0,2,2,0,0,2,0,0,0,0,0,0,0,0,0,58363
19825,216,23,58,97,32,6,12,5,5,0,0,5,0,0,0,0,0,0,0,0,0,7,7,4,0,3,0,0,0,0,0,0,0,0,0,58365
19826,768,122,176,239,145,86,49,9,9,0,0,9,0,0,0,0,0,0,0,0,0,40,14,0,0,14,26,14,14,0,0,12,0,0,12,58366
19827,1039,120,261,426,147,85,74,41,41,7,5,29,0,0,0,0,0,0,0,0,0,33,23,17,0,6,10,9,9,0,0,1,0,0,1,58367
19828,2840,534,983,1005,270,48,239,148,125,53,9,63,23,12,10,0,2,11,0,0,11,91,91,47,0,44,0,0,0,0,0,0,0,0,0,58368
19829,820,124,179,381,99,37,85,14,11,1,0,10,3,3,3,0,0,0,0,0,0,71,17,2,0,15,54,11,3,0,8,43,3,0,40,58369
19830,717,176,196,284,54,7,152,71,27,0,0,27,44,17,7,0,10,27,14,0,13,81,58,13,0,45,23,0,0,0,0,23,23,0,0,58370
19831,87,4,26,49,8,0,2,0,0,0,0,0,0,0,0,0,0,0,0,0,0,2,2,2,0,0,0,0,0,0,0,0,0,0,0,58372
19832,443,45,122,191,62,23,23,8,4,0,0,4,4,4,2,0,2,0,0,0,0,15,12,4,3,5,3,3,3,0,0,0,0,0,0,58374
19833,266,33,92,104,32,5,13,8,2,0,0,2,6,6,6,0,0,0,0,0,0,5,5,2,0,3,0,0,0,0,0,0,0,0,0,58377
19834,176,50,71,40,10,5,31,24,24,3,0,21,0,0,0,0,0,0,0,0,0,7,7,0,0,7,0,0,0,0,0,0,0,0,0,58379
19835,296,19,88,145,35,9,8,2,2,0,0,2,0,0,0,0,0,0,0,0,0,6,6,6,0,0,0,0,0,0,0,0,0,0,0,58380
19836,210,9,61,74,61,5,6,4,4,0,0,4,0,0,0,0,0,0,0,0,0,2,2,0,0,2,0,0,0,0,0,0,0,0,0,58381
19837,122,5,37,45,35,0,13,0,0,0,0,0,0,0,0,0,0,0,0,0,0,13,13,0,0,13,0,0,0,0,0,0,0,0,0,58382
19838,452,28,156,200,49,19,33,19,19,2,0,17,0,0,0,0,0,0,0,0,0,14,14,1,10,3,0,0,0,0,0,0,0,0,0,58384
19839,210,33,60,80,30,7,13,13,13,3,0,10,0,0,0,0,0,0,0,0,0,0,0,0,0,0,0,0,0,0,0,0,0,0,0,58385
19840,160,16,58,75,11,0,8,7,7,0,0,7,0,0,0,0,0,0,0,0,0,1,0,0,0,0,1,0,0,0,0,1,1,0,0,58386
19841,12027,1513,4136,3348,2382,648,850,449,446,179,12,255,3,0,0,0,0,3,0,0,3,401,368,185,14,169,33,22,7,5,10,11,11,0,0,58401
19842,335,72,163,86,6,8,12,12,0,0,0,0,12,6,0,0,6,6,0,0,6,0,0,0,0,0,0,0,0,0,0,0,0,0,0,58402
19843,0,0,0,0,0,0,177,66,66,9,3,54,0,0,0,0,0,0,0,0,0,111,111,36,0,75,0,0,0,0,0,0,0,0,0,58405
19844,907,232,239,254,148,34,57,32,22,6,0,16,10,8,1,7,0,2,0,0,2,25,16,9,0,7,9,8,8,0,0,1,0,0,1,58413
19845,88,13,30,18,27,0,6,2,0,0,0,0,2,0,0,0,0,2,2,0,0,4,2,0,0,2,2,0,0,0,0,2,0,0,2,58415
19846,365,93,85,110,62,15,5,5,5,2,0,3,0,0,0,0,0,0,0,0,0,0,0,0,0,0,0,0,0,0,0,0,0,0,0,58416
19847,288,29,119,78,58,4,37,0,0,0,0,0,0,0,0,0,0,0,0,0,0,37,37,0,0,37,0,0,0,0,0,0,0,0,0,58418
19848,218,11,67,76,58,6,2,0,0,0,0,0,0,0,0,0,0,0,0,0,0,2,2,0,0,2,0,0,0,0,0,0,0,0,0,58420
19849,2034,276,681,655,378,44,162,101,98,39,0,59,3,3,3,0,0,0,0,0,0,61,61,19,4,38,0,0,0,0,0,0,0,0,0,58421
19850,181,22,73,48,38,0,7,4,4,4,0,0,0,0,0,0,0,0,0,0,0,3,0,0,0,0,3,0,0,0,0,3,0,0,3,58422
19851,68,10,28,21,3,6,0,0,0,0,0,0,0,0,0,0,0,0,0,0,0,0,0,0,0,0,0,0,0,0,0,0,0,0,0,58423
19852,147,42,44,37,21,3,7,2,2,0,0,2,0,0,0,0,0,0,0,0,0,5,5,5,0,0,0,0,0,0,0,0,0,0,0,58424
19853,1123,144,435,385,145,14,70,47,47,19,4,24,0,0,0,0,0,0,0,0,0,23,23,12,0,11,0,0,0,0,0,0,0,0,0,58425
19854,140,17,45,41,17,20,7,2,2,0,0,2,0,0,0,0,0,0,0,0,0,5,5,0,0,5,0,0,0,0,0,0,0,0,0,58426
19855,275,65,50,137,13,10,0,0,0,0,0,0,0,0,0,0,0,0,0,0,0,0,0,0,0,0,0,0,0,0,0,0,0,0,0,58428
19856,200,3,76,95,26,0,50,27,20,0,0,20,7,0,0,0,0,7,0,7,0,23,23,3,0,20,0,0,0,0,0,0,0,0,0,58429
19857,78,7,22,43,6,0,1,0,0,0,0,0,0,0,0,0,0,0,0,0,0,1,1,0,0,1,0,0,0,0,0,0,0,0,0,58430
19858,98,7,34,33,19,5,3,3,3,0,0,3,0,0,0,0,0,0,0,0,0,0,0,0,0,0,0,0,0,0,0,0,0,0,0,58431
19859,807,113,170,375,123,26,61,18,18,6,0,12,0,0,0,0,0,0,0,0,0,43,28,16,0,12,15,15,15,0,0,0,0,0,0,58433
19860,1344,175,349,494,257,69,151,99,96,49,0,47,3,3,3,0,0,0,0,0,0,52,52,18,3,31,0,0,0,0,0,0,0,0,0,58436
19861,485,30,139,202,89,25,32,20,20,3,0,17,0,0,0,0,0,0,0,0,0,12,7,0,0,7,5,5,5,0,0,0,0,0,0,58438
19862,114,10,19,64,21,0,1,0,0,0,0,0,0,0,0,0,0,0,0,0,0,1,1,0,0,1,0,0,0,0,0,0,0,0,0,58439
19863,137,27,46,40,7,17,0,0,0,0,0,0,0,0,0,0,0,0,0,0,0,0,0,0,0,0,0,0,0,0,0,0,0,0,0,58440
19864,199,57,61,48,23,10,0,0,0,0,0,0,0,0,0,0,0,0,0,0,0,0,0,0,0,0,0,0,0,0,0,0,0,0,0,58441
19865,399,109,131,118,36,5,8,8,8,3,0,5,0,0,0,0,0,0,0,0,0,0,0,0,0,0,0,0,0,0,0,0,0,0,0,58442
19866,143,22,36,59,22,4,2,0,0,0,0,0,0,0,0,0,0,0,0,0,0,2,2,2,0,0,0,0,0,0,0,0,0,0,0,58443
19867,211,25,59,95,30,2,7,5,5,2,0,3,0,0,0,0,0,0,0,0,0,2,2,0,0,2,0,0,0,0,0,0,0,0,0,58444
19868,84,6,30,36,8,4,5,1,1,0,0,1,0,0,0,0,0,0,0,0,0,4,0,0,0,0,4,4,4,0,0,0,0,0,0,58445
19869,234,32,88,77,37,0,0,0,0,0,0,0,0,0,0,0,0,0,0,0,0,0,0,0,0,0,0,0,0,0,0,0,0,0,0,58448
19870,147,25,77,25,18,2,5,2,2,2,0,0,0,0,0,0,0,0,0,0,0,3,3,3,0,0,0,0,0,0,0,0,0,0,0,58451
19871,29,8,11,10,0,0,0,0,0,0,0,0,0,0,0,0,0,0,0,0,0,0,0,0,0,0,0,0,0,0,0,0,0,0,0,58452
19872,348,28,136,119,46,19,26,18,18,0,10,8,0,0,0,0,0,0,0,0,0,8,8,2,0,6,0,0,0,0,0,0,0,0,0,58454
19873,257,31,109,77,36,4,8,2,2,2,0,0,0,0,0,0,0,0,0,0,0,6,6,5,0,1,0,0,0,0,0,0,0,0,0,58455
19874,341,48,109,85,84,15,22,14,8,2,0,6,6,6,6,0,0,0,0,0,0,8,8,5,0,3,0,0,0,0,0,0,0,0,0,58456
19875,888,126,278,291,173,20,70,42,33,7,0,26,9,0,0,0,0,9,0,0,9,28,28,12,2,14,0,0,0,0,0,0,0,0,0,58458
19876,191,52,87,44,8,0,11,5,5,0,0,5,0,0,0,0,0,0,0,0,0,6,6,0,6,0,0,0,0,0,0,0,0,0,0,58460
19877,436,54,159,156,61,6,21,8,8,3,0,5,0,0,0,0,0,0,0,0,0,13,11,4,0,7,2,2,2,0,0,0,0,0,0,58461
19878,480,97,182,109,70,22,16,4,3,3,0,0,1,0,0,0,0,1,0,1,0,12,12,6,0,6,0,0,0,0,0,0,0,0,0,58463
19879,226,45,69,81,23,8,15,5,5,3,0,2,0,0,0,0,0,0,0,0,0,10,3,3,0,0,7,7,0,0,7,0,0,0,0,58464
19880,368,45,98,156,66,3,28,17,6,0,0,6,11,11,11,0,0,0,0,0,0,11,11,0,0,11,0,0,0,0,0,0,0,0,0,58466
19881,481,39,190,169,69,14,35,17,17,6,1,10,0,0,0,0,0,0,0,0,0,18,17,0,0,17,1,1,1,0,0,0,0,0,0,58467
19882,279,22,86,105,58,8,17,9,9,0,4,5,0,0,0,0,0,0,0,0,0,8,8,4,0,4,0,0,0,0,0,0,0,0,0,58472
19883,1874,230,646,564,374,60,102,40,29,22,0,7,11,11,3,8,0,0,0,0,0,62,54,44,0,10,8,8,0,0,8,0,0,0,0,58474
19884,130,28,50,29,23,0,10,3,3,0,0,3,0,0,0,0,0,0,0,0,0,7,2,0,0,2,5,5,0,0,5,0,0,0,0,58475
19885,159,10,58,54,27,10,15,10,10,2,0,8,0,0,0,0,0,0,0,0,0,5,5,3,0,2,0,0,0,0,0,0,0,0,0,58476
19886,149,15,77,42,14,1,3,0,0,0,0,0,0,0,0,0,0,0,0,0,0,3,3,0,0,3,0,0,0,0,0,0,0,0,0,58477
19887,122,4,48,55,15,0,1,0,0,0,0,0,0,0,0,0,0,0,0,0,0,1,1,1,0,0,0,0,0,0,0,0,0,0,0,58478
19888,168,2,71,77,16,2,10,10,7,0,0,7,3,3,3,0,0,0,0,0,0,0,0,0,0,0,0,0,0,0,0,0,0,0,0,58479
19889,177,9,101,42,25,0,13,12,12,6,0,6,0,0,0,0,0,0,0,0,0,1,1,0,0,1,0,0,0,0,0,0,0,0,0,58480
19890,226,13,96,54,39,24,0,0,0,0,0,0,0,0,0,0,0,0,0,0,0,0,0,0,0,0,0,0,0,0,0,0,0,0,0,58481
19891,686,71,176,231,173,35,47,11,11,0,0,11,0,0,0,0,0,0,0,0,0,36,34,13,0,21,2,0,0,0,0,2,2,0,0,58482
19892,167,32,63,50,12,10,10,1,1,0,0,1,0,0,0,0,0,0,0,0,0,9,9,3,0,6,0,0,0,0,0,0,0,0,0,58483
19893,46,8,13,25,0,0,2,0,0,0,0,0,0,0,0,0,0,0,0,0,0,2,2,0,0,2,0,0,0,0,0,0,0,0,0,58484
19894,116,11,31,51,16,7,6,1,1,0,0,1,0,0,0,0,0,0,0,0,0,5,5,3,0,2,0,0,0,0,0,0,0,0,0,58486
19895,341,79,153,67,40,2,22,20,20,0,0,20,0,0,0,0,0,0,0,0,0,2,2,0,0,2,0,0,0,0,0,0,0,0,0,58487
19896,239,39,81,74,39,6,0,0,0,0,0,0,0,0,0,0,0,0,0,0,0,0,0,0,0,0,0,0,0,0,0,0,0,0,0,58488
19897,223,19,97,69,27,11,21,18,18,2,0,16,0,0,0,0,0,0,0,0,0,3,2,2,0,0,1,1,1,0,0,0,0,0,0,58490
19898,309,10,120,108,53,18,10,1,1,0,0,1,0,0,0,0,0,0,0,0,0,9,9,3,0,6,0,0,0,0,0,0,0,0,0,58492
19899,251,51,73,89,25,13,14,7,7,3,0,4,0,0,0,0,0,0,0,0,0,7,6,4,0,2,1,0,0,0,0,1,0,1,0,58494
19900,989,243,290,275,122,59,36,17,17,3,2,12,0,0,0,0,0,0,0,0,0,19,16,3,3,10,3,3,3,0,0,0,0,0,0,58495
19901,147,48,60,21,18,0,0,0,0,0,0,0,0,0,0,0,0,0,0,0,0,0,0,0,0,0,0,0,0,0,0,0,0,0,0,58496
19902,209,16,94,60,36,3,16,16,16,13,0,3,0,0,0,0,0,0,0,0,0,0,0,0,0,0,0,0,0,0,0,0,0,0,0,58497
19903,19332,1481,4908,6437,4771,1735,1312,701,589,303,54,232,112,96,68,4,24,16,13,0,3,611,489,343,35,111,122,103,84,3,16,19,19,0,0,58501
19904,18501,906,3437,6664,4624,2870,1306,664,583,257,55,271,81,81,67,0,14,0,0,0,0,642,547,350,38,159,95,77,53,0,24,18,0,0,18,58503
19905,15961,1116,4213,6482,2994,1156,1536,702,656,249,65,342,46,34,29,0,5,12,12,0,0,834,764,427,58,279,70,59,59,0,0,11,0,0,11,58504
19906,0,0,0,0,0,0,0,0,0,0,0,0,0,0,0,0,0,0,0,0,0,0,0,0,0,0,0,0,0,0,0,0,0,0,0,58505
19907,230,30,92,83,25,0,36,14,11,0,0,11,3,3,3,0,0,0,0,0,0,22,7,7,0,0,15,15,0,0,15,0,0,0,0,58520
19908,544,33,132,215,114,50,29,9,7,3,0,4,2,0,0,0,0,2,2,0,0,20,17,7,0,10,3,3,3,0,0,0,0,0,0,58521
19909,2804,350,754,1134,419,147,90,69,36,23,0,13,33,4,0,0,4,29,0,0,29,21,12,8,0,4,9,9,9,0,0,0,0,0,0,58523
19910,55,12,21,19,3,0,0,0,0,0,0,0,0,0,0,0,0,0,0,0,0,0,0,0,0,0,0,0,0,0,0,0,0,0,0,58524
19911,393,87,143,107,35,21,109,58,46,15,0,31,12,6,0,6,0,6,0,0,6,51,43,0,0,43,8,2,0,0,2,6,0,2,4,58528
19912,455,54,121,203,62,15,35,11,5,0,1,4,6,3,3,0,0,3,1,0,2,24,24,1,2,21,0,0,0,0,0,0,0,0,0,58529
19913,811,130,268,272,112,29,43,15,10,7,0,3,5,5,5,0,0,0,0,0,0,28,28,5,0,23,0,0,0,0,0,0,0,0,0,58530
19914,275,54,75,99,41,6,4,0,0,0,0,0,0,0,0,0,0,0,0,0,0,4,4,4,0,0,0,0,0,0,0,0,0,0,0,58531
19915,197,34,54,90,16,3,6,3,1,0,0,1,2,2,2,0,0,0,0,0,0,3,3,3,0,0,0,0,0,0,0,0,0,0,0,58532
19916,718,115,293,201,83,26,61,37,37,17,0,20,0,0,0,0,0,0,0,0,0,24,24,12,0,12,0,0,0,0,0,0,0,0,0,58533
19917,412,39,161,149,55,8,18,13,9,0,0,9,4,4,4,0,0,0,0,0,0,5,5,3,0,2,0,0,0,0,0,0,0,0,0,58535
19918,1366,221,320,550,217,58,164,85,55,11,28,16,30,10,3,4,3,20,10,4,6,79,58,5,5,48,21,15,13,0,2,6,0,6,0,58538
19919,1789,207,589,704,232,57,77,41,41,15,0,26,0,0,0,0,0,0,0,0,0,36,36,14,0,22,0,0,0,0,0,0,0,0,0,58540
19920,316,38,171,65,42,0,22,2,2,0,0,2,0,0,0,0,0,0,0,0,0,20,20,20,0,0,0,0,0,0,0,0,0,0,0,58541
19921,197,42,75,70,10,0,15,13,13,1,0,12,0,0,0,0,0,0,0,0,0,2,2,0,0,2,0,0,0,0,0,0,0,0,0,58542
19922,439,34,157,139,99,10,43,35,15,11,0,4,20,20,0,0,20,0,0,0,0,8,8,2,0,6,0,0,0,0,0,0,0,0,0,58544
19923,2413,210,667,931,524,81,181,64,64,28,0,36,0,0,0,0,0,0,0,0,0,117,115,87,0,28,2,2,0,0,2,0,0,0,0,58545
19924,96,19,31,25,21,0,5,0,0,0,0,0,0,0,0,0,0,0,0,0,0,5,5,5,0,0,0,0,0,0,0,0,0,0,0,58549
19925,1248,255,399,433,141,20,128,63,59,27,0,32,4,4,4,0,0,0,0,0,0,65,61,17,3,41,4,4,0,0,4,0,0,0,0,58552
19926,15870,1396,4362,6059,3181,872,1179,634,461,178,32,251,173,133,95,7,31,40,40,0,0,545,417,264,48,105,128,101,85,0,16,27,17,10,0,58554
19927,636,34,164,269,131,38,46,30,25,4,0,21,5,5,0,0,5,0,0,0,0,16,11,4,0,7,5,0,0,0,0,5,0,0,5,58558
19928,149,17,38,60,29,5,0,0,0,0,0,0,0,0,0,0,0,0,0,0,0,0,0,0,0,0,0,0,0,0,0,0,0,0,0,58559
19929,148,9,88,28,16,7,6,6,6,0,0,6,0,0,0,0,0,0,0,0,0,0,0,0,0,0,0,0,0,0,0,0,0,0,0,58560
19930,733,167,247,206,101,12,52,32,32,9,0,23,0,0,0,0,0,0,0,0,0,20,20,10,6,4,0,0,0,0,0,0,0,0,0,58561
19931,295,35,117,92,42,9,25,18,15,5,0,10,3,3,3,0,0,0,0,0,0,7,5,4,1,0,2,0,0,0,0,2,2,0,0,58562
19932,1417,158,459,562,207,31,60,24,24,4,4,16,0,0,0,0,0,0,0,0,0,36,36,12,0,24,0,0,0,0,0,0,0,0,0,58563
19933,102,9,57,14,14,8,44,30,26,12,0,14,4,4,4,0,0,0,0,0,0,14,14,6,0,8,0,0,0,0,0,0,0,0,0,58564
19934,151,4,68,49,28,2,3,3,3,0,0,3,0,0,0,0,0,0,0,0,0,0,0,0,0,0,0,0,0,0,0,0,0,0,0,58565
19935,104,10,40,36,14,4,17,11,3,0,0,3,8,4,4,0,0,4,0,0,4,6,4,0,0,4,2,2,2,0,0,0,0,0,0,58566
19936,273,34,93,102,36,8,16,8,5,0,0,5,3,3,0,0,3,0,0,0,0,8,6,4,0,2,2,0,0,0,0,2,0,2,0,58568
19937,47,0,18,22,7,0,1,1,1,1,0,0,0,0,0,0,0,0,0,0,0,0,0,0,0,0,0,0,0,0,0,0,0,0,0,58569
19938,276,51,101,97,25,2,13,13,12,2,1,9,1,1,0,0,1,0,0,0,0,0,0,0,0,0,0,0,0,0,0,0,0,0,0,58570
19939,479,33,207,158,59,22,16,16,16,0,0,16,0,0,0,0,0,0,0,0,0,0,0,0,0,0,0,0,0,0,0,0,0,0,0,58571
19940,228,22,102,83,16,5,36,22,18,7,2,9,4,4,2,2,0,0,0,0,0,14,14,3,0,11,0,0,0,0,0,0,0,0,0,58572
19941,595,121,214,186,55,19,26,12,12,1,3,8,0,0,0,0,0,0,0,0,0,14,14,0,0,14,0,0,0,0,0,0,0,0,0,58573
19942,625,70,237,211,74,33,48,27,27,11,0,16,0,0,0,0,0,0,0,0,0,21,21,0,0,21,0,0,0,0,0,0,0,0,0,58575
19943,704,89,282,245,69,19,25,19,19,13,0,6,0,0,0,0,0,0,0,0,0,6,6,4,0,2,0,0,0,0,0,0,0,0,0,58576
19944,1308,42,399,595,228,44,147,60,56,25,2,29,4,4,3,0,1,0,0,0,0,87,65,7,0,58,22,7,0,0,7,15,15,0,0,58577
19945,831,75,291,315,115,35,32,28,23,7,0,16,5,0,0,0,0,5,5,0,0,4,4,4,0,0,0,0,0,0,0,0,0,0,0,58579
19946,256,65,125,55,8,3,17,11,0,0,0,0,11,7,7,0,0,4,0,0,4,6,6,4,0,2,0,0,0,0,0,0,0,0,0,58580
19947,178,24,86,46,18,4,6,1,1,0,0,1,0,0,0,0,0,0,0,0,0,5,5,1,0,4,0,0,0,0,0,0,0,0,0,58581
19948,14811,1569,4462,4944,2842,994,1257,659,540,217,15,308,119,75,59,15,1,44,13,8,23,598,497,305,16,176,101,45,45,0,0,56,49,7,0,58601
19949,144,12,32,39,43,18,2,0,0,0,0,0,0,0,0,0,0,0,0,0,0,2,2,2,0,0,0,0,0,0,0,0,0,0,0,58620
19950,826,90,236,339,138,23,56,35,35,20,0,15,0,0,0,0,0,0,0,0,0,21,21,13,4,4,0,0,0,0,0,0,0,0,0,58621
19951,1104,139,439,341,153,32,61,37,35,22,0,13,2,2,2,0,0,0,0,0,0,24,21,10,0,11,3,3,3,0,0,0,0,0,0,58622
19952,1684,185,594,558,306,41,131,27,24,2,0,22,3,0,0,0,0,3,3,0,0,104,75,36,10,29,29,8,8,0,0,21,14,4,3,58623
19953,163,33,75,40,13,2,3,1,0,0,0,0,1,1,0,1,0,0,0,0,0,2,1,0,0,1,1,1,1,0,0,0,0,0,0,58625
19954,191,27,60,79,16,9,7,6,4,0,0,4,2,2,2,0,0,0,0,0,0,1,1,0,0,1,0,0,0,0,0,0,0,0,0,58626
19955,166,25,89,45,3,4,16,6,6,0,0,6,0,0,0,0,0,0,0,0,0,10,10,0,8,2,0,0,0,0,0,0,0,0,0,58627
19956,294,26,124,124,13,7,55,30,30,9,0,21,0,0,0,0,0,0,0,0,0,25,20,2,7,11,5,0,0,0,0,5,5,0,0,58630
19957,722,100,347,175,77,23,54,31,31,24,0,7,0,0,0,0,0,0,0,0,0,23,23,11,0,12,0,0,0,0,0,0,0,0,0,58631
19958,123,10,32,59,20,2,21,3,3,3,0,0,0,0,0,0,0,0,0,0,0,18,18,1,0,17,0,0,0,0,0,0,0,0,0,58632
19959,74,0,35,30,9,0,7,7,7,0,0,7,0,0,0,0,0,0,0,0,0,0,0,0,0,0,0,0,0,0,0,0,0,0,0,58634
19960,534,63,129,242,93,7,51,29,28,3,0,25,1,0,0,0,0,1,0,1,0,22,22,13,0,9,0,0,0,0,0,0,0,0,0,58636
19961,856,163,264,254,161,14,33,24,12,5,0,7,12,8,1,4,3,4,0,0,4,9,9,5,0,4,0,0,0,0,0,0,0,0,0,58638
19962,1368,93,451,475,258,91,84,66,38,15,0,23,28,12,12,0,0,16,16,0,0,18,4,1,0,3,14,14,0,0,14,0,0,0,0,58639
19963,1095,74,401,405,169,46,81,50,42,20,0,22,8,4,4,0,0,4,4,0,0,31,20,12,2,6,11,11,2,9,0,0,0,0,0,58640
19964,60,0,26,33,1,0,20,8,8,8,0,0,0,0,0,0,0,0,0,0,0,12,12,0,0,12,0,0,0,0,0,0,0,0,0,58641
19965,273,32,99,93,26,23,20,20,20,8,0,12,0,0,0,0,0,0,0,0,0,0,0,0,0,0,0,0,0,0,0,0,0,0,0,58642
19966,145,29,66,28,22,0,14,8,8,4,0,4,0,0,0,0,0,0,0,0,0,6,6,0,0,6,0,0,0,0,0,0,0,0,0,58643
19967,179,15,50,65,43,6,3,0,0,0,0,0,0,0,0,0,0,0,0,0,0,3,0,0,0,0,3,3,0,0,3,0,0,0,0,58645
19968,854,131,294,269,142,18,42,19,19,12,0,7,0,0,0,0,0,0,0,0,0,23,17,9,0,8,6,6,6,0,0,0,0,0,0,58646
19969,885,82,341,344,93,25,30,26,26,0,0,26,0,0,0,0,0,0,0,0,0,4,4,0,0,4,0,0,0,0,0,0,0,0,0,58647
19970,292,24,116,107,35,10,16,5,2,0,0,2,3,3,0,3,0,0,0,0,0,11,11,0,0,11,0,0,0,0,0,0,0,0,0,58649
19971,310,38,85,117,45,25,6,6,6,2,0,4,0,0,0,0,0,0,0,0,0,0,0,0,0,0,0,0,0,0,0,0,0,0,0,58650
19972,326,69,75,108,63,11,11,2,1,1,0,0,1,1,0,0,1,0,0,0,0,9,9,9,0,0,0,0,0,0,0,0,0,0,0,58651
19973,739,96,236,230,140,37,46,34,23,12,0,11,11,9,9,0,0,2,2,0,0,12,12,0,3,9,0,0,0,0,0,0,0,0,0,58652
19974,441,35,126,194,69,17,35,12,11,0,3,8,1,1,1,0,0,0,0,0,0,23,23,9,0,14,0,0,0,0,0,0,0,0,0,58653
19975,184,1,56,101,23,3,50,26,26,7,0,19,0,0,0,0,0,0,0,0,0,24,24,0,0,24,0,0,0,0,0,0,0,0,0,58654
19976,305,39,100,104,45,17,17,11,9,6,1,2,2,2,2,0,0,0,0,0,0,6,4,0,0,4,2,2,2,0,0,0,0,0,0,58655
19977,272,14,78,133,38,9,12,12,12,10,0,2,0,0,0,0,0,0,0,0,0,0,0,0,0,0,0,0,0,0,0,0,0,0,0,58656
19978,19772,1520,5781,7579,3485,1407,1499,814,538,212,16,310,276,238,179,2,57,38,8,0,30,685,472,349,3,120,213,133,129,0,4,80,22,3,55,58701
19979,0,0,0,0,0,0,0,0,0,0,0,0,0,0,0,0,0,0,0,0,0,0,0,0,0,0,0,0,0,0,0,0,0,0,0,58702
19980,12103,767,3055,4557,2783,941,1212,683,425,133,0,292,258,181,170,0,11,77,69,8,0,529,380,182,116,82,149,76,38,11,27,73,64,0,9,58703
19981,1854,37,326,1001,266,224,281,130,24,18,6,0,106,65,65,0,0,41,41,0,0,151,133,37,0,96,18,13,0,0,13,5,0,0,5,58704
19982,26,0,0,26,0,0,104,101,0,0,0,0,101,101,101,0,0,0,0,0,0,3,0,0,0,0,3,3,3,0,0,0,0,0,0,58705
19983,25,0,2,10,13,0,321,117,117,61,0,56,0,0,0,0,0,0,0,0,0,204,204,112,0,92,0,0,0,0,0,0,0,0,0,58707
19984,419,28,203,121,40,27,9,3,1,0,0,1,2,2,2,0,0,0,0,0,0,6,4,0,0,4,2,2,0,0,2,0,0,0,0,58710
19985,121,9,72,17,23,0,2,0,0,0,0,0,0,0,0,0,0,0,0,0,0,2,2,1,0,1,0,0,0,0,0,0,0,0,0,58711
19986,108,8,33,48,19,0,7,5,5,0,0,5,0,0,0,0,0,0,0,0,0,2,2,0,0,2,0,0,0,0,0,0,0,0,0,58712
19987,14,2,2,8,2,0,0,0,0,0,0,0,0,0,0,0,0,0,0,0,0,0,0,0,0,0,0,0,0,0,0,0,0,0,0,58713
19988,97,27,39,22,9,0,0,0,0,0,0,0,0,0,0,0,0,0,0,0,0,0,0,0,0,0,0,0,0,0,0,0,0,0,0,58716
19989,744,50,260,280,117,37,49,34,34,3,0,31,0,0,0,0,0,0,0,0,0,15,11,9,0,2,4,0,0,0,0,4,0,0,4,58718
19990,364,56,106,135,45,22,19,14,14,0,0,14,0,0,0,0,0,0,0,0,0,5,5,1,0,4,0,0,0,0,0,0,0,0,0,58721
19991,1033,49,304,439,208,33,99,83,83,42,13,28,0,0,0,0,0,0,0,0,0,16,16,16,0,0,0,0,0,0,0,0,0,0,0,58722
19992,205,31,98,56,11,9,2,0,0,0,0,0,0,0,0,0,0,0,0,0,0,2,2,2,0,0,0,0,0,0,0,0,0,0,0,58723
19993,168,11,45,80,32,0,3,2,2,0,0,2,0,0,0,0,0,0,0,0,0,1,1,0,0,1,0,0,0,0,0,0,0,0,0,58725
19994,229,46,72,83,23,5,18,11,11,4,0,7,0,0,0,0,0,0,0,0,0,7,7,7,0,0,0,0,0,0,0,0,0,0,0,58727
19995,1089,101,349,416,201,22,35,24,24,15,0,9,0,0,0,0,0,0,0,0,0,11,11,11,0,0,0,0,0,0,0,0,0,0,0,58730
19996,191,18,72,85,8,8,15,10,9,0,0,9,1,1,1,0,0,0,0,0,0,5,5,0,0,5,0,0,0,0,0,0,0,0,0,58731
19997,326,23,134,94,63,12,12,4,1,1,0,0,3,0,0,0,0,3,3,0,0,8,3,0,0,3,5,5,5,0,0,0,0,0,0,58733
19998,200,26,90,70,14,0,14,4,3,0,0,3,1,1,1,0,0,0,0,0,0,10,10,5,0,5,0,0,0,0,0,0,0,0,0,58734
19999,284,7,83,154,27,13,22,12,12,0,0,12,0,0,0,0,0,0,0,0,0,10,10,0,0,10,0,0,0,0,0,0,0,0,0,58735
20000,380,69,155,91,51,14,8,3,3,3,0,0,0,0,0,0,0,0,0,0,0,5,5,0,0,5,0,0,0,0,0,0,0,0,0,58736
20001,104,5,49,35,12,3,5,3,3,3,0,0,0,0,0,0,0,0,0,0,0,2,0,0,0,0,2,2,0,0,2,0,0,0,0,58737
20002,557,42,120,317,62,16,42,12,7,1,0,6,5,0,0,0,0,5,4,0,1,30,27,14,0,13,3,3,3,0,0,0,0,0,0,58740
20003,460,51,250,98,53,8,38,28,27,9,0,18,1,1,1,0,0,0,0,0,0,10,10,3,1,6,0,0,0,0,0,0,0,0,0,58741
20004,97,27,35,30,3,2,5,3,2,0,0,2,1,1,1,0,0,0,0,0,0,2,2,0,0,2,0,0,0,0,0,0,0,0,0,58744
20005,1045,140,381,340,149,35,52,39,17,3,0,14,22,8,8,0,0,14,4,0,10,13,9,7,0,2,4,4,4,0,0,0,0,0,0,58746
20006,106,16,28,45,13,4,1,0,0,0,0,0,0,0,0,0,0,0,0,0,0,1,1,1,0,0,0,0,0,0,0,0,0,0,0,58748
20007,415,40,125,153,81,16,30,28,20,15,0,5,8,7,7,0,0,1,1,0,0,2,2,1,0,1,0,0,0,0,0,0,0,0,0,58750
20008,152,11,70,48,14,9,14,3,3,1,0,2,0,0,0,0,0,0,0,0,0,11,10,8,0,2,1,1,1,0,0,0,0,0,0,58752
20009,101,10,27,42,12,10,5,0,0,0,0,0,0,0,0,0,0,0,0,0,0,5,5,5,0,0,0,0,0,0,0,0,0,0,0,58755
20010,170,12,40,67,51,0,21,19,15,3,0,12,4,4,4,0,0,0,0,0,0,2,2,2,0,0,0,0,0,0,0,0,0,0,0,58756
20011,413,63,106,200,24,20,91,63,40,12,0,28,23,10,3,7,0,13,0,3,10,28,17,7,0,10,11,8,1,3,4,3,0,0,3,58757
20012,243,30,134,44,33,2,5,5,5,3,0,2,0,0,0,0,0,0,0,0,0,0,0,0,0,0,0,0,0,0,0,0,0,0,0,58758
20013,623,40,254,234,79,16,44,29,29,6,0,23,0,0,0,0,0,0,0,0,0,15,15,2,0,13,0,0,0,0,0,0,0,0,0,58759
20014,148,39,30,49,21,9,11,3,3,0,0,3,0,0,0,0,0,0,0,0,0,8,8,3,0,5,0,0,0,0,0,0,0,0,0,58760
20015,795,53,220,352,146,24,61,41,34,11,0,23,7,7,0,0,7,0,0,0,0,20,14,3,0,11,6,6,0,0,6,0,0,0,0,58761
20016,173,11,58,82,19,3,4,2,2,0,0,2,0,0,0,0,0,0,0,0,0,2,2,0,0,2,0,0,0,0,0,0,0,0,0,58762
20017,2143,273,607,885,268,110,249,154,93,32,0,61,61,42,24,0,18,19,0,14,5,95,59,25,0,34,36,20,3,0,17,16,7,0,9,58763
20018,236,11,110,57,58,0,18,16,0,0,0,0,16,16,16,0,0,0,0,0,0,2,2,2,0,0,0,0,0,0,0,0,0,0,0,58765
20019,140,17,62,38,19,4,10,7,7,0,0,7,0,0,0,0,0,0,0,0,0,3,0,0,0,0,3,3,0,0,3,0,0,0,0,58768
20020,229,23,99,107,0,0,0,0,0,0,0,0,0,0,0,0,0,0,0,0,0,0,0,0,0,0,0,0,0,0,0,0,0,0,0,58769
20021,892,93,224,389,129,57,98,45,33,10,1,22,12,2,0,0,2,10,0,10,0,53,53,12,9,32,0,0,0,0,0,0,0,0,0,58770
20022,389,40,153,132,58,6,13,7,2,0,0,2,5,0,0,0,0,5,5,0,0,6,6,6,0,0,0,0,0,0,0,0,0,0,0,58771
20023,74,5,38,19,12,0,3,3,3,0,0,3,0,0,0,0,0,0,0,0,0,0,0,0,0,0,0,0,0,0,0,0,0,0,0,58772
20024,554,57,195,189,76,37,37,22,19,9,6,4,3,3,1,2,0,0,0,0,0,15,2,2,0,0,13,13,13,0,0,0,0,0,0,58773
20025,225,26,61,105,18,15,23,4,0,0,0,0,4,0,0,0,0,4,4,0,0,19,17,0,0,17,2,2,2,0,0,0,0,0,0,58775
20026,183,25,56,66,36,0,0,0,0,0,0,0,0,0,0,0,0,0,0,0,0,0,0,0,0,0,0,0,0,0,0,0,0,0,0,58776
20027,123,8,13,81,18,3,0,0,0,0,0,0,0,0,0,0,0,0,0,0,0,0,0,0,0,0,0,0,0,0,0,0,0,0,0,58778
20028,470,58,189,152,71,0,20,9,9,0,0,9,0,0,0,0,0,0,0,0,0,11,9,5,0,4,2,2,2,0,0,0,0,0,0,58779
20029,466,43,160,188,72,3,68,25,20,0,0,20,5,5,3,0,2,0,0,0,0,43,41,21,0,20,2,2,2,0,0,0,0,0,0,58781
20030,283,16,100,111,54,2,14,6,6,0,0,6,0,0,0,0,0,0,0,0,0,8,6,0,0,6,2,2,2,0,0,0,0,0,0,58782
20031,270,49,73,113,28,7,5,4,4,4,0,0,0,0,0,0,0,0,0,0,0,1,1,1,0,0,0,0,0,0,0,0,0,0,0,58783
20032,1737,123,488,799,270,57,132,87,87,0,0,87,0,0,0,0,0,0,0,0,0,45,39,33,6,0,6,0,0,0,0,6,0,0,6,58784
20033,725,72,298,231,97,27,48,11,9,9,0,0,2,2,2,0,0,0,0,0,0,37,30,24,0,6,7,0,0,0,0,7,7,0,0,58785
20034,119,21,36,57,5,0,0,0,0,0,0,0,0,0,0,0,0,0,0,0,0,0,0,0,0,0,0,0,0,0,0,0,0,0,0,58787
20035,789,65,261,316,106,41,58,41,25,3,0,22,16,11,6,0,5,5,0,0,5,17,14,11,0,3,3,3,3,0,0,0,0,0,0,58788
20036,264,27,113,103,13,8,9,9,9,0,0,9,0,0,0,0,0,0,0,0,0,0,0,0,0,0,0,0,0,0,0,0,0,0,0,58789
20037,1078,121,393,324,171,69,75,38,23,10,0,13,15,15,15,0,0,0,0,0,0,37,32,16,0,16,5,5,5,0,0,0,0,0,0,58790
20038,224,32,66,87,16,23,5,0,0,0,0,0,0,0,0,0,0,0,0,0,0,5,0,0,0,0,5,5,5,0,0,0,0,0,0,58792
20039,471,68,170,159,56,18,13,11,11,2,0,9,0,0,0,0,0,0,0,0,0,2,1,0,0,1,1,1,1,0,0,0,0,0,0,58793
20040,56,4,20,29,3,0,3,3,3,2,0,1,0,0,0,0,0,0,0,0,0,0,0,0,0,0,0,0,0,0,0,0,0,0,0,58794
20041,140,12,44,48,36,0,10,0,0,0,0,0,0,0,0,0,0,0,0,0,0,10,10,7,0,3,0,0,0,0,0,0,0,0,0,58795
20042,13724,1432,4149,5295,2088,760,932,545,421,127,0,294,124,70,68,0,2,54,23,6,25,387,351,188,0,163,36,13,0,0,13,23,0,0,23,58801
20043,185,21,39,74,46,5,31,17,17,6,6,5,0,0,0,0,0,0,0,0,0,14,9,9,0,0,5,5,5,0,0,0,0,0,0,58830
20044,371,32,99,141,80,19,19,15,8,0,0,8,7,0,0,0,0,7,0,0,7,4,4,4,0,0,0,0,0,0,0,0,0,0,0,58831
20045,54,6,29,10,9,0,0,0,0,0,0,0,0,0,0,0,0,0,0,0,0,0,0,0,0,0,0,0,0,0,0,0,0,0,0,58833
20046,236,10,103,87,36,0,46,46,21,0,0,21,25,25,25,0,0,0,0,0,0,0,0,0,0,0,0,0,0,0,0,0,0,0,0,58835
20047,174,21,63,58,23,9,22,17,17,12,0,5,0,0,0,0,0,0,0,0,0,5,0,0,0,0,5,5,5,0,0,0,0,0,0,58838
20048,333,21,114,145,44,9,32,3,3,0,0,3,0,0,0,0,0,0,0,0,0,29,29,17,0,12,0,0,0,0,0,0,0,0,0,58843
20049,169,31,50,45,18,25,2,0,0,0,0,0,0,0,0,0,0,0,0,0,0,2,2,0,0,2,0,0,0,0,0,0,0,0,0,58844
20050,225,26,75,78,33,13,7,4,4,0,0,4,0,0,0,0,0,0,0,0,0,3,3,0,0,3,0,0,0,0,0,0,0,0,0,58845
20051,363,36,92,153,48,34,32,8,8,8,0,0,0,0,0,0,0,0,0,0,0,24,17,17,0,0,7,0,0,0,0,7,7,0,0,58847
20052,676,46,150,389,62,29,116,37,13,6,0,7,24,14,14,0,0,10,10,0,0,79,45,28,0,17,34,34,23,0,11,0,0,0,0,58849
20053,1257,189,378,485,179,26,99,62,46,12,0,34,16,6,6,0,0,10,0,0,10,37,31,14,3,14,6,6,6,0,0,0,0,0,0,58852
20054,184,6,50,114,14,0,31,24,19,5,0,14,5,0,0,0,0,5,0,5,0,7,0,0,0,0,7,0,0,0,0,7,0,0,7,58853
20055,2364,211,645,861,531,116,164,70,70,17,0,53,0,0,0,0,0,0,0,0,0,94,81,19,0,62,13,13,13,0,0,0,0,0,0,58854
20056,130,21,18,71,17,3,2,2,2,2,0,0,0,0,0,0,0,0,0,0,0,0,0,0,0,0,0,0,0,0,0,0,0,0,0,58856
20057,1254,88,421,440,204,101,59,13,13,10,0,3,0,0,0,0,0,0,0,0,0,46,46,0,0,46,0,0,0,0,0,0,0,0,0,59001
20058,164,20,105,30,9,0,19,4,2,2,0,0,2,0,0,0,0,2,2,0,0,15,15,0,0,15,0,0,0,0,0,0,0,0,0,59002
20059,622,38,239,196,91,58,65,32,28,10,0,18,4,4,4,0,0,0,0,0,0,33,17,7,0,10,16,12,12,0,0,4,0,0,4,59003
20060,500,107,246,42,66,39,41,5,5,0,0,5,0,0,0,0,0,0,0,0,0,36,36,23,0,13,0,0,0,0,0,0,0,0,0,59006
20061,115,1,67,38,7,2,8,0,0,0,0,0,0,0,0,0,0,0,0,0,0,8,8,4,0,4,0,0,0,0,0,0,0,0,0,59007
20062,287,25,94,133,32,3,19,16,6,6,0,0,10,5,0,0,5,5,0,0,5,3,0,0,0,0,3,3,0,0,3,0,0,0,0,59008
20063,63,11,26,23,3,0,6,0,0,0,0,0,0,0,0,0,0,0,0,0,0,6,6,0,0,6,0,0,0,0,0,0,0,0,0,59010
20064,2079,100,856,533,489,101,179,135,135,32,26,77,0,0,0,0,0,0,0,0,0,44,31,13,7,11,13,13,4,0,9,0,0,0,0,59011
20065,177,19,37,87,22,12,22,13,13,0,3,10,0,0,0,0,0,0,0,0,0,9,5,0,0,5,4,0,0,0,0,4,0,0,4,59012
20066,170,20,56,64,30,0,0,0,0,0,0,0,0,0,0,0,0,0,0,0,0,0,0,0,0,0,0,0,0,0,0,0,0,0,0,59013
20067,1278,140,437,449,185,67,85,74,66,28,14,24,8,8,8,0,0,0,0,0,0,11,10,7,0,3,1,1,1,0,0,0,0,0,0,59014
20068,425,30,145,186,53,11,30,21,21,2,0,19,0,0,0,0,0,0,0,0,0,9,9,0,0,9,0,0,0,0,0,0,0,0,0,59015
20069,442,80,108,177,62,15,31,22,21,1,1,19,1,0,0,0,0,1,0,0,1,9,0,0,0,0,9,9,0,9,0,0,0,0,0,59016
20070,422,11,181,80,118,32,45,33,22,10,0,12,11,9,9,0,0,2,0,0,2,12,12,0,0,12,0,0,0,0,0,0,0,0,0,59018
20071,2898,253,1205,966,279,195,160,126,126,38,20,68,0,0,0,0,0,0,0,0,0,34,17,4,3,10,17,0,0,0,0,17,0,0,17,59019
20072,28,2,6,15,5,0,0,0,0,0,0,0,0,0,0,0,0,0,0,0,0,0,0,0,0,0,0,0,0,0,0,0,0,0,0,59020
20073,1122,161,431,405,91,34,170,70,39,26,0,13,31,7,0,7,0,24,15,9,0,100,54,0,28,26,46,15,0,5,10,31,14,17,0,59022
20074,353,22,163,94,57,17,33,9,9,4,0,5,0,0,0,0,0,0,0,0,0,24,24,6,0,18,0,0,0,0,0,0,0,0,0,59024
20075,53,2,8,37,5,1,9,8,8,4,0,4,0,0,0,0,0,0,0,0,0,1,0,0,0,0,1,1,1,0,0,0,0,0,0,59025
20076,202,11,105,71,15,0,2,0,0,0,0,0,0,0,0,0,0,0,0,0,0,2,0,0,0,0,2,2,2,0,0,0,0,0,0,59026
20077,451,6,149,168,85,43,9,9,9,0,1,8,0,0,0,0,0,0,0,0,0,0,0,0,0,0,0,0,0,0,0,0,0,0,0,59027
20078,346,7,96,126,98,19,16,5,5,0,0,5,0,0,0,0,0,0,0,0,0,11,4,0,0,4,7,7,0,0,7,0,0,0,0,59028
20079,556,40,272,164,65,15,12,8,4,0,0,4,4,0,0,0,0,4,0,1,3,4,4,0,0,4,0,0,0,0,0,0,0,0,0,59029
20080,1082,56,224,322,344,136,97,56,28,0,0,28,28,28,5,0,23,0,0,0,0,41,41,41,0,0,0,0,0,0,0,0,0,0,0,59030
20081,163,75,35,16,8,29,9,0,0,0,0,0,0,0,0,0,0,0,0,0,0,9,9,0,0,9,0,0,0,0,0,0,0,0,0,59031
20082,256,26,106,90,34,0,37,3,3,3,0,0,0,0,0,0,0,0,0,0,0,34,34,0,6,28,0,0,0,0,0,0,0,0,0,59032
20083,246,83,76,70,17,0,11,11,8,0,0,8,3,3,3,0,0,0,0,0,0,0,0,0,0,0,0,0,0,0,0,0,0,0,0,59033
20084,3394,482,1287,1084,247,294,174,44,34,0,0,34,10,10,0,0,10,0,0,0,0,130,130,0,0,130,0,0,0,0,0,0,0,0,0,59034
20085,59,6,23,25,0,5,0,0,0,0,0,0,0,0,0,0,0,0,0,0,0,0,0,0,0,0,0,0,0,0,0,0,0,0,0,59035
20086,1035,190,413,250,146,36,73,35,28,6,0,22,7,0,0,0,0,7,0,0,7,38,23,15,0,8,15,1,0,0,1,14,0,0,14,59036
20087,1259,19,529,509,145,57,31,8,8,0,0,8,0,0,0,0,0,0,0,0,0,23,23,0,0,23,0,0,0,0,0,0,0,0,0,59037
20088,471,36,171,161,73,30,26,24,24,2,3,19,0,0,0,0,0,0,0,0,0,2,2,0,0,2,0,0,0,0,0,0,0,0,0,59038
20089,34,14,11,7,0,2,0,0,0,0,0,0,0,0,0,0,0,0,0,0,0,0,0,0,0,0,0,0,0,0,0,0,0,0,0,59039
20090,1368,122,464,408,255,119,102,58,46,8,0,38,12,12,12,0,0,0,0,0,0,44,44,18,2,24,0,0,0,0,0,0,0,0,0,59041
20091,1602,316,448,631,162,45,301,141,100,15,0,85,41,31,7,16,8,10,0,0,10,160,114,25,12,77,46,25,0,11,14,21,0,15,6,59043
20092,7480,653,2908,2459,1144,316,469,247,233,118,23,92,14,14,14,0,0,0,0,0,0,222,165,41,34,90,57,38,19,0,19,19,19,0,0,59044
20093,256,17,85,76,51,27,11,4,4,0,0,4,0,0,0,0,0,0,0,0,0,7,7,0,0,7,0,0,0,0,0,0,0,0,0,59046
20094,9083,718,2858,2606,1906,995,458,191,172,9,0,163,19,0,0,0,0,19,0,0,19,267,225,112,0,113,42,42,41,0,1,0,0,0,0,59047
20095,863,157,218,333,96,59,114,79,54,4,10,40,25,19,5,8,6,6,0,0,6,35,35,2,0,33,0,0,0,0,0,0,0,0,0,59050
20096,134,19,43,30,32,10,7,1,1,1,0,0,0,0,0,0,0,0,0,0,0,6,6,0,0,6,0,0,0,0,0,0,0,0,0,59052
20097,297,105,80,82,22,8,57,41,34,5,0,29,7,0,0,0,0,7,0,0,7,16,1,1,0,0,15,0,0,0,0,15,0,0,15,59053
20098,214,24,97,70,21,2,19,6,6,0,0,6,0,0,0,0,0,0,0,0,0,13,13,3,0,10,0,0,0,0,0,0,0,0,0,59054
20099,54,8,13,20,8,5,2,2,2,0,0,2,0,0,0,0,0,0,0,0,0,0,0,0,0,0,0,0,0,0,0,0,0,0,0,59055
20100,448,11,135,145,115,42,23,4,1,0,0,1,3,3,0,0,3,0,0,0,0,19,19,3,0,16,0,0,0,0,0,0,0,0,0,59057
20101,58,4,22,11,3,18,4,0,0,0,0,0,0,0,0,0,0,0,0,0,0,4,4,0,0,4,0,0,0,0,0,0,0,0,0,59058
20102,115,14,47,42,12,0,6,6,0,0,0,0,6,6,6,0,0,0,0,0,0,0,0,0,0,0,0,0,0,0,0,0,0,0,0,59059
20103,187,7,67,52,48,13,6,2,2,2,0,0,0,0,0,0,0,0,0,0,0,4,4,0,4,0,0,0,0,0,0,0,0,0,0,59061
20104,44,0,20,19,5,0,12,0,0,0,0,0,0,0,0,0,0,0,0,0,0,12,12,0,0,12,0,0,0,0,0,0,0,0,0,59062
20105,1339,105,511,447,232,44,151,67,67,40,0,27,0,0,0,0,0,0,0,0,0,84,79,10,0,69,5,5,5,0,0,0,0,0,0,59063
20106,150,0,87,50,13,0,0,0,0,0,0,0,0,0,0,0,0,0,0,0,0,0,0,0,0,0,0,0,0,0,0,0,0,0,0,59064
20107,48,0,0,22,26,0,0,0,0,0,0,0,0,0,0,0,0,0,0,0,0,0,0,0,0,0,0,0,0,0,0,0,0,0,0,59065
20108,328,40,95,135,37,21,28,10,10,4,0,6,0,0,0,0,0,0,0,0,0,18,14,0,0,14,4,0,0,0,0,4,0,0,4,59066
20109,219,24,52,60,54,29,30,17,17,5,0,12,0,0,0,0,0,0,0,0,0,13,13,0,0,13,0,0,0,0,0,0,0,0,0,59067
20110,2610,154,744,680,723,309,135,60,45,4,0,41,15,8,8,0,0,7,0,0,7,75,61,12,0,49,14,14,12,0,2,0,0,0,0,59068
20111,358,14,116,96,99,33,25,13,13,0,0,13,0,0,0,0,0,0,0,0,0,12,9,0,0,9,3,0,0,0,0,3,3,0,0,59069
20112,682,26,213,292,132,19,36,23,18,0,0,18,5,0,0,0,0,5,0,0,5,13,9,0,0,9,4,0,0,0,0,4,0,0,4,59070
20113,86,12,16,17,41,0,8,5,0,0,0,0,5,5,5,0,0,0,0,0,0,3,3,0,0,3,0,0,0,0,0,0,0,0,0,59071
20114,3065,322,1338,973,244,188,224,102,94,40,15,39,8,7,5,0,2,1,0,0,1,122,77,28,0,49,45,42,8,9,25,3,0,0,3,59072
20115,298,45,143,66,34,10,16,7,5,5,0,0,2,0,0,0,0,2,0,2,0,9,9,0,0,9,0,0,0,0,0,0,0,0,0,59074
20116,91,7,27,43,11,3,14,14,6,0,0,6,8,8,8,0,0,0,0,0,0,0,0,0,0,0,0,0,0,0,0,0,0,0,0,59075
20117,61,29,7,12,10,3,5,5,5,0,0,5,0,0,0,0,0,0,0,0,0,0,0,0,0,0,0,0,0,0,0,0,0,0,0,59076
20118,72,3,25,37,7,0,1,1,1,0,0,1,0,0,0,0,0,0,0,0,0,0,0,0,0,0,0,0,0,0,0,0,0,0,0,59077
20119,90,2,47,28,12,1,0,0,0,0,0,0,0,0,0,0,0,0,0,0,0,0,0,0,0,0,0,0,0,0,0,0,0,0,0,59078
20120,2422,121,992,817,445,47,313,117,109,29,26,54,8,8,0,0,8,0,0,0,0,196,142,28,0,114,54,54,54,0,0,0,0,0,0,59079
20121,11,0,0,5,2,4,0,0,0,0,0,0,0,0,0,0,0,0,0,0,0,0,0,0,0,0,0,0,0,0,0,0,0,0,0,59081
20122,23,0,14,9,0,0,0,0,0,0,0,0,0,0,0,0,0,0,0,0,0,0,0,0,0,0,0,0,0,0,0,0,0,0,0,59082
20123,110,0,41,40,29,0,2,2,2,0,0,2,0,0,0,0,0,0,0,0,0,0,0,0,0,0,0,0,0,0,0,0,0,0,0,59085
20124,560,6,138,173,151,92,25,5,5,0,0,5,0,0,0,0,0,0,0,0,0,20,20,0,9,11,0,0,0,0,0,0,0,0,0,59086
20125,367,16,186,120,32,13,29,10,10,6,0,4,0,0,0,0,0,0,0,0,0,19,19,0,0,19,0,0,0,0,0,0,0,0,0,59087
20126,820,41,417,195,159,8,86,55,55,0,5,50,0,0,0,0,0,0,0,0,0,31,31,0,0,31,0,0,0,0,0,0,0,0,0,59088
20127,219,47,60,88,18,6,20,14,7,0,0,7,7,5,0,5,0,2,0,2,0,6,6,0,5,1,0,0,0,0,0,0,0,0,0,59089
20128,26362,3118,9265,8174,4032,1773,2121,1084,673,263,78,332,411,150,73,45,32,261,122,58,81,1037,658,281,45,332,379,120,120,0,0,259,176,73,10,59101
20129,33448,1975,8682,11498,7850,3443,2284,1104,1009,475,59,475,95,81,54,0,27,14,0,0,14,1180,1053,501,90,462,127,96,34,17,45,31,19,0,12,59102
20130,19765,1382,6283,6710,4146,1244,1490,834,694,220,70,404,140,106,68,38,0,34,8,12,14,656,524,253,6,265,132,81,61,0,20,51,6,0,45,59105
20131,8629,330,1762,2472,2709,1356,580,282,228,72,5,151,54,54,43,11,0,0,0,0,0,298,241,60,40,141,57,34,34,0,0,23,0,23,0,59106
20132,3042,378,1201,1033,275,155,327,218,125,22,3,100,93,87,56,0,31,6,0,0,6,109,93,21,0,72,16,1,1,0,0,15,0,0,15,59201
20133,123,3,7,74,23,16,17,5,5,5,0,0,0,0,0,0,0,0,0,0,0,12,12,12,0,0,0,0,0,0,0,0,0,0,0,59211
20134,278,20,82,106,58,12,30,12,10,3,0,7,2,0,0,0,0,2,0,0,2,18,18,0,0,18,0,0,0,0,0,0,0,0,0,59212
20135,454,70,228,104,35,17,36,15,11,0,0,11,4,4,0,0,4,0,0,0,0,21,13,5,0,8,8,0,0,0,0,8,0,0,8,59213
20136,107,0,49,36,15,7,4,4,4,0,0,4,0,0,0,0,0,0,0,0,0,0,0,0,0,0,0,0,0,0,0,0,0,0,0,59214
20137,812,46,373,235,135,23,48,29,24,11,5,8,5,5,5,0,0,0,0,0,0,19,19,10,0,9,0,0,0,0,0,0,0,0,0,59215
20138,157,44,48,53,12,0,0,0,0,0,0,0,0,0,0,0,0,0,0,0,0,0,0,0,0,0,0,0,0,0,0,0,0,0,0,59217
20139,634,52,190,242,123,27,67,51,42,20,0,22,9,9,0,0,9,0,0,0,0,16,16,3,0,13,0,0,0,0,0,0,0,0,0,59218
20140,155,29,29,40,48,9,14,9,9,0,0,9,0,0,0,0,0,0,0,0,0,5,1,0,0,1,4,4,4,0,0,0,0,0,0,59219
20141,996,84,334,394,152,32,76,29,25,17,4,4,4,0,0,0,0,4,0,4,0,47,40,8,0,32,7,7,7,0,0,0,0,0,0,59221
20142,134,6,44,61,21,2,2,0,0,0,0,0,0,0,0,0,0,0,0,0,0,2,2,1,1,0,0,0,0,0,0,0,0,0,0,59222
20143,289,1,113,108,50,17,13,9,3,1,0,2,6,6,6,0,0,0,0,0,0,4,4,1,0,3,0,0,0,0,0,0,0,0,0,59223
20144,290,49,97,97,30,17,40,24,19,3,3,13,5,1,0,1,0,4,0,0,4,16,11,0,0,11,5,0,0,0,0,5,0,0,5,59225
20145,315,30,143,90,49,3,36,2,2,0,0,2,0,0,0,0,0,0,0,0,0,34,34,2,0,32,0,0,0,0,0,0,0,0,0,59226
20146,3248,280,1109,1236,496,127,210,83,59,49,10,0,24,15,0,0,15,9,0,0,9,127,107,36,0,71,20,1,0,0,1,19,0,0,19,59230
20147,263,64,100,92,0,7,4,4,4,0,0,4,0,0,0,0,0,0,0,0,0,0,0,0,0,0,0,0,0,0,0,0,0,0,0,59231
20148,12,0,0,7,2,3,0,0,0,0,0,0,0,0,0,0,0,0,0,0,0,0,0,0,0,0,0,0,0,0,0,0,0,0,0,59240
20149,275,14,118,114,23,6,16,8,8,3,0,5,0,0,0,0,0,0,0,0,0,8,8,1,0,7,0,0,0,0,0,0,0,0,0,59241
20150,71,6,7,51,7,0,0,0,0,0,0,0,0,0,0,0,0,0,0,0,0,0,0,0,0,0,0,0,0,0,0,0,0,0,0,59242
20151,205,21,74,58,40,12,27,27,27,3,0,24,0,0,0,0,0,0,0,0,0,0,0,0,0,0,0,0,0,0,0,0,0,0,0,59243
20152,56,6,15,25,10,0,0,0,0,0,0,0,0,0,0,0,0,0,0,0,0,0,0,0,0,0,0,0,0,0,0,0,0,0,0,59244
20153,252,21,58,93,57,23,25,22,18,6,0,12,4,2,2,0,0,2,2,0,0,3,3,0,3,0,0,0,0,0,0,0,0,0,0,59247
20154,557,44,265,170,64,14,32,24,23,1,0,22,1,1,1,0,0,0,0,0,0,8,8,1,0,7,0,0,0,0,0,0,0,0,0,59248
20155,140,4,80,31,14,11,23,13,13,7,0,6,0,0,0,0,0,0,0,0,0,10,10,0,6,4,0,0,0,0,0,0,0,0,0,59250
20156,89,5,27,39,18,0,1,0,0,0,0,0,0,0,0,0,0,0,0,0,0,1,1,0,1,0,0,0,0,0,0,0,0,0,0,59252
20157,98,12,17,33,27,9,1,1,0,0,0,0,1,0,0,0,0,1,0,0,1,0,0,0,0,0,0,0,0,0,0,0,0,0,0,59253
20158,1511,155,441,589,261,65,77,32,29,20,0,9,3,0,0,0,0,3,2,0,1,45,38,28,0,10,7,7,7,0,0,0,0,0,0,59254
20159,1895,474,765,502,140,14,284,114,54,7,0,47,60,13,0,0,13,47,9,0,38,170,69,9,0,60,101,9,7,0,2,92,0,25,67,59255
20160,42,0,13,29,0,0,0,0,0,0,0,0,0,0,0,0,0,0,0,0,0,0,0,0,0,0,0,0,0,0,0,0,0,0,0,59256
20161,28,0,0,28,0,0,0,0,0,0,0,0,0,0,0,0,0,0,0,0,0,0,0,0,0,0,0,0,0,0,0,0,0,0,0,59257
20162,85,4,23,20,29,9,9,9,9,0,0,9,0,0,0,0,0,0,0,0,0,0,0,0,0,0,0,0,0,0,0,0,0,0,0,59258
20163,246,13,96,94,39,4,39,35,28,18,0,10,7,3,3,0,0,4,4,0,0,4,4,2,0,2,0,0,0,0,0,0,0,0,0,59259
20164,93,7,32,46,8,0,5,1,1,0,0,1,0,0,0,0,0,0,0,0,0,4,4,0,0,4,0,0,0,0,0,0,0,0,0,59260
20165,387,44,175,137,22,9,42,28,19,1,3,15,9,0,0,0,0,9,0,0,9,14,3,0,1,2,11,6,6,0,0,5,0,0,5,59261
20166,522,47,218,182,57,18,71,49,49,11,0,38,0,0,0,0,0,0,0,0,0,22,22,0,2,20,0,0,0,0,0,0,0,0,0,59262
20167,1083,53,341,444,194,51,47,13,8,0,0,8,5,5,0,0,5,0,0,0,0,34,29,14,0,15,5,5,0,5,0,0,0,0,0,59263
20168,5395,516,1772,2133,739,235,380,193,142,45,3,94,51,27,27,0,0,24,24,0,0,187,168,64,6,98,19,3,0,3,0,16,16,0,0,59270
20169,209,15,77,60,51,6,7,0,0,0,0,0,0,0,0,0,0,0,0,0,0,7,7,3,0,4,0,0,0,0,0,0,0,0,0,59274
20170,244,16,71,115,26,16,10,7,7,0,0,7,0,0,0,0,0,0,0,0,0,3,3,3,0,0,0,0,0,0,0,0,0,0,0,59275
20171,13,0,10,3,0,0,8,8,0,0,0,0,8,8,8,0,0,0,0,0,0,0,0,0,0,0,0,0,0,0,0,0,0,0,0,59276
20172,7959,731,2517,3151,1274,286,621,324,237,97,36,104,87,43,38,0,5,44,8,0,36,297,271,119,7,145,26,19,19,0,0,7,7,0,0,59301
20173,160,28,54,71,7,0,8,6,6,3,0,3,0,0,0,0,0,0,0,0,0,2,2,0,0,2,0,0,0,0,0,0,0,0,0,59311
20174,22,4,9,5,4,0,7,0,0,0,0,0,0,0,0,0,0,0,0,0,0,7,2,0,0,2,5,5,5,0,0,0,0,0,0,59312
20175,1761,119,780,600,184,78,77,24,18,13,0,5,6,5,5,0,0,1,0,0,1,53,50,50,0,0,3,0,0,0,0,3,3,0,0,59313
20176,89,2,39,13,32,3,0,0,0,0,0,0,0,0,0,0,0,0,0,0,0,0,0,0,0,0,0,0,0,0,0,0,0,0,0,59314
20177,87,3,19,39,25,1,6,4,4,4,0,0,0,0,0,0,0,0,0,0,0,2,2,0,0,2,0,0,0,0,0,0,0,0,0,59315
20178,884,71,242,396,132,43,64,45,45,0,0,45,0,0,0,0,0,0,0,0,0,19,19,19,0,0,0,0,0,0,0,0,0,0,0,59317
20179,71,4,38,16,11,2,0,0,0,0,0,0,0,0,0,0,0,0,0,0,0,0,0,0,0,0,0,0,0,0,0,0,0,0,0,59318
20180,47,2,15,15,11,4,2,0,0,0,0,0,0,0,0,0,0,0,0,0,0,2,2,0,0,2,0,0,0,0,0,0,0,0,0,59322
20181,1576,32,385,587,358,214,105,71,52,22,0,30,19,19,0,0,19,0,0,0,0,34,27,0,0,27,7,0,0,0,0,7,0,7,0,59323
20182,649,23,257,239,96,34,53,22,16,10,0,6,6,4,0,0,4,2,2,0,0,31,27,2,0,25,4,4,3,0,1,0,0,0,0,59324
20183,272,68,73,87,35,9,20,4,4,0,0,4,0,0,0,0,0,0,0,0,0,16,16,10,0,6,0,0,0,0,0,0,0,0,0,59326
20184,2002,252,685,687,273,105,196,85,85,42,14,29,0,0,0,0,0,0,0,0,0,111,95,61,0,34,16,16,16,0,0,0,0,0,0,59327
20185,5918,655,1776,2456,709,322,431,211,190,92,11,87,21,15,8,0,7,6,0,0,6,220,183,100,22,61,37,37,28,0,9,0,0,0,0,59330
20186,125,16,47,52,10,0,6,6,6,3,0,3,0,0,0,0,0,0,0,0,0,0,0,0,0,0,0,0,0,0,0,0,0,0,0,59332
20187,11,0,0,7,4,0,0,0,0,0,0,0,0,0,0,0,0,0,0,0,0,0,0,0,0,0,0,0,0,0,0,0,0,0,0,59333
20188,169,3,44,59,57,6,10,1,1,0,0,1,0,0,0,0,0,0,0,0,0,9,9,4,2,3,0,0,0,0,0,0,0,0,0,59336
20189,525,50,252,178,36,9,22,18,16,11,0,5,2,2,2,0,0,0,0,0,0,4,2,0,0,2,2,2,2,0,0,0,0,0,0,59337
20190,89,13,19,46,10,1,14,11,11,0,0,11,0,0,0,0,0,0,0,0,0,3,3,0,0,3,0,0,0,0,0,0,0,0,0,59338
20191,113,7,18,68,15,5,5,0,0,0,0,0,0,0,0,0,0,0,0,0,0,5,4,4,0,0,1,1,1,0,0,0,0,0,0,59339
20192,35,0,11,13,11,0,0,0,0,0,0,0,0,0,0,0,0,0,0,0,0,0,0,0,0,0,0,0,0,0,0,0,0,0,0,59343
20193,240,33,76,82,36,13,11,9,9,0,0,9,0,0,0,0,0,0,0,0,0,2,2,0,0,2,0,0,0,0,0,0,0,0,0,59344
20194,238,20,137,50,26,5,13,5,5,5,0,0,0,0,0,0,0,0,0,0,0,8,8,8,0,0,0,0,0,0,0,0,0,0,0,59347
20195,650,58,299,168,96,29,43,28,27,0,0,27,1,0,0,0,0,1,0,0,1,15,15,0,0,15,0,0,0,0,0,0,0,0,0,59349
20196,102,10,34,52,6,0,4,0,0,0,0,0,0,0,0,0,0,0,0,0,0,4,1,1,0,0,3,0,0,0,0,3,0,0,3,59351
20197,700,112,222,229,96,41,59,49,49,16,0,33,0,0,0,0,0,0,0,0,0,10,10,3,0,7,0,0,0,0,0,0,0,0,0,59353
20198,40,0,17,23,0,0,0,0,0,0,0,0,0,0,0,0,0,0,0,0,0,0,0,0,0,0,0,0,0,0,0,0,0,0,0,59354
20199,9589,1325,2907,3098,1576,683,649,304,191,24,51,116,113,57,42,9,6,56,0,48,8,345,235,60,0,175,110,55,29,16,10,55,0,18,37,59401
20200,18468,1279,5765,6281,3481,1662,1678,820,696,253,92,351,124,105,64,13,28,19,0,0,19,858,687,149,119,419,171,68,12,9,47,103,44,0,59,59404
20201,20077,1676,5910,7807,3336,1348,1337,682,469,150,25,294,213,157,89,44,24,56,20,0,36,655,493,297,25,171,162,107,94,0,13,55,0,4,51,59405
20202,518,41,186,149,115,27,87,44,33,6,0,27,11,11,11,0,0,0,0,0,0,43,38,27,0,11,5,0,0,0,0,5,0,0,5,59410
20203,271,0,90,53,128,0,0,0,0,0,0,0,0,0,0,0,0,0,0,0,0,0,0,0,0,0,0,0,0,0,0,0,0,0,0,59411
20204,1167,74,424,384,186,99,104,59,32,0,0,32,27,27,21,0,6,0,0,0,0,45,45,5,0,40,0,0,0,0,0,0,0,0,0,59412
20205,719,156,255,186,111,11,95,43,0,0,0,0,43,43,43,0,0,0,0,0,0,52,52,44,0,8,0,0,0,0,0,0,0,0,0,59414
20206,435,41,106,185,71,32,23,11,11,0,0,11,0,0,0,0,0,0,0,0,0,12,12,9,0,3,0,0,0,0,0,0,0,0,0,59416
20207,4394,914,1128,1875,374,103,435,194,173,16,51,106,21,18,0,17,1,3,0,0,3,241,208,85,3,120,33,25,8,0,17,8,4,0,4,59417
20208,88,0,13,33,38,4,6,6,6,0,0,6,0,0,0,0,0,0,0,0,0,0,0,0,0,0,0,0,0,0,0,0,0,0,0,59418
20209,161,30,48,57,17,9,13,4,4,4,0,0,0,0,0,0,0,0,0,0,0,9,0,0,0,0,9,0,0,0,0,9,0,0,9,59419
20210,167,4,62,55,37,9,7,3,3,3,0,0,0,0,0,0,0,0,0,0,0,4,4,0,0,4,0,0,0,0,0,0,0,0,0,59420
20211,1367,130,383,424,263,167,60,23,17,8,0,9,6,6,6,0,0,0,0,0,0,37,28,5,4,19,9,9,0,7,2,0,0,0,0,59421
20212,1690,155,591,446,405,93,179,101,75,26,0,49,26,15,11,0,4,11,10,0,1,78,63,8,0,55,15,0,0,0,0,15,0,0,15,59422
20213,51,1,31,12,5,2,3,3,3,0,0,3,0,0,0,0,0,0,0,0,0,0,0,0,0,0,0,0,0,0,0,0,0,0,0,59424
20214,2470,285,758,873,435,119,202,113,103,60,0,43,10,3,0,0,3,7,0,6,1,89,78,36,0,42,11,0,0,0,0,11,0,7,4,59425
20215,2679,336,812,890,531,110,237,118,55,29,13,13,63,14,14,0,0,49,49,0,0,119,97,0,0,97,22,0,0,0,0,22,17,5,0,59427
20216,314,11,87,150,59,7,18,13,8,5,0,3,5,1,0,1,0,4,0,0,4,5,5,0,0,5,0,0,0,0,0,0,0,0,0,59430
20217,121,41,37,41,2,0,0,0,0,0,0,0,0,0,0,0,0,0,0,0,0,0,0,0,0,0,0,0,0,0,0,0,0,0,0,59432
20218,490,36,122,163,141,28,45,22,22,0,11,11,0,0,0,0,0,0,0,0,0,23,23,9,0,14,0,0,0,0,0,0,0,0,0,59433
20219,441,31,98,126,127,59,27,6,6,0,6,0,0,0,0,0,0,0,0,0,0,21,18,12,0,6,3,3,0,3,0,0,0,0,0,59434
20220,1248,108,438,465,156,81,57,27,18,4,2,12,9,0,0,0,0,9,0,0,9,30,25,2,3,20,5,1,0,0,1,4,0,0,4,59436
20221,105,3,33,24,31,14,0,0,0,0,0,0,0,0,0,0,0,0,0,0,0,0,0,0,0,0,0,0,0,0,0,0,0,0,0,59440
20222,58,0,44,2,10,2,5,0,0,0,0,0,0,0,0,0,0,0,0,0,0,5,5,5,0,0,0,0,0,0,0,0,0,0,0,59441
20223,1292,96,451,397,231,117,64,37,37,16,0,21,0,0,0,0,0,0,0,0,0,27,27,15,0,12,0,0,0,0,0,0,0,0,0,59442
20224,564,72,185,174,95,38,88,65,57,0,16,41,8,8,8,0,0,0,0,0,0,23,23,7,0,16,0,0,0,0,0,0,0,0,0,59443
20225,184,89,46,39,10,0,14,5,0,0,0,0,5,0,0,0,0,5,0,0,5,9,4,4,0,0,5,0,0,0,0,5,0,0,5,59444
20226,374,25,162,106,60,21,39,14,14,0,0,14,0,0,0,0,0,0,0,0,0,25,25,2,0,23,0,0,0,0,0,0,0,0,0,59446
20227,152,10,75,35,25,7,9,2,2,0,0,2,0,0,0,0,0,0,0,0,0,7,7,0,0,7,0,0,0,0,0,0,0,0,0,59447
20228,333,43,69,175,39,7,39,33,29,10,0,19,4,3,0,3,0,1,0,0,1,6,6,0,0,6,0,0,0,0,0,0,0,0,0,59448
20229,319,7,63,106,133,10,43,27,20,14,0,6,7,7,7,0,0,0,0,0,0,16,16,7,0,9,0,0,0,0,0,0,0,0,0,59450
20230,168,2,56,57,41,12,2,2,2,0,0,2,0,0,0,0,0,0,0,0,0,0,0,0,0,0,0,0,0,0,0,0,0,0,0,59451
20231,398,18,154,111,96,19,15,3,3,0,0,3,0,0,0,0,0,0,0,0,0,12,6,0,0,6,6,6,6,0,0,0,0,0,0,59452
20232,220,7,82,48,75,8,14,9,9,0,0,9,0,0,0,0,0,0,0,0,0,5,5,0,0,5,0,0,0,0,0,0,0,0,0,59453
20233,145,18,34,76,17,0,24,22,22,0,0,22,0,0,0,0,0,0,0,0,0,2,2,0,0,2,0,0,0,0,0,0,0,0,0,59454
20234,133,0,32,62,39,0,2,2,1,1,0,0,1,1,0,0,1,0,0,0,0,0,0,0,0,0,0,0,0,0,0,0,0,0,0,59456
20235,7054,580,2433,2147,1364,530,362,200,175,95,0,80,25,25,8,17,0,0,0,0,0,162,142,86,0,56,20,0,0,0,0,20,0,20,0,59457
20236,118,27,45,36,8,2,18,18,9,0,0,9,9,0,0,0,0,9,0,9,0,0,0,0,0,0,0,0,0,0,0,0,0,0,0,59460
20237,11,0,7,0,4,0,0,0,0,0,0,0,0,0,0,0,0,0,0,0,0,0,0,0,0,0,0,0,0,0,0,0,0,0,0,59461
20238,105,0,34,35,32,4,2,2,2,0,0,2,0,0,0,0,0,0,0,0,0,0,0,0,0,0,0,0,0,0,0,0,0,0,0,59462
20239,96,4,35,20,37,0,8,8,8,0,0,8,0,0,0,0,0,0,0,0,0,0,0,0,0,0,0,0,0,0,0,0,0,0,0,59463
20240,288,21,128,104,30,5,31,22,18,10,2,6,4,0,0,0,0,4,2,0,2,9,6,0,0,6,3,0,0,0,0,3,0,0,3,59464
20241,64,4,32,13,12,3,0,0,0,0,0,0,0,0,0,0,0,0,0,0,0,0,0,0,0,0,0,0,0,0,0,0,0,0,0,59465
20242,73,10,15,38,10,0,11,8,8,0,0,8,0,0,0,0,0,0,0,0,0,3,3,0,0,3,0,0,0,0,0,0,0,0,0,59466
20243,148,19,33,81,13,2,17,1,1,1,0,0,0,0,0,0,0,0,0,0,0,16,16,0,0,16,0,0,0,0,0,0,0,0,0,59467
20244,455,45,122,197,78,13,54,28,22,6,0,16,6,0,0,0,0,6,0,0,6,26,21,8,0,13,5,3,1,0,2,2,0,0,2,59468
20245,126,10,41,52,19,4,1,1,1,0,0,1,0,0,0,0,0,0,0,0,0,0,0,0,0,0,0,0,0,0,0,0,0,0,0,59469
20246,183,12,89,50,23,9,48,44,42,0,37,5,2,2,0,0,2,0,0,0,0,4,4,0,0,4,0,0,0,0,0,0,0,0,0,59471
20247,534,95,194,181,57,7,56,27,27,5,0,22,0,0,0,0,0,0,0,0,0,29,17,3,0,14,12,5,0,0,5,7,0,0,7,59472
20248,2709,285,1010,1056,244,114,212,105,51,18,0,33,54,25,0,0,25,29,25,0,4,107,97,26,0,71,10,10,0,0,10,0,0,0,0,59474
20249,295,53,145,71,16,10,38,29,22,0,0,22,7,0,0,0,0,7,7,0,0,9,3,0,0,3,6,0,0,0,0,6,6,0,0,59477
20250,712,66,201,206,213,26,31,9,6,0,4,2,3,3,3,0,0,0,0,0,0,22,22,0,8,14,0,0,0,0,0,0,0,0,0,59479
20251,318,16,116,137,36,13,12,6,6,0,0,6,0,0,0,0,0,0,0,0,0,6,0,0,0,0,6,0,0,0,0,6,0,0,6,59480
20252,519,125,113,184,82,15,72,38,28,10,0,18,10,10,10,0,0,0,0,0,0,34,16,2,0,14,18,2,0,2,0,16,0,0,16,59482
20253,305,51,124,100,12,18,0,0,0,0,0,0,0,0,0,0,0,0,0,0,0,0,0,0,0,0,0,0,0,0,0,0,0,0,0,59483
20254,129,1,32,64,32,0,0,0,0,0,0,0,0,0,0,0,0,0,0,0,0,0,0,0,0,0,0,0,0,0,0,0,0,0,0,59484
20255,368,17,130,150,35,36,36,23,15,0,0,15,8,8,0,0,8,0,0,0,0,13,13,10,0,3,0,0,0,0,0,0,0,0,0,59485
20256,858,134,270,301,135,18,88,39,39,14,0,25,0,0,0,0,0,0,0,0,0,49,35,23,0,12,14,0,0,0,0,14,0,0,14,59486
20257,1012,107,336,383,146,40,86,55,49,4,0,45,6,3,3,0,0,3,3,0,0,31,31,6,0,25,0,0,0,0,0,0,0,0,0,59487
20258,199,14,56,94,35,0,4,4,4,0,0,4,0,0,0,0,0,0,0,0,0,0,0,0,0,0,0,0,0,0,0,0,0,0,0,59489
20259,7994,554,2204,3290,1323,623,813,414,376,92,24,260,38,35,35,0,0,3,3,0,0,399,354,195,12,147,45,28,28,0,0,17,17,0,0,59501
20260,847,52,349,291,124,31,63,43,43,4,5,34,0,0,0,0,0,0,0,0,0,20,20,2,0,18,0,0,0,0,0,0,0,0,0,59520
20261,1954,347,401,982,163,61,263,170,132,22,0,110,38,30,12,7,11,8,3,0,5,93,82,4,5,73,11,5,0,0,5,6,1,0,5,59521
20262,1307,319,317,409,214,48,137,80,32,32,0,0,48,0,0,0,0,48,6,0,42,57,49,0,0,49,8,0,0,0,0,8,0,0,8,59522
20263,1566,171,649,503,198,45,71,55,38,21,0,17,17,6,6,0,0,11,5,0,6,16,16,0,0,16,0,0,0,0,0,0,0,0,0,59523
20264,468,84,164,155,48,17,66,41,34,0,0,34,7,2,0,0,2,5,0,5,0,25,18,1,0,17,7,7,4,0,3,0,0,0,0,59524
20265,153,44,28,49,28,4,12,8,5,5,0,0,3,3,3,0,0,0,0,0,0,4,0,0,0,0,4,1,0,0,1,3,0,0,3,59525
20266,1409,221,342,582,212,52,171,104,94,4,13,77,10,4,0,0,4,6,0,6,0,67,57,6,3,48,10,10,0,0,10,0,0,0,0,59526
20267,493,55,146,227,53,12,35,26,25,0,0,25,1,1,0,0,1,0,0,0,0,9,4,0,4,0,5,5,0,0,5,0,0,0,0,59527
20268,135,4,43,58,26,4,8,5,5,0,0,5,0,0,0,0,0,0,0,0,0,3,3,0,0,3,0,0,0,0,0,0,0,0,0,59528
20269,120,3,40,61,15,1,11,4,4,3,0,1,0,0,0,0,0,0,0,0,0,7,7,0,0,7,0,0,0,0,0,0,0,0,0,59529
20270,89,5,29,33,22,0,6,6,6,0,0,6,0,0,0,0,0,0,0,0,0,0,0,0,0,0,0,0,0,0,0,0,0,0,0,59530
20271,245,20,47,107,55,16,0,0,0,0,0,0,0,0,0,0,0,0,0,0,0,0,0,0,0,0,0,0,0,0,0,0,0,0,0,59531
20272,140,15,20,89,12,4,2,2,2,0,0,2,0,0,0,0,0,0,0,0,0,0,0,0,0,0,0,0,0,0,0,0,0,0,0,59532
20273,67,0,25,37,5,0,0,0,0,0,0,0,0,0,0,0,0,0,0,0,0,0,0,0,0,0,0,0,0,0,0,0,0,0,0,59535
20274,99,0,85,12,2,0,23,21,21,0,0,21,0,0,0,0,0,0,0,0,0,2,2,0,0,2,0,0,0,0,0,0,0,0,0,59537
20275,2111,149,859,733,258,112,144,89,74,21,0,53,15,0,0,0,0,15,0,15,0,55,55,11,23,21,0,0,0,0,0,0,0,0,0,59538
20276,265,11,69,117,63,5,4,3,3,3,0,0,0,0,0,0,0,0,0,0,0,1,0,0,0,0,1,1,0,0,1,0,0,0,0,59540
20277,157,16,55,71,13,2,20,5,2,1,0,1,3,3,0,0,3,0,0,0,0,15,4,0,0,4,11,0,0,0,0,11,0,0,11,59542
20278,109,7,36,26,40,0,3,1,1,1,0,0,0,0,0,0,0,0,0,0,0,2,2,1,0,1,0,0,0,0,0,0,0,0,0,59544
20279,30,0,2,17,11,0,0,0,0,0,0,0,0,0,0,0,0,0,0,0,0,0,0,0,0,0,0,0,0,0,0,0,0,0,0,59545
20280,60,6,27,17,10,0,10,0,0,0,0,0,0,0,0,0,0,0,0,0,0,10,10,0,0,10,0,0,0,0,0,0,0,0,0,59546
20281,28,0,15,13,0,0,1,1,0,0,0,0,1,1,1,0,0,0,0,0,0,0,0,0,0,0,0,0,0,0,0,0,0,0,0,59547
20282,20901,1100,4015,6131,5609,4046,1558,739,698,219,78,401,41,33,12,0,21,8,0,0,8,819,722,298,29,395,97,92,89,0,3,5,0,0,5,59601
20283,17069,944,4209,6484,3961,1471,957,576,491,107,20,364,85,85,31,38,16,0,0,0,0,381,330,124,0,206,51,28,13,0,15,23,16,0,7,59602
20284,138,22,31,58,14,13,11,7,2,0,0,2,5,5,5,0,0,0,0,0,0,4,4,0,0,4,0,0,0,0,0,0,0,0,0,59631
20285,1483,139,524,561,183,76,175,79,55,0,18,37,24,24,11,13,0,0,0,0,0,96,83,19,10,54,13,13,0,0,13,0,0,0,0,59632
20286,151,27,45,38,28,13,4,0,0,0,0,0,0,0,0,0,0,0,0,0,0,4,0,0,0,0,4,0,0,0,0,4,0,0,4,59633
20287,3363,69,779,920,1053,542,328,175,175,39,52,84,0,0,0,0,0,0,0,0,0,153,141,37,0,104,12,12,5,0,7,0,0,0,0,59634
20288,4685,148,1568,1807,910,252,547,383,324,48,121,155,59,59,59,0,0,0,0,0,0,164,152,55,74,23,12,12,0,12,0,0,0,0,0,59635
20289,2,0,2,0,0,0,0,0,0,0,0,0,0,0,0,0,0,0,0,0,0,0,0,0,0,0,0,0,0,0,0,0,0,0,0,59636
20290,512,55,167,133,104,53,22,12,12,6,0,6,0,0,0,0,0,0,0,0,0,10,0,0,0,0,10,10,10,0,0,0,0,0,0,59638
20291,794,57,288,311,106,32,60,34,34,17,0,17,0,0,0,0,0,0,0,0,0,26,26,13,0,13,0,0,0,0,0,0,0,0,0,59639
20292,76,0,24,16,22,14,0,0,0,0,0,0,0,0,0,0,0,0,0,0,0,0,0,0,0,0,0,0,0,0,0,0,0,0,0,59640
20293,24,0,13,8,1,2,0,0,0,0,0,0,0,0,0,0,0,0,0,0,0,0,0,0,0,0,0,0,0,0,0,0,0,0,0,59642
20294,464,40,316,56,44,8,25,20,20,13,0,7,0,0,0,0,0,0,0,0,0,5,0,0,0,0,5,5,5,0,0,0,0,0,0,59643
20295,2793,329,1144,865,238,217,181,111,82,55,0,27,29,10,10,0,0,19,19,0,0,70,32,8,3,21,38,0,0,0,0,38,5,29,4,59644
20296,1126,130,446,347,163,40,98,25,19,0,0,19,6,3,2,0,1,3,0,0,3,73,55,14,0,41,18,6,3,3,0,12,12,0,0,59645
20297,213,35,35,56,37,50,55,0,0,0,0,0,0,0,0,0,0,0,0,0,0,55,55,55,0,0,0,0,0,0,0,0,0,0,0,59647
20298,349,27,157,87,51,27,11,4,4,4,0,0,0,0,0,0,0,0,0,0,0,7,7,2,0,5,0,0,0,0,0,0,0,0,0,59648
20299,22584,2049,8651,6938,3274,1672,2017,1173,1059,210,92,757,114,70,33,37,0,44,3,12,29,844,563,248,15,300,281,189,189,0,0,92,62,28,2,59701
20300,66,27,2,2,35,0,0,0,0,0,0,0,0,0,0,0,0,0,0,0,0,0,0,0,0,0,0,0,0,0,0,0,0,0,0,59703
20301,238,14,97,66,54,7,10,4,0,0,0,0,4,4,4,0,0,0,0,0,0,6,6,6,0,0,0,0,0,0,0,0,0,0,0,59710
20302,6467,677,2324,2222,804,440,658,347,194,65,47,82,153,101,78,0,23,52,0,12,40,311,246,51,54,141,65,25,23,0,2,40,0,19,21,59711
20303,171,18,57,61,28,7,7,0,0,0,0,0,0,0,0,0,0,0,0,0,0,7,7,5,0,2,0,0,0,0,0,0,0,0,0,59713
20304,11760,623,3136,4193,2717,1091,1048,590,564,158,80,326,26,17,3,14,0,9,0,9,0,458,376,142,65,169,82,43,29,10,4,39,39,0,0,59714
20305,18927,529,2341,5093,6743,4221,3552,1863,1845,382,163,1300,18,13,11,0,2,5,2,0,3,1689,1666,627,162,877,23,23,17,6,0,0,0,0,0,59715
20306,1266,21,207,299,571,168,46,40,29,0,17,12,11,11,11,0,0,0,0,0,0,6,6,0,0,6,0,0,0,0,0,0,0,0,0,59716
20307,17809,533,3209,5479,6023,2565,727,428,350,105,3,242,78,58,52,5,1,20,9,0,11,299,288,127,12,149,11,7,3,4,0,4,4,0,0,59718
20308,240,0,13,97,74,56,0,0,0,0,0,0,0,0,0,0,0,0,0,0,0,0,0,0,0,0,0,0,0,0,0,0,0,0,0,59720
20309,389,30,90,157,99,13,38,7,7,4,0,3,0,0,0,0,0,0,0,0,0,31,19,8,0,11,12,12,0,0,12,0,0,0,0,59721
20310,4332,423,1743,1471,472,223,284,147,106,20,0,86,41,27,0,0,27,14,0,0,14,137,87,30,0,57,50,41,28,0,13,9,0,9,0,59722
20311,106,0,62,14,15,15,23,9,9,0,0,9,0,0,0,0,0,0,0,0,0,14,14,0,0,14,0,0,0,0,0,0,0,0,0,59724
20312,5080,392,1414,1847,885,542,710,334,308,111,12,185,26,0,0,0,0,26,0,0,26,376,339,142,61,136,37,0,0,0,0,37,10,0,27,59725
20313,174,3,51,58,50,12,6,3,3,0,0,3,0,0,0,0,0,0,0,0,0,3,3,3,0,0,0,0,0,0,0,0,0,0,0,59727
20314,282,14,75,128,40,25,35,29,19,0,2,17,10,4,0,4,0,6,6,0,0,6,6,1,0,5,0,0,0,0,0,0,0,0,0,59728
20315,1659,53,560,473,346,227,25,25,19,0,6,13,6,6,6,0,0,0,0,0,0,0,0,0,0,0,0,0,0,0,0,0,0,0,0,59729
20316,1437,70,388,375,443,161,64,28,28,11,0,17,0,0,0,0,0,0,0,0,0,36,36,2,0,34,0,0,0,0,0,0,0,0,0,59730
20317,108,11,49,25,3,20,3,3,3,0,0,3,0,0,0,0,0,0,0,0,0,0,0,0,0,0,0,0,0,0,0,0,0,0,0,59731
20318,52,0,19,12,21,0,0,0,0,0,0,0,0,0,0,0,0,0,0,0,0,0,0,0,0,0,0,0,0,0,0,0,0,0,0,59732
20319,163,29,48,61,20,5,2,2,0,0,0,0,2,0,0,0,0,2,0,0,2,0,0,0,0,0,0,0,0,0,0,0,0,0,0,59733
20320,349,27,145,82,80,15,28,6,6,0,0,6,0,0,0,0,0,0,0,0,0,22,8,0,3,5,14,14,14,0,0,0,0,0,0,59735
20321,130,6,35,46,32,11,6,4,1,1,0,0,3,0,0,0,0,3,3,0,0,2,0,0,0,0,2,0,0,0,0,2,2,0,0,59736
20322,281,7,134,76,41,23,0,0,0,0,0,0,0,0,0,0,0,0,0,0,0,0,0,0,0,0,0,0,0,0,0,0,0,0,0,59739
20323,165,0,36,84,18,27,0,0,0,0,0,0,0,0,0,0,0,0,0,0,0,0,0,0,0,0,0,0,0,0,0,0,0,0,0,59740
20324,2986,249,862,907,675,293,164,102,83,9,6,68,19,16,10,0,6,3,3,0,0,62,58,19,4,35,4,2,2,0,0,2,2,0,0,59741
20325,135,21,65,22,15,12,2,2,0,0,0,0,2,2,2,0,0,0,0,0,0,0,0,0,0,0,0,0,0,0,0,0,0,0,0,59743
20326,93,28,21,24,20,0,7,5,3,0,0,3,2,2,0,0,2,0,0,0,0,2,2,2,0,0,0,0,0,0,0,0,0,0,0,59745
20327,67,0,14,23,19,11,0,0,0,0,0,0,0,0,0,0,0,0,0,0,0,0,0,0,0,0,0,0,0,0,0,0,0,0,0,59746
20328,165,0,77,65,15,8,30,6,6,0,0,6,0,0,0,0,0,0,0,0,0,24,24,21,0,3,0,0,0,0,0,0,0,0,0,59747
20329,154,16,52,71,15,0,21,14,11,0,0,11,3,0,0,0,0,3,0,0,3,7,7,4,0,3,0,0,0,0,0,0,0,0,0,59748
20330,1191,104,381,405,237,64,57,26,26,4,0,22,0,0,0,0,0,0,0,0,0,31,31,10,0,21,0,0,0,0,0,0,0,0,0,59749
20331,249,13,87,85,46,18,7,0,0,0,0,0,0,0,0,0,0,0,0,0,0,7,7,7,0,0,0,0,0,0,0,0,0,0,0,59750
20332,155,3,46,60,25,21,33,8,8,0,0,8,0,0,0,0,0,0,0,0,0,25,25,6,14,5,0,0,0,0,0,0,0,0,0,59751
20333,2297,197,861,708,403,128,196,116,102,5,17,80,14,4,0,4,0,10,10,0,0,80,56,48,0,8,24,18,18,0,0,6,0,0,6,59752
20334,625,23,162,169,203,68,41,14,13,0,0,13,1,0,0,0,0,1,0,0,1,27,21,10,0,11,6,4,4,0,0,2,0,0,2,59754
20335,194,6,40,59,58,31,11,5,5,3,0,2,0,0,0,0,0,0,0,0,0,6,6,0,0,6,0,0,0,0,0,0,0,0,0,59755
20336,315,54,140,104,13,4,7,7,4,0,0,4,3,1,0,0,1,2,0,0,2,0,0,0,0,0,0,0,0,0,0,0,0,0,0,59756
20337,1481,60,483,500,335,103,109,33,23,12,0,11,10,0,0,0,0,10,0,0,10,76,71,41,7,23,5,5,0,0,5,0,0,0,0,59758
20338,2657,165,928,876,488,200,102,49,38,19,5,14,11,11,11,0,0,0,0,0,0,53,37,23,0,14,16,16,0,0,16,0,0,0,0,59759
20339,221,26,95,70,23,7,11,7,7,1,0,6,0,0,0,0,0,0,0,0,0,4,4,4,0,0,0,0,0,0,0,0,0,0,0,59760
20340,247,11,99,84,43,10,16,13,13,0,0,13,0,0,0,0,0,0,0,0,0,3,3,0,0,3,0,0,0,0,0,0,0,0,0,59761
20341,277,10,126,67,52,22,29,25,20,0,0,20,5,5,0,5,0,0,0,0,0,4,4,0,0,4,0,0,0,0,0,0,0,0,0,59762
20342,18386,1006,4027,5644,4741,2968,2813,1304,1143,300,256,587,161,127,63,9,55,34,0,34,0,1509,1350,564,155,631,159,86,86,0,0,73,23,0,50,59801
20343,12723,678,2603,4078,3467,1897,939,566,552,224,63,265,14,0,0,0,0,14,0,14,0,373,256,109,0,147,117,85,77,0,8,32,21,11,0,59802
20344,10777,348,1687,3335,3371,2036,813,463,391,64,78,249,72,72,54,18,0,0,0,0,0,350,315,81,67,167,35,18,0,18,0,17,0,0,17,59803
20345,5579,314,1466,1676,1342,781,371,180,180,180,0,0,0,0,0,0,0,0,0,0,0,191,187,109,0,78,4,0,0,0,0,4,0,4,0,59804
20346,12140,719,3201,4515,2666,1039,632,309,252,32,0,220,57,56,0,47,9,1,0,0,1,323,236,72,15,149,87,72,71,0,1,15,0,0,15,59808
20347,906,38,346,324,147,51,68,27,12,0,4,8,15,15,15,0,0,0,0,0,0,41,41,11,16,14,0,0,0,0,0,0,0,0,0,59820
20348,1512,221,356,602,242,91,165,96,70,0,23,47,26,26,26,0,0,0,0,0,0,69,56,12,0,44,13,13,0,7,6,0,0,0,0,59821
20349,1022,88,293,294,252,95,31,18,18,7,6,5,0,0,0,0,0,0,0,0,0,13,13,0,0,13,0,0,0,0,0,0,0,0,0,59823
20350,1056,157,296,357,172,74,184,127,100,28,9,63,27,4,0,4,0,23,0,23,0,57,57,3,2,52,0,0,0,0,0,0,0,0,0,59824
20351,1667,202,757,399,208,101,75,10,10,0,0,10,0,0,0,0,0,0,0,0,0,65,42,19,4,19,23,0,0,0,0,23,23,0,0,59825
20352,453,17,157,142,84,53,12,12,12,7,0,5,0,0,0,0,0,0,0,0,0,0,0,0,0,0,0,0,0,0,0,0,0,0,0,59826
20353,283,36,170,52,19,6,0,0,0,0,0,0,0,0,0,0,0,0,0,0,0,0,0,0,0,0,0,0,0,0,0,0,0,0,0,59827
20354,3938,327,1108,1557,709,237,348,156,138,0,0,138,18,0,0,0,0,18,18,0,0,192,165,25,72,68,27,27,0,27,0,0,0,0,0,59828
20355,1693,172,701,536,186,98,205,158,152,96,2,54,6,2,0,0,2,4,0,4,0,47,19,1,3,15,28,22,16,0,6,6,0,6,0,59829
20356,74,20,16,38,0,0,0,0,0,0,0,0,0,0,0,0,0,0,0,0,0,0,0,0,0,0,0,0,0,0,0,0,0,0,0,59830
20357,344,33,100,152,48,11,61,30,9,1,0,8,21,21,2,0,19,0,0,0,0,31,10,0,0,10,21,11,0,0,11,10,4,0,6,59831
20358,707,117,252,208,112,18,40,8,8,3,0,5,0,0,0,0,0,0,0,0,0,32,30,4,0,26,2,2,0,0,2,0,0,0,0,59832
20359,3687,187,1211,1262,741,286,258,154,133,55,20,58,21,21,10,11,0,0,0,0,0,104,104,47,29,28,0,0,0,0,0,0,0,0,0,59833
20360,1386,50,638,373,247,78,122,79,27,27,0,0,52,0,0,0,0,52,0,0,52,43,30,0,0,30,13,13,0,0,13,0,0,0,0,59834
20361,254,17,75,90,52,20,14,7,7,0,0,7,0,0,0,0,0,0,0,0,0,7,7,0,0,7,0,0,0,0,0,0,0,0,0,59837
20362,9840,799,3455,3030,1594,962,462,275,180,19,0,161,95,66,14,10,42,29,23,0,6,187,170,47,0,123,17,0,0,0,0,17,0,0,17,59840
20363,340,53,163,79,39,6,65,39,25,8,3,14,14,8,7,0,1,6,6,0,0,26,21,8,0,13,5,4,4,0,0,1,0,1,0,59841
20364,78,0,36,26,16,0,14,3,3,0,0,3,0,0,0,0,0,0,0,0,0,11,11,0,0,11,0,0,0,0,0,0,0,0,0,59842
20365,285,18,78,122,55,12,27,22,22,4,0,18,0,0,0,0,0,0,0,0,0,5,5,3,0,2,0,0,0,0,0,0,0,0,0,59843
20366,560,93,232,141,77,17,94,71,45,18,0,27,26,0,0,0,0,26,11,0,15,23,23,0,0,23,0,0,0,0,0,0,0,0,0,59844
20367,955,147,313,313,110,72,55,25,20,0,0,20,5,5,5,0,0,0,0,0,0,30,25,0,0,25,5,3,3,0,0,2,0,0,2,59845
20368,1014,98,329,242,202,143,105,0,0,0,0,0,0,0,0,0,0,0,0,0,0,105,105,52,0,53,0,0,0,0,0,0,0,0,0,59846
20369,3700,159,889,1295,902,455,310,104,79,41,0,38,25,25,25,0,0,0,0,0,0,206,144,48,18,78,62,62,26,36,0,0,0,0,0,59847
20370,96,9,44,33,5,5,23,4,0,0,0,0,4,0,0,0,0,4,0,0,4,19,19,0,0,19,0,0,0,0,0,0,0,0,0,59848
20371,175,38,9,29,99,0,0,0,0,0,0,0,0,0,0,0,0,0,0,0,0,0,0,0,0,0,0,0,0,0,0,0,0,0,0,59851
20372,694,111,259,231,85,8,28,24,0,0,0,0,24,14,14,0,0,10,0,0,10,4,4,2,0,2,0,0,0,0,0,0,0,0,0,59853
20373,225,20,59,60,56,30,2,2,2,2,0,0,0,0,0,0,0,0,0,0,0,0,0,0,0,0,0,0,0,0,0,0,0,0,0,59854
20374,573,52,194,270,57,0,46,20,20,0,20,0,0,0,0,0,0,0,0,0,0,26,0,0,0,0,26,17,0,0,17,9,0,0,9,59855
20375,285,25,111,96,37,16,28,14,14,2,0,12,0,0,0,0,0,0,0,0,0,14,14,0,0,14,0,0,0,0,0,0,0,0,0,59856
20376,1148,148,323,337,237,103,45,31,28,3,10,15,3,3,3,0,0,0,0,0,0,14,14,10,0,4,0,0,0,0,0,0,0,0,0,59858
20377,2382,249,988,743,331,71,92,62,24,7,0,17,38,22,0,21,1,16,0,16,0,30,20,16,0,4,10,10,0,0,10,0,0,0,0,59859
20378,6862,442,2427,2005,1298,690,357,160,137,68,0,69,23,23,4,19,0,0,0,0,0,197,175,78,0,97,22,3,3,0,0,19,0,14,5,59860
20379,66,0,7,59,0,0,0,0,0,0,0,0,0,0,0,0,0,0,0,0,0,0,0,0,0,0,0,0,0,0,0,0,0,0,0,59863
20380,4276,470,1416,1663,438,289,408,193,175,31,25,119,18,12,3,0,9,6,0,6,0,215,168,41,20,107,47,6,4,0,2,41,0,4,37,59864
20381,1942,327,430,805,214,166,209,73,63,17,0,46,10,10,10,0,0,0,0,0,0,136,74,0,8,66,62,36,25,0,11,26,6,7,13,59865
20382,823,65,346,323,83,6,60,36,12,12,0,0,24,24,0,0,24,0,0,0,0,24,24,7,0,17,0,0,0,0,0,0,0,0,0,59866
20383,9,0,4,5,0,0,0,0,0,0,0,0,0,0,0,0,0,0,0,0,0,0,0,0,0,0,0,0,0,0,0,0,0,0,0,59867
20384,1284,108,419,359,214,184,73,38,30,7,0,23,8,8,8,0,0,0,0,0,0,35,21,14,0,7,14,14,0,8,6,0,0,0,0,59868
20385,7477,577,2566,2421,1457,456,342,177,128,0,51,77,49,43,36,7,0,6,0,6,0,165,125,36,12,77,40,24,6,0,18,16,0,10,6,59870
20386,148,13,59,45,31,0,0,0,0,0,0,0,0,0,0,0,0,0,0,0,0,0,0,0,0,0,0,0,0,0,0,0,0,0,0,59871
20387,1673,240,828,400,151,54,149,45,35,7,11,17,10,10,0,0,10,0,0,0,0,104,104,27,0,77,0,0,0,0,0,0,0,0,0,59872
20388,2475,295,1124,704,274,78,163,86,62,7,0,55,24,0,0,0,0,24,0,12,12,77,66,31,0,35,11,11,3,0,8,0,0,0,0,59873
20389,753,124,294,141,138,56,49,17,14,0,0,14,3,0,0,0,0,3,0,0,3,32,32,0,3,29,0,0,0,0,0,0,0,0,0,59874
20390,2552,209,835,973,431,104,205,141,66,13,0,53,75,14,14,0,0,61,0,61,0,64,59,5,0,54,5,5,5,0,0,0,0,0,0,59875
20391,33320,2132,10646,12011,5829,2702,3038,1438,1060,261,79,720,378,254,187,62,5,124,3,43,78,1600,1287,523,86,678,313,280,137,84,59,33,33,0,0,59901
20392,417,38,161,134,59,25,32,14,14,3,0,11,0,0,0,0,0,0,0,0,0,18,18,0,0,18,0,0,0,0,0,0,0,0,0,59910
20393,5998,261,1577,2204,1398,558,255,159,87,52,3,32,72,32,29,3,0,40,25,0,15,96,85,20,4,61,11,11,2,0,9,0,0,0,0,59911
20394,9422,631,3334,3249,1701,507,551,333,269,125,3,141,64,39,0,33,6,25,0,25,0,218,130,67,7,56,88,47,0,0,47,41,0,0,41,59912
20395,412,15,131,130,127,9,0,0,0,0,0,0,0,0,0,0,0,0,0,0,0,0,0,0,0,0,0,0,0,0,0,0,0,0,0,59913
20396,175,15,78,32,20,30,3,3,3,0,0,3,0,0,0,0,0,0,0,0,0,0,0,0,0,0,0,0,0,0,0,0,0,0,0,59914
20397,361,45,94,84,107,31,15,0,0,0,0,0,0,0,0,0,0,0,0,0,0,15,15,0,0,15,0,0,0,0,0,0,0,0,0,59915
20398,56,0,22,25,5,4,0,0,0,0,0,0,0,0,0,0,0,0,0,0,0,0,0,0,0,0,0,0,0,0,0,0,0,0,0,59916
20399,3009,262,884,1062,543,258,340,165,154,35,39,80,11,11,11,0,0,0,0,0,0,175,175,19,3,153,0,0,0,0,0,0,0,0,0,59917
20400,558,56,145,207,130,20,0,0,0,0,0,0,0,0,0,0,0,0,0,0,0,0,0,0,0,0,0,0,0,0,0,0,0,0,0,59918
20401,585,173,297,93,8,14,38,38,32,7,0,25,6,6,6,0,0,0,0,0,0,0,0,0,0,0,0,0,0,0,0,0,0,0,0,59919
20402,1334,92,387,496,256,103,63,35,25,4,0,21,10,0,0,0,0,10,0,4,6,28,28,11,3,14,0,0,0,0,0,0,0,0,0,59920
20403,1827,37,310,620,528,332,77,66,66,38,0,28,0,0,0,0,0,0,0,0,0,11,0,0,0,0,11,11,11,0,0,0,0,0,0,59922
20404,7281,1092,2642,2440,706,401,365,237,200,58,19,123,37,0,0,0,0,37,0,0,37,128,123,28,0,95,5,5,0,0,5,0,0,0,0,59923
20405,967,148,367,314,89,49,102,73,51,24,0,27,22,22,0,22,0,0,0,0,0,29,29,4,0,25,0,0,0,0,0,0,0,0,0,59925
20406,300,45,143,62,50,0,63,0,0,0,0,0,0,0,0,0,0,0,0,0,0,63,63,53,0,10,0,0,0,0,0,0,0,0,0,59926
20407,215,29,129,28,29,0,31,17,17,0,0,17,0,0,0,0,0,0,0,0,0,14,14,0,0,14,0,0,0,0,0,0,0,0,0,59927
20408,82,0,0,57,0,25,0,0,0,0,0,0,0,0,0,0,0,0,0,0,0,0,0,0,0,0,0,0,0,0,0,0,0,0,0,59928
20409,180,3,72,63,27,15,18,9,9,0,0,9,0,0,0,0,0,0,0,0,0,9,9,6,0,3,0,0,0,0,0,0,0,0,0,59929
20410,621,5,330,158,57,71,27,12,12,12,0,0,0,0,0,0,0,0,0,0,0,15,15,0,0,15,0,0,0,0,0,0,0,0,0,59930
20411,237,36,50,68,52,31,0,0,0,0,0,0,0,0,0,0,0,0,0,0,0,0,0,0,0,0,0,0,0,0,0,0,0,0,0,59931
20412,1113,10,313,493,280,17,85,36,36,21,0,15,0,0,0,0,0,0,0,0,0,49,49,23,26,0,0,0,0,0,0,0,0,0,0,59932
20413,43,16,21,6,0,0,13,7,7,0,0,7,0,0,0,0,0,0,0,0,0,6,0,0,0,0,6,6,6,0,0,0,0,0,0,59933
20414,397,38,124,182,49,4,10,10,10,0,0,10,0,0,0,0,0,0,0,0,0,0,0,0,0,0,0,0,0,0,0,0,0,0,0,59934
20415,2803,479,923,955,353,93,133,89,86,5,2,79,3,3,3,0,0,0,0,0,0,44,29,12,0,17,15,15,2,0,13,0,0,0,0,59935
20416,336,20,43,139,65,69,70,33,5,0,0,5,28,28,28,0,0,0,0,0,0,37,22,19,0,3,15,15,15,0,0,0,0,0,0,59936
20417,9445,414,2332,2727,2682,1290,442,275,209,27,0,182,66,56,47,9,0,10,0,0,10,167,137,46,0,91,30,27,0,20,7,3,3,0,0,59937
20418,16495,1071,5044,5422,3109,1849,1470,826,703,198,97,408,123,123,39,84,0,0,0,0,0,644,571,214,34,323,73,58,27,0,31,15,0,0,15,60002
20419,35435,1857,6635,8280,11385,7278,2361,1266,1180,260,19,901,86,69,22,20,27,17,0,0,17,1095,1054,364,28,662,41,27,27,0,0,14,0,0,14,60004
20420,21675,1298,4969,5198,6420,3790,1414,669,634,204,112,318,35,0,0,0,0,35,0,0,35,745,704,343,104,257,41,41,0,0,41,0,0,0,0,60005
20421,24454,1729,6289,7711,6300,2425,1610,648,627,144,67,416,21,21,10,11,0,0,0,0,0,962,829,291,22,516,133,32,15,0,17,101,0,0,101,60007
20422,15314,2307,4041,4591,2869,1506,1046,498,417,182,14,221,81,37,24,7,6,44,39,0,5,548,410,92,48,270,138,138,38,68,32,0,0,0,0,60008
20423,30661,794,3704,6807,10846,8510,2395,1236,1167,237,96,834,69,62,54,0,8,7,0,0,7,1159,1076,253,56,767,83,71,57,6,8,12,12,0,0,60010
20424,7294,104,1225,1839,2652,1474,784,310,299,82,16,201,11,11,11,0,0,0,0,0,0,474,474,267,29,178,0,0,0,0,0,0,0,0,0,60012
20425,17284,1084,3243,5237,5148,2572,1910,964,859,319,38,502,105,93,19,65,9,12,12,0,0,946,908,180,173,555,38,38,35,0,3,0,0,0,0,60013
20426,31205,2600,6335,9289,8444,4537,3534,1812,1595,530,173,892,217,170,102,13,55,47,28,0,19,1722,1645,538,256,851,77,59,35,17,7,18,1,0,17,60014
20427,17955,465,1813,2999,6524,6154,1901,930,879,294,39,546,51,30,0,0,30,21,8,0,13,971,905,206,26,673,66,23,23,0,0,43,13,0,30,60015
20428,44015,5611,10863,11378,10748,5415,2720,1735,1612,295,64,1253,123,69,51,12,6,54,38,0,16,985,934,382,28,524,51,32,13,0,19,19,0,13,6,60016
20429,19530,3882,6175,5103,3250,1120,1461,777,590,237,51,302,187,96,36,60,0,91,69,0,22,684,562,173,84,305,122,49,3,14,32,73,0,0,73,60018
20430,7557,861,2252,2753,1273,418,460,276,226,76,25,125,50,50,0,50,0,0,0,0,0,184,128,10,0,118,56,56,41,0,15,0,0,0,0,60020
20431,3685,246,821,1073,1015,530,210,94,85,17,15,53,9,0,0,0,0,9,9,0,0,116,104,85,19,0,12,12,12,0,0,0,0,0,0,60021
20432,5266,7,213,560,1896,2590,446,255,255,21,7,227,0,0,0,0,0,0,0,0,0,191,191,21,7,163,0,0,0,0,0,0,0,0,0,60022
20433,27398,1202,4786,6169,9149,6092,1777,776,746,92,36,618,30,12,0,0,12,18,0,0,18,1001,932,194,53,685,69,46,19,0,27,23,0,0,23,60025
20434,9806,619,1477,1869,2944,2897,692,331,292,0,0,292,39,30,30,0,0,9,0,0,9,361,342,76,0,266,19,19,11,0,8,0,0,0,0,60026
20435,271,24,13,44,95,95,16,13,13,2,0,11,0,0,0,0,0,0,0,0,0,3,3,0,0,3,0,0,0,0,0,0,0,0,0,60029
20436,23650,1559,4572,6648,6556,4315,2077,1126,1007,264,179,564,119,38,21,0,17,81,68,0,13,951,941,441,60,440,10,10,0,10,0,0,0,0,0,60030
20437,24478,1652,4774,7144,7116,3792,2714,1290,1255,481,134,640,35,14,14,0,0,21,0,0,21,1424,1394,407,156,831,30,11,11,0,0,19,0,13,6,60031
20438,8365,1805,2817,2671,588,484,949,554,516,155,98,263,38,27,27,0,0,11,0,0,11,395,312,70,27,215,83,13,6,0,7,70,0,29,41,60033
20439,1361,159,448,484,212,58,90,32,29,5,0,24,3,3,0,3,0,0,0,0,0,58,55,24,0,31,3,0,0,0,0,3,3,0,0,60034
20440,20479,876,2041,3680,6944,6938,1495,879,737,114,79,544,142,83,83,0,0,59,17,0,42,616,594,155,30,409,22,22,22,0,0,0,0,0,0,60035
20441,3541,722,1023,727,622,447,236,137,85,30,20,35,52,14,1,0,13,38,38,0,0,99,99,0,46,53,0,0,0,0,0,0,0,0,0,60040
20442,6382,464,2290,2367,798,463,509,205,186,63,13,110,19,19,0,19,0,0,0,0,0,304,290,79,11,200,14,14,0,0,14,0,0,0,0,60041
20443,5643,512,1587,2174,1089,281,631,226,183,46,7,130,43,43,43,0,0,0,0,0,0,405,396,142,67,187,9,9,9,0,0,0,0,0,0,60042
20444,1643,13,48,101,682,799,176,74,74,7,0,67,0,0,0,0,0,0,0,0,0,102,102,20,3,79,0,0,0,0,0,0,0,0,0,60043
20445,6841,223,771,1280,2625,1942,533,209,209,67,20,122,0,0,0,0,0,0,0,0,0,324,293,74,0,219,31,13,5,0,8,18,0,0,18,60044
20446,13836,359,1154,1993,5398,4932,1439,656,656,130,13,513,0,0,0,0,0,0,0,0,0,783,783,225,23,535,0,0,0,0,0,0,0,0,0,60045
20447,22228,1116,5038,7320,5726,3028,2075,1163,1080,255,127,698,83,62,57,5,0,21,0,13,8,912,879,274,72,533,33,33,19,14,0,0,0,0,0,60046
20448,27502,1334,4205,5930,9613,6420,2786,1395,1337,379,119,839,58,58,9,49,0,0,0,0,0,1391,1336,395,39,902,55,45,45,0,0,10,0,10,0,60047
20449,19980,850,2461,3991,7273,5405,1752,901,825,249,65,511,76,52,40,12,0,24,0,0,24,851,813,224,57,532,38,38,7,0,31,0,0,0,0,60048
20450,21684,1797,7294,7308,3918,1367,1731,777,726,177,167,382,51,51,26,14,11,0,0,0,0,954,869,345,111,413,85,85,67,8,10,0,0,0,0,60050
20451,16627,1237,6245,5522,2503,1120,1491,823,757,223,133,401,66,49,23,7,19,17,0,11,6,668,623,195,53,375,45,45,45,0,0,0,0,0,0,60051
20452,17266,1754,3938,4449,4669,2456,862,560,545,117,85,343,15,0,0,0,0,15,15,0,0,302,300,91,8,201,2,0,0,0,0,2,0,0,2,60053
20453,38787,4474,9183,9907,9569,5654,2577,1433,1240,329,124,787,193,60,60,0,0,133,103,0,30,1144,1129,191,76,862,15,15,0,0,15,0,0,0,0,60056
20454,24477,3067,5780,5893,6384,3353,2274,1213,1079,336,174,569,134,82,63,19,0,52,32,0,20,1061,974,297,89,588,87,87,87,0,0,0,0,0,0,60060
20455,17354,874,2718,3636,6033,4093,1236,665,604,190,23,391,61,61,0,55,6,0,0,0,0,571,554,182,39,333,17,17,0,17,0,0,0,0,0,60061
20456,28544,956,3331,5696,10126,8435,2048,1101,1033,125,0,908,68,34,19,13,2,34,0,0,34,947,926,291,37,598,21,0,0,0,0,21,0,0,21,60062
20457,9194,3184,2625,2215,773,397,1037,513,384,100,38,246,129,52,10,12,30,77,50,27,0,524,436,51,101,284,88,88,23,65,0,0,0,0,0,60064
20458,26931,1353,4434,5621,8987,6536,1937,1062,1058,254,46,758,4,1,0,0,1,3,0,0,3,875,770,239,83,448,105,68,49,12,7,37,0,0,37,60067
20459,25822,1083,4600,6253,7830,6056,2140,1036,957,258,59,640,79,22,10,0,12,57,0,38,19,1104,1011,336,30,645,93,93,0,10,83,0,0,0,0,60068
20460,5973,216,826,1176,1977,1778,289,178,172,42,14,116,6,6,6,0,0,0,0,0,0,111,111,58,8,45,0,0,0,0,0,0,0,0,0,60069
20461,10836,1592,2823,2464,2678,1279,689,315,240,14,32,194,75,0,0,0,0,75,64,0,11,374,343,104,0,239,31,29,27,0,2,2,0,0,2,60070
20462,2613,114,832,1105,449,113,133,56,56,13,0,43,0,0,0,0,0,0,0,0,0,77,77,46,0,31,0,0,0,0,0,0,0,0,0,60071
20463,569,23,211,198,106,31,59,24,21,3,0,18,3,3,0,3,0,0,0,0,0,35,35,20,0,15,0,0,0,0,0,0,0,0,0,60072
20464,35453,7382,10093,9432,5782,2764,3244,1812,1436,397,116,923,376,302,175,19,108,74,38,16,20,1432,1115,393,82,640,317,185,88,14,83,132,68,37,27,60073
20465,25380,3140,5947,6091,6777,3425,2245,1105,904,355,102,447,201,122,98,24,0,79,32,28,19,1140,1053,316,23,714,87,86,65,0,21,1,0,0,1,60074
20466,23471,2920,4192,5089,6580,4690,1754,786,753,238,48,467,33,32,15,0,17,1,0,0,1,968,944,301,243,400,24,17,0,0,17,7,0,0,7,60076
20467,19735,2079,4069,5483,5351,2753,1441,773,688,38,27,623,85,25,21,0,4,60,0,33,27,668,640,148,64,428,28,25,0,25,0,3,3,0,0,60077
20468,6474,398,1730,2808,1126,412,644,296,252,15,29,208,44,44,36,8,0,0,0,0,0,348,314,107,0,207,34,34,20,14,0,0,0,0,0,60081
20469,6792,378,1268,2277,1718,1151,613,376,320,141,11,168,56,38,23,15,0,18,18,0,0,237,225,83,14,128,12,12,12,0,0,0,0,0,0,60083
20470,10595,1208,2694,3206,2405,1082,979,516,422,0,39,383,94,77,59,18,0,17,0,0,17,463,443,145,77,221,20,20,8,12,0,0,0,0,0,60084
20471,40943,13571,11800,9745,4213,1614,4713,2399,1984,608,184,1192,415,295,86,81,128,120,41,16,63,2314,1829,341,236,1252,485,294,82,95,117,191,56,16,119,60085
20472,16709,3427,5058,5469,1871,884,1615,826,620,205,105,310,206,121,115,0,6,85,24,11,50,789,657,225,115,317,132,72,72,0,0,60,0,19,41,60087
20473,4016,31,835,2378,652,120,4015,3373,682,582,0,100,2691,2671,2614,0,57,20,0,0,20,642,193,173,0,20,449,449,423,0,26,0,0,0,0,60088
20474,29414,997,3874,6180,10614,7749,1945,1019,963,286,125,552,56,0,0,0,0,56,39,0,17,926,920,242,45,633,6,0,0,0,0,6,0,0,6,60089
20475,26585,3726,6709,6482,6425,3243,1742,863,786,200,88,498,77,77,64,0,13,0,0,0,0,879,746,361,17,368,133,91,81,0,10,42,0,0,42,60090
20476,17837,309,921,2229,6393,7985,1574,974,941,110,21,810,33,22,22,0,0,11,0,11,0,600,576,96,17,463,24,10,0,0,10,14,0,0,14,60091
20477,12260,244,770,1227,4747,5272,1306,678,667,72,3,592,11,9,0,8,1,2,2,0,0,628,587,215,0,372,41,41,15,26,0,0,0,0,0,60093
20478,4860,440,1462,1866,734,358,512,285,250,61,47,142,35,35,35,0,0,0,0,0,0,227,182,16,15,151,45,34,23,0,11,11,0,11,0,60096
20479,7114,674,2434,2511,933,562,527,163,151,30,46,75,12,12,12,0,0,0,0,0,0,364,324,172,0,152,40,40,40,0,0,0,0,0,0,60097
20480,21967,2754,5838,7021,4302,2052,1737,1057,914,245,144,525,143,99,80,0,19,44,0,5,39,680,660,201,105,354,20,9,6,3,0,11,0,8,3,60098
20481,19188,3174,6101,6872,1943,1098,2180,897,677,138,116,423,220,162,138,6,18,58,4,13,41,1283,1009,223,174,612,274,118,70,0,48,156,25,85,46,60099
20482,25667,5563,7599,6861,4044,1600,1959,982,775,93,140,542,207,175,102,55,18,32,15,0,17,977,806,300,151,355,171,163,121,0,42,8,8,0,0,60101
20483,21093,1000,4059,6400,6106,3528,2019,1166,1083,304,190,589,83,35,0,35,0,48,8,30,10,853,824,237,89,498,29,29,0,20,9,0,0,0,0,60102
20484,27646,1800,5257,8631,7853,4105,2796,1520,1197,297,206,694,323,190,166,0,24,133,18,23,92,1276,1203,528,53,622,73,45,45,0,0,28,0,0,28,60103
20485,12082,2022,3784,4303,1347,626,1370,651,503,13,69,421,148,81,33,48,0,67,31,0,36,719,605,197,109,299,114,67,28,14,25,47,47,0,0,60104
20486,13553,3172,4746,3361,1639,635,993,609,522,174,55,293,87,49,45,0,4,38,28,10,0,384,311,69,76,166,73,73,38,35,0,0,0,0,0,60106
20487,26827,3593,7236,7592,5826,2580,2081,949,785,230,54,501,164,139,139,0,0,25,6,16,3,1132,1054,414,83,557,78,68,41,3,24,10,4,0,6,60107
20488,17147,1335,4636,5032,4229,1915,839,346,295,84,12,199,51,51,36,0,15,0,0,0,0,493,474,236,31,207,19,19,0,19,0,0,0,0,0,60108
20489,378,21,139,162,20,36,60,22,14,3,2,9,8,8,0,8,0,0,0,0,0,38,28,20,0,8,10,10,2,8,0,0,0,0,0,60109
20490,22440,6226,6183,5435,3292,1304,2475,1198,950,218,144,588,248,152,27,37,88,96,45,21,30,1277,1041,361,61,619,236,197,103,46,48,39,8,0,31,60110
20491,232,21,44,79,40,48,38,29,29,0,13,16,0,0,0,0,0,0,0,0,0,9,9,0,0,9,0,0,0,0,0,0,0,0,0,60111
20492,2596,175,685,1043,493,200,351,163,134,42,0,92,29,29,0,29,0,0,0,0,0,188,154,49,0,105,34,34,34,0,0,0,0,0,0,60112
20493,163,42,50,45,20,6,6,3,3,0,0,3,0,0,0,0,0,0,0,0,0,3,0,0,0,0,3,3,0,3,0,0,0,0,0,60113
20494,21917,1900,4783,7116,5032,3086,5597,2599,2521,557,380,1584,78,73,31,32,10,5,0,0,5,2998,2926,816,610,1500,72,72,72,0,0,0,0,0,0,60115
20495,10813,499,2569,3384,2854,1507,811,319,303,90,31,182,16,11,6,0,5,5,0,0,5,492,434,152,0,282,58,58,58,0,0,0,0,0,0,60118
20496,6707,235,1853,2106,1788,725,626,325,316,79,42,195,9,9,9,0,0,0,0,0,0,301,284,99,59,126,17,17,0,0,17,0,0,0,0,60119
20497,30595,8153,8723,7490,4764,1465,2940,1619,1351,290,60,1001,268,219,151,16,52,49,0,20,29,1321,1036,230,123,683,285,204,126,0,78,81,20,0,61,60120
20498,30088,6053,8284,9233,4159,2359,2763,1377,1246,234,124,888,131,48,38,3,7,83,38,10,35,1386,1249,401,120,728,137,111,63,48,0,26,24,0,2,60123
20499,13059,722,2742,3648,3516,2431,902,733,617,108,29,480,116,115,115,0,0,1,0,0,1,169,161,136,0,25,8,8,7,0,1,0,0,0,0,60124
20500,29990,1505,4422,7116,10582,6365,2783,1338,1302,300,180,822,36,15,15,0,0,21,10,0,11,1445,1422,295,110,1017,23,7,7,0,0,16,0,8,8,60126
20501,124,5,31,65,20,3,9,9,9,2,0,7,0,0,0,0,0,0,0,0,0,0,0,0,0,0,0,0,0,0,0,0,0,0,0,60129
20502,10692,709,2267,3172,2642,1902,442,189,128,48,0,80,61,35,29,0,6,26,0,0,26,253,229,62,17,150,24,24,0,0,24,0,0,0,0,60130
20503,12294,2485,4399,3397,1520,493,910,338,276,83,20,173,62,49,23,8,18,13,13,0,0,572,483,46,27,410,89,69,24,10,35,20,0,0,20,60131
20504,23406,4948,6306,6401,4317,1434,2677,1220,1011,259,77,675,209,131,91,17,23,78,24,54,0,1457,1292,402,54,836,165,113,38,0,75,52,0,38,14,60133
20505,18852,553,2542,4307,7434,4016,1779,913,820,217,58,545,93,40,19,0,21,53,0,13,40,866,828,294,51,483,38,29,20,9,0,9,9,0,0,60134
20506,4455,455,1631,1577,524,268,331,121,107,29,41,37,14,14,14,0,0,0,0,0,0,210,189,31,78,80,21,21,21,0,0,0,0,0,0,60135
20507,4289,188,633,1392,1383,693,377,169,169,26,12,131,0,0,0,0,0,0,0,0,0,208,208,130,0,78,0,0,0,0,0,0,0,0,0,60136
20508,25786,1430,3766,5728,8915,5947,2012,1149,1086,304,155,627,63,43,12,10,21,20,0,0,20,863,789,268,66,455,74,71,30,27,14,3,0,0,3,60137
20509,21970,3669,5455,6185,5035,1626,2123,1247,1003,209,176,618,244,212,39,163,10,32,20,0,12,876,591,177,28,386,285,279,106,154,19,6,6,0,0,60139
20510,8810,825,2438,3313,1485,749,578,162,162,105,2,55,0,0,0,0,0,0,0,0,0,416,410,295,0,115,6,6,6,0,0,0,0,0,0,60140
20511,173,55,56,14,19,29,0,0,0,0,0,0,0,0,0,0,0,0,0,0,0,0,0,0,0,0,0,0,0,0,0,0,0,0,0,60141
20512,19214,747,5210,7155,4246,1856,1107,682,633,114,63,456,49,49,49,0,0,0,0,0,0,425,425,215,28,182,0,0,0,0,0,0,0,0,0,60142
20513,7271,695,1834,1830,1984,928,488,306,288,0,0,288,18,9,0,9,0,9,0,0,9,182,182,58,13,111,0,0,0,0,0,0,0,0,0,60143
20514,36,11,3,6,16,0,2,0,0,0,0,0,0,0,0,0,0,0,0,0,0,2,2,2,0,0,0,0,0,0,0,0,0,0,0,60144
20515,1576,112,526,666,165,107,176,82,82,48,14,20,0,0,0,0,0,0,0,0,0,94,91,33,3,55,3,3,0,3,0,0,0,0,0,60145
20516,1708,249,620,530,175,134,213,124,118,24,14,80,6,6,6,0,0,0,0,0,0,89,89,29,13,47,0,0,0,0,0,0,0,0,0,60146
20517,36852,2436,8142,11383,10001,4890,2826,1612,1472,604,149,719,140,117,82,21,14,23,23,0,0,1214,1069,415,108,546,145,92,8,64,20,53,0,0,53,60148
20518,1012,140,291,337,195,49,61,41,34,2,0,32,7,7,7,0,0,0,0,0,0,20,20,3,0,17,0,0,0,0,0,0,0,0,0,60150
20519,2859,202,903,1122,475,157,170,90,89,33,5,51,1,1,0,0,1,0,0,0,0,80,70,28,0,42,10,10,0,10,0,0,0,0,0,60151
20520,8646,706,3146,2919,1125,750,650,291,267,63,22,182,24,19,19,0,0,5,0,0,5,359,335,201,14,120,24,24,24,0,0,0,0,0,0,60152
20521,16187,3675,5307,5146,1336,723,1357,705,526,75,34,417,179,102,0,9,93,77,19,9,49,652,546,107,74,365,106,90,34,28,28,16,0,0,16,60153
20522,12544,1345,3229,3827,2586,1557,629,334,291,73,18,200,43,30,10,19,1,13,0,0,13,295,278,135,20,123,17,17,13,0,4,0,0,0,0,60154
20523,5864,645,2058,2055,812,294,281,102,102,0,20,82,0,0,0,0,0,0,0,0,0,179,160,40,24,96,19,19,19,0,0,0,0,0,0,60155
20524,18155,998,5266,6345,4043,1503,1656,957,817,235,152,430,140,48,31,0,17,92,0,40,52,699,541,264,47,230,158,158,32,56,70,0,0,0,0,60156
20525,1492,117,392,483,337,163,132,78,78,35,0,43,0,0,0,0,0,0,0,0,0,54,41,18,0,23,13,13,13,0,0,0,0,0,0,60157
20526,14856,4898,5181,3272,1100,405,1332,812,714,189,65,460,98,55,28,0,27,43,8,11,24,520,436,52,45,339,84,52,24,12,16,32,0,23,9,60160
20527,5564,1077,1505,1770,889,323,491,203,180,81,0,99,23,23,0,6,17,0,0,0,0,288,288,85,37,166,0,0,0,0,0,0,0,0,0,60162
20528,3562,477,947,1213,706,219,353,199,143,33,9,101,56,34,0,34,0,22,0,0,22,154,133,17,0,116,21,21,17,4,0,0,0,0,0,60163
20529,13750,4093,4568,3477,1259,353,1540,729,609,86,90,433,120,90,54,0,36,30,30,0,0,811,630,182,54,394,181,102,25,45,32,79,24,0,55,60164
20530,2805,1222,820,580,172,11,301,150,117,25,0,92,33,33,8,13,12,0,0,0,0,151,65,20,12,33,86,70,38,0,32,16,9,0,7,60165
20531,23070,2639,4999,6541,5662,3229,1768,931,868,241,114,513,63,55,55,0,0,8,0,0,8,837,737,155,71,511,100,47,5,0,42,53,0,0,53,60169
20532,7352,951,2461,2399,858,683,428,247,184,72,9,103,63,27,0,0,27,36,0,21,15,181,170,41,0,129,11,11,11,0,0,0,0,0,0,60171
20533,16447,671,4039,5682,3856,2199,1531,620,613,122,24,467,7,3,0,0,3,4,0,0,4,911,887,234,70,583,24,24,24,0,0,0,0,0,0,60172
20534,8731,96,1050,2104,3419,2062,389,200,164,19,9,136,36,0,0,0,0,36,24,0,12,189,170,62,22,86,19,8,0,0,8,11,0,0,11,60173
20535,22578,1851,4772,6178,6006,3771,1484,906,803,252,35,516,103,54,40,0,14,49,43,0,6,578,507,148,62,297,71,71,59,0,12,0,0,0,0,60174
20536,16487,689,3026,3950,6035,2787,1680,984,742,166,57,519,242,70,24,0,46,172,0,15,157,696,681,247,33,401,15,15,0,15,0,0,0,0,0,60175
20537,8011,1349,2815,2171,1196,480,359,200,166,17,0,149,34,34,34,0,0,0,0,0,0,159,132,24,16,92,27,16,16,0,0,11,0,11,0,60176
20538,13990,866,3765,4769,3223,1367,1606,715,651,219,51,381,64,64,49,0,15,0,0,0,0,891,836,349,37,450,55,12,0,12,0,43,0,0,43,60177
20539,15114,1198,3555,5068,3194,2099,1155,575,420,131,16,273,155,128,93,35,0,27,17,0,10,580,526,311,42,173,54,49,49,0,0,5,0,0,5,60178
20540,935,63,384,296,141,51,72,19,16,2,0,14,3,2,2,0,0,1,0,0,1,53,51,2,0,49,2,0,0,0,0,2,0,0,2,60180
20541,19774,1982,4694,6244,4491,2363,1653,757,636,137,85,414,121,103,60,21,22,18,4,0,14,896,819,233,82,504,77,77,17,18,42,0,0,0,0,60181
20542,1802,49,281,476,578,418,160,53,47,5,0,42,6,0,0,0,0,6,6,0,0,107,90,51,5,34,17,17,8,0,9,0,0,0,0,60184
20543,21860,5075,5983,5377,3514,1911,2452,1238,952,188,167,597,286,183,114,28,41,103,43,60,0,1214,1108,377,122,609,106,67,23,30,14,39,0,8,31,60185
20544,17754,1117,2388,4276,6011,3962,2694,1390,1243,373,144,726,147,92,21,43,28,55,0,0,55,1304,1233,373,102,758,71,46,34,5,7,25,0,0,25,60187
20545,27932,2793,6043,8551,7278,3267,2598,1481,1140,465,110,565,341,341,180,151,10,0,0,0,0,1117,1074,307,142,625,43,43,43,0,0,0,0,0,0,60188
20546,21063,487,2311,4626,7726,5913,1848,802,738,244,49,445,64,49,0,22,27,15,15,0,0,1046,1046,299,85,662,0,0,0,0,0,0,0,0,0,60189
20547,7677,300,1212,2214,2328,1623,509,366,298,71,19,208,68,68,14,54,0,0,0,0,0,143,143,62,0,81,0,0,0,0,0,0,0,0,0,60190
20548,10042,1279,3438,3292,1369,664,661,299,261,78,35,148,38,38,25,0,13,0,0,0,0,362,355,214,19,122,7,7,7,0,0,0,0,0,0,60191
20549,11088,552,1982,2131,4001,2422,881,424,419,78,40,301,5,0,0,0,0,5,0,5,0,457,457,275,19,163,0,0,0,0,0,0,0,0,0,60192
20550,29231,1915,7235,9085,6990,4006,1502,704,595,48,111,436,109,62,56,6,0,47,0,19,28,798,704,269,38,397,94,80,45,0,35,14,0,14,0,60193
20551,14296,772,3313,4051,4217,1943,849,476,458,130,41,287,18,18,18,0,0,0,0,0,0,373,349,123,23,203,24,24,12,0,12,0,0,0,0,60194
20552,2961,138,265,713,1130,715,84,19,19,15,4,0,0,0,0,0,0,0,0,0,0,65,48,27,13,8,17,17,17,0,0,0,0,0,0,60195
20553,24989,1227,2454,3993,7322,9993,4764,2466,2405,666,111,1628,61,45,19,12,14,16,15,0,1,2298,2298,674,116,1508,0,0,0,0,0,0,0,0,0,60201
20554,22633,1498,2693,4315,6424,7703,1552,777,721,122,99,500,56,56,45,0,11,0,0,0,0,775,694,167,86,441,81,81,27,0,54,0,0,0,0,60202
20555,3064,65,208,538,1160,1093,137,75,75,12,0,63,0,0,0,0,0,0,0,0,0,62,62,0,12,50,0,0,0,0,0,0,0,0,0,60203
20556,1818,37,178,329,558,716,39,6,0,0,0,0,6,6,0,0,6,0,0,0,0,33,33,28,0,5,0,0,0,0,0,0,0,0,0,60301
20557,22594,882,1873,4669,6739,8431,1208,555,545,57,14,474,10,0,0,0,0,10,0,0,10,653,653,94,46,513,0,0,0,0,0,0,0,0,0,60302
20558,11608,354,1122,2471,3735,3926,722,243,202,37,13,152,41,41,9,0,32,0,0,0,0,479,442,90,51,301,37,37,0,37,0,0,0,0,0,60304
20559,6706,168,461,980,2453,2644,1033,576,516,100,4,412,60,0,0,0,0,60,0,0,60,457,436,138,17,281,21,21,21,0,0,0,0,0,0,60305
20560,5435,332,2197,1982,668,256,528,262,232,65,16,151,30,30,30,0,0,0,0,0,0,266,266,76,0,190,0,0,0,0,0,0,0,0,0,60401
20561,40654,9055,12016,12078,5311,2194,3703,1861,1590,177,129,1284,271,148,38,65,45,123,28,73,22,1842,1422,156,97,1169,420,287,145,4,138,133,17,0,116,60402
20562,13951,1868,4897,4859,1689,638,758,367,320,50,24,246,47,36,26,0,10,11,0,0,11,391,339,114,27,198,52,52,0,23,29,0,0,0,0,60403
20563,11954,834,3005,3873,2909,1333,951,552,471,115,110,246,81,81,49,18,14,0,0,0,0,399,382,105,27,250,17,17,0,17,0,0,0,0,0,60404
20564,15776,3620,5300,4766,1323,767,1567,896,741,130,123,488,155,94,45,29,20,61,33,0,28,671,487,76,52,359,184,114,110,0,4,70,41,1,28,60406
20565,1212,151,534,448,75,4,98,61,39,6,4,29,22,19,6,3,10,3,3,0,0,37,35,14,0,21,2,2,0,2,0,0,0,0,0,60407
20566,3781,389,1565,1424,301,102,327,208,167,30,36,101,41,41,20,15,6,0,0,0,0,119,119,65,19,35,0,0,0,0,0,0,0,0,0,60408
20567,23541,3681,6717,9844,2267,1032,2321,1163,902,68,88,746,261,249,37,105,107,12,0,12,0,1158,1036,37,203,796,122,73,18,13,42,49,49,0,0,60409
20568,7708,367,2542,2876,1315,608,707,499,482,245,15,222,17,4,0,4,0,13,13,0,0,208,208,67,31,110,0,0,0,0,0,0,0,0,0,60410
20569,35019,6277,11593,12083,3238,1828,4166,2084,1555,156,317,1082,529,336,193,102,41,193,0,115,78,2082,1813,288,261,1264,269,228,74,109,45,41,0,0,41,60411
20570,9697,1169,3112,3591,1356,469,267,176,176,47,27,102,0,0,0,0,0,0,0,0,0,91,91,49,16,26,0,0,0,0,0,0,0,0,0,60415
20571,5634,398,2337,2039,577,283,408,235,175,20,15,140,60,33,14,19,0,27,10,17,0,173,155,51,21,83,18,18,18,0,0,0,0,0,0,60416
20572,10884,826,2842,3565,2299,1352,823,456,344,77,43,224,112,103,78,0,25,9,9,0,0,367,343,100,24,219,24,0,0,0,0,24,0,12,12,60417
20573,14156,1737,4001,5723,1899,796,1488,749,532,91,92,349,217,192,65,64,63,25,0,0,25,739,691,35,268,388,48,47,26,0,21,1,0,0,1,60419
20574,5029,910,1643,1845,381,250,190,106,96,29,35,32,10,10,10,0,0,0,0,0,0,84,67,14,0,53,17,0,0,0,0,17,0,10,7,60420
20575,2717,145,1052,1042,344,134,163,62,29,12,9,8,33,20,0,20,0,13,0,6,7,101,96,13,5,78,5,0,0,0,0,5,0,5,0,60421
20576,6315,44,821,1730,2006,1714,467,177,177,15,7,155,0,0,0,0,0,0,0,0,0,290,289,32,19,238,1,1,1,0,0,0,0,0,0,60422
20577,19316,843,4379,5616,5054,3424,1916,993,932,158,86,688,61,61,15,46,0,0,0,0,0,923,896,303,115,478,27,27,27,0,0,0,0,0,0,60423
20578,1575,163,759,498,133,22,139,86,79,11,4,64,7,0,0,0,0,7,0,5,2,53,46,9,0,37,7,7,5,2,0,0,0,0,0,60424
20579,5887,579,1260,2516,1079,453,574,405,242,43,8,191,163,156,82,9,65,7,0,0,7,169,169,68,12,89,0,0,0,0,0,0,0,0,0,60425
20580,17206,4179,6745,4719,1183,380,1717,716,470,45,114,311,246,172,52,44,76,74,0,40,34,1001,760,83,82,595,241,129,23,70,36,112,0,42,70,60426
20581,8032,1379,2883,2721,740,309,855,440,370,35,44,291,70,42,5,37,0,28,0,0,28,415,399,46,59,294,16,0,0,0,0,16,0,0,16,60428
20582,10147,1442,3013,3686,1165,841,980,556,443,94,156,193,113,49,1,18,30,64,0,15,49,424,419,122,35,262,5,5,5,0,0,0,0,0,0,60429
20583,13955,698,2442,4567,3642,2606,1880,1014,937,272,129,536,77,77,13,36,28,0,0,0,0,866,808,200,76,532,58,58,8,50,0,0,0,0,0,60430
20584,13590,1021,3436,5059,2748,1326,1467,686,492,146,55,291,194,62,35,0,27,132,0,0,132,781,631,231,82,318,150,99,77,0,22,51,0,51,0,60431
20585,12169,4245,4267,2734,684,239,1231,615,417,110,32,275,198,110,52,15,43,88,26,11,51,616,485,78,117,290,131,71,53,15,3,60,32,22,6,60432
20586,11045,2591,4065,3148,783,458,1172,649,467,93,16,358,182,121,65,30,26,61,20,26,15,523,418,76,25,317,105,75,41,0,34,30,11,0,19,60433
20587,32291,4792,10953,9486,4858,2202,2372,1236,1145,165,266,714,91,50,23,0,27,41,25,15,1,1136,995,371,135,489,141,126,38,0,88,15,4,0,11,60435
20588,11437,2367,3944,3633,1132,361,1068,617,513,54,63,396,104,70,3,25,42,34,0,0,34,451,389,110,45,234,62,41,0,41,0,21,20,0,1,60436
20589,114,16,48,49,1,0,3,2,2,0,0,2,0,0,0,0,0,0,0,0,0,1,1,1,0,0,0,0,0,0,0,0,0,0,0,60437
20590,19646,1976,6649,7154,2802,1065,1512,860,762,195,46,521,98,98,79,19,0,0,0,0,0,652,599,121,78,400,53,34,34,0,0,19,8,0,11,60438
20591,15524,916,3756,4737,3765,2350,1276,657,640,263,113,264,17,5,5,0,0,12,0,0,12,619,571,175,117,279,48,48,19,0,29,0,0,0,0,60439
20592,32944,4570,9044,9480,6978,2872,3464,1513,1197,249,71,877,316,253,188,13,52,63,42,6,15,1951,1620,327,170,1123,331,217,156,28,33,114,55,16,43,60440
20593,22953,2228,6898,7547,4249,2031,1803,1012,771,246,40,485,241,153,57,50,46,88,0,12,76,791,713,292,98,323,78,21,21,0,0,57,0,16,41,60441
20594,6475,253,2070,2397,1074,681,511,209,209,64,0,145,0,0,0,0,0,0,0,0,0,302,284,27,0,257,18,18,0,18,0,0,0,0,0,60442
20595,14031,958,3633,4898,2700,1842,1105,608,573,64,111,398,35,35,18,0,17,0,0,0,0,497,364,9,138,217,133,133,51,15,67,0,0,0,0,60443
20596,1216,136,533,438,59,50,108,34,25,4,4,17,9,5,5,0,0,4,4,0,0,74,62,27,5,30,12,6,6,0,0,6,0,6,0,60444
20597,18005,1998,6045,6294,2587,1081,1462,823,696,146,83,467,127,93,39,44,10,34,0,0,34,639,546,86,66,394,93,76,50,26,0,17,17,0,0,60445
20598,23361,3198,6696,7808,4174,1485,3076,1594,1398,289,155,954,196,135,75,60,0,61,0,0,61,1482,1299,315,180,804,183,139,40,83,16,44,32,0,12,60446
20599,8789,659,2653,3196,1504,777,792,316,300,80,28,192,16,16,16,0,0,0,0,0,0,476,476,168,35,273,0,0,0,0,0,0,0,0,0,60447
20600,16621,623,4613,5840,3623,1922,1710,874,789,309,46,434,85,40,14,0,26,45,45,0,0,836,753,228,52,473,83,83,18,0,65,0,0,0,0,60448
20601,6210,255,2047,2123,1201,584,339,114,105,18,39,48,9,8,0,0,8,1,0,0,1,225,225,17,0,208,0,0,0,0,0,0,0,0,0,60449
20602,14264,1233,5341,4499,2206,985,1116,488,328,87,53,188,160,118,93,25,0,42,42,0,0,628,597,198,100,299,31,19,19,0,0,12,0,3,9,60450
20603,22006,917,6300,7427,4791,2571,2121,959,884,208,130,546,75,56,56,0,0,19,19,0,0,1162,1112,398,89,625,50,50,31,0,19,0,0,0,0,60451
20604,18346,1847,6174,5798,3182,1345,1804,1059,660,81,164,415,399,296,120,46,130,103,0,75,28,745,699,220,53,426,46,32,12,0,20,14,0,0,14,60452
20605,39874,4656,12562,11796,6936,3924,2718,1604,1325,440,143,742,279,145,67,43,35,134,0,55,79,1114,1055,358,63,634,59,35,24,0,11,24,0,0,24,60453
20606,10499,2342,3659,2957,1109,432,860,454,424,114,66,244,30,30,6,10,14,0,0,0,0,406,379,49,0,330,27,27,0,27,0,0,0,0,0,60455
20607,3042,199,1211,1093,363,176,167,125,125,35,33,57,0,0,0,0,0,0,0,0,0,42,33,0,0,33,9,0,0,0,0,9,0,0,9,60456
20608,9744,1344,3342,2767,1583,708,547,250,197,63,42,92,53,32,0,0,32,21,21,0,0,297,264,0,41,223,33,33,0,33,0,0,0,0,0,60457
20609,9084,1177,3602,2759,1111,435,464,159,147,8,38,101,12,0,0,0,0,12,0,0,12,305,282,30,85,167,23,23,23,0,0,0,0,0,0,60458
20610,18715,4408,7558,4495,1742,512,1779,948,734,300,86,348,214,205,136,18,51,9,0,0,9,831,710,100,7,603,121,101,65,36,0,20,0,0,20,60459
20611,924,84,459,279,62,40,101,56,51,5,7,39,5,5,3,2,0,0,0,0,0,45,45,20,13,12,0,0,0,0,0,0,0,0,0,60460
20612,3862,231,565,1266,1050,750,146,127,112,0,0,112,15,15,0,0,15,0,0,0,0,19,19,0,0,19,0,0,0,0,0,0,0,0,0,60461
20613,28401,1666,7930,8021,6520,4264,2110,823,720,253,118,349,103,70,7,30,33,33,0,0,33,1287,1198,390,97,711,89,27,18,0,9,62,24,0,38,60462
20614,10810,933,2384,2947,2593,1953,863,464,428,81,58,289,36,34,22,0,12,2,0,0,2,399,399,134,25,240,0,0,0,0,0,0,0,0,0,60463
20615,7487,406,1768,2323,1660,1330,423,293,279,115,45,119,14,14,0,14,0,0,0,0,0,130,130,12,0,118,0,0,0,0,0,0,0,0,0,60464
20616,12745,1385,3863,4745,1544,1208,894,465,402,151,108,143,63,44,29,0,15,19,19,0,0,429,429,135,15,279,0,0,0,0,0,0,0,0,0,60465
20617,14538,1622,3638,5714,2079,1485,1599,812,629,95,51,483,183,140,72,40,28,43,33,0,10,787,759,136,108,515,28,28,6,22,0,0,0,0,0,60466
20618,18591,1143,5217,5080,4531,2620,1501,756,748,113,69,566,8,8,0,8,0,0,0,0,0,745,736,124,53,559,9,3,0,3,0,6,6,0,0,60467
20619,3990,163,1338,1499,665,325,416,286,230,89,63,78,56,33,17,16,0,23,0,0,23,130,126,85,11,30,4,4,4,0,0,0,0,0,0,60468
20620,3424,1001,1240,860,225,98,389,230,180,34,59,87,50,36,20,16,0,14,0,0,14,159,159,30,19,110,0,0,0,0,0,0,0,0,0,60469
20621,403,64,182,140,13,4,62,33,30,2,8,20,3,3,0,3,0,0,0,0,0,29,24,14,2,8,5,2,0,2,0,3,0,0,3,60470
20622,9544,699,2064,3932,1836,1013,956,517,440,21,41,378,77,59,0,48,11,18,0,0,18,439,383,127,71,185,56,48,0,20,28,8,0,8,0,60471
20623,3496,849,1116,1156,327,48,387,285,170,0,18,152,115,115,103,0,12,0,0,0,0,102,79,0,7,72,23,23,23,0,0,0,0,0,0,60472
20624,15048,1559,3987,5657,2370,1475,1316,785,687,16,55,616,98,43,17,11,15,55,0,0,55,531,367,31,32,304,164,164,7,70,87,0,0,0,0,60473
20625,488,40,226,160,48,14,34,11,8,2,2,4,3,3,2,1,0,0,0,0,0,23,19,4,0,15,4,2,0,2,0,2,0,0,2,60474
20626,6448,1222,2269,2104,514,339,315,187,130,24,14,92,57,20,9,0,11,37,9,20,8,128,117,34,0,83,11,11,0,0,11,0,0,0,0,60475
20627,2045,191,1016,627,159,52,76,53,53,13,7,33,0,0,0,0,0,0,0,0,0,23,23,18,5,0,0,0,0,0,0,0,0,0,0,60476
20628,26903,1861,7817,9194,5713,2318,1952,819,703,198,64,441,116,70,20,0,50,46,0,39,7,1133,1052,387,89,576,81,81,27,29,25,0,0,0,0,60477
20629,11283,784,2668,4204,2257,1370,908,494,413,133,46,234,81,81,28,53,0,0,0,0,0,414,346,91,33,222,68,68,0,68,0,0,0,0,0,60478
20630,436,37,109,213,75,2,28,16,13,9,4,0,3,3,3,0,0,0,0,0,0,12,12,6,6,0,0,0,0,0,0,0,0,0,0,60479
20631,3679,226,971,1216,548,718,332,180,151,36,27,88,29,29,29,0,0,0,0,0,0,152,109,35,12,62,43,43,43,0,0,0,0,0,0,60480
20632,8503,819,3554,3034,702,394,576,286,143,42,0,101,143,143,85,18,40,0,0,0,0,290,255,71,79,105,35,23,7,16,0,12,12,0,0,60481
20633,7742,849,3299,2497,862,235,655,254,198,27,13,158,56,18,18,0,0,38,0,38,0,401,327,65,38,224,74,50,38,0,12,24,0,7,17,60482
20634,4012,268,887,1906,668,283,645,359,265,14,44,207,94,94,39,16,39,0,0,0,0,286,271,18,91,162,15,15,0,0,15,0,0,0,0,60484
20635,17746,950,4672,5081,4942,2101,1604,850,838,355,98,385,12,0,0,0,0,12,0,0,12,754,658,180,14,464,96,80,56,0,24,16,16,0,0,60487
20636,12005,799,1823,3478,3949,1956,1446,837,749,172,87,490,88,88,32,0,56,0,0,0,0,609,575,147,63,365,34,20,20,0,0,14,0,0,14,60490
20637,15370,792,4298,4696,3409,2175,1235,595,557,149,11,397,38,30,30,0,0,8,0,0,8,640,560,255,38,267,80,80,46,0,34,0,0,0,0,60491
20638,7055,2114,2400,1626,665,250,620,351,290,119,25,146,61,10,5,0,5,51,20,15,16,269,200,34,8,158,69,69,40,0,29,0,0,0,0,60501
20639,15095,612,1552,3484,5459,3988,932,457,422,101,83,238,35,24,17,0,7,11,0,11,0,475,459,135,25,299,16,16,16,0,0,0,0,0,0,60502
20640,10316,482,1459,2610,3702,2063,600,348,255,24,0,231,93,79,10,0,69,14,14,0,0,252,252,196,10,46,0,0,0,0,0,0,0,0,0,60503
20641,23701,2224,4244,6934,6643,3656,2104,1271,1181,230,143,808,90,78,47,0,31,12,0,0,12,833,779,389,31,359,54,44,0,0,44,10,10,0,0,60504
20642,40249,19763,10235,7141,2296,814,4407,2242,1631,464,249,918,611,331,205,126,0,280,149,80,51,2165,1610,393,301,916,555,382,259,45,78,173,134,12,27,60505
20643,35020,7658,9275,10073,5207,2807,4105,1997,1779,458,111,1210,218,112,68,44,0,106,49,46,11,2108,1712,374,138,1200,396,270,184,18,68,126,38,44,44,60506
20644,18780,852,3094,5235,5519,4080,1795,895,785,238,98,449,110,110,56,0,54,0,0,0,0,900,818,323,121,374,82,42,0,25,17,40,40,0,0,60510
20645,1055,70,344,421,186,34,66,37,23,2,8,13,14,0,0,0,0,14,14,0,0,29,29,9,0,20,0,0,0,0,0,0,0,0,0,60511
20646,1126,167,522,252,79,106,0,0,0,0,0,0,0,0,0,0,0,0,0,0,0,0,0,0,0,0,0,0,0,0,0,0,0,0,0,60512
20647,13176,843,3350,4650,2832,1501,979,455,432,70,9,353,23,23,16,0,7,0,0,0,0,524,436,156,10,270,88,88,14,0,74,0,0,0,0,60513
20648,6747,267,675,1442,2386,1977,778,375,317,38,0,279,58,58,58,0,0,0,0,0,0,403,403,69,70,264,0,0,0,0,0,0,0,0,0,60514
20649,19371,815,3084,4968,6495,4009,1378,620,600,249,74,277,20,20,11,9,0,0,0,0,0,758,728,331,21,376,30,30,27,3,0,0,0,0,0,60515
20650,19760,776,3882,5477,5856,3769,1553,766,721,229,66,426,45,30,30,0,0,15,15,0,0,787,744,220,27,497,43,43,18,25,0,0,0,0,0,60516
20651,22595,1303,4134,6639,6650,3869,1542,904,831,294,36,501,73,46,37,0,9,27,11,0,16,638,536,199,47,290,102,102,59,43,0,0,0,0,0,60517
20652,2575,343,1082,810,231,109,160,42,40,16,10,14,2,2,2,0,0,0,0,0,0,118,105,21,24,60,13,13,13,0,0,0,0,0,0,60518
20653,0,0,0,0,0,0,0,0,0,0,0,0,0,0,0,0,0,0,0,0,0,0,0,0,0,0,0,0,0,0,0,0,0,0,0,60519
20654,1889,137,644,646,283,179,120,51,35,12,7,16,16,16,7,6,3,0,0,0,0,69,63,43,12,8,6,3,0,3,0,3,3,0,0,60520
20655,10973,221,1009,1516,4137,4090,1171,719,715,63,39,613,4,0,0,0,0,4,0,0,4,452,441,68,0,373,11,3,0,0,3,8,0,0,8,60521
20656,7824,386,1377,1607,2079,2375,410,225,220,26,0,194,5,0,0,0,0,5,0,5,0,185,185,53,0,132,0,0,0,0,0,0,0,0,0,60523
20657,21749,1937,4725,5225,5645,4217,1289,518,489,99,36,354,29,23,20,0,3,6,6,0,0,771,742,141,68,533,29,0,0,0,0,29,0,0,29,60525
20658,9140,387,1772,2807,2598,1576,681,386,370,133,25,212,16,8,0,0,8,8,0,0,8,295,288,104,12,172,7,0,0,0,0,7,0,0,7,60526
20659,19799,1144,3761,4868,5310,4716,1433,559,516,67,34,415,43,30,5,9,16,13,0,0,13,874,863,242,29,592,11,11,11,0,0,0,0,0,0,60527
20660,382,23,156,142,25,36,50,36,34,18,0,16,2,2,2,0,0,0,0,0,0,14,14,6,2,6,0,0,0,0,0,0,0,0,0,60530
20661,1306,92,493,447,194,80,57,21,16,1,3,12,5,5,0,4,1,0,0,0,0,36,23,6,0,17,13,13,13,0,0,0,0,0,0,60531
20662,18899,829,2362,5375,6280,4053,1325,591,556,176,35,345,35,35,0,26,9,0,0,0,0,734,709,191,58,460,25,11,0,11,0,14,14,0,0,60532
20663,7065,1155,2509,2125,943,333,461,178,152,17,26,109,26,26,26,0,0,0,0,0,0,283,275,23,76,176,8,8,8,0,0,0,0,0,0,60534
20664,70,2,23,25,20,0,13,1,1,1,0,0,0,0,0,0,0,0,0,0,0,12,10,0,0,10,2,2,1,1,0,0,0,0,0,60536
20665,418,55,163,158,37,5,40,30,19,0,0,19,11,4,3,1,0,7,0,0,7,10,8,6,0,2,2,2,2,0,0,0,0,0,0,60537
20666,16096,1839,4743,5378,3198,938,1540,809,691,108,55,528,118,110,84,26,0,8,0,0,8,731,642,157,53,432,89,81,37,0,44,8,8,0,0,60538
20667,188,43,0,145,0,0,0,0,0,0,0,0,0,0,0,0,0,0,0,0,0,0,0,0,0,0,0,0,0,0,0,0,0,0,0,60539
20668,27999,940,3193,5701,10177,7988,2960,1528,1435,405,198,832,93,47,47,0,0,46,0,25,21,1432,1366,496,86,784,66,0,0,0,0,66,0,0,66,60540
20669,2096,181,689,753,324,149,155,80,71,20,2,49,9,9,4,5,0,0,0,0,0,75,72,14,7,51,3,2,2,0,0,1,1,0,0,60541
20670,11308,858,2578,3297,3051,1524,717,250,226,52,0,174,24,24,24,0,0,0,0,0,0,467,456,201,0,255,11,11,0,11,0,0,0,0,0,60542
20671,22722,1115,5240,7565,5549,3253,2180,1248,1188,390,45,753,60,17,9,8,0,43,43,0,0,932,870,296,33,541,62,62,28,34,0,0,0,0,0,60543
20672,15798,959,3805,5345,3367,2322,1404,647,581,182,73,326,66,66,54,12,0,0,0,0,0,757,679,184,4,491,78,78,78,0,0,0,0,0,0,60544
20673,8342,1511,2565,2534,1089,643,644,331,301,30,33,238,30,0,0,0,0,30,0,30,0,313,253,62,32,159,60,10,0,0,10,50,0,33,17,60545
20674,10901,850,2502,2791,2470,2288,816,366,351,37,0,314,15,15,5,0,10,0,0,0,0,450,450,36,80,334,0,0,0,0,0,0,0,0,0,60546
20675,8473,853,3164,2945,1017,494,635,310,224,58,25,141,86,54,30,24,0,32,32,0,0,325,282,104,0,178,43,26,14,12,0,17,0,17,0,60548
20676,522,43,170,243,46,20,97,97,97,53,0,44,0,0,0,0,0,0,0,0,0,0,0,0,0,0,0,0,0,0,0,0,0,0,0,60549
20677,916,94,309,367,92,54,73,36,33,4,0,29,3,3,3,0,0,0,0,0,0,37,37,9,0,28,0,0,0,0,0,0,0,0,0,60550
20678,3397,728,1255,1043,245,126,183,110,62,15,8,39,48,26,26,0,0,22,0,0,22,73,73,18,24,31,0,0,0,0,0,0,0,0,0,60551
20679,2944,193,1050,1110,424,167,393,276,229,14,30,185,47,47,18,0,29,0,0,0,0,117,49,6,31,12,68,52,21,0,31,16,0,0,16,60552
20680,537,63,247,139,72,16,48,33,33,0,4,29,0,0,0,0,0,0,0,0,0,15,10,3,2,5,5,5,5,0,0,0,0,0,0,60553
20681,7995,368,1822,2626,2039,1140,666,297,240,39,44,157,57,57,38,0,19,0,0,0,0,369,369,135,17,217,0,0,0,0,0,0,0,0,0,60554
20682,8994,602,1823,2865,2505,1199,732,447,352,136,27,189,95,9,0,0,9,86,31,55,0,285,189,61,12,116,96,18,9,0,9,78,0,51,27,60555
20683,1206,61,419,440,220,66,85,30,26,0,16,10,4,4,2,2,0,0,0,0,0,55,55,18,4,33,0,0,0,0,0,0,0,0,0,60556
20684,0,0,0,0,0,0,0,0,0,0,0,0,0,0,0,0,0,0,0,0,0,0,0,0,0,0,0,0,0,0,0,0,0,0,0,60557
20685,8227,96,633,1291,3197,3010,762,382,382,139,14,229,0,0,0,0,0,0,0,0,0,380,372,89,18,265,8,8,0,0,8,0,0,0,0,60558
20686,17974,1259,4263,5031,4700,2721,901,466,387,53,97,237,79,71,0,57,14,8,0,0,8,435,381,166,31,184,54,44,44,0,0,10,0,10,0,60559
20687,14388,725,3723,4938,3284,1718,894,501,386,80,29,277,115,20,20,0,0,95,53,26,16,393,380,160,62,158,13,13,13,0,0,0,0,0,0,60560
20688,16867,885,3478,4691,4524,3289,1221,717,646,135,82,429,71,62,61,1,0,9,0,9,0,504,455,114,94,247,49,15,0,0,15,34,34,0,0,60561
20689,24762,1236,3683,5562,8255,6026,1879,1034,938,186,123,629,96,56,23,19,14,40,40,0,0,845,747,272,42,433,98,74,74,0,0,24,12,0,12,60563
20690,24670,533,2650,4193,9275,8019,3056,1629,1511,499,101,911,118,89,68,0,21,29,0,0,29,1427,1346,513,58,775,81,32,32,0,0,49,15,19,15,60564
20691,26146,759,2799,5215,9845,7528,2664,1402,1386,439,81,866,16,7,0,0,7,9,0,0,9,1262,1232,308,54,870,30,30,28,0,2,0,0,0,0,60565
20692,13424,322,2174,3495,4837,2596,1333,594,568,157,0,411,26,26,20,6,0,0,0,0,0,739,730,262,124,344,9,9,0,9,0,0,0,0,0,60585
20693,26800,2091,6419,8968,6325,2997,3755,1850,1538,429,181,928,312,250,199,51,0,62,0,54,8,1905,1807,911,182,714,98,60,0,9,51,38,12,0,26,60586
20694,7932,106,405,1104,3199,3118,304,87,82,29,0,53,5,5,5,0,0,0,0,0,0,217,217,15,46,156,0,0,0,0,0,0,0,0,0,60601
20695,953,0,13,253,370,317,145,57,57,11,0,46,0,0,0,0,0,0,0,0,0,88,88,11,0,77,0,0,0,0,0,0,0,0,0,60602
20696,445,0,9,52,196,188,177,75,75,4,0,71,0,0,0,0,0,0,0,0,0,102,102,9,34,59,0,0,0,0,0,0,0,0,0,60603
20697,376,8,13,35,105,215,0,0,0,0,0,0,0,0,0,0,0,0,0,0,0,0,0,0,0,0,0,0,0,0,0,0,0,0,0,60604
20698,18718,900,1238,2517,6747,7316,1275,574,523,92,29,402,51,40,0,0,40,11,0,0,11,701,660,210,72,378,41,41,41,0,0,0,0,0,0,60605
20699,2252,21,64,145,878,1144,0,0,0,0,0,0,0,0,0,0,0,0,0,0,0,0,0,0,0,0,0,0,0,0,0,0,0,0,0,60606
20700,17627,954,1330,2240,6700,6403,1747,652,607,61,51,495,45,27,0,27,0,18,0,0,18,1095,1054,238,143,673,41,41,28,0,13,0,0,0,0,60607
20701,50685,18507,13602,8952,6399,3225,4760,2931,1671,290,346,1035,1260,454,82,74,298,806,53,61,692,1829,1628,231,374,1023,201,98,40,27,31,103,51,10,42,60608
20702,36510,12823,11781,8058,2527,1321,4313,2059,1606,108,270,1228,453,274,63,63,148,179,45,36,98,2254,1821,367,216,1238,433,192,25,54,113,241,0,38,203,60609
20703,30888,1230,2665,5057,11660,10276,1005,468,449,107,25,317,19,19,0,0,19,0,0,0,0,537,537,162,48,327,0,0,0,0,0,0,0,0,0,60610
20704,25527,203,1006,3483,11138,9697,394,107,107,4,0,103,0,0,0,0,0,0,0,0,0,287,240,47,12,181,47,0,0,0,0,47,0,0,47,60611
20705,22261,4197,5324,5659,4256,2825,2279,1058,890,42,129,719,168,79,16,18,45,89,0,8,81,1221,993,139,198,656,228,134,36,62,36,94,0,0,94,60612
20706,37928,1684,3342,5273,17031,10598,696,334,315,50,0,265,19,15,0,15,0,4,0,4,0,362,327,76,52,199,35,8,8,0,0,27,0,0,27,60613
20707,47185,1484,2038,4679,21135,17849,2947,1454,1407,309,132,966,47,47,18,29,0,0,0,0,0,1493,1451,566,117,768,42,38,38,0,0,4,0,0,4,60614
20708,28026,2492,3943,6631,5985,8975,2187,1242,1182,195,175,812,60,48,20,17,11,12,0,0,12,945,905,159,126,620,40,23,17,0,6,17,0,15,2,60615
20709,34609,6784,8252,6631,7064,5878,2812,1422,1332,243,83,1006,90,82,23,0,59,8,0,8,0,1390,1094,303,208,583,296,274,81,87,106,22,0,0,22,60616
20710,52952,11976,15540,16854,4903,3679,4682,2450,1892,168,417,1307,558,308,63,155,90,250,90,45,115,2232,1918,316,236,1366,314,210,91,79,40,104,50,19,35,60617
20711,67160,12735,15280,13212,16557,9376,3713,1974,1634,118,195,1321,340,230,64,6,160,110,76,0,34,1739,1622,496,80,1046,117,30,0,27,3,87,12,29,46,60618
20712,42931,5512,11202,16316,6358,3543,4333,2286,1784,105,291,1388,502,272,71,91,110,230,0,31,199,2047,1668,162,303,1203,379,326,37,116,173,53,8,19,26,60619
20713,47118,8272,15482,16640,4487,2237,5353,2684,2094,116,415,1563,590,213,45,11,157,377,12,226,139,2669,2289,170,567,1552,380,154,27,55,72,226,8,62,156,60620
20714,19631,5165,6544,6605,904,413,2518,1336,1042,26,77,939,294,93,37,24,32,201,32,37,132,1182,833,42,184,607,349,209,0,100,109,140,13,9,118,60621
20715,39726,5033,4239,6505,15198,8751,1734,717,626,50,159,417,91,81,16,37,28,10,10,0,0,1017,842,217,133,492,175,81,47,23,11,94,15,51,28,60622
20716,46806,21855,13013,8680,2305,953,6232,3181,2542,152,244,2146,639,367,176,51,140,272,86,129,57,3051,2491,154,325,2012,560,311,117,103,91,249,11,3,235,60623
20717,21560,5771,8302,5779,1201,507,3144,1499,1192,41,105,1046,307,146,9,27,110,161,0,26,135,1645,1394,70,143,1181,251,106,29,35,42,145,0,98,47,60624
20718,54645,12275,8465,10659,14413,8833,3888,1916,1552,343,137,1072,364,227,56,79,92,137,110,27,0,1972,1664,309,115,1240,308,77,14,49,14,231,69,85,77,60625
20719,34311,5756,6060,7935,8561,5999,2802,1028,963,213,41,709,65,37,27,0,10,28,0,0,28,1774,1623,455,166,1002,151,29,0,2,27,122,36,0,86,60626
20720,46269,8101,13410,16988,4962,2808,5008,2347,1858,38,329,1491,489,244,31,63,150,245,0,71,174,2661,2137,128,323,1686,524,281,47,84,150,243,22,25,196,60628
20721,64124,22458,20976,15376,3869,1445,8136,4238,3453,419,391,2643,785,448,226,53,169,337,120,108,109,3898,3344,518,287,2539,554,304,46,67,191,250,81,0,169,60629
20722,40431,5419,11373,11165,8369,4105,2812,1321,1210,216,157,837,111,69,27,11,31,42,0,17,25,1491,1345,446,163,736,146,39,19,11,9,107,12,13,82,60630
20723,21550,1801,5345,7104,4788,2512,842,356,315,80,25,210,41,7,0,0,7,34,0,0,34,486,449,59,61,329,37,37,0,0,37,0,0,0,0,60631
20724,51572,22280,16427,8503,3242,1120,6145,3277,2788,324,421,2043,489,203,21,35,147,286,135,34,117,2868,2381,313,399,1669,487,323,81,99,143,164,37,28,99,60632
20725,8932,1549,3069,2916,1019,379,645,409,329,13,34,282,80,65,0,48,17,15,0,0,15,236,231,42,34,155,5,0,0,0,0,5,0,5,0,60633
20726,51406,9485,16944,14622,6966,3389,3547,1805,1590,261,177,1152,215,165,66,35,64,50,33,0,17,1742,1447,262,259,926,295,184,73,23,88,111,20,29,62,60634
20727,23790,6094,8652,7103,1456,485,3333,1761,1452,131,348,973,309,130,61,47,22,179,21,82,76,1572,1248,75,308,865,324,192,23,62,107,132,0,53,79,60636
20728,27854,4378,6119,8634,3847,4876,4113,2069,1829,221,238,1370,240,155,65,65,25,85,0,19,66,2044,1787,374,246,1167,257,174,6,131,37,83,0,30,53,60637
20729,38371,6800,13587,10643,5073,2268,2916,1291,1134,173,189,772,157,124,28,95,1,33,0,33,0,1625,1546,480,228,838,79,69,22,46,1,10,0,0,10,60638
20730,52897,20736,15924,11784,3228,1225,6545,3509,2888,345,505,2038,621,362,164,94,104,259,58,33,168,3036,2541,358,299,1884,495,354,120,108,126,141,0,45,96,60639
20731,52706,5544,7651,11885,16406,11220,1443,824,671,98,63,510,153,114,54,59,1,39,0,7,32,619,579,131,126,322,40,36,7,18,11,4,0,0,4,60640
20732,47220,11607,13638,11316,7014,3645,3197,1653,1308,272,197,839,345,197,81,89,27,148,52,61,35,1544,1332,215,273,844,212,125,57,15,53,87,46,0,41,60641
20733,14283,1401,1798,2210,5822,3052,356,169,169,49,7,113,0,0,0,0,0,0,0,0,0,187,168,14,15,139,19,19,0,9,10,0,0,0,0,60642
20734,35134,3227,8397,11670,6198,5642,2693,1154,1054,111,155,788,100,60,19,29,12,40,25,14,1,1539,1436,263,246,927,103,65,0,65,0,38,0,0,38,60643
20735,29146,7785,11098,7586,2022,655,3428,1627,1181,138,152,891,446,234,40,44,150,212,7,52,153,1801,1601,112,251,1238,200,69,13,18,38,131,57,56,18,60644
20736,30143,5691,6046,6944,7024,4438,2134,1098,915,84,79,752,183,70,22,27,21,113,80,14,19,1036,939,117,120,702,97,46,46,0,0,51,37,0,14,60645
20737,19993,1681,3614,4621,5961,4116,993,739,568,137,55,376,171,53,49,0,4,118,12,0,106,254,241,36,22,183,13,0,0,0,0,13,0,0,13,60646
20738,59475,9282,14438,11365,16057,8333,3796,1788,1376,131,67,1178,412,243,61,22,160,169,61,16,92,2008,1624,215,86,1323,384,277,178,10,89,107,29,0,78,60647
20739,30742,4327,7183,11708,4447,3077,2417,1012,890,191,141,558,122,41,0,11,30,81,0,0,81,1405,1227,170,187,870,178,117,16,40,61,61,12,17,32,60649
20740,37534,11046,12523,10234,2759,972,4365,2124,1784,140,239,1405,340,221,33,48,140,119,17,10,92,2241,1920,135,372,1413,321,119,43,41,35,202,49,25,128,60651
20741,26549,4564,7584,9004,3629,1768,3092,1721,1300,153,106,1041,421,297,130,128,39,124,92,0,32,1371,1195,188,113,894,176,150,0,65,85,26,0,8,18,60652
20742,19931,3526,4703,6419,3049,2234,1627,1006,879,97,185,597,127,47,0,42,5,80,27,0,53,621,546,85,87,374,75,74,47,27,0,1,0,1,0,60653
20743,13568,311,659,1385,6389,4824,129,76,76,0,0,76,0,0,0,0,0,0,0,0,0,53,53,0,0,53,0,0,0,0,0,0,0,0,0,60654
20744,18119,769,4563,5812,4324,2651,1905,978,933,295,105,533,45,26,17,9,0,19,7,12,0,927,916,300,105,511,11,11,11,0,0,0,0,0,0,60655
20745,20460,2127,6189,5907,4039,2198,600,301,270,31,0,239,31,10,0,10,0,21,0,0,21,299,281,99,22,160,18,18,18,0,0,0,0,0,0,60656
20746,51908,1103,2791,6491,24256,17267,853,348,337,100,37,200,11,11,11,0,0,0,0,0,0,505,462,149,18,295,43,31,31,0,0,12,0,0,12,60657
20747,26769,5264,4688,6895,6638,3284,1758,1160,970,227,82,661,190,58,44,0,14,132,35,0,97,598,530,58,107,365,68,34,18,0,16,34,5,29,0,60659
20748,30841,3203,5032,7214,9099,6293,2399,842,793,104,129,560,49,1,1,0,0,48,43,0,5,1557,1463,390,99,974,94,65,26,1,38,29,7,0,22,60660
20749,6148,73,240,564,2751,2520,75,53,53,9,0,44,0,0,0,0,0,0,0,0,0,22,22,0,0,22,0,0,0,0,0,0,0,0,0,60661
20750,17410,2752,6356,4740,2526,1036,1032,460,442,77,67,298,18,18,18,0,0,0,0,0,0,572,529,169,27,333,43,17,17,0,0,26,0,13,13,60706
20751,29823,4392,9537,8132,4832,2930,1964,1160,1012,217,92,703,148,99,93,6,0,49,25,0,24,804,687,133,99,455,117,50,44,6,0,67,0,0,67,60707
20752,8922,926,1364,2079,2747,1806,779,425,425,82,0,343,0,0,0,0,0,0,0,0,0,354,354,92,23,239,0,0,0,0,0,0,0,0,0,60712
20753,23126,3819,7149,5484,4526,2148,985,669,646,189,9,448,23,23,12,0,11,0,0,0,0,316,299,85,0,214,17,17,2,7,8,0,0,0,0,60714
20754,14988,2012,4905,5578,1888,605,1315,654,550,208,55,287,104,60,50,9,1,44,44,0,0,661,524,185,118,221,137,85,47,34,4,52,0,0,52,60803
20755,46708,17472,16399,9340,2834,663,5107,2560,2027,346,225,1456,533,365,198,58,109,168,88,24,56,2547,2004,465,132,1407,543,446,150,168,128,97,6,0,91,60804
20756,12995,1149,3788,4048,2514,1496,1119,611,508,68,151,289,103,56,20,9,27,47,0,0,47,508,500,231,25,244,8,8,8,0,0,0,0,0,0,60805
20757,16772,2448,5438,6777,1380,729,2130,1062,958,56,113,789,104,57,43,14,0,47,0,0,47,1068,895,56,247,592,173,75,24,19,32,98,0,8,90,60827
20758,23313,4284,7798,8100,1976,1155,1993,1226,1053,281,62,710,173,115,25,33,57,58,16,17,25,767,559,107,85,367,208,125,33,92,0,83,10,19,54,60901
20759,289,30,149,98,12,0,4,2,2,0,0,2,0,0,0,0,0,0,0,0,0,2,0,0,0,0,2,2,2,0,0,0,0,0,0,60910
20760,1095,43,478,390,133,51,64,46,18,2,0,16,28,28,28,0,0,0,0,0,0,18,18,2,0,16,0,0,0,0,0,0,0,0,0,60911
20761,420,71,163,133,28,25,43,26,26,9,0,17,0,0,0,0,0,0,0,0,0,17,17,4,0,13,0,0,0,0,0,0,0,0,0,60912
20762,1125,131,467,409,71,47,24,13,13,2,0,11,0,0,0,0,0,0,0,0,0,11,7,2,4,1,4,4,0,4,0,0,0,0,0,60913
20763,17520,1578,5181,6287,2584,1890,2290,1117,951,221,93,637,166,166,34,107,25,0,0,0,0,1173,1103,458,101,544,70,43,26,17,0,27,0,0,27,60914
20764,7051,729,2619,2835,631,237,506,158,117,74,0,43,41,21,21,0,0,20,20,0,0,348,244,103,0,141,104,104,73,0,31,0,0,0,0,60915
20765,370,23,192,130,25,0,33,12,12,0,4,8,0,0,0,0,0,0,0,0,0,21,21,4,0,17,0,0,0,0,0,0,0,0,0,60917
20766,569,31,276,190,58,14,42,14,10,2,0,8,4,4,4,0,0,0,0,0,0,28,26,13,1,12,2,2,0,0,2,0,0,0,0,60918
20767,412,37,117,227,20,11,25,12,5,2,0,3,7,3,0,0,3,4,0,0,4,13,10,1,0,9,3,3,3,0,0,0,0,0,0,60919
20768,74,2,30,34,7,1,10,0,0,0,0,0,0,0,0,0,0,0,0,0,0,10,10,3,0,7,0,0,0,0,0,0,0,0,0,60920
20769,910,168,438,220,62,22,69,39,39,9,0,30,0,0,0,0,0,0,0,0,0,30,27,15,2,10,3,0,0,0,0,3,0,3,0,60921
20770,1619,200,601,551,217,50,125,80,69,3,5,61,11,11,9,2,0,0,0,0,0,45,43,28,3,12,2,0,0,0,0,2,0,0,2,60922
20771,1219,82,571,401,105,60,73,35,27,24,0,3,8,0,0,0,0,8,0,8,0,38,33,17,2,14,5,0,0,0,0,5,5,0,0,60924
20772,29,3,16,7,0,3,0,0,0,0,0,0,0,0,0,0,0,0,0,0,0,0,0,0,0,0,0,0,0,0,0,0,0,0,0,60926
20773,1509,78,671,558,123,79,135,82,78,18,32,28,4,4,0,4,0,0,0,0,0,53,53,14,9,30,0,0,0,0,0,0,0,0,0,60927
20774,523,34,236,167,68,18,24,24,24,12,0,12,0,0,0,0,0,0,0,0,0,0,0,0,0,0,0,0,0,0,0,0,0,0,0,60928
20775,511,45,187,177,81,21,104,59,18,1,2,15,41,41,20,0,21,0,0,0,0,45,15,0,9,6,30,30,30,0,0,0,0,0,0,60929
20776,613,96,317,138,23,39,36,29,12,0,0,12,17,17,0,17,0,0,0,0,0,7,7,4,0,3,0,0,0,0,0,0,0,0,0,60930
20777,386,23,186,128,35,14,29,5,3,0,1,2,2,2,0,0,2,0,0,0,0,24,20,16,0,4,4,4,0,0,4,0,0,0,0,60931
20778,0,0,0,0,0,0,0,0,0,0,0,0,0,0,0,0,0,0,0,0,0,0,0,0,0,0,0,0,0,0,0,0,0,0,0,60932
20779,186,27,98,52,5,4,7,5,5,3,0,2,0,0,0,0,0,0,0,0,0,2,2,0,0,2,0,0,0,0,0,0,0,0,0,60933
20780,194,12,108,58,16,0,9,2,2,2,0,0,0,0,0,0,0,0,0,0,0,7,7,0,6,1,0,0,0,0,0,0,0,0,0,60934
20781,829,71,291,337,96,34,121,52,50,29,0,21,2,2,2,0,0,0,0,0,0,69,69,17,9,43,0,0,0,0,0,0,0,0,0,60935
20782,2959,302,1336,671,521,129,199,70,70,7,26,37,0,0,0,0,0,0,0,0,0,129,129,64,29,36,0,0,0,0,0,0,0,0,0,60936
20783,1447,309,522,472,75,69,71,25,19,0,7,12,6,6,6,0,0,0,0,0,0,46,38,17,3,18,8,8,6,0,2,0,0,0,0,60938
20784,2334,202,958,847,152,175,197,111,91,22,3,66,20,20,1,0,19,0,0,0,0,86,84,27,14,43,2,2,2,0,0,0,0,0,0,60940
20785,1338,175,500,445,143,75,123,85,71,26,0,45,14,14,14,0,0,0,0,0,0,38,38,10,7,21,0,0,0,0,0,0,0,0,0,60941
20786,4296,693,2078,1019,393,113,297,34,34,0,0,34,0,0,0,0,0,0,0,0,0,263,220,72,0,148,43,25,0,0,25,18,16,0,2,60942
20787,134,19,49,46,13,7,9,6,6,5,0,1,0,0,0,0,0,0,0,0,0,3,3,0,0,3,0,0,0,0,0,0,0,0,0,60945
20788,267,19,93,127,16,12,12,2,2,0,0,2,0,0,0,0,0,0,0,0,0,10,10,0,0,10,0,0,0,0,0,0,0,0,0,60946
20789,1100,79,300,375,200,146,40,7,7,4,0,3,0,0,0,0,0,0,0,0,0,33,33,18,0,15,0,0,0,0,0,0,0,0,0,60948
20790,414,74,111,199,23,7,17,15,11,4,0,7,4,4,0,4,0,0,0,0,0,2,1,0,0,1,1,1,1,0,0,0,0,0,0,60949
20791,7943,714,3158,2352,1103,616,665,323,292,38,33,221,31,28,0,18,10,3,0,0,3,342,312,141,37,134,30,24,24,0,0,6,0,0,6,60950
20792,514,29,203,204,45,33,51,27,25,2,6,17,2,0,0,0,0,2,0,0,2,24,24,7,9,8,0,0,0,0,0,0,0,0,0,60951
20793,444,44,230,116,42,12,28,10,6,0,6,0,4,0,0,0,0,4,0,0,4,18,15,9,3,3,3,0,0,0,0,3,0,0,3,60952
20794,1775,219,732,504,238,82,135,86,64,32,0,32,22,17,6,11,0,5,0,0,5,49,49,17,0,32,0,0,0,0,0,0,0,0,0,60953
20795,4477,844,1807,1301,288,237,419,211,170,66,13,91,41,11,0,0,11,30,19,0,11,208,208,5,23,180,0,0,0,0,0,0,0,0,0,60954
20796,1189,282,429,300,125,53,154,89,58,8,0,50,31,7,5,0,2,24,20,0,4,65,44,16,3,25,21,13,13,0,0,8,0,5,3,60955
20797,3883,476,1313,1496,434,164,285,192,153,76,0,77,39,28,18,6,4,11,11,0,0,93,64,21,0,43,29,20,20,0,0,9,0,0,9,60957
20798,1419,477,441,375,73,53,154,81,73,3,20,50,8,8,0,0,8,0,0,0,0,73,69,13,14,42,4,4,0,4,0,0,0,0,0,60958
20799,762,95,335,257,56,19,91,61,53,19,0,34,8,8,6,2,0,0,0,0,0,30,16,9,0,7,14,14,14,0,0,0,0,0,0,60959
20800,721,70,352,226,67,6,53,45,42,18,0,24,3,3,3,0,0,0,0,0,0,8,8,0,0,8,0,0,0,0,0,0,0,0,0,60960
20801,491,25,208,184,42,32,67,14,14,8,0,6,0,0,0,0,0,0,0,0,0,53,44,6,0,38,9,9,9,0,0,0,0,0,0,60961
20802,411,71,181,103,51,5,34,27,25,15,0,10,2,0,0,0,0,2,0,2,0,7,2,0,1,1,5,5,0,0,5,0,0,0,0,60962
20803,1200,137,451,431,123,58,89,62,57,17,0,40,5,0,0,0,0,5,0,0,5,27,20,11,0,9,7,0,0,0,0,7,0,0,7,60963
20804,3637,478,1315,1303,344,197,292,150,128,37,4,87,22,17,0,17,0,5,1,0,4,142,101,15,19,67,41,40,18,21,1,1,0,0,1,60964
20805,1047,131,488,317,68,43,76,42,42,6,0,36,0,0,0,0,0,0,0,0,0,34,34,4,6,24,0,0,0,0,0,0,0,0,0,60966
20806,257,24,93,71,67,2,1,1,1,0,0,1,0,0,0,0,0,0,0,0,0,0,0,0,0,0,0,0,0,0,0,0,0,0,0,60968
20807,30,0,11,13,3,3,1,1,1,1,0,0,0,0,0,0,0,0,0,0,0,0,0,0,0,0,0,0,0,0,0,0,0,0,0,60969
20808,5230,744,2122,1685,515,164,465,222,157,18,14,125,65,0,0,0,0,65,48,0,17,243,211,129,0,82,32,22,6,16,0,10,0,0,10,60970
20809,299,15,144,102,27,11,19,17,14,0,0,14,3,0,0,0,0,3,0,0,3,2,2,2,0,0,0,0,0,0,0,0,0,0,0,60973
20810,227,36,80,111,0,0,21,13,7,0,0,7,6,6,6,0,0,0,0,0,0,8,8,1,3,4,0,0,0,0,0,0,0,0,0,60974
20811,998,86,333,362,129,88,28,22,22,11,0,11,0,0,0,0,0,0,0,0,0,6,6,3,0,3,0,0,0,0,0,0,0,0,0,61001
20812,1383,131,476,625,116,35,83,23,23,7,0,16,0,0,0,0,0,0,0,0,0,60,56,43,0,13,4,4,4,0,0,0,0,0,0,61006
20813,442,55,175,140,65,7,62,27,27,0,0,27,0,0,0,0,0,0,0,0,0,35,35,13,0,22,0,0,0,0,0,0,0,0,0,61007
20814,21848,4000,7633,6206,2607,1402,2333,1338,1029,320,24,685,309,165,50,63,52,144,13,0,131,995,827,222,44,561,168,78,78,0,0,90,0,0,90,61008
20815,5223,281,1566,1904,851,621,559,263,248,28,18,202,15,15,0,0,15,0,0,0,0,296,281,132,7,142,15,15,0,0,15,0,0,0,0,61010
20816,1732,60,520,618,207,327,107,39,39,13,13,13,0,0,0,0,0,0,0,0,0,68,68,39,0,29,0,0,0,0,0,0,0,0,0,61011
20817,1506,224,626,409,222,25,119,54,54,30,0,24,0,0,0,0,0,0,0,0,0,65,57,23,21,13,8,3,3,0,0,5,5,0,0,61012
20818,371,38,127,116,66,24,14,13,13,11,0,2,0,0,0,0,0,0,0,0,0,1,1,1,0,0,0,0,0,0,0,0,0,0,0,61013
20819,868,76,323,329,95,45,48,20,20,2,0,18,0,0,0,0,0,0,0,0,0,28,28,10,0,18,0,0,0,0,0,0,0,0,0,61014
20820,530,8,299,182,10,31,20,18,18,0,0,18,0,0,0,0,0,0,0,0,0,2,2,2,0,0,0,0,0,0,0,0,0,0,0,61015
20821,3521,296,929,1186,745,365,110,56,56,9,0,47,0,0,0,0,0,0,0,0,0,54,46,46,0,0,8,8,8,0,0,0,0,0,0,61016
20822,793,68,392,241,56,36,51,29,16,1,0,15,13,13,13,0,0,0,0,0,0,22,22,3,2,17,0,0,0,0,0,0,0,0,0,61018
20823,2484,184,875,848,373,204,136,82,69,26,0,43,13,13,13,0,0,0,0,0,0,54,22,12,3,7,32,25,25,0,0,7,0,0,7,61019
20824,2018,225,623,806,285,79,220,61,55,5,3,47,6,3,0,0,3,3,3,0,0,159,143,28,16,99,16,16,0,0,16,0,0,0,0,61020
20825,16535,2322,5512,5715,2065,921,1059,553,407,116,39,252,146,71,28,6,37,75,34,5,36,506,489,155,56,278,17,17,7,10,0,0,0,0,0,61021
20826,1699,179,648,493,300,79,138,63,38,4,0,34,25,10,5,0,5,15,0,6,9,75,75,40,19,16,0,0,0,0,0,0,0,0,0,61024
20827,3242,292,1424,985,436,105,222,133,61,49,0,12,72,19,19,0,0,53,0,24,29,89,86,32,2,52,3,3,3,0,0,0,0,0,0,61025
20828,0,0,0,0,0,0,0,0,0,0,0,0,0,0,0,0,0,0,0,0,0,0,0,0,0,0,0,0,0,0,0,0,0,0,0,61027
20829,1437,49,532,471,173,212,103,66,36,10,1,25,30,30,23,0,7,0,0,0,0,37,37,27,0,10,0,0,0,0,0,0,0,0,0,61028
20830,1585,161,769,452,180,23,90,59,59,20,0,39,0,0,0,0,0,0,0,0,0,31,7,0,4,3,24,24,4,16,4,0,0,0,0,61030
20831,1099,200,388,364,109,38,74,29,29,2,0,27,0,0,0,0,0,0,0,0,0,45,34,20,0,14,11,0,0,0,0,11,11,0,0,61031
20832,22050,2434,7900,7690,2519,1507,1336,791,667,83,97,487,124,74,16,5,53,50,0,14,36,545,525,187,103,235,20,20,20,0,0,0,0,0,0,61032
20833,5358,440,1718,1437,1119,644,262,112,92,38,0,54,20,0,0,0,0,20,20,0,0,150,128,51,0,77,22,0,0,0,0,22,0,0,22,61036
20834,181,0,58,83,40,0,0,0,0,0,0,0,0,0,0,0,0,0,0,0,0,0,0,0,0,0,0,0,0,0,0,0,0,0,0,61037
20835,850,85,343,308,75,39,69,60,60,0,21,39,0,0,0,0,0,0,0,0,0,9,4,0,0,4,5,0,0,0,0,5,0,0,5,61038
20836,668,19,242,347,57,3,79,50,47,26,14,7,3,3,3,0,0,0,0,0,0,29,29,10,0,19,0,0,0,0,0,0,0,0,0,61039
20837,1011,95,374,295,134,113,44,20,17,4,0,13,3,0,0,0,0,3,0,0,3,24,16,0,8,8,8,8,8,0,0,0,0,0,0,61041
20838,328,32,124,141,11,20,9,6,6,0,1,5,0,0,0,0,0,0,0,0,0,3,3,0,3,0,0,0,0,0,0,0,0,0,0,61042
20839,66,5,28,15,15,3,0,0,0,0,0,0,0,0,0,0,0,0,0,0,0,0,0,0,0,0,0,0,0,0,0,0,0,0,0,61043
20840,129,16,30,60,18,5,8,0,0,0,0,0,0,0,0,0,0,0,0,0,0,8,8,0,0,8,0,0,0,0,0,0,0,0,0,61044
20841,2148,197,724,874,227,126,134,75,55,19,0,36,20,12,5,2,5,8,0,0,8,59,53,3,3,47,6,6,4,0,2,0,0,0,0,61046
20842,1122,98,538,288,126,72,62,8,8,2,2,4,0,0,0,0,0,0,0,0,0,54,54,2,0,52,0,0,0,0,0,0,0,0,0,61047
20843,2913,297,1047,1028,364,177,211,90,90,19,0,71,0,0,0,0,0,0,0,0,0,121,107,19,19,69,14,14,6,8,0,0,0,0,0,61048
20844,381,27,139,153,44,18,43,23,20,3,0,17,3,3,3,0,0,0,0,0,0,20,17,0,6,11,3,3,3,0,0,0,0,0,0,61049
20845,201,9,121,41,30,0,4,4,0,0,0,0,4,4,4,0,0,0,0,0,0,0,0,0,0,0,0,0,0,0,0,0,0,0,0,61050
20846,1112,120,551,302,108,31,67,28,23,2,11,10,5,5,5,0,0,0,0,0,0,39,36,4,0,32,3,3,0,0,3,0,0,0,0,61051
20847,711,164,252,191,64,40,22,4,4,2,0,2,0,0,0,0,0,0,0,0,0,18,16,6,0,10,2,2,2,0,0,0,0,0,0,61052
20848,2207,236,925,664,231,151,127,71,58,23,0,35,13,13,11,0,2,0,0,0,0,56,56,13,0,43,0,0,0,0,0,0,0,0,0,61053
20849,2820,423,846,1027,305,219,227,139,115,0,35,80,24,24,12,12,0,0,0,0,0,88,88,70,18,0,0,0,0,0,0,0,0,0,0,61054
20850,120,0,55,45,12,8,8,8,8,0,0,8,0,0,0,0,0,0,0,0,0,0,0,0,0,0,0,0,0,0,0,0,0,0,0,61057
20851,87,7,37,22,21,0,51,1,1,0,0,1,0,0,0,0,0,0,0,0,0,50,42,2,0,40,8,8,8,0,0,0,0,0,0,61059
20852,1005,80,413,392,75,45,66,21,15,8,0,7,6,6,0,6,0,0,0,0,0,45,45,20,0,25,0,0,0,0,0,0,0,0,0,61060
20853,5201,379,2105,1594,670,453,356,145,124,34,28,62,21,21,0,12,9,0,0,0,0,211,211,93,35,83,0,0,0,0,0,0,0,0,0,61061
20854,1328,133,502,451,201,41,102,66,62,19,0,43,4,4,4,0,0,0,0,0,0,36,36,17,0,19,0,0,0,0,0,0,0,0,0,61062
20855,2816,164,1230,899,359,164,216,91,60,0,0,60,31,31,6,25,0,0,0,0,0,125,120,81,15,24,5,0,0,0,0,5,0,0,5,61063
20856,2559,189,1029,933,303,105,124,67,67,26,11,30,0,0,0,0,0,0,0,0,0,57,57,12,10,35,0,0,0,0,0,0,0,0,0,61064
20857,6875,400,2960,2442,847,226,816,300,209,34,0,175,91,42,42,0,0,49,36,13,0,516,471,134,2,335,45,45,0,36,9,0,0,0,0,61065
20858,498,65,172,150,61,50,22,10,10,0,0,10,0,0,0,0,0,0,0,0,0,12,12,0,0,12,0,0,0,0,0,0,0,0,0,61067
20859,9643,1828,3163,2970,1149,533,970,592,459,136,94,229,133,100,34,45,21,33,33,0,0,378,318,136,33,149,60,60,25,35,0,0,0,0,0,61068
20860,861,99,406,269,42,45,35,30,30,7,0,23,0,0,0,0,0,0,0,0,0,5,5,2,0,3,0,0,0,0,0,0,0,0,0,61070
20861,9806,1587,3756,3385,764,314,858,458,352,82,41,229,106,83,40,0,43,23,0,13,10,400,312,72,60,180,88,61,21,0,40,27,6,0,21,61071
20862,7942,432,2832,2493,1395,790,748,450,374,79,34,261,76,62,15,0,47,14,0,14,0,298,251,51,19,181,47,15,15,0,0,32,0,0,32,61072
20863,12868,752,3966,4499,2347,1304,1315,678,501,81,73,347,177,107,43,11,53,70,70,0,0,637,610,280,48,282,27,13,0,0,13,14,14,0,0,61073
20864,3046,465,1383,731,347,120,297,143,103,19,40,44,40,30,14,16,0,10,10,0,0,154,124,89,20,15,30,0,0,0,0,30,0,30,0,61074
20865,653,34,386,120,99,14,57,33,30,5,0,25,3,3,0,3,0,0,0,0,0,24,20,11,0,9,4,4,4,0,0,0,0,0,0,61075
20866,64,0,27,0,37,0,15,15,15,0,0,15,0,0,0,0,0,0,0,0,0,0,0,0,0,0,0,0,0,0,0,0,0,0,0,61077
20867,961,67,402,374,85,33,49,29,29,5,2,22,0,0,0,0,0,0,0,0,0,20,20,11,0,9,0,0,0,0,0,0,0,0,0,61078
20868,73,0,42,23,8,0,9,9,9,2,0,7,0,0,0,0,0,0,0,0,0,0,0,0,0,0,0,0,0,0,0,0,0,0,0,61079
20869,7276,1087,2954,2025,921,289,752,345,268,52,5,211,77,40,40,0,0,37,9,0,28,407,251,78,0,173,156,85,85,0,0,71,29,24,18,61080
20870,14912,2096,4809,5285,1710,1012,1002,501,442,164,0,278,59,59,35,24,0,0,0,0,0,501,426,115,40,271,75,44,37,0,7,31,31,0,0,61081
20871,1836,96,679,570,334,157,143,77,67,14,0,53,10,10,0,10,0,0,0,0,0,66,64,26,24,14,2,2,0,0,2,0,0,0,0,61084
20872,2334,216,932,782,284,120,158,52,47,16,0,31,5,5,0,0,5,0,0,0,0,106,100,12,0,88,6,0,0,0,0,6,0,0,6,61085
20873,1234,123,532,420,83,76,90,52,28,11,0,17,24,18,13,5,0,6,0,0,6,38,17,10,0,7,21,21,11,10,0,0,0,0,0,61087
20874,3928,158,1183,1404,706,477,280,133,124,65,23,36,9,9,0,9,0,0,0,0,0,147,123,83,21,19,24,24,24,0,0,0,0,0,0,61088
20875,591,22,211,191,150,17,38,7,7,6,0,1,0,0,0,0,0,0,0,0,0,31,23,0,4,19,8,8,0,0,8,0,0,0,0,61089
20876,93,0,60,26,0,7,0,0,0,0,0,0,0,0,0,0,0,0,0,0,0,0,0,0,0,0,0,0,0,0,0,0,0,0,0,61091
20877,13656,3235,5177,3804,973,467,1503,772,526,51,0,475,246,124,78,46,0,122,0,16,106,731,547,144,89,314,184,107,69,14,24,77,13,16,48,61101
20878,11936,3342,4230,3095,845,424,1259,595,449,142,71,236,146,52,6,0,46,94,46,2,46,664,456,79,69,308,208,143,33,96,14,65,0,13,52,61102
20879,16347,3002,5222,4816,2135,1172,1365,719,573,155,56,362,146,18,0,16,2,128,18,36,74,646,505,159,45,301,141,82,47,19,16,59,23,17,19,61103
20880,10702,2844,3856,3250,423,329,1213,738,413,59,64,290,325,248,194,5,49,77,14,5,58,475,301,32,9,260,174,78,52,25,1,96,0,16,80,61104
20881,21929,1675,5749,6880,4497,3128,1294,673,552,126,40,386,121,72,33,0,39,49,49,0,0,621,574,159,31,384,47,47,31,16,0,0,0,0,0,61107
20882,20236,2143,6746,6714,3033,1600,1314,653,548,158,79,311,105,75,55,0,20,30,0,0,30,661,567,143,44,380,94,14,0,0,14,80,7,0,73,61108
20883,18584,3653,7379,5255,1603,694,1208,594,557,100,82,375,37,37,20,12,5,0,0,0,0,614,544,188,43,313,70,50,47,0,3,20,7,0,13,61109
20884,16420,1482,5432,5727,2552,1227,1267,674,502,122,62,318,172,77,46,31,0,95,16,0,79,593,537,189,18,330,56,43,30,0,13,13,13,0,0,61111
20885,106,0,32,54,20,0,0,0,0,0,0,0,0,0,0,0,0,0,0,0,0,0,0,0,0,0,0,0,0,0,0,0,0,0,0,61112
20886,10777,586,2415,3100,2741,1935,588,314,299,64,29,206,15,15,15,0,0,0,0,0,0,274,215,50,11,154,59,59,0,0,59,0,0,0,0,61114
20887,15604,2058,6376,5238,1288,644,1070,467,429,62,99,268,38,17,17,0,0,21,0,0,21,603,569,238,101,230,34,12,12,0,0,22,0,0,22,61115
20888,25027,3783,7654,8088,3798,1704,2811,1304,1136,233,47,856,168,81,28,50,3,87,45,3,39,1507,1292,548,21,723,215,106,26,34,46,109,8,53,48,61201
20889,919,66,386,338,101,28,38,33,33,9,0,24,0,0,0,0,0,0,0,0,0,5,5,2,0,3,0,0,0,0,0,0,0,0,0,61230
20890,3778,398,1580,1232,338,230,278,133,122,64,0,58,11,11,3,0,8,0,0,0,0,145,105,30,21,54,40,40,32,0,8,0,0,0,0,61231
20891,989,64,322,452,117,34,101,49,48,11,9,28,1,1,1,0,0,0,0,0,0,52,52,42,4,6,0,0,0,0,0,0,0,0,0,61232
20892,936,48,343,323,151,71,54,21,17,5,3,9,4,0,0,0,0,4,0,2,2,33,28,15,0,13,5,5,0,5,0,0,0,0,0,61234
20893,1024,88,493,322,97,24,85,50,50,19,0,31,0,0,0,0,0,0,0,0,0,35,35,17,0,18,0,0,0,0,0,0,0,0,0,61235
20894,39,10,21,8,0,0,0,0,0,0,0,0,0,0,0,0,0,0,0,0,0,0,0,0,0,0,0,0,0,0,0,0,0,0,0,61236
20895,1990,187,753,659,240,151,120,48,32,0,0,32,16,3,0,0,3,13,5,0,8,72,63,19,0,44,9,5,5,0,0,4,0,0,4,61238
20896,683,128,254,240,50,11,44,10,5,0,5,0,5,5,5,0,0,0,0,0,0,34,31,5,10,16,3,3,3,0,0,0,0,0,0,61239
20897,4453,261,1285,1682,756,469,202,131,118,43,17,58,13,7,0,0,7,6,0,0,6,71,71,16,0,55,0,0,0,0,0,0,0,0,0,61240
20898,4474,555,1802,1605,417,95,415,218,163,11,40,112,55,55,55,0,0,0,0,0,0,197,146,13,20,113,51,51,31,0,20,0,0,0,0,61241
20899,816,36,261,333,99,87,38,26,19,2,0,17,7,3,3,0,0,4,0,4,0,12,9,2,0,7,3,0,0,0,0,3,0,3,0,61242
20900,173,14,70,56,28,5,5,0,0,0,0,0,0,0,0,0,0,0,0,0,0,5,5,4,0,1,0,0,0,0,0,0,0,0,0,61243
20901,16669,2766,5472,5633,1899,899,957,508,410,154,26,230,98,22,3,8,11,76,17,24,35,449,428,250,45,133,21,21,10,5,6,0,0,0,0,61244
20902,1720,112,696,498,276,138,99,73,50,20,0,30,23,9,9,0,0,14,11,0,3,26,26,9,0,17,0,0,0,0,0,0,0,0,0,61250
20903,273,23,161,89,0,0,7,0,0,0,0,0,0,0,0,0,0,0,0,0,0,7,7,0,0,7,0,0,0,0,0,0,0,0,0,61251
20904,3781,380,1380,1331,471,219,277,183,161,26,9,126,22,22,22,0,0,0,0,0,0,94,94,74,0,20,0,0,0,0,0,0,0,0,0,61252
20905,8021,457,2534,2744,1548,738,552,273,227,105,6,116,46,37,37,0,0,9,0,0,9,279,237,113,0,124,42,33,0,0,33,9,0,0,9,61254
20906,1522,168,525,488,211,130,92,62,37,0,0,37,25,5,3,2,0,20,0,0,20,30,28,16,0,12,2,2,2,0,0,0,0,0,0,61256
20907,870,85,301,283,198,3,88,43,32,0,0,32,11,11,11,0,0,0,0,0,0,45,40,22,0,18,5,5,0,0,5,0,0,0,0,61257
20908,227,14,135,52,21,5,15,2,0,0,0,0,2,0,0,0,0,2,0,0,2,13,10,5,0,5,3,0,0,0,0,3,0,3,0,61258
20909,774,0,291,330,70,83,23,15,15,0,0,15,0,0,0,0,0,0,0,0,0,8,8,0,0,8,0,0,0,0,0,0,0,0,0,61259
20910,611,24,273,203,79,32,40,13,13,0,0,13,0,0,0,0,0,0,0,0,0,27,27,16,0,11,0,0,0,0,0,0,0,0,0,61260
20911,651,67,299,206,36,43,16,13,13,0,8,5,0,0,0,0,0,0,0,0,0,3,3,3,0,0,0,0,0,0,0,0,0,0,0,61261
20912,1024,30,322,410,145,117,61,42,42,20,11,11,0,0,0,0,0,0,0,0,0,19,19,8,0,11,0,0,0,0,0,0,0,0,0,61262
20913,468,27,265,163,6,7,15,6,0,0,0,0,6,0,0,0,0,6,6,0,0,9,9,0,0,9,0,0,0,0,0,0,0,0,0,61263
20914,8032,817,2981,2976,884,374,287,144,144,31,21,92,0,0,0,0,0,0,0,0,0,143,95,20,14,61,48,37,30,7,0,11,0,6,5,61264
20915,30823,3657,9303,9857,5180,2826,2346,1174,953,369,63,521,221,181,116,43,22,40,0,13,27,1172,1022,498,76,448,150,80,7,20,53,70,0,69,1,61265
20916,5142,434,2231,1638,591,248,350,197,163,54,43,66,34,14,0,0,14,20,20,0,0,153,109,37,0,72,44,44,0,44,0,0,0,0,0,61270
20917,1079,104,528,363,53,31,49,33,30,8,0,22,3,0,0,0,0,3,0,3,0,16,11,6,2,3,5,0,0,0,0,5,0,2,3,61272
20918,2353,192,707,855,462,137,134,82,61,34,0,27,21,9,9,0,0,12,12,0,0,52,52,25,0,27,0,0,0,0,0,0,0,0,0,61273
20919,231,9,161,46,10,5,22,10,10,10,0,0,0,0,0,0,0,0,0,0,0,12,12,12,0,0,0,0,0,0,0,0,0,0,0,61274
20920,3127,144,1110,1052,518,303,215,100,89,9,21,59,11,11,0,11,0,0,0,0,0,115,115,56,5,54,0,0,0,0,0,0,0,0,0,61275
20921,62,12,30,9,11,0,10,10,10,10,0,0,0,0,0,0,0,0,0,0,0,0,0,0,0,0,0,0,0,0,0,0,0,0,0,61276
20922,2264,145,796,845,285,193,153,77,68,11,20,37,9,5,5,0,0,4,0,4,0,76,69,48,2,19,7,7,0,7,0,0,0,0,0,61277
20923,210,14,46,79,31,40,4,0,0,0,0,0,0,0,0,0,0,0,0,0,0,4,4,4,0,0,0,0,0,0,0,0,0,0,0,61278
20924,665,13,306,231,90,25,49,41,41,2,8,31,0,0,0,0,0,0,0,0,0,8,6,2,0,4,2,2,0,0,2,0,0,0,0,61279
20925,1768,100,639,626,252,151,151,68,59,15,0,44,9,9,9,0,0,0,0,0,0,83,80,56,5,19,3,3,0,3,0,0,0,0,0,61281
20926,5266,672,1728,2064,439,363,235,97,91,46,10,35,6,6,6,0,0,0,0,0,0,138,102,30,26,46,36,36,36,0,0,0,0,0,0,61282
20927,1003,199,476,242,61,25,96,77,18,10,0,8,59,6,0,0,6,53,42,0,11,19,13,0,0,13,6,6,3,3,0,0,0,0,0,61283
20928,1788,117,534,591,365,181,98,68,46,46,0,0,22,0,0,0,0,22,0,0,22,30,25,0,13,12,5,5,5,0,0,0,0,0,0,61284
20929,1201,102,504,457,78,60,47,42,35,9,0,26,7,7,7,0,0,0,0,0,0,5,5,5,0,0,0,0,0,0,0,0,0,0,0,61285
20930,7495,916,2537,2844,1030,168,374,216,152,69,0,83,64,15,14,0,1,49,41,8,0,158,158,25,42,91,0,0,0,0,0,0,0,0,0,61301
20931,2881,459,1116,991,196,119,252,119,116,13,0,103,3,3,0,0,3,0,0,0,0,133,113,47,6,60,20,20,20,0,0,0,0,0,0,61310
20932,116,0,71,28,9,8,0,0,0,0,0,0,0,0,0,0,0,0,0,0,0,0,0,0,0,0,0,0,0,0,0,0,0,0,0,61311
20933,362,26,160,128,34,14,42,13,8,0,0,8,5,0,0,0,0,5,3,0,2,29,19,11,0,8,10,0,0,0,0,10,0,0,10,61312
20934,100,9,45,35,7,4,0,0,0,0,0,0,0,0,0,0,0,0,0,0,0,0,0,0,0,0,0,0,0,0,0,0,0,0,0,61313
20935,603,42,288,218,35,20,67,4,4,2,0,2,0,0,0,0,0,0,0,0,0,63,63,9,3,51,0,0,0,0,0,0,0,0,0,61314
20936,212,37,113,47,9,6,31,15,12,3,0,9,3,3,3,0,0,0,0,0,0,16,16,0,5,11,0,0,0,0,0,0,0,0,0,61315
20937,173,7,72,70,21,3,8,1,1,0,1,0,0,0,0,0,0,0,0,0,0,7,7,4,2,1,0,0,0,0,0,0,0,0,0,61316
20938,311,48,100,106,42,15,20,5,3,3,0,0,2,0,0,0,0,2,2,0,0,15,15,0,10,5,0,0,0,0,0,0,0,0,0,61317
20939,437,30,195,157,31,24,39,14,11,5,0,6,3,3,0,3,0,0,0,0,0,25,25,0,0,25,0,0,0,0,0,0,0,0,0,61318
20940,741,38,298,260,113,32,23,17,17,3,0,14,0,0,0,0,0,0,0,0,0,6,6,0,0,6,0,0,0,0,0,0,0,0,0,61319
20941,494,24,175,218,67,10,59,20,17,8,2,7,3,3,3,0,0,0,0,0,0,39,39,17,4,18,0,0,0,0,0,0,0,0,0,61320
20942,211,27,68,74,40,2,25,21,9,2,0,7,12,12,12,0,0,0,0,0,0,4,4,0,0,4,0,0,0,0,0,0,0,0,0,61321
20943,1049,370,330,245,72,32,167,89,80,6,20,54,9,9,0,4,5,0,0,0,0,78,70,10,0,60,8,0,0,0,0,8,0,0,8,61322
20944,66,10,22,24,9,1,2,0,0,0,0,0,0,0,0,0,0,0,0,0,0,2,2,2,0,0,0,0,0,0,0,0,0,0,0,61323
20945,35,0,15,20,0,0,0,0,0,0,0,0,0,0,0,0,0,0,0,0,0,0,0,0,0,0,0,0,0,0,0,0,0,0,0,61324
20946,646,41,267,231,80,27,59,21,21,13,0,8,0,0,0,0,0,0,0,0,0,38,36,23,1,12,2,2,2,0,0,0,0,0,0,61325
20947,1613,182,635,572,150,74,142,70,50,24,6,20,20,20,20,0,0,0,0,0,0,72,62,36,3,23,10,5,0,0,5,5,0,0,5,61326
20948,975,81,420,397,56,21,33,30,21,4,0,17,9,9,9,0,0,0,0,0,0,3,3,0,0,3,0,0,0,0,0,0,0,0,0,61327
20949,13,7,6,0,0,0,0,0,0,0,0,0,0,0,0,0,0,0,0,0,0,0,0,0,0,0,0,0,0,0,0,0,0,0,0,61328
20950,964,49,331,355,137,92,107,57,46,20,12,14,11,9,0,9,0,2,0,2,0,50,50,35,0,15,0,0,0,0,0,0,0,0,0,61329
20951,920,85,382,315,100,38,120,39,33,10,0,23,6,0,0,0,0,6,6,0,0,81,72,43,6,23,9,9,9,0,0,0,0,0,0,61330
20952,0,0,0,0,0,0,0,0,0,0,0,0,0,0,0,0,0,0,0,0,0,0,0,0,0,0,0,0,0,0,0,0,0,0,0,61331
20953,62,6,26,22,8,0,2,2,2,0,0,2,0,0,0,0,0,0,0,0,0,0,0,0,0,0,0,0,0,0,0,0,0,0,0,61332
20954,186,12,74,49,23,28,2,1,1,0,0,1,0,0,0,0,0,0,0,0,0,1,1,0,0,1,0,0,0,0,0,0,0,0,0,61333
20955,417,45,155,140,55,22,20,11,9,0,0,9,2,2,0,2,0,0,0,0,0,9,5,3,0,2,4,0,0,0,0,4,0,2,2,61334
20956,358,46,136,127,39,10,8,6,6,3,0,3,0,0,0,0,0,0,0,0,0,2,2,0,0,2,0,0,0,0,0,0,0,0,0,61335
20957,537,74,182,172,82,27,54,45,11,5,1,5,34,34,31,0,3,0,0,0,0,9,7,0,0,7,2,0,0,0,0,2,2,0,0,61336
20958,348,43,148,130,16,11,19,9,9,2,1,6,0,0,0,0,0,0,0,0,0,10,10,8,0,2,0,0,0,0,0,0,0,0,0,61337
20959,166,22,62,79,2,1,22,4,4,3,0,1,0,0,0,0,0,0,0,0,0,18,6,0,0,6,12,0,0,0,0,12,8,4,0,61338
20960,221,35,69,94,14,9,33,16,16,12,0,4,0,0,0,0,0,0,0,0,0,17,17,16,0,1,0,0,0,0,0,0,0,0,0,61340
20961,5361,722,2107,1809,433,290,429,221,196,45,51,100,25,25,25,0,0,0,0,0,0,208,167,54,43,70,41,41,16,0,25,0,0,0,0,61341
20962,6136,1024,2458,1763,612,279,372,141,114,38,0,76,27,27,18,0,9,0,0,0,0,231,218,139,9,70,13,13,0,13,0,0,0,0,0,61342
20963,229,26,113,58,12,20,12,8,8,0,0,8,0,0,0,0,0,0,0,0,0,4,4,1,2,1,0,0,0,0,0,0,0,0,0,61344
20964,571,53,200,218,60,40,54,40,14,2,0,12,26,12,8,0,4,14,4,1,9,14,8,4,0,4,6,2,2,0,0,4,0,0,4,61345
20965,47,8,22,15,2,0,3,3,3,3,0,0,0,0,0,0,0,0,0,0,0,0,0,0,0,0,0,0,0,0,0,0,0,0,0,61346
20966,3109,315,1045,1294,264,191,157,61,61,17,0,44,0,0,0,0,0,0,0,0,0,96,68,55,0,13,28,28,28,0,0,0,0,0,0,61348
20967,582,66,254,176,59,27,30,16,14,2,0,12,2,2,2,0,0,0,0,0,0,14,14,12,0,2,0,0,0,0,0,0,0,0,0,61349
20968,16670,1789,6130,5731,2000,1020,1172,590,446,155,76,215,144,108,55,45,8,36,13,13,10,582,448,162,64,222,134,108,108,0,0,26,0,0,26,61350
20969,951,66,356,398,92,39,98,53,41,10,0,31,12,4,0,4,0,8,0,5,3,45,40,13,0,27,5,5,4,1,0,0,0,0,0,61353
20970,7982,695,2799,2788,1064,636,554,259,210,125,38,47,49,27,24,0,3,22,0,22,0,295,295,118,61,116,0,0,0,0,0,0,0,0,0,61354
20971,8058,713,3201,2471,1093,580,480,317,264,88,27,149,53,38,28,10,0,15,15,0,0,163,143,88,0,55,20,20,20,0,0,0,0,0,0,61356
20972,310,39,139,94,38,0,0,0,0,0,0,0,0,0,0,0,0,0,0,0,0,0,0,0,0,0,0,0,0,0,0,0,0,0,0,61358
20973,206,30,78,74,16,8,8,1,0,0,0,0,1,1,0,1,0,0,0,0,0,7,7,4,0,3,0,0,0,0,0,0,0,0,0,61359
20974,2397,132,1012,839,310,104,249,193,176,35,0,141,17,17,8,9,0,0,0,0,0,56,32,12,0,20,24,10,0,0,10,14,14,0,0,61360
20975,972,115,419,262,122,54,81,22,20,0,0,20,2,2,2,0,0,0,0,0,0,59,44,9,0,35,15,15,13,0,2,0,0,0,0,61361
20976,3911,435,1529,1302,432,213,194,103,101,33,0,68,2,2,2,0,0,0,0,0,0,91,81,41,0,40,10,10,0,10,0,0,0,0,0,61362
20977,151,23,58,58,5,7,17,7,7,2,0,5,0,0,0,0,0,0,0,0,0,10,10,10,0,0,0,0,0,0,0,0,0,0,0,61363
20978,13499,1880,5623,4423,1119,454,972,447,396,152,45,199,51,23,7,16,0,28,0,6,22,525,432,235,33,164,93,76,32,17,27,17,0,0,17,61364
20979,575,41,305,149,52,28,60,36,32,23,5,4,4,4,4,0,0,0,0,0,0,24,24,0,0,24,0,0,0,0,0,0,0,0,0,61367
20980,1166,115,434,414,110,93,34,9,7,2,0,5,2,0,0,0,0,2,0,2,0,25,25,4,0,21,0,0,0,0,0,0,0,0,0,61368
20981,1152,159,454,358,150,31,67,25,23,11,0,12,2,2,0,2,0,0,0,0,0,42,19,8,0,11,23,13,8,5,0,10,0,0,10,61369
20982,989,87,323,413,125,41,55,28,21,6,5,10,7,7,7,0,0,0,0,0,0,27,22,13,9,0,5,5,0,3,2,0,0,0,0,61370
20983,72,11,46,11,4,0,7,4,3,0,0,3,1,1,1,0,0,0,0,0,0,3,3,3,0,0,0,0,0,0,0,0,0,0,0,61372
20984,1404,66,473,619,198,48,74,31,28,10,8,10,3,3,3,0,0,0,0,0,0,43,43,20,0,23,0,0,0,0,0,0,0,0,0,61373
20985,90,0,51,33,6,0,6,0,0,0,0,0,0,0,0,0,0,0,0,0,0,6,3,3,0,0,3,3,3,0,0,0,0,0,0,61374
20986,850,36,285,264,205,60,30,3,3,2,1,0,0,0,0,0,0,0,0,0,0,27,16,2,0,14,11,11,11,0,0,0,0,0,0,61375
20987,1665,92,595,561,272,145,120,64,58,13,0,45,6,6,0,0,6,0,0,0,0,56,53,7,2,44,3,0,0,0,0,3,0,3,0,61376
20988,1069,161,518,235,111,44,111,60,57,29,0,28,3,3,3,0,0,0,0,0,0,51,51,0,14,37,0,0,0,0,0,0,0,0,0,61377
20989,353,21,138,97,89,8,17,8,8,0,0,8,0,0,0,0,0,0,0,0,0,9,6,0,0,6,3,3,0,3,0,0,0,0,0,61378
20990,865,95,358,373,32,7,63,24,24,9,2,13,0,0,0,0,0,0,0,0,0,39,19,8,0,11,20,20,20,0,0,0,0,0,0,61379
20991,23790,3965,8686,7132,2359,1648,2032,907,735,132,248,355,172,149,60,17,72,23,0,8,15,1125,1000,347,81,572,125,43,26,0,17,82,0,9,73,61401
20992,2605,293,1056,940,273,43,207,114,106,52,0,54,8,0,0,0,0,8,8,0,0,93,82,16,0,66,11,0,0,0,0,11,0,0,11,61410
20993,241,49,138,34,20,0,15,0,0,0,0,0,0,0,0,0,0,0,0,0,0,15,15,0,0,15,0,0,0,0,0,0,0,0,0,61411
20994,911,53,322,343,155,38,61,47,47,3,33,11,0,0,0,0,0,0,0,0,0,14,14,1,0,13,0,0,0,0,0,0,0,0,0,61412
20995,686,58,276,223,87,42,52,35,31,6,2,23,4,4,0,4,0,0,0,0,0,17,12,6,2,4,5,5,5,0,0,0,0,0,0,61413
20996,455,34,197,169,43,12,9,5,5,0,0,5,0,0,0,0,0,0,0,0,0,4,4,4,0,0,0,0,0,0,0,0,0,0,0,61414
20997,1206,157,421,354,196,78,87,51,51,0,11,40,0,0,0,0,0,0,0,0,0,36,22,5,0,17,14,2,2,0,0,12,0,0,12,61415
20998,132,26,48,37,17,4,9,9,7,2,0,5,2,0,0,0,0,2,0,0,2,0,0,0,0,0,0,0,0,0,0,0,0,0,0,61416
20999,190,32,87,61,0,10,10,0,0,0,0,0,0,0,0,0,0,0,0,0,0,10,10,0,10,0,0,0,0,0,0,0,0,0,0,61417
21000,482,58,154,167,79,24,13,13,13,0,0,13,0,0,0,0,0,0,0,0,0,0,0,0,0,0,0,0,0,0,0,0,0,0,0,61418
21001,102,4,38,35,16,9,3,2,0,0,0,0,2,2,0,0,2,0,0,0,0,1,1,0,0,1,0,0,0,0,0,0,0,0,0,61419
21002,838,70,278,359,101,30,37,26,14,9,0,5,12,9,6,3,0,3,0,3,0,11,11,2,0,9,0,0,0,0,0,0,0,0,0,61420
21003,894,60,367,312,124,31,106,58,47,7,0,40,11,11,0,1,10,0,0,0,0,48,40,14,4,22,8,8,4,0,4,0,0,0,0,61421
21004,2398,338,882,827,261,90,201,88,64,39,11,14,24,0,0,0,0,24,0,24,0,113,102,39,0,63,11,11,11,0,0,0,0,0,0,61422
21005,514,53,242,180,35,4,68,42,42,0,21,21,0,0,0,0,0,0,0,0,0,26,26,0,0,26,0,0,0,0,0,0,0,0,0,61423
21006,68,0,26,32,10,0,7,0,0,0,0,0,0,0,0,0,0,0,0,0,0,7,7,0,0,7,0,0,0,0,0,0,0,0,0,61424
21007,204,24,30,92,58,0,0,0,0,0,0,0,0,0,0,0,0,0,0,0,0,0,0,0,0,0,0,0,0,0,0,0,0,0,0,61425
21008,81,37,33,11,0,0,10,10,10,0,0,10,0,0,0,0,0,0,0,0,0,0,0,0,0,0,0,0,0,0,0,0,0,0,0,61426
21009,1761,250,635,606,238,32,149,82,55,9,6,40,27,13,3,0,10,14,0,0,14,67,44,4,13,27,23,23,10,4,9,0,0,0,0,61427
21010,667,34,173,220,146,94,25,9,9,0,4,5,0,0,0,0,0,0,0,0,0,16,9,0,0,9,7,7,7,0,0,0,0,0,0,61428
21011,572,87,250,151,43,41,50,33,29,3,4,22,4,2,0,2,0,2,0,2,0,17,17,10,3,4,0,0,0,0,0,0,0,0,0,61430
21012,313,27,111,144,17,14,21,14,12,2,0,10,2,2,0,0,2,0,0,0,0,7,7,0,0,7,0,0,0,0,0,0,0,0,0,61431
21013,425,22,177,123,62,41,39,19,19,2,0,17,0,0,0,0,0,0,0,0,0,20,17,5,0,12,3,0,0,0,0,3,0,3,0,61432
21014,0,0,0,0,0,0,0,0,0,0,0,0,0,0,0,0,0,0,0,0,0,0,0,0,0,0,0,0,0,0,0,0,0,0,0,61433
21015,2349,235,1002,734,265,113,223,81,79,0,19,60,2,0,0,0,0,2,0,2,0,142,142,84,0,58,0,0,0,0,0,0,0,0,0,61434
21016,115,20,42,42,11,0,12,0,0,0,0,0,0,0,0,0,0,0,0,0,0,12,12,7,0,5,0,0,0,0,0,0,0,0,0,61435
21017,805,88,323,211,130,53,30,14,14,0,0,14,0,0,0,0,0,0,0,0,0,16,16,0,0,16,0,0,0,0,0,0,0,0,0,61436
21018,675,76,249,208,121,21,25,11,10,0,4,6,1,1,0,1,0,0,0,0,0,14,14,5,0,9,0,0,0,0,0,0,0,0,0,61437
21019,615,21,156,208,175,55,45,36,35,29,0,6,1,1,1,0,0,0,0,0,0,9,9,2,0,7,0,0,0,0,0,0,0,0,0,61438
21020,204,25,92,66,10,11,6,6,6,2,2,2,0,0,0,0,0,0,0,0,0,0,0,0,0,0,0,0,0,0,0,0,0,0,0,61439
21021,512,28,180,160,129,15,13,9,9,4,0,5,0,0,0,0,0,0,0,0,0,4,4,0,0,4,0,0,0,0,0,0,0,0,0,61440
21022,759,86,372,200,90,11,18,14,12,0,0,12,2,2,2,0,0,0,0,0,0,4,4,4,0,0,0,0,0,0,0,0,0,0,0,61441
21023,499,88,214,156,39,2,23,6,6,4,0,2,0,0,0,0,0,0,0,0,0,17,15,9,0,6,2,2,2,0,0,0,0,0,0,61442
21024,9289,1597,3190,3071,907,524,924,553,373,33,0,340,180,143,35,34,74,37,6,6,25,371,242,70,22,150,129,69,53,8,8,60,0,32,28,61443
21025,627,51,274,194,100,8,28,12,12,0,0,12,0,0,0,0,0,0,0,0,0,16,15,7,2,6,1,1,0,1,0,0,0,0,0,61447
21026,2900,318,1029,1064,362,127,177,89,84,15,12,57,5,5,0,0,5,0,0,0,0,88,88,29,0,59,0,0,0,0,0,0,0,0,0,61448
21027,388,64,184,85,55,0,40,19,12,4,0,8,7,6,0,5,1,1,0,1,0,21,10,5,0,5,11,11,11,0,0,0,0,0,0,61449
21028,1243,71,498,407,192,75,140,88,78,16,16,46,10,10,0,7,3,0,0,0,0,52,32,8,13,11,20,20,5,0,15,0,0,0,0,61450
21029,373,27,153,110,66,17,39,29,29,0,0,29,0,0,0,0,0,0,0,0,0,10,10,0,0,10,0,0,0,0,0,0,0,0,0,61451
21030,271,16,159,81,13,2,16,0,0,0,0,0,0,0,0,0,0,0,0,0,0,16,1,0,0,1,15,12,12,0,0,3,0,0,3,61452
21031,418,19,218,130,34,17,26,16,16,1,1,14,0,0,0,0,0,0,0,0,0,10,10,3,0,7,0,0,0,0,0,0,0,0,0,61453
21032,374,55,194,81,38,6,12,9,9,1,0,8,0,0,0,0,0,0,0,0,0,3,1,0,0,1,2,2,0,2,0,0,0,0,0,61454
21033,10635,687,2368,2968,2242,2370,3530,2068,2031,402,356,1273,37,37,8,0,29,0,0,0,0,1462,1429,342,151,936,33,18,7,6,5,15,0,10,5,61455
21034,694,50,261,226,136,21,39,29,27,8,1,18,2,2,0,2,0,0,0,0,0,10,10,0,2,8,0,0,0,0,0,0,0,0,0,61458
21035,310,36,175,75,24,0,11,2,0,0,0,0,2,2,0,0,2,0,0,0,0,9,9,0,9,0,0,0,0,0,0,0,0,0,0,61459
21036,240,15,116,60,33,16,6,5,0,0,0,0,5,0,0,0,0,5,5,0,0,1,1,0,1,0,0,0,0,0,0,0,0,0,0,61460
21037,7070,1038,2432,2116,1014,470,1053,490,414,85,25,304,76,76,68,8,0,0,0,0,0,563,555,172,57,326,8,8,8,0,0,0,0,0,0,61462
21038,886,116,347,288,58,77,60,37,22,2,3,17,15,15,9,6,0,0,0,0,0,23,21,17,0,4,2,2,2,0,0,0,0,0,0,61465
21039,258,26,78,86,33,35,20,12,12,1,5,6,0,0,0,0,0,0,0,0,0,8,8,4,3,1,0,0,0,0,0,0,0,0,0,61466
21040,704,26,320,245,73,40,109,55,44,10,0,34,11,11,3,8,0,0,0,0,0,54,51,11,3,37,3,0,0,0,0,3,3,0,0,61467
21041,110,20,30,47,7,6,23,4,4,0,0,4,0,0,0,0,0,0,0,0,0,19,0,0,0,0,19,19,19,0,0,0,0,0,0,61468
21042,1718,265,805,456,154,38,137,90,63,31,3,29,27,22,19,3,0,5,0,5,0,47,47,34,0,13,0,0,0,0,0,0,0,0,0,61469
21043,399,61,173,137,18,10,37,27,21,0,0,21,6,6,0,6,0,0,0,0,0,10,10,3,0,7,0,0,0,0,0,0,0,0,0,61470
21044,92,5,50,26,9,2,1,0,0,0,0,0,0,0,0,0,0,0,0,0,0,1,1,1,0,0,0,0,0,0,0,0,0,0,0,61471
21045,509,42,138,178,130,21,34,8,4,0,0,4,4,4,4,0,0,0,0,0,0,26,18,0,0,18,8,7,0,0,7,1,1,0,0,61472
21046,1250,121,399,372,264,94,23,20,20,4,4,12,0,0,0,0,0,0,0,0,0,3,3,3,0,0,0,0,0,0,0,0,0,0,0,61473
21047,126,28,48,46,4,0,5,4,4,2,0,2,0,0,0,0,0,0,0,0,0,1,1,0,0,1,0,0,0,0,0,0,0,0,0,61474
21048,177,9,102,51,15,0,49,0,0,0,0,0,0,0,0,0,0,0,0,0,0,49,49,27,0,22,0,0,0,0,0,0,0,0,0,61475
21049,414,28,150,171,55,10,26,15,14,10,2,2,1,1,1,0,0,0,0,0,0,11,10,8,0,2,1,0,0,0,0,1,0,0,1,61476
21050,485,62,231,146,14,32,14,2,1,0,0,1,1,1,1,0,0,0,0,0,0,12,12,0,0,12,0,0,0,0,0,0,0,0,0,61477
21051,135,7,45,65,18,0,6,6,6,0,0,6,0,0,0,0,0,0,0,0,0,0,0,0,0,0,0,0,0,0,0,0,0,0,0,61478
21052,111,0,33,64,14,0,0,0,0,0,0,0,0,0,0,0,0,0,0,0,0,0,0,0,0,0,0,0,0,0,0,0,0,0,0,61479
21053,1036,96,373,411,136,20,114,40,36,8,0,28,4,0,0,0,0,4,0,4,0,74,74,43,12,19,0,0,0,0,0,0,0,0,0,61480
21054,405,22,157,155,44,27,12,6,6,0,0,6,0,0,0,0,0,0,0,0,0,6,6,0,3,3,0,0,0,0,0,0,0,0,0,61482
21055,1419,176,519,444,223,57,90,33,31,9,3,19,2,2,2,0,0,0,0,0,0,57,57,24,0,33,0,0,0,0,0,0,0,0,0,61483
21056,697,111,288,217,70,11,68,28,27,10,4,13,1,1,1,0,0,0,0,0,0,40,31,14,1,16,9,9,7,0,2,0,0,0,0,61484
21057,367,27,131,121,77,11,57,38,38,21,2,15,0,0,0,0,0,0,0,0,0,19,19,3,0,16,0,0,0,0,0,0,0,0,0,61485
21058,1103,137,442,416,84,24,93,43,43,38,5,0,0,0,0,0,0,0,0,0,0,50,50,3,0,47,0,0,0,0,0,0,0,0,0,61486
21059,769,44,286,314,118,7,75,60,48,28,0,20,12,3,3,0,0,9,9,0,0,15,8,0,4,4,7,7,7,0,0,0,0,0,0,61488
21060,676,51,277,244,74,30,30,15,15,3,0,12,0,0,0,0,0,0,0,0,0,15,15,2,0,13,0,0,0,0,0,0,0,0,0,61489
21061,952,52,381,359,104,56,56,28,26,9,7,10,2,2,2,0,0,0,0,0,0,28,25,20,2,3,3,3,3,0,0,0,0,0,0,61490
21062,1609,176,682,533,133,85,48,15,15,0,0,15,0,0,0,0,0,0,0,0,0,33,23,3,0,20,10,10,6,0,4,0,0,0,0,61491
21063,1333,155,544,467,117,50,90,75,53,6,8,39,22,20,7,10,3,2,0,0,2,15,9,3,0,6,6,6,3,3,0,0,0,0,0,61501
21064,519,29,208,184,67,31,28,23,23,7,0,16,0,0,0,0,0,0,0,0,0,5,5,2,0,3,0,0,0,0,0,0,0,0,0,61516
21065,2223,122,820,632,441,208,171,87,76,25,2,49,11,8,8,0,0,3,3,0,0,84,84,25,0,59,0,0,0,0,0,0,0,0,0,61517
21066,113,16,49,36,3,9,7,6,6,2,0,4,0,0,0,0,0,0,0,0,0,1,1,1,0,0,0,0,0,0,0,0,0,0,0,61519
21067,12518,1855,4066,4691,1276,630,639,329,272,71,25,176,57,26,17,0,9,31,24,0,7,310,281,94,68,119,29,6,4,2,0,23,0,23,0,61520
21068,8028,710,2689,2924,1117,588,499,271,218,60,11,147,53,53,35,18,0,0,0,0,0,228,185,70,0,115,43,32,0,0,32,11,0,11,0,61523
21069,126,11,56,37,10,12,3,3,3,0,0,3,0,0,0,0,0,0,0,0,0,0,0,0,0,0,0,0,0,0,0,0,0,0,0,61524
21070,5636,194,531,1677,2073,1161,514,280,240,145,16,79,40,34,8,0,26,6,3,0,3,234,230,79,26,125,4,0,0,0,0,4,0,4,0,61525
21071,707,53,198,232,152,72,61,16,16,8,0,8,0,0,0,0,0,0,0,0,0,45,45,0,0,45,0,0,0,0,0,0,0,0,0,61526
21072,1739,157,373,440,507,262,125,20,20,0,0,20,0,0,0,0,0,0,0,0,0,105,89,29,0,60,16,16,16,0,0,0,0,0,0,61528
21073,1959,67,611,664,478,139,179,91,91,35,5,51,0,0,0,0,0,0,0,0,0,88,82,59,0,23,6,6,6,0,0,0,0,0,0,61529
21074,4070,280,1194,1407,746,443,351,111,111,24,39,48,0,0,0,0,0,0,0,0,0,240,240,132,31,77,0,0,0,0,0,0,0,0,0,61530
21075,2337,228,1012,738,297,62,182,100,95,12,13,70,5,0,0,0,0,5,0,0,5,82,77,32,24,21,5,5,5,0,0,0,0,0,0,61531
21076,365,68,192,97,0,8,21,10,10,0,0,10,0,0,0,0,0,0,0,0,0,11,11,0,0,11,0,0,0,0,0,0,0,0,0,61532
21077,1649,155,770,538,123,63,122,43,28,11,0,17,15,15,15,0,0,0,0,0,0,79,79,26,3,50,0,0,0,0,0,0,0,0,0,61533
21078,1242,119,471,473,147,32,63,44,44,10,2,32,0,0,0,0,0,0,0,0,0,19,17,0,0,17,2,2,2,0,0,0,0,0,0,61534
21079,1092,12,417,276,277,110,61,61,61,17,0,44,0,0,0,0,0,0,0,0,0,0,0,0,0,0,0,0,0,0,0,0,0,0,0,61535
21080,2067,193,849,699,239,87,106,64,58,8,23,27,6,6,6,0,0,0,0,0,0,42,33,9,5,19,9,0,0,0,0,9,0,0,9,61536
21081,1995,225,847,625,249,49,180,77,67,39,0,28,10,5,5,0,0,5,0,5,0,103,100,36,0,64,3,0,0,0,0,3,0,3,0,61537
21082,140,29,65,46,0,0,16,9,6,0,0,6,3,2,2,0,0,1,0,1,0,7,7,5,0,2,0,0,0,0,0,0,0,0,0,61539
21083,2030,118,906,679,216,111,175,75,49,33,0,16,26,0,0,0,0,26,0,26,0,100,76,33,7,36,24,24,24,0,0,0,0,0,0,61540
21084,90,3,48,28,0,11,13,9,0,0,0,0,9,9,7,2,0,0,0,0,0,4,4,2,0,2,0,0,0,0,0,0,0,0,0,61541
21085,2913,376,1245,889,351,52,168,76,66,29,0,37,10,10,3,0,7,0,0,0,0,92,91,37,12,42,1,1,0,1,0,0,0,0,0,61542
21086,76,12,48,13,3,0,9,0,0,0,0,0,0,0,0,0,0,0,0,0,0,9,9,0,0,9,0,0,0,0,0,0,0,0,0,61543
21087,491,38,200,164,42,47,86,46,39,0,0,39,7,6,5,1,0,1,0,1,0,40,35,15,0,20,5,1,0,1,0,4,0,0,4,61544
21088,536,86,254,92,70,34,62,0,0,0,0,0,0,0,0,0,0,0,0,0,0,62,62,0,5,57,0,0,0,0,0,0,0,0,0,61545
21089,3210,314,1290,1228,317,61,202,114,97,36,7,54,17,7,7,0,0,10,0,0,10,88,79,31,6,42,9,0,0,0,0,9,0,5,4,61546
21090,2757,106,852,961,496,342,244,170,114,14,2,98,56,33,18,7,8,23,0,10,13,74,64,20,1,43,10,0,0,0,0,10,10,0,0,61547
21091,7966,462,1998,2527,2061,918,733,467,393,152,20,221,74,50,50,0,0,24,0,0,24,266,245,64,7,174,21,21,0,21,0,0,0,0,0,61548
21092,12457,650,2863,3752,3519,1673,910,428,420,121,99,200,8,8,8,0,0,0,0,0,0,482,435,139,0,296,47,47,47,0,0,0,0,0,0,61550
21093,129,20,76,27,6,0,0,0,0,0,0,0,0,0,0,0,0,0,0,0,0,0,0,0,0,0,0,0,0,0,0,0,0,0,0,61552
21094,156,17,53,52,27,7,5,5,0,0,0,0,5,5,5,0,0,0,0,0,0,0,0,0,0,0,0,0,0,0,0,0,0,0,0,61553
21095,30641,3380,12077,10229,3620,1335,1694,761,625,231,48,346,136,110,65,44,1,26,0,11,15,933,715,181,32,502,218,106,48,48,10,112,0,0,112,61554
21096,2200,218,756,708,303,215,115,62,46,25,0,21,16,16,0,8,8,0,0,0,0,53,46,9,4,33,7,0,0,0,0,7,3,0,4,61559
21097,451,35,193,117,15,91,1,0,0,0,0,0,0,0,0,0,0,0,0,0,0,1,1,0,1,0,0,0,0,0,0,0,0,0,0,61560
21098,1863,139,639,700,298,87,245,172,157,103,6,48,15,15,15,0,0,0,0,0,0,73,67,39,10,18,6,6,0,0,6,0,0,0,0,61561
21099,40,0,40,0,0,0,0,0,0,0,0,0,0,0,0,0,0,0,0,0,0,0,0,0,0,0,0,0,0,0,0,0,0,0,0,61562
21100,344,31,151,126,33,3,22,14,10,2,0,8,4,4,4,0,0,0,0,0,0,8,7,4,0,3,1,1,0,1,0,0,0,0,0,61563
21101,756,90,383,249,24,10,82,44,27,0,3,24,17,6,0,0,6,11,0,0,11,38,35,14,0,21,3,0,0,0,0,3,3,0,0,61564
21102,1264,100,578,416,108,62,57,33,33,2,10,21,0,0,0,0,0,0,0,0,0,24,13,9,0,4,11,3,3,0,0,8,0,0,8,61565
21103,386,130,110,125,10,11,12,5,2,0,0,2,3,0,0,0,0,3,0,3,0,7,5,0,0,5,2,0,0,0,0,2,0,2,0,61567
21104,2843,152,794,895,748,254,274,172,172,49,32,91,0,0,0,0,0,0,0,0,0,102,102,62,0,40,0,0,0,0,0,0,0,0,0,61568
21105,682,9,300,205,120,48,58,20,20,0,0,20,0,0,0,0,0,0,0,0,0,38,38,9,0,29,0,0,0,0,0,0,0,0,0,61569
21106,1209,103,486,410,164,46,66,47,43,8,6,29,4,4,4,0,0,0,0,0,0,19,19,0,0,19,0,0,0,0,0,0,0,0,0,61570
21107,16070,857,4483,5785,3557,1388,1278,629,602,241,5,356,27,27,19,8,0,0,0,0,0,649,581,255,67,259,68,30,30,0,0,38,6,32,0,61571
21108,845,41,392,303,90,19,85,28,20,8,0,12,8,8,8,0,0,0,0,0,0,57,57,0,7,50,0,0,0,0,0,0,0,0,0,61572
21109,791,179,235,145,120,112,63,28,5,0,0,5,23,0,0,0,0,23,0,0,23,35,0,0,0,0,35,0,0,0,0,35,0,0,35,61602
21110,9686,1567,3444,3254,995,426,1008,457,345,47,23,275,112,61,38,0,23,51,6,25,20,551,429,115,36,278,122,45,6,34,5,77,14,0,63,61603
21111,21114,2847,7074,6726,2987,1480,1322,593,525,152,71,302,68,17,11,0,6,51,0,0,51,729,577,149,68,360,152,32,17,15,0,120,68,0,52,61604
21112,8969,2651,3774,2093,371,80,929,597,415,83,50,282,182,75,42,7,26,107,0,30,77,332,248,46,64,138,84,17,0,9,8,67,21,0,46,61605
21113,2773,207,739,789,570,468,1437,682,667,215,29,423,15,7,0,7,0,8,0,3,5,755,751,214,47,490,4,4,0,0,4,0,0,0,0,61606
21114,8132,685,3019,3089,921,418,384,190,157,47,15,95,33,19,15,4,0,14,0,5,9,194,182,87,9,86,12,12,10,2,0,0,0,0,0,61607
21115,3880,568,1746,1317,178,71,431,125,125,31,13,81,0,0,0,0,0,0,0,0,0,306,241,93,6,142,65,54,0,0,54,11,0,0,11,61610
21116,18034,1687,5565,6856,2796,1130,1043,536,391,81,12,298,145,111,75,33,3,34,8,23,3,507,433,111,30,292,74,23,23,0,0,51,10,0,41,61611
21117,20868,1166,4434,6515,5311,3442,1180,573,494,166,44,284,79,64,9,8,47,15,0,15,0,607,515,246,21,248,92,92,28,0,64,0,0,0,0,61614
21118,16315,732,3432,4546,4437,3168,1242,514,479,183,15,281,35,0,0,0,0,35,15,0,20,728,662,120,29,513,66,61,17,0,44,5,0,5,0,61615
21119,4429,333,1312,1808,622,354,254,138,115,23,0,92,23,23,0,0,23,0,0,0,0,116,103,32,8,63,13,13,0,13,0,0,0,0,0,61616
21120,0,0,0,0,0,0,317,151,151,34,0,117,0,0,0,0,0,0,0,0,0,166,166,33,6,127,0,0,0,0,0,0,0,0,0,61625
21121,23332,2084,7252,6651,5432,1913,2248,1062,890,251,103,536,172,48,31,13,4,124,103,11,10,1186,1059,311,94,654,127,85,15,48,22,42,42,0,0,61701
21122,23080,775,3652,5017,9071,4565,1700,1141,1071,305,50,716,70,56,56,0,0,14,14,0,0,559,507,227,50,230,52,32,0,0,32,20,0,0,20,61704
21123,8322,289,1552,2269,2923,1289,823,317,288,91,0,197,29,22,22,0,0,7,0,0,7,506,485,200,19,266,21,21,0,0,21,0,0,0,0,61705
21124,109,20,48,37,4,0,5,0,0,0,0,0,0,0,0,0,0,0,0,0,0,5,4,2,0,2,1,0,0,0,0,1,0,0,1,61720
21125,393,23,204,116,45,5,36,26,26,1,0,25,0,0,0,0,0,0,0,0,0,10,6,0,0,6,4,4,0,0,4,0,0,0,0,61721
21126,405,21,161,133,74,16,47,8,6,1,0,5,2,2,0,2,0,0,0,0,0,39,39,29,0,10,0,0,0,0,0,0,0,0,0,61722
21127,1248,143,569,337,174,25,22,9,8,2,2,4,1,1,1,0,0,0,0,0,0,13,13,4,1,8,0,0,0,0,0,0,0,0,0,61723
21128,312,12,122,134,36,8,13,8,8,4,2,2,0,0,0,0,0,0,0,0,0,5,5,2,0,3,0,0,0,0,0,0,0,0,0,61724
21129,961,45,217,381,199,119,116,42,42,24,11,7,0,0,0,0,0,0,0,0,0,74,61,50,0,11,13,4,0,4,0,9,2,0,7,61725
21130,1751,166,654,525,226,180,118,75,35,7,2,26,40,29,29,0,0,11,0,11,0,43,33,15,0,18,10,5,5,0,0,5,0,5,0,61726
21131,7070,687,3020,2157,899,307,607,326,253,64,34,155,73,58,48,6,4,15,0,0,15,281,259,103,0,156,22,22,22,0,0,0,0,0,0,61727
21132,968,65,404,325,149,25,107,73,66,19,6,41,7,7,0,4,3,0,0,0,0,34,34,4,0,30,0,0,0,0,0,0,0,0,0,61728
21133,648,20,238,196,156,38,57,28,24,19,0,5,4,4,3,1,0,0,0,0,0,29,29,25,0,4,0,0,0,0,0,0,0,0,0,61729
21134,285,2,120,114,47,2,7,7,6,2,2,2,1,1,0,1,0,0,0,0,0,0,0,0,0,0,0,0,0,0,0,0,0,0,0,61730
21135,112,0,56,20,16,20,13,6,6,6,0,0,0,0,0,0,0,0,0,0,0,7,7,7,0,0,0,0,0,0,0,0,0,0,0,61731
21136,1434,99,420,443,307,165,128,70,57,26,0,31,13,8,3,5,0,5,0,0,5,58,58,35,11,12,0,0,0,0,0,0,0,0,0,61732
21137,712,22,259,261,136,34,30,23,23,0,3,20,0,0,0,0,0,0,0,0,0,7,7,2,2,3,0,0,0,0,0,0,0,0,0,61733
21138,1889,104,680,688,321,96,203,101,92,30,3,59,9,9,9,0,0,0,0,0,0,102,99,14,0,85,3,0,0,0,0,3,0,3,0,61734
21139,438,16,263,82,57,20,9,5,5,0,0,5,0,0,0,0,0,0,0,0,0,4,0,0,0,0,4,4,0,0,4,0,0,0,0,61735
21140,1112,43,401,311,257,100,80,47,30,10,0,20,17,17,17,0,0,0,0,0,0,33,29,11,7,11,4,4,4,0,0,0,0,0,0,61736
21141,387,20,176,111,71,9,46,26,26,21,0,5,0,0,0,0,0,0,0,0,0,20,20,20,0,0,0,0,0,0,0,0,0,0,0,61737
21142,2814,163,1137,894,488,132,265,126,126,39,5,82,0,0,0,0,0,0,0,0,0,139,111,60,5,46,28,28,28,0,0,0,0,0,0,61738
21143,3303,314,1454,873,450,212,310,159,76,37,0,39,83,83,67,16,0,0,0,0,0,151,151,87,4,60,0,0,0,0,0,0,0,0,0,61739
21144,1181,75,472,411,154,69,70,18,18,3,0,15,0,0,0,0,0,0,0,0,0,52,48,4,0,44,4,4,4,0,0,0,0,0,0,61740
21145,1015,122,518,264,76,35,74,16,14,6,0,8,2,2,0,0,2,0,0,0,0,58,29,15,0,14,29,29,5,4,20,0,0,0,0,61741
21146,893,38,257,413,130,55,78,54,54,13,0,41,0,0,0,0,0,0,0,0,0,24,24,7,0,17,0,0,0,0,0,0,0,0,0,61742
21147,152,3,54,57,35,3,15,0,0,0,0,0,0,0,0,0,0,0,0,0,0,15,10,6,2,2,5,5,5,0,0,0,0,0,0,61743
21148,1242,66,494,414,241,27,82,58,58,36,0,22,0,0,0,0,0,0,0,0,0,24,20,10,3,7,4,4,4,0,0,0,0,0,0,61744
21149,2939,210,888,910,706,225,157,84,72,0,19,53,12,12,4,8,0,0,0,0,0,73,73,29,0,44,0,0,0,0,0,0,0,0,0,61745
21150,1108,83,497,384,123,21,81,47,47,15,3,29,0,0,0,0,0,0,0,0,0,34,19,3,0,16,15,15,15,0,0,0,0,0,0,61747
21151,1915,54,543,523,578,217,111,44,44,24,3,17,0,0,0,0,0,0,0,0,0,67,67,33,10,24,0,0,0,0,0,0,0,0,0,61748
21152,510,29,262,188,23,8,19,12,7,1,0,6,5,5,5,0,0,0,0,0,0,7,7,7,0,0,0,0,0,0,0,0,0,0,0,61749
21153,42,0,7,27,8,0,0,0,0,0,0,0,0,0,0,0,0,0,0,0,0,0,0,0,0,0,0,0,0,0,0,0,0,0,0,61750
21154,90,15,44,31,0,0,3,3,3,0,0,3,0,0,0,0,0,0,0,0,0,0,0,0,0,0,0,0,0,0,0,0,0,0,0,61751
21155,2920,157,1092,822,696,153,297,127,121,49,13,59,6,0,0,0,0,6,0,6,0,170,160,110,9,41,10,10,10,0,0,0,0,0,0,61752
21156,2140,120,733,698,453,136,120,41,41,5,0,36,0,0,0,0,0,0,0,0,0,79,79,19,30,30,0,0,0,0,0,0,0,0,0,61753
21157,898,65,403,284,111,35,71,12,10,8,2,0,2,2,2,0,0,0,0,0,0,59,59,48,4,7,0,0,0,0,0,0,0,0,0,61754
21158,3030,137,961,1111,650,171,364,207,169,64,12,93,38,38,38,0,0,0,0,0,0,157,144,75,4,65,13,13,0,4,9,0,0,0,0,61755
21159,1638,221,705,421,244,47,82,37,37,20,14,3,0,0,0,0,0,0,0,0,0,45,32,17,3,12,13,13,13,0,0,0,0,0,0,61756
21160,1102,101,363,326,250,62,111,54,51,4,4,43,3,3,0,0,3,0,0,0,0,57,57,14,3,40,0,0,0,0,0,0,0,0,0,61759
21161,1711,192,753,556,161,49,107,57,57,5,3,49,0,0,0,0,0,0,0,0,0,50,50,31,0,19,0,0,0,0,0,0,0,0,0,61760
21162,25536,1273,5530,6109,8564,4060,6029,2549,2459,565,351,1543,90,90,68,0,22,0,0,0,0,3480,3361,1054,137,2170,119,84,84,0,0,35,35,0,0,61761
21163,10341,1574,4167,3202,932,466,745,386,289,135,15,139,97,72,64,0,8,25,0,0,25,359,312,155,22,135,47,27,12,15,0,20,0,19,1,61764
21164,375,33,201,110,17,14,44,33,30,8,1,21,3,1,0,0,1,2,2,0,0,11,9,3,0,6,2,2,2,0,0,0,0,0,0,61769
21165,811,43,436,244,67,21,47,41,38,15,0,23,3,3,0,3,0,0,0,0,0,6,6,0,0,6,0,0,0,0,0,0,0,0,0,61770
21166,656,37,266,227,99,27,54,11,11,0,0,11,0,0,0,0,0,0,0,0,0,43,31,0,0,31,12,12,12,0,0,0,0,0,0,61771
21167,272,20,145,71,10,26,10,10,10,10,0,0,0,0,0,0,0,0,0,0,0,0,0,0,0,0,0,0,0,0,0,0,0,0,0,61772
21168,351,45,167,75,41,23,13,9,9,0,0,9,0,0,0,0,0,0,0,0,0,4,4,2,0,2,0,0,0,0,0,0,0,0,0,61773
21169,581,69,263,147,77,25,63,33,31,8,0,23,2,0,0,0,0,2,2,0,0,30,30,13,2,15,0,0,0,0,0,0,0,0,0,61774
21170,234,25,90,92,27,0,18,1,1,1,0,0,0,0,0,0,0,0,0,0,0,17,17,2,2,13,0,0,0,0,0,0,0,0,0,61775
21171,1214,52,446,257,336,123,47,32,27,27,0,0,5,5,5,0,0,0,0,0,0,15,13,0,13,0,2,0,0,0,0,2,0,0,2,61776
21172,586,15,286,203,73,9,25,5,4,4,0,0,1,0,0,0,0,1,1,0,0,20,6,6,0,0,14,14,14,0,0,0,0,0,0,61777
21173,555,31,345,111,60,8,23,18,16,7,6,3,2,2,2,0,0,0,0,0,0,5,4,4,0,0,1,1,1,0,0,0,0,0,0,61778
21174,12392,798,1665,2258,3157,4514,5224,2468,2461,418,280,1763,7,0,0,0,0,7,0,0,7,2756,2654,791,206,1657,102,0,0,0,0,102,102,0,0,61801
21175,12942,1358,3821,3341,2086,2336,789,426,325,132,10,183,101,61,14,43,4,40,10,15,15,363,359,130,66,163,4,4,4,0,0,0,0,0,0,61802
21176,156,9,71,67,7,2,11,6,3,0,0,3,3,3,0,3,0,0,0,0,0,5,5,4,0,1,0,0,0,0,0,0,0,0,0,61810
21177,422,45,199,146,23,9,73,66,63,1,5,57,3,3,0,0,3,0,0,0,0,7,7,1,0,6,0,0,0,0,0,0,0,0,0,61811
21178,292,30,133,94,25,10,16,11,11,3,0,8,0,0,0,0,0,0,0,0,0,5,0,0,0,0,5,5,5,0,0,0,0,0,0,61812
21179,1392,168,569,460,149,46,90,60,48,4,0,44,12,12,12,0,0,0,0,0,0,30,25,7,2,16,5,2,2,0,0,3,0,3,0,61813
21180,867,104,307,343,77,36,85,41,28,12,2,14,13,13,13,0,0,0,0,0,0,44,44,5,0,39,0,0,0,0,0,0,0,0,0,61814
21181,161,11,64,77,8,1,16,3,3,0,0,3,0,0,0,0,0,0,0,0,0,13,11,10,0,1,2,0,0,0,0,2,2,0,0,61815
21182,330,16,154,69,79,12,30,15,15,2,1,12,0,0,0,0,0,0,0,0,0,15,12,3,0,9,3,3,2,1,0,0,0,0,0,61816
21183,1767,124,547,714,266,116,196,107,101,21,22,58,6,0,0,0,0,6,0,6,0,89,71,23,0,48,18,18,18,0,0,0,0,0,0,61817
21184,973,80,416,337,106,34,98,51,45,0,4,41,6,6,4,0,2,0,0,0,0,47,47,11,3,33,0,0,0,0,0,0,0,0,0,61818
21185,13098,988,2209,3192,3095,3614,7095,3972,3852,679,194,2979,120,63,3,56,4,57,0,57,0,3123,3067,655,191,2221,56,56,46,0,10,0,0,0,0,61820
21186,20709,1017,4403,6229,4847,4213,1510,808,716,189,86,441,92,38,14,14,10,54,21,14,19,702,617,180,23,414,85,47,47,0,0,38,28,0,10,61821
21187,15395,521,2397,4014,4138,4325,1088,503,485,165,16,304,18,18,18,0,0,0,0,0,0,585,559,186,82,291,26,26,7,19,0,0,0,0,0,61822
21188,408,22,156,162,52,16,23,9,0,0,0,0,9,4,4,0,0,5,5,0,0,14,13,0,0,13,1,1,1,0,0,0,0,0,0,61830
21189,92,0,42,40,6,4,2,2,0,0,0,0,2,2,2,0,0,0,0,0,0,0,0,0,0,0,0,0,0,0,0,0,0,0,0,61831
21190,24289,4095,9395,7113,2316,1370,2003,1013,807,124,31,652,206,115,56,36,23,91,31,0,60,990,776,139,34,603,214,162,96,47,19,52,14,0,38,61832
21191,1575,213,798,456,89,19,73,24,24,11,0,13,0,0,0,0,0,0,0,0,0,49,49,37,0,12,0,0,0,0,0,0,0,0,0,61833
21192,5686,832,2058,1986,562,248,308,151,124,39,10,75,27,19,4,0,15,8,0,0,8,157,137,51,10,76,20,12,12,0,0,8,0,0,8,61834
21193,442,36,226,158,15,7,48,23,12,12,0,0,11,0,0,0,0,11,0,11,0,25,24,4,9,11,1,1,0,0,1,0,0,0,0,61839
21194,559,0,187,239,82,51,48,41,41,0,0,41,0,0,0,0,0,0,0,0,0,7,7,7,0,0,0,0,0,0,0,0,0,0,0,61840
21195,925,77,364,333,121,30,78,45,21,0,7,14,24,24,24,0,0,0,0,0,0,33,15,9,0,6,18,0,0,0,0,18,0,0,18,61841
21196,2005,81,695,849,272,108,154,89,83,23,8,52,6,6,6,0,0,0,0,0,0,65,65,17,0,48,0,0,0,0,0,0,0,0,0,61842
21197,1530,85,561,644,181,59,76,36,34,4,2,28,2,2,0,0,2,0,0,0,0,40,32,22,0,10,8,8,6,2,0,0,0,0,0,61843
21198,619,29,238,295,50,7,81,31,25,5,6,14,6,0,0,0,0,6,6,0,0,50,48,7,7,34,2,2,2,0,0,0,0,0,0,61844
21199,244,17,98,129,0,0,17,8,8,0,0,8,0,0,0,0,0,0,0,0,0,9,9,0,0,9,0,0,0,0,0,0,0,0,0,61845
21200,3503,516,1343,1313,230,101,201,102,95,21,0,74,7,7,7,0,0,0,0,0,0,99,87,26,0,61,12,12,12,0,0,0,0,0,0,61846
21201,878,70,359,271,113,65,84,22,22,7,0,15,0,0,0,0,0,0,0,0,0,62,62,48,3,11,0,0,0,0,0,0,0,0,0,61847
21202,145,16,75,52,2,0,12,12,12,2,0,10,0,0,0,0,0,0,0,0,0,0,0,0,0,0,0,0,0,0,0,0,0,0,0,61848
21203,1200,42,499,435,121,103,70,22,15,5,3,7,7,4,4,0,0,3,0,0,3,48,48,9,0,39,0,0,0,0,0,0,0,0,0,61849
21204,392,22,196,102,63,9,38,26,10,3,0,7,16,16,15,0,1,0,0,0,0,12,12,0,0,12,0,0,0,0,0,0,0,0,0,61850
21205,231,4,76,108,37,6,18,13,12,2,2,8,1,0,0,0,0,1,0,1,0,5,4,4,0,0,1,1,1,0,0,0,0,0,0,61851
21206,226,35,105,70,4,12,5,5,5,1,0,4,0,0,0,0,0,0,0,0,0,0,0,0,0,0,0,0,0,0,0,0,0,0,0,61852
21207,8616,281,1924,2599,2196,1616,676,398,345,130,52,163,53,44,15,13,16,9,0,9,0,278,256,56,19,181,22,0,0,0,0,22,0,0,22,61853
21208,1141,103,471,299,192,76,59,24,24,3,8,13,0,0,0,0,0,0,0,0,0,35,33,17,0,16,2,0,0,0,0,2,0,0,2,61854
21209,139,24,19,83,0,13,47,35,35,0,20,15,0,0,0,0,0,0,0,0,0,12,0,0,0,0,12,12,12,0,0,0,0,0,0,61855
21210,5067,273,1354,1469,1254,717,452,232,224,36,11,177,8,0,0,0,0,8,0,0,8,220,168,31,19,118,52,52,52,0,0,0,0,0,0,61856
21211,75,10,30,27,4,4,11,8,8,0,6,2,0,0,0,0,0,0,0,0,0,3,3,2,0,1,0,0,0,0,0,0,0,0,0,61857
21212,2008,148,792,723,247,98,157,74,41,2,7,32,33,33,4,29,0,0,0,0,0,83,51,23,3,25,32,5,5,0,0,27,0,0,27,61858
21213,826,17,246,363,134,66,50,26,20,4,0,16,6,6,6,0,0,0,0,0,0,24,24,14,0,10,0,0,0,0,0,0,0,0,0,61859
21214,341,28,139,142,29,3,15,10,10,2,0,8,0,0,0,0,0,0,0,0,0,5,5,3,0,2,0,0,0,0,0,0,0,0,0,61862
21215,540,24,217,201,67,31,11,9,3,0,3,0,6,6,1,0,5,0,0,0,0,2,2,0,0,2,0,0,0,0,0,0,0,0,0,61863
21216,1222,15,344,480,202,181,81,68,68,12,8,48,0,0,0,0,0,0,0,0,0,13,13,13,0,0,0,0,0,0,0,0,0,0,0,61864
21217,975,100,449,316,79,31,80,63,56,13,3,40,7,7,2,5,0,0,0,0,0,17,17,0,0,17,0,0,0,0,0,0,0,0,0,61865
21218,8885,1250,3197,3078,942,418,1056,553,528,129,56,343,25,14,5,9,0,11,3,0,8,503,428,148,37,243,75,72,24,39,9,3,3,0,0,61866
21219,1006,131,406,287,87,95,87,48,30,20,0,10,18,14,0,14,0,4,0,0,4,39,32,0,9,23,7,3,0,3,0,4,0,0,4,61870
21220,182,16,57,71,27,11,3,1,1,0,0,1,0,0,0,0,0,0,0,0,0,2,2,0,0,2,0,0,0,0,0,0,0,0,0,61871
21221,690,62,349,209,48,22,39,33,28,7,0,21,5,0,0,0,0,5,0,0,5,6,6,2,0,4,0,0,0,0,0,0,0,0,0,61872
21222,4022,169,1015,1411,870,557,272,79,79,57,7,15,0,0,0,0,0,0,0,0,0,193,184,119,23,42,9,9,0,0,9,0,0,0,0,61873
21223,4418,141,640,932,1415,1290,211,118,118,36,0,82,0,0,0,0,0,0,0,0,0,93,93,27,10,56,0,0,0,0,0,0,0,0,0,61874
21224,399,28,38,132,100,101,87,36,36,0,10,26,0,0,0,0,0,0,0,0,0,51,25,25,0,0,26,26,26,0,0,0,0,0,0,61875
21225,615,81,307,177,42,8,63,9,7,3,0,4,2,2,0,0,2,0,0,0,0,54,54,6,5,43,0,0,0,0,0,0,0,0,0,61876
21226,1205,46,413,510,181,55,140,87,74,9,4,61,13,10,0,0,10,3,0,0,3,53,45,45,0,0,8,8,6,0,2,0,0,0,0,61877
21227,986,74,376,327,149,60,32,26,23,3,0,20,3,3,0,0,3,0,0,0,0,6,6,2,0,4,0,0,0,0,0,0,0,0,0,61878
21228,2823,169,915,913,475,351,207,78,74,18,0,56,4,4,0,0,4,0,0,0,0,129,107,84,0,23,22,22,22,0,0,0,0,0,0,61880
21229,477,23,190,165,82,17,12,8,8,5,0,3,0,0,0,0,0,0,0,0,0,4,4,2,0,2,0,0,0,0,0,0,0,0,0,61882
21230,3023,340,1171,1162,268,82,242,174,142,39,21,82,32,10,3,0,7,22,0,0,22,68,65,15,14,36,3,0,0,0,0,3,0,0,3,61883
21231,806,36,289,258,156,67,36,32,24,14,0,10,8,8,0,0,8,0,0,0,0,4,4,0,0,4,0,0,0,0,0,0,0,0,0,61884
21232,2771,684,926,761,315,85,214,52,35,15,0,20,17,0,0,0,0,17,14,0,3,162,132,78,5,49,30,11,5,0,6,19,19,0,0,61910
21233,2865,1127,832,611,217,78,418,225,104,44,0,60,121,15,15,0,0,106,16,0,90,193,89,36,23,30,104,10,10,0,0,94,65,0,29,61911
21234,906,102,358,332,71,43,86,42,36,16,0,20,6,5,5,0,0,1,0,0,1,44,42,5,0,37,2,2,2,0,0,0,0,0,0,61912
21235,1156,106,564,315,115,56,34,3,3,0,0,3,0,0,0,0,0,0,0,0,0,31,31,29,0,2,0,0,0,0,0,0,0,0,0,61913
21236,1196,95,578,399,76,48,56,28,28,16,0,12,0,0,0,0,0,0,0,0,0,28,28,12,2,14,0,0,0,0,0,0,0,0,0,61914
21237,377,46,171,98,45,17,26,8,6,3,0,3,2,2,0,2,0,0,0,0,0,18,16,9,0,7,2,2,0,2,0,0,0,0,0,61917
21238,683,25,260,239,117,42,131,49,42,13,0,29,7,5,5,0,0,2,2,0,0,82,79,7,0,72,3,3,0,3,0,0,0,0,0,61919
21239,12732,1096,3043,4272,2382,1939,3192,1601,1570,370,145,1055,31,18,0,18,0,13,0,0,13,1591,1535,545,218,772,56,32,17,0,15,24,0,0,24,61920
21240,1774,149,722,637,185,81,138,91,61,34,2,25,30,30,26,0,4,0,0,0,0,47,34,9,9,16,13,13,13,0,0,0,0,0,0,61924
21241,592,26,216,246,65,39,38,8,0,0,0,0,8,8,3,5,0,0,0,0,0,30,30,9,0,21,0,0,0,0,0,0,0,0,0,61925
21242,814,113,241,378,70,12,57,44,44,34,2,8,0,0,0,0,0,0,0,0,0,13,13,3,0,10,0,0,0,0,0,0,0,0,0,61928
21243,505,44,202,211,48,0,29,15,15,0,0,15,0,0,0,0,0,0,0,0,0,14,14,0,11,3,0,0,0,0,0,0,0,0,0,61929
21244,334,31,117,143,26,17,16,12,10,0,0,10,2,2,0,2,0,0,0,0,0,4,4,2,0,2,0,0,0,0,0,0,0,0,0,61930
21245,743,149,315,251,18,10,75,54,8,2,0,6,46,28,0,28,0,18,18,0,0,21,4,2,0,2,17,17,17,0,0,0,0,0,0,61931
21246,346,47,137,135,18,9,25,13,13,4,2,7,0,0,0,0,0,0,0,0,0,12,10,1,0,9,2,2,0,1,1,0,0,0,0,61932
21247,812,89,318,247,106,52,57,23,18,8,2,8,5,5,5,0,0,0,0,0,0,34,23,6,2,15,11,2,2,0,0,9,0,0,9,61933
21248,98,16,39,35,8,0,8,0,0,0,0,0,0,0,0,0,0,0,0,0,0,8,8,8,0,0,0,0,0,0,0,0,0,0,0,61936
21249,1449,187,685,439,56,82,94,57,39,6,0,33,18,7,7,0,0,11,0,0,11,37,17,4,0,13,20,20,9,0,11,0,0,0,0,61937
21250,15043,1533,5642,5027,2003,838,1057,430,375,90,61,224,55,46,21,25,0,9,0,0,9,627,492,263,71,158,135,100,84,16,0,35,0,9,26,61938
21251,196,39,100,55,2,0,12,5,0,0,0,0,5,0,0,0,0,5,0,0,5,7,7,2,2,3,0,0,0,0,0,0,0,0,0,61940
21252,37,0,29,8,0,0,0,0,0,0,0,0,0,0,0,0,0,0,0,0,0,0,0,0,0,0,0,0,0,0,0,0,0,0,0,61941
21253,899,79,356,328,105,31,61,34,34,8,0,26,0,0,0,0,0,0,0,0,0,27,23,6,0,17,4,4,0,4,0,0,0,0,0,61942
21254,977,127,439,268,99,44,95,39,31,3,5,23,8,3,0,2,1,5,0,0,5,56,53,17,7,29,3,3,3,0,0,0,0,0,0,61943
21255,8898,1306,3229,2560,1285,518,583,315,224,26,30,168,91,42,42,0,0,49,32,8,9,268,194,0,0,194,74,38,0,0,38,36,0,36,0,61944
21256,144,22,65,50,7,0,13,7,2,0,0,2,5,0,0,0,0,5,0,0,5,6,6,2,0,4,0,0,0,0,0,0,0,0,0,61949
21257,5530,759,2154,1632,670,315,447,262,225,49,0,176,37,18,0,0,18,19,19,0,0,185,185,54,36,95,0,0,0,0,0,0,0,0,0,61951
21258,4224,422,1762,1290,521,229,283,204,149,53,22,74,55,55,55,0,0,0,0,0,0,79,70,51,0,19,9,9,9,0,0,0,0,0,0,61953
21259,112,33,62,13,4,0,0,0,0,0,0,0,0,0,0,0,0,0,0,0,0,0,0,0,0,0,0,0,0,0,0,0,0,0,0,61955
21260,1955,131,809,662,254,99,89,40,40,8,11,21,0,0,0,0,0,0,0,0,0,49,43,30,0,13,6,6,6,0,0,0,0,0,0,61956
21261,1449,130,597,554,134,34,69,23,23,3,3,17,0,0,0,0,0,0,0,0,0,46,44,8,3,33,2,2,2,0,0,0,0,0,0,61957
21262,1174,56,459,457,189,13,104,63,36,10,0,26,27,19,17,2,0,8,0,0,8,41,41,26,3,12,0,0,0,0,0,0,0,0,0,62001
21263,22219,2284,7086,8034,3140,1675,1318,726,529,109,124,296,197,117,30,21,66,80,8,6,66,592,524,120,53,351,68,58,29,0,29,10,0,5,5,62002
21264,452,59,192,123,65,13,16,10,9,3,0,6,1,1,1,0,0,0,0,0,0,6,2,0,0,2,4,4,0,0,4,0,0,0,0,62006
21265,1314,132,538,449,144,51,87,61,55,2,4,49,6,6,1,3,2,0,0,0,0,26,17,2,8,7,9,9,0,9,0,0,0,0,0,62009
21266,7705,642,2821,2679,1066,497,553,306,270,88,55,127,36,27,14,0,13,9,9,0,0,247,222,104,48,70,25,0,0,0,0,25,0,25,0,62010
21267,195,36,103,28,22,6,35,17,8,0,0,8,9,9,0,0,9,0,0,0,0,18,18,11,0,7,0,0,0,0,0,0,0,0,0,62011
21268,4651,430,1635,1753,476,357,325,144,126,46,6,74,18,9,0,9,0,9,0,9,0,181,155,38,42,75,26,26,0,4,22,0,0,0,0,62012
21269,392,27,213,119,24,9,13,11,11,0,0,11,0,0,0,0,0,0,0,0,0,2,0,0,0,0,2,2,0,0,2,0,0,0,0,62013
21270,2935,399,1084,994,314,144,254,142,135,66,17,52,7,7,2,5,0,0,0,0,0,112,108,25,34,49,4,4,4,0,0,0,0,0,0,62014
21271,310,48,194,43,15,10,1,1,0,0,0,0,1,0,0,0,0,1,0,0,1,0,0,0,0,0,0,0,0,0,0,0,0,0,0,62015
21272,2713,175,1054,1007,337,140,165,75,60,12,10,38,15,15,15,0,0,0,0,0,0,90,80,52,0,28,10,4,4,0,0,6,6,0,0,62016
21273,572,54,259,177,73,9,21,12,12,0,0,12,0,0,0,0,0,0,0,0,0,9,9,3,2,4,0,0,0,0,0,0,0,0,0,62017
21274,2551,505,1075,829,94,48,212,88,55,15,9,31,33,6,0,6,0,27,0,9,18,124,53,0,14,39,71,51,6,0,45,20,0,0,20,62018
21275,330,46,188,87,4,5,20,19,5,0,0,5,14,14,0,0,14,0,0,0,0,1,1,1,0,0,0,0,0,0,0,0,0,0,0,62019
21276,654,42,271,199,96,46,18,0,0,0,0,0,0,0,0,0,0,0,0,0,0,18,18,0,0,18,0,0,0,0,0,0,0,0,0,62021
21277,753,132,273,226,89,33,33,0,0,0,0,0,0,0,0,0,0,0,0,0,0,33,19,19,0,0,14,0,0,0,0,14,0,0,14,62022
21278,62,1,23,30,7,1,0,0,0,0,0,0,0,0,0,0,0,0,0,0,0,0,0,0,0,0,0,0,0,0,0,0,0,0,0,62023
21279,6834,750,3040,2366,518,160,504,291,262,97,11,154,29,17,0,0,17,12,12,0,0,213,213,118,12,83,0,0,0,0,0,0,0,0,0,62024
21280,20461,787,4621,5899,5431,3723,2961,1227,1184,365,97,722,43,22,22,0,0,21,0,10,11,1734,1676,547,123,1006,58,31,13,11,7,27,0,11,16,62025
21281,377,19,185,149,19,5,24,10,10,0,0,10,0,0,0,0,0,0,0,0,0,14,14,13,0,1,0,0,0,0,0,0,0,0,0,62027
21282,557,12,163,233,73,76,331,133,132,67,0,65,1,0,0,0,0,1,0,1,0,198,196,107,0,89,2,0,0,0,0,2,0,0,2,62028
21283,72,23,39,10,0,0,4,0,0,0,0,0,0,0,0,0,0,0,0,0,0,4,3,3,0,0,1,1,0,0,1,0,0,0,0,62030
21284,641,107,258,226,31,19,20,14,12,2,0,10,2,2,2,0,0,0,0,0,0,6,4,0,0,4,2,2,2,0,0,0,0,0,0,62031
21285,395,64,174,114,26,17,54,31,31,13,0,18,0,0,0,0,0,0,0,0,0,23,23,1,0,22,0,0,0,0,0,0,0,0,0,62032
21286,3309,351,1315,1204,281,158,251,143,96,25,10,61,47,42,17,6,19,5,0,0,5,108,64,22,1,41,44,44,22,0,22,0,0,0,0,62033
21287,8686,534,1645,2332,2590,1585,791,402,377,97,24,256,25,25,25,0,0,0,0,0,0,389,351,103,64,184,38,38,24,14,0,0,0,0,0,62034
21288,11422,926,3325,4553,1755,863,1014,431,305,128,10,167,126,71,12,48,11,55,0,0,55,583,583,164,90,329,0,0,0,0,0,0,0,0,0,62035
21289,514,69,196,155,43,51,40,22,22,14,0,8,0,0,0,0,0,0,0,0,0,18,15,6,0,9,3,3,3,0,0,0,0,0,0,62036
21290,1458,226,500,472,131,129,52,41,40,0,11,29,1,1,0,0,1,0,0,0,0,11,8,0,0,8,3,3,0,3,0,0,0,0,0,62037
21291,29789,4055,12678,9265,2636,1155,1719,1059,951,270,155,526,108,78,32,23,23,30,0,23,7,660,532,105,40,387,128,39,6,33,0,89,31,26,32,62040
21292,1568,137,627,565,157,82,124,68,65,9,5,51,3,3,3,0,0,0,0,0,0,56,48,19,3,26,8,8,0,0,8,0,0,0,0,62044
21293,351,33,182,125,11,0,31,15,15,9,0,6,0,0,0,0,0,0,0,0,0,16,16,8,0,8,0,0,0,0,0,0,0,0,0,62045
21294,516,13,131,137,177,58,11,2,2,2,0,0,0,0,0,0,0,0,0,0,0,9,9,6,1,2,0,0,0,0,0,0,0,0,0,62046
21295,1300,124,573,379,104,120,58,36,34,10,6,18,2,0,0,0,0,2,0,0,2,22,22,5,0,17,0,0,0,0,0,0,0,0,0,62047
21296,1128,129,472,442,80,5,37,16,16,4,4,8,0,0,0,0,0,0,0,0,0,21,14,4,0,10,7,7,5,2,0,0,0,0,0,62048
21297,7876,1554,2865,2747,430,280,690,399,190,50,4,136,209,88,1,1,86,121,0,0,121,291,120,60,1,59,171,162,162,0,0,9,0,9,0,62049
21298,244,44,122,71,7,0,14,0,0,0,0,0,0,0,0,0,0,0,0,0,0,14,11,5,6,0,3,3,0,3,0,0,0,0,0,62050
21299,474,39,250,89,82,14,36,17,17,1,0,16,0,0,0,0,0,0,0,0,0,19,18,3,0,15,1,1,0,0,1,0,0,0,0,62051
21300,8993,912,3102,3613,824,542,693,338,308,84,29,195,30,22,0,12,10,8,0,0,8,355,342,104,27,211,13,12,7,1,4,1,1,0,0,62052
21301,352,51,128,149,15,9,27,11,8,1,0,7,3,3,3,0,0,0,0,0,0,16,16,3,0,13,0,0,0,0,0,0,0,0,0,62053
21302,394,60,144,126,45,19,30,16,16,0,9,7,0,0,0,0,0,0,0,0,0,14,11,4,1,6,3,0,0,0,0,3,0,3,0,62054
21303,6129,777,2542,1851,612,347,352,131,129,13,5,111,2,2,1,1,0,0,0,0,0,221,216,83,0,133,5,5,5,0,0,0,0,0,0,62056
21304,509,40,271,156,38,4,29,4,0,0,0,0,4,2,0,0,2,2,0,2,0,25,16,7,0,9,9,9,9,0,0,0,0,0,0,62058
21305,487,81,169,148,89,0,17,8,8,0,0,8,0,0,0,0,0,0,0,0,0,9,9,0,0,9,0,0,0,0,0,0,0,0,0,62059
21306,3203,921,1203,811,151,117,364,204,185,43,2,140,19,14,12,0,2,5,0,5,0,160,113,13,27,73,47,11,0,11,0,36,0,0,36,62060
21307,1414,53,405,598,250,108,89,74,48,6,8,34,26,15,10,0,5,11,11,0,0,15,15,12,0,3,0,0,0,0,0,0,0,0,0,62061
21308,5641,262,1695,1396,1292,996,512,311,299,152,0,147,12,12,0,0,12,0,0,0,0,201,190,83,13,94,11,11,0,11,0,0,0,0,0,62062
21309,720,76,236,252,144,12,25,23,22,7,11,4,1,1,0,1,0,0,0,0,0,2,2,0,2,0,0,0,0,0,0,0,0,0,0,62063
21310,43,0,15,0,6,22,7,7,7,0,0,7,0,0,0,0,0,0,0,0,0,0,0,0,0,0,0,0,0,0,0,0,0,0,0,62065
21311,1509,42,533,571,221,142,52,39,26,0,0,26,13,0,0,0,0,13,0,13,0,13,13,13,0,0,0,0,0,0,0,0,0,0,0,62067
21312,2322,172,1082,764,221,83,133,53,50,19,2,29,3,3,3,0,0,0,0,0,0,80,71,28,1,42,9,9,9,0,0,0,0,0,0,62069
21313,11,11,0,0,0,0,0,0,0,0,0,0,0,0,0,0,0,0,0,0,0,0,0,0,0,0,0,0,0,0,0,0,0,0,0,62070
21314,764,107,239,307,81,30,70,31,23,4,0,19,8,8,0,8,0,0,0,0,0,39,39,12,0,27,0,0,0,0,0,0,0,0,0,62074
21315,2288,220,1085,691,173,119,106,51,51,18,0,33,0,0,0,0,0,0,0,0,0,55,54,12,6,36,1,1,0,0,1,0,0,0,0,62075
21316,64,6,35,18,5,0,1,1,1,1,0,0,0,0,0,0,0,0,0,0,0,0,0,0,0,0,0,0,0,0,0,0,0,0,0,62076
21317,164,32,61,71,0,0,7,3,1,0,1,0,2,2,0,0,2,0,0,0,0,4,4,0,0,4,0,0,0,0,0,0,0,0,0,62077
21318,89,22,35,27,5,0,8,3,1,0,0,1,2,2,0,0,2,0,0,0,0,5,5,0,0,5,0,0,0,0,0,0,0,0,0,62078
21319,243,7,84,89,54,9,6,0,0,0,0,0,0,0,0,0,0,0,0,0,0,6,6,6,0,0,0,0,0,0,0,0,0,0,0,62079
21320,1917,266,863,627,98,63,157,102,57,10,15,32,45,28,15,13,0,17,0,13,4,55,46,9,3,34,9,5,5,0,0,4,0,4,0,62080
21321,228,21,101,69,27,10,10,8,5,0,0,5,3,3,3,0,0,0,0,0,0,2,0,0,0,0,2,2,0,0,2,0,0,0,0,62081
21322,2073,326,937,610,150,50,146,102,94,7,18,69,8,5,0,5,0,3,0,0,3,44,29,3,6,20,15,3,0,3,0,12,0,0,12,62082
21323,206,38,107,43,18,0,21,10,10,0,0,10,0,0,0,0,0,0,0,0,0,11,11,11,0,0,0,0,0,0,0,0,0,0,0,62083
21324,1064,85,436,373,121,49,66,26,26,0,5,21,0,0,0,0,0,0,0,0,0,40,40,0,1,39,0,0,0,0,0,0,0,0,0,62084
21325,120,7,59,33,13,8,1,1,0,0,0,0,1,1,1,0,0,0,0,0,0,0,0,0,0,0,0,0,0,0,0,0,0,0,0,62085
21326,1056,177,529,287,33,30,144,42,24,0,0,24,18,0,0,0,0,18,18,0,0,102,63,15,2,46,39,3,0,0,3,36,0,0,36,62086
21327,1442,214,651,472,77,28,153,77,58,6,8,44,19,5,0,0,5,14,0,4,10,76,51,12,0,39,25,0,0,0,0,25,0,0,25,62087
21328,5019,508,1815,1771,590,335,356,211,161,13,12,136,50,47,27,9,11,3,3,0,0,145,131,61,27,43,14,0,0,0,0,14,13,1,0,62088
21329,277,18,158,74,20,7,16,15,14,0,0,14,1,1,0,0,1,0,0,0,0,1,1,0,0,1,0,0,0,0,0,0,0,0,0,62089
21330,651,111,282,184,55,19,68,28,17,0,0,17,11,11,0,0,11,0,0,0,0,40,37,0,0,37,3,3,0,0,3,0,0,0,0,62090
21331,218,8,115,49,32,14,9,0,0,0,0,0,0,0,0,0,0,0,0,0,0,9,9,0,0,9,0,0,0,0,0,0,0,0,0,62091
21332,2170,323,990,620,174,63,174,80,49,13,0,36,31,21,11,10,0,10,0,0,10,94,79,24,0,55,15,10,0,0,10,5,0,0,5,62092
21333,237,49,115,60,13,0,25,2,2,0,2,0,0,0,0,0,0,0,0,0,0,23,14,0,0,14,9,6,6,0,0,3,0,2,1,62093
21334,653,121,272,207,42,11,54,16,13,0,0,13,3,0,0,0,0,3,0,0,3,38,11,0,0,11,27,26,26,0,0,1,0,0,1,62094
21335,7834,922,2594,3152,904,262,419,185,157,42,48,67,28,6,6,0,0,22,0,0,22,234,227,58,92,77,7,2,2,0,0,5,5,0,0,62095
21336,1793,198,540,626,229,200,115,36,36,11,0,25,0,0,0,0,0,0,0,0,0,79,77,48,0,29,2,2,0,2,0,0,0,0,0,62097
21337,105,0,69,27,9,0,0,0,0,0,0,0,0,0,0,0,0,0,0,0,0,0,0,0,0,0,0,0,0,0,0,0,0,0,0,62098
21338,3299,917,1122,953,206,101,280,126,69,14,4,51,57,20,5,15,0,37,8,0,29,154,100,27,0,73,54,49,42,0,7,5,0,0,5,62201
21339,5261,1070,1930,1875,241,145,661,402,255,12,30,213,147,137,68,11,58,10,0,0,10,259,219,35,0,184,40,14,0,8,6,26,22,0,4,62203
21340,5363,1576,1749,1781,182,75,619,331,294,44,0,250,37,30,0,17,13,7,0,0,7,288,230,22,14,194,58,47,0,9,38,11,0,7,4,62204
21341,5968,1296,1941,2280,272,179,619,280,262,0,42,220,18,0,0,0,0,18,0,0,18,339,253,0,55,198,86,82,0,21,61,4,0,0,4,62205
21342,9709,1537,4470,3007,562,133,1184,641,388,99,30,259,253,155,0,0,155,98,0,0,98,543,479,146,56,277,64,22,12,10,0,42,14,0,28,62206
21343,5004,1192,1688,1665,246,213,513,307,256,10,22,224,51,8,8,0,0,43,39,4,0,206,202,21,29,152,4,0,0,0,0,4,0,0,4,62207
21344,12362,794,2794,4810,2413,1551,703,361,316,52,54,210,45,24,14,10,0,21,21,0,0,342,314,135,0,179,28,16,0,16,0,12,0,0,12,62208
21345,801,83,258,322,109,29,36,24,24,21,0,3,0,0,0,0,0,0,0,0,0,12,11,2,0,9,1,1,0,1,0,0,0,0,0,62214
21346,1122,113,295,449,203,62,84,40,26,12,2,12,14,12,12,0,0,2,0,0,2,44,38,16,13,9,6,6,6,0,0,0,0,0,0,62215
21347,1812,134,550,630,355,143,136,79,79,35,4,40,0,0,0,0,0,0,0,0,0,57,57,19,13,25,0,0,0,0,0,0,0,0,0,62216
21348,480,80,261,93,35,11,23,8,8,2,3,3,0,0,0,0,0,0,0,0,0,15,3,1,1,1,12,12,5,0,7,0,0,0,0,62217
21349,1034,61,389,376,110,98,106,45,43,26,3,14,2,2,2,0,0,0,0,0,0,61,61,34,0,27,0,0,0,0,0,0,0,0,0,62218
21350,675,79,314,223,45,14,33,15,13,0,2,11,2,2,2,0,0,0,0,0,0,18,18,8,10,0,0,0,0,0,0,0,0,0,0,62219
21351,13508,1138,3945,4949,2084,1392,1190,437,334,134,34,166,103,89,19,16,54,14,0,0,14,753,555,221,85,249,198,63,41,0,22,135,0,0,135,62220
21352,18780,1439,3976,6936,4299,2130,1579,749,742,152,58,532,7,7,0,7,0,0,0,0,0,830,822,126,71,625,8,0,0,0,0,8,0,0,8,62221
21353,12298,756,3306,4477,2280,1479,856,404,327,48,60,219,77,33,27,0,6,44,23,0,21,452,407,101,30,276,45,25,25,0,0,20,20,0,0,62223
21354,2367,33,440,1116,388,390,328,154,92,55,0,37,62,62,62,0,0,0,0,0,0,174,129,44,44,41,45,45,45,0,0,0,0,0,0,62225
21355,20684,1580,5308,8412,3486,1898,1332,775,724,233,34,457,51,35,35,0,0,16,16,0,0,557,505,150,66,289,52,23,23,0,0,29,0,0,29,62226
21356,4191,407,1241,1795,532,216,289,112,112,48,0,64,0,0,0,0,0,0,0,0,0,177,177,106,3,68,0,0,0,0,0,0,0,0,0,62230
21357,5110,589,1853,1624,819,225,359,191,178,45,47,86,13,3,3,0,0,10,0,1,9,168,140,60,30,50,28,24,16,0,8,4,0,0,4,62231
21358,4881,772,1949,1556,386,218,370,229,193,31,68,94,36,11,0,11,0,25,10,0,15,141,129,23,22,84,12,0,0,0,0,12,0,12,0,62232
21359,7282,2202,2978,1530,400,172,336,146,90,49,7,34,56,38,0,12,26,18,0,0,18,190,125,28,23,74,65,9,4,0,5,56,28,0,28,62233
21360,22449,1871,7368,7790,3618,1802,1554,701,555,236,64,255,146,92,31,56,5,54,19,0,35,853,656,221,54,381,197,163,63,21,79,34,0,12,22,62234
21361,8533,759,2575,2570,1837,792,592,327,327,103,56,168,0,0,0,0,0,0,0,0,0,265,264,104,18,142,1,0,0,0,0,1,1,0,0,62236
21362,2013,182,723,734,278,96,109,64,55,32,2,21,9,6,6,0,0,3,3,0,0,45,45,14,0,31,0,0,0,0,0,0,0,0,0,62237
21363,536,104,182,194,51,5,59,27,27,6,0,21,0,0,0,0,0,0,0,0,0,32,19,7,0,12,13,13,13,0,0,0,0,0,0,62238
21364,3247,298,1220,1344,250,135,270,179,112,0,0,112,67,9,0,9,0,58,0,0,58,91,50,0,0,50,41,33,33,0,0,8,0,8,0,62239
21365,1466,234,611,396,183,42,171,73,9,1,0,8,64,53,0,0,53,11,0,11,0,98,98,43,26,29,0,0,0,0,0,0,0,0,0,62240
21366,869,111,376,347,22,13,83,47,33,14,4,15,14,14,14,0,0,0,0,0,0,36,36,15,0,21,0,0,0,0,0,0,0,0,0,62241
21367,977,144,452,216,101,64,71,33,28,15,10,3,5,5,5,0,0,0,0,0,0,38,35,7,0,28,3,0,0,0,0,3,3,0,0,62242
21368,4342,318,1327,1547,760,390,356,178,172,93,12,67,6,6,6,0,0,0,0,0,0,178,163,12,15,136,15,15,15,0,0,0,0,0,0,62243
21369,987,23,534,269,104,57,27,14,12,3,0,9,2,2,2,0,0,0,0,0,0,13,13,1,1,11,0,0,0,0,0,0,0,0,0,62244
21370,1128,110,361,433,148,76,98,48,43,16,5,22,5,5,5,0,0,0,0,0,0,50,50,16,3,31,0,0,0,0,0,0,0,0,0,62245
21371,6342,662,2005,1974,851,850,648,252,252,27,35,190,0,0,0,0,0,0,0,0,0,396,384,142,18,224,12,12,0,12,0,0,0,0,0,62246
21372,157,28,59,49,19,2,1,1,1,1,0,0,0,0,0,0,0,0,0,0,0,0,0,0,0,0,0,0,0,0,0,0,0,0,0,62248
21373,10495,697,3757,3266,1702,1073,621,296,261,123,37,101,35,35,20,15,0,0,0,0,0,325,300,125,40,135,25,25,0,0,25,0,0,0,0,62249
21374,357,30,121,160,42,4,36,24,24,5,0,19,0,0,0,0,0,0,0,0,0,12,12,2,5,5,0,0,0,0,0,0,0,0,0,62250
21375,667,164,291,139,52,21,13,6,5,0,0,5,1,1,1,0,0,0,0,0,0,7,4,0,0,4,3,3,3,0,0,0,0,0,0,62253
21376,3909,234,1014,1288,843,530,366,186,166,18,2,146,20,0,0,0,0,20,0,0,20,180,180,15,35,130,0,0,0,0,0,0,0,0,0,62254
21377,574,93,193,219,55,14,93,69,61,40,0,21,8,1,1,0,0,7,0,0,7,24,22,0,0,22,2,2,2,0,0,0,0,0,0,62255
21378,2223,251,918,735,276,43,102,40,29,19,0,10,11,11,5,0,6,0,0,0,0,62,58,21,0,37,4,4,4,0,0,0,0,0,0,62257
21379,6106,452,1816,2210,999,629,578,306,262,64,35,163,44,44,33,11,0,0,0,0,0,272,212,73,17,122,60,60,28,0,32,0,0,0,0,62258
21380,4862,396,1244,1792,991,439,338,159,159,65,0,94,0,0,0,0,0,0,0,0,0,179,167,40,73,54,12,12,12,0,0,0,0,0,0,62260
21381,117,10,56,36,15,0,0,0,0,0,0,0,0,0,0,0,0,0,0,0,0,0,0,0,0,0,0,0,0,0,0,0,0,0,0,62261
21382,1149,156,560,302,61,70,99,70,45,11,10,24,25,22,0,0,22,3,0,3,0,29,29,0,0,29,0,0,0,0,0,0,0,0,0,62262
21383,3681,324,1224,1268,511,354,327,192,170,57,13,100,22,15,15,0,0,7,0,0,7,135,107,50,0,57,28,0,0,0,0,28,0,0,28,62263
21384,2267,243,713,853,372,86,195,100,87,22,0,65,13,13,13,0,0,0,0,0,0,95,78,14,14,50,17,17,17,0,0,0,0,0,0,62264
21385,3197,292,819,1171,627,288,203,134,118,59,0,59,16,16,16,0,0,0,0,0,0,69,55,34,0,21,14,14,14,0,0,0,0,0,0,62265
21386,235,0,106,100,29,0,29,0,0,0,0,0,0,0,0,0,0,0,0,0,0,29,29,29,0,0,0,0,0,0,0,0,0,0,0,62266
21387,556,34,187,221,78,36,82,53,52,5,0,47,1,0,0,0,0,1,1,0,0,29,29,24,0,5,0,0,0,0,0,0,0,0,0,62268
21388,20323,973,3710,6635,5147,3858,1945,1102,1022,413,132,477,80,4,0,4,0,76,0,0,76,843,753,197,64,492,90,51,12,39,0,39,18,10,11,62269
21389,1400,102,404,539,237,118,93,49,44,8,0,36,5,5,0,5,0,0,0,0,0,44,38,28,0,10,6,6,6,0,0,0,0,0,0,62271
21390,1064,177,457,332,70,28,41,35,11,0,0,11,24,15,15,0,0,9,0,9,0,6,4,4,0,0,2,2,0,2,0,0,0,0,0,62272
21391,200,89,70,27,12,2,2,0,0,0,0,0,0,0,0,0,0,0,0,0,0,2,2,2,0,0,0,0,0,0,0,0,0,0,0,62273
21392,5673,1073,1917,1789,534,360,420,215,84,12,0,72,131,43,35,0,8,88,33,0,55,205,198,77,41,80,7,7,0,0,7,0,0,0,0,62274
21393,2568,448,931,835,203,151,156,66,64,21,0,43,2,2,2,0,0,0,0,0,0,90,80,27,0,53,10,10,0,0,10,0,0,0,0,62275
21394,838,85,382,339,29,3,33,21,14,2,0,12,7,3,0,0,3,4,3,1,0,12,12,0,3,9,0,0,0,0,0,0,0,0,0,62277
21395,4963,498,1819,1787,611,248,408,181,174,64,0,110,7,1,1,0,0,6,0,0,6,227,169,46,0,123,58,0,0,0,0,58,3,0,55,62278
21396,44,0,28,8,8,0,0,0,0,0,0,0,0,0,0,0,0,0,0,0,0,0,0,0,0,0,0,0,0,0,0,0,0,0,0,62279
21397,395,40,190,103,50,12,4,0,0,0,0,0,0,0,0,0,0,0,0,0,0,4,4,4,0,0,0,0,0,0,0,0,0,0,0,62280
21398,1519,67,461,486,335,170,95,23,23,0,17,6,0,0,0,0,0,0,0,0,0,72,72,4,14,54,0,0,0,0,0,0,0,0,0,62281
21399,361,25,149,151,22,14,11,4,2,0,0,2,2,0,0,0,0,2,0,0,2,7,6,4,0,2,1,1,1,0,0,0,0,0,0,62282
21400,417,53,144,141,43,36,28,9,9,0,0,9,0,0,0,0,0,0,0,0,0,19,18,1,0,17,1,1,1,0,0,0,0,0,0,62284
21401,2933,246,918,1042,458,269,168,62,62,38,0,24,0,0,0,0,0,0,0,0,0,106,106,56,20,30,0,0,0,0,0,0,0,0,0,62285
21402,4406,461,1777,1407,575,186,351,269,253,21,16,216,16,16,3,13,0,0,0,0,0,82,74,27,0,47,8,4,0,4,0,4,0,4,0,62286
21403,2020,192,780,753,228,67,140,31,22,5,0,17,9,9,9,0,0,0,0,0,0,109,99,7,6,86,10,10,10,0,0,0,0,0,0,62288
21404,239,57,82,75,13,12,9,7,6,6,0,0,1,0,0,0,0,1,0,0,1,2,2,0,2,0,0,0,0,0,0,0,0,0,0,62289
21405,506,159,201,132,4,10,52,38,31,3,0,28,7,5,0,5,0,2,2,0,0,14,14,0,0,14,0,0,0,0,0,0,0,0,0,62292
21406,3518,240,987,1209,692,390,209,133,124,26,24,74,9,3,3,0,0,6,0,6,0,76,37,24,0,13,39,33,26,7,0,6,0,6,0,62293
21407,10306,643,3038,3871,1841,913,771,518,454,178,25,251,64,58,35,7,16,6,0,0,6,253,176,77,9,90,77,77,59,0,18,0,0,0,0,62294
21408,1082,60,446,369,152,55,84,56,56,25,22,9,0,0,0,0,0,0,0,0,0,28,28,9,0,19,0,0,0,0,0,0,0,0,0,62295
21409,203,38,135,30,0,0,0,0,0,0,0,0,0,0,0,0,0,0,0,0,0,0,0,0,0,0,0,0,0,0,0,0,0,0,0,62297
21410,11648,773,4226,3868,1863,918,901,453,365,162,41,162,88,12,12,0,0,76,38,0,38,448,382,190,27,165,66,38,38,0,0,28,0,28,0,62298
21411,22058,2324,8422,7079,2807,1426,1813,940,640,192,106,342,300,274,106,87,81,26,15,5,6,873,788,375,130,283,85,58,58,0,0,27,19,0,8,62301
21412,13094,1090,3765,4205,2820,1214,923,431,351,177,15,159,80,47,39,0,8,33,30,0,3,492,420,192,20,208,72,72,40,32,0,0,0,0,0,62305
21413,696,65,304,231,61,35,59,23,17,6,6,5,6,0,0,0,0,6,0,0,6,36,26,18,0,8,10,10,4,0,6,0,0,0,0,62311
21414,1586,290,697,477,95,27,105,71,58,5,17,36,13,13,7,0,6,0,0,0,0,34,19,2,0,17,15,15,15,0,0,0,0,0,0,62312
21415,195,46,30,104,15,0,5,0,0,0,0,0,0,0,0,0,0,0,0,0,0,5,5,0,0,5,0,0,0,0,0,0,0,0,0,62313
21416,346,64,95,74,70,43,31,27,24,0,0,24,3,3,0,0,3,0,0,0,0,4,0,0,0,0,4,0,0,0,0,4,0,0,4,62314
21417,419,18,165,157,38,41,10,8,7,0,0,7,1,1,1,0,0,0,0,0,0,2,2,0,0,2,0,0,0,0,0,0,0,0,0,62316
21418,205,45,99,27,31,3,4,3,3,0,0,3,0,0,0,0,0,0,0,0,0,1,1,0,0,1,0,0,0,0,0,0,0,0,0,62319
21419,1530,170,639,529,119,73,83,28,26,13,0,13,2,0,0,0,0,2,2,0,0,55,55,16,7,32,0,0,0,0,0,0,0,0,0,62320
21420,2978,334,1001,993,478,172,172,125,109,27,9,73,16,10,4,6,0,6,0,0,6,47,36,14,0,22,11,11,10,0,1,0,0,0,0,62321
21421,145,12,71,47,4,11,0,0,0,0,0,0,0,0,0,0,0,0,0,0,0,0,0,0,0,0,0,0,0,0,0,0,0,0,0,62323
21422,840,220,320,233,30,37,58,45,8,0,4,4,37,0,0,0,0,37,37,0,0,13,11,11,0,0,2,2,2,0,0,0,0,0,0,62324
21423,238,25,130,42,22,19,31,31,31,11,9,11,0,0,0,0,0,0,0,0,0,0,0,0,0,0,0,0,0,0,0,0,0,0,0,62325
21424,1594,174,657,406,193,164,104,40,29,0,0,29,11,8,8,0,0,3,0,0,3,64,52,10,12,30,12,12,0,12,0,0,0,0,0,62326
21425,1251,106,561,400,135,49,87,18,16,11,0,5,2,2,2,0,0,0,0,0,0,69,69,21,29,19,0,0,0,0,0,0,0,0,0,62330
21426,94,12,39,37,4,2,13,6,3,0,3,0,3,0,0,0,0,3,3,0,0,7,3,2,0,1,4,0,0,0,0,4,0,0,4,62334
21427,50,10,13,23,4,0,14,5,5,5,0,0,0,0,0,0,0,0,0,0,0,9,9,0,7,2,0,0,0,0,0,0,0,0,0,62336
21428,1062,61,471,299,192,39,28,12,12,12,0,0,0,0,0,0,0,0,0,0,0,16,16,8,0,8,0,0,0,0,0,0,0,0,0,62338
21429,672,56,283,236,73,24,55,31,31,16,12,3,0,0,0,0,0,0,0,0,0,24,17,5,0,12,7,7,0,7,0,0,0,0,0,62339
21430,1079,150,477,317,96,39,93,46,40,3,0,37,6,6,0,0,6,0,0,0,0,47,39,20,0,19,8,8,8,0,0,0,0,0,0,62340
21431,2521,195,1022,760,436,108,157,86,81,47,0,34,5,5,5,0,0,0,0,0,0,71,70,70,0,0,1,1,0,0,1,0,0,0,0,62341
21432,390,39,218,89,25,19,23,5,5,0,0,5,0,0,0,0,0,0,0,0,0,18,12,6,0,6,6,6,2,2,2,0,0,0,0,62343
21433,82,0,38,25,19,0,19,8,8,8,0,0,0,0,0,0,0,0,0,0,0,11,11,0,0,11,0,0,0,0,0,0,0,0,0,62344
21434,296,21,153,104,8,10,10,7,7,0,0,7,0,0,0,0,0,0,0,0,0,3,3,3,0,0,0,0,0,0,0,0,0,0,0,62345
21435,148,9,77,51,7,4,16,10,10,8,2,0,0,0,0,0,0,0,0,0,0,6,2,2,0,0,4,0,0,0,0,4,4,0,0,62346
21436,1715,221,611,646,206,31,144,120,120,46,0,74,0,0,0,0,0,0,0,0,0,24,24,17,0,7,0,0,0,0,0,0,0,0,0,62347
21437,110,2,48,49,9,2,6,3,0,0,0,0,3,3,0,3,0,0,0,0,0,3,3,3,0,0,0,0,0,0,0,0,0,0,0,62348
21438,377,47,165,140,23,2,18,3,1,1,0,0,2,2,2,0,0,0,0,0,0,15,15,3,10,2,0,0,0,0,0,0,0,0,0,62349
21439,1254,172,450,383,202,47,83,40,19,8,0,11,21,3,3,0,0,18,0,18,0,43,43,11,8,24,0,0,0,0,0,0,0,0,0,62351
21440,215,52,76,77,8,2,10,10,0,0,0,0,10,10,10,0,0,0,0,0,0,0,0,0,0,0,0,0,0,0,0,0,0,0,0,62352
21441,3926,823,1339,1290,376,98,343,268,175,75,14,86,93,46,41,0,5,47,6,14,27,75,69,17,0,52,6,6,6,0,0,0,0,0,0,62353
21442,1206,86,381,365,271,103,65,28,28,9,0,19,0,0,0,0,0,0,0,0,0,37,24,16,0,8,13,0,0,0,0,13,13,0,0,62354
21443,565,143,251,125,43,3,48,30,24,12,0,12,6,6,3,3,0,0,0,0,0,18,7,0,0,7,11,3,0,0,3,8,0,2,6,62355
21444,448,70,217,124,35,2,28,11,5,0,0,5,6,6,6,0,0,0,0,0,0,17,17,2,0,15,0,0,0,0,0,0,0,0,0,62356
21445,126,11,47,39,29,0,15,5,5,3,0,2,0,0,0,0,0,0,0,0,0,10,7,0,0,7,3,3,3,0,0,0,0,0,0,62357
21446,514,62,209,222,17,4,16,16,16,0,0,16,0,0,0,0,0,0,0,0,0,0,0,0,0,0,0,0,0,0,0,0,0,0,0,62358
21447,135,0,83,44,8,0,0,0,0,0,0,0,0,0,0,0,0,0,0,0,0,0,0,0,0,0,0,0,0,0,0,0,0,0,0,62359
21448,1298,154,608,380,119,37,197,146,133,20,5,108,13,13,3,4,6,0,0,0,0,51,51,7,0,44,0,0,0,0,0,0,0,0,0,62360
21449,538,99,326,78,23,12,12,0,0,0,0,0,0,0,0,0,0,0,0,0,0,12,10,0,0,10,2,2,2,0,0,0,0,0,0,62361
21450,273,29,135,73,22,14,11,8,8,2,0,6,0,0,0,0,0,0,0,0,0,3,2,0,0,2,1,1,0,0,1,0,0,0,0,62362
21451,4225,487,1631,1246,623,238,320,159,101,16,14,71,58,58,58,0,0,0,0,0,0,161,127,79,20,28,34,32,5,0,27,2,0,0,2,62363
21452,470,42,237,163,20,8,44,21,18,17,0,1,3,0,0,0,0,3,3,0,0,23,22,3,1,18,1,0,0,0,0,1,0,0,1,62365
21453,1109,173,618,251,40,27,95,63,41,6,0,35,22,22,6,5,11,0,0,0,0,32,16,8,0,8,16,9,0,0,9,7,0,0,7,62366
21454,818,93,385,234,89,17,16,12,9,0,0,9,3,3,3,0,0,0,0,0,0,4,0,0,0,0,4,4,4,0,0,0,0,0,0,62367
21455,359,62,188,97,8,4,51,6,6,0,0,6,0,0,0,0,0,0,0,0,0,45,45,3,14,28,0,0,0,0,0,0,0,0,0,62370
21456,209,10,61,97,30,11,13,13,13,0,0,13,0,0,0,0,0,0,0,0,0,0,0,0,0,0,0,0,0,0,0,0,0,0,0,62373
21457,243,52,81,78,26,6,5,2,2,0,0,2,0,0,0,0,0,0,0,0,0,3,3,3,0,0,0,0,0,0,0,0,0,0,0,62374
21458,365,50,142,92,79,2,5,2,2,0,0,2,0,0,0,0,0,0,0,0,0,3,3,3,0,0,0,0,0,0,0,0,0,0,0,62375
21459,829,58,368,292,91,20,29,16,16,3,0,13,0,0,0,0,0,0,0,0,0,13,13,10,0,3,0,0,0,0,0,0,0,0,0,62376
21460,733,59,357,258,15,44,46,9,0,0,0,0,9,9,0,0,9,0,0,0,0,37,36,3,0,33,1,0,0,0,0,1,0,1,0,62378
21461,1505,113,646,538,143,65,97,30,21,6,0,15,9,3,3,0,0,6,0,6,0,67,67,24,18,25,0,0,0,0,0,0,0,0,0,62379
21462,254,48,56,129,16,5,12,10,6,0,0,6,4,0,0,0,0,4,4,0,0,2,2,0,0,2,0,0,0,0,0,0,0,0,0,62380
21463,12702,1010,4155,4664,1918,955,885,423,345,245,0,100,78,78,66,0,12,0,0,0,0,462,392,148,48,196,70,45,5,14,26,25,25,0,0,62401
21464,647,65,212,278,69,23,31,14,12,11,0,1,2,2,0,2,0,0,0,0,0,17,17,4,2,11,0,0,0,0,0,0,0,0,0,62410
21465,3198,386,1248,1041,365,158,299,146,120,40,0,80,26,21,21,0,0,5,0,0,5,153,144,77,6,61,9,9,0,9,0,0,0,0,0,62411
21466,210,8,72,116,7,7,30,10,10,0,0,10,0,0,0,0,0,0,0,0,0,20,20,4,0,16,0,0,0,0,0,0,0,0,0,62413
21467,1071,136,545,257,93,40,127,81,76,11,16,49,5,0,0,0,0,5,0,0,5,46,35,4,0,31,11,4,4,0,0,7,7,0,0,62414
21468,1437,213,583,508,108,25,72,23,20,5,0,15,3,2,0,2,0,1,0,1,0,49,45,6,1,38,4,3,2,1,0,1,0,0,1,62417
21469,1270,167,552,398,110,43,122,76,36,0,32,4,40,35,0,31,4,5,2,3,0,46,33,4,16,13,13,13,6,0,7,0,0,0,0,62418
21470,275,37,86,136,12,4,18,10,10,10,0,0,0,0,0,0,0,0,0,0,0,8,8,0,8,0,0,0,0,0,0,0,0,0,0,62419
21471,3168,341,1197,1048,316,266,246,146,135,54,31,50,11,11,0,0,11,0,0,0,0,100,100,20,29,51,0,0,0,0,0,0,0,0,0,62420
21472,668,39,158,277,112,82,51,30,30,0,0,30,0,0,0,0,0,0,0,0,0,21,11,0,0,11,10,10,0,0,10,0,0,0,0,62421
21473,724,115,339,197,61,12,49,19,12,0,0,12,7,7,7,0,0,0,0,0,0,30,26,14,0,12,4,4,4,0,0,0,0,0,0,62422
21474,527,53,198,134,130,12,29,0,0,0,0,0,0,0,0,0,0,0,0,0,0,29,29,14,0,15,0,0,0,0,0,0,0,0,0,62423
21475,1306,138,617,354,164,33,187,115,89,48,0,41,26,2,2,0,0,24,0,0,24,72,60,37,2,21,12,7,2,5,0,5,5,0,0,62424
21476,484,13,180,165,126,0,62,30,30,12,10,8,0,0,0,0,0,0,0,0,0,32,32,32,0,0,0,0,0,0,0,0,0,0,0,62425
21477,711,114,334,211,30,22,83,20,20,4,0,16,0,0,0,0,0,0,0,0,0,63,55,21,32,2,8,8,8,0,0,0,0,0,0,62426
21478,1166,128,478,449,84,27,40,33,26,19,0,7,7,1,1,0,0,6,0,0,6,7,6,0,5,1,1,1,1,0,0,0,0,0,0,62427
21479,2380,326,971,820,158,105,132,75,73,20,11,42,2,0,0,0,0,2,2,0,0,57,57,24,0,33,0,0,0,0,0,0,0,0,0,62428
21480,733,87,384,228,27,7,78,51,38,9,0,29,13,13,3,5,5,0,0,0,0,27,26,14,0,12,1,1,1,0,0,0,0,0,0,62431
21481,335,20,141,156,12,6,43,29,29,14,7,8,0,0,0,0,0,0,0,0,0,14,14,12,2,0,0,0,0,0,0,0,0,0,0,62432
21482,758,63,317,255,67,56,87,45,39,3,0,36,6,0,0,0,0,6,0,0,6,42,42,17,0,25,0,0,0,0,0,0,0,0,0,62433
21483,158,15,58,26,30,29,0,0,0,0,0,0,0,0,0,0,0,0,0,0,0,0,0,0,0,0,0,0,0,0,0,0,0,0,0,62434
21484,430,91,118,196,11,14,52,37,37,21,7,9,0,0,0,0,0,0,0,0,0,15,12,0,8,4,3,0,0,0,0,3,3,0,0,62436
21485,282,11,118,131,22,0,27,17,12,0,0,12,5,5,5,0,0,0,0,0,0,10,10,0,10,0,0,0,0,0,0,0,0,0,0,62438
21486,5029,917,1838,1636,451,187,293,146,109,17,0,92,37,14,1,0,13,23,0,0,23,147,145,37,11,97,2,1,0,1,0,1,1,0,0,62439
21487,851,64,288,339,81,79,39,19,17,13,0,4,2,2,0,0,2,0,0,0,0,20,20,0,9,11,0,0,0,0,0,0,0,0,0,62440
21488,5176,578,2025,1571,678,324,340,154,154,86,32,36,0,0,0,0,0,0,0,0,0,186,168,68,27,73,18,18,0,18,0,0,0,0,0,62441
21489,1585,153,601,643,133,55,125,63,54,18,0,36,9,9,9,0,0,0,0,0,0,62,57,32,0,25,5,5,2,3,0,0,0,0,0,62442
21490,954,146,504,243,39,22,96,38,19,4,0,15,19,12,5,0,7,7,0,0,7,58,58,15,2,41,0,0,0,0,0,0,0,0,0,62443
21491,303,24,128,122,14,15,25,25,25,7,7,11,0,0,0,0,0,0,0,0,0,0,0,0,0,0,0,0,0,0,0,0,0,0,0,62444
21492,520,74,259,158,19,10,67,8,2,0,0,2,6,0,0,0,0,6,6,0,0,59,23,2,0,21,36,36,32,4,0,0,0,0,0,62445
21493,261,44,108,79,24,6,58,33,29,7,0,22,4,4,0,0,4,0,0,0,0,25,23,6,0,17,2,2,2,0,0,0,0,0,0,62446
21494,2317,190,877,834,301,115,145,66,52,9,15,28,14,12,10,2,0,2,2,0,0,79,49,20,4,25,30,6,6,0,0,24,24,0,0,62447
21495,4013,320,1608,1406,405,274,273,127,104,9,0,95,23,23,0,10,13,0,0,0,0,146,140,50,0,90,6,6,0,6,0,0,0,0,0,62448
21496,2011,217,769,704,217,104,190,114,77,42,5,30,37,24,22,0,2,13,0,8,5,76,76,43,2,31,0,0,0,0,0,0,0,0,0,62449
21497,8542,801,2887,2997,1398,459,530,276,262,83,12,167,14,8,8,0,0,6,0,0,6,254,205,100,5,100,49,43,12,31,0,6,0,0,6,62450
21498,1676,159,684,615,164,54,86,35,30,13,0,17,5,5,5,0,0,0,0,0,0,51,38,3,5,30,13,7,7,0,0,6,2,0,4,62451
21499,328,37,122,138,20,11,26,21,21,13,2,6,0,0,0,0,0,0,0,0,0,5,5,0,0,5,0,0,0,0,0,0,0,0,0,62452
21500,8108,967,2577,2985,949,630,690,443,376,153,29,194,67,25,0,6,19,42,0,18,24,247,207,89,19,99,40,12,12,0,0,28,12,8,8,62454
21501,1626,188,764,547,72,55,101,51,28,0,0,28,23,23,21,2,0,0,0,0,0,50,36,9,6,21,14,0,0,0,0,14,3,0,11,62458
21502,172,17,65,63,26,1,8,7,5,3,0,2,2,2,0,2,0,0,0,0,0,1,1,0,0,1,0,0,0,0,0,0,0,0,0,62459
21503,678,89,283,238,65,3,39,21,20,0,0,20,1,0,0,0,0,1,1,0,0,18,16,1,0,15,2,2,1,0,1,0,0,0,0,62460
21504,578,43,262,208,37,28,48,29,29,12,0,17,0,0,0,0,0,0,0,0,0,19,19,15,0,4,0,0,0,0,0,0,0,0,0,62461
21505,657,52,284,199,95,27,45,25,25,18,0,7,0,0,0,0,0,0,0,0,0,20,15,4,0,11,5,5,5,0,0,0,0,0,0,62462
21506,921,61,412,304,111,33,40,21,21,4,3,14,0,0,0,0,0,0,0,0,0,19,16,7,2,7,3,3,3,0,0,0,0,0,0,62463
21507,758,44,305,296,71,42,24,13,13,0,7,6,0,0,0,0,0,0,0,0,0,11,9,3,0,6,2,0,0,0,0,2,2,0,0,62465
21508,4947,1655,1370,1738,169,15,111,85,25,8,0,17,60,4,1,1,2,56,0,0,56,26,23,4,0,19,3,1,0,1,0,2,0,0,2,62466
21509,2629,101,1007,839,438,244,121,68,42,26,5,11,26,0,0,0,0,26,0,0,26,53,53,46,0,7,0,0,0,0,0,0,0,0,0,62467
21510,1740,239,595,680,169,57,164,114,64,18,0,46,50,40,19,21,0,10,0,8,2,50,20,0,8,12,30,17,17,0,0,13,0,0,13,62468
21511,256,19,78,84,47,28,0,0,0,0,0,0,0,0,0,0,0,0,0,0,0,0,0,0,0,0,0,0,0,0,0,0,0,0,0,62469
21512,6492,1071,2336,1844,721,520,500,203,115,0,15,100,88,37,18,0,19,51,11,0,40,297,262,166,24,72,35,18,13,5,0,17,11,6,0,62471
21513,893,94,315,347,93,44,125,70,65,44,0,21,5,5,3,0,2,0,0,0,0,55,55,25,0,30,0,0,0,0,0,0,0,0,0,62473
21514,665,74,285,232,47,27,41,26,25,3,2,20,1,1,0,1,0,0,0,0,0,15,15,1,8,6,0,0,0,0,0,0,0,0,0,62474
21515,348,27,102,187,32,0,57,45,45,0,11,34,0,0,0,0,0,0,0,0,0,12,12,12,0,0,0,0,0,0,0,0,0,0,0,62475
21516,1436,181,624,459,150,22,68,30,24,8,2,14,6,6,0,0,6,0,0,0,0,38,32,11,0,21,6,6,2,0,4,0,0,0,0,62476
21517,704,29,305,278,58,34,97,45,34,22,0,12,11,11,0,11,0,0,0,0,0,52,36,5,0,31,16,16,16,0,0,0,0,0,0,62477
21518,243,41,104,42,49,7,6,0,0,0,0,0,0,0,0,0,0,0,0,0,0,6,6,0,0,6,0,0,0,0,0,0,0,0,0,62478
21519,588,31,190,237,73,57,28,27,27,5,10,12,0,0,0,0,0,0,0,0,0,1,1,1,0,0,0,0,0,0,0,0,0,0,0,62479
21520,508,39,281,147,41,0,30,8,8,6,0,2,0,0,0,0,0,0,0,0,0,22,16,8,0,8,6,6,0,0,6,0,0,0,0,62480
21521,221,26,83,83,29,0,1,0,0,0,0,0,0,0,0,0,0,0,0,0,0,1,1,1,0,0,0,0,0,0,0,0,0,0,0,62481
21522,1781,188,634,635,232,92,137,42,38,0,16,22,4,4,0,0,4,0,0,0,0,95,95,61,7,27,0,0,0,0,0,0,0,0,0,62501
21523,1254,120,658,290,151,35,165,107,93,12,0,81,14,9,2,0,7,5,2,0,3,58,33,31,0,2,25,25,2,3,20,0,0,0,0,62510
21524,211,24,87,63,33,4,93,42,42,42,0,0,0,0,0,0,0,0,0,0,0,51,0,0,0,0,51,2,2,0,0,49,0,49,0,62512
21525,1084,125,480,328,106,45,73,22,22,10,0,12,0,0,0,0,0,0,0,0,0,51,47,7,14,26,4,4,0,4,0,0,0,0,0,62513
21526,199,26,89,84,0,0,13,13,0,0,0,0,13,13,13,0,0,0,0,0,0,0,0,0,0,0,0,0,0,0,0,0,0,0,0,62514
21527,728,56,304,249,92,27,5,0,0,0,0,0,0,0,0,0,0,0,0,0,0,5,5,3,0,2,0,0,0,0,0,0,0,0,0,62515
21528,175,40,69,54,8,4,10,1,1,0,0,1,0,0,0,0,0,0,0,0,0,9,5,2,0,3,4,2,0,2,0,2,0,2,0,62517
21529,254,13,109,56,49,27,13,4,4,4,0,0,0,0,0,0,0,0,0,0,0,9,9,0,0,9,0,0,0,0,0,0,0,0,0,62518
21530,41,6,35,0,0,0,0,0,0,0,0,0,0,0,0,0,0,0,0,0,0,0,0,0,0,0,0,0,0,0,0,0,0,0,0,62519
21531,996,79,361,320,158,78,72,50,48,7,7,34,2,0,0,0,0,2,0,2,0,22,21,3,0,18,1,1,1,0,0,0,0,0,0,62520
21532,25266,2866,8838,7934,3725,1903,1720,925,769,225,146,398,156,110,19,23,68,46,15,15,16,795,682,216,121,345,113,70,70,0,0,43,18,0,25,62521
21533,9847,1215,3325,3013,1449,845,1714,886,717,164,97,456,169,85,36,14,35,84,0,30,54,828,741,208,107,426,87,61,52,0,9,26,3,0,23,62522
21534,681,212,220,241,8,0,53,53,16,0,0,16,37,22,0,0,22,15,0,0,15,0,0,0,0,0,0,0,0,0,0,0,0,0,0,62523
21535,23447,3370,8395,7301,2780,1601,1252,547,426,141,54,231,121,22,0,22,0,99,9,10,80,705,530,229,100,201,175,63,33,0,30,112,8,47,57,62526
21536,1044,67,431,371,127,48,85,56,48,7,7,34,8,8,8,0,0,0,0,0,0,29,27,0,2,25,2,2,2,0,0,0,0,0,0,62530
21537,1228,82,516,447,129,54,124,74,65,29,0,36,9,9,9,0,0,0,0,0,0,50,43,4,0,39,7,7,7,0,0,0,0,0,0,62531
21538,36,0,19,17,0,0,10,10,10,10,0,0,0,0,0,0,0,0,0,0,0,0,0,0,0,0,0,0,0,0,0,0,0,0,0,62532
21539,552,29,258,176,64,25,13,9,3,3,0,0,6,0,0,0,0,6,0,0,6,4,2,0,0,2,2,1,0,0,1,1,0,0,1,62533
21540,899,66,327,377,107,22,52,32,32,3,0,29,0,0,0,0,0,0,0,0,0,20,16,7,0,9,4,4,4,0,0,0,0,0,0,62534
21541,2627,97,570,643,807,510,169,118,118,14,12,92,0,0,0,0,0,0,0,0,0,51,37,0,0,37,14,14,14,0,0,0,0,0,0,62535
21542,602,8,174,234,149,37,7,7,7,0,0,7,0,0,0,0,0,0,0,0,0,0,0,0,0,0,0,0,0,0,0,0,0,0,0,62536
21543,34,3,27,4,0,0,3,3,3,0,0,3,0,0,0,0,0,0,0,0,0,0,0,0,0,0,0,0,0,0,0,0,0,0,0,62537
21544,245,14,149,47,21,14,8,5,4,2,0,2,1,0,0,0,0,1,1,0,0,3,3,3,0,0,0,0,0,0,0,0,0,0,0,62538
21545,958,43,375,324,139,77,75,23,18,2,0,16,5,5,2,2,1,0,0,0,0,52,49,22,11,16,3,3,3,0,0,0,0,0,0,62539
21546,1045,133,548,270,59,35,91,43,31,0,2,29,12,12,0,7,5,0,0,0,0,48,44,21,0,23,4,4,4,0,0,0,0,0,0,62540
21547,89,0,36,53,0,0,1,1,1,0,0,1,0,0,0,0,0,0,0,0,0,0,0,0,0,0,0,0,0,0,0,0,0,0,0,62541
21548,271,18,118,99,28,8,29,25,20,0,2,18,5,5,5,0,0,0,0,0,0,4,4,2,0,2,0,0,0,0,0,0,0,0,0,62543
21549,1307,101,501,438,199,68,108,36,31,14,4,13,5,5,0,5,0,0,0,0,0,72,55,11,3,41,17,17,9,8,0,0,0,0,0,62544
21550,647,46,266,249,51,35,31,14,14,1,4,9,0,0,0,0,0,0,0,0,0,17,10,0,7,3,7,4,0,4,0,3,0,0,3,62545
21551,957,105,457,287,69,39,130,74,66,21,0,45,8,2,2,0,0,6,0,0,6,56,51,12,0,39,5,5,3,2,0,0,0,0,0,62546
21552,573,49,241,232,26,25,83,32,15,1,0,14,17,15,0,1,14,2,2,0,0,51,42,9,0,33,9,3,3,0,0,6,6,0,0,62547
21553,1304,134,582,334,193,61,46,26,24,9,0,15,2,2,2,0,0,0,0,0,0,20,15,10,0,5,5,3,3,0,0,2,2,0,0,62548
21554,3986,259,988,1395,866,478,303,183,183,28,33,122,0,0,0,0,0,0,0,0,0,120,120,99,12,9,0,0,0,0,0,0,0,0,0,62549
21555,2015,168,805,609,271,162,177,112,101,19,19,63,11,11,3,8,0,0,0,0,0,65,56,10,0,46,9,9,6,0,3,0,0,0,0,62550
21556,606,61,270,172,66,37,31,15,15,7,0,8,0,0,0,0,0,0,0,0,0,16,14,7,0,7,2,0,0,0,0,2,0,0,2,62551
21557,285,71,148,54,9,3,42,0,0,0,0,0,0,0,0,0,0,0,0,0,0,42,42,33,0,9,0,0,0,0,0,0,0,0,0,62553
21558,1036,74,406,317,170,69,93,19,12,2,3,7,7,4,0,4,0,3,0,0,3,74,67,22,0,45,7,7,4,3,0,0,0,0,0,62554
21559,313,24,107,80,73,29,27,8,4,4,0,0,4,4,0,2,2,0,0,0,0,19,19,7,0,12,0,0,0,0,0,0,0,0,0,62555
21560,255,24,135,82,4,10,10,10,9,2,4,3,1,1,1,0,0,0,0,0,0,0,0,0,0,0,0,0,0,0,0,0,0,0,0,62556
21561,4967,657,2508,1452,257,93,255,56,40,12,0,28,16,16,12,0,4,0,0,0,0,199,199,137,18,44,0,0,0,0,0,0,0,0,0,62557
21562,2588,176,839,966,469,138,188,132,122,36,0,86,10,10,10,0,0,0,0,0,0,56,37,19,0,18,19,19,19,0,0,0,0,0,0,62558
21563,791,72,323,293,42,61,86,36,36,13,5,18,0,0,0,0,0,0,0,0,0,50,50,24,0,26,0,0,0,0,0,0,0,0,0,62560
21564,3385,412,1321,1141,401,110,365,174,163,50,19,94,11,4,0,0,4,7,0,0,7,191,149,42,42,65,42,42,19,0,23,0,0,0,0,62561
21565,3868,202,668,1160,1074,764,215,108,108,49,10,49,0,0,0,0,0,0,0,0,0,107,107,58,0,49,0,0,0,0,0,0,0,0,0,62563
21566,5392,556,2119,1819,595,303,467,237,223,28,23,172,14,0,0,0,0,14,0,14,0,230,182,50,9,123,48,11,0,0,11,37,0,0,37,62565
21567,674,71,360,148,68,27,43,10,10,2,0,8,0,0,0,0,0,0,0,0,0,33,31,7,3,21,2,0,0,0,0,2,2,0,0,62567
21568,12096,1491,4778,3844,1347,636,821,544,435,204,29,202,109,100,52,0,48,9,0,9,0,277,251,26,36,189,26,26,26,0,0,0,0,0,0,62568
21569,371,75,191,78,19,8,17,4,4,4,0,0,0,0,0,0,0,0,0,0,0,13,13,3,0,10,0,0,0,0,0,0,0,0,0,62570
21570,1061,153,514,315,65,14,53,16,16,5,0,11,0,0,0,0,0,0,0,0,0,37,26,19,0,7,11,11,0,0,11,0,0,0,0,62571
21571,414,54,172,121,67,0,14,12,10,0,9,1,2,1,0,0,1,1,0,0,1,2,2,0,0,2,0,0,0,0,0,0,0,0,0,62572
21572,1012,63,347,367,190,45,119,61,56,13,0,43,5,5,5,0,0,0,0,0,0,58,34,20,7,7,24,7,7,0,0,17,0,4,13,62573
21573,315,42,100,104,43,26,0,0,0,0,0,0,0,0,0,0,0,0,0,0,0,0,0,0,0,0,0,0,0,0,0,0,0,0,0,62601
21574,166,21,109,27,9,0,10,2,2,0,0,2,0,0,0,0,0,0,0,0,0,8,8,4,4,0,0,0,0,0,0,0,0,0,0,62610
21575,883,54,344,283,172,30,58,10,5,0,0,5,5,5,0,5,0,0,0,0,0,48,44,12,3,29,4,4,4,0,0,0,0,0,0,62611
21576,1436,88,768,312,224,44,72,39,28,6,0,22,11,7,1,0,6,4,4,0,0,33,33,15,0,18,0,0,0,0,0,0,0,0,0,62612
21577,2474,96,1012,730,415,221,242,129,94,14,0,80,35,35,32,3,0,0,0,0,0,113,93,18,0,75,20,20,16,0,4,0,0,0,0,62613
21578,3684,160,1713,978,617,216,247,112,100,14,37,49,12,12,12,0,0,0,0,0,0,135,110,37,13,60,25,25,0,12,13,0,0,0,0,62615
21579,464,80,216,120,43,5,37,26,24,15,3,6,2,2,2,0,0,0,0,0,0,11,11,0,5,6,0,0,0,0,0,0,0,0,0,62617
21580,5128,919,2336,1275,414,184,355,208,174,24,110,40,34,17,13,0,4,17,0,12,5,147,101,28,23,50,46,39,33,6,0,7,0,0,7,62618
21581,867,102,386,248,118,13,96,58,42,11,12,19,16,7,0,0,7,9,0,9,0,38,29,12,0,17,9,0,0,0,0,9,0,9,0,62621
21582,0,0,0,0,0,0,0,0,0,0,0,0,0,0,0,0,0,0,0,0,0,0,0,0,0,0,0,0,0,0,0,0,0,0,0,62622
21583,469,59,203,197,10,0,18,6,6,0,0,6,0,0,0,0,0,0,0,0,0,12,9,5,0,4,3,3,3,0,0,0,0,0,0,62624
21584,615,32,210,139,205,29,28,13,3,3,0,0,10,10,10,0,0,0,0,0,0,15,13,0,0,13,2,2,2,0,0,0,0,0,0,62625
21585,5790,775,1805,1978,707,525,571,282,253,120,23,110,29,0,0,0,0,29,0,24,5,289,252,193,0,59,37,37,22,8,7,0,0,0,0,62626
21586,760,84,409,172,72,23,96,49,49,5,2,42,0,0,0,0,0,0,0,0,0,47,32,4,0,28,15,15,0,15,0,0,0,0,0,62627
21587,560,44,275,153,57,31,15,10,10,0,0,10,0,0,0,0,0,0,0,0,0,5,5,1,4,0,0,0,0,0,0,0,0,0,0,62628
21588,8963,221,1865,3016,2476,1385,601,275,275,139,30,106,0,0,0,0,0,0,0,0,0,326,326,125,9,192,0,0,0,0,0,0,0,0,0,62629
21589,352,45,134,92,58,23,4,4,3,0,0,3,1,1,0,1,0,0,0,0,0,0,0,0,0,0,0,0,0,0,0,0,0,0,0,62630
21590,173,17,72,42,42,0,0,0,0,0,0,0,0,0,0,0,0,0,0,0,0,0,0,0,0,0,0,0,0,0,0,0,0,0,0,62631
21591,507,60,206,181,45,15,48,27,27,8,0,19,0,0,0,0,0,0,0,0,0,21,18,0,0,18,3,3,3,0,0,0,0,0,0,62633
21592,433,36,128,181,61,27,12,4,2,0,0,2,2,1,0,1,0,1,0,0,1,8,8,3,0,5,0,0,0,0,0,0,0,0,0,62634
21593,408,20,191,108,80,9,32,18,9,2,2,5,9,9,9,0,0,0,0,0,0,14,14,4,0,10,0,0,0,0,0,0,0,0,0,62635
21594,857,82,352,235,97,91,36,17,17,6,0,11,0,0,0,0,0,0,0,0,0,19,16,9,0,7,3,3,1,2,0,0,0,0,0,62638
21595,184,22,39,70,28,25,0,0,0,0,0,0,0,0,0,0,0,0,0,0,0,0,0,0,0,0,0,0,0,0,0,0,0,0,0,62639
21596,2735,190,1321,812,308,104,233,183,165,61,6,98,18,18,13,5,0,0,0,0,0,50,36,7,0,29,14,14,7,7,0,0,0,0,0,62640
21597,1125,85,499,391,110,40,105,60,45,31,0,14,15,9,0,9,0,6,6,0,0,45,45,26,6,13,0,0,0,0,0,0,0,0,0,62642
21598,248,24,91,75,47,11,17,4,2,1,0,1,2,2,1,0,1,0,0,0,0,13,10,7,0,3,3,0,0,0,0,3,0,0,3,62643
21599,3915,630,1381,1198,408,298,217,81,58,26,0,32,23,11,0,0,11,12,0,0,12,136,64,24,25,15,72,19,19,0,0,53,19,0,34,62644
21600,326,28,155,95,43,5,13,10,8,0,0,8,2,0,0,0,0,2,0,0,2,3,3,0,0,3,0,0,0,0,0,0,0,0,0,62649
21601,18409,2357,7094,4851,2470,1637,1831,1032,881,259,77,545,151,81,68,0,13,70,46,0,24,799,774,270,128,376,25,14,2,10,2,11,0,0,11,62650
21602,442,37,179,205,21,0,46,39,38,8,0,30,1,1,1,0,0,0,0,0,0,7,5,0,2,3,2,2,0,0,2,0,0,0,0,62655
21603,15744,2479,5419,5442,1613,791,1548,839,580,82,36,462,259,128,99,2,27,131,0,0,131,709,414,81,35,298,295,236,76,160,0,59,1,58,0,62656
21604,695,69,330,203,65,28,41,16,14,9,5,0,2,2,0,0,2,0,0,0,0,25,20,5,9,6,5,5,0,5,0,0,0,0,0,62661
21605,313,41,131,108,33,0,41,9,6,1,2,3,3,3,3,0,0,0,0,0,0,32,32,6,0,26,0,0,0,0,0,0,0,0,0,62663
21606,2123,264,885,672,220,82,117,85,69,9,0,60,16,0,0,0,0,16,0,12,4,32,19,4,6,9,13,13,4,0,9,0,0,0,0,62664
21607,1070,159,490,350,53,18,63,36,20,14,0,6,16,3,0,0,3,13,0,0,13,27,27,10,0,17,0,0,0,0,0,0,0,0,0,62665
21608,366,54,141,100,52,19,4,2,2,0,0,2,0,0,0,0,0,0,0,0,0,2,2,1,0,1,0,0,0,0,0,0,0,0,0,62666
21609,266,16,123,97,22,8,14,3,3,0,0,3,0,0,0,0,0,0,0,0,0,11,8,0,1,7,3,3,0,1,2,0,0,0,0,62667
21610,997,65,594,234,60,44,68,23,23,12,5,6,0,0,0,0,0,0,0,0,0,45,44,13,0,31,1,1,1,0,0,0,0,0,0,62668
21611,2254,136,843,683,382,210,235,77,67,3,4,60,10,3,0,0,3,7,7,0,0,158,153,74,12,67,5,5,2,0,3,0,0,0,0,62670
21612,288,15,131,89,40,13,11,5,5,0,0,5,0,0,0,0,0,0,0,0,0,6,6,1,1,4,0,0,0,0,0,0,0,0,0,62671
21613,165,32,84,32,12,5,4,1,1,1,0,0,0,0,0,0,0,0,0,0,0,3,3,3,0,0,0,0,0,0,0,0,0,0,0,62672
21614,464,60,286,88,25,5,4,2,2,1,0,1,0,0,0,0,0,0,0,0,0,2,1,1,0,0,1,1,0,0,1,0,0,0,0,62673
21615,995,139,373,329,97,57,63,32,32,10,0,22,0,0,0,0,0,0,0,0,0,31,27,5,2,20,4,4,2,0,2,0,0,0,0,62674
21616,4364,370,1525,1388,781,300,281,132,122,28,23,71,10,0,0,0,0,10,0,0,10,149,134,105,0,29,15,9,9,0,0,6,0,3,3,62675
21617,1955,86,638,643,462,126,152,95,95,64,0,31,0,0,0,0,0,0,0,0,0,57,57,35,3,19,0,0,0,0,0,0,0,0,0,62677
21618,3967,446,1444,1235,606,236,212,107,78,34,0,44,29,20,4,12,4,9,0,0,9,105,81,31,0,50,24,24,16,8,0,0,0,0,0,62681
21619,475,54,177,167,55,22,50,16,15,4,0,11,1,1,0,0,1,0,0,0,0,34,29,6,9,14,5,5,0,0,5,0,0,0,0,62682
21620,3854,138,920,1195,902,699,381,222,207,63,23,121,15,15,15,0,0,0,0,0,0,159,143,23,14,106,16,16,16,0,0,0,0,0,0,62684
21621,1331,113,519,517,120,62,76,66,64,9,1,54,2,2,0,2,0,0,0,0,0,10,8,4,0,4,2,2,0,0,2,0,0,0,0,62685
21622,443,52,179,167,36,9,37,18,18,10,8,0,0,0,0,0,0,0,0,0,0,19,12,6,1,5,7,0,0,0,0,7,7,0,0,62688
21623,332,54,98,139,28,13,15,12,5,0,2,3,7,7,0,0,7,0,0,0,0,3,3,1,0,2,0,0,0,0,0,0,0,0,0,62689
21624,2844,371,1151,1019,239,64,234,92,70,52,0,18,22,22,22,0,0,0,0,0,0,142,118,27,0,91,24,18,0,18,0,6,0,6,0,62690
21625,1583,165,722,515,114,67,86,42,28,7,2,19,14,12,12,0,0,2,0,2,0,44,31,6,4,21,13,13,8,0,5,0,0,0,0,62691
21626,1288,86,563,396,143,100,123,72,48,0,8,40,24,24,10,14,0,0,0,0,0,51,49,8,0,41,2,2,1,0,1,0,0,0,0,62692
21627,1065,32,237,481,214,101,115,46,44,0,24,20,2,2,2,0,0,0,0,0,0,69,50,12,5,33,19,19,0,5,14,0,0,0,0,62693
21628,2070,192,1013,545,240,80,126,64,52,9,10,33,12,12,12,0,0,0,0,0,0,62,62,37,0,25,0,0,0,0,0,0,0,0,0,62694
21629,150,24,88,27,5,6,8,3,3,0,0,3,0,0,0,0,0,0,0,0,0,5,5,1,0,4,0,0,0,0,0,0,0,0,0,62695
21630,955,141,227,236,183,168,43,43,4,0,0,4,39,5,0,0,5,34,0,0,34,0,0,0,0,0,0,0,0,0,0,0,0,0,0,62701
21631,24802,3354,8319,8635,3101,1393,1773,936,726,157,80,489,210,134,81,25,28,76,44,13,19,837,669,227,71,371,168,60,19,3,38,108,89,9,10,62702
21632,18536,2818,6602,5806,2346,964,2337,1277,1141,310,136,695,136,88,27,14,47,48,0,26,22,1060,886,241,118,527,174,144,83,61,0,30,11,0,19,62703
21633,28574,1693,6366,8475,7283,4757,1515,768,652,138,52,462,116,38,21,12,5,78,15,6,57,747,650,330,86,234,97,50,43,0,7,47,0,47,0,62704
21634,5590,484,1671,2068,868,499,351,216,191,24,12,155,25,7,0,7,0,18,0,0,18,135,114,38,30,46,21,2,2,0,0,19,6,13,0,62707
21635,11657,207,2108,2734,3683,2925,809,339,336,99,0,237,3,3,2,0,1,0,0,0,0,470,464,247,0,217,6,6,6,0,0,0,0,0,0,62711
21636,6810,96,1365,1802,1870,1677,399,244,230,70,35,125,14,13,13,0,0,1,0,0,1,155,155,66,0,89,0,0,0,0,0,0,0,0,0,62712
21637,15877,2420,5374,5979,1356,748,1168,634,468,113,38,317,166,80,36,7,37,86,0,31,55,534,450,106,67,277,84,26,13,9,4,58,0,29,29,62801
21638,739,98,157,375,85,24,72,27,25,5,2,18,2,2,2,0,0,0,0,0,0,45,41,6,23,12,4,0,0,0,0,4,0,0,4,62803
21639,2364,330,724,1031,202,77,163,98,93,4,31,58,5,5,0,5,0,0,0,0,0,65,60,22,15,23,5,5,5,0,0,0,0,0,0,62806
21640,702,114,317,239,25,7,98,61,61,33,12,16,0,0,0,0,0,0,0,0,0,37,37,28,0,9,0,0,0,0,0,0,0,0,0,62807
21641,1092,145,341,436,104,66,92,35,24,3,0,21,11,4,4,0,0,7,0,7,0,57,50,9,0,41,7,0,0,0,0,7,0,0,7,62808
21642,96,5,38,35,12,6,4,4,4,0,0,4,0,0,0,0,0,0,0,0,0,0,0,0,0,0,0,0,0,0,0,0,0,0,0,62809
21643,614,64,249,214,55,32,52,27,22,11,2,9,5,5,3,0,2,0,0,0,0,25,17,1,4,12,8,8,8,0,0,0,0,0,0,62810
21644,158,29,57,66,5,1,10,6,6,3,0,3,0,0,0,0,0,0,0,0,0,4,3,0,0,3,1,1,0,0,1,0,0,0,0,62811
21645,7834,1011,2389,3164,804,466,755,429,273,32,27,214,156,17,14,0,3,139,37,67,35,326,212,67,7,138,114,73,47,11,15,41,0,0,41,62812
21646,1321,164,562,481,86,28,97,39,28,13,0,15,11,5,5,0,0,6,0,0,6,58,56,29,7,20,2,2,0,2,0,0,0,0,0,62814
21647,296,53,114,116,7,6,15,12,12,3,0,9,0,0,0,0,0,0,0,0,0,3,3,0,2,1,0,0,0,0,0,0,0,0,0,62815
21648,999,112,430,371,70,16,61,36,34,27,0,7,2,2,2,0,0,0,0,0,0,25,24,13,0,11,1,1,1,0,0,0,0,0,0,62816
21649,452,106,200,91,27,28,35,33,18,0,0,18,15,15,0,5,10,0,0,0,0,2,2,2,0,0,0,0,0,0,0,0,0,0,0,62817
21650,238,70,69,89,10,0,41,19,19,18,0,1,0,0,0,0,0,0,0,0,0,22,22,20,0,2,0,0,0,0,0,0,0,0,0,62818
21651,306,48,93,128,32,5,16,9,9,0,0,9,0,0,0,0,0,0,0,0,0,7,7,0,0,7,0,0,0,0,0,0,0,0,0,62819
21652,142,19,37,57,7,22,1,0,0,0,0,0,0,0,0,0,0,0,0,0,0,1,1,1,0,0,0,0,0,0,0,0,0,0,0,62820
21653,5575,788,1926,2068,519,274,347,182,139,52,28,59,43,30,24,0,6,13,0,0,13,165,134,66,9,59,31,31,12,0,19,0,0,0,0,62821
21654,1993,204,669,903,141,76,123,107,92,11,3,78,15,15,15,0,0,0,0,0,0,16,16,13,3,0,0,0,0,0,0,0,0,0,0,62822
21655,1377,170,494,559,127,27,117,64,51,18,10,23,13,0,0,0,0,13,6,0,7,53,47,30,0,17,6,0,0,0,0,6,6,0,0,62823
21656,1277,263,498,375,122,19,146,85,25,17,0,8,60,54,40,8,6,6,0,0,6,61,50,5,0,45,11,9,9,0,0,2,0,0,2,62824
21657,151,22,37,77,15,0,5,0,0,0,0,0,0,0,0,0,0,0,0,0,0,5,0,0,0,0,5,0,0,0,0,5,0,0,5,62825
21658,852,148,253,340,58,53,33,11,9,7,0,2,2,2,2,0,0,0,0,0,0,22,16,7,6,3,6,0,0,0,0,6,0,0,6,62827
21659,831,77,316,351,78,9,79,35,21,0,0,21,14,14,14,0,0,0,0,0,0,44,44,16,0,28,0,0,0,0,0,0,0,0,0,62828
21660,77,44,26,7,0,0,14,14,14,0,0,14,0,0,0,0,0,0,0,0,0,0,0,0,0,0,0,0,0,0,0,0,0,0,0,62829
21661,942,98,349,383,78,34,46,20,20,0,0,20,0,0,0,0,0,0,0,0,0,26,20,6,0,14,6,6,0,0,6,0,0,0,0,62830
21662,442,80,174,136,40,12,13,5,5,2,0,3,0,0,0,0,0,0,0,0,0,8,8,2,0,6,0,0,0,0,0,0,0,0,0,62831
21663,6124,834,1999,2378,694,219,333,171,147,34,0,113,24,12,0,5,7,12,0,0,12,162,144,45,36,63,18,18,0,7,11,0,0,0,0,62832
21664,186,35,73,65,13,0,7,7,7,0,0,7,0,0,0,0,0,0,0,0,0,0,0,0,0,0,0,0,0,0,0,0,0,0,0,62833
21665,713,139,203,265,70,36,62,10,10,0,10,0,0,0,0,0,0,0,0,0,0,52,52,4,44,4,0,0,0,0,0,0,0,0,0,62835
21666,465,56,121,185,63,40,13,9,6,2,2,2,3,3,0,3,0,0,0,0,0,4,4,0,0,4,0,0,0,0,0,0,0,0,0,62836
21667,6383,905,2164,2535,551,228,294,193,174,53,22,99,19,10,0,0,10,9,0,0,9,101,68,39,3,26,33,33,0,0,33,0,0,0,0,62837
21668,1180,174,617,345,39,5,94,51,51,14,0,37,0,0,0,0,0,0,0,0,0,43,34,3,9,22,9,9,0,0,9,0,0,0,0,62838
21669,4434,387,1719,1574,516,238,287,125,115,9,23,83,10,10,10,0,0,0,0,0,0,162,162,80,0,82,0,0,0,0,0,0,0,0,0,62839
21670,94,8,39,32,0,15,3,2,2,0,0,2,0,0,0,0,0,0,0,0,0,1,1,0,1,0,0,0,0,0,0,0,0,0,0,62841
21671,576,65,211,261,29,10,26,6,5,0,0,5,1,1,1,0,0,0,0,0,0,20,18,8,0,10,2,2,0,2,0,0,0,0,0,62842
21672,83,22,17,37,3,4,0,0,0,0,0,0,0,0,0,0,0,0,0,0,0,0,0,0,0,0,0,0,0,0,0,0,0,0,0,62843
21673,1405,201,436,625,92,51,100,38,32,17,5,10,6,6,4,0,2,0,0,0,0,62,46,12,0,34,16,16,0,0,16,0,0,0,0,62844
21674,1969,654,588,615,85,27,192,147,76,12,3,61,71,21,0,0,21,50,0,0,50,45,45,7,0,38,0,0,0,0,0,0,0,0,0,62846
21675,395,45,161,159,14,16,10,1,1,1,0,0,0,0,0,0,0,0,0,0,0,9,9,3,0,6,0,0,0,0,0,0,0,0,0,62848
21676,1572,177,585,682,93,35,197,107,95,36,14,45,12,5,0,0,5,7,0,0,7,90,85,14,11,60,5,4,4,0,0,1,0,0,1,62849
21677,164,35,63,51,12,3,18,15,6,6,0,0,9,9,9,0,0,0,0,0,0,3,3,0,0,3,0,0,0,0,0,0,0,0,0,62850
21678,205,17,43,93,38,14,14,9,9,6,0,3,0,0,0,0,0,0,0,0,0,5,3,0,0,3,2,2,2,0,0,0,0,0,0,62851
21679,93,9,43,41,0,0,0,0,0,0,0,0,0,0,0,0,0,0,0,0,0,0,0,0,0,0,0,0,0,0,0,0,0,0,0,62852
21680,637,91,258,220,59,9,53,21,18,5,3,10,3,0,0,0,0,3,0,0,3,32,28,2,4,22,4,2,2,0,0,2,2,0,0,62853
21681,1158,120,548,376,64,50,84,37,37,0,2,35,0,0,0,0,0,0,0,0,0,47,34,5,0,29,13,13,0,13,0,0,0,0,0,62854
21682,228,19,142,64,3,0,8,0,0,0,0,0,0,0,0,0,0,0,0,0,0,8,8,6,0,2,0,0,0,0,0,0,0,0,0,62856
21683,2353,284,1098,644,260,67,200,118,35,7,4,24,83,83,33,50,0,0,0,0,0,82,82,71,0,11,0,0,0,0,0,0,0,0,0,62858
21684,3997,708,1276,1308,410,295,311,147,120,20,50,50,27,27,27,0,0,0,0,0,0,164,133,77,0,56,31,0,0,0,0,31,21,0,10,62859
21685,364,40,169,114,29,12,11,9,9,0,0,9,0,0,0,0,0,0,0,0,0,2,2,0,0,2,0,0,0,0,0,0,0,0,0,62860
21686,102,40,47,15,0,0,1,1,1,0,0,1,0,0,0,0,0,0,0,0,0,0,0,0,0,0,0,0,0,0,0,0,0,0,0,62861
21687,239,17,110,78,28,6,26,20,17,13,4,0,3,0,0,0,0,3,3,0,0,6,5,0,2,3,1,0,0,0,0,1,0,0,1,62862
21688,6959,675,2296,2739,871,378,548,343,332,91,47,194,11,11,0,0,11,0,0,0,0,205,190,73,37,80,15,9,0,9,0,6,6,0,0,62863
21689,16767,2052,5647,5950,1904,1214,1225,708,618,136,133,349,90,58,26,20,12,32,13,15,4,517,445,115,128,202,72,44,16,28,0,28,5,18,5,62864
21690,1273,66,596,476,101,34,72,13,13,0,0,13,0,0,0,0,0,0,0,0,0,59,47,47,0,0,12,12,12,0,0,0,0,0,0,62865
21691,324,79,135,100,3,7,32,13,13,0,0,13,0,0,0,0,0,0,0,0,0,19,11,1,0,10,8,8,0,8,0,0,0,0,0,62867
21692,1209,148,496,431,107,27,86,49,30,8,0,22,19,19,13,0,6,0,0,0,0,37,31,10,7,14,6,6,0,0,6,0,0,0,0,62868
21693,1984,249,510,877,246,102,116,97,76,32,17,27,21,0,0,0,0,21,10,0,11,19,15,5,0,10,4,4,0,0,4,0,0,0,0,62869
21694,1423,199,541,575,76,32,90,67,41,16,5,20,26,23,3,0,20,3,0,0,3,23,23,8,0,15,0,0,0,0,0,0,0,0,0,62870
21695,518,68,174,179,79,18,5,1,1,0,0,1,0,0,0,0,0,0,0,0,0,4,4,0,0,4,0,0,0,0,0,0,0,0,0,62871
21696,761,107,275,312,60,7,71,46,34,25,0,9,12,8,8,0,0,4,1,0,3,25,24,7,0,17,1,0,0,0,0,1,0,1,0,62872
21697,282,54,82,133,11,2,18,12,12,4,0,8,0,0,0,0,0,0,0,0,0,6,0,0,0,0,6,6,6,0,0,0,0,0,0,62874
21698,797,159,320,270,40,8,35,20,16,11,0,5,4,4,0,4,0,0,0,0,0,15,13,0,2,11,2,2,2,0,0,0,0,0,0,62875
21699,141,22,65,42,6,6,15,10,10,1,0,9,0,0,0,0,0,0,0,0,0,5,5,2,0,3,0,0,0,0,0,0,0,0,0,62876
21700,374,33,113,122,94,12,35,35,4,2,0,2,31,7,5,2,0,24,0,0,24,0,0,0,0,0,0,0,0,0,0,0,0,0,0,62877
21701,292,10,120,113,49,0,0,0,0,0,0,0,0,0,0,0,0,0,0,0,0,0,0,0,0,0,0,0,0,0,0,0,0,0,0,62878
21702,62,15,37,10,0,0,2,2,2,0,0,2,0,0,0,0,0,0,0,0,0,0,0,0,0,0,0,0,0,0,0,0,0,0,0,62879
21703,374,38,196,107,30,3,51,39,21,0,0,21,18,0,0,0,0,18,9,9,0,12,12,10,0,2,0,0,0,0,0,0,0,0,0,62880
21704,7602,931,2677,2618,955,421,580,293,204,99,19,86,89,39,15,5,19,50,17,17,16,287,248,104,0,144,39,5,5,0,0,34,8,0,26,62881
21705,1472,281,608,455,113,15,171,119,87,25,32,30,32,16,10,0,6,16,10,6,0,52,46,12,5,29,6,6,0,2,4,0,0,0,0,62882
21706,533,26,141,275,72,19,59,49,49,22,0,27,0,0,0,0,0,0,0,0,0,10,10,5,0,5,0,0,0,0,0,0,0,0,0,62883
21707,2022,147,930,689,173,83,171,78,26,8,11,7,52,11,11,0,0,41,24,17,0,93,93,28,8,57,0,0,0,0,0,0,0,0,0,62884
21708,605,203,231,133,14,24,15,0,0,0,0,0,0,0,0,0,0,0,0,0,0,15,7,7,0,0,8,0,0,0,0,8,0,0,8,62885
21709,356,31,152,154,19,0,44,11,7,2,0,5,4,0,0,0,0,4,0,0,4,33,29,4,0,25,4,4,4,0,0,0,0,0,0,62886
21710,185,8,68,59,46,4,11,2,2,0,0,2,0,0,0,0,0,0,0,0,0,9,9,0,2,7,0,0,0,0,0,0,0,0,0,62887
21711,1765,266,770,570,110,49,156,77,72,26,9,37,5,5,5,0,0,0,0,0,0,79,71,19,0,52,8,3,3,0,0,5,5,0,0,62888
21712,642,54,224,279,67,18,36,12,12,3,0,9,0,0,0,0,0,0,0,0,0,24,24,11,5,8,0,0,0,0,0,0,0,0,0,62889
21713,2071,225,851,740,207,48,157,106,91,27,3,61,15,4,0,4,0,11,0,11,0,51,44,12,2,30,7,7,0,7,0,0,0,0,0,62890
21714,471,76,186,177,24,8,25,6,2,2,0,0,4,4,0,0,4,0,0,0,0,19,19,0,0,19,0,0,0,0,0,0,0,0,0,62891
21715,174,24,54,77,17,2,6,0,0,0,0,0,0,0,0,0,0,0,0,0,0,6,6,0,0,6,0,0,0,0,0,0,0,0,0,62892
21716,659,64,238,256,26,75,36,24,18,0,0,18,6,6,6,0,0,0,0,0,0,12,11,5,0,6,1,1,0,0,1,0,0,0,0,62893
21717,645,44,247,281,46,27,61,30,28,7,0,21,2,0,0,0,0,2,0,0,2,31,28,6,0,22,3,3,0,0,3,0,0,0,0,62894
21718,1321,164,565,483,86,23,145,56,36,17,0,19,20,6,4,0,2,14,0,0,14,89,68,8,0,60,21,9,9,0,0,12,12,0,0,62895
21719,8507,1253,2910,3326,651,367,586,310,268,79,26,163,42,31,10,21,0,11,0,0,11,276,255,47,56,152,21,21,0,0,21,0,0,0,0,62896
21720,282,37,88,115,18,24,19,4,4,0,0,4,0,0,0,0,0,0,0,0,0,15,15,3,0,12,0,0,0,0,0,0,0,0,0,62897
21721,1393,145,458,502,172,116,174,111,107,32,27,48,4,4,4,0,0,0,0,0,0,63,45,8,0,37,18,18,15,3,0,0,0,0,0,62898
21722,1119,232,472,278,112,25,113,63,43,39,2,2,20,17,0,0,17,3,3,0,0,50,49,17,3,29,1,1,1,0,0,0,0,0,0,62899
21723,12604,1094,2264,3323,2705,3218,3444,1560,1508,139,50,1319,52,31,0,31,0,21,0,18,3,1884,1854,274,37,1543,30,24,17,6,1,6,0,0,6,62901
21724,2823,180,341,943,667,692,195,136,136,0,8,128,0,0,0,0,0,0,0,0,0,59,59,2,0,57,0,0,0,0,0,0,0,0,0,62902
21725,1402,56,124,444,329,449,166,39,39,0,0,39,0,0,0,0,0,0,0,0,0,127,102,24,9,69,25,25,25,0,0,0,0,0,0,62903
21726,530,81,183,198,47,21,39,26,15,6,0,9,11,11,11,0,0,0,0,0,0,13,12,0,0,12,1,1,1,0,0,0,0,0,0,62905
21727,5206,941,1645,1552,599,469,192,125,105,6,0,99,20,20,0,0,20,0,0,0,0,67,37,10,0,27,30,0,0,0,0,30,0,0,30,62906
21728,1612,194,557,569,230,62,97,50,43,19,3,21,7,5,5,0,0,2,0,2,0,47,47,5,0,42,0,0,0,0,0,0,0,0,0,62907
21729,255,33,97,78,39,8,6,4,4,0,0,4,0,0,0,0,0,0,0,0,0,2,2,0,0,2,0,0,0,0,0,0,0,0,0,62908
21730,1742,338,637,551,181,35,161,48,41,7,3,31,7,2,2,0,0,5,0,0,5,113,98,26,0,72,15,15,0,13,2,0,0,0,0,62910
21731,797,81,232,316,137,31,60,41,39,3,16,20,2,2,0,0,2,0,0,0,0,19,19,0,0,19,0,0,0,0,0,0,0,0,0,62912
21732,1819,462,561,634,116,46,138,98,78,0,20,58,20,20,0,20,0,0,0,0,0,40,40,0,5,35,0,0,0,0,0,0,0,0,0,62914
21733,184,16,43,94,22,9,34,34,0,0,0,0,34,10,10,0,0,24,0,0,24,0,0,0,0,0,0,0,0,0,0,0,0,0,0,62915
21734,503,82,242,148,28,3,23,8,8,5,1,2,0,0,0,0,0,0,0,0,0,15,1,0,0,1,14,0,0,0,0,14,0,0,14,62916
21735,1785,324,587,692,133,49,176,82,35,4,0,31,47,44,11,33,0,3,0,0,3,94,94,8,15,71,0,0,0,0,0,0,0,0,0,62917
21736,6403,522,1357,2334,1197,993,559,285,273,136,1,136,12,10,10,0,0,2,0,0,2,274,263,137,8,118,11,11,0,0,11,0,0,0,0,62918
21737,725,126,285,223,82,9,41,32,26,0,1,25,6,5,0,4,1,1,0,1,0,9,9,2,0,7,0,0,0,0,0,0,0,0,0,62919
21738,2381,311,626,782,361,301,254,130,130,18,16,96,0,0,0,0,0,0,0,0,0,124,80,9,19,52,44,34,0,0,34,10,0,10,0,62920
21739,331,100,112,99,20,0,15,0,0,0,0,0,0,0,0,0,0,0,0,0,0,15,12,0,0,12,3,0,0,0,0,3,0,0,3,62921
21740,2351,352,957,752,155,135,139,52,48,36,0,12,4,4,0,0,4,0,0,0,0,87,87,29,4,54,0,0,0,0,0,0,0,0,0,62922
21741,397,81,172,132,9,3,14,14,11,1,3,7,3,3,3,0,0,0,0,0,0,0,0,0,0,0,0,0,0,0,0,0,0,0,0,62923
21742,1912,246,592,684,217,173,88,45,34,0,0,34,11,10,0,0,10,1,0,1,0,43,40,5,2,33,3,2,2,0,0,1,1,0,0,62924
21743,1460,195,619,524,88,34,112,63,40,7,0,33,23,16,7,9,0,7,7,0,0,49,49,21,0,28,0,0,0,0,0,0,0,0,0,62926
21744,210,33,123,50,4,0,4,3,3,0,0,3,0,0,0,0,0,0,0,0,0,1,0,0,0,0,1,1,1,0,0,0,0,0,0,62927
21745,189,21,71,49,48,0,9,8,8,0,0,8,0,0,0,0,0,0,0,0,0,1,0,0,0,0,1,1,0,1,0,0,0,0,0,62928
21746,4160,616,1372,1641,413,118,347,218,192,67,16,109,26,15,0,15,0,11,0,11,0,129,94,17,10,67,35,35,25,10,0,0,0,0,0,62930
21747,1258,230,381,413,141,93,24,9,5,0,2,3,4,2,2,0,0,2,0,2,0,15,14,14,0,0,1,0,0,0,0,1,0,0,1,62931
21748,1155,200,426,413,92,24,56,34,23,0,0,23,11,11,5,5,1,0,0,0,0,22,18,0,0,18,4,4,0,0,4,0,0,0,0,62932
21749,773,62,276,286,124,25,27,12,12,3,3,6,0,0,0,0,0,0,0,0,0,15,0,0,0,0,15,15,15,0,0,0,0,0,0,62933
21750,702,120,235,217,93,37,60,30,30,21,0,9,0,0,0,0,0,0,0,0,0,30,30,16,0,14,0,0,0,0,0,0,0,0,0,62934
21751,1213,171,419,511,76,36,75,40,36,8,14,14,4,0,0,0,0,4,4,0,0,35,32,16,0,16,3,0,0,0,0,3,0,0,3,62935
21752,2174,292,764,838,149,131,204,115,66,28,11,27,49,10,5,0,5,39,20,0,19,89,66,9,5,52,23,23,16,0,7,0,0,0,0,62938
21753,2178,169,578,939,306,186,217,126,103,24,0,79,23,23,23,0,0,0,0,0,0,91,77,32,0,45,14,7,0,0,7,7,3,0,4,62939
21754,251,55,124,34,9,29,39,25,25,0,0,25,0,0,0,0,0,0,0,0,0,14,12,9,1,2,2,1,1,0,0,1,0,0,1,62940
21755,506,83,141,182,89,11,47,13,13,8,0,5,0,0,0,0,0,0,0,0,0,34,29,24,0,5,5,5,5,0,0,0,0,0,0,62941
21756,412,86,155,160,11,0,19,0,0,0,0,0,0,0,0,0,0,0,0,0,0,19,14,0,2,12,5,4,1,0,3,1,0,0,1,62942
21757,480,174,139,150,17,0,23,0,0,0,0,0,0,0,0,0,0,0,0,0,0,23,23,0,0,23,0,0,0,0,0,0,0,0,0,62943
21758,9094,1408,2753,3335,1087,511,677,424,337,49,21,267,87,37,19,0,18,50,28,12,10,253,209,50,32,127,44,12,12,0,0,32,0,15,17,62946
21759,499,79,199,139,8,74,41,34,34,0,0,34,0,0,0,0,0,0,0,0,0,7,7,0,7,0,0,0,0,0,0,0,0,0,0,62947
21760,8881,961,2198,3614,1508,600,406,224,209,54,9,146,15,0,0,0,0,15,0,15,0,182,172,23,3,146,10,10,0,0,10,0,0,0,0,62948
21761,556,93,197,203,53,10,4,0,0,0,0,0,0,0,0,0,0,0,0,0,0,4,4,2,0,2,0,0,0,0,0,0,0,0,0,62949
21762,165,30,91,27,17,0,0,0,0,0,0,0,0,0,0,0,0,0,0,0,0,0,0,0,0,0,0,0,0,0,0,0,0,0,0,62950
21763,3884,699,1504,1232,272,177,421,218,137,11,0,126,81,58,0,22,36,23,11,0,12,203,141,29,0,112,62,62,15,0,47,0,0,0,0,62951
21764,2189,370,741,641,345,92,190,115,79,31,7,41,36,0,0,0,0,36,12,0,24,75,71,7,2,62,4,4,0,4,0,0,0,0,0,62952
21765,187,18,85,51,33,0,20,16,14,3,0,11,2,2,2,0,0,0,0,0,0,4,4,0,0,4,0,0,0,0,0,0,0,0,0,62953
21766,386,35,208,102,30,11,17,4,4,4,0,0,0,0,0,0,0,0,0,0,0,13,13,0,0,13,0,0,0,0,0,0,0,0,0,62954
21767,614,116,221,219,28,30,69,33,18,0,0,18,15,15,15,0,0,0,0,0,0,36,23,0,2,21,13,7,7,0,0,6,0,0,6,62956
21768,761,166,328,197,58,12,67,42,33,22,0,11,9,9,6,0,3,0,0,0,0,25,24,0,0,24,1,1,0,0,1,0,0,0,0,62957
21769,1421,78,228,363,420,332,53,23,22,7,0,15,1,1,1,0,0,0,0,0,0,30,30,0,24,6,0,0,0,0,0,0,0,0,0,62958
21770,19528,1967,5515,7454,2546,2046,1216,574,505,144,27,334,69,53,29,0,24,16,0,16,0,642,553,176,64,313,89,89,36,35,18,0,0,0,0,62959
21771,8301,1296,2544,2969,1073,419,564,365,339,37,3,299,26,22,12,10,0,4,0,0,4,199,186,35,10,141,13,13,5,0,8,0,0,0,0,62960
21772,46,21,18,3,4,0,2,0,0,0,0,0,0,0,0,0,0,0,0,0,0,2,2,2,0,0,0,0,0,0,0,0,0,0,0,62961
21773,58,6,13,14,12,13,0,0,0,0,0,0,0,0,0,0,0,0,0,0,0,0,0,0,0,0,0,0,0,0,0,0,0,0,0,62962
21774,408,108,147,117,22,14,30,9,7,0,2,5,2,0,0,0,0,2,0,0,2,21,21,3,0,18,0,0,0,0,0,0,0,0,0,62963
21775,964,178,366,313,41,66,84,56,53,6,0,47,3,0,0,0,0,3,3,0,0,28,26,8,0,18,2,2,0,0,2,0,0,0,0,62964
21776,61,5,24,31,1,0,0,0,0,0,0,0,0,0,0,0,0,0,0,0,0,0,0,0,0,0,0,0,0,0,0,0,0,0,0,62965
21777,10900,1285,3342,3646,1598,1029,865,608,401,61,28,312,207,96,71,14,11,111,0,0,111,257,240,115,3,122,17,17,17,0,0,0,0,0,0,62966
21778,207,30,111,44,15,7,14,10,10,0,0,10,0,0,0,0,0,0,0,0,0,4,4,0,2,2,0,0,0,0,0,0,0,0,0,62967
21779,568,137,171,179,68,13,29,10,10,0,0,10,0,0,0,0,0,0,0,0,0,19,19,0,0,19,0,0,0,0,0,0,0,0,0,62969
21780,536,89,198,178,56,15,30,3,3,0,0,3,0,0,0,0,0,0,0,0,0,27,27,11,0,16,0,0,0,0,0,0,0,0,0,62970
21781,906,110,290,358,138,10,55,20,13,5,0,8,7,0,0,0,0,7,7,0,0,35,35,24,6,5,0,0,0,0,0,0,0,0,0,62972
21782,974,191,339,340,62,42,44,24,24,16,6,2,0,0,0,0,0,0,0,0,0,20,10,10,0,0,10,0,0,0,0,10,0,0,10,62974
21783,187,22,94,25,38,8,9,9,9,0,9,0,0,0,0,0,0,0,0,0,0,0,0,0,0,0,0,0,0,0,0,0,0,0,0,62975
21784,338,54,154,93,34,3,2,2,2,0,0,2,0,0,0,0,0,0,0,0,0,0,0,0,0,0,0,0,0,0,0,0,0,0,0,62976
21785,396,28,146,178,33,11,33,9,9,3,3,3,0,0,0,0,0,0,0,0,0,24,22,16,0,6,2,0,0,0,0,2,0,0,2,62977
21786,893,142,301,319,72,59,30,5,5,0,0,5,0,0,0,0,0,0,0,0,0,25,17,2,8,7,8,6,0,6,0,2,0,2,0,62979
21787,853,143,367,299,24,20,25,9,9,0,0,9,0,0,0,0,0,0,0,0,0,16,16,2,0,14,0,0,0,0,0,0,0,0,0,62982
21788,994,162,356,349,84,43,57,38,28,0,0,28,10,10,0,0,10,0,0,0,0,19,4,0,0,4,15,15,11,0,4,0,0,0,0,62983
21789,1319,293,430,507,61,28,67,28,28,0,13,15,0,0,0,0,0,0,0,0,0,39,30,4,10,16,9,0,0,0,0,9,0,0,9,62984
21790,988,163,457,327,31,10,66,21,20,6,0,14,1,1,0,0,1,0,0,0,0,45,45,0,0,45,0,0,0,0,0,0,0,0,0,62985
21791,625,68,251,278,23,5,62,40,20,11,0,9,20,20,0,20,0,0,0,0,0,22,15,6,0,9,7,7,7,0,0,0,0,0,0,62987
21792,1517,436,661,332,42,46,112,35,5,0,0,5,30,30,0,0,30,0,0,0,0,77,62,12,0,50,15,15,13,0,2,0,0,0,0,62988
21793,625,154,198,247,22,4,28,16,5,0,0,5,11,0,0,0,0,11,0,11,0,12,12,5,0,7,0,0,0,0,0,0,0,0,0,62990
21794,582,128,187,210,40,17,32,12,3,3,0,0,9,9,0,2,7,0,0,0,0,20,18,7,10,1,2,2,2,0,0,0,0,0,0,62992
21795,446,44,147,195,42,18,16,7,7,3,0,4,0,0,0,0,0,0,0,0,0,9,6,6,0,0,3,3,2,1,0,0,0,0,0,62994
21796,3811,770,1385,1167,386,103,216,148,98,35,3,60,50,18,2,7,9,32,0,0,32,68,49,23,0,26,19,19,10,9,0,0,0,0,0,62995
21797,434,103,79,147,49,56,18,18,18,7,11,0,0,0,0,0,0,0,0,0,0,0,0,0,0,0,0,0,0,0,0,0,0,0,0,62996
21798,316,66,146,87,9,8,22,11,11,3,0,8,0,0,0,0,0,0,0,0,0,11,11,0,0,11,0,0,0,0,0,0,0,0,0,62997
21799,227,57,91,60,19,0,56,40,19,0,9,10,21,21,0,21,0,0,0,0,0,16,16,0,0,16,0,0,0,0,0,0,0,0,0,62998
21800,1274,191,496,428,120,39,198,116,89,12,0,77,27,27,23,0,4,0,0,0,0,82,63,0,4,59,19,19,19,0,0,0,0,0,0,62999
21801,11182,99,906,1875,4792,3510,1146,566,542,149,18,375,24,6,6,0,0,18,18,0,0,580,580,164,105,311,0,0,0,0,0,0,0,0,0,63005
21802,24594,2837,7995,8967,3555,1240,1715,1074,955,395,128,432,119,77,51,14,12,42,20,0,22,641,528,180,33,315,113,71,39,0,32,42,42,0,0,63010
21803,25122,1002,3715,6295,8758,5352,2142,1133,1035,418,47,570,98,79,25,14,40,19,0,0,19,1009,955,512,28,415,54,54,41,13,0,0,0,0,0,63011
21804,6963,666,2502,2778,731,286,656,263,164,25,26,113,99,43,43,0,0,56,56,0,0,393,340,129,46,165,53,53,28,25,0,0,0,0,0,63012
21805,1166,105,394,398,152,117,120,120,120,70,15,35,0,0,0,0,0,0,0,0,0,0,0,0,0,0,0,0,0,0,0,0,0,0,0,63013
21806,326,39,136,74,68,9,33,16,16,14,2,0,0,0,0,0,0,0,0,0,0,17,17,15,0,2,0,0,0,0,0,0,0,0,0,63014
21807,1477,270,641,478,72,16,159,82,64,12,0,52,18,6,6,0,0,12,12,0,0,77,77,47,8,22,0,0,0,0,0,0,0,0,0,63015
21808,5044,818,1984,1684,312,246,541,312,214,68,4,142,98,78,17,0,61,20,1,0,19,229,220,104,46,70,9,9,9,0,0,0,0,0,0,63016
21809,30737,1000,3751,6622,10700,8664,1835,1066,1028,388,49,591,38,38,17,0,21,0,0,0,0,769,755,174,50,531,14,14,14,0,0,0,0,0,0,63017
21810,2954,308,913,1155,412,166,192,77,77,61,0,16,0,0,0,0,0,0,0,0,0,115,83,24,17,42,32,32,32,0,0,0,0,0,0,63019
21811,13824,2628,5187,4635,939,435,864,477,357,87,33,237,120,16,16,0,0,104,34,54,16,387,307,25,46,236,80,35,13,0,22,45,0,0,45,63020
21812,37755,1276,5972,10257,12490,7760,3285,1488,1369,728,134,507,119,83,30,44,9,36,20,0,16,1797,1595,862,71,662,202,202,101,20,81,0,0,0,0,63021
21813,3993,598,1514,1467,260,154,204,101,87,9,0,78,14,14,14,0,0,0,0,0,0,103,90,13,0,77,13,13,13,0,0,0,0,0,0,63023
21814,8541,501,1909,2517,2470,1144,837,333,292,109,12,171,41,9,9,0,0,32,0,0,32,504,488,152,22,314,16,16,0,0,16,0,0,0,0,63025
21815,29510,2434,7563,9622,6715,3176,2252,1259,1134,405,83,646,125,125,109,16,0,0,0,0,0,993,984,473,62,449,9,0,0,0,0,9,9,0,0,63026
21816,17907,2139,5939,6513,2013,1303,1413,702,643,281,143,219,59,33,18,15,0,26,12,0,14,711,632,207,81,344,79,64,64,0,0,15,15,0,0,63028
21817,238,68,72,98,0,0,32,10,10,3,7,0,0,0,0,0,0,0,0,0,0,22,22,20,0,2,0,0,0,0,0,0,0,0,0,63030
21818,32729,2647,10166,12513,5013,2390,3231,1620,1379,412,267,700,241,141,17,90,34,100,18,44,38,1611,1475,528,130,817,136,85,63,0,22,51,28,23,0,63031
21819,27696,2365,7350,10414,4992,2575,2750,1638,1442,319,258,865,196,138,74,0,64,58,26,0,32,1112,1020,337,145,538,92,16,16,0,0,76,0,11,65,63033
21820,12360,816,2852,4129,2589,1974,1338,691,606,119,60,427,85,69,0,12,57,16,16,0,0,647,598,256,24,318,49,49,0,0,49,0,0,0,0,63034
21821,643,164,351,123,5,0,23,23,10,10,0,0,13,13,0,0,13,0,0,0,0,0,0,0,0,0,0,0,0,0,0,0,0,0,0,63036
21822,2239,415,829,771,128,96,79,18,14,0,7,7,4,0,0,0,0,4,0,0,4,61,38,19,0,19,23,16,5,0,11,7,4,0,3,63037
21823,4471,128,622,1157,1484,1080,368,233,233,87,0,146,0,0,0,0,0,0,0,0,0,135,135,66,20,49,0,0,0,0,0,0,0,0,0,63038
21824,816,48,476,250,42,0,52,52,52,52,0,0,0,0,0,0,0,0,0,0,0,0,0,0,0,0,0,0,0,0,0,0,0,0,0,63039
21825,5418,59,468,1506,2221,1164,596,348,302,54,44,204,46,15,15,0,0,31,0,0,31,248,237,150,0,87,11,0,0,0,0,11,0,0,11,63040
21826,274,61,93,115,5,0,12,0,0,0,0,0,0,0,0,0,0,0,0,0,0,12,12,0,0,12,0,0,0,0,0,0,0,0,0,63041
21827,13373,1352,4285,5298,1561,877,841,595,500,72,88,340,95,95,42,53,0,0,0,0,0,246,222,64,0,158,24,24,0,24,0,0,0,0,0,63042
21828,16089,1378,3787,4968,3677,2279,959,444,321,128,12,181,123,123,59,64,0,0,0,0,0,515,468,98,31,339,47,47,25,22,0,0,0,0,0,63043
21829,7633,524,2493,2319,1538,759,481,250,203,50,59,94,47,47,36,0,11,0,0,0,0,231,223,52,0,171,8,8,8,0,0,0,0,0,0,63044
21830,0,0,0,0,0,0,0,0,0,0,0,0,0,0,0,0,0,0,0,0,0,0,0,0,0,0,0,0,0,0,0,0,0,0,0,63045
21831,0,0,0,0,0,0,0,0,0,0,0,0,0,0,0,0,0,0,0,0,0,0,0,0,0,0,0,0,0,0,0,0,0,0,0,63047
21832,2271,342,695,911,253,70,210,93,79,20,0,59,14,14,14,0,0,0,0,0,0,117,111,65,0,46,6,6,0,0,6,0,0,0,0,63048
21833,10929,1018,3906,3605,1661,739,711,362,321,176,23,122,41,26,12,14,0,15,0,0,15,349,203,74,49,80,146,104,104,0,0,42,42,0,0,63049
21834,10308,1187,3657,3977,775,712,981,553,486,125,40,321,67,58,43,10,5,9,0,0,9,428,358,116,27,215,70,25,3,8,14,45,25,9,11,63050
21835,9747,1346,3695,3438,902,366,724,434,367,74,73,220,67,28,7,21,0,39,0,0,39,290,290,154,31,105,0,0,0,0,0,0,0,0,0,63051
21836,16068,1864,5724,5766,1884,830,1495,831,732,270,112,350,99,79,62,0,17,20,0,20,0,664,531,205,51,275,133,116,73,0,43,17,0,0,17,63052
21837,61,0,19,33,9,0,3,3,3,1,0,2,0,0,0,0,0,0,0,0,0,0,0,0,0,0,0,0,0,0,0,0,0,0,0,63053
21838,1510,193,602,350,170,195,99,62,62,11,13,38,0,0,0,0,0,0,0,0,0,37,25,0,0,25,12,12,12,0,0,0,0,0,0,63055
21839,1387,201,510,534,93,49,130,121,62,22,0,40,59,11,11,0,0,48,46,0,2,9,7,7,0,0,2,0,0,0,0,2,0,0,2,63056
21840,61,9,18,3,3,28,0,0,0,0,0,0,0,0,0,0,0,0,0,0,0,0,0,0,0,0,0,0,0,0,0,0,0,0,0,63057
21841,1815,251,601,767,102,94,266,174,144,38,45,61,30,30,14,16,0,0,0,0,0,92,92,11,0,81,0,0,0,0,0,0,0,0,0,63060
21842,187,53,72,42,20,0,0,0,0,0,0,0,0,0,0,0,0,0,0,0,0,0,0,0,0,0,0,0,0,0,0,0,0,0,0,63061
21843,3400,388,1259,1168,452,133,236,145,134,32,6,96,11,0,0,0,0,11,11,0,0,91,86,53,4,29,5,0,0,0,0,5,5,0,0,63068
21844,9976,1285,3137,3247,1202,1105,738,414,278,103,0,175,136,72,20,0,52,64,47,17,0,324,263,107,2,154,61,34,0,0,34,27,0,0,27,63069
21845,5110,778,1826,1725,592,189,358,193,145,86,8,51,48,35,25,10,0,13,0,0,13,165,121,25,15,81,44,44,44,0,0,0,0,0,0,63070
21846,911,277,333,277,12,12,111,36,22,0,4,18,14,14,12,0,2,0,0,0,0,75,42,8,0,34,33,11,11,0,0,22,0,0,22,63071
21847,2243,553,858,648,76,108,138,59,59,14,16,29,0,0,0,0,0,0,0,0,0,79,79,43,0,36,0,0,0,0,0,0,0,0,0,63072
21848,394,0,63,34,154,143,0,0,0,0,0,0,0,0,0,0,0,0,0,0,0,0,0,0,0,0,0,0,0,0,0,0,0,0,0,63073
21849,10463,1575,3305,3961,1166,456,717,291,180,29,0,151,111,111,91,20,0,0,0,0,0,426,336,102,36,198,90,48,31,0,17,42,0,42,0,63074
21850,7557,1799,3125,2052,335,246,625,434,318,54,34,230,116,68,58,10,0,48,0,0,48,191,153,41,7,105,38,33,14,0,19,5,5,0,0,63077
21851,9,0,0,9,0,0,0,0,0,0,0,0,0,0,0,0,0,0,0,0,0,0,0,0,0,0,0,0,0,0,0,0,0,0,0,63079
21852,9017,2032,3219,2663,771,332,807,465,362,20,5,337,103,61,3,58,0,42,0,32,10,342,288,81,20,187,54,18,4,0,14,36,5,22,9,63080
21853,12212,1500,3605,4520,1765,822,887,412,301,166,41,94,111,95,40,0,55,16,0,0,16,475,451,209,37,205,24,24,24,0,0,0,0,0,0,63084
21854,674,216,234,173,41,10,32,32,15,0,0,15,17,0,0,0,0,17,0,17,0,0,0,0,0,0,0,0,0,0,0,0,0,0,0,63087
21855,5992,680,1057,1774,1384,1097,168,52,52,24,15,13,0,0,0,0,0,0,0,0,0,116,98,32,0,66,18,18,18,0,0,0,0,0,0,63088
21856,3833,496,1449,1273,331,284,198,70,54,33,0,21,16,0,0,0,0,16,0,16,0,128,128,70,24,34,0,0,0,0,0,0,0,0,0,63089
21857,14645,1370,4275,5176,2474,1350,1256,451,433,107,55,271,18,18,18,0,0,0,0,0,0,805,700,360,21,319,105,88,88,0,0,17,0,0,17,63090
21858,796,101,357,204,97,37,50,15,13,9,0,4,2,0,0,0,0,2,2,0,0,35,31,9,0,22,4,2,2,0,0,2,2,0,0,63091
21859,2006,182,206,506,662,450,130,49,49,0,0,49,0,0,0,0,0,0,0,0,0,81,79,0,0,79,2,0,0,0,0,2,0,0,2,63101
21860,1732,243,302,465,426,296,50,50,7,0,0,7,43,17,0,0,17,26,0,0,26,0,0,0,0,0,0,0,0,0,0,0,0,0,0,63102
21861,4677,549,757,1404,1362,605,521,136,136,37,0,99,0,0,0,0,0,0,0,0,0,385,373,208,23,142,12,0,0,0,0,12,0,0,12,63103
21862,13312,1519,2119,3560,3353,2761,833,320,250,10,24,216,70,38,15,0,23,32,0,0,32,513,445,70,38,337,68,68,45,23,0,0,0,0,0,63104
21863,11045,321,796,1385,3569,4974,2066,1064,964,212,18,734,100,40,0,0,40,60,0,0,60,1002,1002,323,20,659,0,0,0,0,0,0,0,0,0,63105
21864,5918,1744,1684,2042,318,130,806,456,429,12,10,407,27,12,0,0,12,15,0,0,15,350,283,74,76,133,67,46,0,0,46,21,0,21,0,63106
21865,7721,2032,2526,2131,697,335,857,415,382,32,33,317,33,28,0,13,15,5,0,0,5,442,370,39,10,321,72,17,11,6,0,55,4,51,0,63107
21866,13493,1454,1810,2737,3456,4036,1840,674,600,94,68,438,74,26,8,18,0,48,0,48,0,1166,1149,233,172,744,17,5,0,5,0,12,0,0,12,63108
21867,20570,1533,4409,5984,5214,3430,692,443,369,99,108,162,74,74,0,0,74,0,0,0,0,249,228,106,0,122,21,0,0,0,0,21,0,0,21,63109
21868,11748,1565,2064,3241,2482,2396,1061,435,370,79,24,267,65,18,0,18,0,47,17,0,30,626,617,110,0,507,9,9,0,9,0,0,0,0,0,63110
21869,14008,3552,4720,3894,1273,569,1004,720,508,69,89,350,212,125,52,73,0,87,44,16,27,284,143,32,13,98,141,85,27,19,39,56,0,0,56,63111
21870,12980,2279,2959,3427,2176,2139,1119,592,487,57,58,372,105,99,78,8,13,6,6,0,0,527,484,147,99,238,43,21,6,5,10,22,0,0,22,63112
21871,7989,1666,2754,2724,564,281,760,405,357,52,60,245,48,35,0,16,19,13,0,13,0,355,305,117,43,145,50,38,0,15,23,12,0,5,7,63113
21872,24121,3525,8064,8281,3110,1141,1827,971,647,105,51,491,324,114,71,43,0,210,90,31,89,856,700,273,44,383,156,102,31,36,35,54,29,25,0,63114
21873,12879,3107,3953,4296,946,577,1441,704,598,81,32,485,106,52,0,30,22,54,0,41,13,737,578,137,64,377,159,112,82,30,0,47,28,0,19,63115
21874,31043,5726,7995,8671,5511,3140,2085,1151,872,67,217,588,279,126,87,0,39,153,62,46,45,934,724,265,96,363,210,106,87,0,19,104,27,0,77,63116
21875,7013,308,683,1449,2261,2312,211,117,117,46,0,71,0,0,0,0,0,0,0,0,0,94,83,57,0,26,11,0,0,0,0,11,0,0,11,63117
21876,17220,3686,5090,4784,2191,1469,1580,578,357,97,34,226,221,75,42,19,14,146,23,14,109,1002,750,145,28,577,252,129,31,40,58,123,19,0,104,63118
21877,23992,990,2884,6082,7395,6641,1792,893,869,170,100,599,24,12,12,0,0,12,0,12,0,899,878,187,31,660,21,18,0,18,0,3,0,0,3,63119
21878,5392,1415,2071,1460,288,158,801,375,269,15,46,208,106,34,12,12,10,72,0,0,72,426,315,14,21,280,111,46,36,10,0,65,32,0,33,63120
21879,17099,2588,5079,5870,1853,1709,1915,1051,876,136,90,650,175,126,63,50,13,49,0,39,10,864,763,159,90,514,101,87,79,3,5,14,0,1,13,63121
21880,27694,760,3357,5870,10346,7361,1694,765,751,219,29,503,14,14,14,0,0,0,0,0,0,929,905,273,27,605,24,11,0,11,0,13,11,0,2,63122
21881,35693,3193,10483,10926,7533,3558,2265,1205,1061,435,72,554,144,113,44,51,18,31,18,13,0,1060,978,399,85,494,82,29,16,13,0,53,15,12,26,63123
21882,7369,194,545,985,2625,3020,572,276,257,26,6,225,19,11,0,11,0,8,0,0,8,296,296,40,0,256,0,0,0,0,0,0,0,0,0,63124
21883,22628,3592,8338,6697,2943,1058,1726,864,734,282,113,339,130,81,39,15,27,49,13,36,0,862,650,338,86,226,212,92,28,0,64,120,51,40,29,63125
21884,10702,498,2312,3198,3054,1640,723,379,286,85,19,182,93,93,13,49,31,0,0,0,0,344,296,126,0,170,48,48,48,0,0,0,0,0,0,63126
21885,3425,210,819,799,1020,577,192,103,103,38,12,53,0,0,0,0,0,0,0,0,0,89,89,61,0,28,0,0,0,0,0,0,0,0,0,63127
21886,22286,1315,5137,6932,5901,3001,1045,517,485,159,29,297,32,17,17,0,0,15,0,15,0,528,521,217,101,203,7,7,0,7,0,0,0,0,0,63128
21887,37351,2352,10369,11925,8832,3873,2787,1526,1390,439,128,823,136,136,96,11,29,0,0,0,0,1261,1178,495,67,616,83,71,24,14,33,12,0,0,12,63129
21888,20688,1931,2907,5142,4891,5817,2202,922,887,320,78,489,35,25,0,25,0,10,0,10,0,1280,1260,305,78,877,20,20,20,0,0,0,0,0,0,63130
21889,12225,149,888,2024,4643,4521,1060,482,482,128,0,354,0,0,0,0,0,0,0,0,0,578,575,245,31,299,3,0,0,0,0,3,0,0,3,63131
21890,9366,877,1339,2235,2338,2577,527,200,173,11,14,148,27,12,12,0,0,15,0,0,15,327,278,144,0,134,49,49,33,0,16,0,0,0,0,63132
21891,5066,1115,1931,1713,208,99,552,247,170,7,15,148,77,60,15,35,10,17,0,0,17,305,269,50,29,190,36,30,0,30,0,6,0,6,0,63133
21892,8681,1498,3068,3028,757,330,1038,379,269,94,2,173,110,105,35,49,21,5,0,5,0,659,482,58,68,356,177,22,22,0,0,155,92,0,63,63134
21893,13704,1534,4116,5012,1984,1058,1295,625,472,95,87,290,153,88,58,30,0,65,9,9,47,670,498,118,44,336,172,138,27,33,78,34,5,0,29,63135
21894,29282,5497,9991,10264,2418,1112,3297,1807,1330,109,379,842,477,307,96,154,57,170,20,46,104,1490,1258,282,212,764,232,187,82,46,59,45,0,0,45,63136
21895,12507,2101,3872,5090,936,508,1544,660,501,64,113,324,159,99,0,0,99,60,25,11,24,884,736,121,150,465,148,69,23,46,0,79,0,0,79,63137
21896,12128,1648,4082,4212,1476,710,1007,548,472,55,79,338,76,50,47,0,3,26,26,0,0,459,322,122,10,190,137,137,100,0,37,0,0,0,0,63138
21897,17345,1727,3416,5213,3865,3124,380,236,198,46,19,133,38,38,38,0,0,0,0,0,0,144,144,48,19,77,0,0,0,0,0,0,0,0,0,63139
21898,163,42,73,45,1,2,26,9,9,0,0,9,0,0,0,0,0,0,0,0,0,17,17,0,0,17,0,0,0,0,0,0,0,0,0,63140
21899,14107,351,812,2658,5071,5215,1135,639,620,189,69,362,19,0,0,0,0,19,0,0,19,496,467,124,0,343,29,8,0,0,8,21,0,0,21,63141
21900,7424,728,1547,2385,1822,942,296,165,73,29,14,30,92,82,51,31,0,10,10,0,0,131,123,55,20,48,8,0,0,0,0,8,0,0,8,63143
21901,6514,187,953,1388,2186,1800,372,184,184,61,9,114,0,0,0,0,0,0,0,0,0,188,175,61,0,114,13,13,13,0,0,0,0,0,0,63144
21902,22086,1025,3625,5423,6496,5517,1273,665,560,121,65,374,105,95,43,6,46,10,0,10,0,608,560,79,11,470,48,48,0,9,39,0,0,0,0,63146
21903,7026,1586,2396,2391,475,178,743,441,280,25,84,171,161,106,72,0,34,55,0,0,55,302,210,26,24,160,92,66,29,37,0,26,12,0,14,63147
21904,0,0,0,0,0,0,0,0,0,0,0,0,0,0,0,0,0,0,0,0,0,0,0,0,0,0,0,0,0,0,0,0,0,0,0,63155
21905,32808,3609,10231,9752,6115,3101,3303,1801,1572,404,136,1032,229,112,18,59,35,117,47,30,40,1502,1414,469,127,818,88,39,15,0,24,49,49,0,0,63301
21906,31865,1833,7761,9700,8114,4457,2081,1119,975,305,53,617,144,41,0,15,26,103,30,41,32,962,921,374,104,443,41,21,8,13,0,20,0,20,0,63303
21907,26708,1331,5912,8246,7121,4098,2467,1170,1025,433,106,486,145,101,68,13,20,44,35,0,9,1297,1237,538,142,557,60,60,29,0,31,0,0,0,0,63304
21908,113,10,78,10,9,6,0,0,0,0,0,0,0,0,0,0,0,0,0,0,0,0,0,0,0,0,0,0,0,0,0,0,0,0,0,63330
21909,1016,26,244,282,322,142,40,12,12,0,11,1,0,0,0,0,0,0,0,0,0,28,28,7,0,21,0,0,0,0,0,0,0,0,0,63332
21910,561,155,239,127,29,11,37,12,12,1,11,0,0,0,0,0,0,0,0,0,0,25,11,2,2,7,14,10,10,0,0,4,0,0,4,63333
21911,6523,1482,2811,1571,469,190,414,228,171,78,18,75,57,35,11,0,24,22,0,0,22,186,177,14,20,143,9,0,0,0,0,9,0,0,9,63334
21912,769,100,358,198,78,35,40,19,10,0,0,10,9,0,0,0,0,9,0,0,9,21,21,1,2,18,0,0,0,0,0,0,0,0,0,63336
21913,660,235,270,106,49,0,49,33,5,4,1,0,28,2,0,2,0,26,11,15,0,16,14,8,0,6,2,0,0,0,0,2,0,0,2,63339
21914,2612,106,843,843,589,231,154,57,45,32,0,13,12,0,0,0,0,12,12,0,0,97,97,13,59,25,0,0,0,0,0,0,0,0,0,63341
21915,2875,644,1133,781,218,99,280,144,140,14,14,112,4,0,0,0,0,4,0,4,0,136,91,13,2,76,45,34,21,0,13,11,11,0,0,63343
21916,1138,126,425,363,99,125,137,77,61,30,1,30,16,8,4,4,0,8,0,0,8,60,58,19,6,33,2,2,2,0,0,0,0,0,0,63344
21917,358,63,178,56,40,21,17,10,7,2,1,4,3,0,0,0,0,3,3,0,0,7,4,4,0,0,3,0,0,0,0,3,0,0,3,63345
21918,2046,346,849,696,92,63,199,100,97,20,0,77,3,0,0,0,0,3,0,3,0,99,96,27,46,23,3,0,0,0,0,3,0,3,0,63347
21919,4084,291,1287,1436,849,221,348,176,176,37,33,106,0,0,0,0,0,0,0,0,0,172,135,93,19,23,37,28,28,0,0,9,0,0,9,63348
21920,1081,343,313,205,149,71,55,13,10,3,6,1,3,1,1,0,0,2,0,0,2,42,42,23,0,19,0,0,0,0,0,0,0,0,0,63349
21921,547,136,212,153,34,12,5,4,4,2,2,0,0,0,0,0,0,0,0,0,0,1,0,0,0,0,1,1,1,0,0,0,0,0,0,63350
21922,1215,204,570,302,85,54,54,10,6,0,0,6,4,0,0,0,0,4,0,0,4,44,41,13,2,26,3,0,0,0,0,3,0,0,3,63351
21923,669,95,358,171,34,11,42,27,22,5,0,17,5,0,0,0,0,5,5,0,0,15,0,0,0,0,15,15,13,0,2,0,0,0,0,63352
21924,3043,585,1381,803,173,101,244,155,105,14,14,77,50,33,24,9,0,17,0,0,17,89,49,13,0,36,40,27,27,0,0,13,13,0,0,63353
21925,3755,473,1280,1306,498,198,254,168,138,47,44,47,30,30,0,12,18,0,0,0,0,86,69,69,0,0,17,17,17,0,0,0,0,0,0,63357
21926,806,180,345,182,82,17,65,42,19,13,0,6,23,23,23,0,0,0,0,0,0,23,23,6,1,16,0,0,0,0,0,0,0,0,0,63359
21927,3118,474,1136,975,367,166,222,112,86,4,0,82,26,11,2,9,0,15,0,0,15,110,102,36,16,50,8,8,8,0,0,0,0,0,0,63361
21928,3804,716,1539,1059,403,87,360,180,88,6,26,56,92,54,27,27,0,38,10,19,9,180,152,22,43,87,28,0,0,0,0,28,6,0,22,63362
21929,1388,289,644,367,71,17,107,60,48,12,15,21,12,4,0,4,0,8,0,0,8,47,47,14,20,13,0,0,0,0,0,0,0,0,0,63363
21930,30688,2659,9343,10071,5981,2634,2125,1131,1025,399,90,536,106,89,50,14,25,17,6,11,0,994,846,339,111,396,148,100,100,0,0,48,32,0,16,63366
21931,13698,314,2740,4543,3893,2208,979,517,475,176,39,260,42,42,34,8,0,0,0,0,0,462,427,208,48,171,35,35,35,0,0,0,0,0,0,63367
21932,27149,1262,5976,7827,7956,4128,2406,1402,1262,476,83,703,140,140,118,22,0,0,0,0,0,1004,989,592,84,313,15,15,0,0,15,0,0,0,0,63368
21933,1381,186,526,418,164,87,56,34,34,3,9,22,0,0,0,0,0,0,0,0,0,22,21,0,16,5,1,1,1,0,0,0,0,0,0,63369
21934,17,9,0,8,0,0,0,0,0,0,0,0,0,0,0,0,0,0,0,0,0,0,0,0,0,0,0,0,0,0,0,0,0,0,0,63370
21935,420,58,210,118,29,5,56,45,45,4,3,38,0,0,0,0,0,0,0,0,0,11,11,8,1,2,0,0,0,0,0,0,0,0,0,63373
21936,48420,2795,12760,17288,10694,4883,4118,1979,1754,663,86,1005,225,194,133,9,52,31,31,0,0,2139,2039,785,105,1149,100,100,80,0,20,0,0,0,0,63376
21937,1793,313,795,538,97,50,256,128,118,6,54,58,10,10,10,0,0,0,0,0,0,128,128,73,0,55,0,0,0,0,0,0,0,0,0,63377
21938,15372,1673,6431,4799,1593,876,1095,559,511,187,71,253,48,18,18,0,0,30,0,0,30,536,423,182,23,218,113,113,68,31,14,0,0,0,0,63379
21939,328,64,124,99,31,10,14,14,14,0,0,14,0,0,0,0,0,0,0,0,0,0,0,0,0,0,0,0,0,0,0,0,0,0,0,63381
21940,3753,825,1797,807,225,99,233,177,135,12,5,118,42,12,0,0,12,30,0,0,30,56,43,7,2,34,13,11,0,0,11,2,0,0,2,63382
21941,10091,1704,3821,3021,896,649,869,480,366,114,25,227,114,61,50,0,11,53,0,39,14,389,345,228,7,110,44,29,11,0,18,15,0,15,0,63383
21942,1341,252,715,259,54,61,81,51,45,15,0,30,6,6,0,0,6,0,0,0,0,30,30,11,2,17,0,0,0,0,0,0,0,0,0,63384
21943,22349,1263,6094,7858,5036,2098,1918,1007,965,384,72,509,42,34,34,0,0,8,8,0,0,911,850,474,43,333,61,0,0,0,0,61,15,46,0,63385
21944,422,100,181,95,40,6,53,36,20,7,10,3,16,8,0,3,5,8,0,0,8,17,14,6,0,8,3,0,0,0,0,3,0,0,3,63386
21945,56,22,18,14,2,0,0,0,0,0,0,0,0,0,0,0,0,0,0,0,0,0,0,0,0,0,0,0,0,0,0,0,0,0,0,63387
21946,541,135,261,77,48,20,36,14,14,0,0,14,0,0,0,0,0,0,0,0,0,22,22,0,0,22,0,0,0,0,0,0,0,0,0,63388
21947,4341,625,2001,1233,322,160,449,235,181,21,25,135,54,22,22,0,0,32,32,0,0,214,162,36,42,84,52,49,49,0,0,3,3,0,0,63389
21948,7159,1140,2572,2372,746,329,620,366,256,25,22,209,110,82,4,62,16,28,0,0,28,254,254,54,64,136,0,0,0,0,0,0,0,0,0,63390
21949,14551,2318,5477,4028,1828,900,1131,470,374,161,22,191,96,70,52,0,18,26,0,26,0,661,552,177,14,361,109,71,61,4,6,38,26,12,0,63401
21950,385,72,158,109,26,20,16,7,7,0,0,7,0,0,0,0,0,0,0,0,0,9,6,6,0,0,3,0,0,0,0,3,0,0,3,63430
21951,117,12,75,21,0,9,0,0,0,0,0,0,0,0,0,0,0,0,0,0,0,0,0,0,0,0,0,0,0,0,0,0,0,0,0,63431
21952,325,45,152,80,32,16,15,4,4,0,0,4,0,0,0,0,0,0,0,0,0,11,2,0,0,2,9,0,0,0,0,9,9,0,0,63432
21953,31,24,7,0,0,0,0,0,0,0,0,0,0,0,0,0,0,0,0,0,0,0,0,0,0,0,0,0,0,0,0,0,0,0,0,63433
21954,482,17,178,228,39,20,67,54,47,9,5,33,7,6,0,6,0,1,0,0,1,13,4,2,0,2,9,9,0,0,9,0,0,0,0,63434
21955,2567,308,1029,802,319,109,362,171,136,44,0,92,35,12,12,0,0,23,0,0,23,191,144,81,0,63,47,11,4,7,0,36,0,4,32,63435
21956,859,89,529,199,39,3,24,15,15,2,0,13,0,0,0,0,0,0,0,0,0,9,7,7,0,0,2,2,0,0,2,0,0,0,0,63436
21957,905,80,476,249,58,42,84,37,37,8,7,22,0,0,0,0,0,0,0,0,0,47,38,23,0,15,9,9,9,0,0,0,0,0,0,63437
21958,488,53,164,212,22,37,9,9,9,0,0,9,0,0,0,0,0,0,0,0,0,0,0,0,0,0,0,0,0,0,0,0,0,0,0,63438
21959,44,0,34,10,0,0,0,0,0,0,0,0,0,0,0,0,0,0,0,0,0,0,0,0,0,0,0,0,0,0,0,0,0,0,0,63439
21960,1099,92,558,394,42,13,41,27,27,9,0,18,0,0,0,0,0,0,0,0,0,14,14,4,1,9,0,0,0,0,0,0,0,0,0,63440
21961,760,139,290,261,50,20,79,53,38,26,0,12,15,12,0,2,10,3,0,0,3,26,25,0,0,25,1,0,0,0,0,1,0,0,1,63441
21962,386,64,239,71,12,0,8,8,4,0,0,4,4,4,0,0,4,0,0,0,0,0,0,0,0,0,0,0,0,0,0,0,0,0,0,63443
21963,2493,294,1012,841,267,79,202,96,81,26,0,55,15,0,0,0,0,15,15,0,0,106,104,30,31,43,2,2,2,0,0,0,0,0,0,63445
21964,498,124,200,116,26,32,33,14,8,0,4,4,6,0,0,0,0,6,6,0,0,19,8,0,0,8,11,0,0,0,0,11,5,0,6,63446
21965,806,132,404,214,19,37,27,6,6,2,0,4,0,0,0,0,0,0,0,0,0,21,3,0,0,3,18,18,0,0,18,0,0,0,0,63447
21966,1118,179,513,301,84,41,62,34,19,9,2,8,15,3,3,0,0,12,0,0,12,28,13,2,2,9,15,6,3,3,0,9,0,9,0,63448
21967,109,5,49,48,7,0,0,0,0,0,0,0,0,0,0,0,0,0,0,0,0,0,0,0,0,0,0,0,0,0,0,0,0,0,0,63450
21968,191,10,103,45,10,23,3,3,3,0,0,3,0,0,0,0,0,0,0,0,0,0,0,0,0,0,0,0,0,0,0,0,0,0,0,63451
21969,717,96,357,211,51,2,51,38,28,5,0,23,10,5,0,5,0,5,0,0,5,13,8,8,0,0,5,2,0,0,2,3,0,0,3,63452
21970,402,54,185,109,31,23,37,14,14,2,0,12,0,0,0,0,0,0,0,0,0,23,23,16,0,7,0,0,0,0,0,0,0,0,0,63453
21971,619,57,269,210,54,29,24,21,16,1,10,5,5,5,0,5,0,0,0,0,0,3,3,0,0,3,0,0,0,0,0,0,0,0,0,63454
21972,2836,310,1227,825,285,189,129,54,49,15,11,23,5,5,0,0,5,0,0,0,0,75,74,12,14,48,1,1,0,0,1,0,0,0,0,63456
21973,170,27,89,38,11,5,27,16,14,9,0,5,2,2,0,0,2,0,0,0,0,11,11,11,0,0,0,0,0,0,0,0,0,0,0,63457
21974,173,24,53,22,38,36,1,0,0,0,0,0,0,0,0,0,0,0,0,0,0,1,1,0,0,1,0,0,0,0,0,0,0,0,0,63458
21975,2908,298,1338,777,320,175,299,155,104,3,12,89,51,23,16,0,7,28,0,16,12,144,112,47,4,61,32,32,12,20,0,0,0,0,0,63459
21976,280,34,155,49,37,5,7,5,5,0,0,5,0,0,0,0,0,0,0,0,0,2,0,0,0,0,2,0,0,0,0,2,0,0,2,63460
21977,3827,557,1550,1047,386,287,355,212,178,76,0,102,34,25,0,0,25,9,0,0,9,143,143,92,0,51,0,0,0,0,0,0,0,0,0,63461
21978,1132,143,521,333,110,25,55,33,30,6,3,21,3,0,0,0,0,3,0,0,3,22,22,22,0,0,0,0,0,0,0,0,0,0,0,63462
21979,532,91,230,136,54,21,44,10,8,0,0,8,2,2,2,0,0,0,0,0,0,34,34,0,2,32,0,0,0,0,0,0,0,0,0,63463
21980,43,0,33,0,10,0,0,0,0,0,0,0,0,0,0,0,0,0,0,0,0,0,0,0,0,0,0,0,0,0,0,0,0,0,0,63464
21981,312,55,163,64,14,16,44,23,12,0,8,4,11,11,6,5,0,0,0,0,0,21,18,0,0,18,3,3,3,0,0,0,0,0,0,63465
21982,31,0,9,0,22,0,0,0,0,0,0,0,0,0,0,0,0,0,0,0,0,0,0,0,0,0,0,0,0,0,0,0,0,0,0,63467
21983,1663,218,675,521,157,92,96,51,40,40,0,0,11,0,0,0,0,11,11,0,0,45,45,38,0,7,0,0,0,0,0,0,0,0,0,63468
21984,840,119,373,236,65,47,68,19,12,0,0,12,7,0,0,0,0,7,0,0,7,49,39,24,13,2,10,2,2,0,0,8,8,0,0,63469
21985,432,78,216,111,14,13,23,13,13,0,0,13,0,0,0,0,0,0,0,0,0,10,10,10,0,0,0,0,0,0,0,0,0,0,0,63471
21986,352,120,149,67,13,3,28,16,16,0,16,0,0,0,0,0,0,0,0,0,0,12,12,0,0,12,0,0,0,0,0,0,0,0,0,63472
21987,265,13,92,106,47,7,23,16,8,8,0,0,8,8,0,0,8,0,0,0,0,7,7,7,0,0,0,0,0,0,0,0,0,0,0,63473
21988,319,50,173,75,17,4,10,9,7,0,0,7,2,0,0,0,0,2,2,0,0,1,0,0,0,0,1,0,0,0,0,1,1,0,0,63474
21989,11188,1386,3413,2926,1749,1714,3335,1413,1276,360,41,875,137,54,54,0,0,83,38,35,10,1922,1839,551,58,1230,83,24,17,7,0,59,8,38,13,63501
21990,603,49,276,172,69,37,43,19,19,3,8,8,0,0,0,0,0,0,0,0,0,24,19,11,0,8,5,5,0,5,0,0,0,0,0,63530
21991,264,44,163,54,3,0,0,0,0,0,0,0,0,0,0,0,0,0,0,0,0,0,0,0,0,0,0,0,0,0,0,0,0,0,0,63531
21992,854,99,434,234,58,29,58,40,34,18,0,16,6,6,6,0,0,0,0,0,0,18,16,6,0,10,2,2,0,2,0,0,0,0,0,63532
21993,587,38,278,207,33,31,41,19,19,15,0,4,0,0,0,0,0,0,0,0,0,22,18,1,0,17,4,4,4,0,0,0,0,0,0,63533
21994,541,75,290,124,50,2,50,28,28,24,0,4,0,0,0,0,0,0,0,0,0,22,22,6,0,16,0,0,0,0,0,0,0,0,0,63534
21995,111,32,54,20,5,0,10,10,10,4,0,6,0,0,0,0,0,0,0,0,0,0,0,0,0,0,0,0,0,0,0,0,0,0,0,63535
21996,431,67,200,140,17,7,90,41,3,0,0,3,38,2,2,0,0,36,14,0,22,49,17,6,0,11,32,10,10,0,0,22,0,0,22,63536
21997,1225,141,527,369,131,57,74,39,29,16,0,13,10,0,0,0,0,10,10,0,0,35,21,8,3,10,14,0,0,0,0,14,14,0,0,63537
21998,215,19,106,67,18,5,7,7,7,0,0,7,0,0,0,0,0,0,0,0,0,0,0,0,0,0,0,0,0,0,0,0,0,0,0,63538
21999,161,20,51,38,30,22,14,0,0,0,0,0,0,0,0,0,0,0,0,0,0,14,12,5,0,7,2,2,2,0,0,0,0,0,0,63539
22000,168,22,101,17,28,0,11,8,0,0,0,0,8,0,0,0,0,8,0,0,8,3,3,0,0,3,0,0,0,0,0,0,0,0,0,63540
22001,257,19,110,104,22,2,21,14,14,4,0,10,0,0,0,0,0,0,0,0,0,7,7,0,0,7,0,0,0,0,0,0,0,0,0,63541
22002,216,76,83,38,15,4,27,18,12,7,5,0,6,0,0,0,0,6,6,0,0,9,3,0,3,0,6,0,0,0,0,6,3,0,3,63543
22003,696,130,340,137,73,16,61,37,23,9,0,14,14,5,5,0,0,9,0,9,0,24,24,10,0,14,0,0,0,0,0,0,0,0,0,63544
22004,783,96,325,233,82,47,50,24,8,2,0,6,16,0,0,0,0,16,16,0,0,26,20,2,11,7,6,6,0,0,6,0,0,0,0,63545
22005,872,79,416,251,76,50,48,27,19,4,0,15,8,8,8,0,0,0,0,0,0,21,17,17,0,0,4,4,0,0,4,0,0,0,0,63546
22006,363,40,174,113,23,13,106,69,41,0,4,37,28,0,0,0,0,28,28,0,0,37,12,0,9,3,25,0,0,0,0,25,7,9,9,63547
22007,778,108,337,197,88,48,87,31,15,7,0,8,16,3,0,0,3,13,13,0,0,56,17,0,13,4,39,13,0,13,0,26,0,9,17,63548
22008,1690,348,696,472,81,93,109,61,47,19,0,28,14,8,8,0,0,6,6,0,0,48,30,11,0,19,18,0,0,0,0,18,0,0,18,63549
22009,203,102,55,46,0,0,4,0,0,0,0,0,0,0,0,0,0,0,0,0,0,4,4,0,0,4,0,0,0,0,0,0,0,0,0,63551
22010,5439,772,2235,1416,670,346,308,116,94,44,10,40,22,8,8,0,0,14,0,0,14,192,121,44,24,53,71,49,39,10,0,22,0,0,22,63552
22011,2100,407,849,457,279,108,141,62,44,0,0,44,18,0,0,0,0,18,18,0,0,79,53,19,0,34,26,0,0,0,0,26,11,0,15,63555
22012,2471,497,1160,556,154,104,138,80,77,0,7,70,3,3,3,0,0,0,0,0,0,58,46,8,20,18,12,12,12,0,0,0,0,0,0,63556
22013,176,20,116,21,10,9,20,0,0,0,0,0,0,0,0,0,0,0,0,0,0,20,20,0,0,20,0,0,0,0,0,0,0,0,0,63557
22014,578,91,271,138,38,40,33,13,10,5,0,5,3,3,0,3,0,0,0,0,0,20,18,0,0,18,2,2,2,0,0,0,0,0,0,63558
22015,1051,258,424,214,104,51,29,15,11,4,0,7,4,3,3,0,0,1,0,0,1,14,14,10,0,4,0,0,0,0,0,0,0,0,0,63559
22016,217,64,72,45,14,22,1,0,0,0,0,0,0,0,0,0,0,0,0,0,0,1,1,1,0,0,0,0,0,0,0,0,0,0,0,63560
22017,993,153,505,281,40,14,78,44,44,14,0,30,0,0,0,0,0,0,0,0,0,34,34,6,0,28,0,0,0,0,0,0,0,0,0,63561
22018,328,112,89,60,46,21,60,41,0,0,0,0,41,0,0,0,0,41,41,0,0,19,8,8,0,0,11,0,0,0,0,11,7,0,4,63563
22019,2754,294,1248,820,190,202,207,119,62,58,0,4,57,18,0,0,18,39,31,0,8,88,57,8,0,49,31,0,0,0,0,31,0,0,31,63565
22020,86,0,48,15,16,7,4,0,0,0,0,0,0,0,0,0,0,0,0,0,0,4,0,0,0,0,4,4,4,0,0,0,0,0,0,63566
22021,152,88,46,8,6,4,5,5,5,0,0,5,0,0,0,0,0,0,0,0,0,0,0,0,0,0,0,0,0,0,0,0,0,0,0,63567
22022,11349,1891,4124,4037,922,375,866,425,302,50,0,252,123,60,16,44,0,63,0,0,63,441,364,114,20,230,77,77,74,3,0,0,0,0,0,63601
22023,942,230,373,281,31,27,66,31,22,12,2,8,9,3,0,3,0,6,0,6,0,35,35,14,9,12,0,0,0,0,0,0,0,0,0,63620
22024,1066,178,347,384,83,74,105,54,54,0,0,54,0,0,0,0,0,0,0,0,0,51,51,51,0,0,0,0,0,0,0,0,0,0,0,63621
22025,551,199,149,133,42,28,45,16,8,8,0,0,8,0,0,0,0,8,8,0,0,29,29,29,0,0,0,0,0,0,0,0,0,0,0,63622
22026,696,187,300,162,18,29,16,4,0,0,0,0,4,0,0,0,0,4,0,0,4,12,12,3,0,9,0,0,0,0,0,0,0,0,0,63623
22027,2556,799,844,781,86,46,256,91,84,27,3,54,7,4,3,0,1,3,0,0,3,165,85,21,28,36,80,43,24,17,2,37,0,0,37,63624
22028,317,68,145,73,23,8,16,12,12,0,0,12,0,0,0,0,0,0,0,0,0,4,4,0,0,4,0,0,0,0,0,0,0,0,0,63625
22029,819,122,462,149,28,58,86,64,64,24,33,7,0,0,0,0,0,0,0,0,0,22,22,0,0,22,0,0,0,0,0,0,0,0,0,63626
22030,1885,410,852,439,155,29,109,92,68,25,1,42,24,24,2,15,7,0,0,0,0,17,17,1,1,15,0,0,0,0,0,0,0,0,0,63627
22031,10991,2671,3553,3274,1002,491,652,376,257,105,8,144,119,9,0,0,9,110,15,0,95,276,247,171,0,76,29,29,15,0,14,0,0,0,0,63628
22032,1044,249,557,201,25,12,86,45,28,0,5,23,17,13,13,0,0,4,0,0,4,41,29,17,0,12,12,12,2,0,10,0,0,0,0,63629
22033,2591,925,1217,387,62,0,181,111,111,40,0,71,0,0,0,0,0,0,0,0,0,70,55,55,0,0,15,0,0,0,0,15,15,0,0,63630
22034,796,101,339,278,59,19,44,22,21,0,4,17,1,1,1,0,0,0,0,0,0,22,22,4,0,18,0,0,0,0,0,0,0,0,0,63631
22035,686,168,271,211,20,16,7,4,0,0,0,0,4,4,0,4,0,0,0,0,0,3,3,0,0,3,0,0,0,0,0,0,0,0,0,63633
22036,468,149,217,81,20,1,13,0,0,0,0,0,0,0,0,0,0,0,0,0,0,13,7,0,0,7,6,6,6,0,0,0,0,0,0,63636
22037,758,159,327,206,42,24,84,0,0,0,0,0,0,0,0,0,0,0,0,0,0,84,27,0,0,27,57,57,57,0,0,0,0,0,0,63637
22038,1858,492,779,445,93,49,89,51,36,0,8,28,15,1,1,0,0,14,14,0,0,38,33,7,20,6,5,5,5,0,0,0,0,0,0,63638
22039,19216,3597,5915,6181,2185,1338,1010,624,433,26,94,313,191,70,44,15,11,121,16,44,61,386,278,85,12,181,108,63,63,0,0,45,0,34,11,63640
22040,7765,1941,2792,2350,449,233,609,350,231,91,65,75,119,50,24,25,1,69,0,24,45,259,209,41,53,115,50,39,28,0,11,11,0,11,0,63645
22041,1011,260,454,222,52,23,63,24,15,0,0,15,9,3,0,0,3,6,6,0,0,39,39,26,0,13,0,0,0,0,0,0,0,0,0,63648
22042,3057,641,1119,852,250,195,243,107,84,2,10,72,23,5,3,0,2,18,13,0,5,136,112,21,3,88,24,8,8,0,0,16,0,0,16,63650
22043,785,220,261,253,26,25,147,92,79,23,19,37,13,10,3,3,4,3,0,3,0,55,55,23,5,27,0,0,0,0,0,0,0,0,0,63653
22044,410,29,224,100,38,19,18,2,2,0,0,2,0,0,0,0,0,0,0,0,0,16,11,0,0,11,5,0,0,0,0,5,0,5,0,63654
22045,958,233,397,244,27,57,144,58,58,2,6,50,0,0,0,0,0,0,0,0,0,86,67,37,4,26,19,15,15,0,0,4,0,0,4,63655
22046,218,46,114,37,8,13,3,0,0,0,0,0,0,0,0,0,0,0,0,0,0,3,3,3,0,0,0,0,0,0,0,0,0,0,0,63656
22047,3152,906,1478,659,72,37,79,72,64,3,20,41,8,0,0,0,0,8,0,0,8,7,7,0,0,7,0,0,0,0,0,0,0,0,0,63660
22048,847,127,353,250,82,35,65,47,47,0,0,47,0,0,0,0,0,0,0,0,0,18,18,18,0,0,0,0,0,0,0,0,0,0,0,63662
22049,460,162,115,151,32,0,18,11,0,0,0,0,11,11,4,7,0,0,0,0,0,7,5,0,0,5,2,0,0,0,0,2,0,0,2,63663
22050,5577,1516,1696,1554,386,425,446,180,138,29,0,109,42,32,5,0,27,10,10,0,0,266,198,37,59,102,68,54,14,17,23,14,0,0,14,63664
22051,215,33,115,58,9,0,30,30,30,12,0,18,0,0,0,0,0,0,0,0,0,0,0,0,0,0,0,0,0,0,0,0,0,0,0,63665
22052,98,6,62,21,0,9,0,0,0,0,0,0,0,0,0,0,0,0,0,0,0,0,0,0,0,0,0,0,0,0,0,0,0,0,0,63666
22053,7599,1190,3184,2441,599,185,582,258,222,112,8,102,36,27,22,0,5,9,0,0,9,324,282,154,28,100,42,42,13,20,9,0,0,0,0,63670
22054,1408,364,618,320,55,51,144,66,58,28,0,30,8,2,2,0,0,6,6,0,0,78,78,28,0,50,0,0,0,0,0,0,0,0,0,63673
22055,124,0,124,0,0,0,0,0,0,0,0,0,0,0,0,0,0,0,0,0,0,0,0,0,0,0,0,0,0,0,0,0,0,0,0,63674
22056,155,0,72,83,0,0,0,0,0,0,0,0,0,0,0,0,0,0,0,0,0,0,0,0,0,0,0,0,0,0,0,0,0,0,0,63675
22057,22419,2171,6342,6160,5087,2659,2992,1425,1342,417,111,814,83,61,49,0,12,22,9,0,13,1567,1442,422,57,963,125,117,99,18,0,8,8,0,0,63701
22058,5618,1237,1790,1797,496,298,389,186,165,22,85,58,21,21,0,21,0,0,0,0,0,203,109,57,21,31,94,91,3,21,67,3,0,0,3,63703
22059,2624,556,1146,524,225,173,137,54,38,15,23,0,16,10,0,10,0,6,0,0,6,83,74,0,3,71,9,0,0,0,0,9,5,0,4,63730
22060,464,60,177,154,66,7,37,20,20,2,10,8,0,0,0,0,0,0,0,0,0,17,17,10,0,7,0,0,0,0,0,0,0,0,0,63732
22061,539,123,228,129,47,12,46,22,20,12,0,8,2,0,0,0,0,2,2,0,0,24,18,7,0,11,6,3,3,0,0,3,0,0,3,63735
22062,2187,371,909,555,217,135,250,88,54,15,31,8,34,22,22,0,0,12,0,12,0,162,134,26,31,77,28,28,0,8,20,0,0,0,0,63736
22063,6,6,0,0,0,0,0,0,0,0,0,0,0,0,0,0,0,0,0,0,0,0,0,0,0,0,0,0,0,0,0,0,0,0,0,63738
22064,359,65,182,55,57,0,0,0,0,0,0,0,0,0,0,0,0,0,0,0,0,0,0,0,0,0,0,0,0,0,0,0,0,0,0,63739
22065,3733,681,1802,926,242,82,339,263,235,64,0,171,28,20,20,0,0,8,0,8,0,76,37,13,7,17,39,21,21,0,0,18,0,9,9,63740
22066,34,15,12,4,0,3,6,6,6,0,0,6,0,0,0,0,0,0,0,0,0,0,0,0,0,0,0,0,0,0,0,0,0,0,0,63742
22067,54,6,30,18,0,0,14,0,0,0,0,0,0,0,0,0,0,0,0,0,0,14,14,14,0,0,0,0,0,0,0,0,0,0,0,63743
22068,85,20,33,6,17,9,0,0,0,0,0,0,0,0,0,0,0,0,0,0,0,0,0,0,0,0,0,0,0,0,0,0,0,0,0,63744
22069,25,4,9,10,0,2,1,1,0,0,0,0,1,1,0,1,0,0,0,0,0,0,0,0,0,0,0,0,0,0,0,0,0,0,0,63745
22070,23,4,5,9,0,5,0,0,0,0,0,0,0,0,0,0,0,0,0,0,0,0,0,0,0,0,0,0,0,0,0,0,0,0,0,63746
22071,375,80,160,51,79,5,12,12,12,6,0,6,0,0,0,0,0,0,0,0,0,0,0,0,0,0,0,0,0,0,0,0,0,0,0,63747
22072,868,151,435,149,123,10,29,16,7,0,0,7,9,9,0,9,0,0,0,0,0,13,13,7,0,6,0,0,0,0,0,0,0,0,0,63748
22073,5,0,0,5,0,0,0,0,0,0,0,0,0,0,0,0,0,0,0,0,0,0,0,0,0,0,0,0,0,0,0,0,0,0,0,63750
22074,820,232,313,242,33,0,129,8,8,0,0,8,0,0,0,0,0,0,0,0,0,121,116,12,0,104,5,5,5,0,0,0,0,0,0,63751
22075,16165,1788,5956,4187,2764,1470,1147,595,465,253,20,192,130,113,104,9,0,17,17,0,0,552,464,245,37,182,88,88,63,25,0,0,0,0,0,63755
22076,130,0,91,19,14,6,0,0,0,0,0,0,0,0,0,0,0,0,0,0,0,0,0,0,0,0,0,0,0,0,0,0,0,0,0,63758
22077,485,30,224,144,83,4,88,56,56,30,14,12,0,0,0,0,0,0,0,0,0,32,32,9,0,23,0,0,0,0,0,0,0,0,0,63760
22078,139,40,79,5,0,15,0,0,0,0,0,0,0,0,0,0,0,0,0,0,0,0,0,0,0,0,0,0,0,0,0,0,0,0,0,63763
22079,3809,852,1625,905,207,220,236,145,109,34,54,21,36,36,16,0,20,0,0,0,0,91,83,59,0,24,8,4,4,0,0,4,0,0,4,63764
22080,994,68,473,283,102,68,27,27,27,16,0,11,0,0,0,0,0,0,0,0,0,0,0,0,0,0,0,0,0,0,0,0,0,0,0,63766
22081,488,93,255,89,48,3,27,6,6,6,0,0,0,0,0,0,0,0,0,0,0,21,14,10,0,4,7,7,0,0,7,0,0,0,0,63767
22082,1020,168,522,210,83,37,97,51,44,1,1,42,7,7,7,0,0,0,0,0,0,46,21,13,8,0,25,9,9,0,0,16,0,0,16,63769
22083,101,21,55,22,3,0,0,0,0,0,0,0,0,0,0,0,0,0,0,0,0,0,0,0,0,0,0,0,0,0,0,0,0,0,0,63770
22084,1817,280,904,369,172,92,159,73,57,14,13,30,16,7,7,0,0,9,4,0,5,86,80,45,0,35,6,6,6,0,0,0,0,0,0,63771
22085,103,47,56,0,0,0,12,12,12,0,12,0,0,0,0,0,0,0,0,0,0,0,0,0,0,0,0,0,0,0,0,0,0,0,0,63774
22086,10922,1904,4900,2533,1113,472,860,431,355,124,30,201,76,65,49,12,4,11,0,4,7,429,375,218,0,157,54,29,16,0,13,25,0,0,25,63775
22087,4382,801,1911,948,411,311,343,153,108,49,0,59,45,45,37,8,0,0,0,0,0,190,150,61,0,89,40,0,0,0,0,40,0,0,40,63780
22088,848,106,453,202,72,15,47,16,14,11,0,3,2,2,0,2,0,0,0,0,0,31,31,22,0,9,0,0,0,0,0,0,0,0,0,63781
22089,231,76,121,28,6,0,20,0,0,0,0,0,0,0,0,0,0,0,0,0,0,20,20,6,14,0,0,0,0,0,0,0,0,0,0,63782
22090,176,27,50,41,18,40,0,0,0,0,0,0,0,0,0,0,0,0,0,0,0,0,0,0,0,0,0,0,0,0,0,0,0,0,0,63783
22091,184,28,85,67,4,0,15,15,15,3,4,8,0,0,0,0,0,0,0,0,0,0,0,0,0,0,0,0,0,0,0,0,0,0,0,63784
22092,695,105,344,188,38,20,49,19,19,13,0,6,0,0,0,0,0,0,0,0,0,30,30,28,0,2,0,0,0,0,0,0,0,0,0,63785
22093,605,171,303,109,18,4,54,30,20,7,0,13,10,0,0,0,0,10,10,0,0,24,24,16,0,8,0,0,0,0,0,0,0,0,0,63787
22094,15749,3378,6062,3793,1597,919,1096,587,385,145,61,179,202,149,104,0,45,53,0,19,34,509,407,122,75,210,102,54,30,24,0,48,41,7,0,63801
22095,239,131,77,31,0,0,12,0,0,0,0,0,0,0,0,0,0,0,0,0,0,12,12,10,0,2,0,0,0,0,0,0,0,0,0,63820
22096,644,210,265,99,57,13,65,40,34,6,0,28,6,0,0,0,0,6,0,0,6,25,21,8,8,5,4,4,4,0,0,0,0,0,0,63821
22097,2091,422,947,550,137,35,189,106,76,20,0,56,30,30,0,30,0,0,0,0,0,83,83,0,11,72,0,0,0,0,0,0,0,0,0,63822
22098,1080,355,441,230,43,11,32,25,6,2,0,4,19,0,0,0,0,19,0,0,19,7,3,3,0,0,4,4,0,0,4,0,0,0,0,63823
22099,102,30,34,19,19,0,12,3,0,0,0,0,3,3,0,3,0,0,0,0,0,9,9,4,0,5,0,0,0,0,0,0,0,0,0,63824
22100,2819,721,1317,579,146,56,208,127,49,27,0,22,78,53,11,0,42,25,25,0,0,81,78,5,12,61,3,0,0,0,0,3,0,0,3,63825
22101,23,2,9,5,4,3,5,5,5,0,0,5,0,0,0,0,0,0,0,0,0,0,0,0,0,0,0,0,0,0,0,0,0,0,0,63826
22102,640,135,309,167,17,12,50,40,40,21,2,17,0,0,0,0,0,0,0,0,0,10,8,3,1,4,2,0,0,0,0,2,0,2,0,63827
22103,178,64,63,44,7,0,26,20,20,16,0,4,0,0,0,0,0,0,0,0,0,6,6,3,0,3,0,0,0,0,0,0,0,0,0,63828
22104,750,214,295,165,41,35,86,50,5,5,0,0,45,13,5,0,8,32,4,0,28,36,13,3,2,8,23,3,0,0,3,20,0,0,20,63829
22105,4440,1271,1537,1166,320,146,345,137,65,11,20,34,72,52,39,2,11,20,0,0,20,208,169,14,34,121,39,29,29,0,0,10,10,0,0,63830
22106,201,117,28,38,18,0,20,13,8,0,0,8,5,0,0,0,0,5,5,0,0,7,7,0,0,7,0,0,0,0,0,0,0,0,0,63833
22107,4784,1067,2125,1109,346,137,325,162,106,46,1,59,56,53,53,0,0,3,0,0,3,163,128,57,28,43,35,19,0,12,7,16,0,15,1,63834
22108,1027,393,458,125,30,21,141,89,89,20,0,69,0,0,0,0,0,0,0,0,0,52,50,8,0,42,2,2,0,2,0,0,0,0,0,63837
22109,306,112,140,37,12,5,55,36,27,4,0,23,9,9,9,0,0,0,0,0,0,19,19,3,0,16,0,0,0,0,0,0,0,0,0,63839
22110,9291,1685,3768,2264,960,614,551,266,223,76,30,117,43,33,33,0,0,10,0,10,0,285,199,86,0,113,86,59,36,23,0,27,0,13,14,63841
22111,3806,1173,1540,618,308,167,323,169,130,51,0,79,39,9,9,0,0,30,9,0,21,154,105,19,10,76,49,24,6,0,18,25,0,3,22,63845
22112,1112,225,526,264,57,40,87,53,46,11,0,35,7,7,0,7,0,0,0,0,0,34,28,9,4,15,6,0,0,0,0,6,0,0,6,63846
22113,37,37,0,0,0,0,0,0,0,0,0,0,0,0,0,0,0,0,0,0,0,0,0,0,0,0,0,0,0,0,0,0,0,0,0,63847
22114,904,252,350,199,53,50,59,43,35,10,0,25,8,8,8,0,0,0,0,0,0,16,14,0,0,14,2,0,0,0,0,2,0,0,2,63848
22115,184,30,91,63,0,0,20,9,0,0,0,0,9,9,0,0,9,0,0,0,0,11,8,8,0,0,3,0,0,0,0,3,0,0,3,63849
22116,2614,793,1092,510,117,102,300,150,102,5,24,73,48,48,0,12,36,0,0,0,0,150,135,13,10,112,15,15,15,0,0,0,0,0,0,63851
22117,834,235,330,193,41,35,67,28,28,8,5,15,0,0,0,0,0,0,0,0,0,39,27,23,0,4,12,2,0,0,2,10,0,0,10,63852
22118,207,77,85,36,7,2,14,6,6,0,0,6,0,0,0,0,0,0,0,0,0,8,8,0,0,8,0,0,0,0,0,0,0,0,0,63853
22119,815,119,360,284,40,12,51,39,17,3,0,14,22,4,4,0,0,18,0,0,18,12,12,4,0,8,0,0,0,0,0,0,0,0,0,63855
22120,8472,2163,3118,1905,686,600,779,375,264,77,52,135,111,93,48,10,35,18,0,0,18,404,296,127,20,149,108,101,72,24,5,7,7,0,0,63857
22121,114,57,48,5,0,4,0,0,0,0,0,0,0,0,0,0,0,0,0,0,0,0,0,0,0,0,0,0,0,0,0,0,0,0,0,63860
22122,1043,400,413,155,34,41,109,53,35,0,10,25,18,10,0,0,10,8,0,0,8,56,50,5,11,34,6,0,0,0,0,6,0,0,6,63862
22123,4206,1109,1827,893,195,182,325,211,128,23,0,105,83,25,25,0,0,58,0,0,58,114,95,51,3,41,19,0,0,0,0,19,19,0,0,63863
22124,288,60,145,78,0,5,6,6,6,0,0,6,0,0,0,0,0,0,0,0,0,0,0,0,0,0,0,0,0,0,0,0,0,0,0,63866
22125,892,217,440,177,56,2,26,0,0,0,0,0,0,0,0,0,0,0,0,0,0,26,16,14,0,2,10,0,0,0,0,10,0,0,10,63867
22126,504,180,244,73,7,0,51,31,18,0,0,18,13,0,0,0,0,13,0,8,5,20,16,0,7,9,4,4,4,0,0,0,0,0,0,63868
22127,2675,421,1123,699,226,206,128,47,31,13,12,6,16,0,0,0,0,16,0,0,16,81,81,6,9,66,0,0,0,0,0,0,0,0,0,63869
22128,719,263,291,133,14,18,107,46,41,0,20,21,5,0,0,0,0,5,5,0,0,61,42,15,5,22,19,10,6,0,4,9,0,0,9,63870
22129,3196,655,1436,676,224,205,291,182,146,21,26,99,36,27,10,17,0,9,0,9,0,109,83,66,5,12,26,26,0,12,14,0,0,0,0,63873
22130,252,22,140,68,20,2,36,4,2,2,0,0,2,2,2,0,0,0,0,0,0,32,32,10,0,22,0,0,0,0,0,0,0,0,0,63874
22131,1521,587,524,251,130,29,127,66,54,15,0,39,12,0,0,0,0,12,0,0,12,61,50,0,0,50,11,0,0,0,0,11,0,0,11,63876
22132,2402,552,908,644,145,153,210,118,77,15,0,62,41,34,8,13,13,7,0,0,7,92,74,15,0,59,18,16,0,0,16,2,2,0,0,63877
22133,101,15,71,13,2,0,17,10,0,0,0,0,10,6,6,0,0,4,0,0,4,7,3,0,0,3,4,0,0,0,0,4,0,0,4,63878
22134,523,112,225,133,48,5,60,35,26,3,0,23,9,9,0,9,0,0,0,0,0,25,21,0,0,21,4,2,0,0,2,2,2,0,0,63879
22135,92,38,37,0,17,0,0,0,0,0,0,0,0,0,0,0,0,0,0,0,0,0,0,0,0,0,0,0,0,0,0,0,0,0,0,63880
22136,306,119,118,60,9,0,29,19,15,15,0,0,4,0,0,0,0,4,2,2,0,10,5,1,4,0,5,0,0,0,0,5,0,0,5,63882
22137,23478,4673,8139,6914,2334,1418,1745,899,700,259,154,287,199,59,9,0,50,140,17,35,88,846,727,257,35,435,119,33,6,16,11,86,14,44,28,63901
22138,0,0,0,0,0,0,0,0,0,0,0,0,0,0,0,0,0,0,0,0,0,0,0,0,0,0,0,0,0,0,0,0,0,0,0,63902
22139,1067,341,458,236,24,8,9,4,4,0,0,4,0,0,0,0,0,0,0,0,0,5,0,0,0,0,5,0,0,0,0,5,0,0,5,63932
22140,2576,718,1063,549,152,94,162,74,42,7,10,25,32,9,9,0,0,23,0,8,15,88,75,22,0,53,13,0,0,0,0,13,13,0,0,63933
22141,78,22,38,18,0,0,0,0,0,0,0,0,0,0,0,0,0,0,0,0,0,0,0,0,0,0,0,0,0,0,0,0,0,0,0,63934
22142,6754,1541,2834,1650,463,266,506,299,207,86,16,105,92,64,53,0,11,28,0,13,15,207,169,82,0,87,38,19,11,0,8,19,0,0,19,63935
22143,483,136,214,100,32,1,100,46,4,0,2,2,42,0,0,0,0,42,3,28,11,54,23,23,0,0,31,0,0,0,0,31,0,27,4,63936
22144,1744,419,627,525,84,89,260,105,55,17,0,38,50,37,3,6,28,13,0,0,13,155,89,30,8,51,66,17,17,0,0,49,0,49,0,63937
22145,970,395,293,229,31,22,151,70,63,38,0,25,7,7,7,0,0,0,0,0,0,81,67,14,13,40,14,0,0,0,0,14,0,0,14,63939
22146,1098,344,345,278,83,48,96,51,51,0,7,44,0,0,0,0,0,0,0,0,0,45,16,1,10,5,29,0,0,0,0,29,0,29,0,63940
22147,346,61,101,107,62,15,14,0,0,0,0,0,0,0,0,0,0,0,0,0,0,14,14,0,0,14,0,0,0,0,0,0,0,0,0,63941
22148,605,90,290,125,83,17,22,3,3,0,0,3,0,0,0,0,0,0,0,0,0,19,14,3,0,11,5,5,0,0,5,0,0,0,0,63942
22149,667,315,229,116,7,0,54,26,8,0,0,8,18,18,18,0,0,0,0,0,0,28,28,22,0,6,0,0,0,0,0,0,0,0,0,63943
22150,1188,363,393,339,85,8,73,51,39,6,0,33,12,1,0,0,1,11,0,0,11,22,22,3,0,19,0,0,0,0,0,0,0,0,0,63944
22151,831,164,322,193,64,88,65,46,46,46,0,0,0,0,0,0,0,0,0,0,0,19,19,0,0,19,0,0,0,0,0,0,0,0,0,63945
22152,168,0,89,54,11,14,9,9,9,9,0,0,0,0,0,0,0,0,0,0,0,0,0,0,0,0,0,0,0,0,0,0,0,0,0,63951
22153,325,48,168,88,16,5,22,22,10,0,0,10,12,12,0,12,0,0,0,0,0,0,0,0,0,0,0,0,0,0,0,0,0,0,0,63952
22154,1318,354,420,425,101,18,127,63,57,27,3,27,6,3,3,0,0,3,0,0,3,64,64,36,0,28,0,0,0,0,0,0,0,0,0,63953
22155,725,274,248,154,43,6,49,32,28,10,0,18,4,4,4,0,0,0,0,0,0,17,11,6,0,5,6,0,0,0,0,6,0,0,6,63954
22156,133,20,36,59,18,0,0,0,0,0,0,0,0,0,0,0,0,0,0,0,0,0,0,0,0,0,0,0,0,0,0,0,0,0,0,63955
22157,818,128,358,146,85,101,0,0,0,0,0,0,0,0,0,0,0,0,0,0,0,0,0,0,0,0,0,0,0,0,0,0,0,0,0,63956
22158,4137,924,1760,1007,302,144,372,200,110,18,7,85,90,90,27,53,10,0,0,0,0,172,134,44,0,90,38,38,29,0,9,0,0,0,0,63957
22159,2239,388,967,546,180,158,254,119,92,5,2,85,27,19,0,11,8,8,0,0,8,135,135,9,8,118,0,0,0,0,0,0,0,0,0,63960
22160,1281,437,494,276,53,21,62,20,11,9,0,2,9,0,0,0,0,9,0,9,0,42,42,10,27,5,0,0,0,0,0,0,0,0,0,63961
22161,0,0,0,0,0,0,0,0,0,0,0,0,0,0,0,0,0,0,0,0,0,0,0,0,0,0,0,0,0,0,0,0,0,0,0,63962
22162,515,115,175,161,50,14,9,9,9,9,0,0,0,0,0,0,0,0,0,0,0,0,0,0,0,0,0,0,0,0,0,0,0,0,0,63964
22163,2019,364,542,744,176,193,107,29,29,15,0,14,0,0,0,0,0,0,0,0,0,78,78,20,0,58,0,0,0,0,0,0,0,0,0,63965
22164,1743,467,709,453,105,9,36,12,12,0,0,12,0,0,0,0,0,0,0,0,0,24,24,24,0,0,0,0,0,0,0,0,0,0,0,63966
22165,1246,266,511,367,83,19,90,52,26,0,3,23,26,15,12,3,0,11,0,0,11,38,38,2,13,23,0,0,0,0,0,0,0,0,0,63967
22166,485,36,199,130,84,36,30,18,18,7,0,11,0,0,0,0,0,0,0,0,0,12,12,10,0,2,0,0,0,0,0,0,0,0,0,64001
22167,2543,164,1217,696,363,103,227,125,76,17,0,59,49,0,0,0,0,49,2,0,47,102,99,9,12,78,3,3,3,0,0,0,0,0,0,64011
22168,17190,1635,5605,6059,2701,1190,1471,894,729,138,217,374,165,113,102,0,11,52,42,10,0,577,515,221,12,282,62,54,54,0,0,8,0,8,0,64012
22169,16525,993,5076,5443,3191,1822,1603,868,733,300,48,385,135,109,67,11,31,26,0,0,26,735,596,249,71,276,139,55,37,0,18,84,11,0,73,64014
22170,20467,1263,5757,7179,3851,2417,1757,919,795,168,89,538,124,71,51,13,7,53,0,0,53,838,766,211,29,526,72,48,33,0,15,24,0,0,24,64015
22171,3125,306,1431,988,272,128,255,168,144,45,8,91,24,18,5,4,9,6,0,6,0,87,59,42,0,17,28,12,6,6,0,16,0,16,0,64016
22172,333,41,172,89,16,15,17,6,4,1,0,3,2,2,0,2,0,0,0,0,0,11,7,1,0,6,4,0,0,0,0,4,4,0,0,64017
22173,576,6,208,209,123,30,67,43,43,0,5,38,0,0,0,0,0,0,0,0,0,24,11,2,3,6,13,13,13,0,0,0,0,0,0,64018
22174,1269,125,581,364,80,119,67,19,8,1,0,7,11,11,11,0,0,0,0,0,0,48,48,14,0,34,0,0,0,0,0,0,0,0,0,64019
22175,2354,316,983,540,307,208,186,23,23,15,0,8,0,0,0,0,0,0,0,0,0,163,144,108,6,30,19,19,19,0,0,0,0,0,0,64020
22176,368,44,137,100,73,14,43,24,22,8,0,14,2,0,0,0,0,2,2,0,0,19,17,5,3,9,2,0,0,0,0,2,0,0,2,64021
22177,93,24,46,12,4,7,7,7,0,0,0,0,7,0,0,0,0,7,0,4,3,0,0,0,0,0,0,0,0,0,0,0,0,0,0,64022
22178,11080,1685,4676,3450,805,464,851,382,242,17,64,161,140,137,107,15,15,3,0,0,3,469,353,46,4,303,116,52,52,0,0,64,0,0,64,64024
22179,10780,665,3856,3674,1602,983,752,510,466,111,15,340,44,44,8,0,36,0,0,0,0,242,228,100,12,116,14,14,14,0,0,0,0,0,0,64029
22180,15644,2048,4889,5663,1999,1045,1436,786,628,184,103,341,158,117,35,25,57,41,31,0,10,650,552,194,24,334,98,44,42,0,2,54,0,0,54,64030
22181,5287,186,1290,1758,1380,673,459,226,179,90,20,69,47,47,27,0,20,0,0,0,0,233,204,59,15,130,29,29,11,8,10,0,0,0,0,64034
22182,619,88,273,193,42,23,90,64,54,30,0,24,10,3,3,0,0,7,0,0,7,26,26,2,4,20,0,0,0,0,0,0,0,0,0,64035
22183,237,53,134,46,4,0,20,17,13,0,0,13,4,1,0,0,1,3,0,0,3,3,0,0,0,0,3,3,3,0,0,0,0,0,0,64036
22184,4095,811,1349,1136,527,272,380,199,172,42,51,79,27,27,18,9,0,0,0,0,0,181,99,15,5,79,82,82,44,0,38,0,0,0,0,64037
22185,4178,453,1760,1202,443,320,201,124,99,33,4,62,25,4,4,0,0,21,0,0,21,77,55,17,7,31,22,18,3,0,15,4,4,0,0,64040
22186,2991,198,1219,1036,350,188,265,147,139,25,55,59,8,8,8,0,0,0,0,0,0,118,118,41,0,77,0,0,0,0,0,0,0,0,0,64048
22187,14347,2727,5665,4338,1085,532,1004,380,244,62,27,155,136,100,51,35,14,36,6,0,30,624,414,130,20,264,210,76,59,0,17,134,33,0,101,64050
22188,14996,2581,5573,4803,1454,585,632,294,233,26,23,184,61,52,9,0,43,9,0,0,9,338,159,9,50,100,179,88,78,10,0,91,11,16,64,64052
22189,3397,866,1587,766,126,52,201,98,98,10,12,76,0,0,0,0,0,0,0,0,0,103,80,0,11,69,23,13,9,0,4,10,10,0,0,64053
22190,2370,318,921,833,239,59,207,102,102,0,0,102,0,0,0,0,0,0,0,0,0,105,53,23,12,18,52,52,52,0,0,0,0,0,0,64054
22191,24179,2162,8727,8286,3214,1790,1091,670,540,199,43,298,130,89,43,25,21,41,34,0,7,421,359,202,12,145,62,52,36,6,10,10,0,0,10,64055
22192,10022,1129,4433,2932,1081,447,880,487,435,67,31,337,52,31,4,7,20,21,0,17,4,393,299,81,38,180,94,86,8,6,72,8,8,0,0,64056
22193,10160,826,3276,3460,1587,1011,668,420,394,152,96,146,26,22,0,21,1,4,4,0,0,248,224,117,0,107,24,0,0,0,0,24,24,0,0,64057
22194,4592,538,1886,1451,515,202,246,189,120,29,0,91,69,38,0,31,7,31,0,0,31,57,53,3,0,50,4,3,3,0,0,1,0,0,1,64058
22195,8616,317,2237,2972,2034,1056,1067,569,538,223,87,228,31,31,16,15,0,0,0,0,0,498,498,288,8,202,0,0,0,0,0,0,0,0,0,64060
22196,2612,248,1088,897,284,95,119,71,48,6,21,21,23,23,2,21,0,0,0,0,0,48,48,26,0,22,0,0,0,0,0,0,0,0,0,64061
22197,3664,325,1491,1180,415,253,369,239,202,85,6,111,37,25,14,11,0,12,6,6,0,130,130,47,0,83,0,0,0,0,0,0,0,0,0,64062
22198,13180,668,3560,4779,2927,1246,1217,524,425,61,41,323,99,81,59,22,0,18,7,9,2,693,604,146,36,422,89,56,56,0,0,33,19,14,0,64063
22199,11081,226,2024,3503,2968,2360,803,419,382,77,82,223,37,37,37,0,0,0,0,0,0,384,375,147,19,209,9,0,0,0,0,9,0,9,0,64064
22200,13,0,0,6,7,0,36,14,14,14,0,0,0,0,0,0,0,0,0,0,0,22,22,20,0,2,0,0,0,0,0,0,0,0,0,64065
22201,16,0,6,1,4,5,0,0,0,0,0,0,0,0,0,0,0,0,0,0,0,0,0,0,0,0,0,0,0,0,0,0,0,0,0,64066
22202,4322,645,1391,1495,520,271,279,139,136,23,37,76,3,0,0,0,0,3,0,0,3,140,128,62,36,30,12,12,12,0,0,0,0,0,0,64067
22203,24261,1831,6242,7926,5292,2970,2222,1170,1024,311,77,636,146,97,63,0,34,49,0,0,49,1052,921,330,123,468,131,91,68,0,23,40,0,28,12,64068
22204,2084,98,536,873,478,99,174,128,128,64,0,64,0,0,0,0,0,0,0,0,0,46,46,17,3,26,0,0,0,0,0,0,0,0,0,64070
22205,790,73,376,198,86,57,24,10,8,0,0,8,2,2,2,0,0,0,0,0,0,14,13,9,1,3,1,1,0,0,1,0,0,0,0,64071
22206,166,29,70,54,2,11,11,0,0,0,0,0,0,0,0,0,0,0,0,0,0,11,11,6,0,5,0,0,0,0,0,0,0,0,0,64072
22207,536,45,215,227,44,5,50,45,4,2,0,2,41,2,2,0,0,39,0,0,39,5,5,0,0,5,0,0,0,0,0,0,0,0,0,64074
22208,7420,778,2563,2824,821,434,678,283,235,56,0,179,48,34,27,7,0,14,0,0,14,395,343,92,40,211,52,51,51,0,0,1,0,0,1,64075
22209,5938,506,2710,1873,577,272,389,293,261,40,44,177,32,32,23,0,9,0,0,0,0,96,95,27,10,58,1,1,1,0,0,0,0,0,0,64076
22210,1200,116,607,305,112,60,104,51,49,0,3,46,2,2,2,0,0,0,0,0,0,53,49,21,10,18,4,4,0,0,4,0,0,0,0,64077
22211,6173,349,2267,2252,805,500,632,289,226,30,46,150,63,36,13,23,0,27,17,0,10,343,338,57,43,238,5,5,5,0,0,0,0,0,0,64078
22212,8349,555,2092,2705,1875,1122,702,324,301,78,82,141,23,14,14,0,0,9,0,0,9,378,327,164,26,137,51,37,37,0,0,14,0,0,14,64079
22213,8370,809,3342,2519,1197,503,471,154,120,103,4,13,34,13,13,0,0,21,0,0,21,317,224,104,21,99,93,73,7,29,37,20,11,0,9,64080
22214,16092,553,3801,4665,4072,3001,1185,772,660,235,18,407,112,112,88,0,24,0,0,0,0,413,390,123,16,251,23,0,0,0,0,23,23,0,0,64081
22215,9113,407,1643,2850,2925,1288,855,442,389,163,47,179,53,25,25,0,0,28,0,12,16,413,366,137,19,210,47,47,30,17,0,0,0,0,0,64082
22216,13887,660,3997,5313,2685,1232,1111,436,360,139,13,208,76,76,66,10,0,0,0,0,0,675,667,236,6,425,8,0,0,0,0,8,0,0,8,64083
22217,1155,109,447,395,94,110,147,56,43,11,0,32,13,13,0,13,0,0,0,0,0,91,91,16,0,75,0,0,0,0,0,0,0,0,0,64084
22218,6106,721,2876,1630,645,234,318,158,128,14,0,114,30,20,20,0,0,10,10,0,0,160,137,44,0,93,23,15,15,0,0,8,0,0,8,64085
22219,14147,425,2822,5099,4021,1780,1170,590,516,250,39,227,74,65,43,9,13,9,0,9,0,580,498,211,85,202,82,71,26,34,11,11,11,0,0,64086
22220,868,88,453,258,37,32,29,17,15,0,0,15,2,1,1,0,0,1,0,1,0,12,12,0,0,12,0,0,0,0,0,0,0,0,0,64088
22221,7840,481,2784,2366,1618,591,513,250,215,71,0,144,35,23,14,0,9,12,0,0,12,263,213,116,34,63,50,21,16,0,5,29,6,0,23,64089
22222,58,7,18,20,12,1,0,0,0,0,0,0,0,0,0,0,0,0,0,0,0,0,0,0,0,0,0,0,0,0,0,0,0,0,0,64090
22223,106,106,0,0,0,0,0,0,0,0,0,0,0,0,0,0,0,0,0,0,0,0,0,0,0,0,0,0,0,0,0,0,0,0,0,64092
22224,14947,1094,3541,5052,3134,2126,2839,1432,1285,304,87,894,147,26,6,6,14,121,24,62,35,1407,1379,434,85,860,28,14,14,0,0,14,0,0,14,64093
22225,787,173,355,149,60,50,92,74,69,13,8,48,5,5,5,0,0,0,0,0,0,18,10,10,0,0,8,8,8,0,0,0,0,0,0,64096
22226,848,68,442,204,100,34,135,105,38,0,0,38,67,67,33,0,34,0,0,0,0,30,30,26,0,4,0,0,0,0,0,0,0,0,0,64097
22227,1977,156,594,658,364,205,245,162,148,72,11,65,14,14,14,0,0,0,0,0,0,83,71,19,0,52,12,9,9,0,0,3,0,0,3,64098
22228,264,94,70,90,10,0,10,10,0,0,0,0,10,10,0,0,10,0,0,0,0,0,0,0,0,0,0,0,0,0,0,0,0,0,0,64101
22229,0,0,0,0,0,0,0,0,0,0,0,0,0,0,0,0,0,0,0,0,0,0,0,0,0,0,0,0,0,0,0,0,0,0,0,64102
22230,2992,103,356,772,1082,679,38,0,0,0,0,0,0,0,0,0,0,0,0,0,0,38,38,20,0,18,0,0,0,0,0,0,0,0,0,64105
22231,4800,1161,1078,1317,821,423,539,237,159,4,44,111,78,53,0,20,33,25,0,0,25,302,237,7,66,164,65,54,24,25,5,11,0,0,11,64106
22232,6139,1264,1426,1531,1088,830,383,258,221,9,23,189,37,0,0,0,0,37,0,0,37,125,54,13,2,39,71,59,0,0,59,12,0,0,12,64108
22233,6048,1134,1638,1871,816,589,435,202,132,17,0,115,70,49,0,24,25,21,7,0,14,233,175,31,0,144,58,40,24,0,16,18,0,10,8,64109
22234,9292,943,1991,2621,2119,1618,1450,738,656,125,32,499,82,14,9,0,5,68,0,0,68,712,695,294,43,358,17,17,17,0,0,0,0,0,0,64110
22235,12218,852,2451,3028,3717,2170,418,153,119,77,9,33,34,12,12,0,0,22,0,6,16,265,203,67,9,127,62,48,0,17,31,14,13,0,1,64111
22236,6084,128,420,1098,2361,2077,299,83,77,28,0,49,6,6,0,0,6,0,0,0,0,216,216,46,75,95,0,0,0,0,0,0,0,0,0,64112
22237,8411,65,473,1277,3231,3365,300,177,177,52,0,125,0,0,0,0,0,0,0,0,0,123,123,30,0,93,0,0,0,0,0,0,0,0,0,64113
22238,19147,882,3172,6029,5210,3854,676,397,396,65,25,306,1,1,0,0,1,0,0,0,0,279,264,78,36,150,15,15,0,0,15,0,0,0,0,64114
22239,10854,1046,3251,3773,1834,950,766,390,317,85,47,185,73,73,18,55,0,0,0,0,0,376,320,151,37,132,56,56,41,0,15,0,0,0,0,64116
22240,9136,1067,2883,3246,1498,442,570,364,285,94,40,151,79,69,45,24,0,10,0,10,0,206,147,81,0,66,59,50,20,30,0,9,0,9,0,64117
22241,27365,2661,7822,9426,4860,2596,1918,832,666,210,57,399,166,101,92,0,9,65,29,0,36,1086,899,397,48,454,187,103,54,16,33,84,38,0,46,64118
22242,19043,2134,5442,5994,3751,1722,1177,583,508,134,56,318,75,53,43,10,0,22,10,12,0,594,433,141,47,245,161,120,105,15,0,41,7,12,22,64119
22243,346,37,183,48,62,16,0,0,0,0,0,0,0,0,0,0,0,0,0,0,0,0,0,0,0,0,0,0,0,0,0,0,0,0,0,64120
22244,5544,1654,1745,1534,392,219,507,215,113,12,0,101,102,15,6,9,0,87,19,48,20,292,195,54,0,141,97,77,27,50,0,20,12,0,8,64123
22245,7197,3055,2001,1267,695,179,539,182,157,41,4,112,25,25,25,0,0,0,0,0,0,357,285,40,47,198,72,33,0,0,33,39,0,0,39,64124
22246,1046,408,435,189,14,0,18,0,0,0,0,0,0,0,0,0,0,0,0,0,0,18,12,0,0,12,6,0,0,0,0,6,6,0,0,64125
22247,3255,1300,1173,620,151,11,440,224,183,23,0,160,41,13,0,13,0,28,0,0,28,216,183,57,0,126,33,25,8,17,0,8,0,0,8,64126
22248,9768,3099,3465,2502,412,290,1007,441,398,61,0,337,43,7,0,0,7,36,16,0,20,566,437,60,67,310,129,61,15,13,33,68,0,32,36,64127
22249,7661,2033,2706,2255,259,408,737,286,200,34,46,120,86,21,21,0,0,65,0,13,52,451,338,73,41,224,113,90,40,26,24,23,0,0,23,64128
22250,5987,1511,1864,1912,509,191,292,118,66,26,6,34,52,52,26,26,0,0,0,0,0,174,135,81,11,43,39,25,15,0,10,14,0,0,14,64129
22251,13690,3059,5315,3920,838,558,1178,440,281,29,94,158,159,110,0,30,80,49,31,8,10,738,580,84,53,443,158,80,19,30,31,78,0,74,4,64130
22252,16068,1490,4206,5268,2988,2116,992,551,431,72,81,278,120,55,9,7,39,65,0,34,31,441,375,87,46,242,66,66,24,32,10,0,0,0,0,64131
22253,7845,1582,3133,2233,537,360,851,441,332,14,47,271,109,74,59,0,15,35,0,20,15,410,337,107,22,208,73,20,16,0,4,53,0,10,43,64132
22254,22701,2195,7253,7621,3654,1978,1365,642,443,131,44,268,199,99,65,34,0,100,67,23,10,723,607,162,34,411,116,75,44,25,6,41,0,13,28,64133
22255,13554,1678,4855,4908,1331,782,1345,759,559,75,47,437,200,142,50,66,26,58,25,6,27,586,451,105,30,316,135,91,63,0,28,44,0,0,44,64134
22256,1316,167,447,451,140,111,225,36,36,0,0,36,0,0,0,0,0,0,0,0,0,189,68,46,0,22,121,121,0,121,0,0,0,0,0,64136
22257,8060,1118,2321,2454,1498,669,829,545,416,27,28,361,129,73,57,16,0,56,0,0,56,284,214,45,8,161,70,70,63,4,3,0,0,0,0,64137
22258,16479,1646,5851,5508,2320,1154,1197,641,536,160,34,342,105,97,31,24,42,8,0,0,8,556,494,168,5,321,62,48,20,20,8,14,12,0,2,64138
22259,1281,72,287,512,210,200,135,89,89,81,0,8,0,0,0,0,0,0,0,0,0,46,46,28,11,7,0,0,0,0,0,0,0,0,0,64139
22260,3752,136,734,1103,926,853,396,225,214,44,13,157,11,6,6,0,0,5,0,0,5,171,171,67,9,95,0,0,0,0,0,0,0,0,0,64145
22261,1274,157,305,326,354,132,45,24,0,0,0,0,24,0,0,0,0,24,0,24,0,21,0,0,0,0,21,4,4,0,0,17,0,17,0,64146
22262,156,15,50,62,29,0,176,65,23,9,14,0,42,42,0,42,0,0,0,0,0,111,98,23,37,38,13,13,13,0,0,0,0,0,0,64147
22263,193,0,14,133,41,5,0,0,0,0,0,0,0,0,0,0,0,0,0,0,0,0,0,0,0,0,0,0,0,0,0,0,0,0,0,64149
22264,2286,298,771,727,351,139,59,30,30,0,11,19,0,0,0,0,0,0,0,0,0,29,17,13,0,4,12,12,12,0,0,0,0,0,0,64150
22265,16790,755,4228,5368,4197,2242,1257,629,503,194,86,223,126,124,28,25,71,2,0,0,2,628,601,231,30,340,27,27,27,0,0,0,0,0,0,64151
22266,17343,601,2831,5407,5220,3284,1591,820,741,265,72,404,79,79,49,30,0,0,0,0,0,771,713,328,97,288,58,38,38,0,0,20,0,0,20,64152
22267,3455,171,843,884,995,562,259,168,162,13,6,143,6,6,6,0,0,0,0,0,0,91,70,11,0,59,21,13,8,0,5,8,0,0,8,64153
22268,6788,621,1298,2259,1723,887,246,194,174,37,0,137,20,0,0,0,0,20,20,0,0,52,52,32,0,20,0,0,0,0,0,0,0,0,0,64154
22269,14728,653,3572,5409,3469,1625,933,591,414,140,26,248,177,161,144,17,0,16,0,0,16,342,324,126,48,150,18,18,18,0,0,0,0,0,0,64155
22270,3473,120,561,1189,1194,409,171,117,99,17,0,82,18,18,0,18,0,0,0,0,0,54,54,15,0,39,0,0,0,0,0,0,0,0,0,64156
22271,10105,178,1657,3294,3153,1823,761,316,316,109,20,187,0,0,0,0,0,0,0,0,0,445,422,140,57,225,23,10,10,0,0,13,0,13,0,64157
22272,3132,308,364,1113,1060,287,271,112,112,76,0,36,0,0,0,0,0,0,0,0,0,159,159,59,0,100,0,0,0,0,0,0,0,0,0,64158
22273,249,32,122,79,13,3,10,7,6,3,3,0,1,1,1,0,0,0,0,0,0,3,3,0,1,2,0,0,0,0,0,0,0,0,0,64161
22274,524,62,185,182,70,25,40,17,9,0,0,9,8,8,8,0,0,0,0,0,0,23,7,0,0,7,16,9,0,0,9,7,0,3,4,64163
22275,283,0,16,250,17,0,58,39,39,0,0,39,0,0,0,0,0,0,0,0,0,19,19,0,0,19,0,0,0,0,0,0,0,0,0,64164
22276,36,0,0,18,0,18,0,0,0,0,0,0,0,0,0,0,0,0,0,0,0,0,0,0,0,0,0,0,0,0,0,0,0,0,0,64165
22277,189,17,73,43,47,9,0,0,0,0,0,0,0,0,0,0,0,0,0,0,0,0,0,0,0,0,0,0,0,0,0,0,0,0,0,64166
22278,196,0,11,0,165,20,0,0,0,0,0,0,0,0,0,0,0,0,0,0,0,0,0,0,0,0,0,0,0,0,0,0,0,0,0,64167
22279,0,0,0,0,0,0,0,0,0,0,0,0,0,0,0,0,0,0,0,0,0,0,0,0,0,0,0,0,0,0,0,0,0,0,0,64192
22280,1076,63,482,358,131,42,54,26,26,19,0,7,0,0,0,0,0,0,0,0,0,28,26,15,3,8,2,2,0,0,2,0,0,0,0,64401
22281,1813,287,822,419,177,108,109,34,31,4,11,16,3,3,3,0,0,0,0,0,0,75,71,13,14,44,4,0,0,0,0,4,4,0,0,64402
22282,60,0,40,12,8,0,18,0,0,0,0,0,0,0,0,0,0,0,0,0,0,18,18,18,0,0,0,0,0,0,0,0,0,0,0,64420
22283,427,39,217,109,23,39,50,14,14,0,0,14,0,0,0,0,0,0,0,0,0,36,30,18,0,12,6,6,0,6,0,0,0,0,0,64421
22284,163,7,73,48,17,18,16,5,5,5,0,0,0,0,0,0,0,0,0,0,0,11,11,0,0,11,0,0,0,0,0,0,0,0,0,64422
22285,550,22,290,133,74,31,55,30,25,6,7,12,5,5,3,1,1,0,0,0,0,25,25,6,0,19,0,0,0,0,0,0,0,0,0,64423
22286,2970,502,1510,720,225,13,162,78,68,21,0,47,10,10,10,0,0,0,0,0,0,84,64,14,9,41,20,6,6,0,0,14,0,14,0,64424
22287,262,33,135,62,19,13,13,4,4,1,0,3,0,0,0,0,0,0,0,0,0,9,9,0,0,9,0,0,0,0,0,0,0,0,0,64426
22288,440,33,197,157,39,14,29,10,4,0,0,4,6,2,2,0,0,4,4,0,0,19,17,4,0,13,2,0,0,0,0,2,2,0,0,64427
22289,597,62,357,106,55,17,32,9,6,0,0,6,3,3,0,3,0,0,0,0,0,23,17,5,0,12,6,0,0,0,0,6,0,3,3,64428
22290,9562,1619,4006,2758,780,399,568,298,188,21,6,161,110,21,11,0,10,89,8,0,81,270,194,83,14,97,76,11,11,0,0,65,0,9,56,64429
22291,463,52,201,160,42,8,20,1,1,0,0,1,0,0,0,0,0,0,0,0,0,19,12,1,0,11,7,0,0,0,0,7,0,7,0,64430
22292,347,41,169,94,38,5,20,10,10,0,0,10,0,0,0,0,0,0,0,0,0,10,10,0,2,8,0,0,0,0,0,0,0,0,0,64431
22293,115,10,50,4,4,47,4,1,1,1,0,0,0,0,0,0,0,0,0,0,0,3,1,0,0,1,2,2,2,0,0,0,0,0,0,64432
22294,90,5,44,15,7,19,73,65,65,39,0,26,0,0,0,0,0,0,0,0,0,8,8,0,0,8,0,0,0,0,0,0,0,0,0,64433
22295,306,37,120,80,40,29,34,10,10,0,0,10,0,0,0,0,0,0,0,0,0,24,24,9,0,15,0,0,0,0,0,0,0,0,0,64434
22296,523,34,155,220,74,40,29,9,9,9,0,0,0,0,0,0,0,0,0,0,0,20,20,13,0,7,0,0,0,0,0,0,0,0,0,64436
22297,528,77,287,111,39,14,17,17,15,2,0,13,2,0,0,0,0,2,2,0,0,0,0,0,0,0,0,0,0,0,0,0,0,0,0,64437
22298,267,13,84,117,48,5,2,0,0,0,0,0,0,0,0,0,0,0,0,0,0,2,2,0,0,2,0,0,0,0,0,0,0,0,0,64438
22299,1075,38,440,368,133,96,74,28,25,10,0,15,3,0,0,0,0,3,3,0,0,46,43,24,0,19,3,3,3,0,0,0,0,0,0,64439
22300,450,93,181,109,57,10,28,18,18,10,0,8,0,0,0,0,0,0,0,0,0,10,10,0,5,5,0,0,0,0,0,0,0,0,0,64440
22301,81,0,59,8,9,5,4,0,0,0,0,0,0,0,0,0,0,0,0,0,0,4,4,0,0,4,0,0,0,0,0,0,0,0,0,64441
22302,479,71,213,126,41,28,37,14,10,5,0,5,4,0,0,0,0,4,4,0,0,23,19,10,0,9,4,0,0,0,0,4,4,0,0,64442
22303,766,29,305,222,174,36,86,19,19,4,0,15,0,0,0,0,0,0,0,0,0,67,67,3,0,64,0,0,0,0,0,0,0,0,0,64443
22304,1140,68,528,417,116,11,119,55,52,24,3,25,3,3,0,3,0,0,0,0,0,64,64,39,0,25,0,0,0,0,0,0,0,0,0,64444
22305,229,18,104,80,18,9,19,10,8,0,4,4,2,2,2,0,0,0,0,0,0,9,6,0,0,6,3,3,3,0,0,0,0,0,0,64445
22306,709,81,310,164,112,42,64,28,26,6,0,20,2,2,0,2,0,0,0,0,0,36,23,3,0,20,13,4,0,0,4,9,1,8,0,64446
22307,834,60,424,251,75,24,30,17,17,0,0,17,0,0,0,0,0,0,0,0,0,13,13,0,0,13,0,0,0,0,0,0,0,0,0,64448
22308,327,14,215,63,30,5,11,5,5,5,0,0,0,0,0,0,0,0,0,0,0,6,6,4,0,2,0,0,0,0,0,0,0,0,0,64449
22309,353,49,170,98,29,7,9,7,4,4,0,0,3,0,0,0,0,3,3,0,0,2,2,0,0,2,0,0,0,0,0,0,0,0,0,64451
22310,108,28,48,22,10,0,0,0,0,0,0,0,0,0,0,0,0,0,0,0,0,0,0,0,0,0,0,0,0,0,0,0,0,0,0,64453
22311,1821,96,869,519,234,103,156,83,60,14,0,46,23,17,6,0,11,6,0,0,6,73,50,14,0,36,23,23,15,8,0,0,0,0,0,64454
22312,233,18,106,86,15,8,14,14,13,3,0,10,1,1,1,0,0,0,0,0,0,0,0,0,0,0,0,0,0,0,0,0,0,0,0,64455
22313,922,83,455,260,68,56,64,35,31,9,2,20,4,4,0,0,4,0,0,0,0,29,16,0,0,16,13,13,13,0,0,0,0,0,0,64456
22314,139,9,61,22,37,10,7,3,1,0,0,1,2,2,2,0,0,0,0,0,0,4,0,0,0,0,4,4,0,0,4,0,0,0,0,64457
22315,154,15,72,53,4,10,4,0,0,0,0,0,0,0,0,0,0,0,0,0,0,4,4,0,0,4,0,0,0,0,0,0,0,0,0,64458
22316,304,34,144,59,67,0,34,26,26,14,0,12,0,0,0,0,0,0,0,0,0,8,8,8,0,0,0,0,0,0,0,0,0,0,0,64459
22317,529,47,245,127,73,37,33,19,18,0,0,18,1,1,1,0,0,0,0,0,0,14,14,7,2,5,0,0,0,0,0,0,0,0,0,64461
22318,1104,119,525,265,143,52,89,61,52,3,0,49,9,9,9,0,0,0,0,0,0,28,28,0,0,28,0,0,0,0,0,0,0,0,0,64463
22319,2930,261,1282,983,274,130,254,164,147,39,11,97,17,17,6,0,11,0,0,0,0,90,80,11,0,69,10,10,10,0,0,0,0,0,0,64465
22320,353,19,199,105,19,11,23,9,9,3,0,6,0,0,0,0,0,0,0,0,0,14,5,2,0,3,9,9,9,0,0,0,0,0,0,64466
22321,116,43,35,34,4,0,4,4,4,0,0,4,0,0,0,0,0,0,0,0,0,0,0,0,0,0,0,0,0,0,0,0,0,0,0,64467
22322,7700,633,3048,1951,1124,944,2358,1103,1072,356,147,569,31,30,30,0,0,1,0,0,1,1255,1229,588,161,480,26,16,8,8,0,10,0,7,3,64468
22323,1512,187,750,360,152,63,146,43,43,0,0,43,0,0,0,0,0,0,0,0,0,103,71,45,0,26,32,23,0,23,0,9,9,0,0,64469
22324,1168,102,509,319,154,84,79,41,30,27,3,0,11,11,7,4,0,0,0,0,0,38,25,6,0,19,13,13,11,2,0,0,0,0,0,64470
22325,327,54,152,81,38,2,32,27,4,4,0,0,23,8,8,0,0,15,15,0,0,5,5,2,0,3,0,0,0,0,0,0,0,0,0,64471
22326,1085,112,511,252,129,81,38,17,8,6,0,2,9,4,0,2,2,5,0,0,5,21,20,7,0,13,1,1,0,0,1,0,0,0,0,64473
22327,603,50,250,233,57,13,57,40,23,7,13,3,17,17,0,17,0,0,0,0,0,17,17,4,0,13,0,0,0,0,0,0,0,0,0,64474
22328,191,13,98,40,33,7,13,8,8,0,0,8,0,0,0,0,0,0,0,0,0,5,5,0,0,5,0,0,0,0,0,0,0,0,0,64475
22329,268,37,129,62,27,13,9,5,5,0,0,5,0,0,0,0,0,0,0,0,0,4,4,4,0,0,0,0,0,0,0,0,0,0,0,64476
22330,2488,299,973,792,272,152,146,85,71,32,0,39,14,14,7,7,0,0,0,0,0,61,31,3,0,28,30,30,30,0,0,0,0,0,0,64477
22331,724,123,312,185,64,40,44,14,6,2,0,4,8,4,2,2,0,4,0,0,4,30,21,9,0,12,9,0,0,0,0,9,0,0,9,64479
22332,254,46,135,20,14,39,24,3,0,0,0,0,3,3,3,0,0,0,0,0,0,21,21,21,0,0,0,0,0,0,0,0,0,0,0,64480
22333,855,187,408,183,62,15,54,18,15,9,0,6,3,3,3,0,0,0,0,0,0,36,15,3,1,11,21,14,12,2,0,7,0,7,0,64481
22334,1510,172,673,366,223,76,88,40,28,12,0,16,12,11,11,0,0,1,0,0,1,48,32,7,5,20,16,16,16,0,0,0,0,0,0,64482
22335,411,57,170,141,20,23,57,32,32,17,0,15,0,0,0,0,0,0,0,0,0,25,25,15,0,10,0,0,0,0,0,0,0,0,0,64483
22336,674,117,324,174,36,23,51,29,26,12,2,12,3,3,2,0,1,0,0,0,0,22,22,15,0,7,0,0,0,0,0,0,0,0,0,64484
22337,5433,627,2440,1283,636,447,385,324,308,90,19,199,16,16,16,0,0,0,0,0,0,61,45,33,0,12,16,0,0,0,0,16,16,0,0,64485
22338,433,23,187,123,71,29,1,0,0,0,0,0,0,0,0,0,0,0,0,0,0,1,1,1,0,0,0,0,0,0,0,0,0,0,0,64486
22339,609,42,291,140,92,44,67,15,14,6,0,8,1,1,1,0,0,0,0,0,0,52,52,26,7,19,0,0,0,0,0,0,0,0,0,64487
22340,1278,200,484,393,139,62,156,89,54,27,4,23,35,9,4,0,5,26,0,0,26,67,49,15,0,34,18,0,0,0,0,18,0,0,18,64489
22341,1587,142,794,418,154,79,121,50,32,16,0,16,18,18,18,0,0,0,0,0,0,71,71,38,18,15,0,0,0,0,0,0,0,0,0,64490
22342,1379,154,518,399,211,97,74,52,50,5,0,45,2,2,0,0,2,0,0,0,0,22,18,2,0,16,4,4,0,4,0,0,0,0,0,64491
22343,1191,165,542,370,104,10,126,64,35,5,0,30,29,27,0,27,0,2,0,0,2,62,62,29,0,33,0,0,0,0,0,0,0,0,0,64492
22344,367,14,142,131,65,15,38,34,34,26,0,8,0,0,0,0,0,0,0,0,0,4,4,0,0,4,0,0,0,0,0,0,0,0,0,64493
22345,614,45,261,199,85,24,43,23,12,0,3,9,11,11,7,0,4,0,0,0,0,20,17,0,0,17,3,2,2,0,0,1,0,1,0,64494
22346,79,10,53,11,5,0,19,14,14,0,0,14,0,0,0,0,0,0,0,0,0,5,1,0,0,1,4,3,3,0,0,1,0,0,1,64496
22347,314,37,147,89,28,13,9,5,5,0,0,5,0,0,0,0,0,0,0,0,0,4,4,3,1,0,0,0,0,0,0,0,0,0,0,64497
22348,267,19,140,65,27,16,42,26,19,11,0,8,7,7,4,3,0,0,0,0,0,16,16,3,7,6,0,0,0,0,0,0,0,0,0,64498
22349,72,4,43,12,7,6,9,9,9,9,0,0,0,0,0,0,0,0,0,0,0,0,0,0,0,0,0,0,0,0,0,0,0,0,0,64499
22350,7667,1404,2880,2039,974,370,791,312,275,65,0,210,37,20,0,13,7,17,0,17,0,479,335,107,16,212,144,45,13,32,0,99,0,37,62,64501
22351,8560,1242,3450,2556,931,381,638,284,223,87,8,128,61,16,10,6,0,45,0,8,37,354,298,86,48,164,56,45,6,17,22,11,0,0,11,64503
22352,7155,1398,3218,1793,451,295,593,394,256,112,29,115,138,102,78,6,18,36,31,0,5,199,165,88,28,49,34,19,7,5,7,15,0,7,8,64504
22353,8737,1180,2785,2824,1257,691,796,361,283,91,27,165,78,35,35,0,0,43,3,40,0,435,306,141,29,136,129,76,31,6,39,53,39,0,14,64505
22354,16324,1660,5119,4726,2835,1984,1177,541,457,148,48,261,84,74,36,27,11,10,0,0,10,636,524,190,48,286,112,95,85,10,0,17,6,0,11,64506
22355,9072,1154,3610,2484,1406,418,965,482,469,174,27,268,13,13,13,0,0,0,0,0,0,483,483,185,55,243,0,0,0,0,0,0,0,0,0,64507
22356,8566,1146,3933,1864,1079,544,514,242,223,55,60,108,19,19,19,0,0,0,0,0,0,272,236,82,34,120,36,23,21,0,2,13,2,0,11,64601
22357,366,43,157,79,65,22,19,5,5,0,0,5,0,0,0,0,0,0,0,0,0,14,14,0,0,14,0,0,0,0,0,0,0,0,0,64620
22358,366,66,182,79,33,6,50,32,19,3,0,16,13,0,0,0,0,13,7,0,6,18,18,7,3,8,0,0,0,0,0,0,0,0,0,64622
22359,369,76,175,81,22,15,26,15,13,2,3,8,2,1,0,0,1,1,0,0,1,11,8,2,0,6,3,3,3,0,0,0,0,0,0,64623
22360,1151,185,543,288,95,40,80,52,35,13,4,18,17,0,0,0,0,17,5,10,2,28,28,0,6,22,0,0,0,0,0,0,0,0,0,64624
22361,378,35,189,88,53,13,30,27,22,19,0,3,5,5,4,0,1,0,0,0,0,3,3,0,3,0,0,0,0,0,0,0,0,0,0,64625
22362,4214,655,1902,1048,281,328,273,126,115,11,0,104,11,11,4,7,0,0,0,0,0,147,105,29,0,76,42,4,4,0,0,38,0,28,10,64628
22363,331,52,191,49,25,14,29,10,10,0,0,10,0,0,0,0,0,0,0,0,0,19,13,9,2,2,6,4,4,0,0,2,2,0,0,64630
22364,625,101,322,135,62,5,60,34,34,4,0,30,0,0,0,0,0,0,0,0,0,26,26,5,3,18,0,0,0,0,0,0,0,0,0,64631
22365,453,49,207,138,42,17,21,10,9,3,0,6,1,1,0,1,0,0,0,0,0,11,11,6,0,5,0,0,0,0,0,0,0,0,0,64632
22366,3451,599,1492,753,388,219,352,167,152,17,28,107,15,0,0,0,0,15,0,8,7,185,151,39,6,106,34,34,22,0,12,0,0,0,0,64633
22367,356,43,150,127,26,10,35,22,14,6,5,3,8,8,8,0,0,0,0,0,0,13,13,7,0,6,0,0,0,0,0,0,0,0,0,64635
22368,206,31,111,55,7,2,24,9,8,2,0,6,1,1,1,0,0,0,0,0,0,15,10,7,0,3,5,5,5,0,0,0,0,0,0,64636
22369,430,52,218,113,35,12,33,3,0,0,0,0,3,0,0,0,0,3,0,0,3,30,30,0,0,30,0,0,0,0,0,0,0,0,0,64637
22370,334,30,138,93,63,10,50,43,19,0,10,9,24,0,0,0,0,24,0,17,7,7,7,0,0,7,0,0,0,0,0,0,0,0,0,64638
22371,221,42,97,71,8,3,5,5,5,4,0,1,0,0,0,0,0,0,0,0,0,0,0,0,0,0,0,0,0,0,0,0,0,0,0,64639
22372,2261,235,891,624,330,181,183,111,107,22,0,85,4,4,2,0,2,0,0,0,0,72,69,37,3,29,3,3,0,0,3,0,0,0,0,64640
22373,449,85,217,93,28,26,17,7,7,2,0,5,0,0,0,0,0,0,0,0,0,10,10,3,0,7,0,0,0,0,0,0,0,0,0,64641
22374,728,85,367,195,68,13,64,57,57,5,2,50,0,0,0,0,0,0,0,0,0,7,6,3,0,3,1,1,1,0,0,0,0,0,0,64642
22375,797,113,456,110,82,36,73,44,44,30,0,14,0,0,0,0,0,0,0,0,0,29,21,8,6,7,8,0,0,0,0,8,0,0,8,64643
22376,2151,331,899,664,151,106,224,131,110,51,0,59,21,13,10,3,0,8,0,0,8,93,89,48,3,38,4,4,0,4,0,0,0,0,0,64644
22377,108,5,49,52,2,0,9,9,9,0,0,9,0,0,0,0,0,0,0,0,0,0,0,0,0,0,0,0,0,0,0,0,0,0,0,64645
22378,202,31,101,50,17,3,22,0,0,0,0,0,0,0,0,0,0,0,0,0,0,22,22,0,0,22,0,0,0,0,0,0,0,0,0,64646
22379,261,28,116,84,29,4,0,0,0,0,0,0,0,0,0,0,0,0,0,0,0,0,0,0,0,0,0,0,0,0,0,0,0,0,0,64647
22380,1153,449,390,208,78,28,168,95,22,7,0,15,73,2,2,0,0,71,32,0,39,73,46,15,0,31,27,3,1,0,2,24,24,0,0,64648
22381,468,32,234,127,72,3,40,10,8,5,3,0,2,2,0,2,0,0,0,0,0,30,30,23,0,7,0,0,0,0,0,0,0,0,0,64649
22382,558,61,287,142,52,16,33,24,22,4,1,17,2,0,0,0,0,2,1,0,1,9,9,3,2,4,0,0,0,0,0,0,0,0,0,64650
22383,410,46,183,102,72,7,44,3,0,0,0,0,3,3,0,3,0,0,0,0,0,41,33,23,0,10,8,8,8,0,0,0,0,0,0,64651
22384,369,43,195,89,19,23,37,14,11,0,5,6,3,3,3,0,0,0,0,0,0,23,17,7,4,6,6,0,0,0,0,6,0,6,0,64652
22385,439,55,284,85,8,7,56,34,27,4,10,13,7,7,2,0,5,0,0,0,0,22,17,10,6,1,5,5,0,0,5,0,0,0,0,64653
22386,26,7,4,14,1,0,0,0,0,0,0,0,0,0,0,0,0,0,0,0,0,0,0,0,0,0,0,0,0,0,0,0,0,0,0,64654
22387,207,30,102,19,56,0,0,0,0,0,0,0,0,0,0,0,0,0,0,0,0,0,0,0,0,0,0,0,0,0,0,0,0,0,0,64655
22388,158,34,73,21,12,18,18,9,9,6,0,3,0,0,0,0,0,0,0,0,0,9,9,0,0,9,0,0,0,0,0,0,0,0,0,64656
22389,251,43,129,53,22,4,21,8,5,1,0,4,3,3,0,3,0,0,0,0,0,13,10,0,0,10,3,0,0,0,0,3,3,0,0,64657
22390,2214,259,1278,497,108,72,164,103,92,20,0,72,11,11,7,4,0,0,0,0,0,61,61,22,0,39,0,0,0,0,0,0,0,0,0,64658
22391,588,34,286,160,73,35,71,44,42,6,2,34,2,2,0,2,0,0,0,0,0,27,18,4,0,14,9,9,1,0,8,0,0,0,0,64659
22392,354,48,192,53,39,22,24,18,18,9,0,9,0,0,0,0,0,0,0,0,0,6,6,3,1,2,0,0,0,0,0,0,0,0,0,64660
22393,705,121,317,171,56,40,38,14,14,6,0,8,0,0,0,0,0,0,0,0,0,24,10,0,0,10,14,0,0,0,0,14,0,0,14,64661
22394,332,23,189,71,35,14,10,10,10,10,0,0,0,0,0,0,0,0,0,0,0,0,0,0,0,0,0,0,0,0,0,0,0,0,0,64664
22395,242,17,142,61,17,5,28,23,21,11,0,10,2,0,0,0,0,2,0,0,2,5,5,3,0,2,0,0,0,0,0,0,0,0,0,64667
22396,1058,115,452,321,89,81,52,30,27,7,3,17,3,3,3,0,0,0,0,0,0,22,22,7,0,15,0,0,0,0,0,0,0,0,0,64668
22397,712,120,387,149,37,19,29,19,15,2,0,13,4,4,0,0,4,0,0,0,0,10,9,2,0,7,1,0,0,0,0,1,0,0,1,64670
22398,1472,156,620,437,190,69,86,54,48,3,3,42,6,6,3,3,0,0,0,0,0,32,32,10,8,14,0,0,0,0,0,0,0,0,0,64671
22399,87,8,42,32,0,5,0,0,0,0,0,0,0,0,0,0,0,0,0,0,0,0,0,0,0,0,0,0,0,0,0,0,0,0,0,64672
22400,1631,166,868,389,141,67,135,89,51,11,0,40,38,10,0,5,5,28,0,4,24,46,13,3,0,10,33,0,0,0,0,33,0,0,33,64673
22401,317,54,185,56,13,9,11,9,3,0,0,3,6,6,6,0,0,0,0,0,0,2,2,0,0,2,0,0,0,0,0,0,0,0,0,64674
22402,157,13,83,48,10,3,3,3,3,0,0,3,0,0,0,0,0,0,0,0,0,0,0,0,0,0,0,0,0,0,0,0,0,0,0,64676
22403,451,74,173,129,61,14,32,7,7,3,4,0,0,0,0,0,0,0,0,0,0,25,23,9,12,2,2,0,0,0,0,2,2,0,0,64679
22404,154,19,62,61,12,0,3,1,0,0,0,0,1,1,1,0,0,0,0,0,0,2,2,2,0,0,0,0,0,0,0,0,0,0,0,64681
22405,225,28,134,55,3,5,3,0,0,0,0,0,0,0,0,0,0,0,0,0,0,3,3,3,0,0,0,0,0,0,0,0,0,0,0,64682
22406,5470,718,2112,1772,544,324,425,205,197,79,3,115,8,8,8,0,0,0,0,0,0,220,206,56,0,150,14,0,0,0,0,14,0,0,14,64683
22407,183,28,103,37,14,1,41,30,15,0,6,9,15,15,15,0,0,0,0,0,0,11,5,5,0,0,6,0,0,0,0,6,0,0,6,64686
22408,420,52,216,113,29,10,25,13,5,5,0,0,8,8,8,0,0,0,0,0,0,12,2,2,0,0,10,3,0,3,0,7,3,0,4,64688
22409,392,64,170,116,38,4,8,1,1,0,0,1,0,0,0,0,0,0,0,0,0,7,5,3,0,2,2,2,2,0,0,0,0,0,0,64689
22410,9831,960,3987,2962,1239,683,885,509,370,194,39,137,139,69,69,0,0,70,0,64,6,376,282,146,73,63,94,82,48,0,34,12,12,0,0,64701
22411,2846,383,1280,819,260,104,250,114,108,32,16,60,6,6,0,6,0,0,0,0,0,136,113,59,18,36,23,4,4,0,0,19,19,0,0,64720
22412,295,61,111,113,10,0,14,6,6,3,0,3,0,0,0,0,0,0,0,0,0,8,8,0,0,8,0,0,0,0,0,0,0,0,0,64722
22413,422,68,230,102,22,0,39,21,11,2,3,6,10,10,0,10,0,0,0,0,0,18,18,0,0,18,0,0,0,0,0,0,0,0,0,64723
22414,1297,174,609,284,146,84,54,37,30,4,0,26,7,3,0,3,0,4,0,0,4,17,13,5,2,6,4,4,1,3,0,0,0,0,0,64724
22415,1388,196,587,450,120,35,134,47,44,4,0,40,3,0,0,0,0,3,0,0,3,87,79,22,3,54,8,8,0,0,8,0,0,0,0,64725
22416,361,51,187,98,25,0,12,5,5,0,0,5,0,0,0,0,0,0,0,0,0,7,5,0,0,5,2,0,0,0,0,2,2,0,0,64726
22417,455,44,216,137,43,15,24,17,17,7,0,10,0,0,0,0,0,0,0,0,0,7,4,4,0,0,3,0,0,0,0,3,0,1,2,64728
22418,5027,770,2265,1359,316,317,347,200,140,71,0,69,60,49,46,0,3,11,0,0,11,147,118,70,0,48,29,29,16,13,0,0,0,0,0,64730
22419,844,116,297,288,89,54,61,28,28,4,0,24,0,0,0,0,0,0,0,0,0,33,33,12,1,20,0,0,0,0,0,0,0,0,0,64733
22420,1428,104,477,492,253,102,87,56,56,40,0,16,0,0,0,0,0,0,0,0,0,31,31,19,8,4,0,0,0,0,0,0,0,0,0,64734
22421,9662,1432,3668,2979,958,625,605,301,248,108,29,111,53,31,26,0,5,22,11,0,11,304,288,117,0,171,16,16,12,4,0,0,0,0,0,64735
22422,833,153,313,257,65,45,37,16,10,3,0,7,6,6,6,0,0,0,0,0,0,21,21,21,0,0,0,0,0,0,0,0,0,0,0,64738
22423,624,57,290,151,86,40,43,35,35,0,0,35,0,0,0,0,0,0,0,0,0,8,8,0,0,8,0,0,0,0,0,0,0,0,0,64739
22424,1305,231,734,241,82,17,38,25,21,2,0,19,4,4,0,4,0,0,0,0,0,13,13,0,0,13,0,0,0,0,0,0,0,0,0,64740
22425,289,15,102,121,24,27,28,11,3,0,0,3,8,8,8,0,0,0,0,0,0,17,17,0,0,17,0,0,0,0,0,0,0,0,0,64741
22426,1559,157,629,492,194,87,129,55,38,16,3,19,17,11,11,0,0,6,0,6,0,74,72,14,0,58,2,2,2,0,0,0,0,0,0,64742
22427,178,8,95,61,10,4,7,6,6,6,0,0,0,0,0,0,0,0,0,0,0,1,1,1,0,0,0,0,0,0,0,0,0,0,0,64743
22428,5114,859,2331,1377,420,127,315,164,128,0,0,128,36,0,0,0,0,36,0,0,36,151,129,69,0,60,22,15,0,0,15,7,7,0,0,64744
22429,122,16,54,24,28,0,2,0,0,0,0,0,0,0,0,0,0,0,0,0,0,2,2,0,0,2,0,0,0,0,0,0,0,0,0,64745
22430,1153,102,446,417,155,33,73,12,12,2,1,9,0,0,0,0,0,0,0,0,0,61,55,13,2,40,6,6,6,0,0,0,0,0,0,64746
22431,2591,303,1171,756,304,57,260,125,110,50,0,60,15,3,0,3,0,12,10,0,2,135,79,12,3,64,56,16,16,0,0,40,0,0,40,64747
22432,888,135,430,245,71,7,122,32,29,6,0,23,3,3,0,0,3,0,0,0,0,90,71,12,0,59,19,10,0,0,10,9,6,0,3,64748
22433,236,57,136,40,3,0,24,5,1,0,0,1,4,0,0,0,0,4,0,4,0,19,19,14,0,5,0,0,0,0,0,0,0,0,0,64750
22434,420,59,209,121,21,10,57,40,23,0,0,23,17,17,3,0,14,0,0,0,0,17,15,0,0,15,2,2,0,0,2,0,0,0,0,64752
22435,1610,182,807,347,195,79,103,47,32,13,2,17,15,15,10,5,0,0,0,0,0,56,51,16,0,35,5,0,0,0,0,5,5,0,0,64755
22436,529,87,191,233,18,0,60,32,26,4,0,22,6,6,4,2,0,0,0,0,0,28,13,0,0,13,15,0,0,0,0,15,7,0,8,64756
22437,5833,864,2337,1603,615,414,398,198,129,11,0,118,69,11,4,0,7,58,5,2,51,200,143,75,25,43,57,42,42,0,0,15,12,0,3,64759
22438,1026,102,374,404,101,45,79,28,24,5,2,17,4,2,2,0,0,2,0,0,2,51,51,5,3,43,0,0,0,0,0,0,0,0,0,64761
22439,899,131,339,281,120,28,73,47,33,8,2,23,14,6,3,3,0,8,0,0,8,26,26,3,1,22,0,0,0,0,0,0,0,0,0,64762
22440,1059,244,508,234,51,22,99,49,20,10,0,10,29,0,0,0,0,29,29,0,0,50,50,44,0,6,0,0,0,0,0,0,0,0,0,64763
22441,47,28,13,6,0,0,0,0,0,0,0,0,0,0,0,0,0,0,0,0,0,0,0,0,0,0,0,0,0,0,0,0,0,0,0,64765
22442,311,48,159,94,10,0,17,0,0,0,0,0,0,0,0,0,0,0,0,0,0,17,17,5,0,12,0,0,0,0,0,0,0,0,0,64767
22443,389,53,134,98,50,54,24,16,15,6,0,9,1,0,0,0,0,1,0,0,1,8,8,3,2,3,0,0,0,0,0,0,0,0,0,64769
22444,770,96,346,187,90,51,36,18,5,5,0,0,13,0,0,0,0,13,10,0,3,18,11,1,0,10,7,7,7,0,0,0,0,0,0,64770
22445,463,59,173,143,60,28,19,9,9,0,0,9,0,0,0,0,0,0,0,0,0,10,10,10,0,0,0,0,0,0,0,0,0,0,0,64771
22446,9063,1371,3973,2393,758,568,934,406,328,92,32,204,78,25,25,0,0,53,23,14,16,528,457,196,33,228,71,71,30,11,30,0,0,0,0,64772
22447,2784,506,1386,565,195,132,200,86,76,30,5,41,10,0,0,0,0,10,0,0,10,114,67,10,2,55,47,23,10,9,4,24,0,22,2,64776
22448,366,39,146,137,22,22,20,8,0,0,0,0,8,0,0,0,0,8,0,0,8,12,8,5,0,3,4,0,0,0,0,4,0,4,0,64778
22449,1631,376,623,425,148,59,131,63,43,0,11,32,20,0,0,0,0,20,0,0,20,68,49,9,16,24,19,3,3,0,0,16,8,0,8,64779
22450,541,121,307,48,41,24,44,30,30,0,0,30,0,0,0,0,0,0,0,0,0,14,2,2,0,0,12,0,0,0,0,12,0,4,8,64780
22451,96,33,29,34,0,0,11,4,1,0,0,1,3,0,0,0,0,3,0,3,0,7,3,1,0,2,4,0,0,0,0,4,0,4,0,64781
22452,464,87,205,121,20,31,53,29,29,7,0,22,0,0,0,0,0,0,0,0,0,24,24,6,0,18,0,0,0,0,0,0,0,0,0,64783
22453,1160,211,453,362,92,42,68,58,47,34,0,13,11,0,0,0,0,11,0,0,11,10,10,3,0,7,0,0,0,0,0,0,0,0,0,64784
22454,917,116,430,297,60,14,89,38,27,13,10,4,11,0,0,0,0,11,0,2,9,51,29,6,10,13,22,22,0,17,5,0,0,0,0,64788
22455,543,85,257,146,45,10,46,27,15,2,0,13,12,0,0,0,0,12,12,0,0,19,10,2,0,8,9,5,0,5,0,4,4,0,0,64790
22456,23062,3392,7556,7142,3270,1702,1746,986,857,282,155,420,129,33,13,20,0,96,68,11,17,760,680,399,39,242,80,68,49,19,0,12,12,0,0,64801
22457,24446,3132,7383,8325,3511,2095,2035,884,692,298,34,360,192,177,101,25,51,15,1,3,11,1151,905,355,48,502,246,115,82,1,32,131,31,0,100,64804
22458,449,70,194,119,59,7,20,9,2,2,0,0,7,7,2,5,0,0,0,0,0,11,11,10,0,1,0,0,0,0,0,0,0,0,0,64830
22459,4159,829,1433,1360,356,181,320,144,144,8,0,136,0,0,0,0,0,0,0,0,0,176,130,106,20,4,46,32,32,0,0,14,0,14,0,64831
22460,492,70,208,176,22,16,105,61,60,0,0,60,1,1,1,0,0,0,0,0,0,44,44,0,0,44,0,0,0,0,0,0,0,0,0,64832
22461,57,25,24,6,2,0,6,5,3,0,2,1,2,2,2,0,0,0,0,0,0,1,0,0,0,0,1,1,1,0,0,0,0,0,0,64833
22462,5968,560,1968,1654,1312,474,547,238,238,51,17,170,0,0,0,0,0,0,0,0,0,309,283,68,11,204,26,0,0,0,0,26,11,0,15,64834
22463,1147,147,542,359,81,18,42,25,17,4,0,13,8,8,8,0,0,0,0,0,0,17,13,0,0,13,4,4,1,0,3,0,0,0,0,64835
22464,15378,3641,5481,3604,1809,843,1098,586,490,173,72,245,96,36,29,0,7,60,15,33,12,512,293,63,9,221,219,62,43,1,18,157,41,98,18,64836
22465,1999,323,668,660,271,77,192,103,78,51,0,27,25,25,6,19,0,0,0,0,0,89,82,59,0,23,7,7,7,0,0,0,0,0,0,64840
22466,191,10,71,74,31,5,35,22,10,0,3,7,12,12,12,0,0,0,0,0,0,13,8,5,0,3,5,0,0,0,0,5,5,0,0,64841
22467,569,130,276,131,13,19,57,22,20,2,2,16,2,0,0,0,0,2,0,0,2,35,33,0,0,33,2,1,1,0,0,1,0,0,1,64842
22468,2086,417,798,736,98,37,203,180,124,45,6,73,56,46,5,0,41,10,0,0,10,23,19,8,7,4,4,4,4,0,0,0,0,0,0,64843
22469,2824,415,1172,1070,135,32,371,256,185,64,8,113,71,71,66,5,0,0,0,0,0,115,60,0,10,50,55,55,16,27,12,0,0,0,0,64844
22470,363,143,119,84,17,0,34,28,21,6,0,15,7,0,0,0,0,7,0,7,0,6,6,0,0,6,0,0,0,0,0,0,0,0,0,64847
22471,456,60,270,102,1,23,30,6,6,6,0,0,0,0,0,0,0,0,0,0,0,24,24,0,0,24,0,0,0,0,0,0,0,0,0,64848
22472,118,23,64,26,4,1,22,18,18,0,0,18,0,0,0,0,0,0,0,0,0,4,4,2,0,2,0,0,0,0,0,0,0,0,0,64849
22473,15737,2649,5286,5141,1608,1053,1343,780,592,188,63,341,188,122,122,0,0,66,34,22,10,563,446,172,21,253,117,64,27,0,37,53,44,0,9,64850
22474,2511,727,884,745,86,69,234,101,93,4,68,21,8,0,0,0,0,8,0,0,8,133,133,36,4,93,0,0,0,0,0,0,0,0,0,64854
22475,1890,243,663,465,419,100,95,57,57,16,4,37,0,0,0,0,0,0,0,0,0,38,35,0,0,35,3,3,0,3,0,0,0,0,0,64855
22476,2397,401,946,841,161,48,329,193,177,16,16,145,16,16,16,0,0,0,0,0,0,136,77,0,20,57,59,59,52,7,0,0,0,0,0,64856
22477,304,82,117,82,22,1,39,15,15,1,0,14,0,0,0,0,0,0,0,0,0,24,22,7,0,15,2,2,0,0,2,0,0,0,0,64857
22478,62,0,43,19,0,0,24,24,24,0,0,24,0,0,0,0,0,0,0,0,0,0,0,0,0,0,0,0,0,0,0,0,0,0,0,64858
22479,750,113,238,293,58,48,70,51,51,4,0,47,0,0,0,0,0,0,0,0,0,19,19,0,0,19,0,0,0,0,0,0,0,0,0,64859
22480,1003,219,216,376,166,26,34,19,13,6,0,7,6,0,0,0,0,6,0,0,6,15,10,10,0,0,5,0,0,0,0,5,0,0,5,64861
22481,1708,264,812,408,140,84,267,155,125,36,10,79,30,12,12,0,0,18,18,0,0,112,90,27,4,59,22,9,4,5,0,13,0,11,2,64862
22482,1010,318,333,261,86,12,106,66,53,9,0,44,13,0,0,0,0,13,13,0,0,40,31,0,0,31,9,0,0,0,0,9,0,0,9,64863
22483,3733,590,1369,1248,323,203,365,209,136,63,6,67,73,21,21,0,0,52,0,31,21,156,156,102,0,54,0,0,0,0,0,0,0,0,0,64865
22484,970,138,384,314,68,66,94,42,39,0,0,39,3,0,0,0,0,3,3,0,0,52,40,14,0,26,12,1,1,0,0,11,0,0,11,64866
22485,1113,196,383,435,76,23,72,24,9,0,1,8,15,0,0,0,0,15,0,0,15,48,45,0,0,45,3,3,3,0,0,0,0,0,0,64867
22486,8956,1028,3072,3091,1278,487,861,377,309,75,0,234,68,60,56,4,0,8,8,0,0,484,468,294,38,136,16,6,6,0,0,10,7,0,3,64870
22487,708,181,396,116,12,3,1,0,0,0,0,0,0,0,0,0,0,0,0,0,0,1,1,1,0,0,0,0,0,0,0,0,0,0,0,64873
22488,504,87,208,156,49,4,41,32,32,0,13,19,0,0,0,0,0,0,0,0,0,9,9,7,0,2,0,0,0,0,0,0,0,0,0,64874
22489,229,52,127,28,5,17,5,4,2,2,0,0,2,0,0,0,0,2,0,2,0,1,1,0,0,1,0,0,0,0,0,0,0,0,0,65001
22490,4091,250,1073,1291,1072,405,236,122,119,0,0,119,3,3,0,3,0,0,0,0,0,114,105,30,12,63,9,9,9,0,0,0,0,0,0,65010
22491,1343,443,491,276,99,34,79,26,9,0,3,6,17,0,0,0,0,17,3,0,14,53,0,0,0,0,53,0,0,0,0,53,31,0,22,65011
22492,2164,389,1037,503,163,72,225,91,85,19,28,38,6,6,6,0,0,0,0,0,0,134,93,28,0,65,41,26,26,0,0,15,0,0,15,65013
22493,1758,307,801,473,117,60,94,59,48,30,0,18,11,11,0,11,0,0,0,0,0,35,35,12,0,23,0,0,0,0,0,0,0,0,0,65014
22494,942,81,508,160,148,45,161,96,85,38,0,47,11,11,0,11,0,0,0,0,0,65,65,17,5,43,0,0,0,0,0,0,0,0,0,65016
22495,1068,275,490,198,51,54,166,11,11,0,0,11,0,0,0,0,0,0,0,0,0,155,155,75,0,80,0,0,0,0,0,0,0,0,0,65017
22496,5095,658,1946,1227,898,366,244,140,114,28,0,86,26,0,0,0,0,26,10,0,16,104,99,43,16,40,5,0,0,0,0,5,5,0,0,65018
22497,10354,1247,3606,3509,1196,796,560,355,269,102,9,158,86,83,67,7,9,3,0,0,3,205,181,45,0,136,24,18,11,7,0,6,6,0,0,65020
22498,1076,107,523,296,113,37,44,32,29,18,0,11,3,1,1,0,0,2,0,0,2,12,10,0,0,10,2,0,0,0,0,2,0,0,2,65023
22499,757,74,331,200,92,60,60,28,22,4,0,18,6,0,0,0,0,6,6,0,0,32,30,7,0,23,2,2,0,0,2,0,0,0,0,65024
22500,493,78,195,133,45,42,52,13,12,1,3,8,1,0,0,0,0,1,1,0,0,39,23,17,0,6,16,0,0,0,0,16,8,0,8,65025
22501,6986,1193,2878,1918,624,373,397,221,175,32,50,93,46,27,27,0,0,19,10,0,9,176,169,106,33,30,7,7,7,0,0,0,0,0,0,65026
22502,1237,254,528,291,129,35,296,101,79,39,13,27,22,22,22,0,0,0,0,0,0,195,195,77,0,118,0,0,0,0,0,0,0,0,0,65032
22503,372,197,126,31,18,0,40,0,0,0,0,0,0,0,0,0,0,0,0,0,0,40,30,0,0,30,10,0,0,0,0,10,10,0,0,65034
22504,1235,124,617,272,198,24,111,39,38,19,0,19,1,0,0,0,0,1,1,0,0,72,69,9,11,49,3,3,3,0,0,0,0,0,0,65035
22505,3862,526,1492,1223,472,149,137,50,34,14,9,11,16,4,4,0,0,12,0,12,0,87,72,28,0,44,15,0,0,0,0,15,10,5,0,65037
22506,2003,200,728,503,364,208,127,40,40,12,8,20,0,0,0,0,0,0,0,0,0,87,64,16,8,40,23,23,23,0,0,0,0,0,0,65039
22507,886,59,419,212,115,81,120,64,53,0,0,53,11,11,11,0,0,0,0,0,0,56,56,39,0,17,0,0,0,0,0,0,0,0,0,65040
22508,4230,670,1715,1045,524,276,225,85,70,64,0,6,15,10,10,0,0,5,0,0,5,140,126,87,0,39,14,9,9,0,0,5,0,5,0,65041
22509,6479,613,2268,1969,1090,539,588,360,268,38,46,184,92,49,3,28,18,43,43,0,0,228,218,78,3,137,10,0,0,0,0,10,10,0,0,65043
22510,824,75,413,167,119,50,75,57,32,8,3,21,25,25,4,19,2,0,0,0,0,18,17,5,0,12,1,0,0,0,0,1,1,0,0,65046
22511,1112,71,496,430,91,24,18,0,0,0,0,0,0,0,0,0,0,0,0,0,0,18,18,0,0,18,0,0,0,0,0,0,0,0,0,65047
22512,98,22,25,9,42,0,22,9,9,9,0,0,0,0,0,0,0,0,0,0,0,13,13,0,0,13,0,0,0,0,0,0,0,0,0,65048
22513,4626,237,1318,1648,1008,415,264,116,68,15,4,49,48,32,32,0,0,16,3,0,13,148,140,61,0,79,8,8,0,0,8,0,0,0,0,65049
22514,403,243,124,21,12,3,63,27,3,0,0,3,24,0,0,0,0,24,20,0,4,36,2,0,0,2,34,4,0,0,4,30,30,0,0,65050
22515,3303,414,1559,929,273,128,319,217,183,39,0,144,34,34,4,0,30,0,0,0,0,102,75,18,4,53,27,25,8,0,17,2,2,0,0,65051
22516,2943,185,961,1094,465,238,82,55,37,32,0,5,18,18,0,18,0,0,0,0,0,27,13,0,13,0,14,14,14,0,0,0,0,0,0,65052
22517,1019,73,386,221,186,153,113,61,61,35,0,26,0,0,0,0,0,0,0,0,0,52,52,22,0,30,0,0,0,0,0,0,0,0,0,65053
22518,541,46,319,126,32,18,21,0,0,0,0,0,0,0,0,0,0,0,0,0,0,21,21,0,0,21,0,0,0,0,0,0,0,0,0,65054
22519,770,200,346,151,60,13,61,49,43,13,0,30,6,6,6,0,0,0,0,0,0,12,12,2,3,7,0,0,0,0,0,0,0,0,0,65058
22520,525,70,172,148,74,61,111,24,24,0,0,24,0,0,0,0,0,0,0,0,0,87,87,21,1,65,0,0,0,0,0,0,0,0,0,65059
22521,544,72,318,91,25,38,37,15,15,0,0,15,0,0,0,0,0,0,0,0,0,22,14,11,0,3,8,8,0,0,8,0,0,0,0,65061
22522,25,0,0,0,14,11,0,0,0,0,0,0,0,0,0,0,0,0,0,0,0,0,0,0,0,0,0,0,0,0,0,0,0,0,0,65062
22523,2344,285,859,667,405,128,267,114,91,46,0,45,23,23,17,6,0,0,0,0,0,153,93,29,15,49,60,45,42,0,3,15,15,0,0,65063
22524,324,29,104,119,65,7,10,4,4,0,0,4,0,0,0,0,0,0,0,0,0,6,6,4,2,0,0,0,0,0,0,0,0,0,0,65064
22525,4882,501,1468,1715,801,397,149,47,47,27,0,20,0,0,0,0,0,0,0,0,0,102,102,64,0,38,0,0,0,0,0,0,0,0,0,65065
22526,4333,729,1839,1192,437,136,385,184,136,75,14,47,48,28,15,13,0,20,0,0,20,201,188,80,41,67,13,13,0,0,13,0,0,0,0,65066
22527,324,117,84,106,17,0,14,0,0,0,0,0,0,0,0,0,0,0,0,0,0,14,14,0,0,14,0,0,0,0,0,0,0,0,0,65067
22528,535,63,184,204,50,34,52,15,11,0,0,11,4,4,4,0,0,0,0,0,0,37,26,7,0,19,11,3,0,0,3,8,0,0,8,65068
22529,514,61,252,135,53,13,67,39,32,4,4,24,7,7,7,0,0,0,0,0,0,28,28,17,9,2,0,0,0,0,0,0,0,0,0,65069
22530,1374,151,574,435,139,75,49,31,22,0,10,12,9,9,0,9,0,0,0,0,0,18,18,0,0,18,0,0,0,0,0,0,0,0,0,65072
22531,1927,208,815,536,233,135,153,69,69,13,0,56,0,0,0,0,0,0,0,0,0,84,78,25,14,39,6,0,0,0,0,6,0,0,6,65074
22532,642,78,271,167,83,43,30,9,5,2,0,3,4,0,0,0,0,4,0,0,4,21,21,7,0,14,0,0,0,0,0,0,0,0,0,65075
22533,509,70,212,114,102,11,34,21,18,9,0,9,3,3,3,0,0,0,0,0,0,13,13,0,0,13,0,0,0,0,0,0,0,0,0,65076
22534,377,85,178,76,27,11,23,0,0,0,0,0,0,0,0,0,0,0,0,0,0,23,23,0,0,23,0,0,0,0,0,0,0,0,0,65077
22535,2418,360,1117,665,173,103,153,120,87,31,0,56,33,16,16,0,0,17,17,0,0,33,29,0,3,26,4,0,0,0,0,4,0,4,0,65078
22536,3841,453,1460,1154,411,363,199,80,68,0,13,55,12,0,0,0,0,12,0,12,0,119,103,15,16,72,16,0,0,0,0,16,0,16,0,65079
22537,478,6,188,131,123,30,21,21,21,0,0,21,0,0,0,0,0,0,0,0,0,0,0,0,0,0,0,0,0,0,0,0,0,0,0,65080
22538,2849,696,1136,729,208,80,240,88,69,11,24,34,19,7,7,0,0,12,12,0,0,152,152,100,0,52,0,0,0,0,0,0,0,0,0,65081
22539,955,185,449,205,77,39,31,14,14,5,0,9,0,0,0,0,0,0,0,0,0,17,17,6,0,11,0,0,0,0,0,0,0,0,0,65082
22540,196,18,97,15,43,23,0,0,0,0,0,0,0,0,0,0,0,0,0,0,0,0,0,0,0,0,0,0,0,0,0,0,0,0,0,65083
22541,4841,1265,1941,1150,390,95,480,198,105,28,34,43,93,77,6,62,9,16,0,0,16,282,261,32,42,187,21,7,7,0,0,14,4,0,10,65084
22542,795,120,312,218,100,45,98,73,73,23,0,50,0,0,0,0,0,0,0,0,0,25,25,4,0,21,0,0,0,0,0,0,0,0,0,65085
22543,19472,2092,6605,5538,3551,1686,1472,652,496,170,21,305,156,137,73,22,42,19,0,0,19,820,734,263,39,432,86,75,0,9,66,11,4,0,7,65101
22544,27266,2251,7523,7897,6211,3384,2026,1100,935,378,40,517,165,114,65,26,23,51,0,28,23,926,749,352,10,387,177,161,57,26,78,16,8,0,8,65109
22545,16070,1163,2711,4053,4266,3877,7549,3269,3224,1061,140,2023,45,37,30,0,7,8,0,0,8,4280,4205,1415,267,2523,75,41,13,0,28,34,0,0,34,65201
22546,28568,2480,7079,8170,7449,3390,1408,658,546,138,14,394,112,63,38,13,12,49,3,41,5,750,642,78,42,522,108,64,34,7,23,44,26,0,18,65202
22547,34748,1685,4562,7106,11130,10265,2529,1394,1286,592,156,538,108,82,49,15,18,26,12,0,14,1135,1012,360,152,500,123,107,79,17,11,16,0,0,16,65203
22548,0,0,0,0,0,0,180,12,12,6,0,6,0,0,0,0,0,0,0,0,0,168,168,80,26,62,0,0,0,0,0,0,0,0,0,65215
22549,509,96,217,107,59,30,13,7,7,3,0,4,0,0,0,0,0,0,0,0,0,6,6,4,0,2,0,0,0,0,0,0,0,0,0,65230
22550,2055,218,932,638,157,110,253,52,45,4,0,41,7,7,7,0,0,0,0,0,0,201,170,50,17,103,31,9,0,0,9,22,0,0,22,65231
22551,151,44,62,30,5,10,32,14,5,0,0,5,9,4,0,0,4,5,0,0,5,18,15,10,0,5,3,3,0,0,3,0,0,0,0,65232
22552,7931,1184,3050,2204,1026,467,537,341,243,49,19,175,98,44,13,10,21,54,0,0,54,196,131,45,8,78,65,55,50,5,0,10,0,0,10,65233
22553,991,172,437,264,80,38,87,48,32,5,0,27,16,3,0,3,0,13,0,13,0,39,34,13,4,17,5,5,5,0,0,0,0,0,0,65236
22554,601,85,268,151,71,26,59,49,31,4,6,21,18,10,2,6,2,8,0,8,0,10,10,1,0,9,0,0,0,0,0,0,0,0,0,65237
22555,747,62,323,281,52,29,67,34,27,7,15,5,7,0,0,0,0,7,0,7,0,33,30,2,0,28,3,0,0,0,0,3,3,0,0,65239
22556,5181,450,1985,1386,919,441,362,242,194,46,24,124,48,21,10,0,11,27,0,0,27,120,113,55,14,44,7,7,7,0,0,0,0,0,0,65240
22557,1681,357,569,537,137,81,182,123,90,23,0,67,33,8,8,0,0,25,20,0,5,59,31,9,2,20,28,0,0,0,0,28,0,0,28,65243
22558,195,34,96,57,5,3,33,4,0,0,0,0,4,4,0,4,0,0,0,0,0,29,26,0,0,26,3,3,3,0,0,0,0,0,0,65244
22559,120,11,61,28,16,4,10,0,0,0,0,0,0,0,0,0,0,0,0,0,0,10,10,0,0,10,0,0,0,0,0,0,0,0,0,65246
22560,571,84,313,147,15,12,96,68,26,26,0,0,42,42,0,0,42,0,0,0,0,28,28,28,0,0,0,0,0,0,0,0,0,0,0,65247
22561,2641,285,753,760,511,332,405,229,228,67,3,158,1,1,0,0,1,0,0,0,0,176,170,44,0,126,6,0,0,0,0,6,0,0,6,65248
22562,417,99,173,66,70,9,41,24,19,3,0,16,5,0,0,0,0,5,0,5,0,17,17,17,0,0,0,0,0,0,0,0,0,0,0,65250
22563,14544,2374,5477,3576,2080,1037,1562,682,476,28,29,419,206,74,36,0,38,132,0,84,48,880,762,270,37,455,118,60,19,0,41,58,33,0,25,65251
22564,1225,153,601,273,132,66,122,51,44,36,0,8,7,5,5,0,0,2,2,0,0,71,63,18,5,40,8,8,0,0,8,0,0,0,0,65254
22565,2603,293,933,802,302,273,267,147,131,21,6,104,16,16,4,0,12,0,0,0,0,120,112,43,0,69,8,8,0,0,8,0,0,0,0,65255
22566,1144,78,378,367,205,116,120,75,66,12,2,52,9,0,0,0,0,9,0,0,9,45,43,0,0,43,2,2,1,1,0,0,0,0,0,65256
22567,984,155,404,307,93,25,62,39,29,5,0,24,10,10,10,0,0,0,0,0,0,23,23,0,0,23,0,0,0,0,0,0,0,0,0,65257
22568,305,35,122,109,25,14,29,22,22,12,3,7,0,0,0,0,0,0,0,0,0,7,6,0,3,3,1,1,0,0,1,0,0,0,0,65258
22569,1904,271,830,554,165,84,190,153,106,24,0,82,47,29,29,0,0,18,0,13,5,37,37,12,4,21,0,0,0,0,0,0,0,0,0,65259
22570,417,50,186,124,33,24,18,11,9,0,0,9,2,2,2,0,0,0,0,0,0,7,7,2,0,5,0,0,0,0,0,0,0,0,0,65260
22571,821,120,416,172,89,24,12,4,4,1,0,3,0,0,0,0,0,0,0,0,0,8,8,1,0,7,0,0,0,0,0,0,0,0,0,65261
22572,626,91,242,221,65,7,0,0,0,0,0,0,0,0,0,0,0,0,0,0,0,0,0,0,0,0,0,0,0,0,0,0,0,0,0,65262
22573,1356,207,670,363,72,44,88,35,32,8,8,16,3,0,0,0,0,3,3,0,0,53,29,9,0,20,24,2,2,0,0,22,4,0,18,65263
22574,420,50,188,113,56,13,19,3,3,0,0,3,0,0,0,0,0,0,0,0,0,16,10,2,1,7,6,0,0,0,0,6,6,0,0,65264
22575,10137,1404,4550,2702,848,633,796,386,308,116,21,171,78,61,9,43,9,17,0,17,0,410,357,140,51,166,53,34,19,6,9,19,0,0,19,65265
22576,12305,1920,4590,3980,1155,660,841,376,312,92,53,167,64,38,23,15,0,26,0,16,10,465,389,179,15,195,76,21,9,12,0,55,0,23,32,65270
22577,1424,260,650,305,148,61,127,45,39,18,0,21,6,3,3,0,0,3,0,0,3,82,24,13,0,11,58,48,5,0,43,10,0,0,10,65274
22578,1831,232,820,492,193,94,186,112,73,12,5,56,39,39,18,20,1,0,0,0,0,74,52,34,0,18,22,22,13,2,7,0,0,0,0,65275
22579,1085,100,530,276,123,56,88,35,30,7,6,17,5,5,5,0,0,0,0,0,0,53,39,10,8,21,14,0,0,0,0,14,0,0,14,65276
22580,81,7,64,8,1,1,6,6,6,0,3,3,0,0,0,0,0,0,0,0,0,0,0,0,0,0,0,0,0,0,0,0,0,0,0,65278
22581,1265,75,301,260,286,343,41,37,29,1,9,19,8,0,0,0,0,8,0,0,8,4,4,4,0,0,0,0,0,0,0,0,0,0,0,65279
22582,205,25,108,69,0,3,4,2,2,0,0,2,0,0,0,0,0,0,0,0,0,2,0,0,0,0,2,2,0,0,2,0,0,0,0,65280
22583,2154,326,1058,506,170,94,212,112,95,19,0,76,17,13,13,0,0,4,4,0,0,100,92,53,0,39,8,8,8,0,0,0,0,0,0,65281
22584,132,33,37,54,0,8,18,0,0,0,0,0,0,0,0,0,0,0,0,0,0,18,18,18,0,0,0,0,0,0,0,0,0,0,0,65282
22585,359,19,251,54,35,0,2,0,0,0,0,0,0,0,0,0,0,0,0,0,0,2,2,2,0,0,0,0,0,0,0,0,0,0,0,65283
22586,1671,151,464,702,263,91,60,45,38,12,0,26,7,7,7,0,0,0,0,0,0,15,9,0,2,7,6,6,6,0,0,0,0,0,0,65284
22587,653,32,344,183,52,42,34,34,34,17,17,0,0,0,0,0,0,0,0,0,0,0,0,0,0,0,0,0,0,0,0,0,0,0,0,65285
22588,86,27,15,39,5,0,14,6,6,0,0,6,0,0,0,0,0,0,0,0,0,8,3,0,0,3,5,5,0,5,0,0,0,0,0,65286
22589,279,14,91,104,68,2,37,19,19,0,0,19,0,0,0,0,0,0,0,0,0,18,2,2,0,0,16,16,0,0,16,0,0,0,0,65287
22590,22738,4194,7273,7708,2341,1222,1716,824,720,274,62,384,104,82,62,20,0,22,10,9,3,892,720,307,37,376,172,135,118,0,17,37,31,3,3,65301
22591,1086,7,236,618,146,79,256,216,72,51,0,21,144,144,144,0,0,0,0,0,0,40,24,11,2,11,16,16,16,0,0,0,0,0,0,65305
22592,37,0,12,8,15,2,0,0,0,0,0,0,0,0,0,0,0,0,0,0,0,0,0,0,0,0,0,0,0,0,0,0,0,0,0,65320
22593,339,30,120,124,42,23,87,46,46,22,0,24,0,0,0,0,0,0,0,0,0,41,41,28,0,13,0,0,0,0,0,0,0,0,0,65321
22594,391,61,137,135,36,22,73,64,62,9,2,51,2,0,0,0,0,2,0,0,2,9,7,5,2,0,2,2,0,2,0,0,0,0,0,65322
22595,659,101,283,187,61,27,31,13,13,6,0,7,0,0,0,0,0,0,0,0,0,18,17,2,0,15,1,1,1,0,0,0,0,0,0,65323
22596,1353,106,657,433,96,61,27,21,21,0,0,21,0,0,0,0,0,0,0,0,0,6,6,3,0,3,0,0,0,0,0,0,0,0,0,65324
22597,2337,373,934,719,190,121,156,111,99,29,20,50,12,8,0,0,8,4,0,0,4,45,37,18,8,11,8,8,0,8,0,0,0,0,0,65325
22598,1388,260,596,384,91,57,84,69,69,56,0,13,0,0,0,0,0,0,0,0,0,15,15,0,0,15,0,0,0,0,0,0,0,0,0,65326
22599,164,29,46,54,32,3,20,8,8,1,0,7,0,0,0,0,0,0,0,0,0,12,12,0,0,12,0,0,0,0,0,0,0,0,0,65327
22600,388,59,209,47,39,34,6,6,6,0,0,6,0,0,0,0,0,0,0,0,0,0,0,0,0,0,0,0,0,0,0,0,0,0,0,65329
22601,316,67,150,70,18,11,18,11,9,0,0,9,2,2,0,0,2,0,0,0,0,7,7,2,0,5,0,0,0,0,0,0,0,0,0,65330
22602,1083,168,377,402,65,71,59,22,20,4,0,16,2,2,0,0,2,0,0,0,0,37,32,5,0,27,5,5,0,5,0,0,0,0,0,65332
22603,455,73,146,147,56,33,34,16,10,1,0,9,6,2,0,2,0,4,0,0,4,18,18,3,3,12,0,0,0,0,0,0,0,0,0,65333
22604,622,87,260,180,67,28,27,4,4,0,3,1,0,0,0,0,0,0,0,0,0,23,22,15,0,7,1,0,0,0,0,1,1,0,0,65334
22605,96,26,47,12,9,2,0,0,0,0,0,0,0,0,0,0,0,0,0,0,0,0,0,0,0,0,0,0,0,0,0,0,0,0,0,65335
22606,3265,328,1181,1330,333,93,218,91,76,15,4,57,15,15,15,0,0,0,0,0,0,127,95,56,0,39,32,32,32,0,0,0,0,0,0,65336
22607,1241,334,391,352,125,39,79,41,27,10,4,13,14,2,2,0,0,12,12,0,0,38,32,4,0,28,6,0,0,0,0,6,0,0,6,65337
22608,2095,379,1017,510,118,71,115,47,23,6,3,14,24,24,0,0,24,0,0,0,0,68,68,25,0,43,0,0,0,0,0,0,0,0,0,65338
22609,465,71,165,125,78,26,43,18,1,0,0,1,17,17,14,3,0,0,0,0,0,25,25,10,2,13,0,0,0,0,0,0,0,0,0,65339
22610,9835,1692,3814,2440,1196,693,1172,561,523,198,54,271,38,16,16,0,0,22,8,0,14,611,494,166,46,282,117,37,29,0,8,80,0,0,80,65340
22611,235,31,83,71,31,19,18,12,12,0,0,12,0,0,0,0,0,0,0,0,0,6,3,0,0,3,3,0,0,0,0,3,0,3,0,65344
22612,332,36,102,175,10,9,65,57,32,0,0,32,25,25,25,0,0,0,0,0,0,8,0,0,0,0,8,8,8,0,0,0,0,0,0,65345
22613,649,82,275,230,55,7,23,8,8,5,0,3,0,0,0,0,0,0,0,0,0,15,15,10,2,3,0,0,0,0,0,0,0,0,0,65347
22614,985,135,409,278,81,82,135,62,55,14,2,39,7,3,3,0,0,4,4,0,0,73,64,11,0,53,9,9,3,3,3,0,0,0,0,65348
22615,1775,302,851,424,132,66,184,126,120,35,2,83,6,6,2,4,0,0,0,0,0,58,52,33,0,19,6,6,6,0,0,0,0,0,0,65349
22616,1110,133,393,417,119,48,93,64,62,11,5,46,2,0,0,0,0,2,2,0,0,29,27,13,0,14,2,0,0,0,0,2,2,0,0,65350
22617,1781,349,708,484,169,71,156,83,83,24,0,59,0,0,0,0,0,0,0,0,0,73,70,25,0,45,3,3,3,0,0,0,0,0,0,65351
22618,470,130,259,76,4,1,15,6,6,0,3,3,0,0,0,0,0,0,0,0,0,9,7,5,0,2,2,2,2,0,0,0,0,0,0,65354
22619,8403,1359,3961,2185,552,346,392,163,139,12,9,118,24,24,17,0,7,0,0,0,0,229,165,84,36,45,64,64,0,23,41,0,0,0,0,65355
22620,3063,447,1303,1030,192,91,288,117,89,0,0,89,28,11,0,0,11,17,17,0,0,171,142,62,8,72,29,3,0,0,3,26,10,0,16,65360
22621,18349,2171,5567,4898,3018,2695,2673,1630,1556,380,119,1057,74,42,11,5,26,32,0,28,4,1043,917,233,116,568,126,62,0,0,62,64,13,0,51,65401
22622,32,0,24,4,4,0,0,0,0,0,0,0,0,0,0,0,0,0,0,0,0,0,0,0,0,0,0,0,0,0,0,0,0,0,0,65436
22623,1842,357,807,456,127,95,185,127,115,76,19,20,12,0,0,0,0,12,6,6,0,58,40,10,11,19,18,18,0,0,18,0,0,0,0,65438
22624,280,81,102,97,0,0,0,0,0,0,0,0,0,0,0,0,0,0,0,0,0,0,0,0,0,0,0,0,0,0,0,0,0,0,0,65439
22625,298,55,137,57,42,7,4,0,0,0,0,0,0,0,0,0,0,0,0,0,0,4,4,0,0,4,0,0,0,0,0,0,0,0,0,65440
22626,3971,910,1574,1097,273,117,175,87,59,11,7,41,28,16,0,16,0,12,12,0,0,88,45,13,14,18,43,27,27,0,0,16,16,0,0,65441
22627,88,0,38,0,42,8,0,0,0,0,0,0,0,0,0,0,0,0,0,0,0,0,0,0,0,0,0,0,0,0,0,0,0,0,0,65443
22628,652,60,262,214,100,16,69,48,37,8,0,29,11,3,3,0,0,8,0,8,0,21,17,17,0,0,4,4,4,0,0,0,0,0,0,65444
22629,325,101,52,44,68,60,0,0,0,0,0,0,0,0,0,0,0,0,0,0,0,0,0,0,0,0,0,0,0,0,0,0,0,0,0,65446
22630,217,84,13,73,14,33,53,0,0,0,0,0,0,0,0,0,0,0,0,0,0,53,53,21,0,32,0,0,0,0,0,0,0,0,0,65449
22631,2017,240,795,679,174,129,217,107,97,18,0,79,10,10,2,0,8,0,0,0,0,110,100,2,0,98,10,3,2,1,0,7,7,0,0,65452
22632,5477,1071,2269,1442,415,280,485,308,239,82,20,137,69,57,33,24,0,12,0,0,12,177,136,23,0,113,41,41,38,0,3,0,0,0,0,65453
22633,318,50,158,60,50,0,20,11,11,0,0,11,0,0,0,0,0,0,0,0,0,9,9,0,0,9,0,0,0,0,0,0,0,0,0,65456
22634,143,0,48,64,0,31,139,79,0,0,0,0,79,79,79,0,0,0,0,0,0,60,0,0,0,0,60,60,60,0,0,0,0,0,0,65457
22635,5324,924,2158,1504,511,227,389,267,243,49,11,183,24,19,0,19,0,5,0,0,5,122,118,85,3,30,4,4,0,1,3,0,0,0,0,65459
22636,55,0,31,24,0,0,6,6,6,0,0,6,0,0,0,0,0,0,0,0,0,0,0,0,0,0,0,0,0,0,0,0,0,0,0,65461
22637,996,138,418,279,100,61,98,49,38,9,0,29,11,8,8,0,0,3,3,0,0,49,49,8,23,18,0,0,0,0,0,0,0,0,0,65462
22638,652,177,246,203,0,26,60,0,0,0,0,0,0,0,0,0,0,0,0,0,0,60,60,0,0,60,0,0,0,0,0,0,0,0,0,65463
22639,392,63,94,173,32,30,0,0,0,0,0,0,0,0,0,0,0,0,0,0,0,0,0,0,0,0,0,0,0,0,0,0,0,0,0,65464
22640,1079,170,394,329,143,43,30,7,1,0,0,1,6,6,6,0,0,0,0,0,0,23,23,23,0,0,0,0,0,0,0,0,0,0,0,65466
22641,262,14,115,100,33,0,0,0,0,0,0,0,0,0,0,0,0,0,0,0,0,0,0,0,0,0,0,0,0,0,0,0,0,0,0,65468
22642,664,210,247,130,50,27,21,21,9,0,0,9,12,12,12,0,0,0,0,0,0,0,0,0,0,0,0,0,0,0,0,0,0,0,0,65470
22643,4901,111,1276,2321,925,268,4133,3018,881,675,15,191,2137,2101,2097,4,0,36,26,10,0,1115,529,415,0,114,586,586,580,0,6,0,0,0,0,65473
22644,209,58,83,68,0,0,0,0,0,0,0,0,0,0,0,0,0,0,0,0,0,0,0,0,0,0,0,0,0,0,0,0,0,0,0,65479
22645,3372,552,1495,888,333,104,346,180,180,16,0,164,0,0,0,0,0,0,0,0,0,166,136,24,13,99,30,23,16,0,7,7,7,0,0,65483
22646,166,32,28,78,15,13,0,0,0,0,0,0,0,0,0,0,0,0,0,0,0,0,0,0,0,0,0,0,0,0,0,0,0,0,0,65484
22647,2267,325,1059,659,80,144,237,161,156,30,0,126,5,5,3,2,0,0,0,0,0,76,74,15,0,59,2,0,0,0,0,2,0,2,0,65486
22648,169,51,58,52,4,4,14,14,6,0,6,0,8,0,0,0,0,8,8,0,0,0,0,0,0,0,0,0,0,0,0,0,0,0,0,65501
22649,134,36,54,27,17,0,9,0,0,0,0,0,0,0,0,0,0,0,0,0,0,9,9,0,0,9,0,0,0,0,0,0,0,0,0,65529
22650,885,12,455,357,40,21,56,33,33,24,0,9,0,0,0,0,0,0,0,0,0,23,0,0,0,0,23,23,14,5,4,0,0,0,0,65534
22651,1051,291,404,264,74,18,73,44,30,9,0,21,14,11,8,0,3,3,0,0,3,29,29,0,3,26,0,0,0,0,0,0,0,0,0,65535
22652,19813,3517,8350,5240,1692,1014,1634,870,650,214,49,387,220,141,5,105,31,79,9,48,22,764,721,305,138,278,43,2,2,0,0,41,4,24,13,65536
22653,98,17,38,31,0,12,0,0,0,0,0,0,0,0,0,0,0,0,0,0,0,0,0,0,0,0,0,0,0,0,0,0,0,0,0,65541
22654,4645,967,2120,1158,227,173,303,159,95,6,0,89,64,15,15,0,0,49,2,3,44,144,142,90,0,52,2,2,0,0,2,0,0,0,0,65542
22655,310,25,154,26,77,28,22,14,14,0,0,14,0,0,0,0,0,0,0,0,0,8,8,0,0,8,0,0,0,0,0,0,0,0,0,65543
22656,3854,673,1564,1152,263,202,264,149,124,58,26,40,25,15,15,0,0,10,0,10,0,115,77,3,5,69,38,13,13,0,0,25,11,3,11,65548
22657,2836,556,1273,671,178,158,167,87,87,37,27,23,0,0,0,0,0,0,0,0,0,80,76,33,0,43,4,4,0,0,4,0,0,0,0,65550
22658,1359,173,558,451,153,24,152,143,76,0,4,72,67,67,67,0,0,0,0,0,0,9,9,3,0,6,0,0,0,0,0,0,0,0,0,65552
22659,854,148,481,166,49,10,76,53,48,8,14,26,5,5,0,5,0,0,0,0,0,23,17,9,0,8,6,5,4,0,1,1,0,0,1,65555
22660,4243,711,1674,1199,345,314,218,151,122,4,0,118,29,29,1,0,28,0,0,0,0,67,44,16,6,22,23,0,0,0,0,23,12,6,5,65556
22661,63,9,35,10,9,0,0,0,0,0,0,0,0,0,0,0,0,0,0,0,0,0,0,0,0,0,0,0,0,0,0,0,0,0,0,65557
22662,6283,890,2469,1515,905,504,360,232,206,106,21,79,26,26,20,6,0,0,0,0,0,128,118,37,0,81,10,0,0,0,0,10,0,0,10,65559
22663,10087,2351,3839,2751,673,473,682,360,288,129,0,159,72,72,55,0,17,0,0,0,0,322,290,118,33,139,32,23,23,0,0,9,9,0,0,65560
22664,212,11,201,0,0,0,47,38,38,0,0,38,0,0,0,0,0,0,0,0,0,9,9,0,0,9,0,0,0,0,0,0,0,0,0,65564
22665,3972,959,1648,709,451,205,318,76,57,0,28,29,19,10,7,0,3,9,9,0,0,242,205,34,11,160,37,18,11,0,7,19,0,12,7,65565
22666,539,110,201,125,85,18,63,34,28,15,3,10,6,3,2,1,0,3,0,3,0,29,29,3,14,12,0,0,0,0,0,0,0,0,0,65566
22667,841,150,369,203,117,2,152,57,44,0,0,44,13,5,0,0,5,8,0,0,8,95,95,24,0,71,0,0,0,0,0,0,0,0,0,65567
22668,344,52,175,90,13,14,25,6,4,0,0,4,2,0,0,0,0,2,2,0,0,19,17,0,12,5,2,0,0,0,0,2,0,0,2,65570
22669,1291,298,538,336,72,47,50,13,3,3,0,0,10,0,0,0,0,10,10,0,0,37,26,0,10,16,11,0,0,0,0,11,0,11,0,65571
22670,592,166,217,133,29,47,35,35,35,11,0,24,0,0,0,0,0,0,0,0,0,0,0,0,0,0,0,0,0,0,0,0,0,0,0,65580
22671,1376,132,484,405,245,110,51,16,16,5,0,11,0,0,0,0,0,0,0,0,0,35,35,11,8,16,0,0,0,0,0,0,0,0,0,65582
22672,7124,692,1744,2711,1015,962,662,356,285,23,21,241,71,71,18,53,0,0,0,0,0,306,269,59,64,146,37,37,20,0,17,0,0,0,0,65583
22673,6261,475,2016,2236,974,560,299,206,162,0,27,135,44,6,6,0,0,38,8,0,30,93,93,16,0,77,0,0,0,0,0,0,0,0,0,65584
22674,17,0,17,0,0,0,0,0,0,0,0,0,0,0,0,0,0,0,0,0,0,0,0,0,0,0,0,0,0,0,0,0,0,0,0,65586
22675,1850,400,803,479,59,109,195,72,63,22,7,34,9,9,0,9,0,0,0,0,0,123,123,43,0,80,0,0,0,0,0,0,0,0,0,65588
22676,168,12,105,15,32,4,0,0,0,0,0,0,0,0,0,0,0,0,0,0,0,0,0,0,0,0,0,0,0,0,0,0,0,0,0,65589
22677,598,174,290,74,44,16,102,42,29,14,0,15,13,13,13,0,0,0,0,0,0,60,0,0,0,0,60,49,49,0,0,11,0,0,11,65590
22678,1169,233,605,271,34,26,143,112,92,23,50,19,20,8,8,0,0,12,0,0,12,31,14,0,0,14,17,17,17,0,0,0,0,0,0,65591
22679,534,180,204,136,7,7,33,13,13,7,0,6,0,0,0,0,0,0,0,0,0,20,7,2,0,5,13,13,0,0,13,0,0,0,0,65601
22680,153,17,95,30,7,4,14,14,14,0,0,14,0,0,0,0,0,0,0,0,0,0,0,0,0,0,0,0,0,0,0,0,0,0,0,65603
22681,2569,282,1014,831,351,91,304,162,157,25,0,132,5,5,2,3,0,0,0,0,0,142,127,74,4,49,15,15,15,0,0,0,0,0,0,65604
22682,7324,1250,3080,2153,679,162,485,206,150,40,18,92,56,46,0,46,0,10,0,10,0,279,231,95,21,115,48,34,13,21,0,14,0,0,14,65605
22683,2472,705,976,591,144,56,213,137,107,0,12,95,30,13,0,0,13,17,17,0,0,76,64,13,2,49,12,12,0,12,0,0,0,0,0,65606
22684,6959,1370,3110,1762,511,206,747,261,231,23,8,200,30,25,11,0,14,5,0,0,5,486,297,13,10,274,189,189,29,101,59,0,0,0,0,65608
22685,413,76,191,120,15,11,21,13,9,0,0,9,4,4,4,0,0,0,0,0,0,8,8,0,2,6,0,0,0,0,0,0,0,0,0,65609
22686,3850,401,1437,1237,580,195,384,175,161,24,22,115,14,11,11,0,0,3,0,0,3,209,135,46,19,70,74,21,9,0,12,53,0,0,53,65610
22687,1392,197,568,454,120,53,33,8,8,6,0,2,0,0,0,0,0,0,0,0,0,25,25,20,0,5,0,0,0,0,0,0,0,0,0,65611
22688,1094,164,515,210,122,83,116,99,87,46,0,41,12,12,0,0,12,0,0,0,0,17,15,15,0,0,2,0,0,0,0,2,0,0,2,65612
22689,10524,1371,3643,2953,1444,1113,1100,681,676,302,54,320,5,0,0,0,0,5,0,0,5,419,407,93,113,201,12,0,0,0,0,12,0,0,12,65613
22690,530,73,245,112,70,30,38,27,23,0,0,23,4,2,2,0,0,2,0,2,0,11,10,4,0,6,1,1,1,0,0,0,0,0,0,65614
22691,16348,2206,5087,5128,2791,1136,886,400,371,160,24,187,29,18,0,17,1,11,0,11,0,486,372,171,9,192,114,93,93,0,0,21,21,0,0,65616
22692,1249,187,631,311,54,66,207,179,179,7,15,157,0,0,0,0,0,0,0,0,0,28,28,0,0,28,0,0,0,0,0,0,0,0,0,65617
22693,130,34,44,33,19,0,19,0,0,0,0,0,0,0,0,0,0,0,0,0,0,19,19,0,0,19,0,0,0,0,0,0,0,0,0,65618
22694,5697,333,1271,2234,1327,532,221,131,108,11,0,97,23,23,0,0,23,0,0,0,0,90,66,23,25,18,24,12,0,0,12,12,12,0,0,65619
22695,146,35,49,37,25,0,33,15,15,0,0,15,0,0,0,0,0,0,0,0,0,18,18,0,0,18,0,0,0,0,0,0,0,0,0,65620
22696,6268,1563,2159,1406,786,354,400,272,232,34,48,150,40,0,0,0,0,40,26,0,14,128,92,37,15,40,36,36,0,36,0,0,0,0,0,65622
22697,26,10,3,13,0,0,1,1,1,0,0,1,0,0,0,0,0,0,0,0,0,0,0,0,0,0,0,0,0,0,0,0,0,0,0,65623
22698,1503,230,498,619,95,61,85,35,35,0,0,35,0,0,0,0,0,0,0,0,0,50,50,0,0,50,0,0,0,0,0,0,0,0,0,65624
22699,5634,456,2447,1756,590,385,295,146,78,34,4,40,68,68,68,0,0,0,0,0,0,149,99,15,17,67,50,50,28,0,22,0,0,0,0,65625
22700,1210,290,546,273,20,81,91,39,28,3,0,25,11,2,2,0,0,9,0,3,6,52,49,30,3,16,3,3,3,0,0,0,0,0,0,65626
22701,440,11,243,134,41,11,0,0,0,0,0,0,0,0,0,0,0,0,0,0,0,0,0,0,0,0,0,0,0,0,0,0,0,0,0,65627
22702,398,85,182,116,10,5,42,31,21,6,0,15,10,10,6,0,4,0,0,0,0,11,11,3,0,8,0,0,0,0,0,0,0,0,0,65629
22703,194,0,18,71,57,48,1,0,0,0,0,0,0,0,0,0,0,0,0,0,0,1,1,0,0,1,0,0,0,0,0,0,0,0,0,65630
22704,2970,220,1011,974,614,151,160,66,51,5,5,41,15,15,15,0,0,0,0,0,0,94,94,29,8,57,0,0,0,0,0,0,0,0,0,65631
22705,1527,381,754,277,80,35,262,104,99,43,0,56,5,5,5,0,0,0,0,0,0,158,111,8,0,103,47,37,0,0,37,10,8,0,2,65632
22706,3058,700,1488,598,177,95,158,96,70,18,12,40,26,7,3,4,0,19,4,2,13,62,48,5,4,39,14,2,2,0,0,12,0,0,12,65633
22707,566,122,216,147,61,20,62,58,38,0,2,36,20,20,20,0,0,0,0,0,0,4,4,0,0,4,0,0,0,0,0,0,0,0,0,65634
22708,462,44,181,115,40,82,35,31,24,1,0,23,7,7,7,0,0,0,0,0,0,4,4,0,0,4,0,0,0,0,0,0,0,0,0,65635
22709,1187,251,583,213,51,89,62,43,43,4,0,39,0,0,0,0,0,0,0,0,0,19,19,11,0,8,0,0,0,0,0,0,0,0,0,65637
22710,341,57,180,68,23,13,15,0,0,0,0,0,0,0,0,0,0,0,0,0,0,15,5,0,0,5,10,10,0,10,0,0,0,0,0,65638
22711,577,127,225,169,40,16,29,13,0,0,0,0,13,0,0,0,0,13,0,0,13,16,12,0,0,12,4,4,0,0,4,0,0,0,0,65640
22712,820,52,417,299,32,20,5,0,0,0,0,0,0,0,0,0,0,0,0,0,0,5,5,5,0,0,0,0,0,0,0,0,0,0,0,65641
22713,1847,237,926,435,214,35,159,81,81,0,0,81,0,0,0,0,0,0,0,0,0,78,78,0,0,78,0,0,0,0,0,0,0,0,0,65644
22714,1473,227,648,453,58,87,115,48,21,9,0,12,27,15,15,0,0,12,6,0,6,67,67,38,0,29,0,0,0,0,0,0,0,0,0,65646
22715,1660,351,701,472,113,23,136,91,71,10,51,10,20,11,7,0,4,9,3,6,0,45,40,14,3,23,5,0,0,0,0,5,3,0,2,65647
22716,4189,429,1734,1298,556,172,451,260,253,58,0,195,7,7,7,0,0,0,0,0,0,191,142,13,26,103,49,49,5,44,0,0,0,0,0,65648
22717,973,151,349,282,115,76,63,34,34,5,4,25,0,0,0,0,0,0,0,0,0,29,22,5,0,17,7,5,5,0,0,2,2,0,0,65649
22718,917,132,384,252,96,53,69,16,16,0,0,16,0,0,0,0,0,0,0,0,0,53,53,19,34,0,0,0,0,0,0,0,0,0,0,65650
22719,2517,448,972,770,215,112,204,100,84,5,9,70,16,4,4,0,0,12,0,0,12,104,76,37,0,39,28,28,0,18,10,0,0,0,0,65652
22720,4251,840,1568,1248,369,226,251,177,95,20,22,53,82,80,69,0,11,2,2,0,0,74,69,19,0,50,5,5,5,0,0,0,0,0,0,65653
22721,99,22,38,25,7,7,14,0,0,0,0,0,0,0,0,0,0,0,0,0,0,14,3,3,0,0,11,11,0,8,3,0,0,0,0,65654
22722,2537,396,1163,736,154,88,92,48,27,8,0,19,21,0,0,0,0,21,8,0,13,44,36,7,8,21,8,8,0,0,8,0,0,0,0,65655
22723,3707,973,1682,798,182,72,306,262,218,76,0,142,44,0,0,0,0,44,0,0,44,44,17,0,3,14,27,27,0,27,0,0,0,0,0,65656
22724,74,0,45,22,7,0,12,0,0,0,0,0,0,0,0,0,0,0,0,0,0,12,12,7,0,5,0,0,0,0,0,0,0,0,0,65657
22725,1437,143,575,362,296,61,76,34,28,4,0,24,6,6,0,0,6,0,0,0,0,42,42,0,0,42,0,0,0,0,0,0,0,0,0,65658
22726,97,25,72,0,0,0,0,0,0,0,0,0,0,0,0,0,0,0,0,0,0,0,0,0,0,0,0,0,0,0,0,0,0,0,0,65660
22727,1615,251,695,434,142,93,97,50,38,0,0,38,12,12,4,0,8,0,0,0,0,47,38,14,9,15,9,9,5,0,4,0,0,0,0,65661
22728,661,175,195,266,0,25,24,19,19,0,0,19,0,0,0,0,0,0,0,0,0,5,0,0,0,0,5,0,0,0,0,5,0,0,5,65662
22729,1727,389,716,374,179,69,155,80,38,8,6,24,42,0,0,0,0,42,42,0,0,75,6,2,0,4,69,45,0,0,45,24,9,0,15,65663
22730,88,20,39,24,5,0,3,0,0,0,0,0,0,0,0,0,0,0,0,0,0,3,3,0,0,3,0,0,0,0,0,0,0,0,0,65664
22731,2249,547,882,524,175,121,237,116,96,24,4,68,20,16,16,0,0,4,0,0,4,121,94,8,11,75,27,17,0,0,17,10,0,2,8,65667
22732,1408,328,558,364,103,55,18,7,4,2,0,2,3,1,0,0,1,2,0,1,1,11,5,0,0,5,6,6,6,0,0,0,0,0,0,65668
22733,1423,146,625,387,133,132,74,57,57,3,0,54,0,0,0,0,0,0,0,0,0,17,14,4,0,10,3,3,3,0,0,0,0,0,0,65669
22734,5640,1097,2098,1698,492,255,906,480,472,177,67,228,8,8,8,0,0,0,0,0,0,426,357,198,76,83,69,15,0,0,15,54,0,54,0,65672
22735,2082,420,1093,411,125,33,137,54,51,11,10,30,3,3,0,3,0,0,0,0,0,83,76,60,0,16,7,0,0,0,0,7,7,0,0,65674
22736,418,54,141,156,38,29,38,21,8,0,0,8,13,13,0,13,0,0,0,0,0,17,0,0,0,0,17,2,0,0,2,15,0,15,0,65676
22737,1958,142,807,627,269,113,201,33,33,13,0,20,0,0,0,0,0,0,0,0,0,168,115,6,34,75,53,0,0,0,0,53,0,0,53,65679
22738,851,175,470,142,33,31,51,35,35,0,0,35,0,0,0,0,0,0,0,0,0,16,0,0,0,0,16,0,0,0,0,16,0,16,0,65680
22739,1728,258,698,466,187,119,82,34,34,0,12,22,0,0,0,0,0,0,0,0,0,48,48,0,48,0,0,0,0,0,0,0,0,0,0,65681
22740,1647,231,708,467,177,64,87,53,50,0,15,35,3,3,3,0,0,0,0,0,0,34,19,2,0,17,15,13,13,0,0,2,0,0,2,65682
22741,511,80,206,173,38,14,20,14,12,0,11,1,2,2,2,0,0,0,0,0,0,6,6,0,0,6,0,0,0,0,0,0,0,0,0,65685
22742,3775,291,1229,1467,542,246,93,18,16,7,0,9,2,2,0,0,2,0,0,0,0,75,75,71,0,4,0,0,0,0,0,0,0,0,0,65686
22743,3410,657,1326,929,390,108,207,92,56,0,4,52,36,30,17,13,0,6,0,6,0,115,110,33,0,77,5,5,0,5,0,0,0,0,0,65689
22744,174,38,82,42,7,5,2,0,0,0,0,0,0,0,0,0,0,0,0,0,0,2,2,2,0,0,0,0,0,0,0,0,0,0,0,65690
22745,1123,206,476,358,57,26,83,52,27,9,7,11,25,9,9,0,0,16,16,0,0,31,24,0,0,24,7,7,0,0,7,0,0,0,0,65692
22746,354,115,142,61,33,3,56,42,26,0,0,26,16,0,0,0,0,16,16,0,0,14,5,5,0,0,9,0,0,0,0,9,9,0,0,65702
22747,2212,422,871,594,259,66,204,77,70,5,0,65,7,7,0,0,7,0,0,0,0,127,125,8,0,117,2,0,0,0,0,2,0,0,2,65704
22748,2854,406,1239,841,228,140,100,70,70,0,26,44,0,0,0,0,0,0,0,0,0,30,30,14,9,7,0,0,0,0,0,0,0,0,0,65705
22749,9691,1166,3940,3028,913,644,952,441,365,78,31,256,76,55,55,0,0,21,0,21,0,511,434,165,13,256,77,40,40,0,0,37,10,10,17,65706
22750,1484,209,694,390,178,13,98,51,41,2,7,32,10,4,0,4,0,6,0,0,6,47,31,11,3,17,16,16,11,0,5,0,0,0,0,65707
22751,8080,1643,2787,2399,899,352,938,491,377,120,33,224,114,45,30,15,0,69,0,69,0,447,364,174,51,139,83,83,5,8,70,0,0,0,0,65708
22752,855,155,355,182,83,80,175,100,99,46,5,48,1,0,0,0,0,1,1,0,0,75,62,1,0,61,13,12,0,0,12,1,0,0,1,65710
22753,6874,1387,2860,1695,624,308,476,241,214,11,42,161,27,24,0,24,0,3,0,3,0,235,207,86,11,110,28,15,0,0,15,13,11,2,0,65711
22754,6037,850,2471,1390,894,432,457,177,164,8,57,99,13,12,12,0,0,1,1,0,0,280,255,11,40,204,25,0,0,0,0,25,0,0,25,65712
22755,1750,278,824,474,98,76,184,102,33,19,0,14,69,69,2,67,0,0,0,0,0,82,15,0,1,14,67,25,25,0,0,42,0,0,42,65713
22756,19556,1303,5621,7272,3678,1682,1298,894,708,303,35,370,186,120,46,37,37,66,63,3,0,404,362,165,13,184,42,11,3,8,0,31,0,5,26,65714
22757,25,0,10,9,3,3,0,0,0,0,0,0,0,0,0,0,0,0,0,0,0,0,0,0,0,0,0,0,0,0,0,0,0,0,0,65715
22758,1732,357,813,462,69,31,178,84,57,10,9,38,27,7,7,0,0,20,9,0,11,94,61,3,3,55,33,22,0,0,22,11,11,0,0,65717
22759,452,25,266,109,15,37,41,28,28,0,0,28,0,0,0,0,0,0,0,0,0,13,12,5,0,7,1,0,0,0,0,1,0,0,1,65720
22760,19331,1714,5677,6449,3816,1675,1500,744,633,235,40,358,111,68,0,2,66,43,0,32,11,756,564,207,52,305,192,172,18,20,134,20,0,0,20,65721
22761,991,188,495,155,85,68,48,48,48,13,0,35,0,0,0,0,0,0,0,0,0,0,0,0,0,0,0,0,0,0,0,0,0,0,0,65722
22762,2742,434,1098,784,277,149,299,125,119,71,0,48,6,2,2,0,0,4,0,0,4,174,154,26,33,95,20,4,0,4,0,16,0,0,16,65723
22763,1204,110,444,497,138,15,61,0,0,0,0,0,0,0,0,0,0,0,0,0,0,61,61,0,0,61,0,0,0,0,0,0,0,0,0,65724
22764,1518,316,456,589,109,48,204,82,23,13,5,5,59,0,0,0,0,59,0,0,59,122,122,60,0,62,0,0,0,0,0,0,0,0,0,65725
22765,182,0,128,41,13,0,0,0,0,0,0,0,0,0,0,0,0,0,0,0,0,0,0,0,0,0,0,0,0,0,0,0,0,0,0,65727
22766,27,27,0,0,0,0,0,0,0,0,0,0,0,0,0,0,0,0,0,0,0,0,0,0,0,0,0,0,0,0,0,0,0,0,0,65728
22767,267,70,86,71,14,26,17,17,17,0,0,17,0,0,0,0,0,0,0,0,0,0,0,0,0,0,0,0,0,0,0,0,0,0,0,65729
22768,55,0,55,0,0,0,15,0,0,0,0,0,0,0,0,0,0,0,0,0,0,15,15,0,0,15,0,0,0,0,0,0,0,0,0,65730
22769,127,0,25,82,0,20,0,0,0,0,0,0,0,0,0,0,0,0,0,0,0,0,0,0,0,0,0,0,0,0,0,0,0,0,0,65731
22770,593,46,282,180,59,26,15,0,0,0,0,0,0,0,0,0,0,0,0,0,0,15,15,2,13,0,0,0,0,0,0,0,0,0,0,65732
22771,508,133,212,116,47,0,16,6,6,2,0,4,0,0,0,0,0,0,0,0,0,10,10,4,0,6,0,0,0,0,0,0,0,0,0,65733
22772,2428,623,1060,568,77,100,255,87,68,15,0,53,19,4,4,0,0,15,0,0,15,168,118,6,7,105,50,16,16,0,0,34,0,26,8,65734
22773,168,13,111,34,10,0,0,0,0,0,0,0,0,0,0,0,0,0,0,0,0,0,0,0,0,0,0,0,0,0,0,0,0,0,0,65735
22774,6057,788,2509,1667,696,397,320,142,142,23,0,119,0,0,0,0,0,0,0,0,0,178,170,58,7,105,8,8,8,0,0,0,0,0,0,65737
22775,11466,811,3809,4678,1398,770,512,260,144,44,0,100,116,116,85,9,22,0,0,0,0,252,247,70,47,130,5,5,5,0,0,0,0,0,0,65738
22776,997,148,345,370,95,39,117,33,33,19,0,14,0,0,0,0,0,0,0,0,0,84,84,57,0,27,0,0,0,0,0,0,0,0,0,65739
22777,2633,425,1102,864,183,59,184,95,75,44,0,31,20,18,0,0,18,2,0,2,0,89,46,14,10,22,43,25,0,4,21,18,16,0,2,65740
22778,7864,698,2402,2696,1334,734,594,381,321,77,37,207,60,32,18,0,14,28,15,0,13,213,186,57,9,120,27,27,17,3,7,0,0,0,0,65742
22779,150,21,87,34,7,1,0,0,0,0,0,0,0,0,0,0,0,0,0,0,0,0,0,0,0,0,0,0,0,0,0,0,0,0,0,65744
22780,1509,409,621,360,112,7,66,14,9,0,0,9,5,0,0,0,0,5,5,0,0,52,30,24,0,6,22,1,1,0,0,21,0,0,21,65745
22781,4924,1138,2003,1199,433,151,472,282,151,62,3,86,131,32,17,15,0,99,58,11,30,190,98,28,0,70,92,14,0,0,14,78,19,0,59,65746
22782,3190,493,1192,1026,328,151,149,20,20,20,0,0,0,0,0,0,0,0,0,0,0,129,83,17,0,66,46,46,0,46,0,0,0,0,0,65747
22783,249,41,72,127,0,9,9,9,9,9,0,0,0,0,0,0,0,0,0,0,0,0,0,0,0,0,0,0,0,0,0,0,0,0,0,65752
22784,3156,421,1319,893,401,122,309,159,118,61,36,21,41,41,25,16,0,0,0,0,0,150,145,45,23,77,5,5,0,0,5,0,0,0,0,65753
22785,555,14,151,212,119,59,89,28,28,0,0,28,0,0,0,0,0,0,0,0,0,61,27,27,0,0,34,9,9,0,0,25,0,0,25,65754
22786,246,20,116,94,8,8,32,32,32,0,22,10,0,0,0,0,0,0,0,0,0,0,0,0,0,0,0,0,0,0,0,0,0,0,0,65755
22787,397,61,244,64,13,15,59,30,22,0,0,22,8,8,0,0,8,0,0,0,0,29,29,20,0,9,0,0,0,0,0,0,0,0,0,65756
22788,4649,448,1644,1485,773,299,387,150,143,77,0,66,7,7,4,3,0,0,0,0,0,237,233,44,0,189,4,4,0,0,4,0,0,0,0,65757
22789,899,197,396,191,69,46,77,47,42,6,0,36,5,5,3,1,1,0,0,0,0,30,26,0,2,24,4,3,2,0,1,1,0,0,1,65759
22790,491,93,270,85,24,19,4,2,2,0,0,2,0,0,0,0,0,0,0,0,0,2,0,0,0,0,2,2,2,0,0,0,0,0,0,65760
22791,956,164,412,243,79,58,35,25,22,13,4,5,3,0,0,0,0,3,0,0,3,10,10,4,3,3,0,0,0,0,0,0,0,0,0,65761
22792,339,46,154,93,23,23,41,14,9,0,0,9,5,5,0,0,5,0,0,0,0,27,27,2,3,22,0,0,0,0,0,0,0,0,0,65762
22793,1026,433,329,190,46,28,88,6,0,0,0,0,6,0,0,0,0,6,6,0,0,82,10,0,0,10,72,7,7,0,0,65,30,0,35,65764
22794,81,3,57,17,4,0,19,11,3,0,0,3,8,8,0,8,0,0,0,0,0,8,8,0,8,0,0,0,0,0,0,0,0,0,0,65766
22795,1367,256,730,297,76,8,105,74,40,0,0,40,34,20,0,20,0,14,0,14,0,31,26,17,3,6,5,0,0,0,0,5,0,0,5,65767
22796,282,24,170,88,0,0,29,25,25,16,0,9,0,0,0,0,0,0,0,0,0,4,4,0,0,4,0,0,0,0,0,0,0,0,0,65768
22797,2011,243,939,557,202,70,129,35,23,10,6,7,12,12,7,5,0,0,0,0,0,94,69,18,10,41,25,8,5,0,3,17,0,0,17,65769
22798,1815,200,804,598,163,50,128,81,69,37,0,32,12,0,0,0,0,12,0,0,12,47,45,9,4,32,2,2,2,0,0,0,0,0,0,65770
22799,1163,28,338,342,354,101,221,93,93,26,5,62,0,0,0,0,0,0,0,0,0,128,62,26,0,36,66,66,66,0,0,0,0,0,0,65771
22800,1371,306,561,382,95,27,261,223,205,62,0,143,18,18,5,13,0,0,0,0,0,38,38,26,0,12,0,0,0,0,0,0,0,0,0,65772
22801,449,61,144,119,116,9,43,35,35,11,0,24,0,0,0,0,0,0,0,0,0,8,8,0,0,8,0,0,0,0,0,0,0,0,0,65773
22802,729,72,376,232,22,27,76,34,22,0,0,22,12,12,12,0,0,0,0,0,0,42,41,14,1,26,1,1,0,0,1,0,0,0,0,65774
22803,16423,2569,6212,4811,1459,1372,1175,632,544,155,40,349,88,88,40,31,17,0,0,0,0,543,443,122,17,304,100,81,60,0,21,19,0,3,16,65775
22804,170,29,87,54,0,0,0,0,0,0,0,0,0,0,0,0,0,0,0,0,0,0,0,0,0,0,0,0,0,0,0,0,0,0,0,65777
22805,363,72,156,100,17,18,25,24,12,6,0,6,12,12,0,12,0,0,0,0,0,1,1,0,0,1,0,0,0,0,0,0,0,0,0,65778
22806,1751,378,811,450,92,20,179,142,93,13,60,20,49,0,0,0,0,49,0,0,49,37,34,11,0,23,3,3,0,0,3,0,0,0,0,65779
22807,5430,484,1759,1945,957,285,503,209,209,7,32,170,0,0,0,0,0,0,0,0,0,294,276,130,38,108,18,18,13,0,5,0,0,0,0,65781
22808,102,12,60,24,6,0,17,17,17,0,8,9,0,0,0,0,0,0,0,0,0,0,0,0,0,0,0,0,0,0,0,0,0,0,0,65783
22809,0,0,0,0,0,0,0,0,0,0,0,0,0,0,0,0,0,0,0,0,0,0,0,0,0,0,0,0,0,0,0,0,0,0,0,65784
22810,3817,557,1529,1034,505,192,307,167,164,32,12,120,3,3,0,0,3,0,0,0,0,140,106,41,13,52,34,34,22,0,12,0,0,0,0,65785
22811,1714,283,731,527,57,116,88,65,65,0,2,63,0,0,0,0,0,0,0,0,0,23,23,23,0,0,0,0,0,0,0,0,0,0,0,65786
22812,1194,108,415,378,206,87,58,20,4,0,0,4,16,0,0,0,0,16,16,0,0,38,38,25,0,13,0,0,0,0,0,0,0,0,0,65787
22813,225,29,64,102,30,0,37,20,20,0,0,20,0,0,0,0,0,0,0,0,0,17,17,0,0,17,0,0,0,0,0,0,0,0,0,65788
22814,1184,249,583,278,60,14,123,92,52,6,15,31,40,40,25,0,15,0,0,0,0,31,23,14,0,9,8,8,0,0,8,0,0,0,0,65789
22815,555,111,234,139,48,23,23,0,0,0,0,0,0,0,0,0,0,0,0,0,0,23,12,0,0,12,11,11,0,11,0,0,0,0,0,65790
22816,3162,505,1444,844,220,149,276,154,153,5,5,143,1,1,0,0,1,0,0,0,0,122,108,4,0,104,14,11,8,0,3,3,3,0,0,65791
22817,4314,873,1759,1023,435,224,229,119,119,28,8,83,0,0,0,0,0,0,0,0,0,110,83,26,19,38,27,10,8,0,2,17,0,17,0,65793
22818,27660,4442,8729,8338,4617,1534,3121,1458,1222,261,107,854,236,104,58,31,15,132,37,50,45,1663,1420,456,102,862,243,134,80,14,40,109,0,23,86,65802
22819,27274,4145,9417,8846,3403,1463,2138,1188,962,218,125,619,226,146,73,46,27,80,22,0,58,950,811,253,77,481,139,96,83,13,0,43,9,30,4,65803
22820,25603,1611,5526,9200,5443,3823,1474,662,599,207,103,289,63,63,63,0,0,0,0,0,0,812,735,381,54,300,77,52,33,10,9,25,0,25,0,65804
22821,5025,877,1419,1811,665,253,864,364,298,58,33,207,66,37,29,0,8,29,17,12,0,500,448,153,28,267,52,28,7,16,5,24,0,20,4,65806
22822,34407,3105,9521,12596,6188,2997,4163,1762,1530,430,178,922,232,197,129,68,0,35,15,11,9,2401,2227,809,284,1134,174,84,75,9,0,90,60,12,18,65807
22823,8042,271,1192,1979,2627,1973,501,291,238,42,25,171,53,23,23,0,0,30,0,0,30,210,185,16,0,169,25,0,0,0,0,25,0,0,25,65809
22824,14825,387,2479,4576,4613,2770,926,390,367,111,42,214,23,23,0,23,0,0,0,0,0,536,477,219,47,211,59,35,24,11,0,24,14,0,10,65810
22825,8178,658,3422,2185,1092,821,1145,518,425,127,5,293,93,29,29,0,0,64,0,0,64,627,563,210,32,321,64,51,40,11,0,13,0,13,0,66002
22826,4865,234,1554,1532,1012,533,582,306,269,69,23,177,37,37,19,18,0,0,0,0,0,276,247,74,20,153,29,0,0,0,0,29,25,0,4,66006
22827,4134,180,1246,1337,837,534,431,249,233,40,92,101,16,16,0,16,0,0,0,0,0,182,169,69,6,94,13,13,13,0,0,0,0,0,0,66007
22828,197,1,60,49,68,19,9,3,3,0,0,3,0,0,0,0,0,0,0,0,0,6,6,6,0,0,0,0,0,0,0,0,0,0,0,66008
22829,480,49,223,162,28,18,25,21,21,0,19,2,0,0,0,0,0,0,0,0,0,4,4,0,0,4,0,0,0,0,0,0,0,0,0,66010
22830,7346,571,2214,2642,1334,585,562,263,239,51,0,188,24,10,0,0,10,14,0,0,14,299,285,89,23,173,14,14,0,14,0,0,0,0,0,66012
22831,1250,8,394,348,347,153,144,118,118,9,0,109,0,0,0,0,0,0,0,0,0,26,26,13,0,13,0,0,0,0,0,0,0,0,0,66013
22832,296,0,134,162,0,0,0,0,0,0,0,0,0,0,0,0,0,0,0,0,0,0,0,0,0,0,0,0,0,0,0,0,0,0,0,66014
22833,628,34,264,231,78,21,70,19,19,15,0,4,0,0,0,0,0,0,0,0,0,51,51,34,0,17,0,0,0,0,0,0,0,0,0,66015
22834,211,15,105,43,36,12,20,20,20,0,7,13,0,0,0,0,0,0,0,0,0,0,0,0,0,0,0,0,0,0,0,0,0,0,0,66016
22835,268,8,78,114,41,27,24,10,10,3,0,7,0,0,0,0,0,0,0,0,0,14,14,7,2,5,0,0,0,0,0,0,0,0,0,66017
22836,3558,318,968,1296,574,402,384,129,93,43,0,50,36,36,36,0,0,0,0,0,0,255,226,142,16,68,29,29,11,0,18,0,0,0,0,66018
22837,57,0,0,57,0,0,29,29,29,29,0,0,0,0,0,0,0,0,0,0,0,0,0,0,0,0,0,0,0,0,0,0,0,0,0,66019
22838,1298,107,530,326,195,140,40,20,4,2,0,2,16,4,0,4,0,12,0,0,12,20,20,3,8,9,0,0,0,0,0,0,0,0,0,66020
22839,1402,140,409,503,266,84,133,60,45,17,0,28,15,14,11,0,3,1,0,0,1,73,53,6,12,35,20,20,14,3,3,0,0,0,0,66021
22840,917,94,404,309,99,11,46,7,7,0,0,7,0,0,0,0,0,0,0,0,0,39,39,2,0,37,0,0,0,0,0,0,0,0,0,66023
22841,572,93,318,140,18,3,36,33,12,0,0,12,21,7,7,0,0,14,0,14,0,3,3,3,0,0,0,0,0,0,0,0,0,0,0,66024
22842,5146,269,1499,1347,1573,458,175,65,65,0,0,65,0,0,0,0,0,0,0,0,0,110,67,18,0,49,43,43,0,0,43,0,0,0,0,66025
22843,581,45,276,159,52,49,69,48,48,13,0,35,0,0,0,0,0,0,0,0,0,21,21,4,0,17,0,0,0,0,0,0,0,0,0,66026
22844,2766,89,298,733,823,823,162,56,21,0,0,21,35,9,9,0,0,26,0,26,0,106,106,27,5,74,0,0,0,0,0,0,0,0,0,66027
22845,13290,662,3685,4761,3006,1176,911,360,336,102,0,234,24,21,0,4,17,3,3,0,0,551,551,174,0,377,0,0,0,0,0,0,0,0,0,66030
22846,350,37,98,183,32,0,22,22,9,0,0,9,13,13,0,0,13,0,0,0,0,0,0,0,0,0,0,0,0,0,0,0,0,0,0,66031
22847,3423,549,1135,995,503,241,180,110,68,47,0,21,42,42,42,0,0,0,0,0,0,70,70,55,0,15,0,0,0,0,0,0,0,0,0,66032
22848,468,19,252,146,42,9,34,17,17,3,2,12,0,0,0,0,0,0,0,0,0,17,17,6,0,11,0,0,0,0,0,0,0,0,0,66033
22849,624,61,192,224,101,46,425,232,232,35,49,148,0,0,0,0,0,0,0,0,0,193,193,74,13,106,0,0,0,0,0,0,0,0,0,66035
22850,468,40,198,175,45,10,43,14,14,0,0,14,0,0,0,0,0,0,0,0,0,29,29,5,9,15,0,0,0,0,0,0,0,0,0,66039
22851,2131,297,770,774,214,76,175,80,59,4,6,49,21,0,0,0,0,21,0,0,21,95,95,19,5,71,0,0,0,0,0,0,0,0,0,66040
22852,523,48,207,148,58,62,37,27,8,0,0,8,19,19,3,3,13,0,0,0,0,10,8,2,0,6,2,2,0,0,2,0,0,0,0,66041
22853,390,10,165,155,14,46,12,10,3,2,0,1,7,7,7,0,0,0,0,0,0,2,2,0,0,2,0,0,0,0,0,0,0,0,0,66042
22854,7165,618,2178,2156,1340,873,616,360,345,157,8,180,15,15,15,0,0,0,0,0,0,256,209,29,38,142,47,47,0,47,0,0,0,0,0,66043
22855,13000,800,2431,3487,3283,2999,3381,1709,1667,322,205,1140,42,42,42,0,0,0,0,0,0,1672,1599,428,92,1079,73,73,73,0,0,0,0,0,0,66044
22856,26,0,6,6,14,0,1745,638,638,74,69,495,0,0,0,0,0,0,0,0,0,1107,1107,255,126,726,0,0,0,0,0,0,0,0,0,66045
22857,11015,801,2374,3290,2559,1991,1352,672,579,131,10,438,93,75,63,0,12,18,0,18,0,680,565,186,33,346,115,47,4,34,9,68,19,49,0,66046
22858,11254,575,1492,2745,3344,3098,995,490,434,170,0,264,56,29,13,15,1,27,0,0,27,505,505,155,40,310,0,0,0,0,0,0,0,0,0,66047
22859,24380,2335,7862,7825,3598,2760,1957,1064,907,252,156,499,157,65,28,30,7,92,25,16,51,893,733,294,37,402,160,146,132,8,6,14,8,6,0,66048
22860,16327,388,2383,3495,5182,4879,1038,435,352,79,14,259,83,66,20,41,5,17,17,0,0,603,545,239,40,266,58,48,48,0,0,10,0,0,10,66049
22861,1402,67,498,482,189,166,35,24,10,2,0,8,14,2,0,0,2,12,0,0,12,11,10,0,0,10,1,1,1,0,0,0,0,0,0,66050
22862,1326,208,582,319,155,62,95,52,28,2,0,26,24,24,24,0,0,0,0,0,0,43,31,25,5,1,12,3,0,0,3,9,0,9,0,66052
22863,5065,242,1315,1859,1229,420,372,158,128,18,12,98,30,20,10,10,0,10,10,0,0,214,189,82,21,86,25,25,0,25,0,0,0,0,0,66053
22864,2237,175,1019,718,257,68,120,62,62,20,15,27,0,0,0,0,0,0,0,0,0,58,50,0,0,50,8,4,0,0,4,4,0,0,4,66054
22865,1186,193,397,382,174,40,58,18,18,5,8,5,0,0,0,0,0,0,0,0,0,40,40,3,0,37,0,0,0,0,0,0,0,0,0,66056
22866,276,21,145,73,31,6,24,18,18,11,0,7,0,0,0,0,0,0,0,0,0,6,0,0,0,0,6,6,6,0,0,0,0,0,0,66058
22867,710,37,376,200,61,36,59,20,20,3,0,17,0,0,0,0,0,0,0,0,0,39,35,1,0,34,4,4,0,0,4,0,0,0,0,66060
22868,36504,2667,8376,11106,9757,4598,2957,1622,1437,567,137,733,185,107,48,20,39,78,35,0,43,1335,963,541,93,329,372,319,236,43,40,53,27,0,26,66061
22869,46998,1858,7128,14754,15733,7525,4500,2654,2504,899,325,1280,150,140,27,78,35,10,10,0,0,1846,1810,847,181,782,36,27,27,0,0,9,0,0,9,66062
22870,3821,323,1514,1575,306,103,379,188,188,103,0,85,0,0,0,0,0,0,0,0,0,191,135,50,14,71,56,56,5,51,0,0,0,0,0,66064
22871,1750,141,795,379,331,104,106,20,17,0,8,9,3,3,3,0,0,0,0,0,0,86,66,11,0,55,20,0,0,0,0,20,0,4,16,66066
22872,10828,1070,3716,3679,1467,896,937,417,349,86,21,242,68,57,45,9,3,11,0,11,0,520,464,237,0,227,56,56,30,0,26,0,0,0,0,66067
22873,1907,200,561,684,308,154,154,72,70,27,0,43,2,2,0,2,0,0,0,0,0,82,58,11,2,45,24,6,6,0,0,18,8,0,10,66070
22874,8351,590,2592,3211,1360,598,748,365,261,80,27,154,104,104,77,18,9,0,0,0,0,383,367,102,43,222,16,16,16,0,0,0,0,0,0,66071
22875,836,93,354,318,51,20,46,20,7,1,0,6,13,13,0,13,0,0,0,0,0,26,10,10,0,0,16,16,16,0,0,0,0,0,0,66072
22876,1512,106,494,504,295,113,182,89,79,33,30,16,10,10,10,0,0,0,0,0,0,93,61,1,0,60,32,32,1,14,17,0,0,0,0,66073
22877,1386,121,537,474,142,112,67,42,27,7,0,20,15,15,12,3,0,0,0,0,0,25,25,4,9,12,0,0,0,0,0,0,0,0,0,66075
22878,1097,126,495,313,99,64,89,51,45,16,0,29,6,6,6,0,0,0,0,0,0,38,31,10,7,14,7,4,4,0,0,3,0,0,3,66076
22879,605,53,300,182,39,31,31,24,24,10,0,14,0,0,0,0,0,0,0,0,0,7,7,6,0,1,0,0,0,0,0,0,0,0,0,66078
22880,357,36,173,125,13,10,35,15,15,11,0,4,0,0,0,0,0,0,0,0,0,20,20,0,0,20,0,0,0,0,0,0,0,0,0,66079
22881,561,34,242,223,50,12,91,50,50,43,0,7,0,0,0,0,0,0,0,0,0,41,40,7,0,33,1,1,1,0,0,0,0,0,0,66080
22882,6039,306,1634,2385,1190,524,466,231,216,93,13,110,15,15,15,0,0,0,0,0,0,235,199,90,0,109,36,23,10,13,0,13,0,0,13,66083
22883,5485,113,724,1325,2172,1151,628,329,261,64,23,174,68,54,14,0,40,14,0,0,14,299,297,112,22,163,2,2,0,0,2,0,0,0,0,66085
22884,6779,358,2579,2177,970,695,580,253,190,59,65,66,63,63,63,0,0,0,0,0,0,327,305,162,19,124,22,22,22,0,0,0,0,0,0,66086
22885,1241,119,484,469,128,41,62,40,33,7,7,19,7,0,0,0,0,7,0,0,7,22,17,5,0,12,5,5,5,0,0,0,0,0,0,66087
22886,1793,153,722,592,136,190,110,65,40,16,11,13,25,22,16,6,0,3,3,0,0,45,45,10,0,35,0,0,0,0,0,0,0,0,0,66088
22887,1824,187,717,574,235,111,144,89,78,7,0,71,11,7,3,4,0,4,0,0,4,55,52,17,4,31,3,3,0,2,1,0,0,0,0,66090
22888,115,12,42,30,31,0,6,6,6,0,0,6,0,0,0,0,0,0,0,0,0,0,0,0,0,0,0,0,0,0,0,0,0,0,0,66091
22889,2771,162,1007,1045,440,117,166,103,95,61,0,34,8,8,8,0,0,0,0,0,0,63,50,22,12,16,13,13,0,13,0,0,0,0,0,66092
22890,514,51,215,140,98,10,34,8,8,0,0,8,0,0,0,0,0,0,0,0,0,26,26,13,0,13,0,0,0,0,0,0,0,0,0,66093
22891,366,42,159,131,19,15,12,3,1,0,0,1,2,2,2,0,0,0,0,0,0,9,6,2,3,1,3,3,3,0,0,0,0,0,0,66094
22892,928,127,290,266,175,70,16,11,6,0,0,6,5,4,4,0,0,1,0,1,0,5,1,1,0,0,4,0,0,0,0,4,0,0,4,66095
22893,716,92,240,236,93,55,56,35,35,17,11,7,0,0,0,0,0,0,0,0,0,21,21,11,3,7,0,0,0,0,0,0,0,0,0,66097
22894,7345,2816,2363,1613,376,177,868,410,344,67,75,202,66,20,11,0,9,46,12,8,26,458,348,59,82,207,110,37,8,21,8,73,18,0,55,66101
22895,16972,6193,4898,3999,1302,580,1463,859,594,30,97,467,265,131,80,34,17,134,75,34,25,604,449,137,68,244,155,105,59,0,46,50,16,0,34,66102
22896,8305,1766,2316,2330,1237,656,400,246,167,59,41,67,79,55,30,25,0,24,10,14,0,154,121,30,0,91,33,13,0,11,2,20,20,0,0,66103
22897,15574,3289,5747,5007,989,542,1638,824,618,114,114,390,206,169,102,35,32,37,0,25,12,814,663,187,126,350,151,74,30,0,44,77,9,0,68,66104
22898,1514,671,513,273,57,0,76,50,50,24,0,26,0,0,0,0,0,0,0,0,0,26,26,9,11,6,0,0,0,0,0,0,0,0,0,66105
22899,14575,2989,5755,4122,1183,526,1347,762,616,68,65,483,146,58,29,0,29,88,0,77,11,585,452,166,128,158,133,42,17,0,25,91,5,0,86,66106
22900,15224,1055,4389,5657,2750,1373,1190,573,522,125,81,316,51,41,34,7,0,10,0,0,10,617,540,245,98,197,77,64,56,0,8,13,0,13,0,66109
22901,6860,1198,2574,2093,702,293,555,292,218,48,71,99,74,51,51,0,0,23,18,0,5,263,204,70,18,116,59,6,0,0,6,53,38,0,15,66111
22902,7552,1016,2662,2451,1010,413,809,317,295,68,36,191,22,0,0,0,0,22,22,0,0,492,464,125,127,212,28,28,15,13,0,0,0,0,0,66112
22903,0,0,0,0,0,0,0,0,0,0,0,0,0,0,0,0,0,0,0,0,0,0,0,0,0,0,0,0,0,0,0,0,0,0,0,66115
22904,0,0,0,0,0,0,0,0,0,0,0,0,0,0,0,0,0,0,0,0,0,0,0,0,0,0,0,0,0,0,0,0,0,0,0,66118
22905,11454,835,2146,3722,3044,1707,585,361,274,113,72,89,87,23,23,0,0,64,15,49,0,224,204,83,9,112,20,0,0,0,0,20,6,14,0,66202
22906,13983,1372,3730,4891,3081,909,783,491,398,133,70,195,93,78,78,0,0,15,15,0,0,292,243,123,18,102,49,49,49,0,0,0,0,0,0,66203
22907,13758,1021,3158,3884,3751,1944,611,317,246,76,58,112,71,39,39,0,0,32,24,8,0,294,253,48,19,186,41,41,30,0,11,0,0,0,0,66204
22908,10145,252,1334,2435,3610,2514,586,284,251,59,11,181,33,32,4,2,26,1,1,0,0,302,293,140,5,148,9,0,0,0,0,9,0,0,9,66205
22909,7149,53,475,1499,3076,2046,359,120,120,40,0,80,0,0,0,0,0,0,0,0,0,239,239,73,0,166,0,0,0,0,0,0,0,0,0,66206
22910,9612,270,845,2133,3484,2880,710,341,332,122,8,202,9,0,0,0,0,9,0,0,9,369,346,125,29,192,23,23,12,0,11,0,0,0,0,66207
22911,15663,219,1399,3117,6702,4226,832,429,398,112,35,251,31,26,11,0,15,5,0,5,0,403,396,201,0,195,7,7,7,0,0,0,0,0,0,66208
22912,14137,351,936,2375,6154,4321,1033,595,559,151,15,393,36,35,35,0,0,1,0,1,0,438,438,189,36,213,0,0,0,0,0,0,0,0,0,66209
22913,12880,339,1388,3454,4999,2700,748,450,437,189,25,223,13,0,0,0,0,13,11,2,0,298,237,88,0,149,61,36,7,0,29,25,9,0,16,66210
22914,3517,81,368,953,1210,905,109,64,64,0,12,52,0,0,0,0,0,0,0,0,0,45,45,0,22,23,0,0,0,0,0,0,0,0,0,66211
22915,23191,1397,3957,7285,7077,3475,1703,751,606,200,57,349,145,104,54,8,42,41,10,19,12,952,734,406,49,279,218,218,193,11,14,0,0,0,0,66212
22916,18473,367,1716,4307,7530,4553,1537,631,612,240,48,324,19,19,9,10,0,0,0,0,0,906,833,278,35,520,73,58,12,36,10,15,10,0,5,66213
22917,8008,429,1436,2805,2112,1226,427,294,253,124,12,117,41,41,28,13,0,0,0,0,0,133,111,38,0,73,22,0,0,0,0,22,0,0,22,66214
22918,17547,1029,2842,5840,4893,2943,1213,591,551,222,44,285,40,40,40,0,0,0,0,0,0,622,572,242,81,249,50,40,40,0,0,10,10,0,0,66215
22919,16976,1091,3406,4849,5309,2321,1332,478,461,88,11,362,17,8,8,0,0,9,0,9,0,854,752,265,21,466,102,17,17,0,0,85,0,0,85,66216
22920,3368,70,700,972,984,642,270,163,163,53,15,95,0,0,0,0,0,0,0,0,0,107,84,18,0,66,23,8,0,8,0,15,0,0,15,66217
22921,4624,80,746,1611,1522,665,327,168,160,67,35,58,8,8,0,8,0,0,0,0,0,159,159,40,31,88,0,0,0,0,0,0,0,0,0,66218
22922,7129,191,784,1809,2943,1402,547,239,215,110,32,73,24,24,24,0,0,0,0,0,0,308,297,98,63,136,11,0,0,0,0,11,0,0,11,66219
22923,4577,18,372,958,1781,1448,330,158,148,75,0,73,10,0,0,0,0,10,0,0,10,172,172,45,5,122,0,0,0,0,0,0,0,0,0,66220
22924,9102,200,633,1628,4076,2565,953,508,508,144,23,341,0,0,0,0,0,0,0,0,0,445,421,210,19,192,24,24,24,0,0,0,0,0,0,66221
22925,14080,325,1385,3016,5577,3777,1119,585,520,231,17,272,65,65,0,59,6,0,0,0,0,534,477,235,0,242,57,55,19,36,0,2,2,0,0,66223
22926,6932,52,385,1250,2954,2291,693,363,363,100,11,252,0,0,0,0,0,0,0,0,0,330,279,118,14,147,51,51,14,37,0,0,0,0,0,66224
22927,7423,199,804,2280,2569,1571,775,469,456,105,20,331,13,13,0,13,0,0,0,0,0,306,306,57,18,231,0,0,0,0,0,0,0,0,0,66226
22928,3112,134,593,999,906,480,232,119,119,19,10,90,0,0,0,0,0,0,0,0,0,113,113,73,3,37,0,0,0,0,0,0,0,0,0,66227
22929,1206,61,450,340,227,128,60,33,30,16,4,10,3,3,0,0,3,0,0,0,0,27,25,14,0,11,2,2,2,0,0,0,0,0,0,66401
22930,1940,121,713,617,304,185,184,95,95,31,14,50,0,0,0,0,0,0,0,0,0,89,70,35,0,35,19,19,14,0,5,0,0,0,0,66402
22931,541,54,293,134,43,17,38,21,17,2,4,11,4,4,4,0,0,0,0,0,0,17,17,3,0,14,0,0,0,0,0,0,0,0,0,66403
22932,348,23,215,42,51,17,36,22,22,6,0,16,0,0,0,0,0,0,0,0,0,14,14,14,0,0,0,0,0,0,0,0,0,0,0,66404
22933,382,27,182,138,30,5,7,3,2,0,0,2,1,1,1,0,0,0,0,0,0,4,4,0,0,4,0,0,0,0,0,0,0,0,0,66406
22934,351,34,143,117,37,20,14,0,0,0,0,0,0,0,0,0,0,0,0,0,0,14,1,1,0,0,13,2,0,0,2,11,0,0,11,66407
22935,351,34,198,50,46,23,21,12,12,12,0,0,0,0,0,0,0,0,0,0,0,9,9,5,0,4,0,0,0,0,0,0,0,0,0,66408
22936,2253,98,771,716,439,229,170,81,69,17,9,43,12,12,12,0,0,0,0,0,0,89,89,26,13,50,0,0,0,0,0,0,0,0,0,66409
22937,878,90,407,256,80,45,26,13,13,4,0,9,0,0,0,0,0,0,0,0,0,13,13,2,0,11,0,0,0,0,0,0,0,0,0,66411
22938,175,37,51,75,7,5,3,0,0,0,0,0,0,0,0,0,0,0,0,0,0,3,3,0,0,3,0,0,0,0,0,0,0,0,0,66412
22939,1287,102,589,387,170,39,73,45,42,16,4,22,3,3,0,0,3,0,0,0,0,28,28,24,0,4,0,0,0,0,0,0,0,0,0,66413
22940,1711,85,643,674,242,67,188,114,93,41,7,45,21,17,6,9,2,4,4,0,0,74,40,37,0,3,34,34,10,0,24,0,0,0,0,66414
22941,618,61,246,212,75,24,54,23,23,18,0,5,0,0,0,0,0,0,0,0,0,31,31,21,8,2,0,0,0,0,0,0,0,0,0,66415
22942,384,26,193,86,67,12,77,39,33,30,0,3,6,6,4,0,2,0,0,0,0,38,38,38,0,0,0,0,0,0,0,0,0,0,0,66416
22943,130,16,51,48,15,0,13,7,7,0,0,7,0,0,0,0,0,0,0,0,0,6,6,0,0,6,0,0,0,0,0,0,0,0,0,66417
22944,388,23,170,162,27,6,45,20,20,18,0,2,0,0,0,0,0,0,0,0,0,25,10,6,0,4,15,15,15,0,0,0,0,0,0,66418
22945,263,16,62,159,13,13,7,0,0,0,0,0,0,0,0,0,0,0,0,0,0,7,7,7,0,0,0,0,0,0,0,0,0,0,0,66419
22946,242,24,132,79,7,0,26,13,13,0,0,13,0,0,0,0,0,0,0,0,0,13,13,0,0,13,0,0,0,0,0,0,0,0,0,66422
22947,617,31,255,198,109,24,78,47,23,16,0,7,24,24,0,20,4,0,0,0,0,31,25,3,0,22,6,6,6,0,0,0,0,0,0,66423
22948,427,48,132,174,58,15,38,10,10,8,0,2,0,0,0,0,0,0,0,0,0,28,26,0,0,26,2,2,0,2,0,0,0,0,0,66424
22949,303,9,165,101,21,7,6,0,0,0,0,0,0,0,0,0,0,0,0,0,0,6,6,6,0,0,0,0,0,0,0,0,0,0,0,66425
22950,886,72,393,308,94,19,45,9,9,2,0,7,0,0,0,0,0,0,0,0,0,36,36,25,0,11,0,0,0,0,0,0,0,0,0,66427
22951,313,22,179,40,67,5,23,23,23,0,0,23,0,0,0,0,0,0,0,0,0,0,0,0,0,0,0,0,0,0,0,0,0,0,0,66428
22952,478,19,277,70,62,50,24,12,12,0,0,12,0,0,0,0,0,0,0,0,0,12,12,12,0,0,0,0,0,0,0,0,0,0,0,66429
22953,461,35,223,141,58,4,9,6,6,0,0,6,0,0,0,0,0,0,0,0,0,3,2,1,0,1,1,1,0,0,1,0,0,0,0,66431
22954,287,3,153,94,17,20,18,9,9,8,0,1,0,0,0,0,0,0,0,0,0,9,9,0,0,9,0,0,0,0,0,0,0,0,0,66432
22955,3410,300,1369,1024,402,315,198,140,116,39,0,77,24,16,7,0,9,8,8,0,0,58,43,5,0,38,15,11,11,0,0,4,0,4,0,66434
22956,3839,291,1430,1309,505,304,304,193,193,90,28,75,0,0,0,0,0,0,0,0,0,111,81,41,10,30,30,30,30,0,0,0,0,0,0,66436
22957,186,0,121,58,0,7,32,21,0,0,0,0,21,21,21,0,0,0,0,0,0,11,11,11,0,0,0,0,0,0,0,0,0,0,0,66438
22958,1876,194,863,587,123,109,256,130,118,25,0,93,12,9,6,0,3,3,0,3,0,126,100,34,7,59,26,18,12,6,0,8,0,3,5,66439
22959,1363,45,592,478,163,85,123,41,38,22,0,16,3,3,3,0,0,0,0,0,0,82,77,43,5,29,5,0,0,0,0,5,5,0,0,66440
22960,15791,1645,4700,6393,1960,1093,1663,895,551,163,18,370,344,147,99,24,24,197,54,14,129,768,553,224,27,302,215,158,130,26,2,57,19,18,20,66441
22961,5364,69,1294,2912,845,244,1125,760,87,30,18,39,673,655,646,5,4,18,10,8,0,365,266,70,4,192,99,99,60,0,39,0,0,0,0,66442
22962,489,78,229,109,38,35,20,17,17,2,0,15,0,0,0,0,0,0,0,0,0,3,3,3,0,0,0,0,0,0,0,0,0,0,0,66449
22963,1276,80,412,441,227,116,98,58,46,15,4,27,12,3,1,0,2,9,0,0,9,40,33,17,0,16,7,7,2,5,0,0,0,0,0,66451
22964,169,21,70,65,12,1,3,0,0,0,0,0,0,0,0,0,0,0,0,0,0,3,2,0,0,2,1,1,1,0,0,0,0,0,0,66501
22965,22180,1054,3848,6704,5711,4863,3216,1637,1491,467,24,1000,146,146,127,0,19,0,0,0,0,1579,1404,537,18,849,175,175,164,0,11,0,0,0,0,66502
22966,9487,400,1426,2457,2843,2361,529,190,167,68,16,83,23,23,8,0,15,0,0,0,0,339,295,127,0,168,44,29,12,0,17,15,8,7,0,66503
22967,12,0,0,11,0,1,2993,1172,1172,262,1,909,0,0,0,0,0,0,0,0,0,1821,1821,623,40,1158,0,0,0,0,0,0,0,0,0,66506
22968,726,13,264,254,166,29,79,35,35,20,0,15,0,0,0,0,0,0,0,0,0,44,44,1,0,43,0,0,0,0,0,0,0,0,0,66507
22969,2937,156,1206,1007,381,187,244,149,132,51,0,81,17,17,7,0,10,0,0,0,0,95,88,42,0,46,7,7,0,0,7,0,0,0,0,66508
22970,1787,69,811,676,163,68,171,93,75,22,29,24,18,13,10,3,0,5,0,0,5,78,59,35,0,24,19,16,14,0,2,3,0,3,0,66509
22971,464,69,195,117,53,30,43,23,20,2,0,18,3,2,0,2,0,1,0,0,1,20,12,0,1,11,8,4,2,0,2,4,0,0,4,66510
22972,2252,148,1012,699,242,151,144,75,35,4,0,31,40,29,22,7,0,11,11,0,0,69,46,28,3,15,23,23,20,3,0,0,0,0,0,66512
22973,1067,106,387,347,143,84,107,38,38,12,0,26,0,0,0,0,0,0,0,0,0,69,17,0,17,0,52,52,25,17,10,0,0,0,0,66514
22974,306,25,187,58,34,2,18,8,8,8,0,0,0,0,0,0,0,0,0,0,0,10,10,8,0,2,0,0,0,0,0,0,0,0,0,66515
22975,198,6,83,87,22,0,12,10,7,5,0,2,3,3,3,0,0,0,0,0,0,2,2,0,0,2,0,0,0,0,0,0,0,0,0,66516
22976,973,119,151,528,119,56,73,36,30,0,0,30,6,6,3,0,3,0,0,0,0,37,29,29,0,0,8,8,8,0,0,0,0,0,0,66517
22977,125,6,49,30,31,9,12,9,7,1,0,6,2,2,2,0,0,0,0,0,0,3,3,0,0,3,0,0,0,0,0,0,0,0,0,66518
22978,421,19,148,126,82,46,17,5,5,0,2,3,0,0,0,0,0,0,0,0,0,12,7,5,0,2,5,5,5,0,0,0,0,0,0,66520
22979,1211,102,577,351,139,42,80,31,31,13,0,18,0,0,0,0,0,0,0,0,0,49,48,35,0,13,1,1,1,0,0,0,0,0,0,66521
22980,30,7,15,5,3,0,0,0,0,0,0,0,0,0,0,0,0,0,0,0,0,0,0,0,0,0,0,0,0,0,0,0,0,0,0,66522
22981,2604,298,1058,638,356,254,143,24,21,12,0,9,3,3,0,3,0,0,0,0,0,119,111,72,0,39,8,8,0,8,0,0,0,0,0,66523
22982,1984,117,818,525,305,219,140,98,91,17,29,45,7,7,7,0,0,0,0,0,0,42,38,29,9,0,4,4,3,0,1,0,0,0,0,66524
22983,585,3,241,243,90,8,13,5,3,2,0,1,2,0,0,0,0,2,0,0,2,8,8,7,0,1,0,0,0,0,0,0,0,0,0,66526
22984,171,15,48,57,40,11,15,9,9,3,2,4,0,0,0,0,0,0,0,0,0,6,6,0,0,6,0,0,0,0,0,0,0,0,0,66527
22985,830,130,410,186,84,20,60,37,34,3,0,31,3,2,0,2,0,1,0,1,0,23,19,0,1,18,4,2,2,0,0,2,0,0,2,66528
22986,792,32,239,300,164,57,43,9,7,1,2,4,2,1,1,0,0,1,0,0,1,34,34,14,0,20,0,0,0,0,0,0,0,0,0,66531
22987,387,45,122,121,68,31,13,9,7,0,0,7,2,0,0,0,0,2,0,0,2,4,3,0,0,3,1,1,0,0,1,0,0,0,0,66532
22988,1073,68,388,305,195,117,80,41,39,10,8,21,2,2,2,0,0,0,0,0,0,39,39,19,0,20,0,0,0,0,0,0,0,0,0,66533
22989,2628,292,1052,628,477,179,234,58,52,12,0,40,6,0,0,0,0,6,0,0,6,176,163,115,7,41,13,0,0,0,0,13,13,0,0,66534
22990,1785,146,617,520,354,148,135,81,73,37,0,36,8,8,8,0,0,0,0,0,0,54,15,4,0,11,39,39,39,0,0,0,0,0,0,66535
22991,2106,142,939,659,223,143,397,198,178,94,11,73,20,7,7,0,0,13,5,0,8,199,175,53,0,122,24,16,6,0,10,8,0,0,8,66536
22992,875,75,365,310,89,36,46,13,13,10,3,0,0,0,0,0,0,0,0,0,0,33,24,6,11,7,9,0,0,0,0,9,0,9,0,66537
22993,2083,172,1113,464,239,95,157,126,76,31,0,45,50,50,50,0,0,0,0,0,0,31,31,16,0,15,0,0,0,0,0,0,0,0,0,66538
22994,1817,93,555,585,389,195,156,71,60,21,3,36,11,7,0,7,0,4,0,0,4,85,85,32,5,48,0,0,0,0,0,0,0,0,0,66539
22995,383,20,202,101,43,17,12,7,7,0,0,7,0,0,0,0,0,0,0,0,0,5,5,5,0,0,0,0,0,0,0,0,0,0,0,66540
22996,265,16,150,83,13,3,4,2,2,0,0,2,0,0,0,0,0,0,0,0,0,2,2,0,0,2,0,0,0,0,0,0,0,0,0,66541
22997,2435,134,849,571,672,209,44,38,28,0,0,28,10,10,10,0,0,0,0,0,0,6,6,0,0,6,0,0,0,0,0,0,0,0,0,66542
22998,614,99,219,200,51,45,41,26,26,0,0,26,0,0,0,0,0,0,0,0,0,15,15,10,0,5,0,0,0,0,0,0,0,0,0,66543
22999,259,21,107,82,49,0,0,0,0,0,0,0,0,0,0,0,0,0,0,0,0,0,0,0,0,0,0,0,0,0,0,0,0,0,0,66544
23000,952,45,342,201,250,114,64,42,42,0,0,42,0,0,0,0,0,0,0,0,0,22,22,0,0,22,0,0,0,0,0,0,0,0,0,66546
23001,4897,201,1216,1861,1048,571,466,221,171,49,2,120,50,50,33,0,17,0,0,0,0,245,236,143,0,93,9,9,6,1,2,0,0,0,0,66547
23002,631,47,303,220,30,31,26,21,21,10,0,11,0,0,0,0,0,0,0,0,0,5,5,2,0,3,0,0,0,0,0,0,0,0,0,66548
23003,1136,63,312,411,240,110,47,35,35,16,12,7,0,0,0,0,0,0,0,0,0,12,10,6,0,4,2,1,1,0,0,1,0,0,1,66549
23004,339,28,156,103,41,11,20,6,6,5,0,1,0,0,0,0,0,0,0,0,0,14,3,0,0,3,11,0,0,0,0,11,11,0,0,66550
23005,318,24,159,90,37,8,6,2,0,0,0,0,2,2,0,2,0,0,0,0,0,4,4,0,0,4,0,0,0,0,0,0,0,0,0,66552
23006,565,13,182,163,157,50,28,13,9,3,0,6,4,4,0,0,4,0,0,0,0,15,15,2,0,13,0,0,0,0,0,0,0,0,0,66554
23007,933,314,349,156,75,39,66,42,8,8,0,0,34,34,0,8,26,0,0,0,0,24,6,0,0,6,18,18,11,7,0,0,0,0,0,66603
23008,14342,1145,4024,4292,3206,1675,1155,647,567,167,31,369,80,36,10,20,6,44,25,14,5,508,448,151,17,280,60,49,49,0,0,11,6,4,1,66604
23009,12709,1962,4480,4038,1572,657,1383,669,499,132,30,337,170,162,71,9,82,8,0,0,8,714,504,212,91,201,210,148,26,50,72,62,0,51,11,66605
23010,7802,657,2494,2412,1287,952,528,269,194,36,4,154,75,75,63,12,0,0,0,0,0,259,195,42,0,153,64,64,51,6,7,0,0,0,0,66606
23011,6668,2144,2586,1578,228,132,588,326,147,49,0,98,179,82,64,10,8,97,74,11,12,262,181,51,6,124,81,49,4,0,45,32,0,29,3,66607
23012,3951,710,1755,1020,360,106,306,147,81,43,0,38,66,31,8,0,23,35,6,19,10,159,106,31,19,56,53,24,7,0,17,29,29,0,0,66608
23013,5124,426,1916,1697,708,377,464,317,167,29,35,103,150,96,63,33,0,54,54,0,0,147,91,77,0,14,56,19,0,19,0,37,5,0,32,66609
23014,6480,145,1112,1688,2201,1334,492,251,227,84,26,117,24,24,14,0,10,0,0,0,0,241,241,63,10,168,0,0,0,0,0,0,0,0,0,66610
23015,6670,370,1653,2207,1444,996,240,75,59,26,0,33,16,13,0,9,4,3,0,0,3,165,145,34,18,93,20,20,20,0,0,0,0,0,0,66611
23016,1967,405,806,478,141,137,133,54,32,16,16,0,22,11,11,0,0,11,0,11,0,79,79,16,39,24,0,0,0,0,0,0,0,0,0,66612
23017,21545,984,5044,6931,5194,3392,1420,751,626,268,76,282,125,108,63,30,15,17,0,0,17,669,638,303,98,237,31,31,17,10,4,0,0,0,0,66614
23018,2175,83,665,695,504,228,150,78,61,0,0,61,17,15,14,0,1,2,0,0,2,72,54,0,6,48,18,7,0,0,7,11,0,0,11,66615
23019,3870,902,1711,1011,144,102,224,43,24,4,4,16,19,19,19,0,0,0,0,0,0,181,83,39,0,44,98,98,98,0,0,0,0,0,0,66616
23020,6246,242,2552,2025,1147,280,435,272,244,69,28,147,28,16,0,16,0,12,12,0,0,163,163,40,20,103,0,0,0,0,0,0,0,0,0,66617
23021,6553,287,2167,2271,1264,564,616,391,318,52,0,266,73,64,15,39,10,9,9,0,0,225,222,99,0,123,3,1,0,0,1,2,0,0,2,66618
23022,1653,170,551,542,309,81,104,70,70,15,0,55,0,0,0,0,0,0,0,0,0,34,10,10,0,0,24,24,24,0,0,0,0,0,0,66619
23023,1,0,0,0,1,0,219,72,72,0,8,64,0,0,0,0,0,0,0,0,0,147,147,83,29,35,0,0,0,0,0,0,0,0,0,66621
23024,152,26,82,44,0,0,0,0,0,0,0,0,0,0,0,0,0,0,0,0,0,0,0,0,0,0,0,0,0,0,0,0,0,0,0,66622
23025,8067,1126,2369,2816,1099,657,709,417,414,149,17,248,3,0,0,0,0,3,3,0,0,292,252,185,30,37,40,15,0,0,15,25,0,25,0,66701
23026,572,77,238,186,44,27,24,23,23,17,0,6,0,0,0,0,0,0,0,0,0,1,1,1,0,0,0,0,0,0,0,0,0,0,0,66710
23027,471,65,212,164,17,13,26,15,14,1,0,13,1,1,0,0,1,0,0,0,0,11,7,0,1,6,4,0,0,0,0,4,0,1,3,66711
23028,1208,160,490,319,168,71,70,9,9,0,3,6,0,0,0,0,0,0,0,0,0,61,58,10,0,48,3,3,0,0,3,0,0,0,0,66712
23029,3839,640,1239,1455,316,189,329,190,134,48,0,86,56,56,33,0,23,0,0,0,0,139,135,42,0,93,4,0,0,0,0,4,0,4,0,66713
23030,120,17,62,35,6,0,15,13,0,0,0,0,13,13,13,0,0,0,0,0,0,2,2,0,2,0,0,0,0,0,0,0,0,0,0,66714
23031,532,31,225,176,78,22,39,13,8,2,0,6,5,5,3,2,0,0,0,0,0,26,26,4,3,19,0,0,0,0,0,0,0,0,0,66716
23032,409,72,144,156,31,6,51,36,19,0,0,19,17,17,11,2,4,0,0,0,0,15,15,7,0,8,0,0,0,0,0,0,0,0,0,66717
23033,7440,862,2559,2800,842,377,702,371,312,36,74,202,59,42,42,0,0,17,17,0,0,331,324,66,10,248,7,7,0,7,0,0,0,0,0,66720
23034,693,36,354,206,75,22,63,34,34,2,0,32,0,0,0,0,0,0,0,0,0,29,29,0,0,29,0,0,0,0,0,0,0,0,0,66724
23035,3947,500,1492,1280,463,212,278,95,84,16,22,46,11,11,0,4,7,0,0,0,0,183,176,111,0,65,7,7,7,0,0,0,0,0,0,66725
23036,0,0,0,0,0,0,0,0,0,0,0,0,0,0,0,0,0,0,0,0,0,0,0,0,0,0,0,0,0,0,0,0,0,0,0,66728
23037,219,24,102,78,15,0,8,2,0,0,0,0,2,0,0,0,0,2,0,0,2,6,6,0,0,6,0,0,0,0,0,0,0,0,0,66732
23038,1601,130,501,625,198,147,126,51,45,14,2,29,6,5,4,0,1,1,0,0,1,75,75,30,0,45,0,0,0,0,0,0,0,0,0,66733
23039,149,15,68,45,21,0,0,0,0,0,0,0,0,0,0,0,0,0,0,0,0,0,0,0,0,0,0,0,0,0,0,0,0,0,0,66734
23040,519,40,171,251,35,22,37,0,0,0,0,0,0,0,0,0,0,0,0,0,0,37,37,37,0,0,0,0,0,0,0,0,0,0,0,66735
23041,2566,443,908,874,215,126,222,100,88,45,0,43,12,0,0,0,0,12,8,0,4,122,106,49,4,53,16,12,12,0,0,4,0,0,4,66736
23042,279,27,101,106,17,28,14,10,10,3,0,7,0,0,0,0,0,0,0,0,0,4,1,0,0,1,3,0,0,0,0,3,0,0,3,66738
23043,3539,528,1198,1446,203,164,326,82,61,12,0,49,21,10,10,0,0,11,0,0,11,244,226,52,0,174,18,18,18,0,0,0,0,0,0,66739
23044,176,14,100,42,7,13,43,43,42,13,0,29,1,1,0,0,1,0,0,0,0,0,0,0,0,0,0,0,0,0,0,0,0,0,0,66740
23045,113,5,33,25,39,11,0,0,0,0,0,0,0,0,0,0,0,0,0,0,0,0,0,0,0,0,0,0,0,0,0,0,0,0,0,66741
23046,2896,332,1054,861,411,238,177,127,77,33,0,44,50,28,0,0,28,22,0,0,22,50,42,0,3,39,8,8,0,8,0,0,0,0,0,66743
23047,175,22,87,57,1,8,13,6,3,0,0,3,3,3,0,3,0,0,0,0,0,7,7,5,0,2,0,0,0,0,0,0,0,0,0,66746
23048,1650,142,670,619,143,76,149,81,61,26,0,35,20,7,0,7,0,13,0,0,13,68,61,14,0,47,7,7,7,0,0,0,0,0,0,66748
23049,5298,649,1566,2174,608,301,584,298,273,89,38,146,25,19,19,0,0,6,0,0,6,286,227,125,18,84,59,55,0,55,0,4,0,0,4,66749
23050,655,110,204,262,73,6,46,25,8,0,0,8,17,8,6,2,0,9,0,9,0,21,21,8,0,13,0,0,0,0,0,0,0,0,0,66751
23051,800,75,284,300,107,34,46,28,28,4,0,24,0,0,0,0,0,0,0,0,0,18,18,4,0,14,0,0,0,0,0,0,0,0,0,66753
23052,288,29,129,109,14,7,54,14,14,12,0,2,0,0,0,0,0,0,0,0,0,40,34,10,9,15,6,3,0,0,3,3,0,0,3,66754
23053,760,81,278,274,88,39,35,16,14,5,0,9,2,2,0,0,2,0,0,0,0,19,16,5,0,11,3,3,0,0,3,0,0,0,0,66755
23054,705,139,317,207,22,20,27,13,6,2,0,4,7,5,3,2,0,2,0,2,0,14,11,0,0,11,3,3,0,0,3,0,0,0,0,66756
23055,2293,489,739,683,253,129,159,79,50,0,0,50,29,29,29,0,0,0,0,0,0,80,68,27,0,41,12,7,7,0,0,5,0,0,5,66757
23056,203,33,91,71,1,7,1,1,0,0,0,0,1,1,0,1,0,0,0,0,0,0,0,0,0,0,0,0,0,0,0,0,0,0,0,66758
23057,29,15,0,14,0,0,0,0,0,0,0,0,0,0,0,0,0,0,0,0,0,0,0,0,0,0,0,0,0,0,0,0,0,0,0,66760
23058,249,22,131,70,26,0,44,33,16,0,0,16,17,10,0,10,0,7,7,0,0,11,8,0,0,8,3,0,0,0,0,3,0,0,3,66761
23059,13786,1164,3231,4748,2936,1707,1987,1008,940,161,65,714,68,49,44,0,5,19,0,19,0,979,872,363,108,401,107,99,69,4,26,8,1,0,7,66762
23060,2366,249,739,763,389,226,127,109,86,28,0,58,23,8,0,0,8,15,0,0,15,18,18,10,0,8,0,0,0,0,0,0,0,0,0,66763
23061,352,27,162,137,18,8,18,7,7,0,0,7,0,0,0,0,0,0,0,0,0,11,5,0,4,1,6,6,6,0,0,0,0,0,0,66767
23062,238,36,72,96,34,0,26,6,6,6,0,0,0,0,0,0,0,0,0,0,0,20,20,0,0,20,0,0,0,0,0,0,0,0,0,66769
23063,867,84,298,327,98,60,19,10,10,0,0,10,0,0,0,0,0,0,0,0,0,9,9,0,0,9,0,0,0,0,0,0,0,0,0,66770
23064,823,38,312,331,109,33,51,25,23,13,2,8,2,0,0,0,0,2,2,0,0,26,22,8,3,11,4,0,0,0,0,4,0,0,4,66771
23065,199,14,76,66,39,4,25,10,10,5,5,0,0,0,0,0,0,0,0,0,0,15,13,0,0,13,2,2,2,0,0,0,0,0,0,66772
23066,573,68,213,241,42,9,48,12,12,5,0,7,0,0,0,0,0,0,0,0,0,36,22,6,0,16,14,0,0,0,0,14,0,0,14,66773
23067,68,4,6,57,1,0,9,6,6,2,2,2,0,0,0,0,0,0,0,0,0,3,3,0,3,0,0,0,0,0,0,0,0,0,0,66775
23068,813,69,294,388,43,19,55,47,47,27,0,20,0,0,0,0,0,0,0,0,0,8,8,1,0,7,0,0,0,0,0,0,0,0,0,66776
23069,553,62,238,168,78,7,13,5,5,5,0,0,0,0,0,0,0,0,0,0,0,8,8,2,0,6,0,0,0,0,0,0,0,0,0,66777
23070,46,25,21,0,0,0,4,2,0,0,0,0,2,0,0,0,0,2,0,0,2,2,2,0,0,2,0,0,0,0,0,0,0,0,0,66778
23071,467,17,89,220,97,44,61,10,10,0,0,10,0,0,0,0,0,0,0,0,0,51,50,4,0,46,1,1,1,0,0,0,0,0,0,66779
23072,545,31,215,241,54,4,7,4,4,0,0,4,0,0,0,0,0,0,0,0,0,3,2,0,0,2,1,1,0,1,0,0,0,0,0,66780
23073,948,97,281,336,154,80,85,58,47,10,0,37,11,1,0,0,1,10,0,0,10,27,18,1,6,11,9,0,0,0,0,9,0,0,9,66781
23074,171,49,30,82,10,0,5,5,5,1,0,4,0,0,0,0,0,0,0,0,0,0,0,0,0,0,0,0,0,0,0,0,0,0,0,66782
23075,1500,101,583,484,260,72,84,45,37,17,0,20,8,8,8,0,0,0,0,0,0,39,39,31,4,4,0,0,0,0,0,0,0,0,0,66783
23076,16643,2378,5448,4796,2502,1519,2079,968,708,328,54,326,260,242,205,14,23,18,13,0,5,1111,990,457,93,440,121,102,29,0,73,19,10,9,0,66801
23077,129,4,77,28,16,4,0,0,0,0,0,0,0,0,0,0,0,0,0,0,0,0,0,0,0,0,0,0,0,0,0,0,0,0,0,66830
23078,347,36,91,115,74,31,27,21,14,0,0,14,7,7,0,0,7,0,0,0,0,6,6,0,0,6,0,0,0,0,0,0,0,0,0,66833
23079,650,33,324,194,82,17,23,11,11,2,2,7,0,0,0,0,0,0,0,0,0,12,12,10,0,2,0,0,0,0,0,0,0,0,0,66834
23080,809,73,324,277,95,40,47,35,35,32,0,3,0,0,0,0,0,0,0,0,0,12,12,6,0,6,0,0,0,0,0,0,0,0,0,66835
23081,182,28,80,52,11,11,10,5,5,0,0,5,0,0,0,0,0,0,0,0,0,5,5,5,0,0,0,0,0,0,0,0,0,0,0,66838
23082,2650,195,1058,867,430,100,193,98,75,18,7,50,23,23,23,0,0,0,0,0,0,95,89,43,0,46,6,6,6,0,0,0,0,0,0,66839
23083,489,127,163,125,64,10,69,27,27,13,0,14,0,0,0,0,0,0,0,0,0,42,22,13,0,9,20,0,0,0,0,20,14,6,0,66840
23084,181,7,40,88,40,6,14,8,8,3,0,5,0,0,0,0,0,0,0,0,0,6,6,2,0,4,0,0,0,0,0,0,0,0,0,66842
23085,82,0,5,59,0,18,0,0,0,0,0,0,0,0,0,0,0,0,0,0,0,0,0,0,0,0,0,0,0,0,0,0,0,0,0,66843
23086,982,95,398,268,176,45,105,52,48,12,0,36,4,4,4,0,0,0,0,0,0,53,53,29,2,22,0,0,0,0,0,0,0,0,0,66845
23087,2432,265,827,799,291,250,147,87,82,34,7,41,5,5,4,0,1,0,0,0,0,60,52,28,6,18,8,8,8,0,0,0,0,0,0,66846
23088,287,20,95,123,27,22,15,11,11,8,1,2,0,0,0,0,0,0,0,0,0,4,4,4,0,0,0,0,0,0,0,0,0,0,0,66849
23089,120,1,16,47,24,32,3,3,3,3,0,0,0,0,0,0,0,0,0,0,0,0,0,0,0,0,0,0,0,0,0,0,0,0,0,66850
23090,421,75,162,136,19,29,12,1,1,0,0,1,0,0,0,0,0,0,0,0,0,11,7,3,0,4,4,0,0,0,0,4,0,0,4,66851
23091,433,20,202,139,54,18,34,18,15,7,0,8,3,3,0,3,0,0,0,0,0,16,16,10,0,6,0,0,0,0,0,0,0,0,0,66852
23092,282,26,108,70,59,19,47,38,26,2,5,19,12,0,0,0,0,12,0,12,0,9,2,0,0,2,7,7,7,0,0,0,0,0,0,66853
23093,541,34,278,169,36,24,15,10,10,2,1,7,0,0,0,0,0,0,0,0,0,5,5,0,1,4,0,0,0,0,0,0,0,0,0,66854
23094,1111,55,404,346,225,81,115,71,58,12,0,46,13,9,9,0,0,4,4,0,0,44,41,31,0,10,3,3,0,3,0,0,0,0,0,66856
23095,708,65,255,271,92,25,81,46,46,3,8,35,0,0,0,0,0,0,0,0,0,35,30,23,0,7,5,5,3,2,0,0,0,0,0,66857
23096,303,44,151,57,36,15,27,18,3,0,0,3,15,15,8,0,7,0,0,0,0,9,9,1,0,8,0,0,0,0,0,0,0,0,0,66858
23097,150,9,80,45,10,6,23,23,14,0,0,14,9,9,0,0,9,0,0,0,0,0,0,0,0,0,0,0,0,0,0,0,0,0,0,66859
23098,885,58,362,314,113,38,53,24,24,4,0,20,0,0,0,0,0,0,0,0,0,29,29,25,0,4,0,0,0,0,0,0,0,0,0,66860
23099,2195,205,869,698,300,123,105,74,65,14,6,45,9,0,0,0,0,9,0,0,9,31,31,7,7,17,0,0,0,0,0,0,0,0,0,66861
23100,63,1,15,18,15,14,0,0,0,0,0,0,0,0,0,0,0,0,0,0,0,0,0,0,0,0,0,0,0,0,0,0,0,0,0,66862
23101,54,0,38,16,0,0,10,10,10,0,0,10,0,0,0,0,0,0,0,0,0,0,0,0,0,0,0,0,0,0,0,0,0,0,0,66863
23102,363,48,140,89,53,33,27,19,15,3,1,11,4,2,0,2,0,2,2,0,0,8,8,6,0,2,0,0,0,0,0,0,0,0,0,66864
23103,774,21,281,275,100,97,27,15,15,4,2,9,0,0,0,0,0,0,0,0,0,12,12,2,0,10,0,0,0,0,0,0,0,0,0,66865
23104,1236,104,476,447,120,89,113,51,43,4,14,25,8,0,0,0,0,8,0,0,8,62,56,39,2,15,6,0,0,0,0,6,0,0,6,66866
23105,433,39,119,165,87,23,25,6,6,0,0,6,0,0,0,0,0,0,0,0,0,19,19,4,0,15,0,0,0,0,0,0,0,0,0,66868
23106,475,76,178,129,68,24,16,7,4,0,0,4,3,0,0,0,0,3,3,0,0,9,9,9,0,0,0,0,0,0,0,0,0,0,0,66869
23107,92,14,47,20,9,2,2,0,0,0,0,0,0,0,0,0,0,0,0,0,0,2,2,0,0,2,0,0,0,0,0,0,0,0,0,66870
23108,990,112,329,370,140,39,24,9,9,0,0,9,0,0,0,0,0,0,0,0,0,15,15,4,0,11,0,0,0,0,0,0,0,0,0,66871
23109,898,125,402,314,38,19,104,36,28,1,0,27,8,8,0,2,6,0,0,0,0,68,68,55,0,13,0,0,0,0,0,0,0,0,0,66872
23110,229,7,109,44,27,42,11,2,2,0,2,0,0,0,0,0,0,0,0,0,0,9,9,3,6,0,0,0,0,0,0,0,0,0,0,66873
23111,4185,445,1359,1594,473,314,557,252,231,114,2,115,21,6,6,0,0,15,0,0,15,305,305,193,0,112,0,0,0,0,0,0,0,0,0,66901
23112,147,6,53,76,9,3,11,2,2,2,0,0,0,0,0,0,0,0,0,0,0,9,9,0,0,9,0,0,0,0,0,0,0,0,0,66930
23113,123,10,62,41,2,8,2,2,2,0,2,0,0,0,0,0,0,0,0,0,0,0,0,0,0,0,0,0,0,0,0,0,0,0,0,66932
23114,217,11,107,91,1,7,3,2,2,0,0,2,0,0,0,0,0,0,0,0,0,1,1,0,1,0,0,0,0,0,0,0,0,0,0,66933
23115,1730,117,612,663,201,137,83,59,58,31,7,20,1,1,0,0,1,0,0,0,0,24,16,9,0,7,8,2,2,0,0,6,0,0,6,66935
23116,260,23,89,110,28,10,8,2,2,0,0,2,0,0,0,0,0,0,0,0,0,6,6,6,0,0,0,0,0,0,0,0,0,0,0,66936
23117,508,35,252,177,37,7,28,18,16,8,0,8,2,0,0,0,0,2,2,0,0,10,8,6,0,2,2,2,0,0,2,0,0,0,0,66937
23118,743,57,296,301,72,17,60,41,25,2,0,23,16,16,4,12,0,0,0,0,0,19,19,8,0,11,0,0,0,0,0,0,0,0,0,66938
23119,415,6,123,163,83,40,43,12,12,3,6,3,0,0,0,0,0,0,0,0,0,31,28,5,0,23,3,3,0,3,0,0,0,0,0,66939
23120,291,13,107,135,31,5,0,0,0,0,0,0,0,0,0,0,0,0,0,0,0,0,0,0,0,0,0,0,0,0,0,0,0,0,0,66940
23121,140,22,29,62,21,6,8,3,3,0,0,3,0,0,0,0,0,0,0,0,0,5,5,5,0,0,0,0,0,0,0,0,0,0,0,66941
23122,170,14,68,62,24,2,1,1,1,0,0,1,0,0,0,0,0,0,0,0,0,0,0,0,0,0,0,0,0,0,0,0,0,0,0,66942
23123,358,60,151,98,31,18,17,8,1,0,0,1,7,7,0,0,7,0,0,0,0,9,2,2,0,0,7,7,0,0,7,0,0,0,0,66943
23124,138,20,33,61,21,3,2,2,2,0,0,2,0,0,0,0,0,0,0,0,0,0,0,0,0,0,0,0,0,0,0,0,0,0,0,66944
23125,689,58,262,250,95,24,81,46,22,9,0,13,24,24,12,12,0,0,0,0,0,35,35,15,0,20,0,0,0,0,0,0,0,0,0,66945
23126,120,8,48,48,16,0,10,10,10,6,0,4,0,0,0,0,0,0,0,0,0,0,0,0,0,0,0,0,0,0,0,0,0,0,0,66946
23127,390,44,154,156,19,17,45,16,15,14,0,1,1,1,1,0,0,0,0,0,0,29,29,1,0,28,0,0,0,0,0,0,0,0,0,66948
23128,483,31,172,215,38,27,21,14,14,10,0,4,0,0,0,0,0,0,0,0,0,7,7,2,0,5,0,0,0,0,0,0,0,0,0,66949
23129,623,62,195,187,136,43,70,37,37,0,27,10,0,0,0,0,0,0,0,0,0,33,33,10,0,23,0,0,0,0,0,0,0,0,0,66951
23130,386,28,177,124,44,13,29,26,26,0,0,26,0,0,0,0,0,0,0,0,0,3,3,0,0,3,0,0,0,0,0,0,0,0,0,66952
23131,512,106,154,137,77,38,25,13,13,8,4,1,0,0,0,0,0,0,0,0,0,12,12,11,0,1,0,0,0,0,0,0,0,0,0,66953
23132,76,0,50,18,8,0,6,5,1,1,0,0,4,0,0,0,0,4,4,0,0,1,1,1,0,0,0,0,0,0,0,0,0,0,0,66955
23133,898,93,366,318,111,10,31,20,19,10,0,9,1,1,0,0,1,0,0,0,0,11,11,11,0,0,0,0,0,0,0,0,0,0,0,66956
23134,175,10,70,63,25,7,10,5,4,1,0,3,1,0,0,0,0,1,0,0,1,5,5,0,0,5,0,0,0,0,0,0,0,0,0,66958
23135,228,20,128,62,12,6,13,9,9,1,0,8,0,0,0,0,0,0,0,0,0,4,4,0,0,4,0,0,0,0,0,0,0,0,0,66959
23136,122,7,65,35,15,0,15,8,2,2,0,0,6,6,0,0,6,0,0,0,0,7,7,0,0,7,0,0,0,0,0,0,0,0,0,66960
23137,198,17,53,83,31,14,12,7,7,1,0,6,0,0,0,0,0,0,0,0,0,5,5,2,0,3,0,0,0,0,0,0,0,0,0,66962
23138,94,3,33,44,14,0,2,0,0,0,0,0,0,0,0,0,0,0,0,0,0,2,2,0,0,2,0,0,0,0,0,0,0,0,0,66963
23139,168,11,63,59,34,1,4,4,2,0,0,2,2,2,0,0,2,0,0,0,0,0,0,0,0,0,0,0,0,0,0,0,0,0,0,66964
23140,477,24,184,147,99,23,36,30,22,12,0,10,8,5,3,2,0,3,3,0,0,6,6,2,0,4,0,0,0,0,0,0,0,0,0,66966
23141,1465,163,436,636,156,74,37,26,26,20,0,6,0,0,0,0,0,0,0,0,0,11,11,11,0,0,0,0,0,0,0,0,0,0,0,66967
23142,1288,89,489,500,168,42,82,49,37,20,14,3,12,8,0,0,8,4,4,0,0,33,33,24,0,9,0,0,0,0,0,0,0,0,0,66968
23143,165,2,40,89,31,3,4,0,0,0,0,0,0,0,0,0,0,0,0,0,0,4,4,0,0,4,0,0,0,0,0,0,0,0,0,66970
23144,939,24,229,384,215,87,246,105,58,35,0,23,47,47,15,32,0,0,0,0,0,141,139,54,6,79,2,0,0,0,0,2,0,0,2,67001
23145,8724,387,1553,3091,2426,1267,1000,575,575,225,41,309,0,0,0,0,0,0,0,0,0,425,391,178,48,165,34,34,34,0,0,0,0,0,0,67002
23146,1895,251,610,664,227,143,217,131,108,0,16,92,23,23,12,11,0,0,0,0,0,86,44,32,2,10,42,42,42,0,0,0,0,0,0,67003
23147,518,31,196,185,75,31,35,29,29,0,0,29,0,0,0,0,0,0,0,0,0,6,6,4,2,0,0,0,0,0,0,0,0,0,0,67004
23148,10378,1523,2756,4353,1169,577,1183,572,480,129,85,266,92,63,63,0,0,29,11,18,0,611,454,174,43,237,157,92,47,0,45,65,4,0,61,67005
23149,354,47,55,148,82,22,35,25,22,14,0,8,3,1,1,0,0,2,2,0,0,10,9,3,2,4,1,1,1,0,0,0,0,0,0,67008
23150,598,60,238,207,64,29,52,24,24,5,3,16,0,0,0,0,0,0,0,0,0,28,10,2,8,0,18,0,0,0,0,18,18,0,0,67009
23151,8948,858,2818,3283,1478,511,675,320,256,45,32,179,64,54,38,16,0,10,10,0,0,355,270,146,10,114,85,53,42,0,11,32,32,0,0,67010
23152,20,11,9,0,0,0,0,0,0,0,0,0,0,0,0,0,0,0,0,0,0,0,0,0,0,0,0,0,0,0,0,0,0,0,0,67012
23153,1845,193,573,769,239,71,191,88,88,6,8,74,0,0,0,0,0,0,0,0,0,103,79,6,22,51,24,19,19,0,0,5,5,0,0,67013
23154,354,51,114,128,28,33,19,7,1,0,0,1,6,6,3,3,0,0,0,0,0,12,11,6,4,1,1,0,0,0,0,1,1,0,0,67016
23155,1524,82,383,675,276,108,207,96,83,4,13,66,13,13,13,0,0,0,0,0,0,111,109,29,0,80,2,0,0,0,0,2,0,0,2,67017
23156,50,20,13,15,2,0,0,0,0,0,0,0,0,0,0,0,0,0,0,0,0,0,0,0,0,0,0,0,0,0,0,0,0,0,0,67018
23157,604,37,224,253,56,34,75,29,29,5,4,20,0,0,0,0,0,0,0,0,0,46,44,25,0,19,2,2,0,2,0,0,0,0,0,67019
23158,1032,89,377,356,183,27,150,73,65,17,0,48,8,6,0,6,0,2,0,0,2,77,73,50,0,23,4,4,4,0,0,0,0,0,0,67020
23159,49,18,4,27,0,0,2,0,0,0,0,0,0,0,0,0,0,0,0,0,0,2,2,0,0,2,0,0,0,0,0,0,0,0,0,67021
23160,1223,122,388,460,185,68,81,35,35,13,4,18,0,0,0,0,0,0,0,0,0,46,29,11,5,13,17,7,0,7,0,10,10,0,0,67022
23161,135,11,43,69,12,0,5,2,2,0,0,2,0,0,0,0,0,0,0,0,0,3,3,0,0,3,0,0,0,0,0,0,0,0,0,67023
23162,556,59,199,190,76,32,17,6,6,3,0,3,0,0,0,0,0,0,0,0,0,11,2,0,0,2,9,9,9,0,0,0,0,0,0,67024
23163,2459,152,768,785,540,214,243,136,115,18,0,97,21,21,12,9,0,0,0,0,0,107,107,73,4,30,0,0,0,0,0,0,0,0,0,67025
23164,3212,272,1124,1020,603,193,329,172,151,69,7,75,21,9,9,0,0,12,12,0,0,157,151,73,0,78,6,6,6,0,0,0,0,0,0,67026
23165,175,20,53,75,19,8,3,2,2,0,0,2,0,0,0,0,0,0,0,0,0,1,1,0,0,1,0,0,0,0,0,0,0,0,0,67028
23166,610,65,250,199,59,37,65,27,27,16,0,11,0,0,0,0,0,0,0,0,0,38,38,28,0,10,0,0,0,0,0,0,0,0,0,67029
23167,1572,51,521,484,395,121,264,126,102,59,22,21,24,24,21,0,3,0,0,0,0,138,138,73,6,59,0,0,0,0,0,0,0,0,0,67030
23168,1744,224,784,498,142,96,139,73,46,27,0,19,27,27,27,0,0,0,0,0,0,66,66,12,3,51,0,0,0,0,0,0,0,0,0,67031
23169,819,90,248,355,97,29,54,29,22,0,0,22,7,7,7,0,0,0,0,0,0,25,25,20,0,5,0,0,0,0,0,0,0,0,0,67035
23170,90,8,47,27,3,5,0,0,0,0,0,0,0,0,0,0,0,0,0,0,0,0,0,0,0,0,0,0,0,0,0,0,0,0,0,67036
23171,17647,866,3693,6837,4425,1826,1614,974,761,235,79,447,213,99,83,0,16,114,21,0,93,640,612,232,94,286,28,28,15,13,0,0,0,0,0,67037
23172,515,57,163,247,32,16,40,26,24,9,0,15,2,0,0,0,0,2,2,0,0,14,14,0,0,14,0,0,0,0,0,0,0,0,0,67038
23173,2395,169,810,923,364,129,230,132,126,31,0,95,6,6,6,0,0,0,0,0,0,98,86,11,0,75,12,12,8,0,4,0,0,0,0,67039
23174,145,11,33,49,38,14,18,7,7,4,0,3,0,0,0,0,0,0,0,0,0,11,11,3,0,8,0,0,0,0,0,0,0,0,0,67041
23175,11236,960,3421,4842,1331,682,1166,620,452,224,0,228,168,51,14,37,0,117,0,25,92,546,495,176,0,319,51,4,4,0,0,47,0,35,12,67042
23176,2609,249,1009,895,294,162,121,63,63,12,22,29,0,0,0,0,0,0,0,0,0,58,37,11,12,14,21,21,21,0,0,0,0,0,0,67045
23177,557,93,242,153,48,21,17,8,8,8,0,0,0,0,0,0,0,0,0,0,0,9,9,1,0,8,0,0,0,0,0,0,0,0,0,67047
23178,30,0,11,19,0,0,0,0,0,0,0,0,0,0,0,0,0,0,0,0,0,0,0,0,0,0,0,0,0,0,0,0,0,0,0,67049
23179,1242,41,452,418,256,75,133,71,67,12,7,48,4,4,4,0,0,0,0,0,0,62,62,13,0,49,0,0,0,0,0,0,0,0,0,67050
23180,316,34,132,98,29,23,18,18,5,0,0,5,13,0,0,0,0,13,13,0,0,0,0,0,0,0,0,0,0,0,0,0,0,0,0,67051
23181,4692,290,1195,1544,1061,602,564,317,255,74,20,161,62,62,33,29,0,0,0,0,0,247,230,81,8,141,17,17,7,0,10,0,0,0,0,67052
23182,404,55,124,178,31,16,33,27,27,22,0,5,0,0,0,0,0,0,0,0,0,6,6,0,2,4,0,0,0,0,0,0,0,0,0,67053
23183,920,83,266,385,128,58,47,34,27,19,0,8,7,0,0,0,0,7,7,0,0,13,7,0,0,7,6,0,0,0,0,6,0,3,3,67054
23184,101,16,85,0,0,0,0,0,0,0,0,0,0,0,0,0,0,0,0,0,0,0,0,0,0,0,0,0,0,0,0,0,0,0,0,67055
23185,2093,420,519,737,332,85,213,113,105,29,28,48,8,0,0,0,0,8,8,0,0,100,72,22,27,23,28,21,0,21,0,7,7,0,0,67056
23186,183,11,39,64,58,11,7,7,5,3,0,2,2,0,0,0,0,2,0,1,1,0,0,0,0,0,0,0,0,0,0,0,0,0,0,67057
23187,1453,166,464,600,142,81,55,31,12,0,0,12,19,19,19,0,0,0,0,0,0,24,24,24,0,0,0,0,0,0,0,0,0,0,0,67058
23188,603,47,149,247,80,80,117,48,48,0,6,42,0,0,0,0,0,0,0,0,0,69,59,15,4,40,10,7,7,0,0,3,0,0,3,67059
23189,8903,766,3334,3333,1067,403,832,368,287,64,15,208,81,75,51,24,0,6,0,0,6,464,411,74,78,259,53,29,13,0,16,24,0,0,24,67060
23190,123,14,51,38,12,8,5,3,3,3,0,0,0,0,0,0,0,0,0,0,0,2,2,0,0,2,0,0,0,0,0,0,0,0,0,67061
23191,2664,178,701,1089,515,181,320,150,136,69,5,62,14,14,0,14,0,0,0,0,0,170,170,69,0,101,0,0,0,0,0,0,0,0,0,67062
23192,2450,253,700,781,457,259,316,187,178,83,5,90,9,9,9,0,0,0,0,0,0,129,120,55,0,65,9,9,0,0,9,0,0,0,0,67063
23193,144,13,52,79,0,0,7,0,0,0,0,0,0,0,0,0,0,0,0,0,0,7,7,0,0,7,0,0,0,0,0,0,0,0,0,67065
23194,229,21,91,65,40,12,8,5,5,5,0,0,0,0,0,0,0,0,0,0,0,3,3,0,0,3,0,0,0,0,0,0,0,0,0,67066
23195,1207,70,319,339,327,152,55,34,34,18,0,16,0,0,0,0,0,0,0,0,0,21,16,2,5,9,5,0,0,0,0,5,5,0,0,67067
23196,2982,423,939,1104,329,187,205,112,64,7,32,25,48,39,39,0,0,9,0,0,9,93,43,0,0,43,50,48,25,23,0,2,0,0,2,67068
23197,875,84,328,250,106,107,46,29,29,6,0,23,0,0,0,0,0,0,0,0,0,17,14,11,0,3,3,0,0,0,0,3,0,0,3,67070
23198,93,0,50,38,5,0,5,0,0,0,0,0,0,0,0,0,0,0,0,0,0,5,5,0,0,5,0,0,0,0,0,0,0,0,0,67071
23199,166,17,80,53,6,10,22,9,0,0,0,0,9,9,7,0,2,0,0,0,0,13,7,6,0,1,6,6,6,0,0,0,0,0,0,67072
23200,213,4,83,69,55,2,14,4,4,1,0,3,0,0,0,0,0,0,0,0,0,10,10,0,0,10,0,0,0,0,0,0,0,0,0,67073
23201,1334,100,373,571,196,94,85,57,54,12,7,35,3,3,0,3,0,0,0,0,0,28,21,13,0,8,7,7,0,0,7,0,0,0,0,67074
23202,1972,142,480,682,505,163,355,76,76,12,0,64,0,0,0,0,0,0,0,0,0,279,239,100,24,115,40,40,40,0,0,0,0,0,0,67101
23203,219,23,55,102,37,2,19,3,3,0,0,3,0,0,0,0,0,0,0,0,0,16,16,6,0,10,0,0,0,0,0,0,0,0,0,67103
23204,1741,124,595,703,227,92,138,89,75,22,5,48,14,14,8,0,6,0,0,0,0,49,49,20,4,25,0,0,0,0,0,0,0,0,0,67104
23205,170,16,53,71,25,5,32,22,22,0,0,22,0,0,0,0,0,0,0,0,0,10,10,0,0,10,0,0,0,0,0,0,0,0,0,67105
23206,110,6,13,56,7,28,9,0,0,0,0,0,0,0,0,0,0,0,0,0,0,9,9,0,0,9,0,0,0,0,0,0,0,0,0,67106
23207,2009,385,646,519,294,165,83,31,27,16,0,11,4,4,4,0,0,0,0,0,0,52,19,3,7,9,33,30,19,0,11,3,3,0,0,67107
23208,1005,76,319,357,156,97,83,41,30,18,0,12,11,0,0,0,0,11,11,0,0,42,34,11,0,23,8,4,4,0,0,4,0,0,4,67108
23209,248,31,50,134,21,12,30,26,18,6,0,12,8,8,6,2,0,0,0,0,0,4,4,2,0,2,0,0,0,0,0,0,0,0,0,67109
23210,5334,212,1665,1770,1299,388,371,233,233,93,37,103,0,0,0,0,0,0,0,0,0,138,138,65,9,64,0,0,0,0,0,0,0,0,0,67110
23211,179,36,79,44,20,0,24,24,15,15,0,0,9,9,9,0,0,0,0,0,0,0,0,0,0,0,0,0,0,0,0,0,0,0,0,67111
23212,205,7,53,89,49,7,2,0,0,0,0,0,0,0,0,0,0,0,0,0,0,2,0,0,0,0,2,2,2,0,0,0,0,0,0,67112
23213,14588,1567,4536,4601,2550,1334,1160,611,513,237,32,244,98,82,39,0,43,16,0,0,16,549,457,179,18,260,92,62,62,0,0,30,0,20,10,67114
23214,1145,67,216,306,328,228,247,121,121,42,13,66,0,0,0,0,0,0,0,0,0,126,126,56,0,70,0,0,0,0,0,0,0,0,0,67117
23215,474,37,142,182,72,41,53,20,20,0,0,20,0,0,0,0,0,0,0,0,0,33,20,0,0,20,13,13,0,13,0,0,0,0,0,67118
23216,1101,54,439,413,130,65,113,73,67,28,0,39,6,6,6,0,0,0,0,0,0,40,33,7,0,26,7,0,0,0,0,7,7,0,0,67119
23217,1140,87,385,467,150,51,105,38,38,38,0,0,0,0,0,0,0,0,0,0,0,67,52,22,8,22,15,15,0,0,15,0,0,0,0,67120
23218,72,0,31,22,13,6,0,0,0,0,0,0,0,0,0,0,0,0,0,0,0,0,0,0,0,0,0,0,0,0,0,0,0,0,0,67122
23219,535,26,246,193,49,21,19,16,16,0,9,7,0,0,0,0,0,0,0,0,0,3,3,0,0,3,0,0,0,0,0,0,0,0,0,67123
23220,5488,603,1560,2001,776,548,541,267,259,84,8,167,8,8,8,0,0,0,0,0,0,274,251,129,14,108,23,3,0,3,0,20,0,0,20,67124
23221,612,40,123,263,131,55,12,6,4,4,0,0,2,0,0,0,0,2,0,2,0,6,6,0,0,6,0,0,0,0,0,0,0,0,0,67127
23222,113,9,24,59,16,5,5,5,5,0,0,5,0,0,0,0,0,0,0,0,0,0,0,0,0,0,0,0,0,0,0,0,0,0,0,67131
23223,244,31,95,100,8,10,32,7,7,3,0,4,0,0,0,0,0,0,0,0,0,25,25,5,0,20,0,0,0,0,0,0,0,0,0,67132
23224,4218,116,1191,1506,896,509,385,163,163,55,6,102,0,0,0,0,0,0,0,0,0,222,222,96,17,109,0,0,0,0,0,0,0,0,0,67133
23225,237,37,100,62,28,10,6,0,0,0,0,0,0,0,0,0,0,0,0,0,0,6,6,4,0,2,0,0,0,0,0,0,0,0,0,67134
23226,2325,202,739,794,381,209,227,100,100,4,16,80,0,0,0,0,0,0,0,0,0,127,127,34,0,93,0,0,0,0,0,0,0,0,0,67135
23227,462,61,233,114,52,2,2,2,2,0,0,2,0,0,0,0,0,0,0,0,0,0,0,0,0,0,0,0,0,0,0,0,0,0,0,67137
23228,193,29,74,53,31,6,11,5,5,0,0,5,0,0,0,0,0,0,0,0,0,6,6,2,0,4,0,0,0,0,0,0,0,0,0,67138
23229,436,46,155,155,61,19,25,22,20,5,2,13,2,2,2,0,0,0,0,0,0,3,2,1,0,1,1,1,0,0,1,0,0,0,0,67140
23230,320,44,141,101,26,8,0,0,0,0,0,0,0,0,0,0,0,0,0,0,0,0,0,0,0,0,0,0,0,0,0,0,0,0,0,67142
23231,51,0,30,20,1,0,0,0,0,0,0,0,0,0,0,0,0,0,0,0,0,0,0,0,0,0,0,0,0,0,0,0,0,0,0,67143
23232,1622,141,421,535,352,173,287,222,190,39,21,130,32,24,20,4,0,8,0,0,8,65,61,17,4,40,4,4,0,0,4,0,0,0,0,67144
23233,1366,103,430,541,214,78,108,64,58,23,3,32,6,4,4,0,0,2,2,0,0,44,39,15,0,24,5,1,1,0,0,4,4,0,0,67146
23234,5737,160,1881,1893,1304,499,577,401,338,31,0,307,63,38,38,0,0,25,0,25,0,176,176,76,0,100,0,0,0,0,0,0,0,0,0,67147
23235,726,31,331,230,92,42,47,9,7,0,0,7,2,2,2,0,0,0,0,0,0,38,38,17,0,21,0,0,0,0,0,0,0,0,0,67149
23236,25,6,13,6,0,0,0,0,0,0,0,0,0,0,0,0,0,0,0,0,0,0,0,0,0,0,0,0,0,0,0,0,0,0,0,67150
23237,351,16,64,159,57,55,11,4,4,0,0,4,0,0,0,0,0,0,0,0,0,7,7,6,0,1,0,0,0,0,0,0,0,0,0,67151
23238,6285,598,2421,2197,756,313,503,270,239,93,32,114,31,23,13,0,10,8,0,8,0,233,208,51,28,129,25,22,22,0,0,3,3,0,0,67152
23239,913,78,267,353,136,79,52,32,29,26,0,3,3,3,3,0,0,0,0,0,0,20,20,5,0,15,0,0,0,0,0,0,0,0,0,67154
23240,110,0,24,50,16,20,2,0,0,0,0,0,0,0,0,0,0,0,0,0,0,2,2,1,0,1,0,0,0,0,0,0,0,0,0,67155
23241,9985,1033,2901,3636,1518,897,977,504,395,156,31,208,109,39,27,4,8,70,13,47,10,473,455,159,37,259,18,0,0,0,0,18,6,12,0,67156
23242,86,0,49,24,7,6,0,0,0,0,0,0,0,0,0,0,0,0,0,0,0,0,0,0,0,0,0,0,0,0,0,0,0,0,0,67159
23243,1249,90,347,349,330,133,22,3,3,0,0,3,0,0,0,0,0,0,0,0,0,19,19,4,0,15,0,0,0,0,0,0,0,0,0,67202
23244,20124,3221,5815,6498,3172,1418,1521,702,506,105,158,243,196,64,57,7,0,132,20,64,48,819,689,228,84,377,130,72,32,17,23,58,0,28,30,67203
23245,13394,3038,3658,3791,2048,859,1378,659,503,108,41,354,156,125,103,10,12,31,0,0,31,719,400,142,30,228,319,279,151,0,128,40,40,0,0,67204
23246,10496,526,1628,2865,3792,1685,1196,644,644,176,72,396,0,0,0,0,0,0,0,0,0,552,528,281,29,218,24,24,14,0,10,0,0,0,0,67205
23247,11289,526,1660,3146,3752,2205,808,396,372,132,40,200,24,8,0,8,0,16,0,0,16,412,364,135,0,229,48,40,0,0,40,8,0,0,8,67206
23248,17033,1830,4579,6245,2805,1574,1337,706,476,152,119,205,230,55,29,16,10,175,70,0,105,631,518,183,13,322,113,109,82,27,0,4,0,4,0,67207
23249,11481,902,2573,4081,2479,1446,1235,726,642,179,115,348,84,36,14,14,8,48,35,13,0,509,416,124,33,259,93,68,30,0,38,25,0,22,3,67208
23250,9354,660,2882,3056,2004,752,600,300,282,70,11,201,18,18,0,0,18,0,0,0,0,300,234,80,0,154,66,66,39,27,0,0,0,0,0,67209
23251,5339,1509,1425,1635,567,203,596,345,225,36,10,179,120,101,31,49,21,19,5,0,14,251,219,66,22,131,32,29,12,0,17,3,3,0,0,67210
23252,13489,3290,4505,4183,1103,408,1248,639,477,130,50,297,162,68,38,13,17,94,57,22,15,609,519,140,70,309,90,83,45,0,38,7,0,0,7,67211
23253,29476,1874,7583,9866,7354,2799,2288,1158,1010,301,112,597,148,121,48,41,32,27,9,18,0,1130,1010,514,54,442,120,41,41,0,0,79,39,40,0,67212
23254,13465,2814,4682,4401,1143,425,1177,500,409,69,27,313,91,43,31,0,12,48,22,0,26,677,472,79,48,345,205,70,48,11,11,135,94,0,41,67213
23255,9166,2392,3039,2713,745,277,1056,538,395,36,13,346,143,73,29,44,0,70,32,31,7,518,399,90,71,238,119,54,9,25,20,65,0,5,60,67214
23256,3894,311,979,1498,850,256,197,98,82,12,0,70,16,0,0,0,0,16,12,0,4,99,79,54,14,11,20,20,20,0,0,0,0,0,0,67215
23257,14706,2951,5415,5057,1005,278,1047,574,513,55,78,380,61,51,0,40,11,10,10,0,0,473,378,48,22,308,95,4,4,0,0,91,27,10,54,67216
23258,17679,2672,6924,6270,1240,573,1392,729,598,199,74,325,131,91,34,43,14,40,22,0,18,663,561,208,71,282,102,88,39,42,7,14,0,14,0,67217
23259,14625,2168,3980,4923,2413,1141,1035,512,340,140,4,196,172,96,64,13,19,76,27,39,10,523,355,142,57,156,168,74,50,0,24,94,35,6,53,67218
23260,7220,957,2178,2736,989,360,847,424,319,33,157,129,105,35,7,28,0,70,32,0,38,423,377,199,29,149,46,21,0,21,0,25,25,0,0,67219
23261,9161,570,1523,2647,2789,1632,774,406,380,64,29,287,26,26,0,26,0,0,0,0,0,368,368,144,0,224,0,0,0,0,0,0,0,0,0,67220
23262,456,7,40,198,130,81,51,33,33,24,0,9,0,0,0,0,0,0,0,0,0,18,18,0,0,18,0,0,0,0,0,0,0,0,0,67223
23263,12229,226,1767,3763,3838,2635,892,467,457,242,11,204,10,10,10,0,0,0,0,0,0,425,373,183,18,172,52,0,0,0,0,52,0,0,52,67226
23264,149,0,101,26,22,0,0,0,0,0,0,0,0,0,0,0,0,0,0,0,0,0,0,0,0,0,0,0,0,0,0,0,0,0,0,67227
23265,1092,0,47,96,679,270,93,11,11,0,0,11,0,0,0,0,0,0,0,0,0,82,82,0,0,82,0,0,0,0,0,0,0,0,0,67228
23266,6850,73,914,1667,2637,1559,493,250,218,66,4,148,32,32,16,0,16,0,0,0,0,243,243,33,11,199,0,0,0,0,0,0,0,0,0,67230
23267,132,0,28,59,13,32,0,0,0,0,0,0,0,0,0,0,0,0,0,0,0,0,0,0,0,0,0,0,0,0,0,0,0,0,0,67232
23268,7397,314,1254,2506,2327,996,596,207,207,64,11,132,0,0,0,0,0,0,0,0,0,389,378,168,34,176,11,11,11,0,0,0,0,0,0,67235
23269,0,0,0,0,0,0,0,0,0,0,0,0,0,0,0,0,0,0,0,0,0,0,0,0,0,0,0,0,0,0,0,0,0,0,0,67260
23270,8786,849,2655,3272,1279,731,890,622,557,78,46,433,65,55,14,23,18,10,0,6,4,268,248,160,34,54,20,20,0,13,7,0,0,0,0,67301
23271,1025,22,365,402,137,99,150,78,77,14,4,59,1,1,1,0,0,0,0,0,0,72,71,42,19,10,1,0,0,0,0,1,0,0,1,67330
23272,119,1,40,54,2,22,4,4,4,2,0,2,0,0,0,0,0,0,0,0,0,0,0,0,0,0,0,0,0,0,0,0,0,0,0,67332
23273,2170,239,918,692,225,96,232,108,100,39,10,51,8,8,8,0,0,0,0,0,0,124,124,36,0,88,0,0,0,0,0,0,0,0,0,67333
23274,62,13,37,9,2,1,0,0,0,0,0,0,0,0,0,0,0,0,0,0,0,0,0,0,0,0,0,0,0,0,0,0,0,0,0,67334
23275,2335,320,739,923,224,129,103,85,74,0,17,57,11,11,3,0,8,0,0,0,0,18,9,0,0,9,9,0,0,0,0,9,4,5,0,67335
23276,1310,188,452,415,183,72,37,17,17,3,0,14,0,0,0,0,0,0,0,0,0,20,20,2,3,15,0,0,0,0,0,0,0,0,0,67336
23277,8531,1108,2910,3203,882,428,799,250,226,51,22,153,24,24,12,0,12,0,0,0,0,549,437,130,49,258,112,112,49,52,11,0,0,0,0,67337
23278,223,40,64,94,18,7,16,9,9,3,0,6,0,0,0,0,0,0,0,0,0,7,7,2,0,5,0,0,0,0,0,0,0,0,0,67340
23279,183,29,29,71,43,11,4,4,4,0,0,4,0,0,0,0,0,0,0,0,0,0,0,0,0,0,0,0,0,0,0,0,0,0,0,67341
23280,590,33,200,272,52,33,31,11,11,10,0,1,0,0,0,0,0,0,0,0,0,20,20,16,0,4,0,0,0,0,0,0,0,0,0,67342
23281,543,66,218,202,44,13,29,14,10,5,0,5,4,4,2,2,0,0,0,0,0,15,14,3,0,11,1,1,1,0,0,0,0,0,0,67344
23282,168,39,79,38,3,9,0,0,0,0,0,0,0,0,0,0,0,0,0,0,0,0,0,0,0,0,0,0,0,0,0,0,0,0,0,67345
23283,283,26,82,108,42,25,12,0,0,0,0,0,0,0,0,0,0,0,0,0,0,12,6,0,0,6,6,6,0,0,6,0,0,0,0,67346
23284,371,51,171,101,33,15,21,0,0,0,0,0,0,0,0,0,0,0,0,0,0,21,21,0,2,19,0,0,0,0,0,0,0,0,0,67347
23285,842,72,364,280,73,53,48,16,5,0,0,5,11,11,11,0,0,0,0,0,0,32,24,16,0,8,8,8,8,0,0,0,0,0,0,67349
23286,482,54,104,253,71,0,50,41,38,0,0,38,3,3,1,0,2,0,0,0,0,9,9,0,0,9,0,0,0,0,0,0,0,0,0,67351
23287,420,66,92,156,93,13,62,49,29,4,2,23,20,11,0,9,2,9,0,9,0,13,12,0,0,12,1,0,0,0,0,1,0,1,0,67352
23288,284,22,126,105,23,8,3,3,3,0,0,3,0,0,0,0,0,0,0,0,0,0,0,0,0,0,0,0,0,0,0,0,0,0,0,67353
23289,506,31,204,242,23,6,25,15,11,3,0,8,4,4,2,0,2,0,0,0,0,10,10,0,0,10,0,0,0,0,0,0,0,0,0,67354
23290,128,6,25,64,22,11,14,14,11,0,0,11,3,3,0,0,3,0,0,0,0,0,0,0,0,0,0,0,0,0,0,0,0,0,0,67355
23291,2032,248,681,753,235,115,83,58,41,2,0,39,17,17,2,0,15,0,0,0,0,25,25,7,6,12,0,0,0,0,0,0,0,0,0,67356
23292,8464,908,2397,3273,1183,703,832,388,354,77,6,271,34,29,28,0,1,5,5,0,0,444,350,195,17,138,94,88,70,7,11,6,6,0,0,67357
23293,343,86,190,50,17,0,5,0,0,0,0,0,0,0,0,0,0,0,0,0,0,5,5,5,0,0,0,0,0,0,0,0,0,0,0,67360
23294,1483,169,523,516,196,79,90,62,54,21,0,33,8,0,0,0,0,8,0,0,8,28,21,2,0,19,7,3,0,0,3,4,0,4,0,67361
23295,32,16,0,16,0,0,0,0,0,0,0,0,0,0,0,0,0,0,0,0,0,0,0,0,0,0,0,0,0,0,0,0,0,0,0,67363
23296,215,36,56,101,20,2,17,17,15,2,0,13,2,0,0,0,0,2,0,2,0,0,0,0,0,0,0,0,0,0,0,0,0,0,0,67364
23297,33365,3846,10835,10683,4983,3018,2839,1564,1379,526,163,690,185,146,107,12,27,39,26,13,0,1275,962,652,12,298,313,190,121,26,43,123,33,50,40,67401
23298,6895,651,2762,2018,957,507,463,215,181,103,0,78,34,29,29,0,0,5,5,0,0,248,202,93,0,109,46,46,46,0,0,0,0,0,0,67410
23299,917,5,395,309,120,88,40,33,33,10,0,23,0,0,0,0,0,0,0,0,0,7,7,5,0,2,0,0,0,0,0,0,0,0,0,67416
23300,122,4,60,35,15,8,1,0,0,0,0,0,0,0,0,0,0,0,0,0,0,1,1,1,0,0,0,0,0,0,0,0,0,0,0,67417
23301,130,1,38,66,20,5,14,0,0,0,0,0,0,0,0,0,0,0,0,0,0,14,14,5,9,0,0,0,0,0,0,0,0,0,0,67418
23302,3161,230,921,1173,593,244,215,118,118,22,8,88,0,0,0,0,0,0,0,0,0,97,97,39,0,58,0,0,0,0,0,0,0,0,0,67420
23303,866,26,260,369,162,49,46,29,29,0,0,29,0,0,0,0,0,0,0,0,0,17,17,2,0,15,0,0,0,0,0,0,0,0,0,67422
23304,220,22,101,74,17,6,9,7,7,0,0,7,0,0,0,0,0,0,0,0,0,2,0,0,0,0,2,2,0,0,2,0,0,0,0,67423
23305,518,35,167,177,117,22,50,34,34,6,0,28,0,0,0,0,0,0,0,0,0,16,12,4,0,8,4,2,2,0,0,2,0,0,2,67425
23306,298,17,91,114,49,27,73,39,39,27,9,3,0,0,0,0,0,0,0,0,0,34,34,21,0,13,0,0,0,0,0,0,0,0,0,67427
23307,1112,192,413,361,110,36,127,95,72,44,2,26,23,19,11,8,0,4,4,0,0,32,32,20,0,12,0,0,0,0,0,0,0,0,0,67428
23308,523,45,204,194,52,28,2,0,0,0,0,0,0,0,0,0,0,0,0,0,0,2,2,0,0,2,0,0,0,0,0,0,0,0,0,67430
23309,1864,146,630,719,247,122,137,53,40,19,3,18,13,13,0,0,13,0,0,0,0,84,71,11,0,60,13,13,13,0,0,0,0,0,0,67431
23310,4340,187,1468,1715,675,295,250,116,94,55,0,39,22,22,22,0,0,0,0,0,0,134,134,25,0,109,0,0,0,0,0,0,0,0,0,67432
23311,526,41,179,199,57,50,60,46,35,0,0,35,11,10,0,10,0,1,0,0,1,14,14,1,0,13,0,0,0,0,0,0,0,0,0,67436
23312,921,91,357,318,103,52,43,38,30,20,0,10,8,8,8,0,0,0,0,0,0,5,5,0,0,5,0,0,0,0,0,0,0,0,0,67437
23313,268,29,129,61,28,21,14,14,9,9,0,0,5,0,0,0,0,5,0,3,2,0,0,0,0,0,0,0,0,0,0,0,0,0,0,67438
23314,2618,280,982,823,360,173,145,86,68,34,0,34,18,11,0,0,11,7,0,0,7,59,56,34,0,22,3,3,3,0,0,0,0,0,0,67439
23315,691,52,280,262,70,27,60,15,12,9,0,3,3,0,0,0,0,3,3,0,0,45,45,12,6,27,0,0,0,0,0,0,0,0,0,67441
23316,173,11,82,53,27,0,0,0,0,0,0,0,0,0,0,0,0,0,0,0,0,0,0,0,0,0,0,0,0,0,0,0,0,0,0,67442
23317,1184,323,339,363,119,40,104,39,11,2,0,9,28,0,0,0,0,28,28,0,0,65,33,12,0,21,32,3,3,0,0,29,29,0,0,67443
23318,474,39,184,157,38,56,33,26,26,0,0,26,0,0,0,0,0,0,0,0,0,7,7,5,0,2,0,0,0,0,0,0,0,0,0,67444
23319,468,46,151,168,70,33,31,24,20,9,0,11,4,0,0,0,0,4,0,0,4,7,7,2,0,5,0,0,0,0,0,0,0,0,0,67445
23320,382,5,111,202,58,6,29,16,16,5,0,11,0,0,0,0,0,0,0,0,0,13,13,6,0,7,0,0,0,0,0,0,0,0,0,67446
23321,297,24,99,89,57,28,0,0,0,0,0,0,0,0,0,0,0,0,0,0,0,0,0,0,0,0,0,0,0,0,0,0,0,0,0,67447
23322,792,32,351,248,71,90,64,14,14,14,0,0,0,0,0,0,0,0,0,0,0,50,47,20,0,27,3,3,3,0,0,0,0,0,0,67448
23323,2297,189,1010,793,159,146,118,81,64,17,7,40,17,16,16,0,0,1,0,0,1,37,35,5,6,24,2,2,0,2,0,0,0,0,0,67449
23324,355,34,126,134,50,11,28,16,10,5,0,5,6,0,0,0,0,6,0,0,6,12,12,12,0,0,0,0,0,0,0,0,0,0,0,67450
23325,609,34,189,268,110,8,90,59,42,6,0,36,17,17,0,3,14,0,0,0,0,31,22,6,0,16,9,9,0,9,0,0,0,0,0,67451
23326,184,14,49,72,42,7,20,15,10,8,0,2,5,5,5,0,0,0,0,0,0,5,3,0,0,3,2,2,2,0,0,0,0,0,0,67452
23327,402,53,144,139,53,13,13,12,10,7,0,3,2,2,2,0,0,0,0,0,0,1,1,1,0,0,0,0,0,0,0,0,0,0,0,67454
23328,1395,119,444,571,195,66,68,35,35,0,0,35,0,0,0,0,0,0,0,0,0,33,26,6,2,18,7,7,7,0,0,0,0,0,0,67455
23329,3130,198,881,983,643,425,332,140,140,21,0,119,0,0,0,0,0,0,0,0,0,192,182,58,7,117,10,10,10,0,0,0,0,0,0,67456
23330,533,29,164,203,108,29,61,41,41,27,0,14,0,0,0,0,0,0,0,0,0,20,20,10,0,10,0,0,0,0,0,0,0,0,0,67457
23331,250,21,77,100,52,0,15,9,9,0,0,9,0,0,0,0,0,0,0,0,0,6,6,6,0,0,0,0,0,0,0,0,0,0,0,67458
23332,141,15,22,66,36,2,0,0,0,0,0,0,0,0,0,0,0,0,0,0,0,0,0,0,0,0,0,0,0,0,0,0,0,0,0,67459
23333,10497,812,3034,3723,2017,911,861,467,383,122,0,261,84,84,73,11,0,0,0,0,0,394,394,210,0,184,0,0,0,0,0,0,0,0,0,67460
23334,745,60,265,248,149,23,55,18,15,5,7,3,3,3,0,3,0,0,0,0,0,37,37,12,0,25,0,0,0,0,0,0,0,0,0,67464
23335,582,65,199,272,37,9,35,6,4,4,0,0,2,2,2,0,0,0,0,0,0,29,29,14,8,7,0,0,0,0,0,0,0,0,0,67466
23336,1973,193,599,785,290,106,114,66,56,20,3,33,10,10,10,0,0,0,0,0,0,48,48,8,0,40,0,0,0,0,0,0,0,0,0,67467
23337,128,5,68,45,8,2,1,1,1,0,0,1,0,0,0,0,0,0,0,0,0,0,0,0,0,0,0,0,0,0,0,0,0,0,0,67468
23338,377,28,131,152,29,37,2,2,2,2,0,0,0,0,0,0,0,0,0,0,0,0,0,0,0,0,0,0,0,0,0,0,0,0,0,67470
23339,1215,146,457,399,153,60,72,51,48,19,8,21,3,3,3,0,0,0,0,0,0,21,21,15,0,6,0,0,0,0,0,0,0,0,0,67473
23340,154,14,46,67,21,6,26,12,12,2,0,10,0,0,0,0,0,0,0,0,0,14,12,0,0,12,2,2,0,0,2,0,0,0,0,67474
23341,168,25,71,52,14,6,23,20,3,3,0,0,17,17,17,0,0,0,0,0,0,3,3,0,0,3,0,0,0,0,0,0,0,0,0,67475
23342,40,2,20,16,2,0,1,1,1,0,0,1,0,0,0,0,0,0,0,0,0,0,0,0,0,0,0,0,0,0,0,0,0,0,0,67478
23343,1186,147,415,427,135,62,106,35,35,6,0,29,0,0,0,0,0,0,0,0,0,71,48,31,0,17,23,17,14,3,0,6,0,0,6,67480
23344,447,31,141,177,56,42,15,8,8,1,0,7,0,0,0,0,0,0,0,0,0,7,7,0,0,7,0,0,0,0,0,0,0,0,0,67481
23345,57,0,9,48,0,0,0,0,0,0,0,0,0,0,0,0,0,0,0,0,0,0,0,0,0,0,0,0,0,0,0,0,0,0,0,67482
23346,214,65,64,59,21,5,14,8,8,3,0,5,0,0,0,0,0,0,0,0,0,6,6,1,0,5,0,0,0,0,0,0,0,0,0,67483
23347,587,28,225,202,99,33,66,25,22,8,1,13,3,2,0,2,0,1,0,0,1,41,37,21,2,14,4,4,0,0,4,0,0,0,0,67484
23348,270,5,96,95,69,5,13,13,13,0,0,13,0,0,0,0,0,0,0,0,0,0,0,0,0,0,0,0,0,0,0,0,0,0,0,67485
23349,896,42,374,325,137,18,80,43,40,0,2,38,3,3,0,0,3,0,0,0,0,37,37,11,4,22,0,0,0,0,0,0,0,0,0,67487
23350,763,84,279,232,117,51,50,10,10,6,0,4,0,0,0,0,0,0,0,0,0,40,37,23,0,14,3,0,0,0,0,3,3,0,0,67490
23351,311,57,87,91,53,23,25,21,21,5,0,16,0,0,0,0,0,0,0,0,0,4,2,2,0,0,2,2,0,0,2,0,0,0,0,67491
23352,93,12,31,34,13,3,14,6,0,0,0,0,6,0,0,0,0,6,6,0,0,8,8,0,0,8,0,0,0,0,0,0,0,0,0,67492
23353,16951,2878,5747,6716,1365,245,1607,899,773,185,78,510,126,101,28,9,64,25,13,0,12,708,624,274,11,339,84,84,73,0,11,0,0,0,0,67501
23354,17234,1007,3822,7050,3356,1999,1114,655,605,180,52,373,50,41,31,0,10,9,0,9,0,459,414,228,13,173,45,16,16,0,0,29,0,0,29,67502
23355,1669,255,686,571,110,47,112,66,59,25,19,15,7,7,0,7,0,0,0,0,0,46,46,32,0,14,0,0,0,0,0,0,0,0,0,67505
23356,218,25,83,84,26,0,19,17,16,0,0,16,1,1,1,0,0,0,0,0,0,2,2,0,0,2,0,0,0,0,0,0,0,0,0,67510
23357,294,11,110,112,45,16,3,1,1,0,0,1,0,0,0,0,0,0,0,0,0,2,2,0,1,1,0,0,0,0,0,0,0,0,0,67511
23358,153,19,52,40,37,5,15,13,1,0,1,0,12,12,12,0,0,0,0,0,0,2,2,0,0,2,0,0,0,0,0,0,0,0,0,67512
23359,44,1,16,15,7,5,0,0,0,0,0,0,0,0,0,0,0,0,0,0,0,0,0,0,0,0,0,0,0,0,0,0,0,0,0,67513
23360,509,55,192,177,51,34,23,11,7,3,0,4,4,4,4,0,0,0,0,0,0,12,12,0,2,10,0,0,0,0,0,0,0,0,0,67514
23361,54,5,16,5,24,4,0,0,0,0,0,0,0,0,0,0,0,0,0,0,0,0,0,0,0,0,0,0,0,0,0,0,0,0,0,67515
23362,327,56,130,98,23,20,71,46,44,0,0,44,2,1,0,1,0,1,0,1,0,25,25,25,0,0,0,0,0,0,0,0,0,0,0,67516
23363,15,0,0,11,4,0,0,0,0,0,0,0,0,0,0,0,0,0,0,0,0,0,0,0,0,0,0,0,0,0,0,0,0,0,0,67518
23364,126,35,21,43,24,3,1,1,0,0,0,0,1,1,0,1,0,0,0,0,0,0,0,0,0,0,0,0,0,0,0,0,0,0,0,67519
23365,251,15,75,67,58,36,14,3,3,3,0,0,0,0,0,0,0,0,0,0,0,11,11,8,0,3,0,0,0,0,0,0,0,0,0,67520
23366,107,7,26,64,4,6,0,0,0,0,0,0,0,0,0,0,0,0,0,0,0,0,0,0,0,0,0,0,0,0,0,0,0,0,0,67521
23367,1418,85,366,550,276,141,118,46,46,20,0,26,0,0,0,0,0,0,0,0,0,72,58,18,0,40,14,14,14,0,0,0,0,0,0,67522
23368,249,12,62,103,53,19,32,16,6,0,0,6,10,10,0,10,0,0,0,0,0,16,15,0,4,11,1,1,1,0,0,0,0,0,0,67523
23369,404,86,142,117,44,15,39,21,18,9,0,9,3,0,0,0,0,3,0,3,0,18,18,9,0,9,0,0,0,0,0,0,0,0,0,67524
23370,816,66,239,314,125,72,78,40,40,4,0,36,0,0,0,0,0,0,0,0,0,38,38,7,3,28,0,0,0,0,0,0,0,0,0,67525
23371,1945,190,674,817,206,58,138,71,71,36,0,35,0,0,0,0,0,0,0,0,0,67,62,38,8,16,5,0,0,0,0,5,0,5,0,67526
23372,231,43,92,72,10,14,6,0,0,0,0,0,0,0,0,0,0,0,0,0,0,6,5,2,0,3,1,0,0,0,0,1,1,0,0,67529
23373,12888,2006,4036,4459,1672,715,1255,651,524,260,19,245,127,73,36,24,13,54,50,1,3,604,468,179,56,233,136,114,73,0,41,22,22,0,0,67530
23374,1280,155,414,466,195,50,76,51,48,28,0,20,3,3,3,0,0,0,0,0,0,25,7,0,0,7,18,18,10,8,0,0,0,0,0,67543
23375,2108,251,721,707,296,133,183,95,95,33,0,62,0,0,0,0,0,0,0,0,0,88,87,22,15,50,1,0,0,0,0,1,0,0,1,67544
23376,174,10,62,69,23,10,19,0,0,0,0,0,0,0,0,0,0,0,0,0,0,19,19,2,0,17,0,0,0,0,0,0,0,0,0,67545
23377,1807,336,545,603,244,79,125,66,61,16,6,39,5,0,0,0,0,5,0,0,5,59,54,37,0,17,5,5,5,0,0,0,0,0,0,67546
23378,1207,181,447,359,134,86,67,52,39,4,12,23,13,11,1,10,0,2,0,0,2,15,15,0,5,10,0,0,0,0,0,0,0,0,0,67547
23379,1159,128,385,427,132,87,67,39,21,11,0,10,18,0,0,0,0,18,12,6,0,28,6,1,0,5,22,0,0,0,0,22,0,5,17,67548
23380,4243,426,1264,1542,599,412,435,378,375,144,14,217,3,3,0,0,3,0,0,0,0,57,57,26,0,31,0,0,0,0,0,0,0,0,0,67550
23381,523,59,150,194,101,19,27,21,21,5,0,16,0,0,0,0,0,0,0,0,0,6,6,2,0,4,0,0,0,0,0,0,0,0,0,67552
23382,109,13,39,44,11,2,18,16,16,0,16,0,0,0,0,0,0,0,0,0,0,2,2,2,0,0,0,0,0,0,0,0,0,0,0,67553
23383,2887,381,1009,1087,259,151,169,78,69,19,0,50,9,9,0,0,9,0,0,0,0,91,67,15,15,37,24,24,24,0,0,0,0,0,0,67554
23384,264,19,119,97,24,5,18,12,10,10,0,0,2,0,0,0,0,2,2,0,0,6,3,3,0,0,3,0,0,0,0,3,3,0,0,67556
23385,390,59,111,122,76,22,58,24,21,6,0,15,3,3,1,2,0,0,0,0,0,34,27,17,0,10,7,1,1,0,0,6,6,0,0,67557
23386,52,7,36,9,0,0,0,0,0,0,0,0,0,0,0,0,0,0,0,0,0,0,0,0,0,0,0,0,0,0,0,0,0,0,0,67559
23387,1307,89,516,443,188,71,50,36,31,21,0,10,5,2,0,0,2,3,3,0,0,14,14,9,5,0,0,0,0,0,0,0,0,0,0,67560
23388,992,103,412,344,80,53,90,43,35,0,16,19,8,8,0,8,0,0,0,0,0,47,42,23,0,19,5,5,5,0,0,0,0,0,0,67561
23389,341,17,96,112,82,34,15,10,8,3,0,5,2,2,0,0,2,0,0,0,0,5,5,0,2,3,0,0,0,0,0,0,0,0,0,67563
23390,173,27,72,40,32,2,13,8,8,2,4,2,0,0,0,0,0,0,0,0,0,5,2,0,0,2,3,0,0,0,0,3,0,0,3,67564
23391,265,24,92,107,32,10,14,4,4,0,0,4,0,0,0,0,0,0,0,0,0,10,6,3,0,3,4,4,0,0,4,0,0,0,0,67565
23392,507,86,151,200,52,18,34,20,20,8,0,12,0,0,0,0,0,0,0,0,0,14,14,6,0,8,0,0,0,0,0,0,0,0,0,67566
23393,300,12,122,119,41,6,29,15,13,6,0,7,2,2,2,0,0,0,0,0,0,14,14,4,2,8,0,0,0,0,0,0,0,0,0,67567
23394,226,9,47,115,40,15,38,17,17,17,0,0,0,0,0,0,0,0,0,0,0,21,21,16,0,5,0,0,0,0,0,0,0,0,0,67568
23395,1041,83,239,496,184,39,108,56,47,19,0,28,9,9,6,3,0,0,0,0,0,52,36,13,0,23,16,14,4,0,10,2,2,0,0,67570
23396,353,41,132,123,36,21,15,8,8,2,0,6,0,0,0,0,0,0,0,0,0,7,7,6,0,1,0,0,0,0,0,0,0,0,0,67572
23397,111,11,38,46,11,5,0,0,0,0,0,0,0,0,0,0,0,0,0,0,0,0,0,0,0,0,0,0,0,0,0,0,0,0,0,67573
23398,227,18,94,86,17,12,10,10,10,0,0,10,0,0,0,0,0,0,0,0,0,0,0,0,0,0,0,0,0,0,0,0,0,0,0,67574
23399,251,20,73,123,21,14,26,22,22,11,0,11,0,0,0,0,0,0,0,0,0,4,4,0,0,4,0,0,0,0,0,0,0,0,0,67575
23400,1214,157,355,498,142,62,90,42,22,0,0,22,20,14,14,0,0,6,5,0,1,48,30,3,0,27,18,8,4,0,4,10,0,0,10,67576
23401,1155,129,387,413,179,47,56,36,34,12,0,22,2,0,0,0,0,2,2,0,0,20,20,20,0,0,0,0,0,0,0,0,0,0,0,67578
23402,1906,79,614,587,409,217,284,153,153,61,0,92,0,0,0,0,0,0,0,0,0,131,131,54,6,71,0,0,0,0,0,0,0,0,0,67579
23403,218,35,66,89,14,14,7,3,3,0,0,3,0,0,0,0,0,0,0,0,0,4,4,2,0,2,0,0,0,0,0,0,0,0,0,67581
23404,493,64,176,192,48,13,29,8,5,0,2,3,3,3,0,2,1,0,0,0,0,21,14,0,0,14,7,4,2,0,2,3,3,0,0,67583
23405,236,13,90,81,50,2,22,6,6,2,0,4,0,0,0,0,0,0,0,0,0,16,16,2,0,14,0,0,0,0,0,0,0,0,0,67584
23406,14159,984,3749,4642,3076,1708,1622,818,702,352,39,311,116,108,93,15,0,8,8,0,0,804,717,381,115,221,87,86,54,31,1,1,0,0,1,67601
23407,292,17,92,135,40,8,11,9,9,3,0,6,0,0,0,0,0,0,0,0,0,2,2,0,0,2,0,0,0,0,0,0,0,0,0,67621
23408,512,35,201,203,64,9,26,18,18,16,0,2,0,0,0,0,0,0,0,0,0,8,6,2,0,4,2,2,2,0,0,0,0,0,0,67622
23409,166,24,49,48,43,2,8,3,3,3,0,0,0,0,0,0,0,0,0,0,0,5,5,5,0,0,0,0,0,0,0,0,0,0,0,67623
23410,193,33,38,56,54,12,13,7,4,0,0,4,3,3,3,0,0,0,0,0,0,6,2,0,0,2,4,4,4,0,0,0,0,0,0,67625
23411,113,14,68,25,4,2,0,0,0,0,0,0,0,0,0,0,0,0,0,0,0,0,0,0,0,0,0,0,0,0,0,0,0,0,0,67626
23412,39,9,17,7,6,0,0,0,0,0,0,0,0,0,0,0,0,0,0,0,0,0,0,0,0,0,0,0,0,0,0,0,0,0,0,67628
23413,121,43,34,19,19,6,4,1,1,0,0,1,0,0,0,0,0,0,0,0,0,3,0,0,0,0,3,3,0,0,3,0,0,0,0,67629
23414,195,4,100,40,49,2,3,2,2,2,0,0,0,0,0,0,0,0,0,0,0,1,1,1,0,0,0,0,0,0,0,0,0,0,0,67631
23415,197,13,53,82,41,8,30,24,24,7,4,13,0,0,0,0,0,0,0,0,0,6,6,0,0,6,0,0,0,0,0,0,0,0,0,67632
23416,191,2,64,94,20,11,1,0,0,0,0,0,0,0,0,0,0,0,0,0,0,1,1,1,0,0,0,0,0,0,0,0,0,0,0,67634
23417,102,6,50,20,22,4,0,0,0,0,0,0,0,0,0,0,0,0,0,0,0,0,0,0,0,0,0,0,0,0,0,0,0,0,0,67635
23418,1688,192,582,521,269,124,150,88,88,41,8,39,0,0,0,0,0,0,0,0,0,62,59,45,11,3,3,3,3,0,0,0,0,0,0,67637
23419,245,42,113,81,6,3,18,11,11,0,0,11,0,0,0,0,0,0,0,0,0,7,7,7,0,0,0,0,0,0,0,0,0,0,0,67638
23420,117,7,30,53,27,0,13,0,0,0,0,0,0,0,0,0,0,0,0,0,0,13,13,3,10,0,0,0,0,0,0,0,0,0,0,67639
23421,390,23,139,154,58,16,23,17,0,0,0,0,17,17,17,0,0,0,0,0,0,6,6,6,0,0,0,0,0,0,0,0,0,0,0,67640
23422,1298,75,443,498,221,61,72,50,45,9,0,36,5,0,0,0,0,5,5,0,0,22,22,15,0,7,0,0,0,0,0,0,0,0,0,67642
23423,137,9,50,35,28,15,2,0,0,0,0,0,0,0,0,0,0,0,0,0,0,2,2,0,0,2,0,0,0,0,0,0,0,0,0,67643
23424,159,22,74,34,15,14,9,5,5,5,0,0,0,0,0,0,0,0,0,0,0,4,4,4,0,0,0,0,0,0,0,0,0,0,0,67644
23425,420,38,142,187,45,8,8,6,3,3,0,0,3,3,3,0,0,0,0,0,0,2,2,0,0,2,0,0,0,0,0,0,0,0,0,67645
23426,482,40,185,171,56,30,13,8,8,0,0,8,0,0,0,0,0,0,0,0,0,5,5,4,0,1,0,0,0,0,0,0,0,0,0,67646
23427,187,12,58,81,35,1,12,3,3,0,0,3,0,0,0,0,0,0,0,0,0,9,9,5,0,4,0,0,0,0,0,0,0,0,0,67647
23428,446,33,151,163,81,18,20,7,7,3,0,4,0,0,0,0,0,0,0,0,0,13,9,6,0,3,4,4,4,0,0,0,0,0,0,67648
23429,281,24,89,64,81,23,2,2,2,0,0,2,0,0,0,0,0,0,0,0,0,0,0,0,0,0,0,0,0,0,0,0,0,0,0,67649
23430,177,0,60,85,30,2,15,8,8,8,0,0,0,0,0,0,0,0,0,0,0,7,7,5,0,2,0,0,0,0,0,0,0,0,0,67650
23431,356,38,134,124,50,10,15,7,7,2,0,5,0,0,0,0,0,0,0,0,0,8,8,2,0,6,0,0,0,0,0,0,0,0,0,67651
23432,260,9,129,100,22,0,8,3,3,3,0,0,0,0,0,0,0,0,0,0,0,5,5,2,3,0,0,0,0,0,0,0,0,0,0,67653
23433,3153,412,1057,1172,415,97,93,20,20,0,20,0,0,0,0,0,0,0,0,0,0,73,62,21,0,41,11,11,11,0,0,0,0,0,0,67654
23434,40,0,20,20,0,0,0,0,0,0,0,0,0,0,0,0,0,0,0,0,0,0,0,0,0,0,0,0,0,0,0,0,0,0,0,67656
23435,234,15,100,71,42,6,32,18,16,5,0,11,2,2,0,2,0,0,0,0,0,14,2,1,0,1,12,8,8,0,0,4,0,0,4,67657
23436,76,0,21,37,13,5,4,3,3,0,0,3,0,0,0,0,0,0,0,0,0,1,1,0,0,1,0,0,0,0,0,0,0,0,0,67658
23437,120,6,67,26,0,21,27,7,7,7,0,0,0,0,0,0,0,0,0,0,0,20,20,20,0,0,0,0,0,0,0,0,0,0,0,67659
23438,78,5,35,16,10,12,0,0,0,0,0,0,0,0,0,0,0,0,0,0,0,0,0,0,0,0,0,0,0,0,0,0,0,0,0,67660
23439,2337,200,863,905,273,96,168,94,94,31,0,63,0,0,0,0,0,0,0,0,0,74,74,32,18,24,0,0,0,0,0,0,0,0,0,67661
23440,1812,142,697,646,190,137,95,38,38,33,0,5,0,0,0,0,0,0,0,0,0,57,53,30,0,23,4,4,4,0,0,0,0,0,0,67663
23441,281,19,102,60,82,18,6,4,3,0,0,3,1,1,0,1,0,0,0,0,0,2,2,0,0,2,0,0,0,0,0,0,0,0,0,67664
23442,3639,395,1245,1195,440,364,283,149,110,37,0,73,39,39,32,0,7,0,0,0,0,134,104,83,4,17,30,30,30,0,0,0,0,0,0,67665
23443,154,12,60,47,26,9,5,5,5,5,0,0,0,0,0,0,0,0,0,0,0,0,0,0,0,0,0,0,0,0,0,0,0,0,0,67667
23444,1246,92,423,396,246,89,68,36,21,8,0,13,15,12,4,8,0,3,0,0,3,32,18,10,0,8,14,3,3,0,0,11,7,0,4,67669
23445,1118,77,422,332,216,71,66,34,27,7,0,20,7,7,7,0,0,0,0,0,0,32,30,17,0,13,2,2,2,0,0,0,0,0,0,67671
23446,1801,193,574,635,293,106,120,28,28,12,0,16,0,0,0,0,0,0,0,0,0,92,90,42,0,48,2,2,2,0,0,0,0,0,0,67672
23447,93,6,36,47,4,0,5,3,3,3,0,0,0,0,0,0,0,0,0,0,0,2,0,0,0,0,2,2,2,0,0,0,0,0,0,67673
23448,44,0,27,3,14,0,17,0,0,0,0,0,0,0,0,0,0,0,0,0,0,17,17,17,0,0,0,0,0,0,0,0,0,0,0,67674
23449,209,52,77,55,19,6,23,8,2,0,2,0,6,0,0,0,0,6,6,0,0,15,11,0,0,11,4,0,0,0,0,4,0,0,4,67675
23450,4077,367,987,1573,650,500,518,151,139,42,14,83,12,12,0,0,12,0,0,0,0,367,367,238,9,120,0,0,0,0,0,0,0,0,0,67701
23451,1162,73,336,435,241,77,78,36,36,26,0,10,0,0,0,0,0,0,0,0,0,42,35,21,0,14,7,7,0,0,7,0,0,0,0,67730
23452,495,64,126,210,90,5,62,15,15,5,0,10,0,0,0,0,0,0,0,0,0,47,23,18,0,5,24,24,24,0,0,0,0,0,0,67731
23453,334,17,90,109,94,24,19,12,12,1,0,11,0,0,0,0,0,0,0,0,0,7,7,4,0,3,0,0,0,0,0,0,0,0,0,67732
23454,125,28,29,52,4,12,21,21,21,0,0,21,0,0,0,0,0,0,0,0,0,0,0,0,0,0,0,0,0,0,0,0,0,0,0,67733
23455,146,4,51,75,12,4,2,0,0,0,0,0,0,0,0,0,0,0,0,0,0,2,2,0,0,2,0,0,0,0,0,0,0,0,0,67734
23456,3910,413,1317,1569,437,174,214,194,194,123,10,61,0,0,0,0,0,0,0,0,0,20,20,11,5,4,0,0,0,0,0,0,0,0,0,67735
23457,213,5,83,77,46,2,13,9,9,0,0,9,0,0,0,0,0,0,0,0,0,4,4,0,0,4,0,0,0,0,0,0,0,0,0,67736
23458,355,32,140,119,57,7,18,6,5,2,0,3,1,1,1,0,0,0,0,0,0,12,12,5,0,7,0,0,0,0,0,0,0,0,0,67737
23459,417,22,145,127,110,13,25,4,4,2,0,2,0,0,0,0,0,0,0,0,0,21,18,5,0,13,3,3,0,0,3,0,0,0,0,67738
23460,231,37,65,88,40,1,17,10,10,3,0,7,0,0,0,0,0,0,0,0,0,7,7,7,0,0,0,0,0,0,0,0,0,0,0,67739
23461,1257,117,404,442,201,93,69,38,29,5,10,14,9,9,9,0,0,0,0,0,0,31,16,9,0,7,15,11,0,0,11,4,0,0,4,67740
23462,158,32,55,57,10,4,0,0,0,0,0,0,0,0,0,0,0,0,0,0,0,0,0,0,0,0,0,0,0,0,0,0,0,0,0,67741
23463,81,16,27,23,7,8,0,0,0,0,0,0,0,0,0,0,0,0,0,0,0,0,0,0,0,0,0,0,0,0,0,0,0,0,0,67743
23464,205,11,70,103,13,8,8,0,0,0,0,0,0,0,0,0,0,0,0,0,0,8,8,0,0,8,0,0,0,0,0,0,0,0,0,67744
23465,264,29,100,83,40,12,7,5,5,1,1,3,0,0,0,0,0,0,0,0,0,2,2,1,0,1,0,0,0,0,0,0,0,0,0,67745
23466,109,26,31,42,10,0,0,0,0,0,0,0,0,0,0,0,0,0,0,0,0,0,0,0,0,0,0,0,0,0,0,0,0,0,0,67747
23467,1696,96,584,688,264,64,124,65,65,50,0,15,0,0,0,0,0,0,0,0,0,59,55,36,2,17,4,0,0,0,0,4,0,0,4,67748
23468,1788,196,631,566,313,82,85,24,24,1,1,22,0,0,0,0,0,0,0,0,0,61,51,16,0,35,10,1,1,0,0,9,9,0,0,67749
23469,151,22,73,41,14,1,3,0,0,0,0,0,0,0,0,0,0,0,0,0,0,3,3,1,0,2,0,0,0,0,0,0,0,0,0,67751
23470,1008,70,372,345,167,54,47,20,19,3,0,16,1,1,0,0,1,0,0,0,0,27,24,16,0,8,3,3,3,0,0,0,0,0,0,67752
23471,303,27,105,121,41,9,34,33,33,30,1,2,0,0,0,0,0,0,0,0,0,1,1,0,0,1,0,0,0,0,0,0,0,0,0,67753
23472,1541,158,510,533,225,115,48,33,33,17,0,16,0,0,0,0,0,0,0,0,0,15,15,10,0,5,0,0,0,0,0,0,0,0,0,67756
23473,347,38,98,182,21,8,9,6,2,2,0,0,4,4,0,4,0,0,0,0,0,3,3,3,0,0,0,0,0,0,0,0,0,0,0,67757
23474,720,83,215,249,144,29,45,28,28,10,0,18,0,0,0,0,0,0,0,0,0,17,14,14,0,0,3,3,3,0,0,0,0,0,0,67758
23475,155,6,53,68,19,9,22,18,18,9,0,9,0,0,0,0,0,0,0,0,0,4,2,2,0,0,2,2,2,0,0,0,0,0,0,67761
23476,251,47,88,64,49,3,23,15,15,2,0,13,0,0,0,0,0,0,0,0,0,8,8,3,0,5,0,0,0,0,0,0,0,0,0,67762
23477,291,55,110,88,34,4,19,12,12,4,0,8,0,0,0,0,0,0,0,0,0,7,7,2,0,5,0,0,0,0,0,0,0,0,0,67764
23478,17347,5781,3895,4878,1944,849,2016,1083,966,316,46,604,117,71,71,0,0,46,43,3,0,933,690,338,17,335,243,221,107,44,70,22,0,22,0,67801
23479,854,69,206,329,196,54,42,11,11,4,0,7,0,0,0,0,0,0,0,0,0,31,31,26,0,5,0,0,0,0,0,0,0,0,0,67831
23480,784,71,235,321,125,32,42,11,10,2,3,5,1,1,1,0,0,0,0,0,0,31,31,6,9,16,0,0,0,0,0,0,0,0,0,67834
23481,1795,289,584,560,292,70,195,48,48,28,0,20,0,0,0,0,0,0,0,0,0,147,106,44,5,57,41,7,0,7,0,34,10,3,21,67835
23482,82,14,34,20,14,0,0,0,0,0,0,0,0,0,0,0,0,0,0,0,0,0,0,0,0,0,0,0,0,0,0,0,0,0,0,67836
23483,541,173,128,155,66,19,64,32,20,8,0,12,12,2,0,0,2,10,10,0,0,32,8,5,0,3,24,3,0,0,3,21,21,0,0,67837
23484,607,148,188,201,54,16,100,54,44,12,14,18,10,10,6,0,4,0,0,0,0,46,42,19,0,23,4,4,2,0,2,0,0,0,0,67838
23485,907,69,311,334,159,34,56,37,37,13,0,24,0,0,0,0,0,0,0,0,0,19,19,13,0,6,0,0,0,0,0,0,0,0,0,67839
23486,37,1,15,21,0,0,0,0,0,0,0,0,0,0,0,0,0,0,0,0,0,0,0,0,0,0,0,0,0,0,0,0,0,0,0,67840
23487,279,66,83,58,63,9,25,25,25,4,0,21,0,0,0,0,0,0,0,0,0,0,0,0,0,0,0,0,0,0,0,0,0,0,0,67841
23488,365,57,130,96,55,27,45,2,0,0,0,0,2,2,2,0,0,0,0,0,0,43,43,11,0,32,0,0,0,0,0,0,0,0,0,67842
23489,181,17,76,86,2,0,8,8,8,0,0,8,0,0,0,0,0,0,0,0,0,0,0,0,0,0,0,0,0,0,0,0,0,0,0,67843
23490,502,44,184,159,93,22,47,30,30,12,5,13,0,0,0,0,0,0,0,0,0,17,17,3,0,14,0,0,0,0,0,0,0,0,0,67844
23491,19590,6022,4832,5237,2276,1223,2114,1209,947,439,48,460,262,107,70,30,7,155,91,35,29,905,742,245,30,467,163,102,80,22,0,61,19,0,42,67846
23492,327,37,82,125,67,16,18,13,13,11,0,2,0,0,0,0,0,0,0,0,0,5,5,0,0,5,0,0,0,0,0,0,0,0,0,67849
23493,255,36,70,77,43,29,13,6,2,0,0,2,4,4,4,0,0,0,0,0,0,7,7,1,0,6,0,0,0,0,0,0,0,0,0,67850
23494,1319,196,345,490,160,128,229,107,90,43,2,45,17,17,14,0,3,0,0,0,0,122,105,66,4,35,17,17,14,3,0,0,0,0,0,67851
23495,675,115,165,209,142,44,44,17,17,12,0,5,0,0,0,0,0,0,0,0,0,27,22,7,0,15,5,5,5,0,0,0,0,0,0,67853
23496,972,89,291,372,154,66,77,43,40,10,0,30,3,0,0,0,0,3,0,0,3,34,34,9,0,25,0,0,0,0,0,0,0,0,0,67854
23497,1159,277,289,360,175,58,113,68,63,42,10,11,5,5,0,0,5,0,0,0,0,45,42,4,0,38,3,0,0,0,0,3,3,0,0,67855
23498,72,15,28,23,6,0,22,17,17,17,0,0,0,0,0,0,0,0,0,0,0,5,5,5,0,0,0,0,0,0,0,0,0,0,0,67857
23499,383,130,111,112,26,4,63,43,32,0,2,30,11,0,0,0,0,11,0,0,11,20,18,13,0,5,2,2,0,0,2,0,0,0,0,67859
23500,1830,374,414,682,260,100,143,113,94,51,0,43,19,0,0,0,0,19,19,0,0,30,30,5,0,25,0,0,0,0,0,0,0,0,0,67860
23501,1227,293,355,369,166,44,113,72,48,6,10,32,24,17,5,12,0,7,7,0,0,41,35,18,0,17,6,0,0,0,0,6,0,6,0,67861
23502,193,34,60,78,11,10,17,13,11,0,0,11,2,0,0,0,0,2,2,0,0,4,4,0,0,4,0,0,0,0,0,0,0,0,0,67862
23503,257,34,33,161,29,0,4,4,4,0,0,4,0,0,0,0,0,0,0,0,0,0,0,0,0,0,0,0,0,0,0,0,0,0,0,67863
23504,1453,148,417,488,293,107,128,64,54,40,0,14,10,0,0,0,0,10,3,0,7,64,64,27,14,23,0,0,0,0,0,0,0,0,0,67864
23505,663,52,207,279,87,38,46,19,19,5,0,14,0,0,0,0,0,0,0,0,0,27,27,8,3,16,0,0,0,0,0,0,0,0,0,67865
23506,1049,331,319,240,140,19,74,47,27,12,5,10,20,3,3,0,0,17,15,0,2,27,15,11,0,4,12,0,0,0,0,12,12,0,0,67867
23507,148,25,38,73,0,12,10,0,0,0,0,0,0,0,0,0,0,0,0,0,0,10,0,0,0,0,10,0,0,0,0,10,10,0,0,67868
23508,958,220,328,223,115,72,100,49,36,21,0,15,13,5,2,3,0,8,3,0,5,51,45,9,4,32,6,6,6,0,0,0,0,0,0,67869
23509,1124,303,331,359,83,48,95,60,39,20,5,14,21,7,7,0,0,14,14,0,0,35,25,4,4,17,10,10,10,0,0,0,0,0,0,67870
23510,3539,479,1167,1070,702,121,112,56,47,19,9,19,9,0,0,0,0,9,9,0,0,56,56,0,0,56,0,0,0,0,0,0,0,0,0,67871
23511,770,50,229,314,133,44,48,30,22,2,6,14,8,7,1,0,6,1,1,0,0,18,18,5,0,13,0,0,0,0,0,0,0,0,0,67876
23512,1320,308,359,358,183,112,160,87,87,21,5,61,0,0,0,0,0,0,0,0,0,73,69,29,0,40,4,0,0,0,0,4,0,0,4,67877
23513,1620,292,538,586,156,48,117,58,34,34,0,0,24,24,23,0,1,0,0,0,0,59,43,10,0,33,16,16,16,0,0,0,0,0,0,67878
23514,889,74,285,335,143,52,85,40,40,24,0,16,0,0,0,0,0,0,0,0,0,45,26,15,0,11,19,15,15,0,0,4,4,0,0,67879
23515,4841,1149,1430,1413,666,183,319,146,100,50,0,50,46,37,35,0,2,9,0,7,2,173,160,26,101,33,13,10,5,5,0,3,3,0,0,67880
23516,265,40,39,119,58,9,24,14,14,0,0,14,0,0,0,0,0,0,0,0,0,10,10,3,0,7,0,0,0,0,0,0,0,0,0,67882
23517,12579,4681,3095,3206,955,642,1563,791,478,162,28,288,313,183,144,22,17,130,126,0,4,772,681,316,65,300,91,77,53,0,24,14,0,0,14,67901
23518,1665,267,572,537,225,64,129,58,43,21,0,22,15,14,0,0,14,1,0,0,1,71,32,21,0,11,39,39,11,0,28,0,0,0,0,67950
23519,3064,556,1057,896,423,132,245,84,76,34,19,23,8,8,0,0,8,0,0,0,0,161,121,17,8,96,40,0,0,0,0,40,37,0,3,67951
23520,465,121,127,153,52,12,34,22,12,10,0,2,10,10,10,0,0,0,0,0,0,12,12,4,0,8,0,0,0,0,0,0,0,0,0,67952
23521,121,8,34,59,20,0,23,0,0,0,0,0,0,0,0,0,0,0,0,0,0,23,23,0,0,23,0,0,0,0,0,0,0,0,0,67953
23522,373,63,98,141,58,13,43,34,34,15,0,19,0,0,0,0,0,0,0,0,0,9,9,0,0,9,0,0,0,0,0,0,0,0,0,67954
23523,65,0,28,21,6,10,2,0,0,0,0,0,0,0,0,0,0,0,0,0,0,2,2,0,0,2,0,0,0,0,0,0,0,0,0,68001
23524,1247,51,456,384,243,113,148,79,46,6,0,40,33,33,33,0,0,0,0,0,0,69,63,15,0,48,6,6,6,0,0,0,0,0,0,68002
23525,3024,122,949,971,670,312,193,91,62,36,0,26,29,29,18,11,0,0,0,0,0,102,87,37,0,50,15,15,15,0,0,0,0,0,0,68003
23526,583,47,266,193,61,16,35,14,14,3,0,11,0,0,0,0,0,0,0,0,0,21,16,1,0,15,5,5,5,0,0,0,0,0,0,68004
23527,15620,1209,4258,5976,2881,1296,1276,733,586,139,103,344,147,147,116,31,0,0,0,0,0,543,463,115,32,316,80,55,41,14,0,25,0,0,25,68005
23528,4975,77,813,1375,1941,769,374,139,139,77,11,51,0,0,0,0,0,0,0,0,0,235,188,134,2,52,47,47,47,0,0,0,0,0,0,68007
23529,8144,392,2677,2512,2030,533,734,341,285,131,10,144,56,56,38,18,0,0,0,0,0,393,377,161,0,216,16,0,0,0,0,16,0,0,16,68008
23530,107,0,13,66,26,2,422,206,187,3,0,184,19,19,0,0,19,0,0,0,0,216,190,1,2,187,26,26,0,0,26,0,0,0,0,68010
23531,228,27,104,62,11,24,13,3,3,0,0,3,0,0,0,0,0,0,0,0,0,10,10,10,0,0,0,0,0,0,0,0,0,0,0,68014
23532,846,41,385,274,107,39,46,23,23,11,0,12,0,0,0,0,0,0,0,0,0,23,23,14,0,9,0,0,0,0,0,0,0,0,0,68015
23533,286,18,119,82,35,32,15,8,8,1,0,7,0,0,0,0,0,0,0,0,0,7,4,4,0,0,3,3,3,0,0,0,0,0,0,68016
23534,983,27,338,392,168,58,93,27,27,10,0,17,0,0,0,0,0,0,0,0,0,66,66,60,0,6,0,0,0,0,0,0,0,0,0,68017
23535,340,34,129,70,49,58,2,2,2,0,0,2,0,0,0,0,0,0,0,0,0,0,0,0,0,0,0,0,0,0,0,0,0,0,0,68018
23536,351,40,151,123,25,12,24,15,15,0,0,15,0,0,0,0,0,0,0,0,0,9,5,4,0,1,4,4,4,0,0,0,0,0,0,68019
23537,590,63,285,166,54,22,52,36,36,19,0,17,0,0,0,0,0,0,0,0,0,16,9,2,0,7,7,7,7,0,0,0,0,0,0,68020
23538,10399,403,1684,2780,3586,1946,746,418,408,223,0,185,10,0,0,0,0,10,10,0,0,328,310,80,0,230,18,18,15,3,0,0,0,0,0,68022
23539,1634,84,445,643,313,149,96,50,50,14,1,35,0,0,0,0,0,0,0,0,0,46,46,25,0,21,0,0,0,0,0,0,0,0,0,68023
23540,20394,2962,7162,6300,2972,998,1408,709,580,200,99,281,129,113,113,0,0,16,10,6,0,699,634,295,48,291,65,29,15,14,0,36,11,11,14,68025
23541,7086,252,1605,2369,1808,1052,559,246,219,81,15,123,27,27,27,0,0,0,0,0,0,313,299,182,0,117,14,14,14,0,0,0,0,0,0,68028
23542,669,50,311,147,113,48,75,65,62,14,0,48,3,3,3,0,0,0,0,0,0,10,10,4,0,6,0,0,0,0,0,0,0,0,0,68029
23543,537,47,199,216,27,48,81,65,54,29,0,25,11,11,11,0,0,0,0,0,0,16,10,1,0,9,6,6,4,2,0,0,0,0,0,68030
23544,1395,94,525,480,162,134,129,70,65,50,0,15,5,5,0,5,0,0,0,0,0,59,53,31,0,22,6,0,0,0,0,6,6,0,0,68031
23545,334,28,145,110,43,8,7,7,7,7,0,0,0,0,0,0,0,0,0,0,0,0,0,0,0,0,0,0,0,0,0,0,0,0,0,68033
23546,699,27,308,205,123,36,146,108,108,14,2,92,0,0,0,0,0,0,0,0,0,38,38,12,0,26,0,0,0,0,0,0,0,0,0,68034
23547,383,90,191,89,12,1,4,2,0,0,0,0,2,2,0,0,2,0,0,0,0,2,0,0,0,0,2,0,0,0,0,2,0,2,0,68036
23548,1446,141,525,457,230,93,88,27,15,4,0,11,12,12,3,9,0,0,0,0,0,61,57,52,0,5,4,0,0,0,0,4,4,0,0,68037
23549,949,68,418,311,127,25,61,46,41,7,0,34,5,0,0,0,0,5,5,0,0,15,15,0,0,15,0,0,0,0,0,0,0,0,0,68038
23550,537,190,137,162,36,12,88,57,45,0,10,35,12,8,0,0,8,4,0,0,4,31,25,0,0,25,6,2,0,2,0,4,4,0,0,68039
23551,200,2,102,76,16,4,44,33,31,5,0,26,2,2,2,0,0,0,0,0,0,11,11,9,0,2,0,0,0,0,0,0,0,0,0,68040
23552,700,43,248,294,91,24,45,14,14,9,0,5,0,0,0,0,0,0,0,0,0,31,21,13,5,3,10,10,0,7,3,0,0,0,0,68041
23553,67,14,22,26,5,0,4,1,1,0,0,1,0,0,0,0,0,0,0,0,0,3,3,1,0,2,0,0,0,0,0,0,0,0,0,68042
23554,400,124,156,80,28,12,21,12,8,0,5,3,4,4,4,0,0,0,0,0,0,9,7,5,0,2,2,2,0,0,2,0,0,0,0,68044
23555,1318,94,392,514,223,95,102,52,52,3,0,49,0,0,0,0,0,0,0,0,0,50,44,6,0,38,6,6,0,0,6,0,0,0,0,68045
23556,16715,566,3509,5676,4626,2338,1658,932,789,241,37,511,143,110,75,27,8,33,5,0,28,726,674,314,74,286,52,15,15,0,0,37,33,0,4,68046
23557,1246,96,483,380,193,94,88,61,48,21,0,27,13,8,8,0,0,5,0,4,1,27,27,6,0,21,0,0,0,0,0,0,0,0,0,68047
23558,8575,492,3041,2998,1333,711,778,407,351,77,59,215,56,46,46,0,0,10,0,0,10,371,296,186,0,110,75,49,24,25,0,26,26,0,0,68048
23559,552,38,283,145,70,16,30,20,15,3,0,12,5,5,0,5,0,0,0,0,0,10,8,0,0,8,2,2,2,0,0,0,0,0,0,68050
23560,178,21,72,60,19,6,8,3,0,0,0,0,3,3,0,0,3,0,0,0,0,5,1,0,0,1,4,4,2,0,2,0,0,0,0,68055
23561,1111,78,473,373,131,56,95,45,31,14,0,17,14,0,0,0,0,14,0,14,0,50,43,26,2,15,7,7,7,0,0,0,0,0,0,68057
23562,279,6,46,150,52,25,7,0,0,0,0,0,0,0,0,0,0,0,0,0,0,7,7,0,0,7,0,0,0,0,0,0,0,0,0,68058
23563,1862,111,665,565,397,124,175,120,120,33,19,68,0,0,0,0,0,0,0,0,0,55,55,12,0,43,0,0,0,0,0,0,0,0,0,68059
23564,1647,135,593,623,230,66,132,54,54,28,0,26,0,0,0,0,0,0,0,0,0,78,42,22,0,20,36,20,20,0,0,16,0,0,16,68061
23565,197,14,91,47,36,9,17,14,9,3,0,6,5,5,5,0,0,0,0,0,0,3,3,2,0,1,0,0,0,0,0,0,0,0,0,68062
23566,217,16,95,55,42,9,34,27,26,9,15,2,1,1,1,0,0,0,0,0,0,7,7,2,0,5,0,0,0,0,0,0,0,0,0,68063
23567,2345,133,757,864,373,218,127,56,53,31,0,22,3,0,0,0,0,3,3,0,0,71,56,27,0,29,15,5,5,0,0,10,0,0,10,68064
23568,1069,61,431,346,156,75,75,26,26,17,4,5,0,0,0,0,0,0,0,0,0,49,49,11,4,34,0,0,0,0,0,0,0,0,0,68065
23569,3395,315,943,1061,769,307,231,113,79,31,8,40,34,22,0,0,22,12,0,0,12,118,101,37,7,57,17,17,17,0,0,0,0,0,0,68066
23570,656,71,215,279,53,38,72,45,34,7,0,27,11,8,0,3,5,3,0,0,3,27,14,4,0,10,13,11,0,4,7,2,0,0,2,68067
23571,54,1,25,17,6,5,4,4,4,0,0,4,0,0,0,0,0,0,0,0,0,0,0,0,0,0,0,0,0,0,0,0,0,0,0,68068
23572,1814,111,439,551,447,266,131,85,85,19,5,61,0,0,0,0,0,0,0,0,0,46,46,6,0,40,0,0,0,0,0,0,0,0,0,68069
23573,586,60,269,169,83,5,120,63,53,13,0,40,10,10,10,0,0,0,0,0,0,57,45,17,0,28,12,8,0,0,8,4,4,0,0,68070
23574,914,124,256,437,74,23,181,65,50,4,3,43,15,5,5,0,0,10,8,0,2,116,101,18,9,74,15,7,7,0,0,8,3,0,5,68071
23575,17,0,13,4,0,0,0,0,0,0,0,0,0,0,0,0,0,0,0,0,0,0,0,0,0,0,0,0,0,0,0,0,0,0,0,68072
23576,1313,53,432,544,219,65,79,46,46,18,4,24,0,0,0,0,0,0,0,0,0,33,33,10,0,23,0,0,0,0,0,0,0,0,0,68073
23577,3772,394,684,1186,942,566,472,165,115,48,7,60,50,6,0,0,6,44,0,0,44,307,301,136,30,135,6,6,0,0,6,0,0,0,0,68102
23578,22692,2661,6196,8398,3603,1834,1880,1004,854,135,134,585,150,76,46,19,11,74,0,66,8,876,680,232,100,348,196,159,159,0,0,37,0,5,32,68104
23579,15261,3913,3909,4161,2112,1166,1279,699,499,173,52,274,200,82,82,0,0,118,31,63,24,580,480,181,17,282,100,63,57,0,6,37,20,0,17,68105
23580,14028,887,3398,4087,3344,2312,929,411,409,184,17,208,2,2,0,0,2,0,0,0,0,518,428,225,17,186,90,58,58,0,0,32,32,0,0,68106
23581,16666,7423,4632,3408,910,293,1940,1097,866,270,172,424,231,111,60,27,24,120,30,22,68,843,662,149,102,411,181,119,90,0,29,62,24,23,15,68107
23582,8702,2975,2218,2359,800,350,752,432,361,115,83,163,71,48,23,9,16,23,20,0,3,320,275,98,7,170,45,26,12,0,14,19,12,0,7,68108
23583,5337,1208,1986,1695,339,109,667,379,343,68,106,169,36,12,0,0,12,24,0,0,24,288,175,32,41,102,113,49,18,31,0,64,34,0,30,68110
23584,12835,2835,4377,4283,989,351,1569,950,671,56,204,411,279,144,26,47,71,135,72,4,59,619,482,160,75,247,137,112,62,33,17,25,0,5,20,68111
23585,7189,1197,2245,2363,875,509,469,220,206,36,7,163,14,0,0,0,0,14,0,14,0,249,202,66,82,54,47,47,0,22,25,0,0,0,0,68112
23586,266,0,39,144,51,32,60,35,0,0,0,0,35,35,35,0,0,0,0,0,0,25,13,6,7,0,12,12,12,0,0,0,0,0,0,68113
23587,12159,460,2029,4053,3508,2109,794,331,274,115,42,117,57,40,40,0,0,17,0,10,7,463,440,165,36,239,23,8,0,0,8,15,8,0,7,68114
23588,16471,374,2308,4630,6086,3073,980,457,442,308,16,118,15,15,15,0,0,0,0,0,0,523,523,279,73,171,0,0,0,0,0,0,0,0,0,68116
23589,5665,1209,2096,1682,520,158,380,224,177,81,8,88,47,30,30,0,0,17,17,0,0,156,156,37,30,89,0,0,0,0,0,0,0,0,0,68117
23590,6106,113,610,1525,2283,1575,527,293,293,110,5,178,0,0,0,0,0,0,0,0,0,234,234,170,0,64,0,0,0,0,0,0,0,0,0,68118
23591,7200,273,1487,2745,1787,908,436,218,178,117,3,58,40,40,0,0,40,0,0,0,0,218,218,54,4,160,0,0,0,0,0,0,0,0,0,68122
23592,16582,637,2873,6529,4130,2413,1399,669,614,279,95,240,55,55,49,6,0,0,0,0,0,730,683,355,82,246,47,34,28,0,6,13,0,0,13,68123
23593,10347,482,1912,2809,3083,2061,753,441,411,161,4,246,30,23,0,9,14,7,7,0,0,312,302,116,12,174,10,0,0,0,0,10,10,0,0,68124
23594,14731,1325,3547,4982,3468,1409,951,476,386,177,41,168,90,66,34,32,0,24,24,0,0,475,352,199,0,153,123,55,36,0,19,68,17,47,4,68127
23595,11790,549,3161,3827,2762,1491,832,463,437,184,47,206,26,0,0,0,0,26,0,26,0,369,327,173,22,132,42,42,30,12,0,0,0,0,0,68128
23596,12026,184,1448,3496,4588,2310,963,473,440,169,74,197,33,33,33,0,0,0,0,0,0,490,464,276,7,181,26,26,26,0,0,0,0,0,0,68130
23597,8052,1043,1994,2390,1474,1151,979,317,278,63,112,103,39,22,3,19,0,17,0,0,17,662,598,307,77,214,64,64,53,11,0,0,0,0,0,68131
23598,9125,505,1200,2110,3300,2010,1062,534,462,200,49,213,72,2,0,0,2,70,70,0,0,528,444,165,21,258,84,83,50,33,0,1,0,0,1,68132
23599,6260,313,1000,2125,1801,1021,567,318,276,162,25,89,42,42,42,0,0,0,0,0,0,249,249,76,90,83,0,0,0,0,0,0,0,0,0,68133
23600,19662,1387,5518,7544,3773,1440,1074,491,370,207,41,122,121,89,86,0,3,32,21,6,5,583,548,270,73,205,35,35,35,0,0,0,0,0,0,68134
23601,15542,224,1954,4759,6047,2558,1643,741,674,344,28,302,67,67,66,0,1,0,0,0,0,902,875,461,32,382,27,20,20,0,0,7,7,0,0,68135
23602,8716,298,1296,2760,3057,1305,438,201,183,72,9,102,18,18,9,0,9,0,0,0,0,237,223,83,22,118,14,14,14,0,0,0,0,0,0,68136
23603,16768,793,4501,6114,3782,1578,1157,551,432,262,31,139,119,107,68,18,21,12,4,8,0,606,521,217,79,225,85,75,75,0,0,10,10,0,0,68137
23604,7237,232,1851,2862,1617,675,593,345,312,109,27,176,33,33,33,0,0,0,0,0,0,248,209,95,33,81,39,26,26,0,0,13,0,13,0,68138
23605,2119,20,631,783,443,242,172,82,82,19,12,51,0,0,0,0,0,0,0,0,0,90,77,5,10,62,13,13,0,0,13,0,0,0,0,68142
23606,16864,843,3456,5656,4581,2328,1184,577,516,337,29,150,61,61,54,6,1,0,0,0,0,607,544,362,31,151,63,63,22,35,6,0,0,0,0,68144
23607,6367,789,2155,2209,817,397,561,239,180,42,5,133,59,59,20,0,39,0,0,0,0,322,290,87,91,112,32,32,13,19,0,0,0,0,0,68147
23608,4325,433,1208,1296,834,554,343,208,173,62,8,103,35,27,26,0,1,8,0,8,0,135,105,47,22,36,30,30,0,0,30,0,0,0,0,68152
23609,15423,374,2130,4290,5639,2990,1054,555,514,206,66,242,41,41,34,7,0,0,0,0,0,499,499,331,11,157,0,0,0,0,0,0,0,0,0,68154
23610,3543,235,1213,1233,653,209,369,191,173,81,23,69,18,18,8,10,0,0,0,0,0,178,172,85,4,83,6,0,0,0,0,6,0,6,0,68157
23611,18597,924,3273,6296,5378,2726,1277,672,649,255,19,375,23,23,23,0,0,0,0,0,0,605,562,258,29,275,43,43,43,0,0,0,0,0,0,68164
23612,71,0,20,12,6,33,957,296,296,117,6,173,0,0,0,0,0,0,0,0,0,661,661,307,6,348,0,0,0,0,0,0,0,0,0,68178
23613,960,88,280,321,227,44,63,29,29,7,0,22,0,0,0,0,0,0,0,0,0,34,28,15,2,11,6,6,6,0,0,0,0,0,0,68301
23614,201,22,89,54,24,12,22,13,13,0,0,13,0,0,0,0,0,0,0,0,0,9,9,0,0,9,0,0,0,0,0,0,0,0,0,68303
23615,201,6,74,52,48,21,0,0,0,0,0,0,0,0,0,0,0,0,0,0,0,0,0,0,0,0,0,0,0,0,0,0,0,0,0,68304
23616,2940,228,1008,955,559,190,222,118,98,49,0,49,20,20,20,0,0,0,0,0,0,104,104,28,0,76,0,0,0,0,0,0,0,0,0,68305
23617,312,13,139,151,7,2,39,12,12,3,0,9,0,0,0,0,0,0,0,0,0,27,27,26,0,1,0,0,0,0,0,0,0,0,0,68307
23618,80,9,36,33,2,0,0,0,0,0,0,0,0,0,0,0,0,0,0,0,0,0,0,0,0,0,0,0,0,0,0,0,0,0,0,68309
23619,9973,1111,3402,3272,1519,669,515,257,218,75,12,131,39,24,20,0,4,15,0,8,7,258,216,139,0,77,42,42,37,5,0,0,0,0,0,68310
23620,664,48,235,189,173,19,40,33,16,0,0,16,17,17,0,17,0,0,0,0,0,7,7,0,1,6,0,0,0,0,0,0,0,0,0,68313
23621,331,14,67,166,39,45,14,8,8,0,6,2,0,0,0,0,0,0,0,0,0,6,6,0,0,6,0,0,0,0,0,0,0,0,0,68314
23622,60,4,13,43,0,0,0,0,0,0,0,0,0,0,0,0,0,0,0,0,0,0,0,0,0,0,0,0,0,0,0,0,0,0,0,68315
23623,285,19,99,91,58,18,17,7,7,0,0,7,0,0,0,0,0,0,0,0,0,10,10,6,1,3,0,0,0,0,0,0,0,0,0,68316
23624,1060,28,290,433,212,97,55,31,31,14,0,17,0,0,0,0,0,0,0,0,0,24,24,14,0,10,0,0,0,0,0,0,0,0,0,68317
23625,334,35,170,113,16,0,26,17,17,10,0,7,0,0,0,0,0,0,0,0,0,9,7,7,0,0,2,2,2,0,0,0,0,0,0,68318
23626,394,17,165,146,58,8,105,62,61,21,0,40,1,0,0,0,0,1,0,1,0,43,34,0,3,31,9,9,9,0,0,0,0,0,0,68319
23627,240,25,108,74,29,4,23,5,2,0,0,2,3,0,0,0,0,3,3,0,0,18,11,3,0,8,7,0,0,0,0,7,0,0,7,68320
23628,203,9,87,90,12,5,34,34,34,0,0,34,0,0,0,0,0,0,0,0,0,0,0,0,0,0,0,0,0,0,0,0,0,0,0,68321
23629,363,12,139,134,63,15,23,2,2,0,0,2,0,0,0,0,0,0,0,0,0,21,12,0,0,12,9,9,0,9,0,0,0,0,0,68322
23630,210,13,96,67,25,9,12,6,3,1,0,2,3,3,3,0,0,0,0,0,0,6,6,0,0,6,0,0,0,0,0,0,0,0,0,68323
23631,107,36,37,33,1,0,1,1,1,0,0,1,0,0,0,0,0,0,0,0,0,0,0,0,0,0,0,0,0,0,0,0,0,0,0,68324
23632,126,6,55,41,21,3,6,1,1,1,0,0,0,0,0,0,0,0,0,0,0,5,5,3,0,2,0,0,0,0,0,0,0,0,0,68325
23633,204,17,58,80,42,7,9,5,5,5,0,0,0,0,0,0,0,0,0,0,0,4,4,2,0,2,0,0,0,0,0,0,0,0,0,68326
23634,235,10,125,82,14,4,2,2,2,0,0,2,0,0,0,0,0,0,0,0,0,0,0,0,0,0,0,0,0,0,0,0,0,0,0,68327
23635,337,22,68,198,16,33,21,7,7,7,0,0,0,0,0,0,0,0,0,0,0,14,14,0,0,14,0,0,0,0,0,0,0,0,0,68328
23636,439,47,178,114,76,24,4,2,2,0,0,2,0,0,0,0,0,0,0,0,0,2,2,0,0,2,0,0,0,0,0,0,0,0,0,68329
23637,689,22,261,267,108,31,50,47,44,6,0,38,3,3,0,3,0,0,0,0,0,3,3,3,0,0,0,0,0,0,0,0,0,0,0,68331
23638,83,0,31,39,11,2,1,1,1,0,0,1,0,0,0,0,0,0,0,0,0,0,0,0,0,0,0,0,0,0,0,0,0,0,0,68332
23639,4661,1059,1496,1361,291,454,942,441,423,49,28,346,18,7,7,0,0,11,0,0,11,501,485,128,68,289,16,16,1,0,15,0,0,0,0,68333
23640,333,27,123,110,64,9,15,7,7,4,0,3,0,0,0,0,0,0,0,0,0,8,8,0,0,8,0,0,0,0,0,0,0,0,0,68335
23641,321,3,113,95,83,27,19,17,16,0,0,16,1,1,0,0,1,0,0,0,0,2,2,2,0,0,0,0,0,0,0,0,0,0,0,68336
23642,195,14,84,61,20,16,9,9,9,4,1,4,0,0,0,0,0,0,0,0,0,0,0,0,0,0,0,0,0,0,0,0,0,0,0,68337
23643,242,36,91,84,22,9,10,0,0,0,0,0,0,0,0,0,0,0,0,0,0,10,10,5,0,5,0,0,0,0,0,0,0,0,0,68338
23644,889,14,263,300,215,97,96,52,45,8,8,29,7,7,0,7,0,0,0,0,0,44,31,6,0,25,13,13,11,0,2,0,0,0,0,68339
23645,659,58,236,260,73,32,82,55,49,8,0,41,6,0,0,0,0,6,0,0,6,27,19,8,0,11,8,8,8,0,0,0,0,0,0,68340
23646,740,37,334,218,118,33,61,39,39,14,7,18,0,0,0,0,0,0,0,0,0,22,20,8,0,12,2,2,2,0,0,0,0,0,0,68341
23647,316,15,139,112,32,18,28,11,11,3,0,8,0,0,0,0,0,0,0,0,0,17,10,10,0,0,7,7,0,7,0,0,0,0,0,68342
23648,690,64,259,276,72,19,45,21,9,0,2,7,12,12,12,0,0,0,0,0,0,24,19,2,0,17,5,5,5,0,0,0,0,0,0,68343
23649,317,12,86,152,59,8,33,15,15,8,0,7,0,0,0,0,0,0,0,0,0,18,17,15,2,0,1,1,1,0,0,0,0,0,0,68344
23650,240,26,114,84,15,1,6,5,5,1,0,4,0,0,0,0,0,0,0,0,0,1,1,0,0,1,0,0,0,0,0,0,0,0,0,68345
23651,386,29,162,108,46,41,41,27,27,27,0,0,0,0,0,0,0,0,0,0,0,14,14,7,0,7,0,0,0,0,0,0,0,0,0,68346
23652,1548,108,431,552,317,140,48,29,26,10,0,16,3,3,3,0,0,0,0,0,0,19,16,9,0,7,3,3,3,0,0,0,0,0,0,68347
23653,177,24,102,26,9,16,12,0,0,0,0,0,0,0,0,0,0,0,0,0,0,12,12,1,0,11,0,0,0,0,0,0,0,0,0,68348
23654,778,52,254,293,124,55,57,30,30,20,0,10,0,0,0,0,0,0,0,0,0,27,27,22,3,2,0,0,0,0,0,0,0,0,0,68349
23655,168,16,72,46,32,2,16,3,3,1,0,2,0,0,0,0,0,0,0,0,0,13,13,4,0,9,0,0,0,0,0,0,0,0,0,68350
23656,621,49,180,248,125,19,63,20,20,9,0,11,0,0,0,0,0,0,0,0,0,43,34,18,0,16,9,9,9,0,0,0,0,0,0,68351
23657,3731,462,1620,1154,304,191,207,156,140,77,10,53,16,7,6,0,1,9,0,9,0,51,51,42,0,9,0,0,0,0,0,0,0,0,0,68352
23658,614,69,315,156,48,26,40,11,11,11,0,0,0,0,0,0,0,0,0,0,0,29,29,29,0,0,0,0,0,0,0,0,0,0,0,68354
23659,3664,252,1550,1084,575,203,230,143,130,29,21,80,13,13,12,0,1,0,0,0,0,87,67,35,0,32,20,0,0,0,0,20,0,0,20,68355
23660,266,29,149,43,31,14,13,4,4,0,0,4,0,0,0,0,0,0,0,0,0,9,9,0,0,9,0,0,0,0,0,0,0,0,0,68357
23661,1138,94,290,421,260,73,66,18,12,2,0,10,6,6,5,0,1,0,0,0,0,48,48,26,0,22,0,0,0,0,0,0,0,0,0,68358
23662,1160,121,342,446,193,58,53,30,28,18,0,10,2,0,0,0,0,2,0,0,2,23,23,2,0,21,0,0,0,0,0,0,0,0,0,68359
23663,328,23,150,78,59,18,45,25,23,6,0,17,2,2,0,0,2,0,0,0,0,20,20,5,0,15,0,0,0,0,0,0,0,0,0,68360
23664,1700,116,687,584,202,111,184,73,48,29,0,19,25,0,0,0,0,25,25,0,0,111,96,6,10,80,15,15,7,0,8,0,0,0,0,68361
23665,43,20,20,2,1,0,18,12,12,1,0,11,0,0,0,0,0,0,0,0,0,6,6,0,0,6,0,0,0,0,0,0,0,0,0,68362
23666,65,5,34,20,4,2,0,0,0,0,0,0,0,0,0,0,0,0,0,0,0,0,0,0,0,0,0,0,0,0,0,0,0,0,0,68364
23667,222,15,113,75,13,6,0,0,0,0,0,0,0,0,0,0,0,0,0,0,0,0,0,0,0,0,0,0,0,0,0,0,0,0,0,68365
23668,853,73,250,276,198,56,169,73,29,10,3,16,44,24,24,0,0,20,0,20,0,96,96,72,19,5,0,0,0,0,0,0,0,0,0,68366
23669,341,28,167,79,52,15,7,7,7,2,0,5,0,0,0,0,0,0,0,0,0,0,0,0,0,0,0,0,0,0,0,0,0,0,0,68367
23670,287,13,89,99,59,27,9,9,9,4,4,1,0,0,0,0,0,0,0,0,0,0,0,0,0,0,0,0,0,0,0,0,0,0,0,68368
23671,1558,126,592,585,200,55,94,45,41,18,0,23,4,4,4,0,0,0,0,0,0,49,37,25,0,12,12,12,12,0,0,0,0,0,0,68370
23672,1083,80,303,380,267,53,84,32,32,12,0,20,0,0,0,0,0,0,0,0,0,52,36,8,4,24,16,4,4,0,0,12,12,0,0,68371
23673,1951,64,509,803,391,184,149,80,78,30,20,28,2,2,2,0,0,0,0,0,0,69,69,5,0,64,0,0,0,0,0,0,0,0,0,68372
23674,145,29,82,34,0,0,2,2,2,0,0,2,0,0,0,0,0,0,0,0,0,0,0,0,0,0,0,0,0,0,0,0,0,0,0,68375
23675,1086,80,467,358,131,50,66,28,15,3,0,12,13,0,0,0,0,13,13,0,0,38,23,14,0,9,15,15,15,0,0,0,0,0,0,68376
23676,385,26,181,122,55,1,42,12,10,3,0,7,2,0,0,0,0,2,0,0,2,30,28,28,0,0,2,2,2,0,0,0,0,0,0,68377
23677,521,30,167,169,128,27,34,20,18,14,0,4,2,2,2,0,0,0,0,0,0,14,14,4,0,10,0,0,0,0,0,0,0,0,0,68378
23678,59,11,20,13,10,5,3,3,3,1,0,2,0,0,0,0,0,0,0,0,0,0,0,0,0,0,0,0,0,0,0,0,0,0,0,68379
23679,52,6,23,11,9,3,4,4,4,0,0,4,0,0,0,0,0,0,0,0,0,0,0,0,0,0,0,0,0,0,0,0,0,0,0,68380
23680,199,8,66,72,45,8,12,8,8,0,0,8,0,0,0,0,0,0,0,0,0,4,4,0,0,4,0,0,0,0,0,0,0,0,0,68381
23681,39,3,19,11,6,0,9,5,5,3,0,2,0,0,0,0,0,0,0,0,0,4,0,0,0,0,4,4,4,0,0,0,0,0,0,68382
23682,405,12,151,133,78,31,33,21,21,16,0,5,0,0,0,0,0,0,0,0,0,12,12,4,0,8,0,0,0,0,0,0,0,0,0,68401
23683,827,20,275,315,152,65,78,40,21,13,0,8,19,10,10,0,0,9,9,0,0,38,21,7,2,12,17,3,3,0,0,14,0,14,0,68402
23684,130,6,43,46,20,15,19,7,7,3,0,4,0,0,0,0,0,0,0,0,0,12,12,4,0,8,0,0,0,0,0,0,0,0,0,68403
23685,768,43,244,279,84,118,59,17,17,9,0,8,0,0,0,0,0,0,0,0,0,42,42,42,0,0,0,0,0,0,0,0,0,0,0,68404
23686,1995,212,692,648,290,153,364,240,240,82,0,158,0,0,0,0,0,0,0,0,0,124,124,51,9,64,0,0,0,0,0,0,0,0,0,68405
23687,395,23,156,137,62,17,41,12,12,0,0,12,0,0,0,0,0,0,0,0,0,29,29,13,4,12,0,0,0,0,0,0,0,0,0,68406
23688,459,19,154,174,82,30,26,22,22,0,0,22,0,0,0,0,0,0,0,0,0,4,4,0,0,4,0,0,0,0,0,0,0,0,0,68407
23689,535,10,165,213,94,53,48,3,3,0,0,3,0,0,0,0,0,0,0,0,0,45,45,0,17,28,0,0,0,0,0,0,0,0,0,68409
23690,5905,516,2331,1704,934,420,453,283,263,106,39,118,20,1,0,0,1,19,19,0,0,170,161,77,0,84,9,9,0,9,0,0,0,0,0,68410
23691,336,14,112,152,45,13,22,1,0,0,0,0,1,1,1,0,0,0,0,0,0,21,21,9,0,12,0,0,0,0,0,0,0,0,0,68413
23692,190,18,119,45,8,0,9,9,2,0,0,2,7,7,0,7,0,0,0,0,0,0,0,0,0,0,0,0,0,0,0,0,0,0,0,68414
23693,454,24,193,139,76,22,42,31,25,13,0,12,6,0,0,0,0,6,4,0,2,11,7,5,0,2,4,0,0,0,0,4,4,0,0,68415
23694,185,14,102,62,2,5,13,6,5,4,1,0,1,1,0,1,0,0,0,0,0,7,7,7,0,0,0,0,0,0,0,0,0,0,0,68416
23695,212,19,98,66,21,8,10,10,10,0,0,10,0,0,0,0,0,0,0,0,0,0,0,0,0,0,0,0,0,0,0,0,0,0,0,68417
23696,743,32,266,245,164,36,111,47,43,4,9,30,4,0,0,0,0,4,0,0,4,64,64,22,0,42,0,0,0,0,0,0,0,0,0,68418
23697,184,1,52,101,18,12,1,1,1,1,0,0,0,0,0,0,0,0,0,0,0,0,0,0,0,0,0,0,0,0,0,0,0,0,0,68419
23698,925,147,431,263,49,35,57,47,32,7,2,23,15,0,0,0,0,15,3,0,12,10,5,2,0,3,5,0,0,0,0,5,0,0,5,68420
23699,426,35,167,80,58,86,281,70,70,16,0,54,0,0,0,0,0,0,0,0,0,211,211,100,17,94,0,0,0,0,0,0,0,0,0,68421
23700,306,21,88,162,22,13,30,15,15,5,0,10,0,0,0,0,0,0,0,0,0,15,15,6,0,9,0,0,0,0,0,0,0,0,0,68422
23701,637,24,244,213,121,35,17,2,2,0,2,0,0,0,0,0,0,0,0,0,0,15,15,15,0,0,0,0,0,0,0,0,0,0,0,68423
23702,554,33,211,244,50,16,49,20,10,4,0,6,10,10,10,0,0,0,0,0,0,29,25,3,4,18,4,4,4,0,0,0,0,0,0,68424
23703,864,75,183,266,241,99,111,30,30,16,0,14,0,0,0,0,0,0,0,0,0,81,55,27,0,28,26,26,26,0,0,0,0,0,0,68428
23704,926,12,169,413,252,80,120,69,67,14,0,53,2,2,2,0,0,0,0,0,0,51,51,38,0,13,0,0,0,0,0,0,0,0,0,68430
23705,235,30,122,57,15,11,10,5,5,0,0,5,0,0,0,0,0,0,0,0,0,5,5,2,0,3,0,0,0,0,0,0,0,0,0,68431
23706,237,21,78,129,0,9,12,0,0,0,0,0,0,0,0,0,0,0,0,0,0,12,7,5,0,2,5,5,0,0,5,0,0,0,0,68433
23707,5129,392,1356,1874,891,616,773,375,345,64,11,270,30,28,16,10,2,2,0,0,2,398,390,131,22,237,8,8,8,0,0,0,0,0,0,68434
23708,414,25,92,216,68,13,14,4,4,0,0,4,0,0,0,0,0,0,0,0,0,10,10,7,0,3,0,0,0,0,0,0,0,0,0,68436
23709,169,33,61,40,20,15,0,0,0,0,0,0,0,0,0,0,0,0,0,0,0,0,0,0,0,0,0,0,0,0,0,0,0,0,0,68437
23710,99,9,54,25,9,2,2,0,0,0,0,0,0,0,0,0,0,0,0,0,0,2,2,0,0,2,0,0,0,0,0,0,0,0,0,68438
23711,374,41,148,124,44,17,28,2,2,0,2,0,0,0,0,0,0,0,0,0,0,26,25,0,0,25,1,1,1,0,0,0,0,0,0,68439
23712,74,13,38,15,8,0,7,2,2,2,0,0,0,0,0,0,0,0,0,0,0,5,5,5,0,0,0,0,0,0,0,0,0,0,0,68440
23713,220,30,96,75,15,4,7,2,1,0,0,1,1,0,0,0,0,1,0,0,1,5,5,1,0,4,0,0,0,0,0,0,0,0,0,68441
23714,318,17,117,94,69,21,8,7,5,0,0,5,2,2,2,0,0,0,0,0,0,1,1,1,0,0,0,0,0,0,0,0,0,0,0,68442
23715,778,58,298,275,119,28,57,35,33,7,5,21,2,2,2,0,0,0,0,0,0,22,16,10,0,6,6,3,3,0,0,3,0,0,3,68443
23716,34,0,7,18,9,0,6,6,6,0,0,6,0,0,0,0,0,0,0,0,0,0,0,0,0,0,0,0,0,0,0,0,0,0,0,68444
23717,75,0,39,32,4,0,5,0,0,0,0,0,0,0,0,0,0,0,0,0,0,5,5,0,0,5,0,0,0,0,0,0,0,0,0,68445
23718,1791,126,665,578,269,153,147,65,55,23,12,20,10,10,0,10,0,0,0,0,0,82,82,23,24,35,0,0,0,0,0,0,0,0,0,68446
23719,393,41,200,85,61,6,25,5,5,1,0,4,0,0,0,0,0,0,0,0,0,20,20,1,4,15,0,0,0,0,0,0,0,0,0,68447
23720,327,40,160,62,55,10,13,4,1,0,0,1,3,3,3,0,0,0,0,0,0,9,9,3,0,6,0,0,0,0,0,0,0,0,0,68448
23721,2426,355,1078,784,146,63,116,77,77,9,46,22,0,0,0,0,0,0,0,0,0,39,36,22,0,14,3,0,0,0,0,3,3,0,0,68450
23722,93,5,17,48,23,0,16,10,10,10,0,0,0,0,0,0,0,0,0,0,0,6,6,3,0,3,0,0,0,0,0,0,0,0,0,68452
23723,238,11,137,65,18,7,48,18,18,10,0,8,0,0,0,0,0,0,0,0,0,30,30,5,0,25,0,0,0,0,0,0,0,0,0,68453
23724,459,27,141,204,58,29,27,7,7,5,0,2,0,0,0,0,0,0,0,0,0,20,15,11,0,4,5,0,0,0,0,5,0,0,5,68454
23725,447,18,169,151,75,34,23,11,2,0,0,2,9,9,0,0,9,0,0,0,0,12,12,0,0,12,0,0,0,0,0,0,0,0,0,68455
23726,712,67,244,259,102,40,65,42,38,14,3,21,4,3,0,3,0,1,1,0,0,23,23,1,0,22,0,0,0,0,0,0,0,0,0,68456
23727,257,21,100,107,27,2,66,9,8,2,0,6,1,1,1,0,0,0,0,0,0,57,57,3,48,6,0,0,0,0,0,0,0,0,0,68457
23728,103,2,29,60,12,0,10,1,1,0,1,0,0,0,0,0,0,0,0,0,0,9,9,0,0,9,0,0,0,0,0,0,0,0,0,68458
23729,648,24,381,129,58,56,26,21,19,10,0,9,2,2,0,0,2,0,0,0,0,5,5,0,0,5,0,0,0,0,0,0,0,0,0,68460
23730,360,0,16,108,139,97,60,10,10,0,10,0,0,0,0,0,0,0,0,0,0,50,50,25,8,17,0,0,0,0,0,0,0,0,0,68461
23731,2592,24,585,1140,519,324,149,94,87,60,0,27,7,3,3,0,0,4,0,0,4,55,55,36,0,19,0,0,0,0,0,0,0,0,0,68462
23732,1030,52,371,433,119,55,101,81,78,34,4,40,3,3,3,0,0,0,0,0,0,20,20,7,0,13,0,0,0,0,0,0,0,0,0,68463
23733,345,40,137,115,45,8,10,5,3,2,1,0,2,2,2,0,0,0,0,0,0,5,5,3,0,2,0,0,0,0,0,0,0,0,0,68464
23734,1704,167,601,715,162,59,119,48,33,0,0,33,15,15,13,2,0,0,0,0,0,71,64,15,0,49,7,7,7,0,0,0,0,0,0,68465
23735,1403,148,620,494,94,47,99,39,26,5,3,18,13,13,13,0,0,0,0,0,0,60,60,7,0,53,0,0,0,0,0,0,0,0,0,68466
23736,6244,360,2108,2169,1083,524,584,351,346,144,14,188,5,4,0,0,4,1,0,0,1,233,197,76,14,107,36,35,34,0,1,1,0,0,1,68467
23737,17391,1320,4026,5308,4252,2485,1060,582,441,169,91,181,141,81,80,0,1,60,38,0,22,478,438,114,66,258,40,4,0,0,4,36,19,0,17,68502
23738,8352,1175,1971,2555,1445,1206,1075,566,485,137,49,299,81,31,19,12,0,50,3,0,47,509,466,210,23,233,43,25,25,0,0,18,10,0,8,68503
23739,9469,833,2874,3561,1476,725,1266,564,528,204,50,274,36,36,36,0,0,0,0,0,0,702,668,402,72,194,34,6,0,0,6,28,10,18,0,68504
23740,9885,365,2575,4155,1861,929,705,352,294,157,38,99,58,58,58,0,0,0,0,0,0,353,309,142,17,150,44,44,34,10,0,0,0,0,0,68505
23741,19541,891,4039,6180,5176,3255,1229,574,497,182,36,279,77,54,39,0,15,23,0,0,23,655,599,352,93,154,56,56,56,0,0,0,0,0,0,68506
23742,9321,407,2577,4036,1585,716,658,412,386,157,45,184,26,14,14,0,0,12,12,0,0,246,221,142,10,69,25,25,18,0,7,0,0,0,0,68507
23743,4851,807,1241,1430,831,542,4905,2354,2294,508,205,1581,60,34,21,9,4,26,26,0,0,2551,2501,1000,223,1278,50,40,19,6,15,10,10,0,0,68508
23744,13904,808,3710,4241,3368,1777,988,436,376,94,34,248,60,60,49,11,0,0,0,0,0,552,484,254,16,214,68,55,8,0,47,13,0,0,13,68510
23745,7651,96,1263,2618,2419,1255,360,223,212,111,9,92,11,11,11,0,0,0,0,0,0,137,137,79,3,55,0,0,0,0,0,0,0,0,0,68512
23746,169,8,38,60,63,0,44,44,44,44,0,0,0,0,0,0,0,0,0,0,0,0,0,0,0,0,0,0,0,0,0,0,0,0,0,68514
23747,26177,659,4495,8326,8508,4189,1595,873,753,384,63,306,120,101,57,38,6,19,0,12,7,722,699,329,118,252,23,16,16,0,0,7,0,0,7,68516
23748,284,14,36,56,120,58,137,99,66,33,0,33,33,33,33,0,0,0,0,0,0,38,38,38,0,0,0,0,0,0,0,0,0,0,0,68517
23749,878,25,216,244,200,193,21,4,4,4,0,0,0,0,0,0,0,0,0,0,0,17,17,17,0,0,0,0,0,0,0,0,0,0,0,68520
23750,18748,1863,5011,6597,4032,1245,1468,814,714,343,18,353,100,78,48,30,0,22,10,0,12,654,603,243,54,306,51,31,0,26,5,20,14,6,0,68521
23751,7415,710,1784,2878,1437,606,556,229,190,47,11,132,39,26,22,0,4,13,0,0,13,327,298,79,11,208,29,23,23,0,0,6,0,0,6,68522
23752,900,22,110,412,210,146,161,43,30,12,12,6,13,13,0,5,8,0,0,0,0,118,106,73,0,33,12,12,7,0,5,0,0,0,0,68523
23753,3729,387,869,1625,680,168,252,100,76,16,0,60,24,5,5,0,0,19,0,19,0,152,120,21,44,55,32,32,5,12,15,0,0,0,0,68524
23754,3269,47,395,910,1215,702,274,117,117,67,0,50,0,0,0,0,0,0,0,0,0,157,157,56,20,81,0,0,0,0,0,0,0,0,0,68526
23755,629,40,102,144,240,103,47,40,40,0,23,17,0,0,0,0,0,0,0,0,0,7,7,7,0,0,0,0,0,0,0,0,0,0,0,68527
23756,3584,318,977,1264,753,272,446,177,161,67,76,18,16,16,6,0,10,0,0,0,0,269,221,177,11,33,48,37,31,6,0,11,11,0,0,68528
23757,72,0,33,35,4,0,0,0,0,0,0,0,0,0,0,0,0,0,0,0,0,0,0,0,0,0,0,0,0,0,0,0,0,0,0,68531
23758,477,8,37,253,124,55,105,83,75,24,38,13,8,0,0,0,0,8,0,0,8,22,22,11,0,11,0,0,0,0,0,0,0,0,0,68532
23759,18067,2191,5280,7042,2378,1176,1526,737,573,325,26,222,164,152,134,10,8,12,5,0,7,789,678,295,113,270,111,83,40,0,43,28,0,0,28,68601
23760,1958,133,889,603,209,124,120,41,37,24,0,13,4,0,0,0,0,4,0,0,4,79,66,36,0,30,13,0,0,0,0,13,0,0,13,68620
23761,395,39,264,33,14,45,20,20,20,17,0,3,0,0,0,0,0,0,0,0,0,0,0,0,0,0,0,0,0,0,0,0,0,0,0,68621
23762,200,7,86,69,28,10,33,22,8,8,0,0,14,14,14,0,0,0,0,0,0,11,11,2,0,9,0,0,0,0,0,0,0,0,0,68622
23763,215,16,112,76,11,0,6,0,0,0,0,0,0,0,0,0,0,0,0,0,0,6,6,5,0,1,0,0,0,0,0,0,0,0,0,68623
23764,810,41,328,337,81,23,33,18,18,0,0,18,0,0,0,0,0,0,0,0,0,15,15,2,0,13,0,0,0,0,0,0,0,0,0,68624
23765,453,15,172,197,48,21,59,40,35,0,15,20,5,5,2,3,0,0,0,0,0,19,19,5,7,7,0,0,0,0,0,0,0,0,0,68626
23766,413,17,192,177,21,6,59,36,36,21,0,15,0,0,0,0,0,0,0,0,0,23,23,11,0,12,0,0,0,0,0,0,0,0,0,68627
23767,679,44,233,273,99,30,18,14,12,3,0,9,2,2,2,0,0,0,0,0,0,4,4,4,0,0,0,0,0,0,0,0,0,0,0,68628
23768,1005,64,370,408,131,32,75,32,32,19,3,10,0,0,0,0,0,0,0,0,0,43,41,18,0,23,2,2,2,0,0,0,0,0,0,68629
23769,317,17,155,113,28,4,31,24,24,24,0,0,0,0,0,0,0,0,0,0,0,7,7,1,0,6,0,0,0,0,0,0,0,0,0,68631
23770,2518,306,1022,826,231,133,261,122,118,48,8,62,4,4,4,0,0,0,0,0,0,139,139,19,0,120,0,0,0,0,0,0,0,0,0,68632
23771,1035,163,470,272,119,11,81,43,43,5,0,38,0,0,0,0,0,0,0,0,0,38,38,11,0,27,0,0,0,0,0,0,0,0,0,68633
23772,253,20,119,97,9,8,18,12,12,10,0,2,0,0,0,0,0,0,0,0,0,6,6,2,0,4,0,0,0,0,0,0,0,0,0,68634
23773,289,24,127,97,28,13,15,10,10,0,5,5,0,0,0,0,0,0,0,0,0,5,5,0,0,5,0,0,0,0,0,0,0,0,0,68635
23774,784,81,292,251,128,32,42,5,5,0,0,5,0,0,0,0,0,0,0,0,0,37,37,5,0,32,0,0,0,0,0,0,0,0,0,68636
23775,204,22,87,66,24,5,45,5,5,5,0,0,0,0,0,0,0,0,0,0,0,40,40,23,0,17,0,0,0,0,0,0,0,0,0,68637
23776,1280,152,437,523,110,58,46,27,27,17,0,10,0,0,0,0,0,0,0,0,0,19,13,9,0,4,6,6,0,0,6,0,0,0,0,68638
23777,1096,123,453,334,122,64,104,33,29,6,0,23,4,4,0,4,0,0,0,0,0,71,54,17,0,37,17,16,16,0,0,1,0,0,1,68640
23778,809,71,266,317,100,55,56,27,27,6,0,21,0,0,0,0,0,0,0,0,0,29,29,9,0,20,0,0,0,0,0,0,0,0,0,68641
23779,1121,88,460,406,125,42,131,62,56,20,0,36,6,6,6,0,0,0,0,0,0,69,67,32,0,35,2,0,0,0,0,2,2,0,0,68642
23780,690,43,259,258,106,24,19,5,5,0,0,5,0,0,0,0,0,0,0,0,0,14,14,11,3,0,0,0,0,0,0,0,0,0,0,68643
23781,657,41,250,261,89,16,41,13,13,3,0,10,0,0,0,0,0,0,0,0,0,28,26,8,0,18,2,2,2,0,0,0,0,0,0,68644
23782,357,30,135,166,25,1,48,42,42,18,1,23,0,0,0,0,0,0,0,0,0,6,4,0,1,3,2,2,0,2,0,0,0,0,0,68647
23783,307,14,70,145,43,35,13,11,11,4,0,7,0,0,0,0,0,0,0,0,0,2,2,0,0,2,0,0,0,0,0,0,0,0,0,68648
23784,1271,106,529,385,141,110,107,38,32,24,0,8,6,6,0,0,6,0,0,0,0,69,65,11,0,54,4,0,0,0,0,4,4,0,0,68649
23785,1066,47,346,444,169,60,73,36,25,4,0,21,11,11,11,0,0,0,0,0,0,37,37,4,8,25,0,0,0,0,0,0,0,0,0,68651
23786,599,30,309,208,42,10,18,5,5,0,2,3,0,0,0,0,0,0,0,0,0,13,13,7,0,6,0,0,0,0,0,0,0,0,0,68652
23787,606,45,239,275,33,14,63,43,38,17,0,21,5,5,5,0,0,0,0,0,0,20,20,16,0,4,0,0,0,0,0,0,0,0,0,68653
23788,347,11,171,112,34,19,28,11,7,2,0,5,4,4,0,0,4,0,0,0,0,17,17,8,2,7,0,0,0,0,0,0,0,0,0,68654
23789,87,11,41,31,4,0,3,3,3,0,0,3,0,0,0,0,0,0,0,0,0,0,0,0,0,0,0,0,0,0,0,0,0,0,0,68655
23790,551,25,168,263,73,22,28,13,13,4,0,9,0,0,0,0,0,0,0,0,0,15,2,2,0,0,13,0,0,0,0,13,13,0,0,68658
23791,115,11,35,40,29,0,19,2,2,1,0,1,0,0,0,0,0,0,0,0,0,17,17,0,0,17,0,0,0,0,0,0,0,0,0,68659
23792,854,80,400,259,78,37,81,49,24,6,0,18,25,25,8,0,17,0,0,0,0,32,30,4,0,26,2,2,2,0,0,0,0,0,0,68660
23793,4147,1760,1147,768,369,103,535,350,169,84,16,69,181,58,45,13,0,123,23,0,100,185,129,56,15,58,56,56,39,0,17,0,0,0,0,68661
23794,787,52,277,355,83,20,52,34,29,6,2,21,5,0,0,0,0,5,5,0,0,18,18,5,3,10,0,0,0,0,0,0,0,0,0,68662
23795,460,47,212,164,27,10,16,2,2,0,0,2,0,0,0,0,0,0,0,0,0,14,14,11,0,3,0,0,0,0,0,0,0,0,0,68663
23796,204,21,68,93,17,5,16,6,6,4,0,2,0,0,0,0,0,0,0,0,0,10,10,10,0,0,0,0,0,0,0,0,0,0,0,68664
23797,667,25,242,261,93,46,31,0,0,0,0,0,0,0,0,0,0,0,0,0,0,31,28,11,0,17,3,3,0,0,3,0,0,0,0,68665
23798,1161,100,382,389,210,80,75,45,41,28,6,7,4,0,0,0,0,4,0,4,0,30,25,16,9,0,5,5,5,0,0,0,0,0,0,68666
23799,123,35,52,27,9,0,9,0,0,0,0,0,0,0,0,0,0,0,0,0,0,9,9,0,0,9,0,0,0,0,0,0,0,0,0,68667
23800,298,23,107,123,32,13,29,6,6,1,0,5,0,0,0,0,0,0,0,0,0,23,23,2,0,21,0,0,0,0,0,0,0,0,0,68669
23801,19347,2058,5458,7471,3024,1336,1757,908,756,358,77,321,152,116,79,11,26,36,0,0,36,849,727,329,56,342,122,109,80,8,21,13,8,0,5,68701
23802,467,60,143,198,54,12,37,18,18,2,0,16,0,0,0,0,0,0,0,0,0,19,14,4,0,10,5,5,5,0,0,0,0,0,0,68710
23803,199,24,73,67,28,7,6,6,5,0,0,5,1,1,1,0,0,0,0,0,0,0,0,0,0,0,0,0,0,0,0,0,0,0,0,68711
23804,1399,97,490,540,218,54,85,44,37,25,0,12,7,7,7,0,0,0,0,0,0,41,36,24,0,12,5,5,5,0,0,0,0,0,0,68713
23805,892,60,328,308,156,40,64,21,20,8,3,9,1,1,1,0,0,0,0,0,0,43,43,24,0,19,0,0,0,0,0,0,0,0,0,68714
23806,885,84,240,407,96,58,108,66,60,40,0,20,6,6,6,0,0,0,0,0,0,42,32,12,0,20,10,10,4,0,6,0,0,0,0,68715
23807,680,95,299,189,44,53,42,38,38,3,8,27,0,0,0,0,0,0,0,0,0,4,4,4,0,0,0,0,0,0,0,0,0,0,0,68716
23808,148,2,79,60,5,2,27,5,5,0,0,5,0,0,0,0,0,0,0,0,0,22,11,11,0,0,11,11,11,0,0,0,0,0,0,68717
23809,1423,165,578,449,156,75,102,45,16,11,0,5,29,29,27,0,2,0,0,0,0,57,38,22,3,13,19,19,19,0,0,0,0,0,0,68718
23810,85,3,53,19,10,0,4,4,4,4,0,0,0,0,0,0,0,0,0,0,0,0,0,0,0,0,0,0,0,0,0,0,0,0,0,68719
23811,260,42,86,96,32,4,18,18,18,18,0,0,0,0,0,0,0,0,0,0,0,0,0,0,0,0,0,0,0,0,0,0,0,0,0,68720
23812,452,52,194,135,63,8,17,4,4,0,0,4,0,0,0,0,0,0,0,0,0,13,13,0,0,13,0,0,0,0,0,0,0,0,0,68722
23813,359,23,182,116,22,16,20,9,7,2,0,5,2,2,2,0,0,0,0,0,0,11,11,4,0,7,0,0,0,0,0,0,0,0,0,68723
23814,120,4,53,43,13,7,8,8,4,0,0,4,4,4,3,0,1,0,0,0,0,0,0,0,0,0,0,0,0,0,0,0,0,0,0,68724
23815,370,22,142,134,49,23,13,7,7,0,0,7,0,0,0,0,0,0,0,0,0,6,6,0,0,6,0,0,0,0,0,0,0,0,0,68725
23816,590,22,244,273,45,6,45,30,30,0,0,30,0,0,0,0,0,0,0,0,0,15,15,2,0,13,0,0,0,0,0,0,0,0,0,68726
23817,624,55,212,252,69,36,29,11,11,0,6,5,0,0,0,0,0,0,0,0,0,18,12,3,0,9,6,6,6,0,0,0,0,0,0,68727
23818,177,21,58,53,32,13,10,9,9,0,0,9,0,0,0,0,0,0,0,0,0,1,1,0,0,1,0,0,0,0,0,0,0,0,0,68728
23819,1267,123,516,426,135,67,158,86,85,8,5,72,1,1,1,0,0,0,0,0,0,72,64,55,9,0,8,2,2,0,0,6,0,0,6,68729
23820,1280,76,593,419,133,59,93,51,48,5,0,43,3,3,1,0,2,0,0,0,0,42,42,15,6,21,0,0,0,0,0,0,0,0,0,68730
23821,1838,364,723,484,175,92,138,69,61,39,0,22,8,8,8,0,0,0,0,0,0,69,67,19,7,41,2,0,0,0,0,2,0,2,0,68731
23822,182,11,82,66,20,3,9,4,4,0,0,4,0,0,0,0,0,0,0,0,0,5,5,5,0,0,0,0,0,0,0,0,0,0,0,68732
23823,888,97,380,278,87,46,80,60,60,56,0,4,0,0,0,0,0,0,0,0,0,20,20,9,0,11,0,0,0,0,0,0,0,0,0,68733
23824,98,14,23,45,8,8,18,10,10,10,0,0,0,0,0,0,0,0,0,0,0,8,8,0,0,8,0,0,0,0,0,0,0,0,0,68734
23825,653,35,241,270,70,37,55,29,22,14,1,7,7,7,7,0,0,0,0,0,0,26,22,9,0,13,4,4,4,0,0,0,0,0,0,68735
23826,448,30,203,135,80,0,56,2,2,2,0,0,0,0,0,0,0,0,0,0,0,54,54,29,0,25,0,0,0,0,0,0,0,0,0,68736
23827,1806,114,824,572,192,104,208,114,100,67,4,29,14,9,9,0,0,5,0,0,5,94,79,37,11,31,15,15,11,0,4,0,0,0,0,68739
23828,450,40,172,136,81,21,38,22,22,15,0,7,0,0,0,0,0,0,0,0,0,16,15,12,0,3,1,1,1,0,0,0,0,0,0,68740
23829,561,60,223,196,56,26,51,40,28,7,2,19,12,12,5,0,7,0,0,0,0,11,7,5,0,2,4,0,0,0,0,4,4,0,0,68741
23830,94,23,37,24,2,8,42,4,4,2,0,2,0,0,0,0,0,0,0,0,0,38,38,38,0,0,0,0,0,0,0,0,0,0,0,68742
23831,494,48,208,172,61,5,12,2,2,2,0,0,0,0,0,0,0,0,0,0,0,10,10,0,0,10,0,0,0,0,0,0,0,0,0,68743
23832,1153,51,402,409,219,72,80,61,57,18,7,32,4,4,4,0,0,0,0,0,0,19,19,12,7,0,0,0,0,0,0,0,0,0,0,68745
23833,303,23,125,120,28,7,38,34,26,0,0,26,8,1,0,0,1,7,0,0,7,4,4,0,0,4,0,0,0,0,0,0,0,0,0,68746
23834,99,11,33,15,29,11,0,0,0,0,0,0,0,0,0,0,0,0,0,0,0,0,0,0,0,0,0,0,0,0,0,0,0,0,0,68747
23835,2270,661,558,729,214,108,239,118,118,27,0,91,0,0,0,0,0,0,0,0,0,121,100,64,0,36,21,13,13,0,0,8,0,0,8,68748
23836,22,2,13,4,0,3,4,0,0,0,0,0,0,0,0,0,0,0,0,0,0,4,3,1,0,2,1,1,0,0,1,0,0,0,0,68749
23837,71,6,37,22,6,0,7,0,0,0,0,0,0,0,0,0,0,0,0,0,0,7,7,1,0,6,0,0,0,0,0,0,0,0,0,68751
23838,601,75,169,287,38,32,22,5,4,0,0,4,1,1,0,1,0,0,0,0,0,17,3,0,0,3,14,0,0,0,0,14,14,0,0,68752
23839,49,0,16,29,4,0,0,0,0,0,0,0,0,0,0,0,0,0,0,0,0,0,0,0,0,0,0,0,0,0,0,0,0,0,0,68753
23840,239,28,114,76,21,0,11,5,2,0,0,2,3,0,0,0,0,3,0,0,3,6,0,0,0,0,6,6,6,0,0,0,0,0,0,68755
23841,1463,151,545,474,214,79,82,29,29,17,0,12,0,0,0,0,0,0,0,0,0,53,24,15,0,9,29,16,16,0,0,13,0,0,13,68756
23842,523,60,207,161,63,32,49,34,27,11,9,7,7,7,1,0,6,0,0,0,0,15,15,2,0,13,0,0,0,0,0,0,0,0,0,68757
23843,742,95,234,261,126,26,44,22,22,4,5,13,0,0,0,0,0,0,0,0,0,22,22,12,2,8,0,0,0,0,0,0,0,0,0,68758
23844,203,36,70,84,11,2,6,5,4,0,0,4,1,0,0,0,0,1,1,0,0,1,1,0,0,1,0,0,0,0,0,0,0,0,0,68759
23845,890,137,351,287,73,42,62,29,26,5,1,20,3,3,0,1,2,0,0,0,0,33,24,11,1,12,9,9,8,0,1,0,0,0,0,68760
23846,331,47,144,108,15,17,14,10,10,4,5,1,0,0,0,0,0,0,0,0,0,4,4,2,0,2,0,0,0,0,0,0,0,0,0,68761
23847,3637,423,1238,1267,482,227,289,152,124,71,8,45,28,23,17,0,6,5,0,0,5,137,126,67,0,59,11,11,11,0,0,0,0,0,0,68763
23848,467,31,221,149,41,25,21,0,0,0,0,0,0,0,0,0,0,0,0,0,0,21,21,11,0,10,0,0,0,0,0,0,0,0,0,68764
23849,934,72,349,311,164,38,82,58,55,14,2,39,3,3,3,0,0,0,0,0,0,24,21,8,0,13,3,0,0,0,0,3,3,0,0,68765
23850,297,20,101,155,17,4,16,4,4,0,1,3,0,0,0,0,0,0,0,0,0,12,8,6,0,2,4,0,0,0,0,4,4,0,0,68766
23851,2208,150,851,795,342,70,187,74,74,27,12,35,0,0,0,0,0,0,0,0,0,113,97,44,0,53,16,10,10,0,0,6,6,0,0,68767
23852,489,31,174,220,48,16,21,9,9,2,0,7,0,0,0,0,0,0,0,0,0,12,12,4,0,8,0,0,0,0,0,0,0,0,0,68768
23853,1200,100,488,434,138,40,121,63,25,13,0,12,38,24,0,24,0,14,0,11,3,58,57,20,12,25,1,1,0,0,1,0,0,0,0,68769
23854,1102,94,365,454,122,67,54,22,22,15,4,3,0,0,0,0,0,0,0,0,0,32,32,7,0,25,0,0,0,0,0,0,0,0,0,68770
23855,1019,80,482,322,105,30,77,50,50,26,0,24,0,0,0,0,0,0,0,0,0,27,27,6,0,21,0,0,0,0,0,0,0,0,0,68771
23856,120,13,64,14,27,2,0,0,0,0,0,0,0,0,0,0,0,0,0,0,0,0,0,0,0,0,0,0,0,0,0,0,0,0,0,68773
23857,287,50,145,68,19,5,21,4,4,4,0,0,0,0,0,0,0,0,0,0,0,17,14,8,0,6,3,3,3,0,0,0,0,0,0,68774
23858,8859,2910,2655,2416,592,286,820,385,312,127,18,167,73,57,22,35,0,16,0,0,16,435,395,218,0,177,40,40,40,0,0,0,0,0,0,68776
23859,504,29,226,133,90,26,22,9,7,7,0,0,2,2,2,0,0,0,0,0,0,13,13,8,0,5,0,0,0,0,0,0,0,0,0,68777
23860,384,22,164,131,60,7,17,10,10,4,0,6,0,0,0,0,0,0,0,0,0,7,6,1,1,4,1,1,1,0,0,0,0,0,0,68778
23861,1756,129,624,739,194,70,140,90,80,30,0,50,10,10,0,10,0,0,0,0,0,50,37,16,0,21,13,13,10,3,0,0,0,0,0,68779
23862,705,63,215,257,124,46,40,13,11,4,0,7,2,2,1,0,1,0,0,0,0,27,24,5,0,19,3,0,0,0,0,3,0,0,3,68780
23863,1027,109,328,445,103,42,76,51,41,15,0,26,10,0,0,0,0,10,0,10,0,25,10,6,0,4,15,15,13,0,2,0,0,0,0,68781
23864,750,107,277,204,112,50,19,9,8,8,0,0,1,1,1,0,0,0,0,0,0,10,10,3,0,7,0,0,0,0,0,0,0,0,0,68783
23865,1507,278,505,433,192,99,101,50,50,18,15,17,0,0,0,0,0,0,0,0,0,51,51,20,0,31,0,0,0,0,0,0,0,0,0,68784
23866,138,14,73,33,13,5,14,9,9,7,0,2,0,0,0,0,0,0,0,0,0,5,5,0,0,5,0,0,0,0,0,0,0,0,0,68785
23867,730,70,244,264,119,33,37,12,12,2,0,10,0,0,0,0,0,0,0,0,0,25,25,10,0,15,0,0,0,0,0,0,0,0,0,68786
23868,3415,210,751,1094,873,487,995,423,423,146,50,227,0,0,0,0,0,0,0,0,0,572,572,213,41,318,0,0,0,0,0,0,0,0,0,68787
23869,3385,382,1319,1055,483,146,262,137,125,79,0,46,12,12,0,12,0,0,0,0,0,125,115,82,3,30,10,10,4,0,6,0,0,0,0,68788
23870,95,0,30,36,22,7,1,1,1,0,0,1,0,0,0,0,0,0,0,0,0,0,0,0,0,0,0,0,0,0,0,0,0,0,0,68789
23871,504,17,165,235,62,25,81,27,25,0,0,25,2,2,2,0,0,0,0,0,0,54,54,21,4,29,0,0,0,0,0,0,0,0,0,68790
23872,1182,141,434,396,151,60,57,21,21,7,0,14,0,0,0,0,0,0,0,0,0,36,34,0,7,27,2,2,0,0,2,0,0,0,0,68791
23873,267,30,109,102,23,3,12,8,8,0,0,8,0,0,0,0,0,0,0,0,0,4,4,0,0,4,0,0,0,0,0,0,0,0,0,68792
23874,19179,5081,5465,5989,1642,1002,1752,806,689,409,89,191,117,101,95,0,6,16,13,0,3,946,708,357,135,216,238,186,163,9,14,52,0,26,26,68801
23875,14977,1528,5170,5175,2150,954,1017,496,377,204,28,145,119,96,74,22,0,23,23,0,0,521,480,262,55,163,41,14,14,0,0,27,0,0,27,68803
23876,838,145,347,211,126,9,65,44,44,2,4,38,0,0,0,0,0,0,0,0,0,21,13,0,0,13,8,8,0,0,8,0,0,0,0,68810
23877,533,29,157,202,103,42,30,14,14,2,0,12,0,0,0,0,0,0,0,0,0,16,16,7,0,9,0,0,0,0,0,0,0,0,0,68812
23878,385,21,123,185,39,17,27,27,27,14,0,13,0,0,0,0,0,0,0,0,0,0,0,0,0,0,0,0,0,0,0,0,0,0,0,68813
23879,730,58,258,275,120,19,75,37,37,20,0,17,0,0,0,0,0,0,0,0,0,38,34,0,0,34,4,0,0,0,0,4,4,0,0,68814
23880,425,15,174,142,76,18,32,27,27,17,2,8,0,0,0,0,0,0,0,0,0,5,5,3,0,2,0,0,0,0,0,0,0,0,0,68815
23881,104,20,42,26,16,0,0,0,0,0,0,0,0,0,0,0,0,0,0,0,0,0,0,0,0,0,0,0,0,0,0,0,0,0,0,68816
23882,241,30,135,54,19,3,8,7,7,1,0,6,0,0,0,0,0,0,0,0,0,1,1,1,0,0,0,0,0,0,0,0,0,0,0,68817
23883,3525,205,1094,1326,637,263,233,150,150,40,6,104,0,0,0,0,0,0,0,0,0,83,68,39,0,29,15,0,0,0,0,15,15,0,0,68818
23884,295,22,126,112,32,3,24,21,16,8,0,8,5,5,2,3,0,0,0,0,0,3,3,1,0,2,0,0,0,0,0,0,0,0,0,68820
23885,62,2,39,21,0,0,10,7,6,2,0,4,1,1,1,0,0,0,0,0,0,3,3,0,0,3,0,0,0,0,0,0,0,0,0,68821
23886,3118,246,1147,1000,490,235,248,108,98,77,0,21,10,10,9,0,1,0,0,0,0,140,85,51,11,23,55,8,0,0,8,47,47,0,0,68822
23887,1698,90,835,547,187,39,89,45,45,10,0,35,0,0,0,0,0,0,0,0,0,44,44,13,0,31,0,0,0,0,0,0,0,0,0,68823
23888,828,60,287,340,88,53,78,17,17,7,0,10,0,0,0,0,0,0,0,0,0,61,61,11,0,50,0,0,0,0,0,0,0,0,0,68824
23889,777,41,264,311,110,51,42,23,16,5,0,11,7,3,0,3,0,4,0,4,0,19,19,11,0,8,0,0,0,0,0,0,0,0,0,68825
23890,2631,204,882,1030,332,183,290,125,122,85,10,27,3,3,0,3,0,0,0,0,0,165,165,144,6,15,0,0,0,0,0,0,0,0,0,68826
23891,516,46,178,216,55,21,25,6,6,0,0,6,0,0,0,0,0,0,0,0,0,19,19,0,0,19,0,0,0,0,0,0,0,0,0,68827
23892,146,9,67,46,22,2,17,11,11,3,0,8,0,0,0,0,0,0,0,0,0,6,6,6,0,0,0,0,0,0,0,0,0,0,0,68828
23893,565,28,239,196,64,38,48,30,28,13,0,15,2,2,1,1,0,0,0,0,0,18,18,0,0,18,0,0,0,0,0,0,0,0,0,68831
23894,1320,76,401,548,187,108,122,68,65,26,0,39,3,3,3,0,0,0,0,0,0,54,54,11,7,36,0,0,0,0,0,0,0,0,0,68832
23895,296,9,100,129,55,3,35,30,26,9,0,17,4,4,4,0,0,0,0,0,0,5,5,0,0,5,0,0,0,0,0,0,0,0,0,68833
23896,185,14,104,60,3,4,4,0,0,0,0,0,0,0,0,0,0,0,0,0,0,4,4,0,0,4,0,0,0,0,0,0,0,0,0,68834
23897,300,26,103,132,26,13,36,15,15,11,0,4,0,0,0,0,0,0,0,0,0,21,21,8,0,13,0,0,0,0,0,0,0,0,0,68835
23898,1040,68,404,324,196,48,115,65,58,23,5,30,7,7,0,5,2,0,0,0,0,50,50,13,0,37,0,0,0,0,0,0,0,0,0,68836
23899,45,0,38,3,4,0,2,0,0,0,0,0,0,0,0,0,0,0,0,0,0,2,2,2,0,0,0,0,0,0,0,0,0,0,0,68837
23900,193,14,127,40,12,0,19,14,14,14,0,0,0,0,0,0,0,0,0,0,0,5,5,0,0,5,0,0,0,0,0,0,0,0,0,68838
23901,1862,338,602,549,258,115,98,51,49,13,0,36,2,2,2,0,0,0,0,0,0,47,46,20,0,26,1,1,1,0,0,0,0,0,0,68840
23902,457,15,168,191,67,16,38,11,9,4,0,5,2,2,2,0,0,0,0,0,0,27,27,7,0,20,0,0,0,0,0,0,0,0,0,68841
23903,426,25,199,142,41,19,45,36,36,13,0,23,0,0,0,0,0,0,0,0,0,9,9,5,0,4,0,0,0,0,0,0,0,0,0,68842
23904,482,33,144,232,53,20,50,20,20,7,0,13,0,0,0,0,0,0,0,0,0,30,30,6,0,24,0,0,0,0,0,0,0,0,0,68843
23905,193,9,88,27,46,23,27,9,9,0,0,9,0,0,0,0,0,0,0,0,0,18,18,18,0,0,0,0,0,0,0,0,0,0,0,68844
23906,11209,649,2448,3588,3094,1430,2018,995,912,273,111,528,83,39,35,0,4,44,27,0,17,1023,992,499,97,396,31,18,0,18,0,13,13,0,0,68845
23907,273,19,136,77,32,9,41,35,35,3,0,32,0,0,0,0,0,0,0,0,0,6,6,0,0,6,0,0,0,0,0,0,0,0,0,68846
23908,10695,891,2886,3803,2234,881,458,276,220,66,0,154,56,17,0,10,7,39,12,19,8,182,175,64,14,97,7,5,5,0,0,2,2,0,0,68847
23909,0,0,0,0,0,0,211,68,68,32,12,24,0,0,0,0,0,0,0,0,0,143,143,88,22,33,0,0,0,0,0,0,0,0,0,68849
23910,7021,2859,1972,1460,610,120,749,389,333,57,17,259,56,43,33,0,10,13,0,0,13,360,291,61,70,160,69,16,0,14,2,53,18,0,35,68850
23911,485,33,202,181,50,19,27,18,16,14,0,2,2,0,0,0,0,2,2,0,0,9,9,0,2,7,0,0,0,0,0,0,0,0,0,68852
23912,1147,131,442,352,143,79,34,30,30,9,0,21,0,0,0,0,0,0,0,0,0,4,4,3,0,1,0,0,0,0,0,0,0,0,0,68853
23913,680,61,178,271,130,40,93,19,19,16,1,2,0,0,0,0,0,0,0,0,0,74,70,56,2,12,4,4,4,0,0,0,0,0,0,68854
23914,287,10,88,114,68,7,41,29,29,11,0,18,0,0,0,0,0,0,0,0,0,12,12,0,0,12,0,0,0,0,0,0,0,0,0,68855
23915,382,25,144,126,65,22,30,10,8,4,0,4,2,2,0,2,0,0,0,0,0,20,20,9,0,11,0,0,0,0,0,0,0,0,0,68856
23916,176,16,31,78,37,14,14,13,13,0,0,13,0,0,0,0,0,0,0,0,0,1,1,0,0,1,0,0,0,0,0,0,0,0,0,68858
23917,351,28,150,140,29,4,37,31,2,0,0,2,29,17,0,0,17,12,3,9,0,6,6,1,0,5,0,0,0,0,0,0,0,0,0,68859
23918,184,30,54,71,25,4,11,11,11,0,0,11,0,0,0,0,0,0,0,0,0,0,0,0,0,0,0,0,0,0,0,0,0,0,0,68860
23919,43,11,19,13,0,0,0,0,0,0,0,0,0,0,0,0,0,0,0,0,0,0,0,0,0,0,0,0,0,0,0,0,0,0,0,68861
23920,2178,143,887,741,287,120,123,33,32,5,0,27,1,0,0,0,0,1,0,0,1,90,90,30,0,60,0,0,0,0,0,0,0,0,0,68862
23921,782,122,293,259,89,19,80,30,30,12,0,18,0,0,0,0,0,0,0,0,0,50,50,16,5,29,0,0,0,0,0,0,0,0,0,68863
23922,895,86,378,293,114,24,81,49,44,17,1,26,5,3,3,0,0,2,0,0,2,32,32,2,0,30,0,0,0,0,0,0,0,0,0,68864
23923,623,58,196,188,110,71,50,22,14,5,1,8,8,8,8,0,0,0,0,0,0,28,28,13,1,14,0,0,0,0,0,0,0,0,0,68865
23924,622,24,201,265,114,18,29,6,6,6,0,0,0,0,0,0,0,0,0,0,0,23,19,5,0,14,4,4,0,0,4,0,0,0,0,68866
23925,1410,126,528,502,192,62,163,88,56,36,0,20,32,32,32,0,0,0,0,0,0,75,73,27,4,42,2,2,2,0,0,0,0,0,0,68869
23926,261,7,80,94,67,13,19,12,12,6,0,6,0,0,0,0,0,0,0,0,0,7,7,0,0,7,0,0,0,0,0,0,0,0,0,68870
23927,145,0,47,71,21,6,6,0,0,0,0,0,0,0,0,0,0,0,0,0,0,6,6,0,0,6,0,0,0,0,0,0,0,0,0,68871
23928,632,38,292,204,98,0,16,6,6,0,0,6,0,0,0,0,0,0,0,0,0,10,10,5,3,2,0,0,0,0,0,0,0,0,0,68872
23929,2246,182,797,779,317,171,144,77,77,54,0,23,0,0,0,0,0,0,0,0,0,67,67,14,25,28,0,0,0,0,0,0,0,0,0,68873
23930,759,82,292,263,99,23,51,29,29,16,0,13,0,0,0,0,0,0,0,0,0,22,22,6,0,16,0,0,0,0,0,0,0,0,0,68874
23931,440,53,201,137,32,17,61,42,23,6,0,17,19,19,19,0,0,0,0,0,0,19,18,10,0,8,1,1,1,0,0,0,0,0,0,68875
23932,986,104,375,330,122,55,114,32,32,0,0,32,0,0,0,0,0,0,0,0,0,82,78,35,0,43,4,4,4,0,0,0,0,0,0,68876
23933,304,18,86,126,65,9,11,6,6,5,1,0,0,0,0,0,0,0,0,0,0,5,5,5,0,0,0,0,0,0,0,0,0,0,0,68878
23934,276,27,121,97,21,10,29,6,6,0,0,6,0,0,0,0,0,0,0,0,0,23,23,1,0,22,0,0,0,0,0,0,0,0,0,68879
23935,62,0,22,26,14,0,9,4,4,4,0,0,0,0,0,0,0,0,0,0,0,5,5,5,0,0,0,0,0,0,0,0,0,0,0,68881
23936,349,23,165,128,25,8,22,15,15,0,0,15,0,0,0,0,0,0,0,0,0,7,7,0,7,0,0,0,0,0,0,0,0,0,0,68882
23937,1576,126,557,614,166,113,119,57,53,29,0,24,4,2,2,0,0,2,2,0,0,62,59,24,5,30,3,3,3,0,0,0,0,0,0,68883
23938,16728,1701,5421,6329,2119,1158,1797,896,847,218,180,449,49,30,29,1,0,19,19,0,0,901,887,435,36,416,14,7,7,0,0,7,7,0,0,68901
23939,1026,69,387,383,129,58,42,16,15,7,0,8,1,0,0,0,0,1,0,0,1,26,26,10,0,16,0,0,0,0,0,0,0,0,0,68920
23940,894,109,333,331,97,24,54,24,24,0,0,24,0,0,0,0,0,0,0,0,0,30,27,11,0,16,3,3,3,0,0,0,0,0,0,68922
23941,75,5,22,47,1,0,5,1,1,0,0,1,0,0,0,0,0,0,0,0,0,4,4,2,0,2,0,0,0,0,0,0,0,0,0,68923
23942,779,51,219,305,161,43,64,24,19,9,2,8,5,3,3,0,0,2,0,0,2,40,40,21,2,17,0,0,0,0,0,0,0,0,0,68924
23943,381,25,121,124,83,28,41,41,37,0,0,37,4,4,4,0,0,0,0,0,0,0,0,0,0,0,0,0,0,0,0,0,0,0,0,68925
23944,608,82,277,173,61,15,68,25,18,12,0,6,7,0,0,0,0,7,7,0,0,43,30,13,0,17,13,0,0,0,0,13,0,13,0,68926
23945,850,67,330,305,100,48,64,38,32,0,0,32,6,6,6,0,0,0,0,0,0,26,23,17,0,6,3,3,3,0,0,0,0,0,0,68927
23946,346,25,133,104,67,17,60,32,29,9,0,20,3,0,0,0,0,3,0,3,0,28,25,8,0,17,3,3,0,0,3,0,0,0,0,68928
23947,126,14,45,56,11,0,2,0,0,0,0,0,0,0,0,0,0,0,0,0,0,2,2,2,0,0,0,0,0,0,0,0,0,0,0,68929
23948,1007,74,363,370,142,58,93,43,43,8,0,35,0,0,0,0,0,0,0,0,0,50,50,15,11,24,0,0,0,0,0,0,0,0,0,68930
23949,279,37,109,96,35,2,12,6,0,0,0,0,6,5,5,0,0,1,0,1,0,6,6,0,0,6,0,0,0,0,0,0,0,0,0,68932
23950,687,39,261,240,105,42,61,29,29,0,8,21,0,0,0,0,0,0,0,0,0,32,32,7,10,15,0,0,0,0,0,0,0,0,0,68933
23951,65,5,42,12,0,6,0,0,0,0,0,0,0,0,0,0,0,0,0,0,0,0,0,0,0,0,0,0,0,0,0,0,0,0,0,68934
23952,577,35,258,170,71,43,38,13,13,6,2,5,0,0,0,0,0,0,0,0,0,25,25,19,0,6,0,0,0,0,0,0,0,0,0,68935
23953,115,11,33,42,29,0,0,0,0,0,0,0,0,0,0,0,0,0,0,0,0,0,0,0,0,0,0,0,0,0,0,0,0,0,0,68936
23954,1252,53,443,521,182,53,135,79,79,19,25,35,0,0,0,0,0,0,0,0,0,56,56,29,0,27,0,0,0,0,0,0,0,0,0,68937
23955,308,18,93,137,47,13,32,14,14,3,0,11,0,0,0,0,0,0,0,0,0,18,16,0,0,16,2,2,2,0,0,0,0,0,0,68938
23956,893,76,352,316,95,54,52,24,24,18,0,6,0,0,0,0,0,0,0,0,0,28,25,8,3,14,3,3,3,0,0,0,0,0,0,68939
23957,366,5,109,149,94,9,33,28,18,5,0,13,10,10,0,10,0,0,0,0,0,5,5,3,0,2,0,0,0,0,0,0,0,0,0,68940
23958,554,41,315,133,57,8,21,8,8,0,0,8,0,0,0,0,0,0,0,0,0,13,13,2,0,11,0,0,0,0,0,0,0,0,0,68941
23959,325,24,139,127,26,9,26,19,19,6,0,13,0,0,0,0,0,0,0,0,0,7,7,1,0,6,0,0,0,0,0,0,0,0,0,68942
23960,200,32,95,53,15,5,12,12,12,0,0,12,0,0,0,0,0,0,0,0,0,0,0,0,0,0,0,0,0,0,0,0,0,0,0,68943
23961,746,129,242,279,79,17,102,45,45,6,17,22,0,0,0,0,0,0,0,0,0,57,54,16,0,38,3,3,3,0,0,0,0,0,0,68944
23962,249,3,139,43,42,22,27,12,12,0,0,12,0,0,0,0,0,0,0,0,0,15,15,9,0,6,0,0,0,0,0,0,0,0,0,68945
23963,104,2,5,56,35,6,0,0,0,0,0,0,0,0,0,0,0,0,0,0,0,0,0,0,0,0,0,0,0,0,0,0,0,0,0,68946
23964,467,21,131,219,80,16,34,12,8,0,4,4,4,4,4,0,0,0,0,0,0,22,22,11,0,11,0,0,0,0,0,0,0,0,0,68947
23965,165,10,64,80,9,2,18,10,0,0,0,0,10,0,0,0,0,10,9,0,1,8,6,5,1,0,2,2,2,0,0,0,0,0,0,68948
23966,4559,266,1350,1952,729,262,246,168,152,46,0,106,16,16,16,0,0,0,0,0,0,78,73,31,0,42,5,5,5,0,0,0,0,0,0,68949
23967,245,28,116,78,23,0,21,19,15,0,4,11,4,4,4,0,0,0,0,0,0,2,2,0,0,2,0,0,0,0,0,0,0,0,0,68950
23968,85,10,34,36,0,5,0,0,0,0,0,0,0,0,0,0,0,0,0,0,0,0,0,0,0,0,0,0,0,0,0,0,0,0,0,68952
23969,90,0,23,59,8,0,20,20,20,20,0,0,0,0,0,0,0,0,0,0,0,0,0,0,0,0,0,0,0,0,0,0,0,0,0,68954
23970,1228,40,353,444,258,133,117,67,65,30,0,35,2,2,2,0,0,0,0,0,0,50,49,16,3,30,1,1,1,0,0,0,0,0,0,68955
23971,886,45,288,393,123,37,76,61,61,12,0,49,0,0,0,0,0,0,0,0,0,15,15,9,0,6,0,0,0,0,0,0,0,0,0,68956
23972,423,14,183,141,76,9,42,6,6,0,0,6,0,0,0,0,0,0,0,0,0,36,36,0,25,11,0,0,0,0,0,0,0,0,0,68957
23973,416,11,127,194,67,17,44,30,28,4,0,24,2,2,2,0,0,0,0,0,0,14,14,5,0,9,0,0,0,0,0,0,0,0,0,68958
23974,2676,235,747,1023,488,183,208,130,116,95,0,21,14,14,14,0,0,0,0,0,0,78,39,19,1,19,39,39,39,0,0,0,0,0,0,68959
23975,143,13,44,63,22,1,1,0,0,0,0,0,0,0,0,0,0,0,0,0,0,1,1,1,0,0,0,0,0,0,0,0,0,0,0,68960
23976,696,32,313,291,36,24,11,3,3,1,0,2,0,0,0,0,0,0,0,0,0,8,5,4,0,1,3,3,3,0,0,0,0,0,0,68961
23977,88,0,71,14,3,0,0,0,0,0,0,0,0,0,0,0,0,0,0,0,0,0,0,0,0,0,0,0,0,0,0,0,0,0,0,68964
23978,504,54,148,264,28,10,34,21,21,0,0,21,0,0,0,0,0,0,0,0,0,13,13,6,0,7,0,0,0,0,0,0,0,0,0,68966
23979,902,84,237,393,154,34,55,37,30,13,0,17,7,0,0,0,0,7,0,0,7,18,16,0,0,16,2,2,2,0,0,0,0,0,0,68967
23980,32,7,14,0,11,0,0,0,0,0,0,0,0,0,0,0,0,0,0,0,0,0,0,0,0,0,0,0,0,0,0,0,0,0,0,68969
23981,1048,116,401,379,74,78,58,23,18,5,5,8,5,5,5,0,0,0,0,0,0,35,33,7,0,26,2,2,2,0,0,0,0,0,0,68970
23982,424,30,180,151,54,9,20,9,9,7,0,2,0,0,0,0,0,0,0,0,0,11,0,0,0,0,11,11,11,0,0,0,0,0,0,68971
23983,213,22,105,47,29,10,3,0,0,0,0,0,0,0,0,0,0,0,0,0,0,3,3,1,0,2,0,0,0,0,0,0,0,0,0,68972
23984,300,16,113,116,37,18,20,17,16,5,0,11,1,1,1,0,0,0,0,0,0,3,2,1,1,0,1,1,0,1,0,0,0,0,0,68973
23985,101,10,51,28,6,6,7,1,1,0,0,1,0,0,0,0,0,0,0,0,0,6,5,1,0,4,1,1,0,1,0,0,0,0,0,68974
23986,81,17,17,28,19,0,14,12,12,6,0,6,0,0,0,0,0,0,0,0,0,2,0,0,0,0,2,2,0,2,0,0,0,0,0,68975
23987,146,14,33,63,33,3,5,0,0,0,0,0,0,0,0,0,0,0,0,0,0,5,5,0,0,5,0,0,0,0,0,0,0,0,0,68976
23988,238,16,94,103,18,7,12,6,6,2,0,4,0,0,0,0,0,0,0,0,0,6,6,3,0,3,0,0,0,0,0,0,0,0,0,68977
23989,1701,147,699,587,178,90,36,24,18,4,0,14,6,6,6,0,0,0,0,0,0,12,0,0,0,0,12,12,12,0,0,0,0,0,0,68978
23990,1328,266,388,406,189,79,86,49,42,10,0,32,7,7,7,0,0,0,0,0,0,37,37,20,0,17,0,0,0,0,0,0,0,0,0,68979
23991,323,22,74,131,86,10,27,13,10,9,0,1,3,0,0,0,0,3,1,0,2,14,9,7,0,2,5,5,5,0,0,0,0,0,0,68980
23992,173,21,61,45,42,4,8,2,2,0,0,2,0,0,0,0,0,0,0,0,0,6,6,4,0,2,0,0,0,0,0,0,0,0,0,68981
23993,468,30,169,161,84,24,36,20,20,16,3,1,0,0,0,0,0,0,0,0,0,16,16,9,0,7,0,0,0,0,0,0,0,0,0,68982
23994,6093,378,2198,2350,791,376,661,385,357,250,0,107,28,28,13,11,4,0,0,0,0,276,237,155,15,67,39,18,7,11,0,21,17,0,4,69001
23995,293,23,134,95,38,3,7,3,0,0,0,0,3,3,3,0,0,0,0,0,0,4,2,0,0,2,2,2,0,0,2,0,0,0,0,69020
23996,1040,57,365,380,183,55,41,9,9,0,0,9,0,0,0,0,0,0,0,0,0,32,28,11,0,17,4,4,0,4,0,0,0,0,0,69021
23997,1109,111,410,375,148,65,64,33,30,15,0,15,3,0,0,0,0,3,3,0,0,31,28,3,0,25,3,3,3,0,0,0,0,0,0,69022
23998,273,8,83,114,68,0,35,35,25,25,0,0,10,10,0,10,0,0,0,0,0,0,0,0,0,0,0,0,0,0,0,0,0,0,0,69023
23999,1028,29,314,475,152,58,58,40,40,9,0,31,0,0,0,0,0,0,0,0,0,18,18,5,0,13,0,0,0,0,0,0,0,0,0,69024
24000,661,26,199,292,62,82,124,70,68,18,10,40,2,2,2,0,0,0,0,0,0,54,49,28,0,21,5,5,5,0,0,0,0,0,0,69025
24001,162,11,56,68,25,2,8,0,0,0,0,0,0,0,0,0,0,0,0,0,0,8,5,3,0,2,3,0,0,0,0,3,0,0,3,69026
24002,83,0,17,44,13,9,0,0,0,0,0,0,0,0,0,0,0,0,0,0,0,0,0,0,0,0,0,0,0,0,0,0,0,0,0,69027
24003,640,41,249,222,109,19,61,43,43,10,1,32,0,0,0,0,0,0,0,0,0,18,18,4,0,14,0,0,0,0,0,0,0,0,0,69028
24004,288,14,102,112,51,9,7,3,3,0,0,3,0,0,0,0,0,0,0,0,0,4,4,0,0,4,0,0,0,0,0,0,0,0,0,69029
24005,225,33,89,75,25,3,15,15,15,0,0,15,0,0,0,0,0,0,0,0,0,0,0,0,0,0,0,0,0,0,0,0,0,0,0,69030
24006,355,45,85,136,70,19,31,27,27,4,0,23,0,0,0,0,0,0,0,0,0,4,4,0,0,4,0,0,0,0,0,0,0,0,0,69032
24007,1841,194,720,614,270,43,56,7,7,4,0,3,0,0,0,0,0,0,0,0,0,49,44,39,5,0,5,0,0,0,0,5,5,0,0,69033
24008,777,47,259,340,107,24,92,30,21,10,0,11,9,0,0,0,0,9,0,0,9,62,53,27,10,16,9,9,9,0,0,0,0,0,0,69034
24009,35,5,17,9,1,3,0,0,0,0,0,0,0,0,0,0,0,0,0,0,0,0,0,0,0,0,0,0,0,0,0,0,0,0,0,69036
24010,46,0,15,17,9,5,0,0,0,0,0,0,0,0,0,0,0,0,0,0,0,0,0,0,0,0,0,0,0,0,0,0,0,0,0,69037
24011,361,22,139,143,50,7,25,12,12,9,0,3,0,0,0,0,0,0,0,0,0,13,13,4,3,6,0,0,0,0,0,0,0,0,0,69038
24012,45,0,23,16,6,0,10,0,0,0,0,0,0,0,0,0,0,0,0,0,0,10,5,0,0,5,5,5,5,0,0,0,0,0,0,69039
24013,533,62,145,254,55,17,43,14,14,3,2,9,0,0,0,0,0,0,0,0,0,29,20,0,4,16,9,9,7,0,2,0,0,0,0,69040
24014,98,0,33,42,16,7,0,0,0,0,0,0,0,0,0,0,0,0,0,0,0,0,0,0,0,0,0,0,0,0,0,0,0,0,0,69041
24015,35,4,7,24,0,0,0,0,0,0,0,0,0,0,0,0,0,0,0,0,0,0,0,0,0,0,0,0,0,0,0,0,0,0,0,69042
24016,318,33,124,114,35,12,20,0,0,0,0,0,0,0,0,0,0,0,0,0,0,20,20,4,7,9,0,0,0,0,0,0,0,0,0,69043
24017,520,56,181,224,30,29,24,21,21,0,0,21,0,0,0,0,0,0,0,0,0,3,3,1,0,2,0,0,0,0,0,0,0,0,0,69044
24018,795,68,273,322,100,32,66,35,35,5,10,20,0,0,0,0,0,0,0,0,0,31,27,8,7,12,4,0,0,0,0,4,0,0,4,69045
24019,146,27,32,66,15,6,2,2,2,2,0,0,0,0,0,0,0,0,0,0,0,0,0,0,0,0,0,0,0,0,0,0,0,0,0,69046
24020,20060,1805,6679,7680,2816,1080,1492,756,619,189,39,391,137,82,41,41,0,55,44,11,0,736,665,314,106,245,71,71,0,14,57,0,0,0,0,69101
24021,740,38,259,275,125,43,52,31,28,6,0,22,3,3,0,0,3,0,0,0,0,21,21,11,5,5,0,0,0,0,0,0,0,0,0,69120
24022,305,18,66,127,77,17,17,14,14,6,0,8,0,0,0,0,0,0,0,0,0,3,3,1,0,2,0,0,0,0,0,0,0,0,0,69121
24023,518,42,175,226,57,18,21,9,7,0,0,7,2,2,2,0,0,0,0,0,0,12,12,5,0,7,0,0,0,0,0,0,0,0,0,69122
24024,590,32,184,247,96,31,38,11,11,3,2,6,0,0,0,0,0,0,0,0,0,27,17,5,0,12,10,0,0,0,0,10,0,10,0,69123
24025,283,29,119,107,20,8,25,11,11,8,0,3,0,0,0,0,0,0,0,0,0,14,8,6,0,2,6,6,0,6,0,0,0,0,0,69125
24026,738,52,240,292,112,42,43,18,18,7,0,11,0,0,0,0,0,0,0,0,0,25,24,7,0,17,1,1,0,0,1,0,0,0,0,69127
24027,255,50,119,63,22,1,9,4,4,0,0,4,0,0,0,0,0,0,0,0,0,5,5,0,3,2,0,0,0,0,0,0,0,0,0,69128
24028,943,64,278,365,170,66,43,16,16,9,0,7,0,0,0,0,0,0,0,0,0,27,27,13,0,14,0,0,0,0,0,0,0,0,0,69129
24029,3711,409,1588,1005,468,241,323,154,118,63,11,44,36,36,36,0,0,0,0,0,0,169,169,90,7,72,0,0,0,0,0,0,0,0,0,69130
24030,392,29,126,166,54,17,11,8,8,0,1,7,0,0,0,0,0,0,0,0,0,3,3,3,0,0,0,0,0,0,0,0,0,0,0,69131
24031,91,4,36,26,25,0,14,2,2,2,0,0,0,0,0,0,0,0,0,0,0,12,12,0,0,12,0,0,0,0,0,0,0,0,0,69132
24032,281,31,82,124,29,15,5,1,1,0,0,1,0,0,0,0,0,0,0,0,0,4,4,0,0,4,0,0,0,0,0,0,0,0,0,69133
24033,233,12,63,82,49,27,3,0,0,0,0,0,0,0,0,0,0,0,0,0,0,3,3,0,0,3,0,0,0,0,0,0,0,0,0,69134
24034,54,0,3,0,45,6,10,0,0,0,0,0,0,0,0,0,0,0,0,0,0,10,10,0,0,10,0,0,0,0,0,0,0,0,0,69135
24035,2980,286,1145,825,546,178,231,143,126,36,26,64,17,0,0,0,0,17,0,17,0,88,74,48,0,26,14,0,0,0,0,14,0,0,14,69138
24036,1301,96,352,564,177,112,75,57,50,0,0,50,7,0,0,0,0,7,7,0,0,18,18,11,0,7,0,0,0,0,0,0,0,0,0,69140
24037,262,24,93,92,37,16,8,2,2,0,0,2,0,0,0,0,0,0,0,0,0,6,6,0,0,6,0,0,0,0,0,0,0,0,0,69141
24038,84,16,30,14,14,10,6,6,2,0,0,2,4,2,0,0,2,2,0,0,2,0,0,0,0,0,0,0,0,0,0,0,0,0,0,69142
24039,1002,26,352,423,150,51,80,40,37,9,0,28,3,0,0,0,0,3,0,0,3,40,40,26,0,14,0,0,0,0,0,0,0,0,0,69143
24040,131,6,30,32,63,0,5,0,0,0,0,0,0,0,0,0,0,0,0,0,0,5,5,5,0,0,0,0,0,0,0,0,0,0,0,69144
24041,2229,326,695,820,236,152,129,96,69,46,0,23,27,27,27,0,0,0,0,0,0,33,28,19,0,9,5,5,5,0,0,0,0,0,0,69145
24042,280,19,135,105,19,2,0,0,0,0,0,0,0,0,0,0,0,0,0,0,0,0,0,0,0,0,0,0,0,0,0,0,0,0,0,69146
24043,558,12,210,221,90,25,34,9,7,0,0,7,2,2,0,2,0,0,0,0,0,25,25,0,0,25,0,0,0,0,0,0,0,0,0,69147
24044,126,9,52,31,34,0,14,9,9,0,0,9,0,0,0,0,0,0,0,0,0,5,5,5,0,0,0,0,0,0,0,0,0,0,0,69148
24045,498,31,146,210,87,24,53,29,29,23,0,6,0,0,0,0,0,0,0,0,0,24,23,4,0,19,1,0,0,0,0,1,0,0,1,69149
24046,386,70,127,133,52,4,31,20,20,0,7,13,0,0,0,0,0,0,0,0,0,11,8,1,0,7,3,0,0,0,0,3,3,0,0,69150
24047,602,46,210,260,73,13,85,34,34,8,2,24,0,0,0,0,0,0,0,0,0,51,44,23,0,21,7,7,7,0,0,0,0,0,0,69151
24048,624,29,197,241,127,30,34,26,26,14,4,8,0,0,0,0,0,0,0,0,0,8,8,6,0,2,0,0,0,0,0,0,0,0,0,69152
24049,4083,345,1450,1435,621,232,251,146,84,58,0,26,62,54,54,0,0,8,0,0,8,105,59,18,17,24,46,24,24,0,0,22,22,0,0,69153
24050,1031,89,352,396,127,67,44,27,27,0,3,24,0,0,0,0,0,0,0,0,0,17,17,5,0,12,0,0,0,0,0,0,0,0,0,69154
24051,666,62,162,301,103,38,72,37,24,15,0,9,13,6,6,0,0,7,7,0,0,35,23,17,0,6,12,8,3,0,5,4,4,0,0,69155
24052,409,36,124,147,90,12,56,39,39,31,0,8,0,0,0,0,0,0,0,0,0,17,17,1,0,16,0,0,0,0,0,0,0,0,0,69156
24053,13,0,8,0,5,0,0,0,0,0,0,0,0,0,0,0,0,0,0,0,0,0,0,0,0,0,0,0,0,0,0,0,0,0,0,69157
24054,51,9,18,15,9,0,3,0,0,0,0,0,0,0,0,0,0,0,0,0,0,3,3,0,0,3,0,0,0,0,0,0,0,0,0,69161
24055,5454,354,1457,2214,1046,383,323,137,103,65,0,38,34,34,34,0,0,0,0,0,0,186,186,137,0,49,0,0,0,0,0,0,0,0,0,69162
24056,601,45,190,253,95,18,33,5,2,0,0,2,3,3,0,0,3,0,0,0,0,28,28,15,2,11,0,0,0,0,0,0,0,0,0,69163
24057,1316,68,459,567,157,65,114,46,46,11,4,31,0,0,0,0,0,0,0,0,0,68,62,11,13,38,6,0,0,0,0,6,0,0,6,69165
24058,468,8,102,256,78,24,39,11,11,3,0,8,0,0,0,0,0,0,0,0,0,28,28,14,0,14,0,0,0,0,0,0,0,0,0,69166
24059,206,14,66,73,51,2,2,2,2,0,0,2,0,0,0,0,0,0,0,0,0,0,0,0,0,0,0,0,0,0,0,0,0,0,0,69167
24060,166,17,44,48,29,28,0,0,0,0,0,0,0,0,0,0,0,0,0,0,0,0,0,0,0,0,0,0,0,0,0,0,0,0,0,69168
24061,394,47,77,154,100,16,32,24,24,0,0,24,0,0,0,0,0,0,0,0,0,8,6,0,0,6,2,0,0,0,0,2,2,0,0,69169
24062,254,24,77,114,37,2,18,9,9,0,0,9,0,0,0,0,0,0,0,0,0,9,7,0,0,7,2,0,0,0,0,2,2,0,0,69170
24063,11,0,6,5,0,0,0,0,0,0,0,0,0,0,0,0,0,0,0,0,0,0,0,0,0,0,0,0,0,0,0,0,0,0,0,69171
24064,2928,233,1049,1067,421,158,50,20,20,0,2,18,0,0,0,0,0,0,0,0,0,30,23,13,0,10,7,7,7,0,0,0,0,0,0,69201
24065,1782,155,608,627,273,119,170,88,49,43,0,6,39,38,38,0,0,1,0,0,1,82,27,2,0,25,55,53,32,0,21,2,2,0,0,69210
24066,219,8,59,91,54,7,27,13,13,4,0,9,0,0,0,0,0,0,0,0,0,14,9,5,0,4,5,5,0,0,5,0,0,0,0,69211
24067,203,7,58,100,23,15,48,19,19,0,0,19,0,0,0,0,0,0,0,0,0,29,29,16,0,13,0,0,0,0,0,0,0,0,0,69212
24068,190,13,59,60,58,0,6,4,4,3,0,1,0,0,0,0,0,0,0,0,0,2,2,0,2,0,0,0,0,0,0,0,0,0,0,69214
24069,110,21,32,34,15,8,5,2,2,2,0,0,0,0,0,0,0,0,0,0,0,3,3,0,0,3,0,0,0,0,0,0,0,0,0,69216
24070,348,39,153,104,24,28,16,12,12,6,0,6,0,0,0,0,0,0,0,0,0,4,0,0,0,0,4,0,0,0,0,4,1,0,3,69217
24071,94,15,40,35,4,0,5,0,0,0,0,0,0,0,0,0,0,0,0,0,0,5,5,0,0,5,0,0,0,0,0,0,0,0,0,69218
24072,84,7,4,52,2,19,6,0,0,0,0,0,0,0,0,0,0,0,0,0,0,6,0,0,0,0,6,6,6,0,0,0,0,0,0,69219
24073,56,0,21,13,22,0,0,0,0,0,0,0,0,0,0,0,0,0,0,0,0,0,0,0,0,0,0,0,0,0,0,0,0,0,0,69220
24074,164,9,12,118,16,9,0,0,0,0,0,0,0,0,0,0,0,0,0,0,0,0,0,0,0,0,0,0,0,0,0,0,0,0,0,69221
24075,6792,690,2354,2572,877,299,512,233,230,84,6,140,3,3,3,0,0,0,0,0,0,279,169,12,8,149,110,108,47,0,61,2,0,0,2,69301
24076,19,8,0,11,0,0,0,0,0,0,0,0,0,0,0,0,0,0,0,0,0,0,0,0,0,0,0,0,0,0,0,0,0,0,0,69331
24077,173,15,55,61,31,11,3,3,3,0,0,3,0,0,0,0,0,0,0,0,0,0,0,0,0,0,0,0,0,0,0,0,0,0,0,69333
24078,1657,259,558,550,224,66,53,38,32,18,0,14,6,6,6,0,0,0,0,0,0,15,13,8,0,5,2,2,2,0,0,0,0,0,0,69334
24079,5,0,3,0,2,0,0,0,0,0,0,0,0,0,0,0,0,0,0,0,0,0,0,0,0,0,0,0,0,0,0,0,0,0,0,69335
24080,1709,178,617,555,304,55,128,44,36,10,0,26,8,0,0,0,0,8,0,4,4,84,77,42,3,32,7,0,0,0,0,7,0,7,0,69336
24081,4264,273,882,1199,1275,635,872,346,324,118,7,199,22,14,0,0,14,8,0,0,8,526,464,223,40,201,62,41,41,0,0,21,0,0,21,69337
24082,1171,102,382,410,157,120,93,69,64,20,2,42,5,5,0,0,5,0,0,0,0,24,24,11,0,13,0,0,0,0,0,0,0,0,0,69339
24083,100,0,26,72,2,0,17,15,9,9,0,0,6,6,0,0,6,0,0,0,0,2,2,2,0,0,0,0,0,0,0,0,0,0,0,69340
24084,7163,622,2446,2663,926,506,597,320,264,90,15,159,56,14,0,14,0,42,30,0,12,277,268,114,41,113,9,6,6,0,0,3,0,0,3,69341
24085,1867,202,567,708,251,139,79,38,36,3,0,33,2,0,0,0,0,2,0,0,2,41,21,0,0,21,20,20,20,0,0,0,0,0,0,69343
24086,370,47,81,174,36,32,44,27,27,7,0,20,0,0,0,0,0,0,0,0,0,17,17,12,0,5,0,0,0,0,0,0,0,0,0,69345
24087,426,32,134,162,84,14,8,7,7,0,0,7,0,0,0,0,0,0,0,0,0,1,1,0,0,1,0,0,0,0,0,0,0,0,0,69346
24088,862,74,304,289,151,44,65,36,36,0,0,36,0,0,0,0,0,0,0,0,0,29,26,0,0,26,3,3,3,0,0,0,0,0,0,69347
24089,955,46,330,322,184,73,78,34,34,2,0,32,0,0,0,0,0,0,0,0,0,44,40,4,2,34,4,4,0,4,0,0,0,0,0,69348
24090,239,6,97,104,25,7,3,3,3,0,0,3,0,0,0,0,0,0,0,0,0,0,0,0,0,0,0,0,0,0,0,0,0,0,0,69350
24091,94,3,9,50,12,20,0,0,0,0,0,0,0,0,0,0,0,0,0,0,0,0,0,0,0,0,0,0,0,0,0,0,0,0,0,69351
24092,473,71,228,96,74,4,39,34,34,6,1,27,0,0,0,0,0,0,0,0,0,5,5,1,0,4,0,0,0,0,0,0,0,0,0,69352
24093,16,4,10,2,0,0,0,0,0,0,0,0,0,0,0,0,0,0,0,0,0,0,0,0,0,0,0,0,0,0,0,0,0,0,0,69353
24094,85,0,19,48,18,0,0,0,0,0,0,0,0,0,0,0,0,0,0,0,0,0,0,0,0,0,0,0,0,0,0,0,0,0,0,69354
24095,93,23,36,26,8,0,1,0,0,0,0,0,0,0,0,0,0,0,0,0,0,1,1,1,0,0,0,0,0,0,0,0,0,0,0,69355
24096,1240,148,326,545,104,117,121,68,44,0,0,44,24,14,14,0,0,10,10,0,0,53,50,11,0,39,3,3,0,0,3,0,0,0,0,69356
24097,2356,283,872,900,190,111,206,80,80,9,2,69,0,0,0,0,0,0,0,0,0,126,109,36,8,65,17,6,0,0,6,11,11,0,0,69357
24098,1164,195,293,456,163,57,101,51,38,19,5,14,13,6,6,0,0,7,0,0,7,50,44,9,4,31,6,6,3,3,0,0,0,0,0,69358
24099,992,100,302,306,204,80,53,35,35,14,5,16,0,0,0,0,0,0,0,0,0,18,18,4,0,14,0,0,0,0,0,0,0,0,0,69360
24100,12273,1849,3393,4341,1931,759,938,467,395,233,40,122,72,40,23,9,8,32,32,0,0,471,396,139,28,229,75,75,56,0,19,0,0,0,0,69361
24101,15,0,0,0,15,0,0,0,0,0,0,0,0,0,0,0,0,0,0,0,0,0,0,0,0,0,0,0,0,0,0,0,0,0,0,69365
24102,148,5,59,59,23,2,38,12,12,12,0,0,0,0,0,0,0,0,0,0,0,26,26,12,0,14,0,0,0,0,0,0,0,0,0,69366
24103,158,11,43,62,32,10,11,2,0,0,0,0,2,0,0,0,0,2,0,0,2,9,9,2,0,7,0,0,0,0,0,0,0,0,0,69367
24104,27802,3287,7749,8223,5582,2961,1588,768,575,124,22,429,193,182,84,58,40,11,0,0,11,820,668,227,60,381,152,40,10,0,30,112,44,6,62,70001
24105,13605,1909,2920,3994,2793,1989,874,588,578,131,0,447,10,10,9,0,1,0,0,0,0,286,257,39,0,218,29,19,19,0,0,10,0,0,10,70002
24106,27954,3474,7960,8669,5543,2308,1916,896,708,198,92,418,188,112,82,17,13,76,13,10,53,1020,875,285,116,474,145,94,94,0,0,51,0,36,15,70003
24107,18405,1670,4170,4894,4561,3110,876,419,342,92,0,250,77,76,75,0,1,1,0,0,1,457,447,124,8,315,10,10,10,0,0,0,0,0,0,70005
24108,11581,1425,3120,3126,2437,1473,701,338,238,109,16,113,100,0,0,0,0,100,44,0,56,363,304,62,28,214,59,3,0,0,3,56,0,56,0,70006
24109,3147,466,1515,713,271,182,329,118,110,7,39,64,8,0,0,0,0,8,8,0,0,211,126,0,0,126,85,65,0,35,30,20,0,0,20,70030
24110,964,112,345,286,164,57,30,11,0,0,0,0,11,0,0,0,0,11,0,11,0,19,15,5,0,10,4,4,0,2,2,0,0,0,0,70031
24111,2723,313,1125,951,237,97,159,66,54,0,0,54,12,12,0,11,1,0,0,0,0,93,93,16,0,77,0,0,0,0,0,0,0,0,0,70032
24112,863,294,360,159,42,8,80,0,0,0,0,0,0,0,0,0,0,0,0,0,0,80,57,31,0,26,23,0,0,0,0,23,0,23,0,70036
24113,10282,1522,3633,3285,1566,276,883,321,267,63,0,204,54,13,0,0,13,41,41,0,0,562,479,82,9,388,83,80,29,0,51,3,0,0,3,70037
24114,259,112,143,4,0,0,19,19,19,0,0,19,0,0,0,0,0,0,0,0,0,0,0,0,0,0,0,0,0,0,0,0,0,0,0,70038
24115,1170,198,366,267,269,70,118,35,0,0,0,0,35,35,16,0,19,0,0,0,0,83,65,0,0,65,18,18,18,0,0,0,0,0,0,70039
24116,1010,211,396,243,98,62,85,35,35,0,16,19,0,0,0,0,0,0,0,0,0,50,37,7,0,30,13,13,13,0,0,0,0,0,0,70040
24117,1520,404,603,330,143,40,118,70,61,0,0,61,9,0,0,0,0,9,0,0,9,48,48,7,9,32,0,0,0,0,0,0,0,0,0,70041
24118,11498,1953,4785,3159,1198,403,767,415,363,33,31,299,52,45,0,38,7,7,0,6,1,352,241,38,5,198,111,85,35,0,50,26,0,0,26,70043
24119,8570,718,2636,2832,1568,816,807,445,406,104,92,210,39,39,0,39,0,0,0,0,0,362,330,164,40,126,32,32,32,0,0,0,0,0,0,70047
24120,1403,245,611,410,108,29,156,71,71,32,0,39,0,0,0,0,0,0,0,0,0,85,60,0,0,60,25,0,0,0,0,25,0,0,25,70049
24121,14,14,0,0,0,0,0,0,0,0,0,0,0,0,0,0,0,0,0,0,0,0,0,0,0,0,0,0,0,0,0,0,0,0,0,70050
24122,1328,215,648,326,84,55,56,56,23,0,0,23,33,27,0,0,27,6,6,0,0,0,0,0,0,0,0,0,0,0,0,0,0,0,0,70051
24123,2309,397,906,562,327,117,161,87,54,10,0,44,33,14,7,7,0,19,19,0,0,74,61,16,6,39,13,13,0,0,13,0,0,0,0,70052
24124,11352,3155,4154,2456,1122,465,791,398,346,75,50,221,52,44,21,0,23,8,0,0,8,393,304,52,47,205,89,77,0,14,63,12,12,0,0,70053
24125,25239,3509,8194,7947,3930,1659,1932,1099,986,190,152,644,113,36,6,0,30,77,50,15,12,833,760,280,20,460,73,0,0,0,0,73,37,0,36,70056
24126,3083,823,1065,848,248,99,262,160,131,28,7,96,29,22,0,0,22,7,0,0,7,102,75,31,36,8,27,27,27,0,0,0,0,0,0,70057
24127,24936,4683,8401,6805,3502,1545,2653,1383,1142,240,102,800,241,169,47,35,87,72,43,11,18,1270,1060,85,19,956,210,135,23,0,112,75,5,0,70,70058
24128,11521,3027,4835,2586,803,270,935,591,302,16,102,184,289,87,54,0,33,202,116,51,35,344,251,68,63,120,93,52,40,0,12,41,11,30,0,70062
24129,35792,4701,10901,10924,6560,2706,2187,1130,1007,306,37,664,123,74,50,5,19,49,40,0,9,1057,905,318,0,587,152,66,0,10,56,86,17,4,65,70065
24130,2192,609,898,488,173,24,181,124,98,12,5,81,26,23,18,5,0,3,0,0,3,57,57,22,0,35,0,0,0,0,0,0,0,0,0,70067
24131,21543,3803,7905,6269,2607,959,2193,1116,978,235,127,616,138,86,41,12,33,52,42,0,10,1077,851,243,184,424,226,152,94,10,48,74,74,0,0,70068
24132,8164,1134,2683,2621,1344,382,802,411,406,78,15,313,5,5,0,5,0,0,0,0,0,391,329,125,0,204,62,53,53,0,0,9,0,0,9,70070
24133,2363,465,897,681,186,134,144,66,64,17,5,42,2,1,0,1,0,1,0,0,1,78,64,15,0,49,14,0,0,0,0,14,0,14,0,70071
24134,36454,8412,14361,9599,3022,1060,3640,1885,1418,233,56,1129,467,321,80,35,206,146,57,26,63,1755,1410,228,33,1149,345,241,29,56,156,104,19,22,63,70072
24135,2834,491,1077,893,352,21,313,176,137,15,0,122,39,19,13,6,0,20,0,20,0,137,105,43,8,54,32,17,0,0,17,15,0,0,15,70075
24136,158,111,37,10,0,0,28,28,20,0,0,20,8,8,0,8,0,0,0,0,0,0,0,0,0,0,0,0,0,0,0,0,0,0,0,70076
24137,1969,187,919,569,217,77,146,77,77,10,25,42,0,0,0,0,0,0,0,0,0,69,51,0,9,42,18,18,0,0,18,0,0,0,0,70079
24138,678,114,346,168,50,0,51,51,14,0,0,14,37,0,0,0,0,37,0,0,37,0,0,0,0,0,0,0,0,0,0,0,0,0,0,70080
24139,176,30,104,17,0,25,5,0,0,0,0,0,0,0,0,0,0,0,0,0,0,5,5,0,0,5,0,0,0,0,0,0,0,0,0,70082
24140,1570,530,686,274,62,18,147,147,122,0,0,122,25,4,0,0,4,21,21,0,0,0,0,0,0,0,0,0,0,0,0,0,0,0,0,70083
24141,4969,1233,1976,1165,472,123,417,256,210,14,35,161,46,29,18,0,11,17,0,0,17,161,141,42,26,73,20,20,7,7,6,0,0,0,0,70084
24142,2793,794,1194,639,130,36,255,122,84,4,17,63,38,28,19,9,0,10,0,10,0,133,98,13,0,85,35,32,12,0,20,3,0,3,0,70085
24143,1361,181,758,330,68,24,223,112,84,9,0,75,28,21,8,9,4,7,0,0,7,111,60,0,42,18,51,37,14,0,23,14,0,0,14,70086
24144,5492,1011,2099,1683,535,164,341,171,171,19,19,133,0,0,0,0,0,0,0,0,0,170,170,0,6,164,0,0,0,0,0,0,0,0,0,70087
24145,5331,981,2301,1359,464,226,435,292,244,64,29,151,48,31,31,0,0,17,0,0,17,143,143,19,14,110,0,0,0,0,0,0,0,0,0,70090
24146,140,62,45,26,7,0,51,18,18,0,0,18,0,0,0,0,0,0,0,0,0,33,33,0,0,33,0,0,0,0,0,0,0,0,0,70091
24147,4874,1092,2084,1202,360,136,348,139,127,17,0,110,12,0,0,0,0,12,0,0,12,209,154,36,12,106,55,47,36,11,0,8,0,8,0,70092
24148,20593,4943,8303,5931,1057,359,1726,981,771,129,62,580,210,90,60,17,13,120,84,0,36,745,624,63,128,433,121,79,49,30,0,42,0,0,42,70094
24149,2215,444,453,407,399,512,141,71,64,22,0,42,7,0,0,0,0,7,0,0,7,70,53,12,15,26,17,0,0,0,0,17,0,17,0,70112
24150,5359,1661,1800,983,569,346,584,353,212,6,0,206,141,49,13,36,0,92,8,42,42,231,177,35,54,88,54,32,0,27,5,22,0,11,11,70113
24151,15405,3253,5038,4341,1692,1081,1293,750,490,26,15,449,260,163,35,35,93,97,66,0,31,543,463,72,0,391,80,50,27,4,19,30,30,0,0,70114
24152,25517,2617,3882,5147,7148,6723,792,372,285,27,39,219,87,3,3,0,0,84,24,40,20,420,370,98,52,220,50,15,0,0,15,35,12,0,23,70115
24153,9552,1633,1988,2693,1839,1399,433,159,117,0,55,62,42,16,0,16,0,26,15,11,0,274,172,55,17,100,102,30,14,13,3,72,0,39,33,70116
24154,15661,3573,4947,3840,2025,1276,778,417,320,14,0,306,97,57,14,10,33,40,0,7,33,361,277,24,14,239,84,70,34,0,36,14,0,14,0,70117
24155,19763,2230,3656,4024,4942,4911,3280,1401,1349,269,72,1008,52,52,40,0,12,0,0,0,0,1879,1751,373,84,1294,128,63,27,35,1,65,0,0,65,70118
24156,26272,4767,7551,6479,4531,2944,1496,856,601,68,91,442,255,84,45,0,39,171,9,0,162,640,498,56,34,408,142,37,6,0,31,105,16,51,38,70119
24157,9334,1529,2918,2805,1436,646,368,173,131,21,5,105,42,33,9,24,0,9,0,0,9,195,185,45,28,112,10,0,0,0,0,10,0,0,10,70121
24158,20757,3063,5685,6162,3776,2071,2075,979,881,152,159,570,98,71,15,43,13,27,0,6,21,1096,993,109,67,817,103,89,31,21,37,14,0,0,14,70122
24159,19814,1506,4914,6155,4803,2436,784,406,393,107,21,265,13,4,0,0,4,9,9,0,0,378,324,51,43,230,54,12,12,0,0,42,42,0,0,70123
24160,13427,327,1328,3378,4644,3750,561,274,248,37,9,202,26,13,6,7,0,13,0,0,13,287,262,94,0,168,25,18,16,0,2,7,0,0,7,70124
24161,10029,1545,2148,2238,2455,1643,1579,698,664,59,49,556,34,18,6,0,12,16,0,16,0,881,823,162,76,585,58,25,8,0,17,33,16,7,10,70125
24162,14698,2662,4830,4730,1502,974,1313,704,588,49,91,448,116,80,32,41,7,36,0,0,36,609,526,39,19,468,83,63,0,17,46,20,0,15,5,70126
24163,13168,2139,4544,4686,1330,469,1570,844,721,65,28,628,123,86,0,63,23,37,0,0,37,726,638,120,105,413,88,88,47,0,41,0,0,0,0,70127
24164,11200,1689,2781,4411,1399,920,977,435,353,34,28,291,82,37,0,0,37,45,0,0,45,542,520,71,37,412,22,0,0,0,0,22,0,0,22,70128
24165,6090,2275,1450,1637,489,239,600,294,190,41,7,142,104,9,0,2,7,95,34,22,39,306,258,40,16,202,48,8,0,0,8,40,0,0,40,70129
24166,11212,1069,1343,2571,3565,2664,238,86,86,0,21,65,0,0,0,0,0,0,0,0,0,152,120,53,14,53,32,11,0,11,0,21,0,21,0,70130
24167,19528,2194,4757,5945,4168,2464,1380,579,539,28,107,404,40,24,24,0,0,16,0,0,16,801,756,51,28,677,45,45,32,0,13,0,0,0,0,70131
24168,0,0,0,0,0,0,0,0,0,0,0,0,0,0,0,0,0,0,0,0,0,0,0,0,0,0,0,0,0,0,0,0,0,0,0,70139
24169,0,0,0,0,0,0,0,0,0,0,0,0,0,0,0,0,0,0,0,0,0,0,0,0,0,0,0,0,0,0,0,0,0,0,0,70163
24170,28198,6547,10536,5336,3557,2222,3037,1481,1266,351,47,868,215,181,142,7,32,34,27,0,7,1556,1420,244,62,1114,136,63,20,0,43,73,36,0,37,70301
24171,4372,1438,1869,788,236,41,245,108,108,0,0,108,0,0,0,0,0,0,0,0,0,137,94,0,20,74,43,15,0,15,0,28,0,11,17,70339
24172,128,57,54,17,0,0,0,0,0,0,0,0,0,0,0,0,0,0,0,0,0,0,0,0,0,0,0,0,0,0,0,0,0,0,0,70340
24173,2750,707,1234,590,147,72,304,92,80,6,14,60,12,0,0,0,0,12,0,0,12,212,81,0,22,59,131,108,0,0,108,23,0,23,0,70341
24174,2884,718,1059,687,298,122,306,147,122,38,10,74,25,16,5,11,0,9,0,0,9,159,119,17,0,102,40,9,9,0,0,31,0,0,31,70342
24175,3203,652,1579,618,270,84,283,187,161,58,27,76,26,26,26,0,0,0,0,0,0,96,96,36,0,60,0,0,0,0,0,0,0,0,0,70343
24176,4005,1527,1615,531,219,113,446,245,144,19,21,104,101,76,34,32,10,25,25,0,0,201,195,45,0,150,6,6,6,0,0,0,0,0,0,70344
24177,5784,1668,2363,1120,503,130,614,157,146,36,0,110,11,0,0,0,0,11,11,0,0,457,338,112,32,194,119,119,106,13,0,0,0,0,0,70345
24178,7139,1421,3174,1529,785,230,844,487,376,123,14,239,111,66,8,0,58,45,0,0,45,357,338,80,17,241,19,19,0,0,19,0,0,0,0,70346
24179,160,31,100,29,0,0,27,0,0,0,0,0,0,0,0,0,0,0,0,0,0,27,27,0,0,27,0,0,0,0,0,0,0,0,0,70352
24180,557,228,233,69,20,7,62,0,0,0,0,0,0,0,0,0,0,0,0,0,0,62,13,0,0,13,49,0,0,0,0,49,39,0,10,70353
24181,3027,1031,1219,630,94,53,299,153,53,13,13,27,100,47,47,0,0,53,47,6,0,146,146,44,34,68,0,0,0,0,0,0,0,0,0,70354
24182,818,287,383,100,31,17,12,12,12,0,0,12,0,0,0,0,0,0,0,0,0,0,0,0,0,0,0,0,0,0,0,0,0,0,0,70355
24183,1527,541,731,230,17,8,71,12,12,0,0,12,0,0,0,0,0,0,0,0,0,59,59,0,0,59,0,0,0,0,0,0,0,0,0,70356
24184,2118,833,860,326,67,32,90,54,40,0,0,40,14,0,0,0,0,14,0,0,14,36,21,8,0,13,15,15,10,0,5,0,0,0,0,70357
24185,587,140,284,157,1,5,29,10,0,0,0,0,10,4,4,0,0,6,6,0,0,19,9,0,0,9,10,0,0,0,0,10,10,0,0,70358
24186,5154,1254,2254,1210,360,76,610,280,227,47,6,174,53,42,35,0,7,11,0,11,0,330,316,90,0,226,14,14,14,0,0,0,0,0,0,70359
24187,17810,2549,6104,4694,2960,1503,1585,690,591,75,60,456,99,91,76,0,15,8,0,0,8,895,775,371,37,367,120,88,27,18,43,32,32,0,0,70360
24188,17044,5730,6832,3343,756,383,1629,1058,720,94,109,517,338,171,104,60,7,167,33,12,122,571,422,158,38,226,149,124,0,56,68,25,13,0,12,70363
24189,19346,4535,7892,4404,1768,747,1308,662,415,147,15,253,247,65,41,24,0,182,47,0,135,646,469,134,37,298,177,166,71,0,95,11,0,0,11,70364
24190,1722,283,880,340,168,51,97,68,35,14,0,21,33,33,13,0,20,0,0,0,0,29,11,0,0,11,18,0,0,0,0,18,0,0,18,70372
24191,4625,1320,1798,978,423,106,431,268,148,49,0,99,120,51,29,22,0,69,69,0,0,163,135,64,33,38,28,28,28,0,0,0,0,0,0,70373
24192,4845,1103,2637,653,330,122,282,153,146,18,16,112,7,0,0,0,0,7,7,0,0,129,97,5,0,92,32,26,0,0,26,6,0,0,6,70374
24193,76,9,39,28,0,0,26,0,0,0,0,0,0,0,0,0,0,0,0,0,0,26,26,0,0,26,0,0,0,0,0,0,0,0,0,70375
24194,2968,1023,1506,301,107,31,405,268,166,31,4,131,102,75,49,0,26,27,27,0,0,137,103,21,0,82,34,0,0,0,0,34,10,0,24,70377
24195,15100,4379,5918,3283,1182,338,1316,727,513,92,22,399,214,106,59,47,0,108,39,1,68,589,424,96,29,299,165,84,67,12,5,81,2,63,16,70380
24196,4728,1473,1684,951,456,164,402,250,215,73,15,127,35,25,9,12,4,10,9,0,1,152,102,25,0,77,50,9,0,0,9,41,15,0,26,70390
24197,235,50,24,126,35,0,0,0,0,0,0,0,0,0,0,0,0,0,0,0,0,0,0,0,0,0,0,0,0,0,0,0,0,0,0,70391
24198,5314,1315,2112,1228,436,223,553,351,241,44,7,190,110,39,15,21,3,71,34,19,18,202,197,80,37,80,5,0,0,0,0,5,0,5,0,70392
24199,316,86,125,72,26,7,34,32,32,0,0,32,0,0,0,0,0,0,0,0,0,2,2,0,0,2,0,0,0,0,0,0,0,0,0,70393
24200,9879,2284,4030,2077,1184,304,718,419,291,0,0,291,128,16,16,0,0,112,16,0,96,299,267,103,37,127,32,32,9,0,23,0,0,0,0,70394
24201,3366,1075,1165,725,322,79,282,154,103,69,0,34,51,48,26,0,22,3,0,0,3,128,109,0,0,109,19,19,0,19,0,0,0,0,0,70395
24202,831,281,317,233,0,0,91,19,19,0,0,19,0,0,0,0,0,0,0,0,0,72,35,0,0,35,37,17,0,0,17,20,0,0,20,70397
24203,12587,2089,3644,3372,2161,1321,1654,779,694,192,157,345,85,51,51,0,0,34,0,0,34,875,742,316,46,380,133,64,43,21,0,69,28,10,31,70401
24204,0,0,0,0,0,0,602,178,178,49,0,129,0,0,0,0,0,0,0,0,0,424,424,207,0,217,0,0,0,0,0,0,0,0,0,70402
24205,16529,3356,5258,4334,2586,995,1187,496,355,86,47,222,141,22,0,0,22,119,30,42,47,691,515,133,118,264,176,114,56,14,44,62,0,17,45,70403
24206,6136,1014,2076,1493,1113,440,493,267,177,33,0,144,90,29,17,0,12,61,41,0,20,226,226,51,6,169,0,0,0,0,0,0,0,0,0,70420
24207,9340,1995,3281,2244,1339,481,1038,645,386,2,38,346,259,157,52,53,52,102,65,1,36,393,392,86,36,270,1,0,0,0,0,1,0,0,1,70422
24208,4415,1158,2111,863,119,164,449,188,154,19,2,133,34,20,20,0,0,14,0,0,14,261,201,67,0,134,60,15,0,0,15,45,2,9,34,70426
24209,13241,2996,5448,3432,910,455,916,385,371,59,18,294,14,14,14,0,0,0,0,0,0,531,485,195,51,239,46,38,0,7,31,8,7,0,1,70427
24210,3558,360,1300,996,589,313,111,43,43,14,0,29,0,0,0,0,0,0,0,0,0,68,68,22,0,46,0,0,0,0,0,0,0,0,0,70431
24211,21617,2107,4743,6975,5471,2321,1518,625,533,75,0,458,92,51,4,28,19,41,0,0,41,893,732,298,36,398,161,74,74,0,0,87,0,0,87,70433
24212,11957,1271,3854,4001,2071,760,791,349,307,22,0,285,42,42,11,8,23,0,0,0,0,442,391,171,58,162,51,41,32,9,0,10,0,0,10,70435
24213,543,356,96,48,43,0,33,25,25,0,0,25,0,0,0,0,0,0,0,0,0,8,8,0,0,8,0,0,0,0,0,0,0,0,0,70436
24214,5685,754,2100,1601,900,330,267,146,121,0,0,121,25,10,10,0,0,15,12,3,0,121,104,16,2,86,17,17,0,0,17,0,0,0,0,70437
24215,12162,2607,4727,3165,1289,374,756,427,350,37,0,313,77,62,62,0,0,15,0,0,15,329,225,26,0,199,104,15,15,0,0,89,0,0,89,70438
24216,3028,553,1237,969,134,135,420,209,202,9,33,160,7,0,0,0,0,7,0,0,7,211,195,13,60,122,16,16,0,16,0,0,0,0,0,70441
24217,187,68,47,38,23,11,0,0,0,0,0,0,0,0,0,0,0,0,0,0,0,0,0,0,0,0,0,0,0,0,0,0,0,0,0,70442
24218,5795,1505,2253,1371,449,217,436,229,176,36,0,140,53,6,6,0,0,47,0,8,39,207,160,13,20,127,47,47,10,8,29,0,0,0,0,70443
24219,6716,1634,2822,1596,387,277,486,244,155,0,12,143,89,31,8,0,23,58,24,34,0,242,181,34,14,133,61,49,0,0,49,12,0,0,12,70444
24220,7713,1658,2900,2205,692,258,428,248,217,28,37,152,31,0,0,0,0,31,0,31,0,180,176,69,0,107,4,2,0,0,2,2,0,0,2,70445
24221,4110,987,1465,934,549,175,292,126,124,13,0,111,2,1,0,0,1,1,0,0,1,166,166,14,56,96,0,0,0,0,0,0,0,0,0,70446
24222,6759,287,1407,1983,2091,991,508,320,289,67,22,200,31,11,11,0,0,20,0,0,20,188,174,69,7,98,14,14,14,0,0,0,0,0,0,70447
24223,16951,1072,2790,5059,5275,2755,1246,592,528,69,72,387,64,64,24,0,40,0,0,0,0,654,609,273,0,336,45,17,17,0,0,28,28,0,0,70448
24224,2990,576,1364,774,265,11,206,144,144,50,0,94,0,0,0,0,0,0,0,0,0,62,62,0,23,39,0,0,0,0,0,0,0,0,0,70449
24225,1912,502,752,457,144,57,163,62,51,0,0,51,11,11,0,11,0,0,0,0,0,101,45,11,0,34,56,20,0,20,0,36,0,0,36,70450
24226,27,0,0,17,10,0,0,0,0,0,0,0,0,0,0,0,0,0,0,0,0,0,0,0,0,0,0,0,0,0,0,0,0,0,0,70451
24227,8331,1513,3262,2441,852,263,537,315,200,59,14,127,115,78,38,30,10,37,0,17,20,222,173,34,0,139,49,49,5,25,19,0,0,0,0,70452
24228,719,87,303,232,74,23,9,9,0,0,0,0,9,9,0,9,0,0,0,0,0,0,0,0,0,0,0,0,0,0,0,0,0,0,0,70453
24229,16981,2179,6218,5202,2532,850,1545,778,684,284,136,264,94,0,0,0,0,94,0,44,50,767,666,152,103,411,101,56,36,0,20,45,0,15,30,70454
24230,776,103,350,248,57,18,47,15,15,0,0,15,0,0,0,0,0,0,0,0,0,32,32,0,0,32,0,0,0,0,0,0,0,0,0,70455
24231,1846,499,833,362,100,52,143,87,78,3,9,66,9,9,0,9,0,0,0,0,0,56,47,27,0,20,9,9,0,7,2,0,0,0,0,70456
24232,24167,3148,7174,7435,4060,2350,1814,1003,785,125,164,496,218,127,33,0,94,91,0,64,27,811,759,111,109,539,52,41,35,0,6,11,0,0,11,70458
24233,14036,2430,4373,4694,1762,777,1393,1002,896,172,29,695,106,81,0,63,18,25,14,0,11,391,347,128,36,183,44,11,0,0,11,33,0,8,25,70460
24234,18182,2187,5016,5893,3279,1807,1802,673,566,128,108,330,107,98,63,22,13,9,0,0,9,1129,898,228,93,577,231,183,131,0,52,48,35,0,13,70461
24235,3615,574,1529,912,425,175,352,165,62,19,8,35,103,103,73,30,0,0,0,0,0,187,175,39,0,136,12,0,0,0,0,12,0,0,12,70462
24236,109,28,72,1,3,5,4,4,4,0,0,4,0,0,0,0,0,0,0,0,0,0,0,0,0,0,0,0,0,0,0,0,0,0,0,70463
24237,351,43,228,80,0,0,0,0,0,0,0,0,0,0,0,0,0,0,0,0,0,0,0,0,0,0,0,0,0,0,0,0,0,0,0,70464
24238,452,139,171,132,0,10,64,8,8,0,4,4,0,0,0,0,0,0,0,0,0,56,38,0,15,23,18,9,0,0,9,9,0,9,0,70465
24239,5560,1413,2091,1226,602,228,461,293,270,0,42,228,23,7,3,4,0,16,0,0,16,168,79,30,0,49,89,32,15,17,0,57,0,24,33,70466
24240,13971,777,2574,4114,4202,2304,1558,912,817,196,79,542,95,95,15,0,80,0,0,0,0,646,570,167,0,403,76,57,38,19,0,19,19,0,0,70471
24241,18948,5560,6463,4526,1635,764,1877,934,639,184,22,433,295,65,26,8,31,230,9,19,202,943,837,349,87,401,106,58,32,21,5,48,9,0,39,70501
24242,17806,945,3084,4852,6006,2919,2199,1016,897,258,4,635,119,119,73,35,11,0,0,0,0,1183,1164,217,184,763,19,0,0,0,0,19,0,0,19,70503
24243,26694,4140,6896,8308,5168,2182,2665,1384,1125,414,76,635,259,212,63,38,111,47,39,0,8,1281,1145,496,66,583,136,130,130,0,0,6,6,0,0,70506
24244,10964,1585,3909,3554,1249,667,1014,526,349,103,0,246,177,91,78,0,13,86,40,0,46,488,424,87,70,267,64,28,4,14,10,36,0,36,0,70507
24245,23888,1710,5100,6520,7229,3329,1685,790,612,94,13,505,178,122,43,66,13,56,38,13,5,895,834,318,40,476,61,40,22,10,8,21,14,0,7,70508
24246,16528,4476,6833,3076,1675,468,1201,684,603,260,20,323,81,74,9,27,38,7,4,0,3,517,337,55,24,258,180,118,56,22,40,62,42,20,0,70510
24247,6660,1082,3471,1423,456,228,632,282,238,0,0,238,44,36,32,4,0,8,0,8,0,350,313,30,0,283,37,5,5,0,0,32,0,8,24,70512
24248,105,0,74,0,31,0,0,0,0,0,0,0,0,0,0,0,0,0,0,0,0,0,0,0,0,0,0,0,0,0,0,0,0,0,0,70513
24249,1502,321,708,257,147,69,172,74,63,0,0,63,11,0,0,0,0,11,0,0,11,98,80,26,0,54,18,18,10,8,0,0,0,0,0,70514
24250,2420,734,1087,420,95,84,120,87,48,17,0,31,39,4,0,0,4,35,0,0,35,33,23,0,0,23,10,10,1,0,9,0,0,0,0,70515
24251,670,99,243,266,36,26,147,37,27,15,12,0,10,5,0,0,5,5,0,0,5,110,97,0,22,75,13,13,13,0,0,0,0,0,0,70516
24252,17055,4147,7129,3577,1723,479,1353,887,695,111,42,542,192,116,116,0,0,76,51,0,25,466,332,62,0,270,134,96,46,21,29,38,11,0,27,70517
24253,8701,1227,2839,2367,1653,615,441,186,135,66,3,66,51,18,18,0,0,33,21,0,12,255,255,49,54,152,0,0,0,0,0,0,0,0,0,70518
24254,132,0,37,78,0,17,0,0,0,0,0,0,0,0,0,0,0,0,0,0,0,0,0,0,0,0,0,0,0,0,0,0,0,0,0,70519
24255,12116,2115,5071,3136,1429,365,841,442,373,103,25,245,69,30,30,0,0,39,32,0,7,399,382,79,15,288,17,0,0,0,0,17,7,0,10,70520
24256,449,149,207,68,18,7,48,39,35,2,0,33,4,2,1,1,0,2,2,0,0,9,7,0,0,7,2,2,2,0,0,0,0,0,0,70523
24257,322,84,140,51,30,17,54,48,48,0,0,48,0,0,0,0,0,0,0,0,0,6,6,0,0,6,0,0,0,0,0,0,0,0,0,70524
24258,8324,2432,3384,1891,490,127,565,299,222,78,0,144,77,8,0,0,8,69,23,33,13,266,209,39,7,163,57,31,0,13,18,26,0,6,20,70525
24259,12600,4080,4435,2757,1008,320,1438,768,564,62,66,436,204,48,12,11,25,156,11,46,99,670,564,85,143,336,106,61,22,13,26,45,8,0,37,70526
24260,1541,375,719,328,96,23,141,72,70,38,4,28,2,0,0,0,0,2,2,0,0,69,32,6,0,26,37,37,0,0,37,0,0,0,0,70528
24261,7244,1627,2836,1675,851,255,585,303,241,84,0,157,62,50,8,0,42,12,12,0,0,282,235,74,14,147,47,31,0,19,12,16,0,0,16,70529
24262,834,275,425,103,31,0,59,0,0,0,0,0,0,0,0,0,0,0,0,0,0,59,59,20,0,39,0,0,0,0,0,0,0,0,0,70531
24263,1873,411,719,364,270,109,149,86,82,0,0,82,4,4,4,0,0,0,0,0,0,63,60,0,0,60,3,3,3,0,0,0,0,0,0,70532
24264,4612,859,2484,846,361,62,297,180,122,46,0,76,58,57,35,4,18,1,0,0,1,117,95,34,0,61,22,0,0,0,0,22,0,22,0,70533
24265,672,191,321,82,73,5,40,28,21,4,5,12,7,7,2,0,5,0,0,0,0,12,7,0,0,7,5,5,0,0,5,0,0,0,0,70534
24266,11556,3136,3933,3093,1110,284,1188,664,504,143,5,356,160,49,28,0,21,111,46,0,65,524,418,91,21,306,106,73,34,25,14,33,6,0,27,70535
24267,379,102,267,10,0,0,34,34,28,0,0,28,6,6,6,0,0,0,0,0,0,0,0,0,0,0,0,0,0,0,0,0,0,0,0,70537
24268,9787,2473,4030,2276,628,380,750,345,225,25,18,182,120,107,38,17,52,13,0,1,12,405,349,47,60,242,56,23,18,3,2,33,33,0,0,70538
24269,250,41,114,51,27,17,32,8,5,0,0,5,3,3,0,0,3,0,0,0,0,24,24,0,0,24,0,0,0,0,0,0,0,0,0,70541
24270,2413,538,1244,472,133,26,109,71,53,36,0,17,18,0,0,0,0,18,18,0,0,38,14,3,0,11,24,24,0,7,17,0,0,0,0,70542
24271,2675,519,1322,612,174,48,202,99,99,51,3,45,0,0,0,0,0,0,0,0,0,103,68,17,0,51,35,18,18,0,0,17,0,0,17,70543
24272,7595,1904,3566,1406,437,282,545,285,132,8,0,124,153,143,64,7,72,10,10,0,0,260,192,5,34,153,68,58,58,0,0,10,0,10,0,70544
24273,10274,2394,4499,2140,822,419,995,468,338,85,45,208,130,96,50,40,6,34,0,22,12,527,443,115,0,328,84,28,0,28,0,56,0,34,22,70546
24274,6452,1827,2978,894,489,264,732,459,358,45,52,261,101,101,33,68,0,0,0,0,0,273,244,73,43,128,29,15,0,0,15,14,0,0,14,70548
24275,2715,794,1079,620,168,54,232,96,44,5,0,39,52,0,0,0,0,52,9,0,43,136,128,0,0,128,8,0,0,0,0,8,0,0,8,70549
24276,280,120,123,37,0,0,0,0,0,0,0,0,0,0,0,0,0,0,0,0,0,0,0,0,0,0,0,0,0,0,0,0,0,0,0,70550
24277,1018,201,552,188,51,26,31,25,20,5,6,9,5,5,5,0,0,0,0,0,0,6,4,0,0,4,2,0,0,0,0,2,0,0,2,70552
24278,3504,957,1477,626,256,188,198,132,80,0,33,47,52,18,8,0,10,34,0,34,0,66,66,0,0,66,0,0,0,0,0,0,0,0,0,70554
24279,5138,1134,1925,1256,635,188,621,203,127,36,0,91,76,53,53,0,0,23,10,0,13,418,256,12,14,230,162,94,2,72,20,68,0,0,68,70555
24280,166,50,35,21,40,20,9,0,0,0,0,0,0,0,0,0,0,0,0,0,0,9,5,0,0,5,4,4,4,0,0,0,0,0,0,70556
24281,93,54,39,0,0,0,0,0,0,0,0,0,0,0,0,0,0,0,0,0,0,0,0,0,0,0,0,0,0,0,0,0,0,0,0,70558
24282,1430,435,573,314,52,56,105,37,35,21,9,5,2,0,0,0,0,2,0,0,2,68,60,12,0,48,8,8,0,2,6,0,0,0,0,70559
24283,26583,7553,10885,5248,1915,982,2459,1140,827,227,76,524,313,118,87,20,11,195,0,64,131,1319,1089,147,121,821,230,191,69,92,30,39,10,5,24,70560
24284,12421,1431,4254,3975,1968,793,978,565,488,97,56,335,77,45,45,0,0,32,0,0,32,413,339,60,106,173,74,74,15,12,47,0,0,0,0,70563
24285,24588,5894,10329,4505,2620,1240,2216,1037,862,103,48,711,175,137,54,35,48,38,0,18,20,1179,976,81,31,864,203,160,64,82,14,43,0,25,18,70570
24286,36,0,0,16,20,0,0,0,0,0,0,0,0,0,0,0,0,0,0,0,0,0,0,0,0,0,0,0,0,0,0,0,0,0,0,70575
24287,1186,413,519,184,36,34,70,50,30,6,0,24,20,11,6,0,5,9,0,0,9,20,13,9,0,4,7,0,0,0,0,7,0,0,7,70576
24288,2651,535,1412,573,127,4,90,35,35,0,0,35,0,0,0,0,0,0,0,0,0,55,30,9,3,18,25,19,0,0,19,6,0,0,6,70577
24289,10856,3165,3545,2772,1051,323,737,397,367,130,29,208,30,19,19,0,0,11,0,0,11,340,290,49,57,184,50,36,20,8,8,14,0,0,14,70578
24290,57,48,9,0,0,0,0,0,0,0,0,0,0,0,0,0,0,0,0,0,0,0,0,0,0,0,0,0,0,0,0,0,0,0,0,70580
24291,652,66,274,229,55,28,49,7,7,7,0,0,0,0,0,0,0,0,0,0,0,42,17,0,0,17,25,0,0,0,0,25,25,0,0,70581
24292,12518,2879,5374,2473,1230,562,1064,499,416,181,6,229,83,15,15,0,0,68,0,0,68,565,467,162,7,298,98,57,57,0,0,41,0,0,41,70582
24293,6799,945,2865,2012,691,286,517,268,226,46,23,157,42,42,42,0,0,0,0,0,0,249,201,55,0,146,48,48,48,0,0,0,0,0,0,70583
24294,4774,926,2243,850,520,235,548,260,164,20,11,133,96,96,84,0,12,0,0,0,0,288,180,1,4,175,108,18,5,0,13,90,76,0,14,70584
24295,163,41,50,49,17,6,6,1,1,0,0,1,0,0,0,0,0,0,0,0,0,5,5,0,0,5,0,0,0,0,0,0,0,0,0,70585
24296,12470,4005,4124,2829,1064,448,1244,609,471,110,13,348,138,95,32,14,49,43,0,0,43,635,537,106,8,423,98,27,18,0,9,71,0,0,71,70586
24297,2060,336,955,366,273,130,235,188,113,0,16,97,75,68,44,0,24,7,7,0,0,47,47,0,0,47,0,0,0,0,0,0,0,0,0,70589
24298,3299,672,1272,1014,217,124,209,92,83,26,17,40,9,0,0,0,0,9,0,9,0,117,69,6,0,63,48,23,0,0,23,25,0,25,0,70591
24299,12600,1165,4246,3471,2993,725,854,431,332,93,65,174,99,87,84,3,0,12,0,0,12,423,289,131,12,146,134,63,63,0,0,71,0,23,48,70592
24300,20765,4447,7018,5961,2453,886,1883,839,601,111,112,378,238,128,128,0,0,110,54,43,13,1044,653,112,7,534,391,236,88,43,105,155,91,0,64,70601
24301,22312,1461,5329,7240,5453,2829,2222,1075,1018,346,55,617,57,49,12,8,29,8,0,0,8,1147,1096,287,67,742,51,51,40,0,11,0,0,0,0,70605
24302,16197,2521,5979,5046,1940,711,1531,827,660,105,75,480,167,67,20,35,12,100,0,63,37,704,593,258,12,323,111,72,37,16,19,39,0,0,39,70607
24303,12639,1072,4513,4334,2065,655,894,546,422,132,67,223,124,89,89,0,0,35,11,0,24,348,234,107,15,112,114,82,62,20,0,32,0,0,32,70611
24304,8568,2165,3223,2161,694,325,702,528,441,107,24,310,87,40,34,0,6,47,0,6,41,174,147,62,15,70,27,17,17,0,0,10,0,0,10,70615
24305,773,100,344,173,144,12,71,56,24,0,0,24,32,32,32,0,0,0,0,0,0,15,0,0,0,0,15,0,0,0,0,15,15,0,0,70630
24306,570,135,215,100,47,73,60,8,4,0,0,4,4,4,4,0,0,0,0,0,0,52,42,8,0,34,10,0,0,0,0,10,0,0,10,70631
24307,339,30,186,59,64,0,43,43,12,12,0,0,31,31,0,0,31,0,0,0,0,0,0,0,0,0,0,0,0,0,0,0,0,0,0,70632
24308,4914,923,2214,1227,417,133,391,245,172,25,0,147,73,57,41,12,4,16,0,16,0,146,127,10,32,85,19,19,19,0,0,0,0,0,0,70633
24309,16175,2442,6763,4251,1809,910,1500,676,393,69,30,294,283,236,161,29,46,47,10,4,33,824,698,174,38,486,126,45,14,15,16,81,18,1,62,70634
24310,384,50,191,59,57,27,31,24,24,24,0,0,0,0,0,0,0,0,0,0,0,7,7,0,0,7,0,0,0,0,0,0,0,0,0,70637
24311,545,103,226,149,62,5,63,44,28,8,3,17,16,13,0,0,13,3,3,0,0,19,7,0,0,7,12,0,0,0,0,12,0,0,12,70638
24312,332,42,246,40,0,4,51,9,0,0,0,0,9,3,3,0,0,6,6,0,0,42,42,15,0,27,0,0,0,0,0,0,0,0,0,70639
24313,224,59,101,22,37,5,0,0,0,0,0,0,0,0,0,0,0,0,0,0,0,0,0,0,0,0,0,0,0,0,0,0,0,0,0,70640
24314,231,18,101,60,38,14,2,1,1,0,1,0,0,0,0,0,0,0,0,0,0,1,1,0,0,1,0,0,0,0,0,0,0,0,0,70643
24315,106,0,41,23,34,8,18,6,6,0,0,6,0,0,0,0,0,0,0,0,0,12,0,0,0,0,12,0,0,0,0,12,0,0,12,70644
24316,915,175,426,268,42,4,26,20,20,9,0,11,0,0,0,0,0,0,0,0,0,6,4,0,0,4,2,2,2,0,0,0,0,0,0,70645
24317,265,32,220,13,0,0,58,44,44,0,0,44,0,0,0,0,0,0,0,0,0,14,14,0,0,14,0,0,0,0,0,0,0,0,0,70646
24318,5661,676,2351,1786,594,254,476,208,151,15,45,91,57,52,4,48,0,5,0,0,5,268,236,135,0,101,32,28,17,0,11,4,0,4,0,70647
24319,5714,1207,2316,1372,378,441,513,261,164,23,0,141,97,83,79,0,4,14,0,0,14,252,180,0,0,180,72,60,39,3,18,12,12,0,0,70648
24320,289,10,87,123,33,36,14,8,8,8,0,0,0,0,0,0,0,0,0,0,0,6,6,0,0,6,0,0,0,0,0,0,0,0,0,70650
24321,132,23,67,33,9,0,22,22,22,0,0,22,0,0,0,0,0,0,0,0,0,0,0,0,0,0,0,0,0,0,0,0,0,0,0,70651
24322,1388,190,499,446,194,59,67,67,22,22,0,0,45,0,0,0,0,45,45,0,0,0,0,0,0,0,0,0,0,0,0,0,0,0,0,70652
24323,2149,360,1132,522,100,35,185,108,98,11,0,87,10,10,10,0,0,0,0,0,0,77,48,16,0,32,29,29,0,0,29,0,0,0,0,70653
24324,75,19,34,22,0,0,0,0,0,0,0,0,0,0,0,0,0,0,0,0,0,0,0,0,0,0,0,0,0,0,0,0,0,0,0,70654
24325,1990,403,983,387,97,120,197,79,59,0,0,59,20,10,0,0,10,10,0,0,10,118,114,0,0,114,4,4,4,0,0,0,0,0,0,70655
24326,2422,559,1251,379,133,100,171,129,79,10,5,64,50,25,7,12,6,25,0,0,25,42,42,0,0,42,0,0,0,0,0,0,0,0,0,70656
24327,3325,625,1393,943,319,45,388,231,173,0,0,173,58,58,0,0,58,0,0,0,0,157,124,69,15,40,33,0,0,0,0,33,0,0,33,70657
24328,825,126,428,161,47,63,47,14,14,2,0,12,0,0,0,0,0,0,0,0,0,33,29,12,0,17,4,0,0,0,0,4,0,0,4,70658
24329,1009,159,399,304,125,22,25,19,7,0,0,7,12,6,0,6,0,6,0,0,6,6,6,6,0,0,0,0,0,0,0,0,0,0,0,70659
24330,2308,494,1201,375,141,97,111,62,53,5,0,48,9,9,0,0,9,0,0,0,0,49,39,29,0,10,10,10,0,0,10,0,0,0,0,70660
24331,1527,395,727,356,36,13,154,59,59,22,0,37,0,0,0,0,0,0,0,0,0,95,73,10,0,63,22,22,22,0,0,0,0,0,0,70661
24332,317,61,138,67,37,14,6,3,0,0,0,0,3,3,0,0,3,0,0,0,0,3,3,0,0,3,0,0,0,0,0,0,0,0,0,70662
24333,18444,2873,7443,4750,2365,1013,1726,846,675,156,15,504,171,110,98,0,12,61,21,24,16,880,701,201,14,486,179,132,26,26,80,47,12,0,35,70663
24334,6433,1005,2418,1766,971,273,442,244,232,68,61,103,12,12,0,0,12,0,0,0,0,198,138,81,14,43,60,11,11,0,0,49,7,0,42,70665
24335,4770,1253,2058,982,375,102,433,243,207,52,0,155,36,27,27,0,0,9,9,0,0,190,139,67,0,72,51,0,0,0,0,51,0,0,51,70668
24336,6508,1040,2358,2112,781,217,312,125,98,16,0,82,27,0,0,0,0,27,0,0,27,187,135,72,0,63,52,28,0,0,28,24,0,0,24,70669
24337,13627,1419,5871,3612,2118,607,1534,882,614,141,0,473,268,196,137,59,0,72,0,14,58,652,652,307,47,298,0,0,0,0,0,0,0,0,0,70706
24338,2277,365,820,597,396,99,193,123,116,39,4,73,7,7,7,0,0,0,0,0,0,70,63,13,0,50,7,7,7,0,0,0,0,0,0,70710
24339,3198,620,1246,739,415,178,323,204,183,51,43,89,21,21,0,21,0,0,0,0,0,119,102,35,0,67,17,14,0,0,14,3,0,0,3,70711
24340,4082,1822,1522,542,196,0,25,21,18,12,0,6,3,3,0,0,3,0,0,0,0,4,4,0,0,4,0,0,0,0,0,0,0,0,0,70712
24341,12465,1615,4838,3506,1683,823,1449,692,525,158,51,316,167,55,40,0,15,112,6,4,102,757,600,48,31,521,157,67,7,0,60,90,11,0,79,70714
24342,1105,160,471,331,125,18,161,33,33,11,0,22,0,0,0,0,0,0,0,0,0,128,63,4,0,59,65,65,0,0,65,0,0,0,0,70715
24343,2861,359,1069,778,378,277,390,145,78,25,0,53,67,67,0,0,67,0,0,0,0,245,237,148,4,85,8,8,8,0,0,0,0,0,0,70719
24344,574,86,196,162,116,14,178,83,83,27,5,51,0,0,0,0,0,0,0,0,0,95,82,5,10,67,13,13,13,0,0,0,0,0,0,70721
24345,4049,530,1660,1194,541,124,397,252,164,15,0,149,88,30,26,4,0,58,28,0,30,145,134,20,2,112,11,3,0,3,0,8,0,0,8,70722
24346,1077,427,410,211,29,0,125,48,26,0,7,19,22,0,0,0,0,22,0,0,22,77,29,29,0,0,48,48,12,0,36,0,0,0,0,70723
24347,1332,109,515,411,110,187,143,143,99,99,0,0,44,0,0,0,0,44,44,0,0,0,0,0,0,0,0,0,0,0,0,0,0,0,0,70725
24348,33819,5215,12524,9404,5323,1353,2504,1137,887,189,30,668,250,109,59,0,50,141,9,105,27,1367,1101,99,56,946,266,168,147,0,21,98,17,0,81,70726
24349,553,62,179,135,118,59,85,43,43,0,0,43,0,0,0,0,0,0,0,0,0,42,42,0,0,42,0,0,0,0,0,0,0,0,0,70729
24350,2556,244,1241,738,266,67,159,73,73,19,0,54,0,0,0,0,0,0,0,0,0,86,47,24,0,23,39,0,0,0,0,39,0,0,39,70730
24351,862,260,410,113,45,34,38,26,12,0,0,12,14,11,11,0,0,3,3,0,0,12,12,7,0,5,0,0,0,0,0,0,0,0,0,70732
24352,1185,222,588,304,53,18,83,19,15,9,0,6,4,4,0,4,0,0,0,0,0,64,64,12,0,52,0,0,0,0,0,0,0,0,0,70733
24353,4067,521,1081,1184,928,353,123,66,51,7,0,44,15,15,0,0,15,0,0,0,0,57,47,0,0,47,10,10,10,0,0,0,0,0,0,70734
24354,328,99,115,92,6,16,63,44,33,0,10,23,11,11,0,11,0,0,0,0,0,19,19,13,0,6,0,0,0,0,0,0,0,0,0,70736
24355,25212,2808,9611,7378,4132,1283,2210,1194,947,171,89,687,247,155,51,65,39,92,76,16,0,1016,815,405,39,371,201,201,10,0,191,0,0,0,0,70737
24356,9253,439,3166,3225,1652,771,635,314,293,84,13,196,21,9,9,0,0,12,0,12,0,321,301,74,0,227,20,17,0,0,17,3,0,0,3,70739
24357,798,234,280,252,23,9,86,23,6,0,0,6,17,8,8,0,0,9,0,0,9,63,45,0,0,45,18,18,0,0,18,0,0,0,0,70740
24358,146,14,13,86,20,13,0,0,0,0,0,0,0,0,0,0,0,0,0,0,0,0,0,0,0,0,0,0,0,0,0,0,0,0,0,70743
24359,3954,790,1708,992,326,138,318,238,236,112,0,124,2,0,0,0,0,2,0,1,1,80,37,0,0,37,43,0,0,0,0,43,0,0,43,70744
24360,66,0,49,17,0,0,0,0,0,0,0,0,0,0,0,0,0,0,0,0,0,0,0,0,0,0,0,0,0,0,0,0,0,0,0,70747
24361,4845,1404,2066,800,399,176,362,252,171,23,4,144,81,11,0,4,7,70,0,0,70,110,43,9,0,34,67,67,67,0,0,0,0,0,0,70748
24362,1034,179,526,242,72,15,33,11,11,0,11,0,0,0,0,0,0,0,0,0,0,22,22,0,22,0,0,0,0,0,0,0,0,0,0,70749
24363,1103,272,543,196,73,19,88,40,9,0,3,6,31,0,0,0,0,31,0,0,31,48,43,8,0,35,5,5,5,0,0,0,0,0,0,70750
24364,622,89,261,159,91,22,54,7,7,7,0,0,0,0,0,0,0,0,0,0,0,47,47,28,0,19,0,0,0,0,0,0,0,0,0,70752
24365,716,259,246,171,14,26,18,0,0,0,0,0,0,0,0,0,0,0,0,0,0,18,18,0,0,18,0,0,0,0,0,0,0,0,0,70753
24366,6031,1512,2652,1244,501,122,572,103,63,11,0,52,40,0,0,0,0,40,5,0,35,469,325,62,0,263,144,102,96,6,0,42,0,28,14,70754
24367,1495,199,776,410,107,3,107,67,51,14,0,37,16,16,16,0,0,0,0,0,0,40,17,0,0,17,23,23,13,0,10,0,0,0,0,70755
24368,258,39,121,45,19,34,63,55,55,18,0,37,0,0,0,0,0,0,0,0,0,8,8,0,0,8,0,0,0,0,0,0,0,0,0,70756
24369,2174,517,1021,475,97,64,147,108,77,29,0,48,31,0,0,0,0,31,7,24,0,39,20,0,0,20,19,19,15,0,4,0,0,0,0,70757
24370,1015,150,510,295,44,16,49,46,46,8,8,30,0,0,0,0,0,0,0,0,0,3,0,0,0,0,3,3,0,3,0,0,0,0,0,70759
24371,4441,974,1538,949,608,372,240,120,59,7,0,52,61,39,0,0,39,22,0,0,22,120,32,0,0,32,88,0,0,0,0,88,0,0,88,70760
24372,686,170,249,181,80,6,48,16,16,0,0,16,0,0,0,0,0,0,0,0,0,32,24,0,0,24,8,4,4,0,0,4,0,0,4,70761
24373,596,50,227,144,156,19,29,14,14,0,0,14,0,0,0,0,0,0,0,0,0,15,15,0,0,15,0,0,0,0,0,0,0,0,0,70762
24374,2383,99,1359,655,197,73,212,101,91,12,0,79,10,0,0,0,0,10,10,0,0,111,100,4,23,73,11,0,0,0,0,11,0,11,0,70763
24375,11569,2429,4514,3020,1154,452,924,447,335,41,27,267,112,78,34,0,44,34,0,0,34,477,224,14,0,210,253,211,154,26,31,42,0,8,34,70764
24376,10121,1854,4038,2703,1269,257,689,380,248,81,0,167,132,108,108,0,0,24,7,0,17,309,290,12,0,278,19,8,0,8,0,11,0,0,11,70767
24377,23204,1801,6487,6926,5647,2343,2296,1023,858,249,61,548,165,95,20,75,0,70,55,0,15,1273,1139,392,92,655,134,122,122,0,0,12,12,0,0,70769
24378,2272,149,1020,768,287,48,238,37,10,10,0,0,27,10,10,0,0,17,0,0,17,201,201,71,13,117,0,0,0,0,0,0,0,0,0,70770
24379,572,125,247,151,43,6,35,16,16,0,0,16,0,0,0,0,0,0,0,0,0,19,15,0,0,15,4,4,0,0,4,0,0,0,0,70772
24380,124,25,68,31,0,0,0,0,0,0,0,0,0,0,0,0,0,0,0,0,0,0,0,0,0,0,0,0,0,0,0,0,0,0,0,70773
24381,7126,733,3579,1763,776,275,551,276,214,68,16,130,62,43,43,0,0,19,19,0,0,275,223,52,0,171,52,16,16,0,0,36,0,0,36,70774
24382,7414,1270,2254,1890,1409,591,693,376,284,35,0,249,92,61,0,48,13,31,31,0,0,317,297,35,16,246,20,11,11,0,0,9,0,0,9,70775
24383,4515,1322,1645,920,452,176,100,62,19,4,0,15,43,0,0,0,0,43,0,0,43,38,17,0,0,17,21,21,0,7,14,0,0,0,0,70776
24384,3157,511,1357,863,358,68,203,124,98,6,0,92,26,22,14,0,8,4,0,4,0,79,49,8,0,41,30,30,30,0,0,0,0,0,0,70777
24385,1560,273,642,331,302,12,136,60,37,20,0,17,23,0,0,0,0,23,0,2,21,76,61,9,0,52,15,0,0,0,0,15,0,0,15,70778
24386,899,214,403,175,66,41,125,29,29,20,9,0,0,0,0,0,0,0,0,0,0,96,96,33,17,46,0,0,0,0,0,0,0,0,0,70780
24387,263,79,148,9,18,9,11,11,11,11,0,0,0,0,0,0,0,0,0,0,0,0,0,0,0,0,0,0,0,0,0,0,0,0,0,70782
24388,1902,205,767,632,210,88,133,52,52,0,10,42,0,0,0,0,0,0,0,0,0,81,81,0,0,81,0,0,0,0,0,0,0,0,0,70783
24389,12920,1558,5632,3574,1874,282,1043,668,557,265,0,292,111,78,31,47,0,33,0,33,0,375,338,148,16,174,37,37,37,0,0,0,0,0,0,70785
24390,74,48,26,0,0,0,0,0,0,0,0,0,0,0,0,0,0,0,0,0,0,0,0,0,0,0,0,0,0,0,0,0,0,0,0,70787
24391,2529,646,894,747,167,75,256,85,71,13,3,55,14,9,0,9,0,5,0,0,5,171,124,11,11,102,47,47,13,0,34,0,0,0,0,70788
24392,342,29,148,93,43,29,41,14,12,0,0,12,2,2,2,0,0,0,0,0,0,27,27,0,0,27,0,0,0,0,0,0,0,0,0,70789
24393,15808,1510,4983,5007,2788,1520,1294,669,624,132,9,483,45,37,0,37,0,8,7,0,1,625,551,188,0,363,74,72,11,17,44,2,0,0,2,70791
24394,10,0,0,0,0,10,0,0,0,0,0,0,0,0,0,0,0,0,0,0,0,0,0,0,0,0,0,0,0,0,0,0,0,0,0,70801
24395,16561,3809,5284,4073,1741,1654,1925,802,674,145,33,496,128,77,45,29,3,51,20,0,31,1123,958,279,73,606,165,105,51,35,19,60,31,6,23,70802
24396,34,0,0,11,0,23,712,458,458,151,24,283,0,0,0,0,0,0,0,0,0,254,254,103,10,141,0,0,0,0,0,0,0,0,0,70803
24397,16760,4376,6210,4671,1144,359,2411,1133,921,118,131,672,212,110,64,24,22,102,37,22,43,1278,900,266,118,516,378,212,67,36,109,166,62,0,104,70805
24398,19133,2953,3980,4663,4471,3066,1147,454,300,36,12,252,154,33,30,0,3,121,26,39,56,693,563,121,109,333,130,118,87,31,0,12,0,0,12,70806
24399,10569,2738,3418,2740,1058,615,2387,1368,1142,135,157,850,226,29,0,0,29,197,23,29,145,1019,883,216,157,510,136,94,32,15,47,42,0,36,6,70807
24400,19546,835,2451,3781,6606,5873,3741,1544,1510,480,41,989,34,25,25,0,0,9,0,0,9,2197,2179,829,80,1270,18,18,2,0,16,0,0,0,0,70808
24401,16621,783,2472,4662,5488,3216,778,284,265,119,17,129,19,12,12,0,0,7,0,0,7,494,429,44,85,300,65,65,15,0,50,0,0,0,0,70809
24402,24513,1380,4176,5857,7730,5370,1584,965,892,150,102,640,73,71,65,0,6,2,0,0,2,619,523,137,9,377,96,65,0,0,65,31,31,0,0,70810
24403,8389,1386,2663,2661,1093,586,799,360,251,73,15,163,109,44,13,0,31,65,0,46,19,439,358,93,34,231,81,51,0,51,0,30,0,30,0,70811
24404,7069,1311,1973,2287,1025,473,958,363,276,77,69,130,87,49,49,0,0,38,13,19,6,595,479,75,76,328,116,81,0,42,39,35,8,27,0,70812
24405,9745,857,3229,3443,1580,636,1158,474,366,24,65,277,108,13,8,5,0,95,0,18,77,684,659,95,116,448,25,25,0,25,0,0,0,0,0,70814
24406,19136,2134,5430,6319,3803,1450,1490,758,514,186,36,292,244,154,74,80,0,90,0,0,90,732,684,256,124,304,48,3,0,3,0,45,22,0,23,70815
24407,27861,2617,6451,8713,7233,2847,1452,816,736,123,129,484,80,50,16,34,0,30,23,0,7,636,495,127,42,326,141,61,49,0,12,80,13,0,67,70816
24408,21912,960,4309,6648,7070,2925,1914,1009,970,171,54,745,39,26,25,0,1,13,13,0,0,905,859,223,80,556,46,33,33,0,0,13,13,0,0,70817
24409,6644,537,2693,2174,889,351,408,210,202,86,9,107,8,0,0,0,0,8,0,8,0,198,189,61,11,117,9,9,0,9,0,0,0,0,0,70818
24410,2981,214,1097,936,515,219,172,119,119,25,0,94,0,0,0,0,0,0,0,0,0,53,0,0,0,0,53,32,0,0,32,21,0,21,0,70819
24411,6422,766,1247,1418,1623,1368,1814,1008,964,458,37,469,44,0,0,0,0,44,0,0,44,806,542,316,0,226,264,92,63,16,13,172,169,0,3,70820
24412,0,0,0,0,0,0,0,0,0,0,0,0,0,0,0,0,0,0,0,0,0,0,0,0,0,0,0,0,0,0,0,0,0,0,0,70836
24413,3344,551,1379,881,370,163,173,45,38,15,0,23,7,7,0,7,0,0,0,0,0,128,117,5,38,74,11,9,0,9,0,2,0,0,2,71001
24414,955,225,321,281,118,10,108,60,37,3,10,24,23,23,23,0,0,0,0,0,0,48,26,0,0,26,22,2,0,2,0,20,0,20,0,71003
24415,304,65,98,96,29,16,18,17,17,2,0,15,0,0,0,0,0,0,0,0,0,1,1,0,1,0,0,0,0,0,0,0,0,0,0,71004
24416,8399,942,2552,2343,1590,972,707,367,336,91,16,229,31,22,22,0,0,9,0,0,9,340,323,129,0,194,17,17,16,0,1,0,0,0,0,71006
24417,760,88,225,276,130,41,42,42,20,0,0,20,22,22,22,0,0,0,0,0,0,0,0,0,0,0,0,0,0,0,0,0,0,0,0,71007
24418,461,124,169,67,65,36,53,13,13,1,0,12,0,0,0,0,0,0,0,0,0,40,30,2,3,25,10,10,0,0,10,0,0,0,0,71008
24419,1179,223,453,377,111,15,137,72,65,0,17,48,7,3,0,0,3,4,0,0,4,65,65,0,30,35,0,0,0,0,0,0,0,0,0,71016
24420,981,280,426,176,79,20,94,30,30,11,0,19,0,0,0,0,0,0,0,0,0,64,25,0,0,25,39,28,0,0,28,11,0,0,11,71018
24421,5578,1316,2482,1067,564,149,424,234,152,17,11,124,82,63,26,4,33,19,3,0,16,190,160,54,2,104,30,0,0,0,0,30,0,0,30,71019
24422,443,180,141,93,29,0,37,25,25,0,0,25,0,0,0,0,0,0,0,0,0,12,12,0,0,12,0,0,0,0,0,0,0,0,0,71021
24423,2294,417,951,721,188,17,121,79,69,5,0,64,10,10,2,0,8,0,0,0,0,42,23,3,0,20,19,19,2,0,17,0,0,0,0,71023
24424,1000,248,382,238,95,37,153,104,104,2,9,93,0,0,0,0,0,0,0,0,0,49,47,2,0,45,2,2,2,0,0,0,0,0,0,71024
24425,1389,467,517,334,71,0,216,145,98,15,34,49,47,13,13,0,0,34,34,0,0,71,71,39,21,11,0,0,0,0,0,0,0,0,0,71027
24426,1058,185,437,257,132,47,97,45,30,0,0,30,15,0,0,0,0,15,0,15,0,52,41,2,4,35,11,11,11,0,0,0,0,0,0,71028
24427,116,29,37,26,18,6,0,0,0,0,0,0,0,0,0,0,0,0,0,0,0,0,0,0,0,0,0,0,0,0,0,0,0,0,0,71029
24428,1035,262,372,201,142,58,45,9,0,0,0,0,9,9,0,0,9,0,0,0,0,36,0,0,0,0,36,0,0,0,0,36,0,36,0,71030
24429,767,215,314,139,82,17,54,40,25,12,0,13,15,15,5,10,0,0,0,0,0,14,14,0,3,11,0,0,0,0,0,0,0,0,0,71031
24430,1489,256,583,412,137,101,91,63,42,2,0,40,21,3,3,0,0,18,1,17,0,28,28,0,0,28,0,0,0,0,0,0,0,0,0,71032
24431,2455,205,796,805,527,122,154,105,31,11,0,20,74,54,54,0,0,20,0,0,20,49,49,0,28,21,0,0,0,0,0,0,0,0,0,71033
24432,216,38,90,70,17,1,15,4,4,0,0,4,0,0,0,0,0,0,0,0,0,11,11,0,0,11,0,0,0,0,0,0,0,0,0,71034
24433,12667,1965,4154,4096,1603,849,1041,564,445,145,79,221,119,66,34,0,32,53,16,37,0,477,476,223,0,253,1,1,0,0,1,0,0,0,0,71037
24434,2983,850,1143,643,207,140,117,81,36,0,0,36,45,37,0,0,37,8,0,8,0,36,36,13,0,23,0,0,0,0,0,0,0,0,0,71038
24435,1421,249,668,325,145,34,131,82,45,5,0,40,37,12,12,0,0,25,1,0,24,49,47,4,0,43,2,2,0,2,0,0,0,0,0,71039
24436,6470,1559,2611,1459,569,272,550,380,211,70,0,141,169,72,70,0,2,97,0,71,26,170,150,42,27,81,20,0,0,0,0,20,0,3,17,71040
24437,436,102,253,54,16,11,15,6,4,0,0,4,2,2,0,2,0,0,0,0,0,9,4,0,0,4,5,0,0,0,0,5,0,0,5,71043
24438,542,79,278,107,74,4,2,2,1,0,0,1,1,0,0,0,0,1,0,0,1,0,0,0,0,0,0,0,0,0,0,0,0,0,0,71044
24439,532,158,283,59,25,7,99,47,42,0,7,35,5,0,0,0,0,5,0,5,0,52,52,0,0,52,0,0,0,0,0,0,0,0,0,71045
24440,962,90,616,197,55,4,66,26,15,0,0,15,11,0,0,0,0,11,0,0,11,40,25,0,0,25,15,0,0,0,0,15,0,0,15,71046
24441,8084,1285,3559,2112,758,370,357,189,103,26,0,77,86,32,32,0,0,54,32,0,22,168,137,45,24,68,31,10,10,0,0,21,0,10,11,71047
24442,78,12,20,34,9,3,9,5,5,4,0,1,0,0,0,0,0,0,0,0,0,4,4,4,0,0,0,0,0,0,0,0,0,0,0,71048
24443,2047,472,797,607,101,70,343,167,122,15,0,107,45,23,19,0,4,22,0,13,9,176,138,3,4,131,38,12,12,0,0,26,19,0,7,71049
24444,1868,350,720,580,168,50,143,75,70,21,0,49,5,0,0,0,0,5,5,0,0,68,68,22,0,46,0,0,0,0,0,0,0,0,0,71051
24445,6857,1876,2610,1756,465,150,501,171,142,0,8,134,29,3,0,0,3,26,0,0,26,330,255,26,0,229,75,75,0,51,24,0,0,0,0,71052
24446,13846,2676,5592,3495,1579,504,827,439,360,55,14,291,79,23,8,15,0,56,41,0,15,388,278,11,27,240,110,53,44,9,0,57,27,30,0,71055
24447,1809,283,893,452,158,23,189,100,28,0,3,25,72,11,11,0,0,61,61,0,0,89,87,19,0,68,2,0,0,0,0,2,0,0,2,71060
24448,1034,188,408,329,43,66,20,15,6,6,0,0,9,0,0,0,0,9,0,9,0,5,5,0,0,5,0,0,0,0,0,0,0,0,0,71061
24449,486,115,209,146,0,16,0,0,0,0,0,0,0,0,0,0,0,0,0,0,0,0,0,0,0,0,0,0,0,0,0,0,0,0,0,71063
24450,3108,871,1235,583,235,184,193,122,85,0,0,85,37,30,30,0,0,7,0,0,7,71,42,15,0,27,29,0,0,0,0,29,0,29,0,71064
24451,831,215,360,197,55,4,80,36,36,7,0,29,0,0,0,0,0,0,0,0,0,44,41,10,0,31,3,0,0,0,0,3,0,0,3,71065
24452,2237,502,790,841,79,25,335,226,182,69,0,113,44,0,0,0,0,44,44,0,0,109,64,0,0,64,45,45,45,0,0,0,0,0,0,71067
24453,2350,463,1153,558,71,105,156,57,57,0,3,54,0,0,0,0,0,0,0,0,0,99,87,13,0,74,12,12,12,0,0,0,0,0,0,71068
24454,387,104,164,77,42,0,18,13,1,0,0,1,12,12,7,5,0,0,0,0,0,5,5,0,0,5,0,0,0,0,0,0,0,0,0,71069
24455,1499,445,662,249,87,56,84,75,43,3,0,40,32,2,2,0,0,30,19,0,11,9,6,0,0,6,3,3,0,3,0,0,0,0,0,71070
24456,1758,399,700,393,221,45,220,69,67,0,0,67,2,2,2,0,0,0,0,0,0,151,137,38,0,99,14,14,14,0,0,0,0,0,0,71071
24457,1058,190,487,227,137,17,38,5,5,5,0,0,0,0,0,0,0,0,0,0,0,33,33,0,11,22,0,0,0,0,0,0,0,0,0,71072
24458,1483,253,715,391,103,21,121,91,83,11,0,72,8,8,0,0,8,0,0,0,0,30,19,0,0,19,11,0,0,0,0,11,0,0,11,71073
24459,4449,1298,1655,932,359,205,362,129,70,12,27,31,59,54,0,9,45,5,0,0,5,233,91,0,0,91,142,142,25,60,57,0,0,0,0,71075
24460,3775,562,1383,1210,491,129,277,174,124,3,12,109,50,1,0,1,0,49,49,0,0,103,103,28,37,38,0,0,0,0,0,0,0,0,0,71078
24461,167,29,78,60,0,0,36,36,7,0,0,7,29,0,0,0,0,29,0,0,29,0,0,0,0,0,0,0,0,0,0,0,0,0,0,71079
24462,3796,776,1845,889,231,55,282,136,52,6,0,46,84,50,10,40,0,34,14,0,20,146,51,28,0,23,95,75,31,20,24,20,0,0,20,71082
24463,5727,1283,2166,1674,488,116,470,143,65,15,0,50,78,54,25,20,9,24,0,13,11,327,177,0,0,177,150,27,27,0,0,123,0,62,61,71101
24464,5373,1286,2386,1197,298,206,569,363,274,32,45,197,89,66,0,0,66,23,0,9,14,206,165,12,29,124,41,6,0,0,6,35,0,35,0,71103
24465,9653,903,2351,3225,2124,1050,652,310,294,70,6,218,16,1,0,0,1,15,0,0,15,342,310,106,28,176,32,31,24,7,0,1,0,0,1,71104
24466,15497,457,3190,4703,4457,2690,1057,634,548,84,0,464,86,53,40,13,0,33,0,0,33,423,271,12,29,230,152,152,101,0,51,0,0,0,0,71105
24467,23687,3144,6861,6055,4547,3080,2073,911,689,90,72,527,222,155,62,6,87,67,32,20,15,1162,923,120,94,709,239,112,107,0,5,127,0,17,110,71106
24468,21162,3874,7870,6126,2247,1045,2077,1014,712,103,22,587,302,144,29,55,60,158,14,10,134,1063,843,163,61,619,220,113,53,0,60,107,0,53,54,71107
24469,11048,2268,4776,3133,548,323,1371,691,550,102,69,379,141,118,16,29,73,23,0,0,23,680,496,71,13,412,184,108,38,10,60,76,32,19,25,71108
24470,13720,3322,5403,3416,1089,490,1243,572,326,72,51,203,246,37,25,12,0,209,0,35,174,671,462,121,28,313,209,116,63,12,41,93,64,0,29,71109
24471,902,13,163,418,136,172,201,146,14,8,0,6,132,132,122,0,10,0,0,0,0,55,32,0,0,32,23,2,2,0,0,21,0,14,7,71110
24472,25713,3123,7619,7269,4801,2901,1753,830,631,110,15,506,199,199,124,56,19,0,0,0,0,923,585,203,20,362,338,257,35,180,42,81,22,0,59,71111
24473,20384,1714,6416,7763,3274,1217,1735,966,812,245,36,531,154,114,68,24,22,40,25,0,15,769,632,207,64,361,137,11,10,0,1,126,126,0,0,71112
24474,9945,555,2249,3152,2274,1715,612,258,210,75,0,135,48,0,0,0,0,48,0,0,48,354,285,92,25,168,69,22,22,0,0,47,7,40,0,71115
24475,16713,1768,5933,5634,2470,908,1577,889,641,115,53,473,248,208,36,37,135,40,40,0,0,688,348,61,29,258,340,221,133,24,64,119,12,75,32,71118
24476,8808,1057,2248,2847,1483,1173,603,201,141,53,0,88,60,19,19,0,0,41,0,0,41,402,402,22,0,380,0,0,0,0,0,0,0,0,0,71119
24477,8655,750,3023,3109,1275,498,726,436,296,108,0,188,140,124,40,21,63,16,0,16,0,290,263,55,85,123,27,10,10,0,0,17,17,0,0,71129
24478,13756,1522,2873,3383,3614,2364,814,306,275,44,16,215,31,24,0,4,20,7,0,0,7,508,382,57,25,300,126,72,0,18,54,54,0,15,39,71201
24479,17787,5041,6862,4382,1014,488,2370,1391,864,31,41,792,527,257,15,15,227,270,4,1,265,979,787,159,90,538,192,111,57,13,41,81,16,5,60,71202
24480,21909,2664,6834,6799,3845,1767,3147,1443,1336,231,73,1032,107,81,29,5,47,26,0,6,20,1704,1581,280,96,1205,123,88,70,0,18,35,0,0,35,71203
24481,0,0,0,0,0,0,90,11,11,0,0,11,0,0,0,0,0,0,0,0,0,79,79,11,10,58,0,0,0,0,0,0,0,0,0,71209
24482,766,274,327,148,17,0,73,7,0,0,0,0,7,7,3,0,4,0,0,0,0,66,66,18,0,48,0,0,0,0,0,0,0,0,0,71219
24483,15396,3597,6568,3397,1365,469,1247,591,469,48,45,376,122,62,34,0,28,60,0,21,39,656,438,83,58,297,218,144,38,0,106,74,47,17,10,71220
24484,2381,626,1111,496,69,79,184,148,129,63,9,57,19,9,9,0,0,10,7,3,0,36,36,0,5,31,0,0,0,0,0,0,0,0,0,71222
24485,229,95,95,28,2,9,27,13,8,0,0,8,5,5,0,0,5,0,0,0,0,14,2,0,0,2,12,8,2,0,6,4,0,0,4,71223
24486,5014,619,1869,1567,813,146,348,227,208,17,65,126,19,19,19,0,0,0,0,0,0,121,93,0,24,69,28,0,0,0,0,28,14,0,14,71225
24487,1210,315,476,261,103,55,31,5,4,0,0,4,1,0,0,0,0,1,0,1,0,26,21,16,0,5,5,5,5,0,0,0,0,0,0,71226
24488,2264,327,1036,515,259,127,171,135,113,0,55,58,22,22,0,22,0,0,0,0,0,36,36,27,0,9,0,0,0,0,0,0,0,0,0,71227
24489,1185,269,494,282,66,74,94,12,12,0,0,12,0,0,0,0,0,0,0,0,0,82,40,14,0,26,42,32,22,0,10,10,0,0,10,71229
24490,4324,944,1735,1028,418,199,329,150,118,48,5,65,32,20,0,8,12,12,0,0,12,179,126,42,0,84,53,22,0,0,22,31,13,0,18,71232
24491,166,35,87,32,12,0,7,7,7,0,0,7,0,0,0,0,0,0,0,0,0,0,0,0,0,0,0,0,0,0,0,0,0,0,0,71233
24492,2700,549,1020,722,282,127,160,93,49,0,0,49,44,41,29,12,0,3,3,0,0,67,67,0,0,67,0,0,0,0,0,0,0,0,0,71234
24493,2781,440,1081,686,384,190,207,108,108,33,0,75,0,0,0,0,0,0,0,0,0,99,80,22,15,43,19,19,3,0,16,0,0,0,0,71235
24494,1276,416,510,241,66,43,99,92,30,0,0,30,62,0,0,0,0,62,0,0,62,7,7,0,0,7,0,0,0,0,0,0,0,0,0,71237
24495,1741,223,885,493,140,0,64,27,27,0,0,27,0,0,0,0,0,0,0,0,0,37,23,14,0,9,14,0,0,0,0,14,2,0,12,71238
24496,6188,948,2485,1732,746,277,507,248,146,13,0,133,102,52,31,4,17,50,0,0,50,259,197,29,15,153,62,51,51,0,0,11,0,11,0,71241
24497,95,7,10,52,26,0,4,0,0,0,0,0,0,0,0,0,0,0,0,0,0,4,4,0,0,4,0,0,0,0,0,0,0,0,0,71243
24498,2255,400,516,631,261,447,468,300,209,45,46,118,91,23,0,23,0,68,0,0,68,168,168,41,35,92,0,0,0,0,0,0,0,0,0,71245
24499,702,121,281,253,29,18,51,25,20,0,0,20,5,5,5,0,0,0,0,0,0,26,26,3,0,23,0,0,0,0,0,0,0,0,0,71247
24500,40,25,15,0,0,0,10,10,0,0,0,0,10,10,10,0,0,0,0,0,0,0,0,0,0,0,0,0,0,0,0,0,0,0,0,71250
24501,6314,1113,2694,1664,523,320,606,346,189,15,16,158,157,98,38,13,47,59,35,0,24,260,235,84,28,123,25,25,0,0,25,0,0,0,0,71251
24502,179,59,72,11,17,20,7,4,0,0,0,0,4,2,0,0,2,2,2,0,0,3,0,0,0,0,3,3,0,0,3,0,0,0,0,71253
24503,4140,1454,1561,760,216,149,411,252,206,30,5,171,46,15,0,7,8,31,0,0,31,159,147,18,0,129,12,12,0,0,12,0,0,0,0,71254
24504,533,137,260,83,46,7,67,67,50,0,0,50,17,17,0,17,0,0,0,0,0,0,0,0,0,0,0,0,0,0,0,0,0,0,0,71256
24505,1128,142,495,319,127,45,207,166,160,36,14,110,6,6,0,0,6,0,0,0,0,41,41,8,0,33,0,0,0,0,0,0,0,0,0,71259
24506,2700,355,1116,945,181,103,183,62,39,0,0,39,23,0,0,0,0,23,0,0,23,121,104,52,0,52,17,17,4,0,13,0,0,0,0,71260
24507,1098,227,419,233,83,136,103,78,60,0,12,48,18,18,0,0,18,0,0,0,0,25,22,2,0,20,3,0,0,0,0,3,3,0,0,71261
24508,5430,1532,2362,1038,330,168,447,181,81,26,0,55,100,31,3,3,25,69,37,2,30,266,243,40,0,203,23,4,0,0,4,19,0,0,19,71263
24509,840,139,390,183,108,20,56,24,7,0,0,7,17,0,0,0,0,17,0,0,17,32,19,0,0,19,13,13,0,0,13,0,0,0,0,71264
24510,1048,255,488,183,102,20,65,35,34,4,0,30,1,1,0,1,0,0,0,0,0,30,23,0,0,23,7,3,3,0,0,4,0,4,0,71266
24511,1732,158,635,649,185,105,84,52,29,13,0,16,23,15,0,0,15,8,0,8,0,32,32,0,0,32,0,0,0,0,0,0,0,0,0,71268
24512,8451,2233,3215,1858,754,391,610,293,272,37,0,235,21,12,0,0,12,9,0,0,9,317,255,64,0,191,62,49,10,39,0,13,0,6,7,71269
24513,17162,2446,3649,4146,4281,2640,1707,999,758,118,118,522,241,105,15,22,68,136,5,0,131,708,661,176,106,379,47,0,0,0,0,47,0,0,47,71270
24514,49,0,0,47,2,0,1197,621,621,191,93,337,0,0,0,0,0,0,0,0,0,576,576,179,108,289,0,0,0,0,0,0,0,0,0,71272
24515,1758,378,585,525,121,149,214,89,58,41,0,17,31,9,9,0,0,22,22,0,0,125,55,15,0,40,70,23,0,0,23,47,47,0,0,71275
24516,262,128,80,44,10,0,20,20,8,0,0,8,12,0,0,0,0,12,12,0,0,0,0,0,0,0,0,0,0,0,0,0,0,0,0,71276
24517,1201,275,472,278,119,57,47,13,13,0,0,13,0,0,0,0,0,0,0,0,0,34,0,0,0,0,34,0,0,0,0,34,0,0,34,71277
24518,0,0,0,0,0,0,0,0,0,0,0,0,0,0,0,0,0,0,0,0,0,0,0,0,0,0,0,0,0,0,0,0,0,0,0,71279
24519,2341,190,924,817,336,74,125,47,38,17,0,21,9,9,9,0,0,0,0,0,0,78,60,0,0,60,18,8,0,0,8,10,0,0,10,71280
24520,7309,1927,2667,1862,633,220,603,283,256,0,17,239,27,4,4,0,0,23,0,8,15,320,268,7,35,226,52,22,0,11,11,30,26,0,4,71282
24521,416,62,222,74,58,0,3,0,0,0,0,0,0,0,0,0,0,0,0,0,0,3,3,0,0,3,0,0,0,0,0,0,0,0,0,71286
24522,21780,1963,7024,6628,4362,1803,1395,691,650,94,42,514,41,28,15,0,13,13,0,0,13,704,514,159,76,279,190,158,139,9,10,32,0,11,21,71291
24523,13554,2691,5869,3444,1079,471,994,544,402,59,54,289,142,84,15,0,69,58,0,0,58,450,297,51,11,235,153,91,17,0,74,62,0,29,33,71292
24524,9533,2865,3437,2096,713,422,522,323,262,77,53,132,61,10,6,0,4,51,34,0,17,199,124,69,23,32,75,58,30,0,28,17,5,0,12,71295
24525,14421,3279,4455,3936,1850,901,1529,767,537,32,41,464,230,90,60,0,30,140,55,5,80,762,588,134,54,400,174,81,13,30,38,93,0,78,15,71301
24526,9770,1947,3406,3366,729,322,1068,544,388,62,26,300,156,26,10,0,16,130,0,15,115,524,432,49,4,379,92,86,21,43,22,6,6,0,0,71302
24527,13472,1653,4317,3888,2159,1455,975,455,274,53,0,221,181,91,63,9,19,90,49,18,23,520,483,109,0,374,37,37,11,0,26,0,0,0,0,71303
24528,27,0,0,18,9,0,0,0,0,0,0,0,0,0,0,0,0,0,0,0,0,0,0,0,0,0,0,0,0,0,0,0,0,0,0,71316
24529,4793,1312,1976,1005,358,142,192,103,103,25,11,67,0,0,0,0,0,0,0,0,0,89,76,12,33,31,13,0,0,0,0,13,13,0,0,71322
24530,668,162,291,129,77,9,7,7,7,0,0,7,0,0,0,0,0,0,0,0,0,0,0,0,0,0,0,0,0,0,0,0,0,0,0,71323
24531,820,293,272,105,72,78,70,23,19,0,0,19,4,4,0,4,0,0,0,0,0,47,26,0,0,26,21,0,0,0,0,21,0,0,21,71325
24532,748,206,258,224,56,4,61,16,9,0,0,9,7,7,0,7,0,0,0,0,0,45,45,14,0,31,0,0,0,0,0,0,0,0,0,71326
24533,4392,1358,1719,1055,169,91,385,188,112,33,9,70,76,0,0,0,0,76,0,0,76,197,145,65,0,80,52,0,0,0,0,52,0,7,45,71327
24534,5012,745,2125,1532,493,117,376,206,46,0,0,46,160,68,52,0,16,92,19,17,56,170,152,32,0,120,18,18,0,0,18,0,0,0,0,71328
24535,532,219,201,102,10,0,18,6,6,0,0,6,0,0,0,0,0,0,0,0,0,12,12,0,7,5,0,0,0,0,0,0,0,0,0,71331
24536,481,98,204,142,10,27,46,17,17,0,0,17,0,0,0,0,0,0,0,0,0,29,29,0,9,20,0,0,0,0,0,0,0,0,0,71333
24537,6303,1994,2273,1385,420,231,544,243,178,0,8,170,65,25,25,0,0,40,6,0,34,301,280,0,50,230,21,0,0,0,0,21,4,0,17,71334
24538,961,177,453,236,86,9,36,26,0,0,0,0,26,0,0,0,0,26,0,24,2,10,7,0,0,7,3,3,0,3,0,0,0,0,0,71336
24539,141,26,68,0,17,30,0,0,0,0,0,0,0,0,0,0,0,0,0,0,0,0,0,0,0,0,0,0,0,0,0,0,0,0,0,71339
24540,1137,548,401,134,39,15,76,67,34,0,0,34,33,14,6,0,8,19,0,0,19,9,0,0,0,0,9,0,0,0,0,9,0,9,0,71340
24541,2006,512,1035,339,47,73,157,97,67,24,28,15,30,24,12,12,0,6,0,6,0,60,42,2,23,17,18,0,0,0,0,18,18,0,0,71341
24542,5658,994,2518,1316,585,245,365,243,172,15,4,153,71,49,49,0,0,22,11,0,11,122,112,18,11,83,10,5,0,0,5,5,0,0,5,71342
24543,5364,1503,2172,1059,506,124,400,225,121,12,40,69,104,84,56,22,6,20,0,20,0,175,121,0,15,106,54,46,33,6,7,8,8,0,0,71343
24544,124,122,2,0,0,0,0,0,0,0,0,0,0,0,0,0,0,0,0,0,0,0,0,0,0,0,0,0,0,0,0,0,0,0,0,71345
24545,1836,330,751,496,164,95,168,135,115,0,14,101,20,20,20,0,0,0,0,0,0,33,31,0,0,31,2,0,0,0,0,2,0,0,2,71346
24546,2800,620,959,903,261,57,169,53,53,5,8,40,0,0,0,0,0,0,0,0,0,116,89,7,71,11,27,27,1,26,0,0,0,0,0,71350
24547,7481,2469,2575,1519,506,412,640,315,246,12,27,207,69,38,0,0,38,31,0,0,31,325,164,12,23,129,161,38,10,18,10,123,71,0,52,71351
24548,1132,279,555,221,71,6,102,65,65,10,2,53,0,0,0,0,0,0,0,0,0,37,32,0,11,21,5,5,0,5,0,0,0,0,0,71353
24549,1213,219,494,319,143,38,15,8,0,0,0,0,8,8,8,0,0,0,0,0,0,7,7,0,0,7,0,0,0,0,0,0,0,0,0,71354
24550,2053,513,784,514,170,72,323,171,96,25,7,64,75,75,75,0,0,0,0,0,0,152,143,68,8,67,9,0,0,0,0,9,0,0,9,71355
24551,453,126,174,97,45,11,28,15,15,15,0,0,0,0,0,0,0,0,0,0,0,13,13,0,0,13,0,0,0,0,0,0,0,0,0,71356
24552,1651,466,664,383,127,11,94,38,33,0,3,30,5,0,0,0,0,5,0,0,5,56,56,4,0,52,0,0,0,0,0,0,0,0,0,71357
24553,802,201,437,108,47,9,21,2,2,0,0,2,0,0,0,0,0,0,0,0,0,19,19,0,0,19,0,0,0,0,0,0,0,0,0,71358
24554,23287,3831,7445,6900,3527,1584,2088,1101,853,268,56,529,248,170,68,18,84,78,9,0,69,987,738,230,35,473,249,207,62,38,107,42,0,31,11,71360
24555,1077,290,471,246,61,9,67,26,14,12,0,2,12,12,12,0,0,0,0,0,0,41,32,10,0,22,9,9,0,0,9,0,0,0,0,71362
24556,1117,209,478,220,118,92,73,25,25,2,0,23,0,0,0,0,0,0,0,0,0,48,42,6,0,36,6,3,0,0,3,3,0,3,0,71366
24557,800,296,266,138,50,50,14,7,7,0,0,7,0,0,0,0,0,0,0,0,0,7,7,7,0,0,0,0,0,0,0,0,0,0,0,71367
24558,1004,295,439,162,66,42,91,65,65,8,0,57,0,0,0,0,0,0,0,0,0,26,26,0,0,26,0,0,0,0,0,0,0,0,0,71368
24559,1664,715,625,242,55,27,91,56,52,22,2,28,4,4,4,0,0,0,0,0,0,35,35,0,12,23,0,0,0,0,0,0,0,0,0,71369
24560,1223,288,398,350,115,72,20,17,11,0,0,11,6,6,0,6,0,0,0,0,0,3,0,0,0,0,3,0,0,0,0,3,0,0,3,71371
24561,4752,848,1984,1286,429,205,293,142,73,14,0,59,69,59,10,40,9,10,0,0,10,151,141,76,0,65,10,0,0,0,0,10,0,0,10,71373
24562,732,225,298,195,1,13,75,58,58,0,0,58,0,0,0,0,0,0,0,0,0,17,17,0,0,17,0,0,0,0,0,0,0,0,0,71375
24563,69,23,31,15,0,0,0,0,0,0,0,0,0,0,0,0,0,0,0,0,0,0,0,0,0,0,0,0,0,0,0,0,0,0,0,71377
24564,1668,583,556,386,105,38,169,40,37,11,0,26,3,0,0,0,0,3,0,0,3,129,123,11,13,99,6,0,0,0,0,6,0,0,6,71378
24565,0,0,0,0,0,0,0,0,0,0,0,0,0,0,0,0,0,0,0,0,0,0,0,0,0,0,0,0,0,0,0,0,0,0,0,71401
24566,2970,442,1174,810,448,96,248,138,123,59,0,64,15,9,3,6,0,6,0,6,0,110,94,12,8,74,16,16,6,0,10,0,0,0,0,71403
24567,418,91,216,75,34,2,37,37,37,0,9,28,0,0,0,0,0,0,0,0,0,0,0,0,0,0,0,0,0,0,0,0,0,0,0,71404
24568,3755,347,1348,1423,466,171,291,107,49,0,0,49,58,48,0,13,35,10,10,0,0,184,184,19,3,162,0,0,0,0,0,0,0,0,0,71405
24569,257,9,73,144,19,12,8,8,8,0,0,8,0,0,0,0,0,0,0,0,0,0,0,0,0,0,0,0,0,0,0,0,0,0,0,71406
24570,450,75,300,37,38,0,50,30,30,12,0,18,0,0,0,0,0,0,0,0,0,20,20,0,0,20,0,0,0,0,0,0,0,0,0,71407
24571,4967,902,2199,1198,502,166,322,199,130,43,10,77,69,55,30,0,25,14,0,0,14,123,105,17,0,88,18,18,1,0,17,0,0,0,0,71409
24572,73,2,54,12,0,5,13,7,4,0,0,4,3,3,0,3,0,0,0,0,0,6,6,0,0,6,0,0,0,0,0,0,0,0,0,71410
24573,1765,427,766,428,121,23,85,66,31,4,0,27,35,22,22,0,0,13,0,0,13,19,15,0,0,15,4,4,0,0,4,0,0,0,0,71411
24574,120,8,86,16,2,8,4,0,0,0,0,0,0,0,0,0,0,0,0,0,0,4,4,0,0,4,0,0,0,0,0,0,0,0,0,71414
24575,628,188,308,62,51,19,41,35,29,6,0,23,6,0,0,0,0,6,2,0,4,6,6,0,2,4,0,0,0,0,0,0,0,0,0,71416
24576,3184,765,1316,705,263,135,357,175,83,0,8,75,92,85,76,0,9,7,0,0,7,182,154,2,34,118,28,10,0,10,0,18,0,0,18,71417
24577,4295,955,1875,1082,257,126,272,158,119,0,11,108,39,22,10,12,0,17,0,15,2,114,28,0,0,28,86,22,0,0,22,64,30,0,34,71418
24578,1872,370,763,531,156,52,193,68,58,2,6,50,10,5,5,0,0,5,0,5,0,125,58,3,0,55,67,52,33,8,11,15,0,0,15,71419
24579,1133,349,491,236,52,5,45,9,0,0,0,0,9,0,0,0,0,9,0,0,9,36,36,0,0,36,0,0,0,0,0,0,0,0,0,71422
24580,3017,456,1214,843,348,156,221,147,136,26,13,97,11,0,0,0,0,11,0,11,0,74,45,18,0,27,29,25,14,0,11,4,0,4,0,71423
24581,1003,229,343,355,66,10,203,73,49,0,0,49,24,24,24,0,0,0,0,0,0,130,130,40,11,79,0,0,0,0,0,0,0,0,0,71424
24582,215,89,99,21,6,0,15,0,0,0,0,0,0,0,0,0,0,0,0,0,0,15,15,0,0,15,0,0,0,0,0,0,0,0,0,71425
24583,147,35,82,19,8,3,14,0,0,0,0,0,0,0,0,0,0,0,0,0,0,14,14,0,3,11,0,0,0,0,0,0,0,0,0,71426
24584,180,49,84,45,2,0,25,24,24,0,0,24,0,0,0,0,0,0,0,0,0,1,1,0,0,1,0,0,0,0,0,0,0,0,0,71427
24585,1852,240,818,449,248,97,68,34,34,7,0,27,0,0,0,0,0,0,0,0,0,34,29,14,2,13,5,5,0,5,0,0,0,0,0,71429
24586,1919,524,844,396,62,93,342,212,43,0,0,43,169,149,15,134,0,20,5,15,0,130,130,0,6,124,0,0,0,0,0,0,0,0,0,71430
24587,669,177,279,178,35,0,58,7,7,0,0,7,0,0,0,0,0,0,0,0,0,51,51,0,0,51,0,0,0,0,0,0,0,0,0,71432
24588,2703,605,1219,659,130,90,135,40,24,0,0,24,16,11,0,0,11,5,0,0,5,95,70,4,0,66,25,25,18,3,4,0,0,0,0,71433
24589,2853,785,1264,608,108,88,302,138,79,27,0,52,59,59,59,0,0,0,0,0,0,164,114,48,0,66,50,50,50,0,0,0,0,0,0,71435
24590,958,194,503,215,27,19,71,33,33,0,0,33,0,0,0,0,0,0,0,0,0,38,38,0,0,38,0,0,0,0,0,0,0,0,0,71438
24591,1157,163,544,298,119,33,67,29,24,7,2,15,5,5,5,0,0,0,0,0,0,38,25,10,2,13,13,13,0,6,7,0,0,0,0,71439
24592,316,85,146,66,19,0,0,0,0,0,0,0,0,0,0,0,0,0,0,0,0,0,0,0,0,0,0,0,0,0,0,0,0,0,0,71441
24593,15215,2178,5740,4390,2071,836,1150,592,396,81,26,289,196,109,23,14,72,87,25,2,60,558,350,66,3,281,208,143,93,0,50,65,9,2,54,71446
24594,734,171,356,131,60,16,42,39,33,14,0,19,6,4,0,4,0,2,0,0,2,3,3,0,0,3,0,0,0,0,0,0,0,0,0,71447
24595,6396,1080,2430,1944,604,338,518,329,279,77,21,181,50,24,12,6,6,26,0,14,12,189,147,11,26,110,42,24,11,3,10,18,0,8,10,71449
24596,747,124,353,169,78,23,91,21,16,0,0,16,5,5,0,0,5,0,0,0,0,70,22,0,0,22,48,48,0,0,48,0,0,0,0,71450
24597,34,5,16,6,7,0,3,3,3,0,0,3,0,0,0,0,0,0,0,0,0,0,0,0,0,0,0,0,0,0,0,0,0,0,0,71452
24598,1884,444,890,345,119,86,116,78,62,40,0,22,16,16,9,7,0,0,0,0,0,38,29,0,18,11,9,9,5,4,0,0,0,0,0,71454
24599,177,51,96,22,8,0,0,0,0,0,0,0,0,0,0,0,0,0,0,0,0,0,0,0,0,0,0,0,0,0,0,0,0,0,0,71455
24600,644,142,238,98,60,106,74,13,12,4,0,8,1,0,0,0,0,1,0,0,1,61,61,6,0,55,0,0,0,0,0,0,0,0,0,71456
24601,15720,2592,4945,4083,2266,1834,2423,1047,838,257,45,536,209,40,13,3,24,169,11,85,73,1376,1172,360,104,708,204,151,76,11,64,53,41,0,12,71457
24602,4764,81,1210,2168,936,369,732,436,138,82,0,56,298,298,284,0,14,0,0,0,0,296,152,75,0,77,144,129,9,17,103,15,0,0,15,71459
24603,1678,333,564,577,140,64,105,56,23,4,4,15,33,5,5,0,0,28,28,0,0,49,41,18,6,17,8,0,0,0,0,8,0,0,8,71461
24604,783,215,348,159,55,6,67,43,32,0,0,32,11,0,0,0,0,11,2,0,9,24,24,0,0,24,0,0,0,0,0,0,0,0,0,71462
24605,7504,2037,2915,1922,411,219,343,232,185,70,0,115,47,33,0,6,27,14,0,6,8,111,68,15,0,53,43,27,6,0,21,16,0,0,16,71463
24606,1837,373,898,381,178,7,203,110,76,18,10,48,34,22,22,0,0,12,0,0,12,93,77,4,0,73,16,16,0,0,16,0,0,0,0,71465
24607,409,107,162,140,0,0,47,31,15,0,0,15,16,0,0,0,0,16,16,0,0,16,16,0,0,16,0,0,0,0,0,0,0,0,0,71466
24608,5901,1230,2462,1785,262,162,272,149,73,22,0,51,76,59,54,5,0,17,0,0,17,123,85,9,7,69,38,36,12,15,9,2,0,0,2,71467
24609,578,178,222,100,29,49,55,40,30,0,0,30,10,10,0,0,10,0,0,0,0,15,15,0,0,15,0,0,0,0,0,0,0,0,0,71468
24610,1968,367,888,416,191,106,164,59,42,13,6,23,17,10,0,0,10,7,7,0,0,105,94,11,4,79,11,11,5,0,6,0,0,0,0,71469
24611,78,22,39,0,17,0,2,2,0,0,0,0,2,0,0,0,0,2,0,2,0,0,0,0,0,0,0,0,0,0,0,0,0,0,0,71472
24612,252,74,72,105,1,0,22,5,5,4,0,1,0,0,0,0,0,0,0,0,0,17,6,5,0,1,11,6,0,0,6,5,0,0,5,71473
24613,466,43,149,151,57,66,39,27,26,0,0,26,1,0,0,0,0,1,1,0,0,12,12,0,0,12,0,0,0,0,0,0,0,0,0,71474
24614,585,124,266,101,87,7,14,7,5,0,0,5,2,2,0,0,2,0,0,0,0,7,4,0,0,4,3,3,0,0,3,0,0,0,0,71479
24615,845,229,389,181,18,28,33,18,0,0,0,0,18,3,0,3,0,15,0,0,15,15,15,0,6,9,0,0,0,0,0,0,0,0,0,71480
24616,7816,1960,3106,1809,658,283,496,305,205,41,12,152,100,76,38,31,7,24,14,10,0,191,123,16,0,107,68,45,19,0,26,23,0,0,23,71483
24617,1556,141,374,593,235,213,74,26,17,0,0,17,9,9,9,0,0,0,0,0,0,48,41,5,0,36,7,7,0,0,7,0,0,0,0,71485
24618,3678,1033,1474,768,268,135,408,208,163,32,2,129,45,29,12,13,4,16,7,7,2,200,130,7,0,123,70,59,30,0,29,11,6,0,5,71486
24619,9748,1664,3657,2911,1052,464,1922,895,824,127,163,534,71,37,5,12,20,34,0,0,34,1027,947,93,105,749,80,43,26,17,0,37,15,17,5,71601
24620,11144,2098,3892,3378,1205,571,969,565,460,115,137,208,105,54,33,4,17,51,10,9,32,404,355,63,114,178,49,0,0,0,0,49,11,0,38,71602
24621,23223,3166,8356,6797,3364,1540,1318,663,495,66,66,363,168,114,85,14,15,54,0,37,17,655,583,153,21,409,72,72,16,0,56,0,0,0,0,71603
24622,390,81,223,46,36,4,43,35,21,0,0,21,14,14,0,14,0,0,0,0,0,8,7,0,0,7,1,1,1,0,0,0,0,0,0,71630
24623,499,136,246,105,12,0,23,0,0,0,0,0,0,0,0,0,0,0,0,0,0,23,23,0,0,23,0,0,0,0,0,0,0,0,0,71631
24624,8608,1057,4088,2423,722,318,623,345,277,92,10,175,68,39,27,12,0,29,0,0,29,278,278,78,14,186,0,0,0,0,0,0,0,0,0,71635
24625,2444,780,1067,404,154,39,224,118,59,6,0,53,59,28,6,0,22,31,0,0,31,106,66,0,13,53,40,0,0,0,0,40,36,0,4,71638
24626,4117,1107,1654,919,313,124,347,169,136,22,21,93,33,25,23,2,0,8,8,0,0,178,136,19,15,102,42,40,0,33,7,2,0,0,2,71639
24627,2343,519,1127,483,169,45,159,116,100,0,21,79,16,16,0,0,16,0,0,0,0,43,43,0,12,31,0,0,0,0,0,0,0,0,0,71640
24628,310,76,173,48,0,13,42,0,0,0,0,0,0,0,0,0,0,0,0,0,0,42,36,0,0,36,6,6,0,6,0,0,0,0,0,71642
24629,973,309,406,206,38,14,54,51,32,0,2,30,19,19,10,9,0,0,0,0,0,3,3,0,0,3,0,0,0,0,0,0,0,0,0,71643
24630,3414,1239,1522,501,108,44,169,122,34,0,0,34,88,65,0,19,46,23,0,0,23,47,34,0,0,34,13,13,13,0,0,0,0,0,0,71644
24631,4304,901,1642,1140,439,182,357,225,145,10,0,135,80,47,8,39,0,33,0,33,0,132,89,24,0,65,43,20,20,0,0,23,4,0,19,71646
24632,1289,288,602,217,116,66,128,84,59,0,0,59,25,25,11,0,14,0,0,0,0,44,36,0,0,36,8,8,0,0,8,0,0,0,0,71647
24633,116,39,0,54,10,13,0,0,0,0,0,0,0,0,0,0,0,0,0,0,0,0,0,0,0,0,0,0,0,0,0,0,0,0,0,71651
24634,884,173,403,255,45,8,31,8,5,0,0,5,3,0,0,0,0,3,0,0,3,23,23,0,0,23,0,0,0,0,0,0,0,0,0,71652
24635,3449,789,1338,692,413,217,250,115,75,20,5,50,40,20,0,16,4,20,6,14,0,135,88,0,13,75,47,47,33,0,14,0,0,0,0,71653
24636,2993,446,1259,804,336,148,204,77,44,0,0,44,33,32,17,15,0,1,0,0,1,127,112,54,29,29,15,15,0,0,15,0,0,0,0,71654
24637,9521,1751,3294,2651,1252,573,1225,643,527,42,121,364,116,94,40,51,3,22,0,0,22,582,540,87,83,370,42,35,5,9,21,7,2,0,5,71655
24638,475,104,207,125,35,4,11,5,5,0,0,5,0,0,0,0,0,0,0,0,0,6,6,0,0,6,0,0,0,0,0,0,0,0,0,71658
24639,105,11,27,20,47,0,0,0,0,0,0,0,0,0,0,0,0,0,0,0,0,0,0,0,0,0,0,0,0,0,0,0,0,0,0,71659
24640,564,79,276,73,113,23,114,94,94,0,6,88,0,0,0,0,0,0,0,0,0,20,20,0,0,20,0,0,0,0,0,0,0,0,0,71660
24641,230,72,114,36,8,0,22,8,8,5,0,3,0,0,0,0,0,0,0,0,0,14,14,0,0,14,0,0,0,0,0,0,0,0,0,71661
24642,77,39,8,6,24,0,0,0,0,0,0,0,0,0,0,0,0,0,0,0,0,0,0,0,0,0,0,0,0,0,0,0,0,0,0,71662
24643,533,129,184,191,13,16,27,7,7,2,0,5,0,0,0,0,0,0,0,0,0,20,20,0,0,20,0,0,0,0,0,0,0,0,0,71663
24644,4126,631,1763,1149,442,141,348,166,141,22,0,119,25,25,12,13,0,0,0,0,0,182,158,26,16,116,24,24,5,0,19,0,0,0,0,71665
24645,39,11,4,24,0,0,12,12,12,0,0,12,0,0,0,0,0,0,0,0,0,0,0,0,0,0,0,0,0,0,0,0,0,0,0,71666
24646,5122,916,2266,1395,412,133,407,279,239,35,29,175,40,40,40,0,0,0,0,0,0,128,85,19,4,62,43,8,3,5,0,35,35,0,0,71667
24647,1180,217,523,163,206,71,97,84,78,60,0,18,6,6,0,6,0,0,0,0,0,13,13,0,0,13,0,0,0,0,0,0,0,0,0,71670
24648,5840,1344,2463,1415,458,160,358,195,125,9,0,116,70,18,18,0,0,52,0,0,52,163,102,13,22,67,61,57,57,0,0,4,0,0,4,71671
24649,506,165,216,110,13,2,40,26,26,0,0,26,0,0,0,0,0,0,0,0,0,14,14,0,0,14,0,0,0,0,0,0,0,0,0,71674
24650,1422,293,592,270,179,88,74,24,24,0,0,24,0,0,0,0,0,0,0,0,0,50,50,2,0,48,0,0,0,0,0,0,0,0,0,71675
24651,434,99,216,68,32,19,10,4,4,0,0,4,0,0,0,0,0,0,0,0,0,6,6,0,0,6,0,0,0,0,0,0,0,0,0,71676
24652,96,31,49,13,3,0,2,2,1,0,0,1,1,1,0,0,1,0,0,0,0,0,0,0,0,0,0,0,0,0,0,0,0,0,0,71677
24653,13514,2063,5267,3951,1609,624,1004,519,469,111,74,284,50,41,0,8,33,9,0,7,2,485,388,89,40,259,97,49,6,17,26,48,0,48,0,71701
24654,10,2,6,2,0,0,0,0,0,0,0,0,0,0,0,0,0,0,0,0,0,0,0,0,0,0,0,0,0,0,0,0,0,0,0,71711
24655,1968,248,963,594,127,36,83,51,30,5,0,25,21,20,15,5,0,1,0,0,1,32,26,0,2,24,6,6,0,0,6,0,0,0,0,71720
24656,90,46,13,30,0,1,0,0,0,0,0,0,0,0,0,0,0,0,0,0,0,0,0,0,0,0,0,0,0,0,0,0,0,0,0,71722
24657,278,57,128,68,22,3,11,11,11,11,0,0,0,0,0,0,0,0,0,0,0,0,0,0,0,0,0,0,0,0,0,0,0,0,0,71724
24658,451,169,220,50,10,2,43,22,17,2,3,12,5,5,5,0,0,0,0,0,0,21,13,0,0,13,8,8,1,4,3,0,0,0,0,71725
24659,866,179,412,198,65,12,60,37,35,0,33,2,2,0,0,0,0,2,0,0,2,23,23,11,11,1,0,0,0,0,0,0,0,0,0,71726
24660,21610,3883,7615,6379,2627,1106,1550,815,681,159,58,464,134,69,13,32,24,65,17,0,48,735,572,99,52,421,163,70,52,0,18,93,24,37,32,71730
24661,1068,151,422,293,128,74,98,55,32,5,10,17,23,19,19,0,0,4,4,0,0,43,43,4,8,31,0,0,0,0,0,0,0,0,0,71740
24662,4014,638,2070,885,303,118,464,261,204,92,0,112,57,11,0,0,11,46,10,0,36,203,131,35,0,96,72,27,27,0,0,45,0,0,45,71742
24663,2878,421,1282,847,288,40,215,100,90,0,0,90,10,0,0,0,0,10,0,0,10,115,61,0,0,61,54,8,0,8,0,46,0,13,33,71743
24664,2496,490,1330,489,122,65,132,64,64,9,0,55,0,0,0,0,0,0,0,0,0,68,68,0,0,68,0,0,0,0,0,0,0,0,0,71744
24665,194,30,112,45,2,5,3,2,0,0,0,0,2,2,2,0,0,0,0,0,0,1,0,0,0,0,1,1,1,0,0,0,0,0,0,71745
24666,707,155,394,99,37,22,41,28,28,5,0,23,0,0,0,0,0,0,0,0,0,13,3,3,0,0,10,0,0,0,0,10,0,0,10,71747
24667,1580,209,730,508,78,55,239,129,89,13,0,76,40,0,0,0,0,40,0,0,40,110,110,0,0,110,0,0,0,0,0,0,0,0,0,71749
24668,691,104,134,205,170,78,77,65,47,0,0,47,18,18,5,13,0,0,0,0,0,12,12,0,11,1,0,0,0,0,0,0,0,0,0,71751
24669,629,124,241,200,43,21,57,16,6,0,0,6,10,0,0,0,0,10,0,10,0,41,41,1,0,40,0,0,0,0,0,0,0,0,0,71752
24670,10194,1391,3448,2944,1773,638,1591,745,655,130,35,490,90,52,39,0,13,38,24,0,14,846,650,147,87,416,196,119,104,0,15,77,0,0,77,71753
24671,284,61,72,68,83,0,0,0,0,0,0,0,0,0,0,0,0,0,0,0,0,0,0,0,0,0,0,0,0,0,0,0,0,0,0,71758
24672,481,29,136,151,74,91,62,49,49,0,0,49,0,0,0,0,0,0,0,0,0,13,7,7,0,0,6,0,0,0,0,6,0,6,0,71759
24673,1778,262,766,522,168,60,133,54,54,15,2,37,0,0,0,0,0,0,0,0,0,79,79,22,7,50,0,0,0,0,0,0,0,0,0,71762
24674,1030,230,562,163,42,33,22,20,20,4,0,16,0,0,0,0,0,0,0,0,0,2,2,0,0,2,0,0,0,0,0,0,0,0,0,71763
24675,1496,277,739,392,59,29,105,56,54,0,10,44,2,2,0,0,2,0,0,0,0,49,44,6,0,38,5,5,0,5,0,0,0,0,0,71764
24676,1532,332,699,393,102,6,157,46,19,0,0,19,27,0,0,0,0,27,0,0,27,111,71,5,0,66,40,40,0,0,40,0,0,0,0,71765
24677,473,95,190,148,39,1,25,9,9,0,0,9,0,0,0,0,0,0,0,0,0,16,16,0,6,10,0,0,0,0,0,0,0,0,0,71766
24678,2297,410,1153,522,119,93,137,63,54,23,5,26,9,0,0,0,0,9,0,0,9,74,67,18,19,30,7,0,0,0,0,7,0,7,0,71770
24679,0,0,0,0,0,0,0,0,0,0,0,0,0,0,0,0,0,0,0,0,0,0,0,0,0,0,0,0,0,0,0,0,0,0,0,71772
24680,10729,2168,3772,3241,1161,387,747,429,290,100,43,147,139,135,22,46,67,4,0,0,4,318,188,45,7,136,130,69,50,0,19,61,0,0,61,71801
24681,56,0,8,40,0,8,0,0,0,0,0,0,0,0,0,0,0,0,0,0,0,0,0,0,0,0,0,0,0,0,0,0,0,0,0,71820
24682,6585,1009,2495,2411,471,199,354,201,177,0,39,138,24,16,6,0,10,8,8,0,0,153,143,60,0,83,10,10,10,0,0,0,0,0,0,71822
24683,39,4,19,4,7,5,5,5,5,0,0,5,0,0,0,0,0,0,0,0,0,0,0,0,0,0,0,0,0,0,0,0,0,0,0,71823
24684,402,84,138,143,16,21,8,0,0,0,0,0,0,0,0,0,0,0,0,0,0,8,8,0,0,8,0,0,0,0,0,0,0,0,0,71825
24685,929,346,320,196,43,24,80,56,23,0,0,23,33,33,14,0,19,0,0,0,0,24,24,0,0,24,0,0,0,0,0,0,0,0,0,71826
24686,549,80,284,161,18,6,52,26,26,10,0,16,0,0,0,0,0,0,0,0,0,26,26,13,0,13,0,0,0,0,0,0,0,0,0,71827
24687,6734,2573,1940,1523,488,210,669,294,154,35,11,108,140,10,10,0,0,130,130,0,0,375,233,21,33,179,142,47,0,29,18,95,0,0,95,71832
24688,1546,375,571,361,137,102,97,62,48,0,0,48,14,0,0,0,0,14,0,0,14,35,35,4,0,31,0,0,0,0,0,0,0,0,0,71833
24689,1116,123,532,381,58,22,70,35,25,0,0,25,10,0,0,0,0,10,10,0,0,35,12,0,0,12,23,16,0,16,0,7,0,0,7,71834
24690,760,104,319,261,54,22,76,32,12,12,0,0,20,16,16,0,0,4,0,0,4,44,44,33,0,11,0,0,0,0,0,0,0,0,0,71835
24691,1968,333,841,531,232,31,242,111,88,40,0,48,23,15,9,0,6,8,0,0,8,131,113,15,3,95,18,10,10,0,0,8,0,0,8,71836
24692,3602,519,1660,972,348,103,402,258,238,46,0,192,20,20,20,0,0,0,0,0,0,144,84,12,8,64,60,56,0,26,30,4,4,0,0,71837
24693,740,114,376,205,37,8,77,12,12,0,0,12,0,0,0,0,0,0,0,0,0,65,61,12,0,49,4,4,4,0,0,0,0,0,0,71838
24694,232,43,127,56,5,1,28,28,12,0,0,12,16,16,7,9,0,0,0,0,0,0,0,0,0,0,0,0,0,0,0,0,0,0,0,71839
24695,530,87,223,185,17,18,87,32,30,27,0,3,2,2,0,2,0,0,0,0,0,55,55,0,0,55,0,0,0,0,0,0,0,0,0,71841
24696,1289,444,464,317,31,33,141,104,104,37,0,67,0,0,0,0,0,0,0,0,0,37,32,2,0,30,5,0,0,0,0,5,5,0,0,71842
24697,1499,350,720,271,130,28,157,56,42,0,0,42,14,8,0,0,8,6,0,6,0,101,94,0,9,85,7,7,0,7,0,0,0,0,0,71845
24698,1966,456,777,622,79,32,113,63,59,0,0,59,4,0,0,0,0,4,0,4,0,50,37,1,19,17,13,13,0,0,13,0,0,0,0,71846
24699,510,77,286,102,32,13,165,0,0,0,0,0,0,0,0,0,0,0,0,0,0,165,128,49,0,79,37,37,0,37,0,0,0,0,0,71847
24700,1636,359,623,463,114,77,115,48,20,0,0,20,28,0,0,0,0,28,28,0,0,67,67,10,0,57,0,0,0,0,0,0,0,0,0,71851
24701,6654,1446,2460,1925,507,316,512,296,169,58,63,48,127,100,93,0,7,27,0,13,14,216,131,55,34,42,85,24,17,7,0,61,37,24,0,71852
24702,175,75,51,42,4,3,1,0,0,0,0,0,0,0,0,0,0,0,0,0,0,1,1,0,0,1,0,0,0,0,0,0,0,0,0,71853
24703,24057,3637,9335,7587,2465,1033,1626,840,575,67,19,489,265,229,96,42,91,36,9,0,27,786,625,212,18,395,161,127,59,20,48,34,6,0,28,71854
24704,401,8,264,55,60,14,0,0,0,0,0,0,0,0,0,0,0,0,0,0,0,0,0,0,0,0,0,0,0,0,0,0,0,0,0,71855
24705,4082,670,1587,1212,397,216,303,62,45,11,0,34,17,0,0,0,0,17,0,17,0,241,213,48,20,145,28,0,0,0,0,28,0,0,28,71857
24706,1269,247,584,306,107,25,159,57,33,4,11,18,24,12,12,0,0,12,0,0,12,102,94,0,17,77,8,8,0,0,8,0,0,0,0,71858
24707,362,70,86,95,111,0,21,21,21,0,0,21,0,0,0,0,0,0,0,0,0,0,0,0,0,0,0,0,0,0,0,0,0,0,0,71859
24708,2004,361,954,337,210,142,201,108,102,0,0,102,6,6,0,6,0,0,0,0,0,93,72,0,38,34,21,21,21,0,0,0,0,0,0,71860
24709,1300,169,535,429,104,63,77,54,16,0,0,16,38,38,0,26,12,0,0,0,0,23,23,2,0,21,0,0,0,0,0,0,0,0,0,71861
24710,501,75,215,165,34,12,97,86,86,0,0,86,0,0,0,0,0,0,0,0,0,11,11,0,0,11,0,0,0,0,0,0,0,0,0,71862
24711,152,45,63,35,7,2,7,0,0,0,0,0,0,0,0,0,0,0,0,0,0,7,4,0,0,4,3,3,0,3,0,0,0,0,0,71865
24712,218,39,118,49,3,9,35,0,0,0,0,0,0,0,0,0,0,0,0,0,0,35,13,0,0,13,22,22,0,0,22,0,0,0,0,71866
24713,20170,3205,6379,6235,2746,1605,1583,825,699,125,34,540,126,79,11,13,55,47,0,24,23,758,558,123,45,390,200,129,75,12,42,71,63,0,8,71901
24714,13758,710,3466,5003,2646,1933,210,107,103,0,19,84,4,4,4,0,0,0,0,0,0,103,82,21,0,61,21,21,21,0,0,0,0,0,0,71909
24715,31396,4219,9872,10861,4293,2151,1677,840,692,137,71,484,148,111,56,34,21,37,15,22,0,837,569,163,63,343,268,229,76,95,58,39,0,39,0,71913
24716,2386,476,1100,649,60,101,204,48,46,6,14,26,2,2,0,0,2,0,0,0,0,156,126,36,0,90,30,3,2,0,1,27,0,0,27,71921
24717,137,43,40,36,17,1,8,6,6,0,0,6,0,0,0,0,0,0,0,0,0,2,2,2,0,0,0,0,0,0,0,0,0,0,0,71922
24718,8660,1045,2643,2504,1299,1169,1559,781,708,232,39,437,73,34,2,32,0,39,0,32,7,778,741,281,71,389,37,37,0,0,37,0,0,0,0,71923
24719,3036,528,1220,856,225,207,254,171,131,0,7,124,40,16,16,0,0,24,0,24,0,83,77,17,8,52,6,0,0,0,0,6,0,0,6,71929
24720,1073,206,380,328,33,126,232,146,105,46,0,59,41,0,0,0,0,41,41,0,0,86,86,29,0,57,0,0,0,0,0,0,0,0,0,71933
24721,576,173,151,232,14,6,34,34,34,0,0,34,0,0,0,0,0,0,0,0,0,0,0,0,0,0,0,0,0,0,0,0,0,0,0,71935
24722,1505,259,543,559,111,33,114,71,43,0,0,43,28,9,0,3,6,19,0,0,19,43,30,10,3,17,13,13,13,0,0,0,0,0,0,71937
24723,1084,123,348,423,128,62,68,24,18,0,2,16,6,6,0,6,0,0,0,0,0,44,44,2,0,42,0,0,0,0,0,0,0,0,0,71940
24724,1622,209,609,594,146,64,121,72,67,27,2,38,5,5,0,0,5,0,0,0,0,49,25,8,0,17,24,24,0,0,24,0,0,0,0,71941
24725,3418,726,1231,1011,256,194,238,108,85,0,30,55,23,4,4,0,0,19,19,0,0,130,119,9,7,103,11,0,0,0,0,11,7,4,0,71943
24726,482,90,171,159,48,14,54,46,21,0,0,21,25,12,12,0,0,13,13,0,0,8,3,0,0,3,5,5,5,0,0,0,0,0,0,71944
24727,1054,172,421,358,41,62,182,99,99,67,0,32,0,0,0,0,0,0,0,0,0,83,65,21,0,44,18,18,18,0,0,0,0,0,0,71945
24728,1477,189,827,305,142,14,229,108,108,34,0,74,0,0,0,0,0,0,0,0,0,121,102,0,0,102,19,19,0,19,0,0,0,0,0,71949
24729,629,123,278,187,26,15,71,66,41,6,6,29,25,25,0,0,25,0,0,0,0,5,2,0,2,0,3,3,0,3,0,0,0,0,0,71950
24730,98,4,45,20,29,0,0,0,0,0,0,0,0,0,0,0,0,0,0,0,0,0,0,0,0,0,0,0,0,0,0,0,0,0,0,71952
24731,10335,1365,4126,3476,944,424,493,196,159,45,36,78,37,32,0,24,8,5,0,5,0,297,237,160,0,77,60,60,60,0,0,0,0,0,0,71953
24732,1488,326,729,391,6,36,142,87,76,4,20,52,11,9,0,9,0,2,0,0,2,55,55,21,0,34,0,0,0,0,0,0,0,0,0,71956
24733,2329,321,908,694,264,142,95,30,13,3,6,4,17,11,0,10,1,6,0,0,6,65,47,29,0,18,18,3,0,3,0,15,0,0,15,71957
24734,1583,288,608,457,107,123,80,54,25,0,0,25,29,22,15,0,7,7,4,0,3,26,25,0,7,18,1,0,0,0,0,1,0,1,0,71958
24735,541,128,239,167,7,0,38,0,0,0,0,0,0,0,0,0,0,0,0,0,0,38,9,0,0,9,29,29,29,0,0,0,0,0,0,71959
24736,851,202,326,247,51,25,89,15,9,0,0,9,6,6,6,0,0,0,0,0,0,74,17,7,0,10,57,39,39,0,0,18,18,0,0,71960
24737,883,109,436,235,59,44,40,14,14,0,0,14,0,0,0,0,0,0,0,0,0,26,26,12,0,14,0,0,0,0,0,0,0,0,0,71961
24738,820,176,344,254,13,33,37,32,14,0,0,14,18,18,0,0,18,0,0,0,0,5,5,0,3,2,0,0,0,0,0,0,0,0,0,71962
24739,2559,283,800,978,270,228,292,144,111,10,0,101,33,33,11,22,0,0,0,0,0,148,148,39,29,80,0,0,0,0,0,0,0,0,0,71964
24740,118,35,44,39,0,0,0,0,0,0,0,0,0,0,0,0,0,0,0,0,0,0,0,0,0,0,0,0,0,0,0,0,0,0,0,71965
24741,3006,408,905,1259,296,138,343,241,219,96,0,123,22,19,0,0,19,3,0,0,3,102,78,50,0,28,24,24,0,0,24,0,0,0,0,71968
24742,268,42,132,72,18,4,14,0,0,0,0,0,0,0,0,0,0,0,0,0,0,14,14,0,0,14,0,0,0,0,0,0,0,0,0,71969
24743,669,139,233,172,87,38,49,26,26,0,0,26,0,0,0,0,0,0,0,0,0,23,9,0,0,9,14,14,14,0,0,0,0,0,0,71970
24744,359,58,179,58,13,51,98,70,52,0,0,52,18,18,18,0,0,0,0,0,0,28,28,2,0,26,0,0,0,0,0,0,0,0,0,71971
24745,139,32,46,34,18,9,26,14,14,4,0,10,0,0,0,0,0,0,0,0,0,12,12,0,0,12,0,0,0,0,0,0,0,0,0,71972
24746,835,215,304,241,75,0,59,10,5,0,5,0,5,5,0,5,0,0,0,0,0,49,41,12,0,29,8,0,0,0,0,8,8,0,0,71973
24747,21,0,0,16,0,5,140,114,114,1,9,104,0,0,0,0,0,0,0,0,0,26,26,6,0,20,0,0,0,0,0,0,0,0,0,71998
24748,7,0,0,7,0,0,197,26,26,4,0,22,0,0,0,0,0,0,0,0,0,171,171,37,0,134,0,0,0,0,0,0,0,0,0,71999
24749,325,118,131,34,42,0,13,8,8,8,0,0,0,0,0,0,0,0,0,0,0,5,5,5,0,0,0,0,0,0,0,0,0,0,0,72001
24750,9561,1230,3441,2705,1632,553,620,366,192,26,67,99,174,129,42,6,81,45,9,0,36,254,203,47,13,143,51,37,33,0,4,14,8,6,0,72002
24751,587,54,263,218,45,7,31,17,17,0,3,14,0,0,0,0,0,0,0,0,0,14,9,0,0,9,5,4,1,1,2,1,0,0,1,72003
24752,782,223,336,173,30,20,41,29,29,0,3,26,0,0,0,0,0,0,0,0,0,12,12,0,0,12,0,0,0,0,0,0,0,0,0,72004
24753,116,30,58,9,0,19,8,0,0,0,0,0,0,0,0,0,0,0,0,0,0,8,8,8,0,0,0,0,0,0,0,0,0,0,0,72005
24754,1734,507,732,320,140,35,165,91,48,10,4,34,43,43,0,23,20,0,0,0,0,74,70,0,0,70,4,4,4,0,0,0,0,0,0,72006
24755,3847,560,1213,1226,619,229,379,179,96,30,0,66,83,66,0,0,66,17,0,0,17,200,200,56,7,137,0,0,0,0,0,0,0,0,0,72007
24756,4317,1079,1930,910,269,129,241,80,55,14,0,41,25,17,17,0,0,8,8,0,0,161,94,20,0,74,67,67,26,0,41,0,0,0,0,72010
24757,2864,359,1347,836,221,101,218,131,96,20,0,76,35,28,28,0,0,7,0,7,0,87,68,21,15,32,19,0,0,0,0,19,0,0,19,72011
24758,8173,1604,2744,2628,661,536,776,452,343,91,19,233,109,83,83,0,0,26,0,0,26,324,258,93,0,165,66,34,0,19,15,32,0,0,32,72012
24759,1404,330,480,484,66,44,55,47,35,0,13,22,12,0,0,0,0,12,0,0,12,8,8,8,0,0,0,0,0,0,0,0,0,0,0,72013
24760,49,20,19,7,0,3,8,0,0,0,0,0,0,0,0,0,0,0,0,0,0,8,0,0,0,0,8,0,0,0,0,8,0,0,8,72014
24761,18730,2958,6003,5870,2659,1240,1432,723,601,181,43,377,122,122,122,0,0,0,0,0,0,709,542,219,99,224,167,139,79,58,2,28,0,7,21,72015
24762,2166,271,847,666,210,172,244,146,136,14,4,118,10,10,0,10,0,0,0,0,0,98,95,0,9,86,3,3,0,3,0,0,0,0,0,72016
24763,573,107,255,152,52,7,42,36,7,0,0,7,29,17,17,0,0,12,12,0,0,6,6,0,2,4,0,0,0,0,0,0,0,0,0,72017
24764,16107,1251,5471,5157,2706,1522,1165,572,464,188,22,254,108,49,49,0,0,59,0,0,59,593,529,170,42,317,64,27,27,0,0,37,0,0,37,72019
24765,2765,712,1317,469,161,106,142,106,76,0,8,68,30,17,17,0,0,13,0,4,9,36,16,4,0,12,20,16,0,5,11,4,0,0,4,72020
24766,2888,738,992,847,242,69,253,137,130,8,0,122,7,0,0,0,0,7,0,0,7,116,116,28,0,88,0,0,0,0,0,0,0,0,0,72021
24767,10277,548,3223,3494,2174,838,765,365,336,173,28,135,29,29,27,0,2,0,0,0,0,400,261,100,0,161,139,79,79,0,0,60,60,0,0,72022
24768,22708,2079,7142,8630,3330,1527,1584,759,672,176,101,395,87,29,29,0,0,58,49,9,0,825,684,219,122,343,141,127,0,72,55,14,0,0,14,72023
24769,2622,605,1098,516,325,78,170,72,72,8,24,40,0,0,0,0,0,0,0,0,0,98,98,26,0,72,0,0,0,0,0,0,0,0,0,72024
24770,483,63,203,108,95,14,60,23,23,0,0,23,0,0,0,0,0,0,0,0,0,37,37,23,0,14,0,0,0,0,0,0,0,0,0,72025
24771,342,49,157,129,7,0,21,12,12,9,0,3,0,0,0,0,0,0,0,0,0,9,0,0,0,0,9,9,0,9,0,0,0,0,0,72026
24772,1084,148,452,272,167,45,135,70,59,25,0,34,11,11,7,0,4,0,0,0,0,65,29,8,8,13,36,36,36,0,0,0,0,0,0,72027
24773,1235,278,523,334,83,17,94,52,47,9,4,34,5,0,0,0,0,5,0,0,5,42,27,4,0,23,15,15,10,0,5,0,0,0,0,72029
24774,506,115,189,112,46,44,37,25,25,0,0,25,0,0,0,0,0,0,0,0,0,12,12,0,0,12,0,0,0,0,0,0,0,0,0,72030
24775,4821,1072,1803,1259,461,226,506,274,200,6,0,194,74,42,23,0,19,32,0,32,0,232,214,24,17,173,18,9,6,0,3,9,1,0,8,72031
24776,19619,2448,6323,6384,3144,1320,2200,1069,818,242,97,479,251,135,91,22,22,116,46,49,21,1131,1027,285,46,696,104,55,36,19,0,49,3,0,46,72032
24777,26536,2024,6092,7912,6658,3850,2396,1078,997,252,4,741,81,73,14,13,46,8,0,0,8,1318,1114,401,48,665,204,134,23,63,48,70,8,50,12,72034
24778,0,0,0,0,0,0,1047,403,403,65,30,308,0,0,0,0,0,0,0,0,0,644,644,146,17,481,0,0,0,0,0,0,0,0,0,72035
24779,521,143,232,101,32,13,61,16,0,0,0,0,16,5,0,5,0,11,0,0,11,45,44,0,12,32,1,0,0,0,0,1,0,0,1,72036
24780,25,9,13,1,2,0,0,0,0,0,0,0,0,0,0,0,0,0,0,0,0,0,0,0,0,0,0,0,0,0,0,0,0,0,0,72037
24781,44,0,29,15,0,0,0,0,0,0,0,0,0,0,0,0,0,0,0,0,0,0,0,0,0,0,0,0,0,0,0,0,0,0,0,72038
24782,1716,286,768,510,108,44,20,9,9,3,2,4,0,0,0,0,0,0,0,0,0,11,8,5,0,3,3,3,3,0,0,0,0,0,0,72039
24783,2143,446,1010,498,123,66,112,49,49,18,0,31,0,0,0,0,0,0,0,0,0,63,63,16,6,41,0,0,0,0,0,0,0,0,0,72040
24784,1021,228,430,228,48,87,55,27,21,0,0,21,6,0,0,0,0,6,6,0,0,28,28,4,14,10,0,0,0,0,0,0,0,0,0,72041
24785,3528,689,1410,961,281,187,195,45,37,12,22,3,8,4,0,0,4,4,0,0,4,150,131,53,16,62,19,19,14,0,5,0,0,0,0,72042
24786,746,110,300,224,42,70,11,11,11,0,0,11,0,0,0,0,0,0,0,0,0,0,0,0,0,0,0,0,0,0,0,0,0,0,0,72044
24787,837,137,309,305,23,63,70,38,25,0,0,25,13,13,13,0,0,0,0,0,0,32,32,0,12,20,0,0,0,0,0,0,0,0,0,72045
24788,3059,634,1207,835,254,129,251,150,115,30,41,44,35,20,0,0,20,15,0,0,15,101,68,12,12,44,33,31,0,31,0,2,2,0,0,72046
24789,579,118,251,132,58,20,39,21,20,12,0,8,1,1,0,0,1,0,0,0,0,18,18,5,0,13,0,0,0,0,0,0,0,0,0,72047
24790,29,0,17,12,0,0,0,0,0,0,0,0,0,0,0,0,0,0,0,0,0,0,0,0,0,0,0,0,0,0,0,0,0,0,0,72048
24791,338,75,107,109,33,14,43,38,38,0,0,38,0,0,0,0,0,0,0,0,0,5,5,0,0,5,0,0,0,0,0,0,0,0,0,72051
24792,556,86,186,115,118,51,27,2,2,0,0,2,0,0,0,0,0,0,0,0,0,25,25,17,0,8,0,0,0,0,0,0,0,0,0,72055
24793,785,165,271,258,46,45,48,0,0,0,0,0,0,0,0,0,0,0,0,0,0,48,37,10,0,27,11,11,0,11,0,0,0,0,0,72057
24794,10081,961,3782,3345,1414,579,876,485,411,195,13,203,74,56,37,11,8,18,11,0,7,391,313,78,66,169,78,53,53,0,0,25,0,0,25,72058
24795,26,5,21,0,0,0,0,0,0,0,0,0,0,0,0,0,0,0,0,0,0,0,0,0,0,0,0,0,0,0,0,0,0,0,0,72059
24796,230,68,95,62,2,3,15,5,5,1,0,4,0,0,0,0,0,0,0,0,0,10,0,0,0,0,10,10,10,0,0,0,0,0,0,72060
24797,100,0,56,25,4,15,0,0,0,0,0,0,0,0,0,0,0,0,0,0,0,0,0,0,0,0,0,0,0,0,0,0,0,0,0,72061
24798,1030,123,539,248,86,34,92,56,43,6,5,32,13,13,13,0,0,0,0,0,0,36,27,6,0,21,9,0,0,0,0,9,0,0,9,72063
24799,1768,312,879,428,112,37,85,73,73,9,0,64,0,0,0,0,0,0,0,0,0,12,12,0,0,12,0,0,0,0,0,0,0,0,0,72064
24800,3237,448,1467,809,387,126,284,100,65,33,0,32,35,35,23,12,0,0,0,0,0,184,184,116,0,68,0,0,0,0,0,0,0,0,0,72065
24801,2459,410,1001,701,259,88,78,64,64,11,0,53,0,0,0,0,0,0,0,0,0,14,12,12,0,0,2,2,2,0,0,0,0,0,0,72067
24802,313,109,132,39,26,7,20,11,11,0,0,11,0,0,0,0,0,0,0,0,0,9,9,0,0,9,0,0,0,0,0,0,0,0,0,72068
24803,1275,340,375,286,220,54,204,94,59,0,33,26,35,35,4,31,0,0,0,0,0,110,110,39,2,69,0,0,0,0,0,0,0,0,0,72069
24804,1316,216,563,414,123,0,97,54,53,30,0,23,1,1,0,0,1,0,0,0,0,43,43,0,0,43,0,0,0,0,0,0,0,0,0,72070
24805,374,52,223,76,20,3,11,7,7,0,0,7,0,0,0,0,0,0,0,0,0,4,3,1,0,2,1,1,1,0,0,0,0,0,0,72072
24806,693,124,364,161,16,28,33,16,14,0,0,14,2,0,0,0,0,2,0,0,2,17,17,5,0,12,0,0,0,0,0,0,0,0,0,72073
24807,84,30,49,3,0,2,9,3,3,0,0,3,0,0,0,0,0,0,0,0,0,6,6,0,0,6,0,0,0,0,0,0,0,0,0,72074
24808,24870,3407,9369,8382,2662,1050,2552,1438,997,235,87,675,441,267,141,64,62,174,56,0,118,1114,919,209,10,700,195,116,74,4,38,79,28,6,45,72076
24809,572,226,116,103,74,53,27,6,0,0,0,0,6,6,0,0,6,0,0,0,0,21,21,0,21,0,0,0,0,0,0,0,0,0,0,72079
24810,604,70,231,66,184,53,22,0,0,0,0,0,0,0,0,0,0,0,0,0,0,22,0,0,0,0,22,0,0,0,0,22,0,0,22,72080
24811,5290,1094,2405,1194,413,184,346,193,144,72,8,64,49,4,4,0,0,45,32,0,13,153,153,67,33,53,0,0,0,0,0,0,0,0,0,72081
24812,1274,550,531,193,0,0,73,29,26,10,0,16,3,3,3,0,0,0,0,0,0,44,36,10,0,26,8,0,0,0,0,8,8,0,0,72082
24813,203,34,86,57,15,11,33,30,30,2,2,26,0,0,0,0,0,0,0,0,0,3,3,0,0,3,0,0,0,0,0,0,0,0,0,72083
24814,918,208,453,184,56,17,158,85,64,10,0,54,21,21,9,12,0,0,0,0,0,73,68,37,0,31,5,5,0,0,5,0,0,0,0,72084
24815,136,42,69,21,3,1,9,7,7,0,0,7,0,0,0,0,0,0,0,0,0,2,0,0,0,0,2,0,0,0,0,2,2,0,0,72085
24816,7469,1305,3107,2054,680,323,536,247,228,45,11,172,19,19,0,19,0,0,0,0,0,289,276,60,30,186,13,13,13,0,0,0,0,0,0,72086
24817,1388,137,504,480,225,42,153,70,70,0,10,60,0,0,0,0,0,0,0,0,0,83,83,0,0,83,0,0,0,0,0,0,0,0,0,72087
24818,2279,225,701,786,363,204,75,39,25,25,0,0,14,14,0,0,14,0,0,0,0,36,11,11,0,0,25,25,0,25,0,0,0,0,0,72088
24819,55,0,0,40,3,12,153,124,30,30,0,0,94,94,94,0,0,0,0,0,0,29,8,8,0,0,21,21,0,0,21,0,0,0,0,72099
24820,2403,580,1037,506,227,53,92,49,36,0,0,36,13,0,0,0,0,13,13,0,0,43,43,0,0,43,0,0,0,0,0,0,0,0,0,72101
24821,1648,420,522,540,94,72,87,40,40,9,0,31,0,0,0,0,0,0,0,0,0,47,43,6,0,37,4,4,0,4,0,0,0,0,0,72102
24822,8945,1269,3548,2886,997,245,476,315,261,21,52,188,54,12,0,7,5,42,0,0,42,161,125,35,8,82,36,35,7,12,16,1,1,0,0,72103
24823,15955,2642,6761,4648,1295,609,1106,543,429,127,62,240,114,99,45,54,0,15,14,0,1,563,483,109,60,314,80,53,28,22,3,27,0,0,27,72104
24824,3722,683,1366,1228,344,101,241,169,153,0,29,124,16,16,16,0,0,0,0,0,0,72,63,16,0,47,9,9,0,9,0,0,0,0,0,72106
24825,237,11,95,86,37,8,30,23,13,0,0,13,10,3,0,3,0,7,0,0,7,7,7,0,0,7,0,0,0,0,0,0,0,0,0,72107
24826,26,0,22,4,0,0,0,0,0,0,0,0,0,0,0,0,0,0,0,0,0,0,0,0,0,0,0,0,0,0,0,0,0,0,0,72108
24827,7965,1174,3221,2316,840,414,708,424,339,54,55,230,85,85,46,39,0,0,0,0,0,284,251,87,8,156,33,33,0,23,10,0,0,0,0,72110
24828,710,68,399,159,55,29,24,22,7,0,0,7,15,15,15,0,0,0,0,0,0,2,2,0,0,2,0,0,0,0,0,0,0,0,0,72111
24829,8325,2085,3702,1788,548,202,466,249,188,19,0,169,61,47,36,5,6,14,0,14,0,217,167,11,15,141,50,8,0,5,3,42,0,0,42,72112
24830,14432,657,2745,4534,4218,2278,774,444,401,170,11,220,43,43,13,0,30,0,0,0,0,330,310,34,0,276,20,20,20,0,0,0,0,0,0,72113
24831,7608,1468,2965,2334,582,259,564,207,116,13,0,103,91,23,0,7,16,68,18,13,37,357,276,5,27,244,81,41,0,14,27,40,18,0,22,72114
24832,15922,553,3119,5543,4436,2271,758,461,364,38,24,302,97,78,34,0,44,19,0,0,19,297,297,90,13,194,0,0,0,0,0,0,0,0,0,72116
24833,8768,1624,3634,2443,796,271,856,285,285,30,87,168,0,0,0,0,0,0,0,0,0,571,345,74,13,258,226,226,136,0,90,0,0,0,0,72117
24834,15282,2249,5882,4875,1484,792,1099,716,603,147,101,355,113,23,16,7,0,90,58,32,0,383,359,131,12,216,24,3,3,0,0,21,21,0,0,72118
24835,3,0,0,3,0,0,43,43,15,0,0,15,28,28,28,0,0,0,0,0,0,0,0,0,0,0,0,0,0,0,0,0,0,0,0,72119
24836,21062,1522,6449,6748,4245,2098,1549,741,691,120,94,477,50,50,18,0,32,0,0,0,0,808,674,307,20,347,134,74,51,0,23,60,10,0,50,72120
24837,1827,227,649,689,212,50,101,56,49,0,0,49,7,7,7,0,0,0,0,0,0,45,41,34,0,7,4,4,0,0,4,0,0,0,0,72121
24838,645,144,283,92,99,27,116,17,17,0,17,0,0,0,0,0,0,0,0,0,0,99,88,28,0,60,11,11,11,0,0,0,0,0,0,72122
24839,262,75,161,22,2,2,31,27,20,0,0,20,7,4,4,0,0,3,0,0,3,4,1,0,0,1,3,0,0,0,0,3,0,0,3,72123
24840,680,148,337,182,11,2,51,0,0,0,0,0,0,0,0,0,0,0,0,0,0,51,22,0,0,22,29,29,17,0,12,0,0,0,0,72125
24841,2589,388,1254,695,166,86,150,106,100,39,0,61,6,6,6,0,0,0,0,0,0,44,34,11,4,19,10,10,7,3,0,0,0,0,0,72126
24842,1403,168,687,368,129,51,73,61,59,14,0,45,2,2,0,2,0,0,0,0,0,12,5,0,5,0,7,3,0,3,0,4,4,0,0,72127
24843,563,76,340,99,27,21,63,23,16,0,0,16,7,0,0,0,0,7,3,0,4,40,36,19,16,1,4,0,0,0,0,4,0,0,4,72128
24844,888,199,377,266,30,16,41,23,21,0,0,21,2,2,2,0,0,0,0,0,0,18,18,0,4,14,0,0,0,0,0,0,0,0,0,72129
24845,324,118,158,40,8,0,11,11,11,11,0,0,0,0,0,0,0,0,0,0,0,0,0,0,0,0,0,0,0,0,0,0,0,0,0,72130
24846,3145,660,1265,788,300,132,212,85,65,31,0,34,20,20,0,20,0,0,0,0,0,127,109,43,0,66,18,0,0,0,0,18,18,0,0,72131
24847,1917,319,666,636,177,119,154,81,70,26,0,44,11,11,2,0,9,0,0,0,0,73,65,15,0,50,8,3,0,0,3,5,0,5,0,72132
24848,278,86,82,85,13,12,73,26,26,0,0,26,0,0,0,0,0,0,0,0,0,47,47,41,0,6,0,0,0,0,0,0,0,0,0,72134
24849,1672,154,509,506,400,103,175,31,27,0,0,27,4,4,4,0,0,0,0,0,0,144,129,51,9,69,15,0,0,0,0,15,0,0,15,72135
24850,1244,274,557,320,93,0,52,52,52,34,0,18,0,0,0,0,0,0,0,0,0,0,0,0,0,0,0,0,0,0,0,0,0,0,0,72136
24851,1399,254,526,354,186,79,235,99,99,17,0,82,0,0,0,0,0,0,0,0,0,136,74,7,0,67,62,18,18,0,0,44,0,0,44,72137
24852,194,51,72,49,15,7,14,6,0,0,0,0,6,0,0,0,0,6,0,0,6,8,8,8,0,0,0,0,0,0,0,0,0,0,0,72139
24853,224,70,92,37,12,13,13,4,4,0,0,4,0,0,0,0,0,0,0,0,0,9,5,1,0,4,4,0,0,0,0,4,0,0,4,72140
24854,376,97,161,95,23,0,23,0,0,0,0,0,0,0,0,0,0,0,0,0,0,23,23,0,0,23,0,0,0,0,0,0,0,0,0,72141
24855,1987,290,768,523,265,141,100,78,78,0,0,78,0,0,0,0,0,0,0,0,0,22,22,6,0,16,0,0,0,0,0,0,0,0,0,72142
24856,21804,2454,7398,6164,3556,2232,2824,1414,1247,283,111,853,167,121,30,0,91,46,23,0,23,1410,1259,427,44,788,151,138,138,0,0,13,0,13,0,72143
24857,0,0,0,0,0,0,0,0,0,0,0,0,0,0,0,0,0,0,0,0,0,0,0,0,0,0,0,0,0,0,0,0,0,0,0,72149
24858,8017,1051,3068,2175,1201,522,596,277,186,0,44,142,91,73,33,13,27,18,0,0,18,319,290,135,0,155,29,26,17,9,0,3,0,0,3,72150
24859,282,76,150,31,25,0,0,0,0,0,0,0,0,0,0,0,0,0,0,0,0,0,0,0,0,0,0,0,0,0,0,0,0,0,0,72152
24860,1847,352,891,482,49,73,99,30,30,0,0,30,0,0,0,0,0,0,0,0,0,69,47,4,0,43,22,0,0,0,0,22,0,0,22,72153
24861,451,155,187,93,8,8,0,0,0,0,0,0,0,0,0,0,0,0,0,0,0,0,0,0,0,0,0,0,0,0,0,0,0,0,0,72156
24862,904,110,505,146,109,34,44,12,12,0,0,12,0,0,0,0,0,0,0,0,0,32,25,18,0,7,7,7,7,0,0,0,0,0,0,72157
24863,7342,1075,3526,1873,545,323,596,220,161,84,26,51,59,24,14,10,0,35,13,13,9,376,339,105,0,234,37,37,30,0,7,0,0,0,0,72160
24864,0,0,0,0,0,0,0,0,0,0,0,0,0,0,0,0,0,0,0,0,0,0,0,0,0,0,0,0,0,0,0,0,0,0,0,72165
24865,272,77,119,48,26,2,3,0,0,0,0,0,0,0,0,0,0,0,0,0,0,3,3,0,3,0,0,0,0,0,0,0,0,0,0,72166
24866,1226,214,575,316,99,22,78,58,26,7,5,14,32,32,29,0,3,0,0,0,0,20,7,4,0,3,13,13,0,13,0,0,0,0,0,72167
24867,1879,727,904,244,0,4,41,41,0,0,0,0,41,31,0,0,31,10,0,0,10,0,0,0,0,0,0,0,0,0,0,0,0,0,0,72168
24868,146,49,56,16,19,6,6,4,4,0,0,4,0,0,0,0,0,0,0,0,0,2,2,2,0,0,0,0,0,0,0,0,0,0,0,72169
24869,127,18,69,30,10,0,10,0,0,0,0,0,0,0,0,0,0,0,0,0,0,10,10,6,0,4,0,0,0,0,0,0,0,0,0,72170
24870,6171,597,2338,2129,818,289,490,189,176,32,11,133,13,13,0,0,13,0,0,0,0,301,293,66,39,188,8,7,7,0,0,1,0,0,1,72173
24871,193,39,111,27,10,6,5,4,4,0,0,4,0,0,0,0,0,0,0,0,0,1,1,0,0,1,0,0,0,0,0,0,0,0,0,72175
24872,5466,832,2018,1968,486,162,659,448,286,16,56,214,162,79,32,0,47,83,32,0,51,211,170,52,24,94,41,41,41,0,0,0,0,0,0,72176
24873,325,128,96,61,29,11,33,8,8,0,0,8,0,0,0,0,0,0,0,0,0,25,15,0,0,15,10,10,10,0,0,0,0,0,0,72179
24874,36,0,20,10,3,3,2,2,2,2,0,0,0,0,0,0,0,0,0,0,0,0,0,0,0,0,0,0,0,0,0,0,0,0,0,72181
24875,815,19,135,234,261,166,11,0,0,0,0,0,0,0,0,0,0,0,0,0,0,11,0,0,0,0,11,0,0,0,0,11,11,0,0,72201
24876,7624,926,1763,2154,1611,1170,485,255,224,51,11,162,31,0,0,0,0,31,0,5,26,230,210,27,33,150,20,20,0,20,0,0,0,0,0,72202
24877,20298,3887,6617,5899,2662,1233,1673,824,659,100,106,453,165,102,7,68,27,63,0,0,63,849,673,95,51,527,176,75,36,0,39,101,0,19,82,72204
24878,16461,1156,3067,5218,3805,3215,622,375,292,129,37,126,83,0,0,0,0,83,60,15,8,247,150,31,0,119,97,83,0,77,6,14,0,0,14,72205
24879,17692,3156,7450,4841,1607,638,1104,579,459,100,36,323,120,102,18,51,33,18,0,0,18,525,415,131,19,265,110,56,15,0,41,54,28,5,21,72206
24880,7312,185,780,1814,2809,1724,301,200,200,35,0,165,0,0,0,0,0,0,0,0,0,101,101,25,30,46,0,0,0,0,0,0,0,0,0,72207
24881,17328,3736,6436,5284,1410,462,2136,1062,724,220,35,469,338,266,114,21,131,72,28,8,36,1074,845,173,123,549,229,150,89,61,0,79,6,26,47,72209
24882,10162,987,2766,3498,1889,1022,717,459,413,123,0,290,46,28,7,21,0,18,0,0,18,258,217,144,0,73,41,41,41,0,0,0,0,0,0,72210
24883,14662,450,2203,3880,4900,3229,864,437,362,36,0,326,75,23,23,0,0,52,0,52,0,427,353,120,0,233,74,24,0,19,5,50,0,0,50,72211
24884,9126,331,963,2277,3377,2178,441,303,303,37,79,187,0,0,0,0,0,0,0,0,0,138,138,0,0,138,0,0,0,0,0,0,0,0,0,72212
24885,13944,453,1980,3669,4588,3254,983,484,437,85,14,338,47,0,0,0,0,47,0,47,0,499,452,98,35,319,47,36,25,0,11,11,0,0,11,72223
24886,8809,248,1612,2466,2602,1881,576,268,268,131,0,137,0,0,0,0,0,0,0,0,0,308,290,54,0,236,18,18,18,0,0,0,0,0,0,72227
24887,16200,3542,6318,4765,1250,325,1570,847,675,68,62,545,172,85,12,21,52,87,57,6,24,723,558,33,49,476,165,141,35,54,52,24,0,8,16,72301
24888,108,37,52,15,0,4,6,3,3,3,0,0,0,0,0,0,0,0,0,0,0,3,3,0,0,3,0,0,0,0,0,0,0,0,0,72311
24889,15052,2931,4970,4847,1314,990,1429,785,708,96,79,533,77,25,0,25,0,52,6,17,29,644,583,212,0,371,61,58,20,0,38,3,0,0,3,72315
24890,1279,467,704,92,16,0,0,0,0,0,0,0,0,0,0,0,0,0,0,0,0,0,0,0,0,0,0,0,0,0,0,0,0,0,0,72320
24891,88,14,37,26,11,0,7,3,3,0,0,3,0,0,0,0,0,0,0,0,0,4,4,4,0,0,0,0,0,0,0,0,0,0,0,72321
24892,166,38,97,27,0,4,29,16,0,0,0,0,16,0,0,0,0,16,16,0,0,13,13,0,0,13,0,0,0,0,0,0,0,0,0,72322
24893,1493,351,718,323,66,35,115,36,36,26,0,10,0,0,0,0,0,0,0,0,0,79,77,0,0,77,2,2,0,2,0,0,0,0,0,72324
24894,23,4,3,4,12,0,0,0,0,0,0,0,0,0,0,0,0,0,0,0,0,0,0,0,0,0,0,0,0,0,0,0,0,0,0,72325
24895,1519,341,646,360,114,58,106,46,43,26,0,17,3,3,3,0,0,0,0,0,0,60,45,0,0,45,15,8,2,6,0,7,0,7,0,72326
24896,945,207,320,290,88,40,29,6,6,0,0,6,0,0,0,0,0,0,0,0,0,23,23,2,0,21,0,0,0,0,0,0,0,0,0,72327
24897,13,7,3,0,3,0,0,0,0,0,0,0,0,0,0,0,0,0,0,0,0,0,0,0,0,0,0,0,0,0,0,0,0,0,0,72328
24898,89,41,26,22,0,0,0,0,0,0,0,0,0,0,0,0,0,0,0,0,0,0,0,0,0,0,0,0,0,0,0,0,0,0,0,72329
24899,431,163,179,62,27,0,61,19,17,4,0,13,2,0,0,0,0,2,0,0,2,42,30,0,0,30,12,12,0,3,9,0,0,0,0,72330
24900,1934,560,700,545,71,58,259,127,107,41,0,66,20,20,0,20,0,0,0,0,0,132,105,4,13,88,27,0,0,0,0,27,0,20,7,72331
24901,36,24,12,0,0,0,10,4,4,0,0,4,0,0,0,0,0,0,0,0,0,6,0,0,0,0,6,6,0,0,6,0,0,0,0,72332
24902,490,151,200,119,12,8,24,18,7,0,0,7,11,0,0,0,0,11,0,0,11,6,6,0,0,6,0,0,0,0,0,0,0,0,0,72333
24903,13295,3065,4729,3813,1076,612,1103,556,480,83,45,352,76,64,0,54,10,12,0,8,4,547,441,97,40,304,106,56,33,23,0,50,21,0,29,72335
24904,15,0,0,7,8,0,0,0,0,0,0,0,0,0,0,0,0,0,0,0,0,0,0,0,0,0,0,0,0,0,0,0,0,0,0,72338
24905,99,44,26,16,13,0,6,6,6,0,0,6,0,0,0,0,0,0,0,0,0,0,0,0,0,0,0,0,0,0,0,0,0,0,0,72339
24906,58,10,0,36,12,0,0,0,0,0,0,0,0,0,0,0,0,0,0,0,0,0,0,0,0,0,0,0,0,0,0,0,0,0,0,72340
24907,166,18,54,49,40,5,68,14,9,0,0,9,5,5,5,0,0,0,0,0,0,54,54,0,0,54,0,0,0,0,0,0,0,0,0,72341
24908,3123,811,968,741,400,203,344,205,205,9,64,132,0,0,0,0,0,0,0,0,0,139,106,9,46,51,33,0,0,0,0,33,0,17,16,72342
24909,488,177,167,113,19,12,18,18,18,0,0,18,0,0,0,0,0,0,0,0,0,0,0,0,0,0,0,0,0,0,0,0,0,0,0,72346
24910,507,95,257,78,60,17,35,27,19,8,0,11,8,0,0,0,0,8,8,0,0,8,8,7,0,1,0,0,0,0,0,0,0,0,0,72347
24911,1801,440,701,485,149,26,203,131,100,0,0,100,31,15,4,11,0,16,0,15,1,72,70,8,0,62,2,2,0,2,0,0,0,0,0,72348
24912,884,187,376,125,162,34,44,16,10,0,0,10,6,6,3,0,3,0,0,0,0,28,24,19,0,5,4,3,0,0,3,1,0,0,1,72350
24913,396,93,164,106,23,10,26,12,12,3,7,2,0,0,0,0,0,0,0,0,0,14,14,3,0,11,0,0,0,0,0,0,0,0,0,72351
24914,54,0,18,36,0,0,12,0,0,0,0,0,0,0,0,0,0,0,0,0,0,12,12,0,0,12,0,0,0,0,0,0,0,0,0,72353
24915,1542,524,619,288,96,15,194,90,50,22,0,28,40,40,26,14,0,0,0,0,0,104,100,0,29,71,4,0,0,0,0,4,0,0,4,72354
24916,2003,650,518,668,92,75,131,89,70,3,2,65,19,19,19,0,0,0,0,0,0,42,42,2,0,40,0,0,0,0,0,0,0,0,0,72355
24917,874,299,317,221,22,15,97,24,9,0,0,9,15,0,0,0,0,15,0,0,15,73,65,26,3,36,8,8,0,8,0,0,0,0,0,72358
24918,297,91,139,52,15,0,10,0,0,0,0,0,0,0,0,0,0,0,0,0,0,10,10,0,0,10,0,0,0,0,0,0,0,0,0,72359
24919,4019,1139,1540,1011,216,113,370,178,148,14,47,87,30,30,0,30,0,0,0,0,0,192,102,10,0,92,90,90,23,17,50,0,0,0,0,72360
24920,9801,1426,2836,3274,1618,647,887,419,367,123,37,207,52,19,17,0,2,33,0,2,31,468,408,99,37,272,60,57,17,34,6,3,0,3,0,72364
24921,2086,549,871,480,157,29,163,113,19,6,0,13,94,82,0,75,7,12,12,0,0,50,45,16,0,29,5,4,0,0,4,1,0,0,1,72365
24922,1636,510,475,477,132,42,127,48,48,0,39,9,0,0,0,0,0,0,0,0,0,79,73,7,33,33,6,6,0,0,6,0,0,0,0,72366
24923,79,38,41,0,0,0,12,0,0,0,0,0,0,0,0,0,0,0,0,0,0,12,12,0,0,12,0,0,0,0,0,0,0,0,0,72367
24924,975,229,387,276,52,31,125,98,36,15,0,21,62,62,62,0,0,0,0,0,0,27,9,0,0,9,18,4,4,0,0,14,0,0,14,72368
24925,5167,1250,1875,1517,392,133,570,344,226,21,89,116,118,100,89,11,0,18,0,0,18,226,180,25,108,47,46,34,6,3,25,12,0,0,12,72370
24926,1480,413,585,343,97,42,100,66,58,23,0,35,8,8,8,0,0,0,0,0,0,34,25,4,14,7,9,0,0,0,0,9,0,0,9,72372
24927,1079,293,509,203,62,12,35,7,7,0,0,7,0,0,0,0,0,0,0,0,0,28,7,0,0,7,21,21,11,0,10,0,0,0,0,72373
24928,773,246,359,137,31,0,34,34,34,0,0,34,0,0,0,0,0,0,0,0,0,0,0,0,0,0,0,0,0,0,0,0,0,0,0,72374
24929,1168,337,407,308,63,53,74,31,31,19,0,12,0,0,0,0,0,0,0,0,0,43,37,0,0,37,6,6,0,0,6,0,0,0,0,72376
24930,18,0,9,9,0,0,0,0,0,0,0,0,0,0,0,0,0,0,0,0,0,0,0,0,0,0,0,0,0,0,0,0,0,0,0,72377
24931,53,38,15,0,0,0,0,0,0,0,0,0,0,0,0,0,0,0,0,0,0,0,0,0,0,0,0,0,0,0,0,0,0,0,0,72379
24932,0,0,0,0,0,0,0,0,0,0,0,0,0,0,0,0,0,0,0,0,0,0,0,0,0,0,0,0,0,0,0,0,0,0,0,72383
24933,609,271,198,112,17,11,32,16,12,6,0,6,4,4,4,0,0,0,0,0,0,16,13,0,0,13,3,3,0,3,0,0,0,0,0,72384
24934,1195,315,584,230,37,29,72,23,15,10,0,5,8,0,0,0,0,8,0,0,8,49,44,13,0,31,5,0,0,0,0,5,0,0,5,72386
24935,162,22,90,26,24,0,11,0,0,0,0,0,0,0,0,0,0,0,0,0,0,11,11,0,0,11,0,0,0,0,0,0,0,0,0,72389
24936,5155,1268,1544,1814,367,162,492,254,114,9,41,64,140,11,11,0,0,129,0,43,86,238,231,34,12,185,7,7,0,0,7,0,0,0,0,72390
24937,334,81,152,66,20,15,11,6,6,0,0,6,0,0,0,0,0,0,0,0,0,5,2,0,0,2,3,3,2,0,1,0,0,0,0,72392
24938,496,153,170,94,79,0,18,11,5,0,0,5,6,2,2,0,0,4,0,4,0,7,4,0,4,0,3,3,0,3,0,0,0,0,0,72394
24939,621,131,277,117,71,25,45,20,6,0,0,6,14,6,6,0,0,8,0,4,4,25,25,6,0,19,0,0,0,0,0,0,0,0,0,72395
24940,8810,1763,4130,1812,755,350,849,420,357,102,33,222,63,59,0,8,51,4,0,0,4,429,345,71,5,269,84,52,52,0,0,32,0,0,32,72396
24941,33536,5885,11055,8715,5020,2861,3908,1784,1521,244,99,1178,263,197,67,53,77,66,0,52,14,2124,1801,325,118,1358,323,190,63,19,108,133,104,29,0,72401
24942,15178,1044,4095,4498,3546,1995,1113,643,577,202,0,375,66,51,29,9,13,15,0,0,15,470,424,120,38,266,46,40,40,0,0,6,0,0,6,72404
24943,344,118,127,66,33,0,55,40,22,0,13,9,18,8,0,0,8,10,5,5,0,15,15,0,0,15,0,0,0,0,0,0,0,0,0,72410
24944,1617,274,743,433,126,41,82,52,36,7,10,19,16,16,4,3,9,0,0,0,0,30,30,3,0,27,0,0,0,0,0,0,0,0,0,72411
24945,391,161,122,67,30,11,47,35,35,0,0,35,0,0,0,0,0,0,0,0,0,12,0,0,0,0,12,12,12,0,0,0,0,0,0,72412
24946,503,134,186,150,11,22,18,13,12,7,2,3,1,0,0,0,0,1,0,0,1,5,5,2,0,3,0,0,0,0,0,0,0,0,0,72413
24947,213,44,52,78,23,16,18,10,1,0,1,0,9,4,4,0,0,5,5,0,0,8,2,2,0,0,6,0,0,0,0,6,0,0,6,72414
24948,791,160,304,253,67,7,123,41,18,0,0,18,23,23,23,0,0,0,0,0,0,82,35,0,0,35,47,35,28,0,7,12,0,0,12,72415
24949,4134,657,1772,1073,480,152,431,203,149,50,0,99,54,34,34,0,0,20,0,0,20,228,188,37,19,132,40,5,5,0,0,35,0,23,12,72416
24950,2712,442,1181,651,315,123,151,65,59,22,0,37,6,3,3,0,0,3,0,3,0,86,86,22,0,64,0,0,0,0,0,0,0,0,0,72417
24951,1187,303,654,147,68,15,118,87,78,0,37,41,9,9,9,0,0,0,0,0,0,31,21,3,0,18,10,10,10,0,0,0,0,0,0,72419
24952,247,62,126,33,25,1,24,16,14,0,1,13,2,2,0,2,0,0,0,0,0,8,7,2,0,5,1,0,0,0,0,1,0,1,0,72421
24953,3763,997,1727,775,167,97,234,140,127,0,0,127,13,13,0,13,0,0,0,0,0,94,84,0,0,84,10,10,0,10,0,0,0,0,0,72422
24954,56,28,8,19,1,0,3,0,0,0,0,0,0,0,0,0,0,0,0,0,0,3,0,0,0,0,3,0,0,0,0,3,3,0,0,72424
24955,229,45,66,85,31,2,2,2,2,2,0,0,0,0,0,0,0,0,0,0,0,0,0,0,0,0,0,0,0,0,0,0,0,0,0,72425
24956,167,14,90,36,27,0,0,0,0,0,0,0,0,0,0,0,0,0,0,0,0,0,0,0,0,0,0,0,0,0,0,0,0,0,0,72426
24957,118,29,69,16,3,1,40,37,37,0,0,37,0,0,0,0,0,0,0,0,0,3,3,2,0,1,0,0,0,0,0,0,0,0,0,72427
24958,28,0,15,10,3,0,3,3,0,0,0,0,3,3,3,0,0,0,0,0,0,0,0,0,0,0,0,0,0,0,0,0,0,0,0,72428
24959,283,76,118,56,26,7,18,4,4,0,2,2,0,0,0,0,0,0,0,0,0,14,14,5,0,9,0,0,0,0,0,0,0,0,0,72429
24960,271,43,130,57,9,32,13,7,4,0,0,4,3,0,0,0,0,3,0,0,3,6,5,1,2,2,1,0,0,0,0,1,0,0,1,72430
24961,314,108,154,52,0,0,10,1,1,0,0,1,0,0,0,0,0,0,0,0,0,9,9,0,0,9,0,0,0,0,0,0,0,0,0,72431
24962,4212,1091,1921,1001,123,76,312,141,117,35,0,82,24,24,24,0,0,0,0,0,0,171,125,47,0,78,46,46,20,0,26,0,0,0,0,72432
24963,2198,526,942,552,136,42,199,117,78,0,8,70,39,21,0,21,0,18,4,14,0,82,65,11,0,54,17,12,12,0,0,5,0,0,5,72433
24964,1156,280,466,226,71,113,41,21,3,0,0,3,18,0,0,0,0,18,0,0,18,20,20,17,0,3,0,0,0,0,0,0,0,0,0,72434
24965,379,121,155,52,51,0,44,24,8,3,3,2,16,16,16,0,0,0,0,0,0,20,20,0,9,11,0,0,0,0,0,0,0,0,0,72435
24966,559,89,223,199,38,10,39,14,3,2,0,1,11,11,0,0,11,0,0,0,0,25,25,21,0,4,0,0,0,0,0,0,0,0,0,72436
24967,2111,478,885,563,132,53,111,53,44,17,0,27,9,9,3,3,3,0,0,0,0,58,44,11,0,33,14,14,0,0,14,0,0,0,0,72437
24968,1743,414,729,471,101,28,95,73,41,15,17,9,32,32,0,32,0,0,0,0,0,22,18,14,0,4,4,0,0,0,0,4,4,0,0,72438
24969,125,14,43,50,11,7,15,7,7,0,0,7,0,0,0,0,0,0,0,0,0,8,8,0,0,8,0,0,0,0,0,0,0,0,0,72440
24970,64,22,32,10,0,0,4,4,4,4,0,0,0,0,0,0,0,0,0,0,0,0,0,0,0,0,0,0,0,0,0,0,0,0,0,72441
24971,3175,860,1227,717,249,122,245,128,73,25,0,48,55,55,55,0,0,0,0,0,0,117,20,0,0,20,97,9,0,9,0,88,54,0,34,72442
24972,2129,386,852,580,284,27,130,50,23,0,9,14,27,24,13,11,0,3,0,0,3,80,49,7,0,42,31,22,0,0,22,9,4,0,5,72443
24973,1077,264,455,293,45,20,82,47,25,7,0,18,22,22,0,22,0,0,0,0,0,35,33,4,0,29,2,2,2,0,0,0,0,0,0,72444
24974,49,10,34,4,1,0,0,0,0,0,0,0,0,0,0,0,0,0,0,0,0,0,0,0,0,0,0,0,0,0,0,0,0,0,0,72445
24975,1373,216,506,395,184,72,74,38,38,20,0,18,0,0,0,0,0,0,0,0,0,36,36,19,11,6,0,0,0,0,0,0,0,0,0,72447
24976,135,20,68,41,6,0,32,32,32,30,0,2,0,0,0,0,0,0,0,0,0,0,0,0,0,0,0,0,0,0,0,0,0,0,0,72449
24977,24043,3972,10383,6133,2183,1372,1830,1039,836,195,92,549,203,126,96,7,23,77,18,54,5,791,662,320,106,236,129,129,59,17,53,0,0,0,0,72450
24978,103,34,46,15,6,2,7,6,6,0,0,6,0,0,0,0,0,0,0,0,0,1,0,0,0,0,1,0,0,0,0,1,0,0,1,72453
24979,3441,753,1361,942,277,108,318,161,95,25,20,50,66,37,0,23,14,29,11,0,18,157,116,0,84,32,41,26,26,0,0,15,13,0,2,72454
24980,8929,1540,3485,2776,761,367,610,297,236,57,16,163,61,59,40,19,0,2,0,0,2,313,303,71,11,221,10,10,0,10,0,0,0,0,0,72455
24981,441,96,191,117,23,14,36,35,31,4,0,27,4,0,0,0,0,4,4,0,0,1,1,0,0,1,0,0,0,0,0,0,0,0,0,72456
24982,125,36,57,16,12,4,0,0,0,0,0,0,0,0,0,0,0,0,0,0,0,0,0,0,0,0,0,0,0,0,0,0,0,0,0,72457
24983,545,121,208,179,34,3,58,30,30,0,12,18,0,0,0,0,0,0,0,0,0,28,28,0,13,15,0,0,0,0,0,0,0,0,0,72458
24984,1067,353,380,301,30,3,103,9,9,0,0,9,0,0,0,0,0,0,0,0,0,94,94,90,0,4,0,0,0,0,0,0,0,0,0,72459
24985,447,120,191,97,14,25,5,3,3,0,0,3,0,0,0,0,0,0,0,0,0,2,2,0,2,0,0,0,0,0,0,0,0,0,0,72460
24986,2430,552,1097,546,169,66,175,89,59,9,11,39,30,12,0,12,0,18,0,5,13,86,52,0,0,52,34,12,0,0,12,22,0,0,22,72461
24987,252,50,114,60,10,18,8,8,8,0,0,8,0,0,0,0,0,0,0,0,0,0,0,0,0,0,0,0,0,0,0,0,0,0,0,72462
24988,50,15,16,19,0,0,0,0,0,0,0,0,0,0,0,0,0,0,0,0,0,0,0,0,0,0,0,0,0,0,0,0,0,0,0,72464
24989,1093,187,481,290,29,106,87,23,10,0,0,10,13,0,0,0,0,13,0,0,13,64,64,11,0,53,0,0,0,0,0,0,0,0,0,72466
24990,4,0,0,0,4,0,184,168,168,36,5,127,0,0,0,0,0,0,0,0,0,16,16,0,0,16,0,0,0,0,0,0,0,0,0,72467
24991,862,221,455,150,22,14,68,47,24,0,0,24,23,17,17,0,0,6,6,0,0,21,12,0,0,12,9,5,0,5,0,4,0,0,4,72469
24992,124,38,57,9,7,13,8,6,4,2,1,1,2,2,0,2,0,0,0,0,0,2,2,2,0,0,0,0,0,0,0,0,0,0,0,72470
24993,705,103,375,128,53,46,69,33,21,13,8,0,12,4,0,2,2,8,0,8,0,36,29,7,0,22,7,0,0,0,0,7,0,0,7,72471
24994,6328,1620,2586,1455,482,185,276,150,97,6,0,91,53,29,8,7,14,24,0,24,0,126,96,0,21,75,30,0,0,0,0,30,0,0,30,72472
24995,1826,407,845,471,80,23,162,109,100,14,8,78,9,9,9,0,0,0,0,0,0,53,35,19,0,16,18,14,13,0,1,4,0,0,4,72473
24996,4620,984,1888,1146,381,221,361,152,152,33,4,115,0,0,0,0,0,0,0,0,0,209,208,48,9,151,1,1,0,0,1,0,0,0,0,72476
24997,249,0,43,70,122,14,72,15,15,0,0,15,0,0,0,0,0,0,0,0,0,57,57,0,0,57,0,0,0,0,0,0,0,0,0,72478
24998,1260,348,432,316,138,26,113,75,75,0,5,70,0,0,0,0,0,0,0,0,0,38,38,5,3,30,0,0,0,0,0,0,0,0,0,72479
24999,812,247,352,134,7,72,39,6,2,0,0,2,4,4,4,0,0,0,0,0,0,33,33,25,0,8,0,0,0,0,0,0,0,0,0,72482
25000,16495,2645,6463,4626,1830,931,1601,849,636,247,107,282,213,162,143,6,13,51,25,26,0,752,578,150,17,411,174,116,44,0,72,58,41,0,17,72501
25001,1944,338,764,674,115,53,96,45,21,2,0,19,24,24,0,24,0,0,0,0,0,51,51,22,0,29,0,0,0,0,0,0,0,0,0,72512
25002,2058,468,877,530,103,80,218,117,106,65,0,41,11,11,0,0,11,0,0,0,0,101,96,24,11,61,5,5,5,0,0,0,0,0,0,72513
25003,18,0,9,9,0,0,0,0,0,0,0,0,0,0,0,0,0,0,0,0,0,0,0,0,0,0,0,0,0,0,0,0,0,0,0,72515
25004,400,86,225,65,19,5,19,19,19,0,0,19,0,0,0,0,0,0,0,0,0,0,0,0,0,0,0,0,0,0,0,0,0,0,0,72517
25005,2339,534,879,646,141,139,128,58,58,9,0,49,0,0,0,0,0,0,0,0,0,70,42,40,0,2,28,1,1,0,0,27,10,17,0,72519
25006,309,87,158,64,0,0,35,0,0,0,0,0,0,0,0,0,0,0,0,0,0,35,35,0,0,35,0,0,0,0,0,0,0,0,0,72520
25007,3124,545,1324,970,223,62,281,134,109,25,0,84,25,12,12,0,0,13,2,11,0,147,134,24,0,110,13,12,12,0,0,1,0,1,0,72521
25008,429,73,123,164,15,54,58,10,10,0,0,10,0,0,0,0,0,0,0,0,0,48,48,0,0,48,0,0,0,0,0,0,0,0,0,72522
25009,763,95,380,259,25,4,105,69,53,0,0,53,16,0,0,0,0,16,0,16,0,36,36,0,15,21,0,0,0,0,0,0,0,0,0,72523
25010,181,12,106,46,17,0,0,0,0,0,0,0,0,0,0,0,0,0,0,0,0,0,0,0,0,0,0,0,0,0,0,0,0,0,0,72524
25011,81,9,46,25,1,0,8,6,6,0,6,0,0,0,0,0,0,0,0,0,0,2,2,0,2,0,0,0,0,0,0,0,0,0,0,72526
25012,447,54,148,176,45,24,27,27,27,27,0,0,0,0,0,0,0,0,0,0,0,0,0,0,0,0,0,0,0,0,0,0,0,0,0,72527
25013,52,15,37,0,0,0,27,0,0,0,0,0,0,0,0,0,0,0,0,0,0,27,0,0,0,0,27,27,0,27,0,0,0,0,0,72528
25014,3360,356,1514,1115,266,109,228,153,117,40,10,67,36,36,14,22,0,0,0,0,0,75,75,24,0,51,0,0,0,0,0,0,0,0,0,72529
25015,1417,230,604,362,155,66,72,30,16,0,0,16,14,14,0,0,14,0,0,0,0,42,32,0,0,32,10,10,0,10,0,0,0,0,0,72530
25016,568,33,285,151,99,0,8,0,0,0,0,0,0,0,0,0,0,0,0,0,0,8,8,0,0,8,0,0,0,0,0,0,0,0,0,72531
25017,1610,250,770,412,105,73,37,33,33,0,0,33,0,0,0,0,0,0,0,0,0,4,3,2,0,1,1,0,0,0,0,1,0,0,1,72532
25018,370,100,114,134,17,5,61,50,36,0,0,36,14,5,0,5,0,9,9,0,0,11,11,0,4,7,0,0,0,0,0,0,0,0,0,72533
25019,1075,320,363,324,62,6,105,50,50,47,0,3,0,0,0,0,0,0,0,0,0,55,55,0,0,55,0,0,0,0,0,0,0,0,0,72534
25020,213,58,62,49,32,12,11,9,8,0,0,8,1,0,0,0,0,1,0,0,1,2,2,2,0,0,0,0,0,0,0,0,0,0,0,72536
25021,420,7,243,138,24,8,21,14,14,0,0,14,0,0,0,0,0,0,0,0,0,7,7,0,0,7,0,0,0,0,0,0,0,0,0,72537
25022,251,63,75,92,6,15,0,0,0,0,0,0,0,0,0,0,0,0,0,0,0,0,0,0,0,0,0,0,0,0,0,0,0,0,0,72538
25023,93,40,40,13,0,0,0,0,0,0,0,0,0,0,0,0,0,0,0,0,0,0,0,0,0,0,0,0,0,0,0,0,0,0,0,72539
25024,139,22,36,52,29,0,5,0,0,0,0,0,0,0,0,0,0,0,0,0,0,5,5,0,5,0,0,0,0,0,0,0,0,0,0,72540
25025,2577,428,1122,695,109,223,181,100,78,8,5,65,22,14,10,0,4,8,0,8,0,81,80,46,0,34,1,1,0,1,0,0,0,0,0,72542
25026,9167,1174,3475,2794,1106,618,550,290,275,60,0,215,15,4,4,0,0,11,0,0,11,260,231,79,92,60,29,29,0,29,0,0,0,0,0,72543
25027,519,21,244,156,86,12,42,32,32,0,0,32,0,0,0,0,0,0,0,0,0,10,10,0,0,10,0,0,0,0,0,0,0,0,0,72544
25028,231,67,96,54,14,0,0,0,0,0,0,0,0,0,0,0,0,0,0,0,0,0,0,0,0,0,0,0,0,0,0,0,0,0,0,72546
25029,598,146,258,90,70,34,65,43,43,43,0,0,0,0,0,0,0,0,0,0,0,22,22,0,0,22,0,0,0,0,0,0,0,0,0,72550
25030,50,6,41,1,0,2,9,0,0,0,0,0,0,0,0,0,0,0,0,0,0,9,9,0,0,9,0,0,0,0,0,0,0,0,0,72553
25031,2171,436,806,695,153,81,190,118,90,45,0,45,28,28,0,28,0,0,0,0,0,72,60,3,5,52,12,0,0,0,0,12,0,0,12,72554
25032,130,110,15,5,0,0,0,0,0,0,0,0,0,0,0,0,0,0,0,0,0,0,0,0,0,0,0,0,0,0,0,0,0,0,0,72555
25033,2157,402,838,605,194,118,56,25,21,9,0,12,4,4,0,0,4,0,0,0,0,31,18,7,5,6,13,13,0,0,13,0,0,0,0,72556
25034,6228,1305,2169,1813,666,275,427,298,156,0,0,156,142,42,42,0,0,100,21,0,79,129,112,68,0,44,17,0,0,0,0,17,0,0,17,72560
25035,689,73,302,159,123,32,76,61,55,19,0,36,6,6,0,0,6,0,0,0,0,15,8,4,0,4,7,7,7,0,0,0,0,0,0,72561
25036,1701,300,691,534,114,62,142,93,78,18,5,55,15,15,10,5,0,0,0,0,0,49,28,0,9,19,21,8,0,8,0,13,0,0,13,72562
25037,485,135,147,178,22,3,22,14,9,0,0,9,5,5,0,5,0,0,0,0,0,8,8,0,0,8,0,0,0,0,0,0,0,0,0,72564
25038,681,163,290,178,24,26,18,13,7,7,0,0,6,6,6,0,0,0,0,0,0,5,0,0,0,0,5,0,0,0,0,5,5,0,0,72565
25039,384,63,213,77,21,10,0,0,0,0,0,0,0,0,0,0,0,0,0,0,0,0,0,0,0,0,0,0,0,0,0,0,0,0,0,72566
25040,330,38,58,214,0,20,0,0,0,0,0,0,0,0,0,0,0,0,0,0,0,0,0,0,0,0,0,0,0,0,0,0,0,0,0,72567
25041,996,174,477,293,29,23,25,5,5,2,0,3,0,0,0,0,0,0,0,0,0,20,20,5,0,15,0,0,0,0,0,0,0,0,0,72568
25042,374,42,265,34,13,20,0,0,0,0,0,0,0,0,0,0,0,0,0,0,0,0,0,0,0,0,0,0,0,0,0,0,0,0,0,72569
25043,289,50,169,70,0,0,0,0,0,0,0,0,0,0,0,0,0,0,0,0,0,0,0,0,0,0,0,0,0,0,0,0,0,0,0,72571
25044,122,38,27,44,0,13,40,17,9,0,0,9,8,8,0,8,0,0,0,0,0,23,23,0,0,23,0,0,0,0,0,0,0,0,0,72572
25045,146,9,103,7,14,13,18,18,18,18,0,0,0,0,0,0,0,0,0,0,0,0,0,0,0,0,0,0,0,0,0,0,0,0,0,72573
25046,3028,473,1228,977,202,148,155,85,66,9,0,57,19,19,19,0,0,0,0,0,0,70,66,47,0,19,4,0,0,0,0,4,4,0,0,72576
25047,506,111,140,169,26,60,47,14,13,0,0,13,1,1,0,1,0,0,0,0,0,33,16,1,0,15,17,2,2,0,0,15,0,0,15,72577
25048,316,13,88,180,35,0,15,15,15,0,0,15,0,0,0,0,0,0,0,0,0,0,0,0,0,0,0,0,0,0,0,0,0,0,0,72578
25049,702,221,233,156,78,14,80,61,49,4,0,45,12,12,12,0,0,0,0,0,0,19,19,15,2,2,0,0,0,0,0,0,0,0,0,72579
25050,744,46,226,388,48,36,107,31,31,22,0,9,0,0,0,0,0,0,0,0,0,76,76,0,18,58,0,0,0,0,0,0,0,0,0,72581
25051,1276,144,631,337,76,88,43,35,16,1,2,13,19,1,0,0,1,18,18,0,0,8,5,0,0,5,3,0,0,0,0,3,3,0,0,72583
25052,641,144,157,269,15,56,0,0,0,0,0,0,0,0,0,0,0,0,0,0,0,0,0,0,0,0,0,0,0,0,0,0,0,0,0,72584
25053,91,0,17,74,0,0,89,59,59,0,0,59,0,0,0,0,0,0,0,0,0,30,30,30,0,0,0,0,0,0,0,0,0,0,0,72585
25054,140,50,41,49,0,0,0,0,0,0,0,0,0,0,0,0,0,0,0,0,0,0,0,0,0,0,0,0,0,0,0,0,0,0,0,72587
25055,21003,3016,7620,6920,2206,1241,1484,629,474,151,36,287,155,93,83,10,0,62,48,0,14,855,593,160,69,364,262,143,64,0,79,119,91,4,24,72601
25056,1175,166,522,399,59,29,145,123,81,47,10,24,42,12,7,0,5,30,0,0,30,22,21,0,16,5,1,1,0,0,1,0,0,0,0,72611
25057,6740,985,3065,1731,674,285,389,162,134,95,7,32,28,21,17,0,4,7,0,0,7,227,130,17,0,113,97,21,0,0,21,76,0,22,54,72616
25058,174,118,27,11,8,10,6,6,0,0,0,0,6,0,0,0,0,6,0,3,3,0,0,0,0,0,0,0,0,0,0,0,0,0,0,72617
25059,1719,164,796,571,122,66,45,22,22,16,0,6,0,0,0,0,0,0,0,0,0,23,23,12,0,11,0,0,0,0,0,0,0,0,0,72619
25060,582,26,143,336,68,9,0,0,0,0,0,0,0,0,0,0,0,0,0,0,0,0,0,0,0,0,0,0,0,0,0,0,0,0,0,72623
25061,347,44,121,157,25,0,0,0,0,0,0,0,0,0,0,0,0,0,0,0,0,0,0,0,0,0,0,0,0,0,0,0,0,0,0,72624
25062,1043,92,369,389,154,39,50,39,39,17,3,19,0,0,0,0,0,0,0,0,0,11,11,0,0,11,0,0,0,0,0,0,0,0,0,72626
25063,605,180,277,93,55,0,135,56,14,0,0,14,42,36,36,0,0,6,6,0,0,79,16,0,0,16,63,9,9,0,0,54,0,0,54,72628
25064,330,74,164,87,5,0,26,8,0,0,0,0,8,8,0,8,0,0,0,0,0,18,18,0,0,18,0,0,0,0,0,0,0,0,0,72629
25065,144,7,65,38,27,7,16,16,8,0,0,8,8,8,0,0,8,0,0,0,0,0,0,0,0,0,0,0,0,0,0,0,0,0,0,72630
25066,3726,281,1045,1446,643,311,151,130,78,15,39,24,52,0,0,0,0,52,0,0,52,21,21,0,21,0,0,0,0,0,0,0,0,0,0,72631
25067,3314,361,1085,1045,497,326,195,94,81,42,21,18,13,13,13,0,0,0,0,0,0,101,61,9,7,45,40,14,14,0,0,26,0,0,26,72632
25068,1284,107,611,417,95,54,103,87,87,46,0,41,0,0,0,0,0,0,0,0,0,16,16,0,0,16,0,0,0,0,0,0,0,0,0,72633
25069,3551,556,1429,1056,330,180,247,138,132,63,2,67,6,6,6,0,0,0,0,0,0,109,109,40,5,64,0,0,0,0,0,0,0,0,0,72634
25070,2260,215,975,817,159,94,239,126,86,11,0,75,40,25,19,0,6,15,0,0,15,113,92,35,0,57,21,18,9,9,0,3,0,0,3,72635
25071,18,2,4,3,6,3,1,0,0,0,0,0,0,0,0,0,0,0,0,0,0,1,1,0,0,1,0,0,0,0,0,0,0,0,0,72636
25072,4219,1214,1554,967,406,78,419,263,233,104,9,120,30,25,12,13,0,5,5,0,0,156,125,57,12,56,31,22,14,2,6,9,0,9,0,72638
25073,549,194,214,130,11,0,43,17,17,0,0,17,0,0,0,0,0,0,0,0,0,26,26,0,0,26,0,0,0,0,0,0,0,0,0,72639
25074,254,58,65,98,33,0,6,6,6,0,0,6,0,0,0,0,0,0,0,0,0,0,0,0,0,0,0,0,0,0,0,0,0,0,0,72640
25075,1912,406,737,515,190,64,152,57,24,12,0,12,33,0,0,0,0,33,0,0,33,95,95,0,0,95,0,0,0,0,0,0,0,0,0,72641
25076,1612,262,499,618,198,35,11,6,2,0,2,0,4,0,0,0,0,4,0,4,0,5,5,0,5,0,0,0,0,0,0,0,0,0,0,72642
25077,1723,449,655,476,86,57,174,122,118,90,2,26,4,0,0,0,0,4,0,0,4,52,50,12,0,38,2,0,0,0,0,2,0,0,2,72644
25078,1174,242,496,281,43,112,85,49,23,0,0,23,26,13,0,0,13,13,0,0,13,36,36,9,0,27,0,0,0,0,0,0,0,0,0,72645
25079,492,102,242,88,27,33,0,0,0,0,0,0,0,0,0,0,0,0,0,0,0,0,0,0,0,0,0,0,0,0,0,0,0,0,0,72648
25080,3050,823,1067,815,276,69,149,92,86,0,11,75,6,6,5,0,1,0,0,0,0,57,45,18,0,27,12,9,0,9,0,3,0,3,0,72650
25081,1065,114,445,392,99,15,0,0,0,0,0,0,0,0,0,0,0,0,0,0,0,0,0,0,0,0,0,0,0,0,0,0,0,0,0,72651
25082,21748,2790,7763,7205,2952,1038,1119,526,405,72,89,244,121,81,76,0,5,40,40,0,0,593,436,159,74,203,157,140,63,0,77,17,0,17,0,72653
25083,332,101,93,90,37,11,11,0,0,0,0,0,0,0,0,0,0,0,0,0,0,11,11,0,0,11,0,0,0,0,0,0,0,0,0,72655
25084,1445,160,612,540,83,50,197,87,87,76,3,8,0,0,0,0,0,0,0,0,0,110,107,4,2,101,3,3,0,3,0,0,0,0,0,72658
25085,538,65,276,167,30,0,54,8,7,2,0,5,1,1,1,0,0,0,0,0,0,46,46,0,0,46,0,0,0,0,0,0,0,0,0,72660
25086,227,40,95,77,15,0,13,0,0,0,0,0,0,0,0,0,0,0,0,0,0,13,13,0,13,0,0,0,0,0,0,0,0,0,0,72661
25087,2031,204,1022,583,149,73,105,65,55,24,0,31,10,0,0,0,0,10,0,0,10,40,26,5,0,21,14,12,0,0,12,2,0,0,2,72662
25088,314,78,110,100,20,6,18,18,0,0,0,0,18,18,18,0,0,0,0,0,0,0,0,0,0,0,0,0,0,0,0,0,0,0,0,72663
25089,155,0,71,34,32,18,0,0,0,0,0,0,0,0,0,0,0,0,0,0,0,0,0,0,0,0,0,0,0,0,0,0,0,0,0,72666
25090,508,118,257,109,24,0,22,0,0,0,0,0,0,0,0,0,0,0,0,0,0,22,22,0,0,22,0,0,0,0,0,0,0,0,0,72668
25091,146,48,60,32,6,0,5,3,2,0,0,2,1,0,0,0,0,1,0,1,0,2,2,2,0,0,0,0,0,0,0,0,0,0,0,72669
25092,85,0,72,8,5,0,12,12,12,12,0,0,0,0,0,0,0,0,0,0,0,0,0,0,0,0,0,0,0,0,0,0,0,0,0,72670
25093,209,116,35,46,9,3,16,8,8,5,0,3,0,0,0,0,0,0,0,0,0,8,8,2,6,0,0,0,0,0,0,0,0,0,0,72672
25094,1065,284,325,259,109,88,55,25,11,2,1,8,14,11,0,0,11,3,0,3,0,30,30,7,0,23,0,0,0,0,0,0,0,0,0,72675
25095,296,71,146,74,5,0,38,38,34,4,2,28,4,0,0,0,0,4,0,0,4,0,0,0,0,0,0,0,0,0,0,0,0,0,0,72677
25096,16,7,9,0,0,0,0,0,0,0,0,0,0,0,0,0,0,0,0,0,0,0,0,0,0,0,0,0,0,0,0,0,0,0,0,72679
25097,612,58,195,197,89,73,4,0,0,0,0,0,0,0,0,0,0,0,0,0,0,4,4,0,0,4,0,0,0,0,0,0,0,0,0,72680
25098,149,11,75,63,0,0,0,0,0,0,0,0,0,0,0,0,0,0,0,0,0,0,0,0,0,0,0,0,0,0,0,0,0,0,0,72682
25099,169,60,64,24,15,6,16,0,0,0,0,0,0,0,0,0,0,0,0,0,0,16,16,0,0,16,0,0,0,0,0,0,0,0,0,72683
25100,899,110,370,263,80,76,91,52,47,31,0,16,5,5,0,5,0,0,0,0,0,39,33,13,0,20,6,6,6,0,0,0,0,0,0,72685
25101,149,38,102,9,0,0,0,0,0,0,0,0,0,0,0,0,0,0,0,0,0,0,0,0,0,0,0,0,0,0,0,0,0,0,0,72686
25102,4836,863,1850,1418,519,186,307,159,91,14,0,77,68,17,17,0,0,51,27,0,24,148,139,96,0,43,9,9,9,0,0,0,0,0,0,72687
25103,21464,2255,4987,5475,4827,3920,6478,3161,2957,788,141,2028,204,61,59,0,2,143,34,46,63,3317,3201,584,92,2525,116,52,13,0,39,64,15,41,8,72701
25104,18583,1347,3877,4710,5071,3578,1235,566,551,193,44,314,15,15,15,0,0,0,0,0,0,669,513,184,79,250,156,114,103,11,0,42,42,0,0,72703
25105,12863,1348,2888,3767,3008,1852,895,442,411,234,51,126,31,31,11,0,20,0,0,0,0,453,351,136,56,159,102,81,62,19,0,21,21,0,0,72704
25106,26963,2174,6776,7129,7069,3815,1924,1025,841,213,52,576,184,161,8,67,86,23,2,6,15,899,735,192,18,525,164,98,30,16,52,66,23,0,43,72712
25107,8895,289,2742,2912,1941,1011,266,100,100,9,17,74,0,0,0,0,0,0,0,0,0,166,166,59,17,90,0,0,0,0,0,0,0,0,0,72714
25108,12371,787,3162,4086,2889,1447,400,233,188,26,0,162,45,36,0,0,36,9,0,0,9,167,167,62,52,53,0,0,0,0,0,0,0,0,0,72715
25109,568,117,326,105,20,0,59,59,18,0,0,18,41,41,28,0,13,0,0,0,0,0,0,0,0,0,0,0,0,0,0,0,0,0,0,72717
25110,1236,128,350,377,255,126,110,52,52,18,0,34,0,0,0,0,0,0,0,0,0,58,45,6,4,35,13,13,0,0,13,0,0,0,0,72718
25111,5699,666,1321,1350,1840,522,290,153,133,11,40,82,20,20,0,9,11,0,0,0,0,137,109,14,0,95,28,28,28,0,0,0,0,0,0,72719
25112,201,31,143,15,12,0,30,30,30,0,0,30,0,0,0,0,0,0,0,0,0,0,0,0,0,0,0,0,0,0,0,0,0,0,0,72721
25113,2102,723,863,348,129,39,194,84,73,3,0,70,11,6,0,0,6,5,0,0,5,110,110,0,0,110,0,0,0,0,0,0,0,0,0,72722
25114,4135,810,1680,1069,393,183,257,146,120,32,4,84,26,26,18,0,8,0,0,0,0,111,111,38,0,73,0,0,0,0,0,0,0,0,0,72727
25115,134,35,99,0,0,0,0,0,0,0,0,0,0,0,0,0,0,0,0,0,0,0,0,0,0,0,0,0,0,0,0,0,0,0,0,72729
25116,5218,478,1644,1817,808,471,425,197,188,0,0,188,9,9,0,9,0,0,0,0,0,228,187,63,15,109,41,41,41,0,0,0,0,0,0,72730
25117,3378,569,1215,1014,424,156,174,104,37,6,0,31,67,51,35,0,16,16,0,0,16,70,33,5,0,28,37,37,2,24,11,0,0,0,0,72732
25118,4576,740,1882,1040,666,248,399,182,112,36,12,64,70,56,40,0,16,14,14,0,0,217,179,32,0,147,38,8,0,0,8,30,0,0,30,72734
25119,3391,476,1669,704,386,156,205,121,93,0,6,87,28,9,9,0,0,19,0,11,8,84,48,12,0,36,36,36,36,0,0,0,0,0,0,72736
25120,1863,335,721,514,163,130,191,84,78,0,0,78,6,0,0,0,0,6,0,0,6,107,69,18,0,51,38,38,0,0,38,0,0,0,0,72738
25121,347,112,179,56,0,0,0,0,0,0,0,0,0,0,0,0,0,0,0,0,0,0,0,0,0,0,0,0,0,0,0,0,0,0,0,72739
25122,5880,1341,2584,1349,437,169,493,283,242,12,3,227,41,33,3,17,13,8,0,0,8,210,154,58,25,71,56,56,56,0,0,0,0,0,0,72740
25123,230,59,64,76,31,0,0,0,0,0,0,0,0,0,0,0,0,0,0,0,0,0,0,0,0,0,0,0,0,0,0,0,0,0,0,72742
25124,2971,661,1096,940,163,111,233,164,104,10,9,85,60,60,56,0,4,0,0,0,0,69,43,18,7,18,26,4,0,0,4,22,0,0,22,72744
25125,7301,1096,2587,1688,1462,468,269,162,95,19,0,76,67,35,35,0,0,32,15,17,0,107,51,0,0,51,56,5,0,0,5,51,0,51,0,72745
25126,87,26,0,41,20,0,0,0,0,0,0,0,0,0,0,0,0,0,0,0,0,0,0,0,0,0,0,0,0,0,0,0,0,0,0,72747
25127,69,0,33,20,0,16,11,11,9,0,0,9,2,0,0,0,0,2,0,0,2,0,0,0,0,0,0,0,0,0,0,0,0,0,0,72749
25128,3884,380,1970,1140,254,140,292,225,118,40,0,78,107,107,60,0,47,0,0,0,0,67,67,0,0,67,0,0,0,0,0,0,0,0,0,72751
25129,316,105,104,55,25,27,0,0,0,0,0,0,0,0,0,0,0,0,0,0,0,0,0,0,0,0,0,0,0,0,0,0,0,0,0,72752
25130,5470,752,2114,1564,784,256,406,297,254,81,0,173,43,43,41,0,2,0,0,0,0,109,109,52,23,34,0,0,0,0,0,0,0,0,0,72753
25131,25444,5600,8598,6397,3309,1540,2183,1040,573,107,78,388,467,376,217,31,128,91,23,16,52,1143,948,167,40,741,195,141,44,56,41,54,38,0,16,72756
25132,21133,3305,5635,4976,5065,2152,2002,974,814,160,79,575,160,143,87,41,15,17,17,0,0,1028,836,198,37,601,192,179,44,0,135,13,0,0,13,72758
25133,222,53,102,35,21,11,39,17,3,0,0,3,14,14,0,0,14,0,0,0,0,22,7,0,0,7,15,0,0,0,0,15,0,0,15,72760
25134,13209,2322,4642,3309,1912,1024,1969,907,654,82,0,572,253,243,87,18,138,10,0,10,0,1062,848,136,0,712,214,153,50,0,103,61,51,0,10,72761
25135,22785,4715,6266,5814,4010,1980,2187,1112,936,233,99,604,176,118,103,15,0,58,51,7,0,1075,1037,226,68,743,38,38,19,13,6,0,0,0,0,72762
25136,28777,9388,9501,5826,2771,1291,2543,1065,855,264,76,515,210,112,96,0,16,98,63,35,0,1478,1196,345,10,841,282,138,103,21,14,144,88,0,56,72764
25137,828,284,223,182,70,69,58,25,15,0,0,15,10,10,10,0,0,0,0,0,0,33,33,7,0,26,0,0,0,0,0,0,0,0,0,72768
25138,799,180,234,212,159,14,30,0,0,0,0,0,0,0,0,0,0,0,0,0,0,30,30,0,0,30,0,0,0,0,0,0,0,0,0,72769
25139,765,316,193,238,18,0,95,81,48,0,0,48,33,0,0,0,0,33,33,0,0,14,6,0,0,6,8,8,0,0,8,0,0,0,0,72773
25140,4400,505,1678,1259,575,383,415,205,183,19,0,164,22,22,6,13,3,0,0,0,0,210,143,56,0,87,67,47,9,0,38,20,20,0,0,72774
25141,500,70,241,144,45,0,35,22,22,4,8,10,0,0,0,0,0,0,0,0,0,13,13,9,0,4,0,0,0,0,0,0,0,0,0,72776
25142,9770,1803,3190,2549,1333,895,1953,909,837,194,56,587,72,1,0,0,1,71,52,18,1,1044,908,223,87,598,136,90,90,0,0,46,0,46,0,72801
25143,14450,2214,4493,3962,2622,1159,1489,872,775,257,40,478,97,79,61,0,18,18,0,0,18,617,492,238,48,206,125,104,47,40,17,21,21,0,0,72802
25144,1432,422,645,272,53,40,157,125,121,6,34,81,4,2,0,0,2,2,0,0,2,32,30,0,9,21,2,2,0,0,2,0,0,0,0,72821
25145,4213,1007,1541,1135,388,142,313,236,161,26,0,135,75,54,36,0,18,21,0,21,0,77,52,35,0,17,25,25,25,0,0,0,0,0,0,72823
25146,1038,378,357,220,68,15,97,27,9,0,3,6,18,10,10,0,0,8,3,0,5,70,50,0,0,50,20,14,7,0,7,6,0,0,6,72824
25147,38,19,10,9,0,0,10,3,3,0,0,3,0,0,0,0,0,0,0,0,0,7,7,0,0,7,0,0,0,0,0,0,0,0,0,72826
25148,151,34,117,0,0,0,0,0,0,0,0,0,0,0,0,0,0,0,0,0,0,0,0,0,0,0,0,0,0,0,0,0,0,0,0,72827
25149,63,49,14,0,0,0,0,0,0,0,0,0,0,0,0,0,0,0,0,0,0,0,0,0,0,0,0,0,0,0,0,0,0,0,0,72828
25150,9755,1880,4071,2187,1166,451,936,418,292,114,5,173,126,71,38,33,0,55,50,0,5,518,403,132,44,227,115,82,27,0,55,33,0,0,33,72830
25151,732,171,311,199,36,15,39,18,18,3,0,15,0,0,0,0,0,0,0,0,0,21,13,0,0,13,8,4,4,0,0,4,0,0,4,72832
25152,2688,929,1150,352,168,89,221,180,131,15,0,116,49,44,20,0,24,5,0,0,5,41,32,0,4,28,9,9,0,0,9,0,0,0,0,72833
25153,7650,1928,3333,1596,596,197,590,256,241,46,13,182,15,15,15,0,0,0,0,0,0,334,255,148,0,107,79,79,0,79,0,0,0,0,0,72834
25154,536,110,166,216,27,17,33,33,33,0,24,9,0,0,0,0,0,0,0,0,0,0,0,0,0,0,0,0,0,0,0,0,0,0,0,72835
25155,5303,1167,1893,1492,523,228,508,192,96,0,0,96,96,96,80,0,16,0,0,0,0,316,259,36,12,211,57,25,25,0,0,32,0,0,32,72837
25156,95,0,69,26,0,0,0,0,0,0,0,0,0,0,0,0,0,0,0,0,0,0,0,0,0,0,0,0,0,0,0,0,0,0,0,72838
25157,161,39,73,41,8,0,0,0,0,0,0,0,0,0,0,0,0,0,0,0,0,0,0,0,0,0,0,0,0,0,0,0,0,0,0,72839
25158,1266,356,589,237,73,11,146,89,66,26,0,40,23,23,11,3,9,0,0,0,0,57,57,9,0,48,0,0,0,0,0,0,0,0,0,72840
25159,224,87,116,14,7,0,0,0,0,0,0,0,0,0,0,0,0,0,0,0,0,0,0,0,0,0,0,0,0,0,0,0,0,0,0,72841
25160,825,195,352,163,95,20,90,35,22,0,0,22,13,8,7,1,0,5,5,0,0,55,55,0,0,55,0,0,0,0,0,0,0,0,0,72842
25161,1608,369,574,491,62,112,102,51,31,8,0,23,20,20,0,20,0,0,0,0,0,51,35,7,0,28,16,16,16,0,0,0,0,0,0,72843
25162,875,159,398,256,48,14,13,0,0,0,0,0,0,0,0,0,0,0,0,0,0,13,13,3,0,10,0,0,0,0,0,0,0,0,0,72845
25163,2689,551,1033,612,354,139,194,93,67,21,0,46,26,26,0,22,4,0,0,0,0,101,47,0,0,47,54,24,16,0,8,30,14,0,16,72846
25164,2000,287,1010,488,154,61,218,140,108,16,5,87,32,32,4,25,3,0,0,0,0,78,78,20,0,58,0,0,0,0,0,0,0,0,0,72847
25165,427,69,170,156,23,9,8,8,8,0,0,8,0,0,0,0,0,0,0,0,0,0,0,0,0,0,0,0,0,0,0,0,0,0,0,72851
25166,131,27,58,42,4,0,0,0,0,0,0,0,0,0,0,0,0,0,0,0,0,0,0,0,0,0,0,0,0,0,0,0,0,0,0,72852
25167,1324,331,545,354,63,31,84,66,39,0,25,14,27,4,0,4,0,23,0,0,23,18,10,0,0,10,8,0,0,0,0,8,0,0,8,72853
25168,546,115,293,80,49,9,7,7,7,0,0,7,0,0,0,0,0,0,0,0,0,0,0,0,0,0,0,0,0,0,0,0,0,0,0,72854
25169,4043,920,1718,886,444,75,246,172,138,47,12,79,34,23,0,10,13,11,11,0,0,74,74,20,16,38,0,0,0,0,0,0,0,0,0,72855
25170,357,62,181,77,31,6,0,0,0,0,0,0,0,0,0,0,0,0,0,0,0,0,0,0,0,0,0,0,0,0,0,0,0,0,0,72856
25171,1061,347,407,233,57,17,77,68,50,0,0,50,18,7,4,0,3,11,0,6,5,9,9,0,0,9,0,0,0,0,0,0,0,0,0,72857
25172,2027,298,709,690,235,95,255,163,143,69,0,74,20,20,14,6,0,0,0,0,0,92,70,36,28,6,22,22,0,22,0,0,0,0,0,72858
25173,263,104,141,9,9,0,0,0,0,0,0,0,0,0,0,0,0,0,0,0,0,0,0,0,0,0,0,0,0,0,0,0,0,0,0,72860
25174,1021,141,408,327,120,25,68,26,25,1,0,24,1,1,0,0,1,0,0,0,0,42,42,5,0,37,0,0,0,0,0,0,0,0,0,72863
25175,1036,184,520,215,56,61,329,201,196,24,9,163,5,5,0,0,5,0,0,0,0,128,92,0,0,92,36,0,0,0,0,36,0,36,0,72865
25176,14467,3584,4773,4115,1460,535,1281,753,553,58,13,482,200,140,26,9,105,60,21,0,39,528,403,65,40,298,125,103,44,0,59,22,0,9,13,72901
25177,17715,1751,4138,6090,3733,2003,1611,772,681,147,39,495,91,52,52,0,0,39,8,30,1,839,752,348,2,402,87,27,27,0,0,60,44,0,16,72903
25178,12280,5157,3829,2624,519,151,1459,711,486,110,20,356,225,114,39,0,75,111,35,0,76,748,487,189,34,264,261,166,53,0,113,95,0,0,95,72904
25179,9221,829,3252,2886,1378,876,513,256,203,60,0,143,53,53,27,0,26,0,0,0,0,257,257,74,32,151,0,0,0,0,0,0,0,0,0,72908
25180,5294,438,1458,2012,898,488,467,196,191,14,27,150,5,5,0,0,5,0,0,0,0,271,238,36,14,188,33,33,12,0,21,0,0,0,0,72916
25181,8966,1109,3315,2912,1080,550,633,312,241,101,2,138,71,71,58,13,0,0,0,0,0,321,211,3,69,139,110,78,35,43,0,32,0,17,15,72921
25182,3022,384,1331,1021,237,49,120,11,11,0,0,11,0,0,0,0,0,0,0,0,0,109,97,62,0,35,12,12,12,0,0,0,0,0,0,72923
25183,374,109,129,102,17,17,0,0,0,0,0,0,0,0,0,0,0,0,0,0,0,0,0,0,0,0,0,0,0,0,0,0,0,0,0,72926
25184,6039,935,2488,1792,600,224,586,312,261,135,22,104,51,41,41,0,0,10,0,0,10,274,222,99,37,86,52,52,0,27,25,0,0,0,0,72927
25185,418,70,214,94,34,6,8,4,2,0,0,2,2,0,0,0,0,2,0,0,2,4,4,4,0,0,0,0,0,0,0,0,0,0,0,72928
25186,279,14,122,88,55,0,23,12,12,0,0,12,0,0,0,0,0,0,0,0,0,11,11,0,0,11,0,0,0,0,0,0,0,0,0,72930
25187,1468,308,602,452,91,15,104,73,51,0,0,51,22,10,0,7,3,12,0,0,12,31,31,18,0,13,0,0,0,0,0,0,0,0,0,72932
25188,2876,225,1041,1133,325,152,385,265,235,75,17,143,30,4,0,4,0,26,0,26,0,120,114,0,17,97,6,6,0,6,0,0,0,0,0,72933
25189,834,193,423,205,0,13,208,24,24,0,0,24,0,0,0,0,0,0,0,0,0,184,61,0,0,61,123,16,0,16,0,107,0,0,107,72934
25190,377,100,175,82,3,17,30,12,12,3,0,9,0,0,0,0,0,0,0,0,0,18,7,0,7,0,11,11,0,11,0,0,0,0,0,72935
25191,9504,858,3200,3321,1344,781,896,502,461,61,92,308,41,41,24,17,0,0,0,0,0,394,253,80,20,153,141,141,111,6,24,0,0,0,0,72936
25192,2596,520,1000,810,211,55,179,128,122,4,0,118,6,0,0,0,0,6,0,6,0,51,47,6,6,35,4,4,0,0,4,0,0,0,0,72937
25193,1150,172,523,317,74,64,145,34,34,0,0,34,0,0,0,0,0,0,0,0,0,111,107,7,0,100,4,4,0,4,0,0,0,0,0,72938
25194,1342,250,507,455,62,68,108,42,16,6,0,10,26,5,0,0,5,21,0,0,21,66,10,0,1,9,56,47,0,0,47,9,9,0,0,72940
25195,4061,525,1262,1601,537,136,175,68,68,18,0,50,0,0,0,0,0,0,0,0,0,107,107,5,0,102,0,0,0,0,0,0,0,0,0,72941
25196,1704,397,712,428,113,54,89,44,32,0,0,32,12,0,0,0,0,12,0,4,8,45,32,0,10,22,13,13,2,11,0,0,0,0,0,72943
25197,2050,314,776,654,138,168,152,64,56,15,0,41,8,8,8,0,0,0,0,0,0,88,74,14,5,55,14,3,0,0,3,11,0,0,11,72944
25198,243,42,63,119,19,0,8,2,2,0,0,2,0,0,0,0,0,0,0,0,0,6,1,0,0,1,5,4,0,2,2,1,0,0,1,72945
25199,2348,360,1116,696,116,60,178,117,48,0,16,32,69,62,62,0,0,7,0,0,7,61,61,15,6,40,0,0,0,0,0,0,0,0,0,72946
25200,3247,709,1544,683,230,81,214,90,85,13,8,64,5,5,0,5,0,0,0,0,0,124,61,0,19,42,63,63,9,34,20,0,0,0,0,72947
25201,311,101,190,0,20,0,15,15,15,0,0,15,0,0,0,0,0,0,0,0,0,0,0,0,0,0,0,0,0,0,0,0,0,0,0,72948
25202,7074,1337,2601,2351,463,322,563,252,218,61,11,146,34,28,0,8,20,6,0,0,6,311,257,70,70,117,54,37,0,37,0,17,14,0,3,72949
25203,325,72,160,77,16,0,29,0,0,0,0,0,0,0,0,0,0,0,0,0,0,29,12,0,0,12,17,17,0,0,17,0,0,0,0,72950
25204,854,152,298,319,80,5,51,40,40,3,18,19,0,0,0,0,0,0,0,0,0,11,11,2,0,9,0,0,0,0,0,0,0,0,0,72951
25205,2005,561,706,562,126,50,125,98,62,0,15,47,36,36,0,0,36,0,0,0,0,27,27,0,0,27,0,0,0,0,0,0,0,0,0,72952
25206,226,86,92,48,0,0,0,0,0,0,0,0,0,0,0,0,0,0,0,0,0,0,0,0,0,0,0,0,0,0,0,0,0,0,0,72955
25207,21359,3839,7434,6621,2390,1075,1581,773,646,131,123,392,127,113,30,64,19,14,0,0,14,808,751,213,24,514,57,56,46,10,0,1,0,0,1,72956
25208,4826,1179,1760,1393,370,124,371,252,195,43,12,140,57,26,14,0,12,31,31,0,0,119,56,0,0,56,63,35,13,16,6,28,0,16,12,72958
25209,2034,272,980,520,145,117,109,56,40,1,0,39,16,0,0,0,0,16,0,16,0,53,29,16,0,13,24,24,16,0,8,0,0,0,0,72959
25210,709,142,256,227,59,25,42,17,14,5,0,9,3,3,0,0,3,0,0,0,0,25,25,5,0,20,0,0,0,0,0,0,0,0,0,73002
25211,13254,844,2892,4178,3530,1810,896,444,327,118,18,191,117,97,45,26,26,20,0,0,20,452,415,200,46,169,37,21,21,0,0,16,0,0,16,73003
25212,547,74,240,143,75,15,34,20,20,5,3,12,0,0,0,0,0,0,0,0,0,14,13,2,3,8,1,1,0,0,1,0,0,0,0,73004
25213,5768,984,2297,1584,616,287,640,312,213,38,0,175,99,41,0,0,41,58,27,0,31,328,307,43,0,264,21,9,3,0,6,12,0,0,12,73005
25214,2604,331,1094,803,302,74,275,161,156,42,2,112,5,5,0,5,0,0,0,0,0,114,111,40,11,60,3,0,0,0,0,3,0,0,3,73006
25215,1511,163,416,390,248,294,42,7,7,0,0,7,0,0,0,0,0,0,0,0,0,35,35,35,0,0,0,0,0,0,0,0,0,0,0,73007
25216,12446,1679,3389,4134,2226,1018,1395,748,615,153,18,444,133,79,48,31,0,54,15,18,21,647,636,255,51,330,11,7,7,0,0,4,0,0,4,73008
25217,890,160,357,240,78,55,31,21,21,7,0,14,0,0,0,0,0,0,0,0,0,10,7,2,0,5,3,0,0,0,0,3,0,0,3,73009
25218,11393,1194,4178,3875,1660,486,839,504,347,62,14,271,157,153,125,26,2,4,4,0,0,335,278,84,8,186,57,36,30,0,6,21,0,0,21,73010
25219,324,84,139,86,7,8,14,3,0,0,0,0,3,2,2,0,0,1,0,0,1,11,4,0,0,4,7,3,3,0,0,4,0,0,4,73011
25220,17206,368,2261,4942,6658,2977,1374,682,682,208,56,418,0,0,0,0,0,0,0,0,0,692,676,260,25,391,16,16,16,0,0,0,0,0,0,73012
25221,29695,990,4852,7975,9831,6047,2353,1167,966,266,77,623,201,160,59,32,69,41,30,11,0,1186,1169,314,43,812,17,10,10,0,0,7,7,0,0,73013
25222,1071,143,409,335,118,66,111,56,36,0,13,23,20,15,10,5,0,5,0,3,2,55,33,25,0,8,22,13,8,5,0,9,6,0,3,73014
25223,1811,340,663,568,180,60,138,69,32,8,0,24,37,0,0,0,0,37,0,28,9,69,46,14,0,32,23,19,2,0,17,4,0,0,4,73015
25224,1064,62,377,404,193,28,81,39,32,0,2,30,7,7,7,0,0,0,0,0,0,42,34,17,0,17,8,0,0,0,0,8,8,0,0,73016
25225,1283,276,642,253,62,50,149,109,79,3,27,49,30,3,3,0,0,27,27,0,0,40,34,7,0,27,6,0,0,0,0,6,6,0,0,73017
25226,13106,2231,4897,3580,1595,803,1114,620,476,174,0,302,144,107,79,7,21,37,22,6,9,494,376,116,10,250,118,101,34,17,50,17,0,0,17,73018
25227,0,0,0,0,0,0,58,29,29,0,11,18,0,0,0,0,0,0,0,0,0,29,29,11,0,18,0,0,0,0,0,0,0,0,0,73019
25228,14773,1530,4379,5370,2321,1173,1123,549,466,125,20,321,83,83,38,19,26,0,0,0,0,574,489,262,13,214,85,61,27,30,4,24,0,0,24,73020
25229,233,16,92,64,39,22,0,0,0,0,0,0,0,0,0,0,0,0,0,0,0,0,0,0,0,0,0,0,0,0,0,0,0,0,0,73021
25230,435,47,139,146,46,57,30,18,18,9,4,5,0,0,0,0,0,0,0,0,0,12,12,0,0,12,0,0,0,0,0,0,0,0,0,73024
25231,7514,174,1105,2206,2720,1309,817,391,340,90,52,198,51,32,8,0,24,19,0,0,19,426,353,123,0,230,73,18,18,0,0,55,18,0,37,73025
25232,7900,903,2314,2529,1203,951,374,239,237,44,3,190,2,2,2,0,0,0,0,0,0,135,135,79,0,56,0,0,0,0,0,0,0,0,0,73026
25233,940,73,278,327,174,88,33,17,12,6,0,6,5,3,3,0,0,2,0,0,2,16,15,7,0,8,1,1,0,0,1,0,0,0,0,73027
25234,2281,158,925,785,306,107,104,93,60,12,0,48,33,14,12,0,2,19,0,0,19,11,7,2,0,5,4,4,4,0,0,0,0,0,0,73028
25235,1150,121,510,374,129,16,39,20,18,0,0,18,2,0,0,0,0,2,0,2,0,19,8,2,0,6,11,6,0,0,6,5,5,0,0,73029
25236,2907,344,1176,786,423,178,235,123,103,34,5,64,20,13,13,0,0,7,0,0,7,112,109,65,0,44,3,3,3,0,0,0,0,0,0,73030
25237,218,54,99,52,10,3,4,2,0,0,0,0,2,0,0,0,0,2,0,0,2,2,0,0,0,0,2,0,0,0,0,2,0,0,2,73032
25238,248,91,78,51,19,9,32,18,18,0,0,18,0,0,0,0,0,0,0,0,0,14,14,1,0,13,0,0,0,0,0,0,0,0,0,73033
25239,25775,1333,4162,6626,8372,5282,3519,1851,1775,445,87,1243,76,58,45,7,6,18,0,13,5,1668,1529,507,53,969,139,101,101,0,0,38,0,15,23,73034
25240,12705,1984,4873,4409,983,456,1265,680,542,107,32,403,138,83,24,8,51,55,33,9,13,585,466,192,21,253,119,64,58,0,6,55,0,0,55,73036
25241,1442,204,605,412,142,79,110,74,58,9,11,38,16,0,0,0,0,16,10,6,0,36,36,12,0,24,0,0,0,0,0,0,0,0,0,73038
25242,1048,149,477,266,139,17,81,36,24,13,0,11,12,7,7,0,0,5,0,0,5,45,17,1,1,15,28,28,28,0,0,0,0,0,0,73040
25243,255,32,75,85,46,17,0,0,0,0,0,0,0,0,0,0,0,0,0,0,0,0,0,0,0,0,0,0,0,0,0,0,0,0,0,73041
25244,689,89,303,194,61,42,38,14,14,0,0,14,0,0,0,0,0,0,0,0,0,24,21,2,5,14,3,3,0,0,3,0,0,0,0,73042
25245,108,11,30,32,33,2,12,12,12,0,0,12,0,0,0,0,0,0,0,0,0,0,0,0,0,0,0,0,0,0,0,0,0,0,0,73043
25246,13757,1814,5088,4445,1638,772,1415,807,648,105,42,501,159,159,19,56,84,0,0,0,0,608,554,175,59,320,54,9,9,0,0,45,22,0,23,73044
25247,6575,902,2140,2340,797,396,649,391,297,97,0,200,94,73,64,0,9,21,21,0,0,258,233,44,17,172,25,19,0,0,19,6,0,0,6,73045
25248,3429,691,1380,1089,186,83,210,109,73,18,16,39,36,22,22,0,0,14,0,0,14,101,67,34,4,29,34,11,11,0,0,23,0,2,21,73047
25249,1326,156,529,334,218,89,98,41,37,0,6,31,4,1,0,0,1,3,0,0,3,57,55,14,0,41,2,2,2,0,0,0,0,0,0,73048
25250,4120,451,1748,1284,427,210,396,171,171,50,14,107,0,0,0,0,0,0,0,0,0,225,216,115,0,101,9,0,0,0,0,9,0,0,9,73049
25251,125,0,11,89,13,12,262,105,105,41,0,64,0,0,0,0,0,0,0,0,0,157,157,0,21,136,0,0,0,0,0,0,0,0,0,73050
25252,7278,1527,3077,2059,460,155,497,295,200,58,6,136,95,31,2,0,29,64,0,0,64,202,196,105,8,83,6,0,0,0,0,6,6,0,0,73051
25253,4170,623,1831,1163,409,144,397,273,228,33,8,187,45,9,9,0,0,36,0,12,24,124,121,39,0,82,3,3,0,0,3,0,0,0,0,73052
25254,523,66,259,122,61,15,21,10,10,4,0,6,0,0,0,0,0,0,0,0,0,11,11,0,0,11,0,0,0,0,0,0,0,0,0,73053
25255,2691,407,1014,723,389,158,220,132,103,0,3,100,29,29,0,0,29,0,0,0,0,88,83,14,0,69,5,5,0,0,5,0,0,0,0,73054
25256,6930,937,2986,1903,858,246,549,244,231,40,33,158,13,13,9,4,0,0,0,0,0,305,282,75,0,207,23,0,0,0,0,23,16,0,7,73055
25257,473,48,229,121,61,14,38,11,11,0,0,11,0,0,0,0,0,0,0,0,0,27,27,2,0,25,0,0,0,0,0,0,0,0,0,73056
25258,1800,373,792,431,160,44,170,81,61,3,0,58,20,12,6,0,6,8,0,0,8,89,67,15,3,49,22,0,0,0,0,22,3,7,12,73057
25259,287,45,111,48,46,37,26,22,20,6,0,14,2,2,2,0,0,0,0,0,0,4,4,0,0,4,0,0,0,0,0,0,0,0,0,73058
25260,1783,198,760,599,186,40,111,67,35,14,0,21,32,26,17,9,0,6,0,0,6,44,38,3,0,35,6,3,3,0,0,3,0,0,3,73059
25261,1189,121,454,310,206,98,49,35,31,19,0,12,4,4,0,0,4,0,0,0,0,14,14,3,0,11,0,0,0,0,0,0,0,0,0,73061
25262,1117,155,382,318,157,105,118,83,79,0,0,79,4,4,0,0,4,0,0,0,0,35,33,12,0,21,2,2,0,0,2,0,0,0,0,73062
25263,452,53,210,99,71,19,72,28,27,23,1,3,1,1,0,0,1,0,0,0,0,44,44,8,4,32,0,0,0,0,0,0,0,0,0,73063
25264,13888,972,4339,5586,2139,852,1099,571,514,189,69,256,57,57,35,11,11,0,0,0,0,528,468,215,59,194,60,60,25,0,35,0,0,0,0,73064
25265,4448,595,1430,1486,660,277,446,178,155,17,0,138,23,11,0,0,11,12,0,0,12,268,250,68,12,170,18,18,8,0,10,0,0,0,0,73065
25266,235,24,93,111,4,3,26,26,26,0,0,26,0,0,0,0,0,0,0,0,0,0,0,0,0,0,0,0,0,0,0,0,0,0,0,73066
25267,1477,311,614,329,147,76,127,60,50,15,3,32,10,10,10,0,0,0,0,0,0,67,46,19,0,27,21,4,4,0,0,17,0,0,17,73067
25268,6997,884,2790,2197,825,301,501,207,148,52,0,96,59,27,13,0,14,32,0,0,32,294,247,144,2,101,47,0,0,0,0,47,0,0,47,73068
25269,14951,1171,3436,4405,3210,2729,1518,769,669,132,45,492,100,50,31,0,19,50,34,7,9,749,687,166,24,497,62,56,51,5,0,6,0,6,0,73069
25270,21851,1859,4327,7169,4987,3509,1484,817,769,164,41,564,48,13,12,0,1,35,0,0,35,667,577,265,80,232,90,50,17,14,19,40,0,0,40,73071
25271,24112,935,3963,6354,6924,5936,6148,2897,2665,509,175,1981,232,124,49,0,75,108,32,34,42,3251,3157,899,294,1964,94,40,20,20,0,54,24,0,30,73072
25272,396,58,117,143,56,22,18,7,6,0,0,6,1,0,0,0,0,1,0,0,1,11,11,0,0,11,0,0,0,0,0,0,0,0,0,73073
25273,682,53,320,152,80,77,95,42,24,0,0,24,18,6,0,0,6,12,3,0,9,53,39,21,0,18,14,9,9,0,0,5,0,0,5,73074
25274,6297,1234,2703,1382,682,296,462,280,225,51,40,134,55,42,0,0,42,13,3,0,10,182,131,19,26,86,51,32,0,0,32,19,0,0,19,73075
25275,4950,649,1768,1438,787,308,349,159,144,89,14,41,15,0,0,0,0,15,0,0,15,190,177,34,27,116,13,0,0,0,0,13,0,8,5,73077
25276,5232,248,994,2016,1410,564,451,162,103,11,16,76,59,49,26,23,0,10,0,9,1,289,275,130,16,129,14,14,0,0,14,0,0,0,0,73078
25277,363,26,92,100,82,63,59,36,36,4,0,32,0,0,0,0,0,0,0,0,0,23,21,3,2,16,2,2,0,2,0,0,0,0,0,73079
25278,6463,1031,2452,1977,705,298,510,290,210,66,0,144,80,33,26,0,7,47,47,0,0,220,183,35,20,128,37,25,7,0,18,12,0,0,12,73080
25279,1727,452,753,302,163,57,133,80,55,15,3,37,25,8,0,0,8,17,0,0,17,53,49,12,0,37,4,4,0,4,0,0,0,0,0,73082
25280,4732,768,1735,1617,433,179,452,293,256,31,33,192,37,22,22,0,0,15,15,0,0,159,106,15,0,91,53,30,14,0,16,23,0,0,23,73084
25281,5735,1175,2281,1279,608,392,455,113,62,27,8,27,51,35,24,0,11,16,0,2,14,342,303,51,41,211,39,37,28,0,9,2,0,0,2,73086
25282,8301,829,2753,3370,1077,272,808,448,427,101,0,326,21,21,21,0,0,0,0,0,0,360,359,98,15,246,1,1,0,0,1,0,0,0,0,73089
25283,1287,145,676,293,89,84,45,40,36,4,0,32,4,4,4,0,0,0,0,0,0,5,5,0,5,0,0,0,0,0,0,0,0,0,0,73090
25284,603,123,216,161,63,40,55,32,26,9,0,17,6,6,6,0,0,0,0,0,0,23,16,5,3,8,7,4,4,0,0,3,0,0,3,73092
25285,1766,178,482,640,347,119,167,85,85,41,3,41,0,0,0,0,0,0,0,0,0,82,75,47,0,28,7,7,4,0,3,0,0,0,0,73093
25286,1323,195,561,314,188,65,91,53,40,0,0,40,13,7,0,0,7,6,0,0,6,38,26,13,8,5,12,12,7,0,5,0,0,0,0,73095
25287,7285,604,1925,1965,1776,1015,1210,519,495,228,45,222,24,24,0,7,17,0,0,0,0,691,654,192,24,438,37,29,0,0,29,8,8,0,0,73096
25288,212,49,62,101,0,0,0,0,0,0,0,0,0,0,0,0,0,0,0,0,0,0,0,0,0,0,0,0,0,0,0,0,0,0,0,73097
25289,3048,435,1240,812,323,238,311,125,81,19,0,62,44,27,24,0,3,17,0,0,17,186,136,55,0,81,50,32,27,0,5,18,0,6,12,73098
25290,38644,2388,10057,14561,8552,3086,2886,1455,1283,390,83,810,172,85,54,8,23,87,58,10,19,1431,1391,297,66,1028,40,35,35,0,0,5,0,5,0,73099
25291,2556,515,617,788,387,249,72,69,13,13,0,0,56,23,0,0,23,33,0,0,33,3,3,3,0,0,0,0,0,0,0,0,0,0,0,73102
25292,3432,225,518,996,870,823,102,41,18,0,7,11,23,13,0,0,13,10,0,0,10,61,61,20,0,41,0,0,0,0,0,0,0,0,0,73103
25293,1214,75,211,365,251,312,119,61,50,0,12,38,11,0,0,0,0,11,0,0,11,58,50,0,13,37,8,8,8,0,0,0,0,0,0,73104
25294,3889,418,1089,1262,678,442,204,76,68,0,33,35,8,8,8,0,0,0,0,0,0,128,121,100,0,21,7,0,0,0,0,7,7,0,0,73105
25295,8364,2527,2127,1945,1012,753,838,453,354,86,50,218,99,4,4,0,0,95,50,4,41,385,351,88,4,259,34,29,7,10,12,5,0,0,5,73106
25296,18027,4115,4861,5136,2829,1086,1196,661,413,187,10,216,248,98,84,0,14,150,58,54,38,535,448,232,24,192,87,48,41,0,7,39,20,19,0,73107
25297,8248,4035,2680,1225,183,125,861,559,349,101,10,238,210,60,56,0,4,150,42,91,17,302,221,41,0,180,81,56,3,0,53,25,12,0,13,73108
25298,12488,5000,4081,2870,436,101,1370,527,388,125,34,229,139,75,16,0,59,64,21,7,36,843,649,155,84,410,194,145,31,0,114,49,24,0,25,73109
25299,21128,2528,6338,8456,2837,969,1342,629,481,117,26,338,148,98,66,6,26,50,0,15,35,713,620,315,0,305,93,63,45,14,4,30,23,0,7,73110
25300,7578,1414,2814,2216,720,414,739,393,270,98,29,143,123,33,17,16,0,90,0,14,76,346,302,31,0,271,44,35,0,0,35,9,0,9,0,73111
25301,22192,2574,5316,7583,4523,2196,886,546,467,126,45,296,79,28,13,6,9,51,0,0,51,340,224,117,28,79,116,62,32,0,30,54,6,22,26,73112
25302,10636,1523,3405,3571,1531,606,1075,514,424,99,10,315,90,58,26,15,17,32,0,0,32,561,505,185,19,301,56,39,30,0,9,17,0,9,8,73114
25303,13238,1771,4973,5031,1022,441,1133,585,484,65,29,390,101,67,27,13,27,34,28,6,0,548,449,174,39,236,99,62,42,0,20,37,13,5,19,73115
25304,7254,365,913,1886,2468,1622,263,117,101,18,0,83,16,0,0,0,0,16,16,0,0,146,123,56,0,67,23,23,14,0,9,0,0,0,0,73116
25305,3568,563,1440,1109,211,245,170,67,48,9,18,21,19,18,0,11,7,1,0,0,1,103,65,8,9,48,38,18,0,0,18,20,0,8,12,73117
25306,10248,1450,1586,2902,2436,1874,357,123,91,7,0,84,32,0,0,0,0,32,4,28,0,234,217,83,0,134,17,8,4,0,4,9,0,9,0,73118
25307,18002,7855,5687,3496,725,239,1706,939,679,199,57,423,260,68,46,10,12,192,60,55,77,767,543,157,74,312,224,79,56,12,11,145,27,22,96,73119
25308,25403,1323,4898,8656,6760,3766,1312,651,605,133,110,362,46,10,0,0,10,36,0,0,36,661,531,152,0,379,130,110,45,39,26,20,20,0,0,73120
25309,2525,206,701,897,434,287,156,67,63,29,7,27,4,4,4,0,0,0,0,0,0,89,75,17,0,58,14,7,0,7,0,7,0,0,7,73121
25310,9050,1332,2100,3390,1487,741,856,463,426,253,13,160,37,0,0,0,0,37,18,13,6,393,306,158,10,138,87,87,10,26,51,0,0,0,0,73122
25311,14544,3217,4235,4644,1779,669,1635,883,654,117,101,436,229,81,33,36,12,148,111,11,26,752,567,201,9,357,185,130,48,31,51,55,38,8,9,73127
25312,2767,495,637,973,442,220,184,90,90,15,3,72,0,0,0,0,0,0,0,0,0,94,94,69,11,14,0,0,0,0,0,0,0,0,0,73128
25313,10933,4112,4124,2303,331,63,883,518,377,60,56,261,141,40,31,0,9,101,44,32,25,365,339,46,121,172,26,16,5,6,5,10,0,0,10,73129
25314,13869,1189,4047,5205,2461,967,811,445,372,109,20,243,73,20,11,0,9,53,41,0,12,366,336,144,5,187,30,21,15,0,6,9,9,0,0,73130
25315,2208,170,350,707,590,391,132,57,47,0,0,47,10,10,10,0,0,0,0,0,0,75,62,19,16,27,13,0,0,0,0,13,0,0,13,73131
25316,17265,1455,4353,6008,3713,1736,1502,674,626,262,73,291,48,41,41,0,0,7,0,0,7,828,716,188,39,489,112,98,82,0,16,14,14,0,0,73132
25317,2813,92,279,659,1314,469,72,32,18,0,0,18,14,14,0,0,14,0,0,0,0,40,40,0,0,40,0,0,0,0,0,0,0,0,0,73134
25318,12500,1717,3567,4530,1983,703,799,370,250,60,0,190,120,51,31,0,20,69,0,0,69,429,372,163,18,191,57,10,0,0,10,47,47,0,0,73135
25319,11124,2107,3543,3890,1128,456,786,376,233,20,14,199,143,88,88,0,0,55,26,5,24,410,266,125,15,126,144,94,24,0,70,50,18,0,32,73139
25320,1765,263,607,736,127,32,118,81,65,0,0,65,16,8,8,0,0,8,0,8,0,37,19,9,0,10,18,18,18,0,0,0,0,0,0,73141
25321,7037,229,1003,2002,2431,1372,579,366,366,134,8,224,0,0,0,0,0,0,0,0,0,213,213,121,15,77,0,0,0,0,0,0,0,0,0,73142
25322,834,12,156,401,199,66,125,85,52,52,0,0,33,33,33,0,0,0,0,0,0,40,0,0,0,0,40,40,40,0,0,0,0,0,0,73145
25323,2981,798,1095,749,261,78,198,117,101,42,0,59,16,9,9,0,0,7,0,2,5,81,76,20,0,56,5,5,5,0,0,0,0,0,0,73149
25324,3171,237,817,1168,599,350,246,109,105,15,0,90,4,0,0,0,0,4,4,0,0,137,130,77,10,43,7,7,7,0,0,0,0,0,0,73150
25325,965,6,89,214,356,300,81,44,38,0,10,28,6,6,6,0,0,0,0,0,0,37,37,0,0,37,0,0,0,0,0,0,0,0,0,73151
25326,19844,3393,6574,6801,2160,916,1596,913,658,286,101,271,255,195,166,16,13,60,49,0,11,683,493,220,34,239,190,132,127,0,5,58,45,0,13,73159
25327,34347,3575,10650,12822,5339,1961,2331,1146,807,176,95,536,339,205,131,38,36,134,50,5,79,1185,990,310,109,571,195,106,65,0,41,89,73,0,16,73160
25328,20405,768,4168,6298,6323,2848,1502,816,770,219,56,495,46,0,0,0,0,46,46,0,0,686,566,68,0,498,120,71,9,11,51,49,0,0,49,73162
25329,4225,338,1427,1455,690,315,339,168,132,42,4,86,36,36,0,0,36,0,0,0,0,171,132,40,0,92,39,39,19,0,20,0,0,0,0,73165
25330,1259,71,490,454,146,98,105,62,48,18,25,5,14,0,0,0,0,14,0,14,0,43,12,0,8,4,31,16,16,0,0,15,0,0,15,73169
25331,24177,1442,5380,8921,6122,2312,1603,754,677,190,9,478,77,57,43,0,14,20,5,15,0,849,794,170,70,554,55,49,37,0,12,6,0,6,0,73170
25332,942,57,187,303,261,134,34,21,15,7,0,8,6,6,0,0,6,0,0,0,0,13,13,6,0,7,0,0,0,0,0,0,0,0,0,73173
25333,2193,236,514,722,487,234,193,111,106,16,0,90,5,5,0,5,0,0,0,0,0,82,82,37,0,45,0,0,0,0,0,0,0,0,0,73179
25334,23205,3243,9030,6459,3008,1465,1798,806,619,236,56,327,187,135,114,21,0,52,10,16,26,992,733,250,50,433,259,169,121,23,25,90,63,11,16,73401
25335,71,45,26,0,0,0,0,0,0,0,0,0,0,0,0,0,0,0,0,0,0,0,0,0,0,0,0,0,0,0,0,0,0,0,0,73425
25336,972,126,364,294,134,54,48,15,15,0,0,15,0,0,0,0,0,0,0,0,0,33,33,0,0,33,0,0,0,0,0,0,0,0,0,73430
25337,637,74,174,226,121,42,31,24,18,0,0,18,6,2,0,0,2,4,0,0,4,7,0,0,0,0,7,4,0,4,0,3,0,0,3,73432
25338,1775,226,757,478,235,79,179,95,93,15,0,78,2,2,0,0,2,0,0,0,0,84,82,0,0,82,2,2,2,0,0,0,0,0,0,73433
25339,350,27,115,149,33,26,45,14,14,0,0,14,0,0,0,0,0,0,0,0,0,31,22,0,0,22,9,4,4,0,0,5,0,0,5,73434
25340,69,8,61,0,0,0,0,0,0,0,0,0,0,0,0,0,0,0,0,0,0,0,0,0,0,0,0,0,0,0,0,0,0,0,0,73437
25341,2692,425,1386,513,236,132,210,94,51,11,0,40,43,39,27,12,0,4,0,0,4,116,102,8,0,94,14,2,0,0,2,12,0,0,12,73438
25342,5500,982,2064,1780,415,259,186,88,76,7,0,69,12,0,0,0,0,12,12,0,0,98,48,14,13,21,50,31,16,15,0,19,5,10,4,73439
25343,181,14,60,45,10,52,0,0,0,0,0,0,0,0,0,0,0,0,0,0,0,0,0,0,0,0,0,0,0,0,0,0,0,0,0,73440
25344,182,31,119,30,2,0,7,4,4,0,0,4,0,0,0,0,0,0,0,0,0,3,3,0,0,3,0,0,0,0,0,0,0,0,0,73441
25345,473,56,181,116,104,16,52,41,41,5,0,36,0,0,0,0,0,0,0,0,0,11,11,0,0,11,0,0,0,0,0,0,0,0,0,73442
25346,2217,318,1094,602,175,28,176,133,96,19,26,51,37,37,37,0,0,0,0,0,0,43,43,0,0,43,0,0,0,0,0,0,0,0,0,73443
25347,92,0,59,9,24,0,8,8,8,0,0,8,0,0,0,0,0,0,0,0,0,0,0,0,0,0,0,0,0,0,0,0,0,0,0,73444
25348,5217,1262,1763,1354,507,331,530,271,241,63,4,174,30,30,25,5,0,0,0,0,0,259,223,67,49,107,36,7,0,0,7,29,7,22,0,73446
25349,815,167,332,172,93,51,80,44,36,4,0,32,8,2,2,0,0,6,0,0,6,36,20,12,2,6,16,15,6,9,0,1,1,0,0,73447
25350,3859,719,1604,967,486,83,372,206,170,30,3,137,36,36,36,0,0,0,0,0,0,166,158,24,0,134,8,0,0,0,0,8,8,0,0,73448
25351,2374,436,738,815,267,118,196,82,78,16,0,62,4,0,0,0,0,4,4,0,0,114,106,59,22,25,8,0,0,0,0,8,8,0,0,73449
25352,1033,158,417,239,91,128,42,11,8,0,0,8,3,1,0,1,0,2,1,0,1,31,24,0,0,24,7,7,0,0,7,0,0,0,0,73450
25353,358,24,161,91,67,15,5,5,5,0,0,5,0,0,0,0,0,0,0,0,0,0,0,0,0,0,0,0,0,0,0,0,0,0,0,73453
25354,426,120,147,129,20,10,48,24,18,0,0,18,6,4,3,0,1,2,0,0,2,24,24,3,0,21,0,0,0,0,0,0,0,0,0,73455
25355,1412,241,625,390,112,44,117,57,52,9,2,41,5,5,5,0,0,0,0,0,0,60,45,18,0,27,15,15,2,10,3,0,0,0,0,73456
25356,665,104,374,132,37,18,88,31,25,11,0,14,6,3,0,3,0,3,0,0,3,57,20,14,0,6,37,35,0,0,35,2,0,0,2,73458
25357,670,121,344,171,27,7,30,14,8,0,0,8,6,0,0,0,0,6,6,0,0,16,12,5,0,7,4,4,4,0,0,0,0,0,0,73459
25358,2907,515,747,1107,347,191,300,171,150,8,18,124,21,6,6,0,0,15,10,0,5,129,110,14,4,92,19,14,0,0,14,5,0,5,0,73460
25359,566,124,221,127,60,34,55,12,9,0,0,9,3,2,0,0,2,1,1,0,0,43,41,8,0,33,2,0,0,0,0,2,0,0,2,73461
25360,2570,371,1274,620,250,55,169,85,66,23,0,43,19,13,13,0,0,6,6,0,0,84,74,12,5,57,10,10,7,0,3,0,0,0,0,73463
25361,601,86,347,118,45,5,82,47,32,0,0,32,15,15,12,0,3,0,0,0,0,35,35,6,0,29,0,0,0,0,0,0,0,0,0,73481
25362,113,15,74,23,1,0,0,0,0,0,0,0,0,0,0,0,0,0,0,0,0,0,0,0,0,0,0,0,0,0,0,0,0,0,0,73487
25363,500,59,248,112,60,21,80,50,43,5,0,38,7,4,4,0,0,3,3,0,0,30,30,21,0,9,0,0,0,0,0,0,0,0,0,73491
25364,13798,2582,5198,4317,1274,427,870,464,371,76,0,295,93,72,69,1,2,21,0,0,21,406,372,151,2,219,34,22,8,0,14,12,12,0,0,73501
25365,3337,22,985,1705,439,186,1874,1499,387,279,0,108,1112,1088,1035,4,49,24,24,0,0,375,157,88,0,69,218,218,186,0,32,0,0,0,0,73503
25366,31950,3456,10440,11230,4264,2560,2670,1214,946,197,231,518,268,183,176,0,7,85,10,48,27,1456,1321,356,225,740,135,67,16,0,51,68,2,19,47,73505
25367,14724,1283,4765,5150,2212,1314,1191,654,536,143,44,349,118,96,60,14,22,22,0,0,22,537,332,92,21,219,205,165,155,0,10,40,18,6,16,73507
25368,91,11,48,27,5,0,0,0,0,0,0,0,0,0,0,0,0,0,0,0,0,0,0,0,0,0,0,0,0,0,0,0,0,0,0,73520
25369,13567,2234,3562,5033,1748,990,986,572,364,85,57,222,208,148,106,6,36,60,0,7,53,414,292,110,44,138,122,52,47,0,5,70,22,38,10,73521
25370,1402,120,534,462,176,110,93,47,32,10,0,22,15,15,9,0,6,0,0,0,0,46,46,39,0,7,0,0,0,0,0,0,0,0,0,73526
25371,3283,229,1237,1130,446,241,370,174,76,47,3,26,98,53,30,23,0,45,0,0,45,196,189,52,25,112,7,7,7,0,0,0,0,0,0,73527
25372,343,17,127,123,60,16,58,11,11,3,0,8,0,0,0,0,0,0,0,0,0,47,34,24,0,10,13,13,0,10,3,0,0,0,0,73528
25373,3547,599,1489,1021,242,196,207,96,96,25,31,40,0,0,0,0,0,0,0,0,0,111,88,47,0,41,23,0,0,0,0,23,0,0,23,73529
25374,383,102,134,84,47,16,67,62,62,0,0,62,0,0,0,0,0,0,0,0,0,5,3,0,0,3,2,2,0,0,2,0,0,0,0,73530
25375,262,33,82,84,50,13,27,20,20,0,13,7,0,0,0,0,0,0,0,0,0,7,7,7,0,0,0,0,0,0,0,0,0,0,0,73531
25376,359,46,119,115,54,25,11,7,3,0,0,3,4,4,4,0,0,0,0,0,0,4,4,0,0,4,0,0,0,0,0,0,0,0,0,73532
25377,19102,2842,7475,5135,2531,1119,1289,701,505,147,27,331,196,115,72,36,7,81,7,22,52,588,462,122,6,334,126,74,33,21,20,52,31,0,21,73533
25378,484,87,149,134,76,38,24,15,15,2,0,13,0,0,0,0,0,0,0,0,0,9,9,7,0,2,0,0,0,0,0,0,0,0,0,73537
25379,3224,182,1108,1064,631,239,206,81,64,4,13,47,17,17,17,0,0,0,0,0,0,125,119,51,14,54,6,6,0,0,6,0,0,0,0,73538
25380,138,17,29,86,4,2,12,0,0,0,0,0,0,0,0,0,0,0,0,0,0,12,12,0,0,12,0,0,0,0,0,0,0,0,0,73539
25381,300,41,135,74,37,13,10,8,8,5,0,3,0,0,0,0,0,0,0,0,0,2,2,1,0,1,0,0,0,0,0,0,0,0,0,73540
25382,1973,139,808,581,325,120,110,58,47,30,0,17,11,11,4,7,0,0,0,0,0,52,41,22,0,19,11,11,0,5,6,0,0,0,0,73541
25383,2921,710,1167,591,330,123,297,181,95,7,16,72,86,23,0,17,6,63,6,40,17,116,103,55,3,45,13,13,0,0,13,0,0,0,0,73542
25384,1312,165,433,562,113,39,88,53,53,9,19,25,0,0,0,0,0,0,0,0,0,35,13,0,0,13,22,0,0,0,0,22,0,2,20,73543
25385,154,58,27,40,22,7,19,10,10,1,0,9,0,0,0,0,0,0,0,0,0,9,4,0,0,4,5,5,0,5,0,0,0,0,0,73544
25386,752,125,326,171,123,7,45,25,25,5,0,20,0,0,0,0,0,0,0,0,0,20,20,5,7,8,0,0,0,0,0,0,0,0,0,73546
25387,1787,369,659,576,135,48,73,37,37,26,0,11,0,0,0,0,0,0,0,0,0,36,36,0,0,36,0,0,0,0,0,0,0,0,0,73547
25388,368,10,183,149,10,16,41,0,0,0,0,0,0,0,0,0,0,0,0,0,0,41,41,0,41,0,0,0,0,0,0,0,0,0,0,73548
25389,264,49,65,109,23,18,22,11,0,0,0,0,11,11,11,0,0,0,0,0,0,11,11,0,0,11,0,0,0,0,0,0,0,0,0,73549
25390,1628,388,493,478,183,86,176,94,85,3,0,82,9,9,0,9,0,0,0,0,0,82,59,9,3,47,23,23,0,0,23,0,0,0,0,73550
25391,48,13,9,26,0,0,11,6,6,0,0,6,0,0,0,0,0,0,0,0,0,5,5,0,0,5,0,0,0,0,0,0,0,0,0,73551
25392,1026,97,442,317,114,56,177,104,73,8,16,49,31,28,3,0,25,3,0,0,3,73,56,31,0,25,17,17,0,0,17,0,0,0,0,73552
25393,23,0,12,5,3,3,0,0,0,0,0,0,0,0,0,0,0,0,0,0,0,0,0,0,0,0,0,0,0,0,0,0,0,0,0,73553
25394,2343,503,850,583,280,127,161,69,57,0,8,49,12,12,0,0,12,0,0,0,0,92,86,47,0,39,6,6,6,0,0,0,0,0,0,73554
25395,180,46,81,38,3,12,39,28,20,4,0,16,8,0,0,0,0,8,0,0,8,11,11,0,11,0,0,0,0,0,0,0,0,0,0,73555
25396,124,19,53,35,7,10,17,7,4,4,0,0,3,3,0,3,0,0,0,0,0,10,10,5,0,5,0,0,0,0,0,0,0,0,0,73556
25397,265,41,64,123,17,20,12,10,8,0,8,0,2,0,0,0,0,2,0,0,2,2,2,0,0,2,0,0,0,0,0,0,0,0,0,73557
25398,423,50,205,96,16,56,28,25,25,13,5,7,0,0,0,0,0,0,0,0,0,3,3,0,0,3,0,0,0,0,0,0,0,0,0,73559
25399,319,55,93,108,34,29,88,15,15,0,0,15,0,0,0,0,0,0,0,0,0,73,63,4,0,59,10,10,10,0,0,0,0,0,0,73560
25400,586,123,259,121,63,20,47,27,23,7,12,4,4,4,4,0,0,0,0,0,0,20,20,15,0,5,0,0,0,0,0,0,0,0,0,73562
25401,379,44,174,74,61,26,7,0,0,0,0,0,0,0,0,0,0,0,0,0,0,7,7,0,0,7,0,0,0,0,0,0,0,0,0,73564
25402,712,161,319,153,56,23,42,31,25,0,0,25,6,6,0,4,2,0,0,0,0,11,11,0,0,11,0,0,0,0,0,0,0,0,0,73565
25403,1061,202,313,386,97,63,143,77,59,10,0,49,18,6,6,0,0,12,12,0,0,66,61,2,0,59,5,0,0,0,0,5,0,0,5,73566
25404,438,60,202,116,46,14,34,27,12,12,0,0,15,0,0,0,0,15,15,0,0,7,7,5,0,2,0,0,0,0,0,0,0,0,0,73567
25405,828,140,424,182,65,17,46,25,25,0,4,21,0,0,0,0,0,0,0,0,0,21,21,6,5,10,0,0,0,0,0,0,0,0,0,73568
25406,402,93,207,60,33,9,11,7,7,0,2,5,0,0,0,0,0,0,0,0,0,4,2,0,0,2,2,2,0,0,2,0,0,0,0,73569
25407,754,181,254,203,94,22,70,40,31,0,0,31,9,8,5,0,3,1,0,0,1,30,30,0,0,30,0,0,0,0,0,0,0,0,0,73570
25408,105,18,18,35,7,27,0,0,0,0,0,0,0,0,0,0,0,0,0,0,0,0,0,0,0,0,0,0,0,0,0,0,0,0,0,73571
25409,2386,282,950,779,275,100,219,136,107,67,4,36,29,0,0,0,0,29,22,0,7,83,55,35,0,20,28,9,0,0,9,19,0,0,19,73572
25410,1752,335,845,369,140,63,143,99,67,0,0,67,32,18,18,0,0,14,0,14,0,44,18,5,0,13,26,17,0,0,17,9,5,0,4,73573
25411,6508,1513,2345,1281,853,516,582,398,333,127,18,188,65,65,65,0,0,0,0,0,0,184,168,72,8,88,16,16,16,0,0,0,0,0,0,73601
25412,788,63,362,266,63,34,30,24,20,8,0,12,4,0,0,0,0,4,0,0,4,6,0,0,0,0,6,6,6,0,0,0,0,0,0,73620
25413,134,20,80,21,10,3,3,0,0,0,0,0,0,0,0,0,0,0,0,0,0,3,3,1,0,2,0,0,0,0,0,0,0,0,0,73622
25414,1351,252,553,402,116,28,119,54,48,14,0,34,6,6,6,0,0,0,0,0,0,65,60,8,0,52,5,0,0,0,0,5,0,5,0,73624
25415,458,59,217,110,45,27,13,13,10,4,0,6,3,3,3,0,0,0,0,0,0,0,0,0,0,0,0,0,0,0,0,0,0,0,0,73625
25416,593,105,277,146,44,21,22,19,18,3,3,12,1,1,0,0,1,0,0,0,0,3,3,3,0,0,0,0,0,0,0,0,0,0,0,73626
25417,309,23,144,111,22,9,18,9,9,0,0,9,0,0,0,0,0,0,0,0,0,9,9,3,0,6,0,0,0,0,0,0,0,0,0,73627
25418,1230,99,459,411,176,85,146,101,92,0,0,92,9,6,0,0,6,3,0,0,3,45,41,17,0,24,4,0,0,0,0,4,0,0,4,73628
25419,2244,291,900,575,357,121,105,45,45,0,5,40,0,0,0,0,0,0,0,0,0,60,55,35,0,20,5,5,5,0,0,0,0,0,0,73632
25420,83,3,44,27,6,3,0,0,0,0,0,0,0,0,0,0,0,0,0,0,0,0,0,0,0,0,0,0,0,0,0,0,0,0,0,73638
25421,419,61,146,124,45,43,16,5,5,0,0,5,0,0,0,0,0,0,0,0,0,11,9,0,2,7,2,2,2,0,0,0,0,0,0,73639
25422,541,122,208,156,40,15,89,57,14,0,0,14,43,0,0,0,0,43,43,0,0,32,32,5,0,27,0,0,0,0,0,0,0,0,0,73641
25423,104,9,43,28,14,10,0,0,0,0,0,0,0,0,0,0,0,0,0,0,0,0,0,0,0,0,0,0,0,0,0,0,0,0,0,73642
25424,9173,1502,3511,2522,1143,495,826,495,242,61,16,165,253,128,55,0,73,125,75,0,50,331,229,120,0,109,102,39,39,0,0,63,16,8,39,73644
25425,853,142,381,223,91,16,98,29,29,8,0,21,0,0,0,0,0,0,0,0,0,69,27,0,1,26,42,30,4,0,26,12,0,0,12,73645
25426,219,5,134,33,34,13,1,0,0,0,0,0,0,0,0,0,0,0,0,0,0,1,0,0,0,0,1,0,0,0,0,1,0,0,1,73646
25427,485,56,145,143,109,32,38,18,6,0,0,6,12,12,0,6,6,0,0,0,0,20,20,8,0,12,0,0,0,0,0,0,0,0,0,73647
25428,607,62,221,222,57,45,54,32,32,0,0,32,0,0,0,0,0,0,0,0,0,22,19,0,0,19,3,0,0,0,0,3,3,0,0,73650
25429,2879,402,1094,959,303,121,225,115,69,10,0,59,46,45,0,0,45,1,1,0,0,110,110,59,0,51,0,0,0,0,0,0,0,0,0,73651
25430,606,59,245,159,102,41,47,16,11,5,0,6,5,5,0,0,5,0,0,0,0,31,31,7,0,24,0,0,0,0,0,0,0,0,0,73654
25431,581,54,243,174,81,29,22,8,8,0,8,0,0,0,0,0,0,0,0,0,0,14,11,0,0,11,3,3,3,0,0,0,0,0,0,73655
25432,187,25,92,47,21,2,31,18,13,0,0,13,5,0,0,0,0,5,5,0,0,13,13,0,0,13,0,0,0,0,0,0,0,0,0,73658
25433,152,18,68,50,9,7,11,8,8,0,0,8,0,0,0,0,0,0,0,0,0,3,3,0,0,3,0,0,0,0,0,0,0,0,0,73659
25434,285,27,115,98,35,10,15,0,0,0,0,0,0,0,0,0,0,0,0,0,0,15,11,0,0,11,4,4,4,0,0,0,0,0,0,73660
25435,306,17,169,79,38,3,7,4,4,4,0,0,0,0,0,0,0,0,0,0,0,3,1,0,0,1,2,2,2,0,0,0,0,0,0,73661
25436,4790,1033,1776,1298,404,279,238,180,147,54,14,79,33,0,0,0,0,33,0,0,33,58,36,2,15,19,22,0,0,0,0,22,9,0,13,73662
25437,804,113,269,296,78,48,53,36,36,11,0,25,0,0,0,0,0,0,0,0,0,17,12,2,3,7,5,3,0,0,3,2,0,0,2,73663
25438,782,166,230,264,106,16,61,24,24,4,0,20,0,0,0,0,0,0,0,0,0,37,28,2,0,26,9,0,0,0,0,9,0,0,9,73664
25439,144,19,60,44,18,3,7,0,0,0,0,0,0,0,0,0,0,0,0,0,0,7,7,7,0,0,0,0,0,0,0,0,0,0,0,73666
25440,418,34,166,79,114,25,32,14,10,6,0,4,4,4,0,0,4,0,0,0,0,18,18,3,0,15,0,0,0,0,0,0,0,0,0,73667
25441,1132,189,463,226,175,79,63,50,45,14,0,31,5,2,2,0,0,3,3,0,0,13,13,4,0,9,0,0,0,0,0,0,0,0,0,73669
25442,266,45,89,94,38,0,13,10,5,0,0,5,5,0,0,0,0,5,0,0,5,3,0,0,0,0,3,3,3,0,0,0,0,0,0,73673
25443,15782,3707,6186,4309,1216,364,1682,899,715,268,85,362,184,64,20,18,26,120,56,22,42,783,670,240,27,403,113,25,0,5,20,88,15,33,40,73701
25444,19105,1385,5880,5747,3993,2100,1190,656,567,316,3,248,89,89,32,32,25,0,0,0,0,534,431,305,3,123,103,52,52,0,0,51,12,0,39,73703
25445,17,0,0,3,14,0,24,19,3,3,0,0,16,16,16,0,0,0,0,0,0,5,0,0,0,0,5,5,5,0,0,0,0,0,0,73705
25446,320,24,119,109,45,23,13,5,5,0,0,5,0,0,0,0,0,0,0,0,0,8,8,2,0,6,0,0,0,0,0,0,0,0,0,73716
25447,4104,439,1210,1222,645,588,468,252,211,107,0,104,41,30,0,0,30,11,0,0,11,216,200,113,14,73,16,16,6,0,10,0,0,0,0,73717
25448,400,41,217,91,31,20,3,3,3,0,0,3,0,0,0,0,0,0,0,0,0,0,0,0,0,0,0,0,0,0,0,0,0,0,0,73718
25449,34,7,19,2,6,0,0,0,0,0,0,0,0,0,0,0,0,0,0,0,0,0,0,0,0,0,0,0,0,0,0,0,0,0,0,73719
25450,187,20,67,80,20,0,12,12,8,8,0,0,4,4,4,0,0,0,0,0,0,0,0,0,0,0,0,0,0,0,0,0,0,0,0,73720
25451,319,27,120,91,60,21,25,15,14,6,1,7,1,0,0,0,0,1,0,0,1,10,4,0,0,4,6,0,0,0,0,6,0,0,6,73722
25452,725,119,219,217,123,47,45,1,1,1,0,0,0,0,0,0,0,0,0,0,0,44,16,1,15,0,28,0,0,0,0,28,28,0,0,73724
25453,390,57,156,99,47,31,13,4,4,0,0,4,0,0,0,0,0,0,0,0,0,9,7,2,1,4,2,2,2,0,0,0,0,0,0,73726
25454,167,12,69,45,39,2,18,18,18,18,0,0,0,0,0,0,0,0,0,0,0,0,0,0,0,0,0,0,0,0,0,0,0,0,0,73727
25455,1371,134,415,450,275,97,101,48,37,3,9,25,11,8,5,0,3,3,0,3,0,53,45,10,6,29,8,4,0,0,4,4,0,0,4,73728
25456,409,42,207,99,50,11,13,7,2,0,0,2,5,5,5,0,0,0,0,0,0,6,6,3,0,3,0,0,0,0,0,0,0,0,0,73729
25457,524,82,196,136,76,34,29,12,3,0,0,3,9,9,9,0,0,0,0,0,0,17,8,0,0,8,9,9,4,5,0,0,0,0,0,73730
25458,95,3,35,31,23,3,6,6,6,0,0,6,0,0,0,0,0,0,0,0,0,0,0,0,0,0,0,0,0,0,0,0,0,0,0,73731
25459,159,13,55,49,26,16,10,10,3,0,0,3,7,0,0,0,0,7,0,7,0,0,0,0,0,0,0,0,0,0,0,0,0,0,0,73733
25460,561,101,251,147,44,18,63,39,26,12,0,14,13,12,2,10,0,1,1,0,0,24,24,17,0,7,0,0,0,0,0,0,0,0,0,73734
25461,424,111,142,111,36,24,56,34,32,23,0,9,2,0,0,0,0,2,0,0,2,22,22,0,2,20,0,0,0,0,0,0,0,0,0,73735
25462,307,24,137,68,47,31,19,15,15,3,4,8,0,0,0,0,0,0,0,0,0,4,4,4,0,0,0,0,0,0,0,0,0,0,0,73736
25463,2393,295,894,762,318,124,157,127,83,39,0,44,44,27,27,0,0,17,17,0,0,30,30,4,0,26,0,0,0,0,0,0,0,0,0,73737
25464,836,72,318,311,111,24,73,50,36,17,0,19,14,0,0,0,0,14,14,0,0,23,10,5,0,5,13,13,0,0,13,0,0,0,0,73738
25465,224,16,114,46,37,11,11,1,1,0,0,1,0,0,0,0,0,0,0,0,0,10,10,5,3,2,0,0,0,0,0,0,0,0,0,73739
25466,1485,322,590,362,183,28,23,9,2,0,2,0,7,4,4,0,0,3,3,0,0,14,14,7,0,7,0,0,0,0,0,0,0,0,0,73741
25467,2587,586,993,662,214,132,331,152,138,61,19,58,14,13,12,0,1,1,0,0,1,179,107,41,9,57,72,72,39,19,14,0,0,0,0,73742
25468,92,4,26,44,18,0,8,8,8,0,0,8,0,0,0,0,0,0,0,0,0,0,0,0,0,0,0,0,0,0,0,0,0,0,0,73743
25469,169,21,56,51,37,4,1,1,1,0,0,1,0,0,0,0,0,0,0,0,0,0,0,0,0,0,0,0,0,0,0,0,0,0,0,73744
25470,8,0,4,0,4,0,0,0,0,0,0,0,0,0,0,0,0,0,0,0,0,0,0,0,0,0,0,0,0,0,0,0,0,0,0,73746
25471,182,34,80,40,25,3,20,15,8,0,0,8,7,0,0,0,0,7,7,0,0,5,5,0,0,5,0,0,0,0,0,0,0,0,0,73747
25472,322,41,149,61,42,29,33,20,10,2,0,8,10,0,0,0,0,10,10,0,0,13,13,0,0,13,0,0,0,0,0,0,0,0,0,73749
25473,4782,527,1679,1630,576,370,291,192,144,14,0,130,48,43,43,0,0,5,0,0,5,99,64,23,29,12,35,35,0,0,35,0,0,0,0,73750
25474,356,45,108,121,63,19,15,0,0,0,0,0,0,0,0,0,0,0,0,0,0,15,14,4,0,10,1,0,0,0,0,1,0,1,0,73753
25475,648,61,259,190,110,28,62,50,39,19,16,4,11,11,11,0,0,0,0,0,0,12,12,3,3,6,0,0,0,0,0,0,0,0,0,73754
25476,512,74,254,146,16,22,56,15,15,3,0,12,0,0,0,0,0,0,0,0,0,41,41,1,21,19,0,0,0,0,0,0,0,0,0,73755
25477,182,20,66,58,33,5,11,4,0,0,0,0,4,4,4,0,0,0,0,0,0,7,7,0,0,7,0,0,0,0,0,0,0,0,0,73756
25478,124,8,31,31,54,0,38,0,0,0,0,0,0,0,0,0,0,0,0,0,0,38,38,4,0,34,0,0,0,0,0,0,0,0,0,73757
25479,123,28,54,23,13,5,4,0,0,0,0,0,0,0,0,0,0,0,0,0,0,4,4,0,0,4,0,0,0,0,0,0,0,0,0,73758
25480,1148,78,397,341,218,114,64,47,39,0,0,39,8,5,0,0,5,3,0,0,3,17,17,0,2,15,0,0,0,0,0,0,0,0,0,73759
25481,320,59,116,96,38,11,39,16,7,2,0,5,9,7,0,7,0,2,2,0,0,23,23,12,0,11,0,0,0,0,0,0,0,0,0,73760
25482,377,12,173,141,40,11,48,6,6,0,0,6,0,0,0,0,0,0,0,0,0,42,22,13,0,9,20,20,0,0,20,0,0,0,0,73761
25483,1419,130,444,475,255,115,69,49,46,26,0,20,3,0,0,0,0,3,3,0,0,20,20,0,0,20,0,0,0,0,0,0,0,0,0,73762
25484,982,93,328,369,135,57,57,30,26,17,5,4,4,4,4,0,0,0,0,0,0,27,27,20,0,7,0,0,0,0,0,0,0,0,0,73763
25485,114,5,33,24,30,22,18,18,11,6,0,5,7,3,3,0,0,4,0,0,4,0,0,0,0,0,0,0,0,0,0,0,0,0,0,73764
25486,741,69,257,238,112,65,40,20,20,0,5,15,0,0,0,0,0,0,0,0,0,20,20,4,0,16,0,0,0,0,0,0,0,0,0,73766
25487,1011,109,477,265,151,9,88,45,34,9,2,23,11,11,4,7,0,0,0,0,0,43,27,11,0,16,16,16,16,0,0,0,0,0,0,73768
25488,341,58,113,118,45,7,33,16,3,3,0,0,13,0,0,0,0,13,13,0,0,17,9,6,0,3,8,8,8,0,0,0,0,0,0,73771
25489,3692,762,1387,1018,373,152,129,56,18,2,0,16,38,7,0,0,7,31,0,0,31,73,73,26,0,47,0,0,0,0,0,0,0,0,0,73772
25490,1103,153,463,264,162,61,109,47,43,14,0,29,4,0,0,0,0,4,4,0,0,62,59,52,0,7,3,3,3,0,0,0,0,0,0,73773
25491,9863,1280,3652,3150,1361,420,836,414,283,127,17,139,131,109,62,43,4,22,0,0,22,422,405,246,12,147,17,17,17,0,0,0,0,0,0,73801
25492,687,59,238,192,157,41,32,26,16,0,0,16,10,8,0,0,8,2,0,0,2,6,6,0,0,6,0,0,0,0,0,0,0,0,0,73832
25493,1268,186,587,266,172,57,101,30,26,4,0,22,4,4,4,0,0,0,0,0,0,71,71,39,0,32,0,0,0,0,0,0,0,0,0,73834
25494,223,49,87,61,19,7,30,14,14,4,0,10,0,0,0,0,0,0,0,0,0,16,12,6,3,3,4,4,0,0,4,0,0,0,0,73835
25495,327,55,136,82,42,12,23,8,8,0,0,8,0,0,0,0,0,0,0,0,0,15,15,12,0,3,0,0,0,0,0,0,0,0,0,73838
25496,530,59,258,150,42,21,66,47,41,6,0,35,6,0,0,0,0,6,6,0,0,19,14,10,0,4,5,0,0,0,0,5,5,0,0,73840
25497,1038,413,401,168,23,33,23,14,14,3,0,11,0,0,0,0,0,0,0,0,0,9,9,0,0,9,0,0,0,0,0,0,0,0,0,73841
25498,344,38,140,91,65,10,11,9,9,0,0,9,0,0,0,0,0,0,0,0,0,2,2,0,0,2,0,0,0,0,0,0,0,0,0,73842
25499,637,88,177,197,103,72,53,22,10,4,0,6,12,3,0,0,3,9,0,0,9,31,31,6,0,25,0,0,0,0,0,0,0,0,0,73843
25500,184,39,27,86,23,9,10,4,4,4,0,0,0,0,0,0,0,0,0,0,0,6,6,0,0,6,0,0,0,0,0,0,0,0,0,73844
25501,1315,189,585,328,163,50,110,65,56,27,0,29,9,9,9,0,0,0,0,0,0,45,45,15,0,30,0,0,0,0,0,0,0,0,0,73848
25502,38,0,28,10,0,0,0,0,0,0,0,0,0,0,0,0,0,0,0,0,0,0,0,0,0,0,0,0,0,0,0,0,0,0,0,73851
25503,1474,207,572,372,219,104,70,19,19,9,0,10,0,0,0,0,0,0,0,0,0,51,51,19,4,28,0,0,0,0,0,0,0,0,0,73852
25504,313,24,128,55,84,22,8,0,0,0,0,0,0,0,0,0,0,0,0,0,0,8,8,4,0,4,0,0,0,0,0,0,0,0,0,73853
25505,70,15,18,20,12,5,0,0,0,0,0,0,0,0,0,0,0,0,0,0,0,0,0,0,0,0,0,0,0,0,0,0,0,0,0,73855
25506,578,32,296,198,27,25,25,16,10,0,0,10,6,6,0,6,0,0,0,0,0,9,0,0,0,0,9,9,9,0,0,0,0,0,0,73857
25507,1131,142,375,339,177,98,74,41,35,0,0,35,6,0,0,0,0,6,0,6,0,33,33,16,0,17,0,0,0,0,0,0,0,0,0,73858
25508,1073,129,482,227,196,39,81,49,38,5,0,33,11,3,3,0,0,8,0,8,0,32,17,11,0,6,15,4,4,0,0,11,0,0,11,73859
25509,1064,139,418,304,145,58,96,50,50,18,0,32,0,0,0,0,0,0,0,0,0,46,37,16,0,21,9,9,9,0,0,0,0,0,0,73860
25510,58,37,13,8,0,0,0,0,0,0,0,0,0,0,0,0,0,0,0,0,0,0,0,0,0,0,0,0,0,0,0,0,0,0,0,73901
25511,431,37,153,146,83,12,21,5,5,0,0,5,0,0,0,0,0,0,0,0,0,16,16,4,0,12,0,0,0,0,0,0,0,0,0,73931
25512,1458,245,576,377,184,76,110,45,25,0,0,25,20,20,20,0,0,0,0,0,0,65,65,26,0,39,0,0,0,0,0,0,0,0,0,73932
25513,1091,212,362,301,185,31,94,46,37,6,0,31,9,9,9,0,0,0,0,0,0,48,33,19,0,14,15,6,0,6,0,9,9,0,0,73933
25514,116,25,37,29,22,3,0,0,0,0,0,0,0,0,0,0,0,0,0,0,0,0,0,0,0,0,0,0,0,0,0,0,0,0,0,73937
25515,447,70,178,120,55,24,37,26,15,10,0,5,11,11,0,6,5,0,0,0,0,11,7,4,0,3,4,0,0,0,0,4,0,4,0,73938
25516,777,76,137,251,218,95,269,135,135,48,6,81,0,0,0,0,0,0,0,0,0,134,133,93,0,40,1,0,0,0,0,1,0,0,1,73939
25517,8127,2550,2432,1757,1161,227,653,356,252,60,16,176,104,0,0,0,0,104,48,16,40,297,226,62,33,131,71,8,0,0,8,63,40,10,13,73942
25518,270,72,64,87,36,11,15,9,9,5,0,4,0,0,0,0,0,0,0,0,0,6,6,0,6,0,0,0,0,0,0,0,0,0,0,73944
25519,2030,529,551,563,310,77,166,84,74,14,0,60,10,3,2,0,1,7,4,0,3,82,59,30,0,29,23,9,7,0,2,14,0,13,1,73945
25520,54,0,16,38,0,0,0,0,0,0,0,0,0,0,0,0,0,0,0,0,0,0,0,0,0,0,0,0,0,0,0,0,0,0,0,73946
25521,378,68,153,96,55,6,11,10,10,8,0,2,0,0,0,0,0,0,0,0,0,1,1,1,0,0,0,0,0,0,0,0,0,0,0,73947
25522,1030,282,275,248,193,32,90,52,52,18,5,29,0,0,0,0,0,0,0,0,0,38,38,7,0,31,0,0,0,0,0,0,0,0,0,73949
25523,1141,214,413,338,130,46,139,56,56,8,7,41,0,0,0,0,0,0,0,0,0,83,77,23,6,48,6,0,0,0,0,6,0,0,6,73950
25524,576,129,196,199,45,7,91,64,64,8,16,40,0,0,0,0,0,0,0,0,0,27,27,5,0,22,0,0,0,0,0,0,0,0,0,73951
25525,280,36,153,63,28,0,18,12,12,0,0,12,0,0,0,0,0,0,0,0,0,6,6,2,0,4,0,0,0,0,0,0,0,0,0,74001
25526,1646,150,779,450,167,100,158,73,60,13,0,47,13,8,8,0,0,5,5,0,0,85,68,26,0,42,17,15,12,3,0,2,0,0,2,74002
25527,9337,1651,3442,2624,1147,473,795,430,320,77,51,192,110,43,20,0,23,67,46,6,15,365,230,53,24,153,135,48,26,6,16,87,75,3,9,74003
25528,17917,1092,4882,5655,4392,1896,1387,752,651,209,42,400,101,89,55,0,34,12,0,0,12,635,592,195,38,359,43,43,19,14,10,0,0,0,0,74006
25529,15137,1129,3491,5245,3905,1367,889,464,372,76,25,271,92,69,36,32,1,23,5,11,7,425,327,169,0,158,98,51,23,0,28,47,0,0,47,74008
25530,7308,1039,3230,2121,655,263,442,293,279,40,6,233,14,14,2,0,12,0,0,0,0,149,119,38,15,66,30,21,21,0,0,9,0,0,9,74010
25531,17051,959,4136,6034,4298,1624,1145,602,501,177,60,264,101,56,40,11,5,45,7,21,17,543,484,189,28,267,59,45,37,0,8,14,8,1,5,74011
25532,37249,2597,9497,13873,8026,3256,3470,2003,1686,564,128,994,317,227,93,77,57,90,10,45,35,1467,1355,613,90,652,112,67,44,0,23,45,36,9,0,74012
25533,23090,1682,6512,8628,4740,1528,1707,1030,877,217,45,615,153,101,56,8,37,52,35,0,17,677,538,288,19,231,139,128,72,46,10,11,0,0,11,74014
25534,5663,753,2117,1770,716,307,533,350,284,138,18,128,66,51,51,0,0,15,10,0,5,183,157,37,0,120,26,18,18,0,0,8,0,0,8,74015
25535,3876,747,1359,1181,338,251,386,191,161,29,65,67,30,13,13,0,0,17,17,0,0,195,185,84,0,101,10,10,10,0,0,0,0,0,0,74016
25536,18233,2126,6181,6419,2590,917,1380,748,613,78,97,438,135,46,35,11,0,89,25,0,64,632,491,156,66,269,141,110,65,34,11,31,7,11,13,74017
25537,12097,760,3860,4503,2249,725,1239,659,587,164,46,377,72,65,40,9,16,7,0,0,7,580,538,265,17,256,42,36,17,0,19,6,0,0,6,74019
25538,5123,673,2140,1472,614,224,414,206,180,30,23,127,26,26,18,8,0,0,0,0,0,208,160,37,50,73,48,36,3,0,33,12,0,0,12,74020
25539,12097,848,4241,4157,2172,679,840,494,432,152,47,233,62,62,30,7,25,0,0,0,0,346,290,143,24,123,56,37,37,0,0,19,10,0,9,74021
25540,1344,150,702,372,100,20,88,64,46,14,0,32,18,18,14,0,4,0,0,0,0,24,10,0,0,10,14,14,6,0,8,0,0,0,0,74022
25541,8102,1715,3387,1958,708,334,478,229,134,21,12,101,95,14,14,0,0,81,53,9,19,249,165,39,3,123,84,33,32,0,1,51,24,0,27,74023
25542,661,142,318,169,24,8,55,37,30,11,3,16,7,7,7,0,0,0,0,0,0,18,16,5,0,11,2,2,0,2,0,0,0,0,0,74026
25543,538,106,198,205,17,12,56,28,28,5,3,20,0,0,0,0,0,0,0,0,0,28,28,2,7,19,0,0,0,0,0,0,0,0,0,74027
25544,1151,205,476,343,78,49,95,49,39,10,0,29,10,10,6,0,4,0,0,0,0,46,37,7,0,30,9,9,5,0,4,0,0,0,0,74028
25545,3305,382,1546,1058,248,71,266,160,147,9,50,88,13,13,13,0,0,0,0,0,0,106,96,30,0,66,10,10,10,0,0,0,0,0,0,74029
25546,2251,368,919,583,260,121,224,111,65,26,0,39,46,23,17,0,6,23,0,23,0,113,77,44,0,33,36,36,36,0,0,0,0,0,0,74030
25547,1431,83,726,344,215,63,171,96,78,29,0,49,18,10,5,2,3,8,8,0,0,75,64,37,0,27,11,11,8,3,0,0,0,0,0,74032
25548,6302,575,1804,2647,853,423,624,316,267,132,43,92,49,49,38,11,0,0,0,0,0,308,265,56,31,178,43,25,25,0,0,18,0,0,18,74033
25549,111,14,62,29,0,6,4,2,2,0,0,2,0,0,0,0,0,0,0,0,0,2,2,0,0,2,0,0,0,0,0,0,0,0,0,74034
25550,3063,522,1304,797,288,152,173,82,69,0,0,69,13,13,13,0,0,0,0,0,0,91,82,11,0,71,9,9,0,0,9,0,0,0,0,74035
25551,4211,559,1721,1255,500,176,403,197,125,64,0,61,72,48,36,0,12,24,24,0,0,206,140,14,0,126,66,54,49,0,5,12,2,0,10,74036
25552,9979,427,1911,3137,2887,1617,665,442,395,135,26,234,47,36,0,18,18,11,0,0,11,223,217,90,10,117,6,6,0,6,0,0,0,0,0,74037
25553,1572,176,793,419,108,76,109,39,16,0,3,13,23,14,12,2,0,9,0,0,9,70,42,6,0,36,28,28,25,0,3,0,0,0,0,74038
25554,2457,524,1068,722,111,32,185,120,84,11,20,53,36,27,6,21,0,9,6,0,3,65,65,0,0,65,0,0,0,0,0,0,0,0,0,74039
25555,1395,210,510,464,150,61,115,62,43,11,5,27,19,6,5,0,1,13,10,0,3,53,36,13,0,23,17,0,0,0,0,17,0,2,15,74041
25556,398,70,136,137,45,10,49,12,7,0,2,5,5,1,0,0,1,4,4,0,0,37,33,0,0,33,4,0,0,0,0,4,0,0,4,74042
25557,4984,698,1941,1669,497,179,337,206,183,59,26,98,23,22,15,0,7,1,0,0,1,131,92,22,0,70,39,34,34,0,0,5,0,0,5,74044
25558,295,34,100,60,63,38,20,3,0,0,0,0,3,3,3,0,0,0,0,0,0,17,17,0,10,7,0,0,0,0,0,0,0,0,0,74045
25559,82,24,39,11,5,3,4,0,0,0,0,0,0,0,0,0,0,0,0,0,0,4,4,2,0,2,0,0,0,0,0,0,0,0,0,74046
25560,4352,558,1656,1436,531,171,256,115,76,1,0,75,39,28,4,22,2,11,0,0,11,141,94,30,4,60,47,30,22,0,8,17,0,0,17,74047
25561,4229,674,1870,968,489,228,301,167,155,29,0,126,12,12,12,0,0,0,0,0,0,134,134,8,20,106,0,0,0,0,0,0,0,0,0,74048
25562,159,42,91,26,0,0,33,30,24,0,15,9,6,0,0,0,0,6,0,0,6,3,0,0,0,0,3,0,0,0,0,3,3,0,0,74050
25563,1465,136,690,467,134,38,117,51,49,33,2,14,2,2,0,0,2,0,0,0,0,66,66,6,40,20,0,0,0,0,0,0,0,0,0,74051
25564,882,203,392,229,47,11,91,29,29,0,0,29,0,0,0,0,0,0,0,0,0,62,44,8,9,27,18,15,8,3,4,3,0,0,3,74052
25565,2820,230,992,980,392,226,270,166,141,20,31,90,25,15,12,3,0,10,10,0,0,104,88,15,0,73,16,11,3,0,8,5,0,5,0,74053
25566,571,140,317,92,22,0,55,27,22,0,1,21,5,5,5,0,0,0,0,0,0,28,22,3,0,19,6,6,0,6,0,0,0,0,0,74054
25567,25149,1846,6411,8898,5833,2161,2231,1083,824,153,100,571,259,201,108,83,10,58,40,10,8,1148,1007,480,45,482,141,95,71,0,24,46,5,18,23,74055
25568,3957,485,1775,1226,382,89,261,119,104,11,2,91,15,15,0,11,4,0,0,0,0,142,108,27,0,81,34,26,0,13,13,8,0,0,8,74056
25569,2846,323,1057,855,423,188,191,111,85,9,3,73,26,17,15,2,0,9,0,9,0,80,79,32,5,42,1,1,1,0,0,0,0,0,0,74058
25570,3181,433,1125,818,556,249,274,182,149,59,13,77,33,24,10,0,14,9,8,0,1,92,88,15,3,70,4,4,4,0,0,0,0,0,0,74059
25571,507,102,261,108,17,19,27,11,11,0,0,11,0,0,0,0,0,0,0,0,0,16,14,6,0,8,2,2,0,0,2,0,0,0,0,74060
25572,1606,258,597,416,188,147,50,23,13,0,0,13,10,0,0,0,0,10,0,10,0,27,27,10,0,17,0,0,0,0,0,0,0,0,0,74061
25573,664,116,259,189,78,22,53,30,30,4,10,16,0,0,0,0,0,0,0,0,0,23,22,8,0,14,1,0,0,0,0,1,1,0,0,74062
25574,20309,2550,7043,7043,2666,1007,1653,879,700,204,42,454,179,117,68,28,21,62,32,6,24,774,600,164,103,333,174,124,50,48,26,50,25,11,14,74063
25575,20730,2975,7911,6410,2532,902,1855,929,806,173,109,524,123,68,36,27,5,55,0,0,55,926,810,223,14,573,116,78,3,58,17,38,0,0,38,74066
25576,29,7,15,7,0,0,12,2,0,0,0,0,2,0,0,0,0,2,0,0,2,10,8,1,0,7,2,2,2,0,0,0,0,0,0,74068
25577,9196,1168,3590,2967,1133,338,903,496,430,81,15,334,66,39,29,10,0,27,21,0,6,407,343,111,7,225,64,64,28,20,16,0,0,0,0,74070
25578,79,11,59,9,0,0,10,7,7,0,0,7,0,0,0,0,0,0,0,0,0,3,3,0,0,3,0,0,0,0,0,0,0,0,0,74071
25579,1364,137,547,527,118,35,106,62,55,24,0,31,7,7,0,0,7,0,0,0,0,44,39,31,5,3,5,5,5,0,0,0,0,0,0,74072
25580,3829,359,1593,1192,536,149,333,145,105,43,3,59,40,27,19,3,5,13,0,0,13,188,177,47,29,101,11,4,0,4,0,7,3,0,4,74073
25581,15250,949,3410,3919,4141,2831,2265,1013,981,176,80,725,32,4,0,0,4,28,7,0,21,1252,1172,387,74,711,80,39,34,5,0,41,35,0,6,74074
25582,11774,734,1939,3587,2845,2669,1998,829,662,171,29,462,167,107,107,0,0,60,45,15,0,1169,953,385,20,548,216,153,39,16,98,63,7,0,56,74075
25583,106,5,0,66,0,35,1770,893,893,118,48,727,0,0,0,0,0,0,0,0,0,877,877,141,16,720,0,0,0,0,0,0,0,0,0,74078
25584,2899,391,1199,902,296,111,256,116,99,25,20,54,17,7,0,0,7,10,0,0,10,140,132,83,0,49,8,8,0,8,0,0,0,0,0,74079
25585,1902,136,708,579,364,115,191,89,89,37,2,50,0,0,0,0,0,0,0,0,0,102,95,46,0,49,7,0,0,0,0,7,0,0,7,74080
25586,1260,210,589,292,150,19,115,75,50,0,0,50,25,16,16,0,0,9,9,0,0,40,40,0,0,40,0,0,0,0,0,0,0,0,0,74081
25587,48,10,18,17,3,0,9,5,5,4,0,1,0,0,0,0,0,0,0,0,0,4,4,0,0,4,0,0,0,0,0,0,0,0,0,74082
25588,725,129,299,233,56,8,61,47,47,4,0,43,0,0,0,0,0,0,0,0,0,14,10,2,0,8,4,4,4,0,0,0,0,0,0,74083
25589,404,75,190,107,30,2,1,1,1,0,0,1,0,0,0,0,0,0,0,0,0,0,0,0,0,0,0,0,0,0,0,0,0,0,0,74084
25590,1625,265,857,301,172,30,100,62,53,6,0,47,9,9,0,0,9,0,0,0,0,38,35,14,0,21,3,3,3,0,0,0,0,0,0,74085
25591,1386,522,420,342,61,41,192,186,92,0,0,92,94,23,0,0,23,71,0,0,71,6,0,0,0,0,6,0,0,0,0,6,0,0,6,74103
25592,7685,1064,1376,2298,1797,1150,903,451,403,87,20,296,48,27,26,0,1,21,9,0,12,452,425,138,1,286,27,27,10,11,6,0,0,0,0,74104
25593,19392,1016,3329,6180,5551,3316,870,413,282,168,0,114,131,125,112,0,13,6,0,0,6,457,346,114,0,232,111,52,26,7,19,59,15,7,37,74105
25594,10061,1893,3492,3182,1059,435,984,375,317,28,46,243,58,41,5,12,24,17,0,10,7,609,402,68,23,311,207,122,64,50,8,85,0,13,72,74106
25595,12682,1886,4711,4400,1157,528,1029,482,314,82,0,232,168,62,25,19,18,106,13,50,43,547,345,130,0,215,202,100,50,11,39,102,36,18,48,74107
25596,4292,784,1566,1448,388,106,503,278,181,43,23,115,97,84,84,0,0,13,0,0,13,225,177,42,30,105,48,0,0,0,0,48,14,0,34,74108
25597,8040,2452,2724,2256,461,147,981,528,358,65,47,246,170,65,13,22,30,105,20,4,81,453,272,92,3,177,181,84,17,13,54,97,0,29,68,74110
25598,14318,2444,4225,4596,2149,904,1064,418,321,71,21,229,97,26,22,4,0,71,67,0,4,646,497,212,31,254,149,83,28,0,55,66,20,0,46,74112
25599,11929,446,1758,3378,3747,2600,609,353,332,94,5,233,21,17,0,17,0,4,0,0,4,256,243,90,14,139,13,1,0,0,1,12,0,0,12,74114
25600,13985,4066,5304,3833,624,158,1399,791,532,113,105,314,259,66,52,14,0,193,107,23,63,608,294,68,38,188,314,125,22,35,68,189,95,14,80,74115
25601,2418,631,879,668,191,49,199,109,93,34,19,40,16,0,0,0,0,16,10,0,6,90,67,5,26,36,23,7,7,0,0,16,16,0,0,74116
25602,119,43,57,19,0,0,0,0,0,0,0,0,0,0,0,0,0,0,0,0,0,0,0,0,0,0,0,0,0,0,0,0,0,0,0,74117
25603,3121,206,650,891,930,444,31,10,4,0,0,4,6,6,6,0,0,0,0,0,0,21,17,9,0,8,4,4,4,0,0,0,0,0,0,74119
25604,3984,641,663,1135,953,592,228,72,65,7,17,41,7,0,0,0,0,7,7,0,0,156,123,27,8,88,33,11,4,7,0,22,9,0,13,74120
25605,6054,1134,2586,1858,358,118,624,301,242,31,44,167,59,24,13,3,8,35,14,15,6,323,205,50,37,118,118,89,24,0,65,29,10,4,15,74126
25606,11153,2122,4165,3406,980,480,803,488,308,87,41,180,180,125,81,32,12,55,15,20,20,315,191,49,10,132,124,98,70,5,23,26,0,0,26,74127
25607,7902,1881,2731,2495,635,160,731,377,256,55,6,195,121,34,5,0,29,87,56,21,10,354,308,149,12,147,46,7,0,0,7,39,26,7,6,74128
25608,12246,2287,4025,3802,1570,562,857,484,331,108,32,191,153,41,25,0,16,112,36,18,58,373,278,85,47,146,95,26,0,0,26,69,7,8,54,74129
25609,1444,227,541,587,72,17,124,61,14,0,0,14,47,5,5,0,0,42,0,0,42,63,28,0,0,28,35,0,0,0,0,35,10,0,25,74130
25610,2436,457,714,710,383,172,113,86,82,26,0,56,4,4,4,0,0,0,0,0,0,27,14,7,0,7,13,0,0,0,0,13,7,0,6,74131
25611,5434,473,1215,1609,1516,621,491,168,156,102,0,54,12,8,7,0,1,4,0,0,4,323,239,83,43,113,84,73,57,12,4,11,0,0,11,74132
25612,29481,1476,5371,9676,8347,4611,2084,987,865,338,51,476,122,93,49,6,38,29,10,0,19,1097,940,409,86,445,157,106,83,5,18,51,29,22,0,74133
25613,9534,1439,2465,3489,1595,546,925,466,308,88,0,220,158,133,110,0,23,25,0,8,17,459,346,82,8,256,113,106,30,11,65,7,0,0,7,74134
25614,15074,1264,3180,4831,4101,1698,957,393,317,130,14,173,76,10,9,0,1,66,56,0,10,564,452,305,19,128,112,66,49,0,17,46,28,8,10,74135
25615,19254,1526,3940,6253,5119,2416,2301,1098,951,270,38,643,147,116,66,40,10,31,0,6,25,1203,1055,393,46,616,148,114,99,13,2,34,10,0,24,74136
25616,17817,715,2071,4618,6271,4142,1630,696,670,129,46,495,26,24,0,6,18,2,0,0,2,934,883,285,39,559,51,50,37,6,7,1,0,0,1,74137
25617,11892,1224,3162,4415,2261,830,1085,456,369,105,0,264,87,65,61,4,0,22,12,0,10,629,445,199,20,226,184,102,62,0,40,82,9,25,48,74145
25618,8148,1797,3027,2467,628,229,691,368,296,74,20,202,72,23,10,0,13,49,25,15,9,323,235,70,0,165,88,48,43,0,5,40,10,0,30,74146
25619,8561,1634,3408,2399,750,370,658,348,253,101,0,152,95,74,28,0,46,21,0,0,21,310,258,50,10,198,52,40,17,23,0,12,0,0,12,74301
25620,2010,256,661,699,263,131,108,72,56,32,0,24,16,16,16,0,0,0,0,0,0,36,17,3,0,14,19,19,11,0,8,0,0,0,0,74330
25621,5074,570,1884,1642,781,197,225,127,80,17,15,48,47,10,0,0,10,37,14,0,23,98,76,26,0,50,22,8,0,2,6,14,0,10,4,74331
25622,1163,165,542,358,54,44,45,39,37,6,21,10,2,2,2,0,0,0,0,0,0,6,6,2,0,4,0,0,0,0,0,0,0,0,0,74332
25623,759,96,298,274,70,21,38,14,14,10,0,4,0,0,0,0,0,0,0,0,0,24,20,9,6,5,4,1,1,0,0,3,3,0,0,74333
25624,3325,571,1243,983,378,150,300,142,120,32,16,72,22,17,0,0,17,5,5,0,0,158,138,51,0,87,20,20,20,0,0,0,0,0,0,74337
25625,3417,698,1600,835,244,40,276,153,119,27,12,80,34,30,30,0,0,4,0,0,4,123,117,53,10,54,6,2,2,0,0,4,0,0,4,74338
25626,1621,495,612,405,87,22,143,58,54,9,8,37,4,4,1,3,0,0,0,0,0,85,68,9,8,51,17,0,0,0,0,17,0,0,17,74339
25627,142,21,37,69,15,0,5,2,2,0,0,2,0,0,0,0,0,0,0,0,0,3,3,3,0,0,0,0,0,0,0,0,0,0,0,74340
25628,1942,354,634,561,164,229,64,39,39,7,21,11,0,0,0,0,0,0,0,0,0,25,0,0,0,0,25,0,0,0,0,25,0,9,16,74342
25629,2069,244,784,721,161,159,132,48,42,14,0,28,6,0,0,0,0,6,6,0,0,84,42,7,0,35,42,32,0,14,18,10,0,0,10,74343
25630,10805,1363,3733,3657,1313,739,651,302,234,97,3,134,68,68,68,0,0,0,0,0,0,349,292,86,27,179,57,51,35,0,16,6,0,6,0,74344
25631,5335,1144,2126,1357,478,230,489,210,164,43,14,107,46,28,10,0,18,18,0,0,18,279,202,53,0,149,77,49,27,0,22,28,7,0,21,74346
25632,1825,233,899,485,159,49,339,176,136,6,0,130,40,40,18,0,22,0,0,0,0,163,100,5,11,84,63,56,12,14,30,7,2,2,3,74347
25633,230,27,90,104,7,2,18,12,12,3,0,9,0,0,0,0,0,0,0,0,0,6,6,0,0,6,0,0,0,0,0,0,0,0,0,74349
25634,492,121,205,132,34,0,85,40,21,5,0,16,19,16,5,7,4,3,3,0,0,45,35,13,8,14,10,10,10,0,0,0,0,0,0,74350
25635,4486,599,2027,1315,433,112,368,173,160,36,0,124,13,5,5,0,0,8,0,0,8,195,185,47,0,138,10,10,10,0,0,0,0,0,0,74352
25636,11915,1690,3949,4363,1240,673,1351,736,638,130,87,421,98,60,32,15,13,38,20,2,16,615,499,184,30,285,116,87,48,14,25,29,9,4,16,74354
25637,141,40,84,12,5,0,9,6,4,0,0,4,2,2,0,2,0,0,0,0,0,3,0,0,0,0,3,3,2,0,1,0,0,0,0,74358
25638,410,57,216,72,28,37,54,32,32,0,0,32,0,0,0,0,0,0,0,0,0,22,19,2,0,17,3,0,0,0,0,3,0,0,3,74359
25639,63,13,7,16,12,15,0,0,0,0,0,0,0,0,0,0,0,0,0,0,0,0,0,0,0,0,0,0,0,0,0,0,0,0,0,74360
25640,11047,1502,3942,3540,1471,592,940,501,438,114,59,265,63,25,18,3,4,38,10,28,0,439,343,75,39,229,96,36,1,34,1,60,0,60,0,74361
25641,2013,359,785,678,142,49,120,46,28,4,0,24,18,15,5,3,7,3,0,0,3,74,58,24,5,29,16,10,7,0,3,6,0,0,6,74363
25642,1278,225,589,306,92,66,91,31,28,0,0,28,3,3,2,1,0,0,0,0,0,60,56,12,0,44,4,0,0,0,0,4,0,0,4,74364
25643,2909,553,1249,712,289,106,319,116,94,40,0,54,22,21,4,2,15,1,0,0,1,203,170,26,7,137,33,11,0,5,6,22,0,0,22,74365
25644,1015,253,438,240,46,38,113,41,35,4,0,31,6,6,3,0,3,0,0,0,0,72,54,2,0,52,18,9,0,0,9,9,0,0,9,74366
25645,338,88,118,106,26,0,15,14,14,0,14,0,0,0,0,0,0,0,0,0,0,1,1,0,0,1,0,0,0,0,0,0,0,0,0,74367
25646,31,9,15,5,2,0,2,2,0,0,0,0,2,2,0,0,2,0,0,0,0,0,0,0,0,0,0,0,0,0,0,0,0,0,0,74368
25647,1375,157,545,499,149,25,125,66,66,17,0,49,0,0,0,0,0,0,0,0,0,59,59,17,12,30,0,0,0,0,0,0,0,0,0,74369
25648,2478,447,961,783,214,73,243,115,89,20,1,68,26,15,10,3,2,11,4,7,0,128,104,16,5,83,24,19,15,0,4,5,0,1,4,74370
25649,11531,1941,3858,3680,1476,576,780,410,333,90,48,195,77,58,24,3,31,19,0,0,19,370,236,63,30,143,134,77,62,15,0,57,0,50,7,74401
25650,20304,2717,6385,7137,2782,1283,1567,704,642,116,46,480,62,31,0,28,3,31,0,0,31,863,636,192,26,418,227,124,93,0,31,103,61,0,42,74403
25651,3073,480,1203,965,312,113,157,79,75,11,15,49,4,3,3,0,0,1,0,0,1,78,61,32,3,26,17,17,17,0,0,0,0,0,0,74421
25652,461,66,216,89,46,44,28,25,25,10,0,15,0,0,0,0,0,0,0,0,0,3,3,0,0,3,0,0,0,0,0,0,0,0,0,74422
25653,613,72,231,212,40,58,39,16,3,0,0,3,13,13,5,0,8,0,0,0,0,23,23,2,0,21,0,0,0,0,0,0,0,0,0,74423
25654,782,106,352,244,9,71,17,8,5,0,0,5,3,3,2,1,0,0,0,0,0,9,8,2,0,6,1,0,0,0,0,1,0,0,1,74425
25655,6658,1262,2477,1967,602,350,495,223,167,0,0,167,56,26,21,5,0,30,7,23,0,272,239,50,53,136,33,0,0,0,0,33,7,15,11,74426
25656,711,135,203,258,65,50,61,27,27,18,0,9,0,0,0,0,0,0,0,0,0,34,34,17,0,17,0,0,0,0,0,0,0,0,0,74427
25657,843,110,387,244,75,27,61,49,47,31,3,13,2,2,0,2,0,0,0,0,0,12,10,4,0,6,2,2,2,0,0,0,0,0,0,74428
25658,9436,1361,3405,2642,1504,524,606,268,185,46,50,89,83,41,28,0,13,42,42,0,0,338,292,104,40,148,46,46,26,0,20,0,0,0,0,74429
25659,385,86,141,120,19,19,36,21,21,2,0,19,0,0,0,0,0,0,0,0,0,15,11,1,0,10,4,2,0,0,2,2,0,0,2,74430
25660,591,132,277,148,28,6,70,21,9,2,1,6,12,10,9,1,0,2,0,2,0,49,42,13,0,29,7,0,0,0,0,7,0,0,7,74431
25661,7572,1430,2792,2287,689,374,400,171,131,78,11,42,40,25,4,4,17,15,13,2,0,229,190,28,9,153,39,27,20,0,7,12,0,9,3,74432
25662,6334,521,2014,2590,853,356,638,293,262,125,38,99,31,31,27,4,0,0,0,0,0,345,280,45,17,218,65,65,65,0,0,0,0,0,0,74434
25663,2095,379,753,613,254,96,139,86,55,8,4,43,31,22,0,0,22,9,3,0,6,53,39,5,0,34,14,9,9,0,0,5,0,5,0,74435
25664,3165,569,1138,892,404,162,171,87,46,0,0,46,41,22,22,0,0,19,0,8,11,84,51,5,0,46,33,17,4,4,9,16,0,12,4,74436
25665,6666,1100,2542,2194,632,198,594,312,282,92,21,169,30,23,2,12,9,7,0,0,7,282,191,25,14,152,91,88,42,7,39,3,0,0,3,74437
25666,154,26,88,30,10,0,24,11,3,3,0,0,8,5,5,0,0,3,0,3,0,13,13,8,0,5,0,0,0,0,0,0,0,0,0,74438
25667,3465,632,1383,954,376,120,406,190,175,19,36,120,15,9,9,0,0,6,6,0,0,216,211,55,0,156,5,0,0,0,0,5,3,0,2,74441
25668,659,114,263,209,43,30,20,4,0,0,0,0,4,4,3,1,0,0,0,0,0,16,16,2,0,14,0,0,0,0,0,0,0,0,0,74442
25669,1955,155,703,862,172,63,195,115,105,41,4,60,10,0,0,0,0,10,3,0,7,80,65,0,14,51,15,7,5,0,2,8,4,4,0,74445
25670,364,80,125,107,47,5,51,29,27,21,0,6,2,2,2,0,0,0,0,0,0,22,15,4,7,4,7,7,7,0,0,0,0,0,0,74446
25671,11425,1644,3986,4045,1311,439,1054,716,650,179,45,426,66,24,24,0,0,42,0,20,22,338,298,82,74,142,40,17,0,0,17,23,0,14,9,74447
25672,1155,158,519,356,102,20,106,72,47,8,14,25,25,19,19,0,0,6,0,0,6,34,34,10,7,17,0,0,0,0,0,0,0,0,0,74450
25673,3181,262,865,1197,482,375,173,88,65,0,29,36,23,1,0,0,1,22,22,0,0,85,85,6,0,79,0,0,0,0,0,0,0,0,0,74451
25674,263,18,93,118,9,25,20,4,4,0,0,4,0,0,0,0,0,0,0,0,0,16,12,0,0,12,4,0,0,0,0,4,4,0,0,74452
25675,2061,280,837,665,233,46,205,145,83,4,2,77,62,62,45,17,0,0,0,0,0,60,39,0,0,39,21,21,2,0,19,0,0,0,0,74454
25676,1788,526,585,525,134,18,101,48,44,10,3,31,4,4,0,0,4,0,0,0,0,53,46,14,4,28,7,0,0,0,0,7,0,0,7,74455
25677,145,32,56,19,14,24,9,4,4,0,4,0,0,0,0,0,0,0,0,0,0,5,0,0,0,0,5,5,0,0,5,0,0,0,0,74456
25678,376,70,159,107,22,18,19,12,9,0,0,9,3,3,0,0,3,0,0,0,0,7,7,0,0,7,0,0,0,0,0,0,0,0,0,74457
25679,60,8,33,9,4,6,5,3,3,2,1,0,0,0,0,0,0,0,0,0,0,2,2,1,1,0,0,0,0,0,0,0,0,0,0,74458
25680,66,13,22,24,7,0,0,0,0,0,0,0,0,0,0,0,0,0,0,0,0,0,0,0,0,0,0,0,0,0,0,0,0,0,0,74459
25681,184,40,69,61,6,8,6,6,6,0,6,0,0,0,0,0,0,0,0,0,0,0,0,0,0,0,0,0,0,0,0,0,0,0,0,74460
25682,5279,1191,1993,1570,405,120,296,181,131,23,0,108,50,16,16,0,0,34,17,3,14,115,84,32,0,52,31,0,0,0,0,31,12,0,19,74462
25683,1827,524,670,556,75,2,19,13,10,10,0,0,3,3,1,0,2,0,0,0,0,6,5,0,0,5,1,1,0,1,0,0,0,0,0,74463
25684,17586,2709,4577,5356,2940,2004,2347,1120,970,88,119,763,150,94,29,8,57,56,6,4,46,1227,1001,392,4,605,226,172,65,33,74,54,6,13,35,74464
25685,10793,1543,4276,3254,1184,536,969,393,359,70,51,238,34,27,27,0,0,7,0,0,7,576,448,146,13,289,128,51,10,0,41,77,22,40,15,74467
25686,162,37,74,46,3,2,32,15,6,0,0,6,9,2,0,2,0,7,2,0,5,17,17,6,0,11,0,0,0,0,0,0,0,0,0,74468
25687,1548,173,498,595,198,84,254,145,115,51,8,56,30,30,25,0,5,0,0,0,0,109,96,7,8,81,13,13,10,3,0,0,0,0,0,74469
25688,1125,219,421,298,143,44,75,30,20,5,0,15,10,6,6,0,0,4,0,0,4,45,26,6,2,18,19,9,6,0,3,10,0,0,10,74470
25689,1083,243,341,312,137,50,103,58,55,20,0,35,3,3,3,0,0,0,0,0,0,45,31,17,0,14,14,14,2,0,12,0,0,0,0,74471
25690,387,107,92,86,92,10,53,42,27,0,3,24,15,15,0,0,15,0,0,0,0,11,8,3,0,5,3,3,0,0,3,0,0,0,0,74472
25691,0,0,0,0,0,0,0,0,0,0,0,0,0,0,0,0,0,0,0,0,0,0,0,0,0,0,0,0,0,0,0,0,0,0,0,74477
25692,20187,3284,7247,6285,2248,1123,1395,669,581,223,51,307,88,21,11,5,5,67,33,0,34,726,644,257,33,354,82,66,30,2,34,16,0,16,0,74501
25693,168,29,78,52,7,2,7,6,0,0,0,0,6,0,0,0,0,6,0,6,0,1,1,0,0,1,0,0,0,0,0,0,0,0,0,74521
25694,165,23,78,52,12,0,11,6,4,0,0,4,2,0,0,0,0,2,0,0,2,5,3,0,0,3,2,2,2,0,0,0,0,0,0,74522
25695,3917,736,1499,1172,277,233,243,106,48,18,7,23,58,26,22,0,4,32,0,0,32,137,120,54,3,63,17,12,12,0,0,5,0,0,5,74523
25696,6524,1176,2723,1755,582,288,606,348,297,82,41,174,51,51,47,4,0,0,0,0,0,258,147,51,21,75,111,103,0,36,67,8,0,0,8,74525
25697,143,32,59,32,15,5,9,6,2,0,0,2,4,4,0,0,4,0,0,0,0,3,3,0,0,3,0,0,0,0,0,0,0,0,0,74528
25698,170,45,58,26,20,21,21,19,18,4,2,12,1,1,1,0,0,0,0,0,0,2,2,2,0,0,0,0,0,0,0,0,0,0,0,74530
25699,641,141,205,199,73,23,42,35,34,0,0,34,1,1,0,0,1,0,0,0,0,7,6,0,0,6,1,1,1,0,0,0,0,0,0,74531
25700,582,81,265,170,50,16,41,29,16,11,0,5,13,13,13,0,0,0,0,0,0,12,3,0,0,3,9,9,9,0,0,0,0,0,0,74533
25701,209,13,120,65,11,0,18,14,11,6,0,5,3,3,0,0,3,0,0,0,0,4,4,0,0,4,0,0,0,0,0,0,0,0,0,74534
25702,118,52,44,22,0,0,16,4,4,0,0,4,0,0,0,0,0,0,0,0,0,12,0,0,0,0,12,0,0,0,0,12,0,0,12,74535
25703,1294,217,556,359,136,26,77,43,39,14,0,25,4,4,0,4,0,0,0,0,0,34,26,8,3,15,8,6,2,0,4,2,0,0,2,74536
25704,2703,466,1247,620,246,124,187,62,61,0,20,41,1,0,0,0,0,1,1,0,0,125,104,25,6,73,21,12,3,0,9,9,0,0,9,74538
25705,133,31,40,42,12,8,9,8,0,0,0,0,8,8,8,0,0,0,0,0,0,1,1,0,0,1,0,0,0,0,0,0,0,0,0,74540
25706,355,94,97,117,32,15,0,0,0,0,0,0,0,0,0,0,0,0,0,0,0,0,0,0,0,0,0,0,0,0,0,0,0,0,0,74543
25707,490,79,174,188,44,5,49,42,32,12,0,20,10,10,0,1,9,0,0,0,0,7,7,0,0,7,0,0,0,0,0,0,0,0,0,74546
25708,2295,308,882,712,249,144,122,29,29,6,3,20,0,0,0,0,0,0,0,0,0,93,59,14,0,45,34,12,12,0,0,22,0,22,0,74547
25709,48,7,3,33,5,0,16,0,0,0,0,0,0,0,0,0,0,0,0,0,0,16,14,14,0,0,2,2,0,2,0,0,0,0,0,74549
25710,715,117,242,244,87,25,45,14,11,0,6,5,3,3,3,0,0,0,0,0,0,31,30,9,0,21,1,1,0,1,0,0,0,0,0,74552
25711,750,95,305,260,41,49,47,34,31,1,0,30,3,3,0,0,3,0,0,0,0,13,2,0,0,2,11,11,3,6,2,0,0,0,0,74553
25712,1550,236,561,582,94,77,147,35,17,10,0,7,18,7,7,0,0,11,11,0,0,112,67,18,0,49,45,0,0,0,0,45,22,18,5,74554
25713,494,74,228,114,32,46,52,20,17,0,0,17,3,3,3,0,0,0,0,0,0,32,26,12,0,14,6,6,0,6,0,0,0,0,0,74555
25714,291,109,106,59,4,13,37,27,21,5,5,11,6,6,2,4,0,0,0,0,0,10,10,0,0,10,0,0,0,0,0,0,0,0,0,74556
25715,374,86,134,135,16,3,48,32,32,0,0,32,0,0,0,0,0,0,0,0,0,16,8,5,1,2,8,5,0,0,5,3,0,0,3,74557
25716,390,97,154,107,22,10,30,18,8,3,0,5,10,10,10,0,0,0,0,0,0,12,12,0,0,12,0,0,0,0,0,0,0,0,0,74558
25717,393,54,184,117,31,7,15,9,9,0,0,9,0,0,0,0,0,0,0,0,0,6,4,0,0,4,2,2,0,0,2,0,0,0,0,74560
25718,1337,277,519,383,113,45,171,97,92,50,4,38,5,5,5,0,0,0,0,0,0,74,61,9,0,52,13,9,9,0,0,4,0,0,4,74561
25719,525,77,225,163,38,22,57,39,37,21,10,6,2,0,0,0,0,2,0,2,0,18,18,5,0,13,0,0,0,0,0,0,0,0,0,74562
25720,1547,224,610,481,116,116,139,44,44,12,11,21,0,0,0,0,0,0,0,0,0,95,89,5,0,84,6,6,0,0,6,0,0,0,0,74563
25721,418,49,160,152,39,18,34,20,15,3,3,9,5,1,1,0,0,4,0,0,4,14,14,7,0,7,0,0,0,0,0,0,0,0,0,74565
25722,115,39,56,6,14,0,4,0,0,0,0,0,0,0,0,0,0,0,0,0,0,4,4,4,0,0,0,0,0,0,0,0,0,0,0,74567
25723,800,150,321,171,116,42,32,22,9,0,0,9,13,13,2,0,11,0,0,0,0,10,9,0,0,9,1,1,1,0,0,0,0,0,0,74569
25724,755,98,310,242,72,33,67,39,39,11,0,28,0,0,0,0,0,0,0,0,0,28,28,3,0,25,0,0,0,0,0,0,0,0,0,74570
25725,2649,498,981,778,217,175,177,110,96,22,0,74,14,6,4,0,2,8,2,0,6,67,33,0,7,26,34,20,9,7,4,14,0,12,2,74571
25726,483,110,179,91,57,46,55,33,29,6,0,23,4,4,0,0,4,0,0,0,0,22,18,3,0,15,4,4,0,0,4,0,0,0,0,74572
25727,879,165,357,276,71,10,49,18,14,0,4,10,4,4,0,0,4,0,0,0,0,31,27,4,5,18,4,4,0,0,4,0,0,0,0,74574
25728,116,0,44,46,8,18,7,7,7,0,0,7,0,0,0,0,0,0,0,0,0,0,0,0,0,0,0,0,0,0,0,0,0,0,0,74576
25729,164,3,90,46,25,0,10,6,6,0,0,6,0,0,0,0,0,0,0,0,0,4,4,0,0,4,0,0,0,0,0,0,0,0,0,74577
25730,4111,677,1234,1653,344,203,503,314,267,82,32,153,47,12,10,0,2,35,0,0,35,189,172,32,19,121,17,10,10,0,0,7,0,0,7,74578
25731,12584,2046,4622,4056,1334,526,1060,623,506,129,98,279,117,70,42,22,6,47,28,10,9,437,352,132,25,195,85,46,21,7,18,39,7,4,28,74601
25732,8826,644,2522,2997,1891,772,683,367,308,57,42,209,59,46,11,3,32,13,4,0,9,316,297,110,6,181,19,19,19,0,0,0,0,0,0,74604
25733,481,79,177,170,45,10,27,16,9,0,3,6,7,7,7,0,0,0,0,0,0,11,3,0,0,3,8,5,5,0,0,3,0,0,3,74630
25734,5248,964,1956,1593,449,286,299,79,59,3,0,56,20,3,0,0,3,17,0,17,0,220,220,97,30,93,0,0,0,0,0,0,0,0,0,74631
25735,416,22,175,121,80,18,13,4,4,0,0,4,0,0,0,0,0,0,0,0,0,9,8,1,0,7,1,1,0,0,1,0,0,0,0,74632
25736,419,70,175,125,35,14,34,22,22,12,0,10,0,0,0,0,0,0,0,0,0,12,11,9,0,2,1,1,0,0,1,0,0,0,0,74633
25737,163,35,58,38,21,11,26,19,16,6,0,10,3,0,0,0,0,3,0,3,0,7,7,2,0,5,0,0,0,0,0,0,0,0,0,74636
25738,1431,237,633,369,131,61,96,40,37,10,3,24,3,3,0,3,0,0,0,0,0,56,52,12,2,38,4,4,4,0,0,0,0,0,0,74637
25739,232,39,103,57,26,7,4,0,0,0,0,0,0,0,0,0,0,0,0,0,0,4,4,0,0,4,0,0,0,0,0,0,0,0,0,74640
25740,443,65,172,167,23,16,29,23,20,12,0,8,3,0,0,0,0,3,0,3,0,6,6,5,0,1,0,0,0,0,0,0,0,0,0,74641
25741,296,36,102,115,38,5,25,17,17,4,0,13,0,0,0,0,0,0,0,0,0,8,8,0,0,8,0,0,0,0,0,0,0,0,0,74643
25742,320,55,152,83,28,2,34,7,3,0,0,3,4,0,0,0,0,4,4,0,0,27,20,0,0,20,7,7,0,2,5,0,0,0,0,74644
25743,228,2,98,59,58,11,0,0,0,0,0,0,0,0,0,0,0,0,0,0,0,0,0,0,0,0,0,0,0,0,0,0,0,0,0,74646
25744,2435,259,925,889,246,116,224,125,116,29,16,71,9,9,6,0,3,0,0,0,0,99,89,20,6,63,10,8,8,0,0,2,2,0,0,74647
25745,440,67,222,92,32,27,23,9,9,1,0,8,0,0,0,0,0,0,0,0,0,14,10,0,0,10,4,4,2,0,2,0,0,0,0,74650
25746,441,64,138,169,53,17,19,9,9,0,0,9,0,0,0,0,0,0,0,0,0,10,6,2,0,4,4,4,4,0,0,0,0,0,0,74651
25747,529,75,279,136,34,5,23,13,11,0,0,11,2,2,2,0,0,0,0,0,0,10,10,1,0,9,0,0,0,0,0,0,0,0,0,74652
25748,2279,364,703,739,318,155,384,213,179,79,4,96,34,13,12,1,0,21,3,12,6,171,142,40,7,95,29,19,13,2,4,10,0,6,4,74653
25749,13667,2094,4390,3800,1904,1479,1285,664,504,94,58,352,160,42,32,9,1,118,35,35,48,621,549,187,90,272,72,30,8,15,7,42,0,0,42,74701
25750,418,93,157,110,39,19,32,25,20,4,0,16,5,0,0,0,0,5,5,0,0,7,7,1,0,6,0,0,0,0,0,0,0,0,0,74720
25751,135,12,81,24,18,0,20,6,6,6,0,0,0,0,0,0,0,0,0,0,0,14,14,8,0,6,0,0,0,0,0,0,0,0,0,74722
25752,1134,251,426,278,128,51,84,60,58,0,5,53,2,0,0,0,0,2,2,0,0,24,16,0,0,16,8,8,8,0,0,0,0,0,0,74723
25753,290,46,123,70,33,18,24,19,17,3,0,14,2,0,0,0,0,2,0,0,2,5,0,0,0,0,5,5,0,0,5,0,0,0,0,74724
25754,1580,292,692,370,178,48,110,44,40,10,0,30,4,0,0,0,0,4,4,0,0,66,55,24,2,29,11,0,0,0,0,11,0,0,11,74726
25755,1329,281,527,349,102,70,121,91,81,25,0,56,10,10,0,5,5,0,0,0,0,30,26,12,0,14,4,4,4,0,0,0,0,0,0,74727
25756,7619,1455,3130,2054,623,357,604,336,280,76,6,198,56,29,8,8,13,27,27,0,0,268,205,72,23,110,63,20,6,0,14,43,23,0,20,74728
25757,2162,350,795,586,298,133,169,89,57,13,15,29,32,32,20,12,0,0,0,0,0,80,54,22,0,32,26,26,26,0,0,0,0,0,0,74729
25758,2983,489,1179,849,276,190,150,74,48,1,4,43,26,26,13,8,5,0,0,0,0,76,51,33,7,11,25,25,0,17,8,0,0,0,0,74730
25759,1475,450,581,332,66,46,25,5,5,0,5,0,0,0,0,0,0,0,0,0,0,20,20,0,0,20,0,0,0,0,0,0,0,0,0,74731
25760,2049,246,645,749,220,189,121,49,42,0,8,34,7,7,7,0,0,0,0,0,0,72,58,4,0,54,14,14,14,0,0,0,0,0,0,74733
25761,770,148,403,153,49,17,97,40,31,7,7,17,9,9,0,9,0,0,0,0,0,57,30,11,0,19,27,14,9,5,0,13,0,13,0,74734
25762,1212,214,552,277,99,70,68,37,37,4,0,33,0,0,0,0,0,0,0,0,0,31,31,13,0,18,0,0,0,0,0,0,0,0,0,74735
25763,705,161,272,125,79,68,85,22,4,4,0,0,18,18,18,0,0,0,0,0,0,63,47,22,0,25,16,14,0,0,14,2,0,0,2,74736
25764,449,136,159,101,44,9,45,23,18,0,0,18,5,5,5,0,0,0,0,0,0,22,19,15,0,4,3,0,0,0,0,3,0,3,0,74738
25765,1480,328,698,292,97,65,225,159,93,23,0,70,66,46,36,0,10,20,0,15,5,66,54,9,0,45,12,2,2,0,0,10,10,0,0,74740
25766,673,88,329,151,64,41,80,32,31,0,0,31,1,1,0,0,1,0,0,0,0,48,27,0,0,27,21,21,0,0,21,0,0,0,0,74741
25767,5513,1035,2146,1519,632,181,361,182,126,26,0,100,56,15,4,1,10,41,0,29,12,179,136,96,0,40,43,43,29,14,0,0,0,0,0,74743
25768,6063,1094,2105,1720,794,350,454,252,191,65,14,112,61,61,47,7,7,0,0,0,0,202,184,35,68,81,18,4,0,0,4,14,0,3,11,74745
25769,113,18,50,33,8,4,5,2,2,0,0,2,0,0,0,0,0,0,0,0,0,3,3,3,0,0,0,0,0,0,0,0,0,0,0,74747
25770,410,86,188,103,20,13,24,11,6,0,0,6,5,1,0,1,0,4,0,4,0,13,12,0,5,7,1,1,0,0,1,0,0,0,0,74748
25771,306,99,128,54,12,13,5,2,2,0,2,0,0,0,0,0,0,0,0,0,0,3,3,0,0,3,0,0,0,0,0,0,0,0,0,74750
25772,19,19,0,0,0,0,0,0,0,0,0,0,0,0,0,0,0,0,0,0,0,0,0,0,0,0,0,0,0,0,0,0,0,0,0,74753
25773,167,51,56,54,6,0,20,15,11,0,11,0,4,0,0,0,0,4,0,0,4,5,0,0,0,0,5,0,0,0,0,5,0,0,5,74754
25774,76,9,31,36,0,0,0,0,0,0,0,0,0,0,0,0,0,0,0,0,0,0,0,0,0,0,0,0,0,0,0,0,0,0,0,74755
25775,626,98,276,154,67,31,34,17,17,0,2,15,0,0,0,0,0,0,0,0,0,17,16,2,0,14,1,0,0,0,0,1,0,0,1,74756
25776,985,178,464,232,60,51,50,26,21,6,0,15,5,5,0,0,5,0,0,0,0,24,24,19,0,5,0,0,0,0,0,0,0,0,0,74759
25777,153,32,65,45,11,0,22,10,10,0,0,10,0,0,0,0,0,0,0,0,0,12,12,5,0,7,0,0,0,0,0,0,0,0,0,74760
25778,69,21,18,24,1,5,1,0,0,0,0,0,0,0,0,0,0,0,0,0,0,1,1,0,0,1,0,0,0,0,0,0,0,0,0,74761
25779,2600,447,1107,787,206,53,251,114,70,0,13,57,44,12,12,0,0,32,0,19,13,137,121,51,0,70,16,3,0,0,3,13,0,0,13,74764
25780,935,193,405,242,57,38,82,54,54,6,13,35,0,0,0,0,0,0,0,0,0,28,18,0,0,18,10,3,0,3,0,7,0,0,7,74766
25781,14192,2251,5079,4699,1591,572,1217,575,402,95,25,282,173,55,35,10,10,118,23,34,61,642,437,186,24,227,205,101,63,16,22,104,56,12,36,74801
25782,12417,1226,3863,3972,2166,1190,1405,755,627,191,76,360,128,99,53,31,15,29,0,8,21,650,583,249,27,307,67,24,20,1,3,43,6,3,34,74804
25783,19676,2574,5857,5446,3359,2440,1933,904,667,213,57,397,237,137,95,16,26,100,10,4,86,1029,779,309,68,402,250,139,43,28,68,111,45,0,66,74820
25784,889,142,482,154,93,18,123,72,52,21,0,31,20,20,10,6,4,0,0,0,0,51,26,9,0,17,25,17,8,6,3,8,0,0,8,74824
25785,1507,263,621,400,137,86,97,43,25,0,0,25,18,18,0,7,11,0,0,0,0,54,32,3,2,27,22,22,20,0,2,0,0,0,0,74825
25786,814,161,382,180,57,34,42,27,19,1,0,18,8,5,4,0,1,3,3,0,0,15,7,0,0,7,8,6,6,0,0,2,0,0,2,74826
25787,343,65,127,82,49,20,9,6,6,6,0,0,0,0,0,0,0,0,0,0,0,3,3,0,0,3,0,0,0,0,0,0,0,0,0,74827
25788,1162,331,453,302,50,26,34,21,14,0,0,14,7,4,4,0,0,3,3,0,0,13,5,0,0,5,8,8,5,0,3,0,0,0,0,74829
25789,195,36,67,69,21,2,43,9,9,0,0,9,0,0,0,0,0,0,0,0,0,34,34,3,0,31,0,0,0,0,0,0,0,0,0,74830
25790,620,126,254,170,56,14,53,28,25,12,9,4,3,0,0,0,0,3,0,0,3,25,23,2,0,21,2,0,0,0,0,2,0,0,2,74831
25791,479,81,272,94,24,8,54,30,26,6,0,20,4,4,4,0,0,0,0,0,0,24,24,0,0,24,0,0,0,0,0,0,0,0,0,74832
25792,460,96,184,108,62,10,18,8,7,0,0,7,1,0,0,0,0,1,0,1,0,10,4,0,0,4,6,6,6,0,0,0,0,0,0,74833
25793,4969,625,1984,1736,365,259,331,192,158,46,30,82,34,32,13,19,0,2,0,0,2,139,125,72,0,53,14,5,0,4,1,9,0,0,9,74834
25794,48,10,27,0,11,0,0,0,0,0,0,0,0,0,0,0,0,0,0,0,0,0,0,0,0,0,0,0,0,0,0,0,0,0,0,74836
25795,293,105,74,79,28,7,30,17,14,0,0,14,3,3,3,0,0,0,0,0,0,13,11,3,4,4,2,2,2,0,0,0,0,0,0,74837
25796,515,103,217,146,24,25,43,9,9,2,0,7,0,0,0,0,0,0,0,0,0,34,28,5,0,23,6,5,0,0,5,1,0,0,1,74839
25797,1262,178,539,391,107,47,77,47,43,21,0,22,4,2,0,0,2,2,0,0,2,30,23,8,0,15,7,0,0,0,0,7,3,0,4,74840
25798,60,0,36,4,0,20,9,9,0,0,0,0,9,9,0,0,9,0,0,0,0,0,0,0,0,0,0,0,0,0,0,0,0,0,0,74842
25799,239,20,62,69,59,29,21,7,7,4,0,3,0,0,0,0,0,0,0,0,0,14,11,0,0,11,3,3,2,1,0,0,0,0,0,74843
25800,148,27,70,36,15,0,16,11,7,3,0,4,4,2,0,2,0,2,0,0,2,5,2,0,0,2,3,0,0,0,0,3,0,0,3,74844
25801,425,94,141,133,44,13,41,18,10,6,0,4,8,0,0,0,0,8,0,0,8,23,14,2,0,12,9,0,0,0,0,9,0,0,9,74845
25802,5876,1464,2176,1620,452,164,340,193,100,14,1,85,93,4,1,0,3,89,0,72,17,147,127,29,0,98,20,11,0,0,11,9,9,0,0,74848
25803,2174,328,868,677,216,85,255,159,146,4,0,142,13,0,0,0,0,13,0,0,13,96,83,11,4,68,13,5,5,0,0,8,0,0,8,74849
25804,262,34,104,112,9,3,27,16,10,6,2,2,6,5,2,3,0,1,0,0,1,11,11,0,0,11,0,0,0,0,0,0,0,0,0,74850
25805,6808,1130,2522,2195,601,360,484,278,223,98,0,125,55,50,50,0,0,5,0,0,5,206,165,39,12,114,41,30,16,7,7,11,0,0,11,74851
25806,991,138,331,369,114,39,91,52,28,0,0,28,24,24,9,0,15,0,0,0,0,39,36,3,0,33,3,0,0,0,0,3,3,0,0,74852
25807,1087,184,442,347,85,29,109,52,52,11,2,39,0,0,0,0,0,0,0,0,0,57,46,8,2,36,11,11,9,0,2,0,0,0,0,74854
25808,3615,460,1399,1222,291,243,395,226,218,48,10,160,8,4,0,0,4,4,0,0,4,169,141,9,38,94,28,28,11,0,17,0,0,0,0,74855
25809,590,98,219,183,72,18,44,9,9,0,0,9,0,0,0,0,0,0,0,0,0,35,34,2,3,29,1,0,0,0,0,1,1,0,0,74856
25810,5687,819,1844,2143,536,345,324,195,121,24,0,97,74,61,36,19,6,13,13,0,0,129,116,6,39,71,13,13,13,0,0,0,0,0,0,74857
25811,4103,781,1593,1198,350,181,303,156,121,8,5,108,35,17,8,9,0,18,0,0,18,147,125,26,13,86,22,9,0,9,0,13,0,11,2,74859
25812,1278,185,575,407,73,38,113,56,46,10,0,36,10,2,0,0,2,8,2,6,0,57,21,8,10,3,36,21,4,0,17,15,0,15,0,74860
25813,3630,466,1516,1166,350,132,318,151,123,34,11,78,28,28,23,5,0,0,0,0,0,167,116,32,10,74,51,22,0,22,0,29,0,0,29,74864
25814,1244,251,508,270,138,77,147,99,90,43,0,47,9,9,7,0,2,0,0,0,0,48,42,10,0,32,6,3,0,0,3,3,0,0,3,74865
25815,692,152,311,211,8,10,87,41,32,0,0,32,9,7,7,0,0,2,0,2,0,46,43,26,0,17,3,3,0,3,0,0,0,0,0,74867
25816,8358,1432,2894,2646,785,601,811,405,284,63,32,189,121,62,29,3,30,59,8,0,51,406,343,43,32,268,63,27,6,15,6,36,0,0,36,74868
25817,692,85,313,257,34,3,17,7,7,0,0,7,0,0,0,0,0,0,0,0,0,10,10,0,0,10,0,0,0,0,0,0,0,0,0,74869
25818,1493,171,570,373,226,153,150,103,80,12,10,58,23,23,16,4,3,0,0,0,0,47,47,21,0,26,0,0,0,0,0,0,0,0,0,74871
25819,2563,358,1126,601,328,150,162,85,47,0,0,47,38,19,14,0,5,19,0,0,19,77,48,21,0,27,29,16,9,0,7,13,0,0,13,74872
25820,7957,960,3306,2623,871,197,654,380,333,131,20,182,47,41,33,0,8,6,0,0,6,274,206,98,19,89,68,36,17,9,10,32,0,0,32,74873
25821,838,130,374,204,102,28,74,37,25,5,0,20,12,5,5,0,0,7,0,0,7,37,37,11,0,26,0,0,0,0,0,0,0,0,0,74875
25822,1070,249,470,277,37,37,62,28,23,2,3,18,5,5,3,0,2,0,0,0,0,34,34,9,0,25,0,0,0,0,0,0,0,0,0,74878
25823,1547,261,584,521,91,90,112,88,80,22,0,58,8,4,0,4,0,4,0,0,4,24,21,12,0,9,3,0,0,0,0,3,0,3,0,74880
25824,2666,470,1000,825,308,63,250,122,112,8,6,98,10,3,3,0,0,7,7,0,0,128,89,16,3,70,39,27,22,0,5,12,0,5,7,74881
25825,1594,335,681,452,92,34,155,94,48,1,0,47,46,8,5,2,1,38,21,0,17,61,35,3,0,32,26,17,15,2,0,9,9,0,0,74883
25826,4072,742,1666,1185,329,150,252,139,124,3,10,111,15,4,0,4,0,11,0,2,9,113,80,22,3,55,33,16,5,11,0,17,1,0,16,74884
25827,1359,401,534,355,44,25,103,68,37,0,4,33,31,27,22,0,5,4,0,0,4,35,31,0,11,20,4,0,0,0,0,4,0,0,4,74901
25828,2748,376,1278,878,138,78,195,97,79,22,0,57,18,0,0,0,0,18,12,0,6,98,76,59,0,17,22,22,22,0,0,0,0,0,0,74902
25829,1300,285,504,381,83,47,137,61,26,0,8,18,35,34,8,4,22,1,0,1,0,76,60,21,10,29,16,14,8,0,6,2,0,0,2,74930
25830,974,228,469,184,65,28,68,33,24,8,0,16,9,9,6,0,3,0,0,0,0,35,32,2,12,18,3,0,0,0,0,3,0,0,3,74931
25831,1656,254,743,518,94,47,162,72,61,0,21,40,11,11,11,0,0,0,0,0,0,90,83,40,3,40,7,5,5,0,0,2,0,0,2,74932
25832,103,19,52,32,0,0,5,1,1,0,0,1,0,0,0,0,0,0,0,0,0,4,2,0,0,2,2,2,0,0,2,0,0,0,0,74935
25833,934,216,340,286,79,13,60,42,42,13,0,29,0,0,0,0,0,0,0,0,0,18,11,5,0,6,7,0,0,0,0,7,7,0,0,74936
25834,3718,1006,1189,1086,319,118,301,211,181,74,6,101,30,23,9,14,0,7,0,0,7,90,72,22,13,37,18,6,6,0,0,12,4,0,8,74937
25835,1206,265,566,249,89,37,23,10,0,0,0,0,10,10,0,0,10,0,0,0,0,13,11,3,0,8,2,0,0,0,0,2,2,0,0,74939
25836,1571,266,686,449,118,52,129,53,32,2,5,25,21,14,14,0,0,7,7,0,0,76,53,10,0,43,23,17,4,13,0,6,0,0,6,74940
25837,1871,378,853,495,89,56,171,110,86,15,0,71,24,0,0,0,0,24,0,0,24,61,54,8,0,46,7,7,3,0,4,0,0,0,0,74941
25838,134,21,47,42,9,15,11,5,0,0,0,0,5,5,0,5,0,0,0,0,0,6,6,2,2,2,0,0,0,0,0,0,0,0,0,74942
25839,83,15,36,32,0,0,0,0,0,0,0,0,0,0,0,0,0,0,0,0,0,0,0,0,0,0,0,0,0,0,0,0,0,0,0,74943
25840,782,161,334,211,49,27,90,30,27,4,0,23,3,3,3,0,0,0,0,0,0,60,58,7,8,43,2,2,0,0,2,0,0,0,0,74944
25841,343,109,120,83,16,15,18,10,10,0,0,10,0,0,0,0,0,0,0,0,0,8,5,2,0,3,3,3,0,0,3,0,0,0,0,74945
25842,84,33,38,11,2,0,17,12,7,0,5,2,5,5,5,0,0,0,0,0,0,5,5,0,3,2,0,0,0,0,0,0,0,0,0,74946
25843,8260,1694,3356,2131,806,273,642,353,295,48,17,230,58,49,16,26,7,9,0,9,0,289,203,53,0,150,86,80,77,0,3,6,0,0,6,74948
25844,184,19,80,33,26,26,33,21,21,14,0,7,0,0,0,0,0,0,0,0,0,12,8,0,0,8,4,4,4,0,0,0,0,0,0,74949
25845,1052,249,495,232,57,19,109,36,21,0,0,21,15,4,2,0,2,11,0,0,11,73,49,0,0,49,24,15,11,0,4,9,0,5,4,74951
25846,7812,1174,2353,2590,904,791,712,458,413,94,32,287,45,23,10,0,13,22,22,0,0,254,218,71,21,126,36,11,0,7,4,25,15,0,10,74953
25847,2941,500,1314,951,123,53,272,150,119,13,43,63,31,4,4,0,0,27,0,0,27,122,122,23,15,84,0,0,0,0,0,0,0,0,0,74954
25848,9976,1773,4237,2615,863,488,807,445,398,35,22,341,47,15,15,0,0,32,0,0,32,362,297,129,32,136,65,54,20,34,0,11,0,0,11,74955
25849,1404,285,639,333,75,72,81,61,31,11,0,20,30,14,8,6,0,16,9,0,7,20,11,8,0,3,9,7,7,0,0,2,2,0,0,74956
25850,683,111,266,189,92,25,37,9,4,4,0,0,5,5,3,2,0,0,0,0,0,28,24,12,0,12,4,0,0,0,0,4,0,0,4,74957
25851,4477,1154,1688,1232,247,156,405,179,147,57,9,81,32,26,11,0,15,6,0,0,6,226,178,14,14,150,48,27,11,0,16,21,7,0,14,74959
25852,8430,1809,3405,2163,734,319,739,406,327,24,18,285,79,56,47,5,4,23,0,0,23,333,182,40,4,138,151,103,63,0,40,48,16,5,27,74960
25853,3633,588,1300,1046,439,260,276,164,156,79,18,59,8,8,0,4,4,0,0,0,0,112,96,5,40,51,16,8,0,8,0,8,0,0,8,74962
25854,512,96,244,148,11,13,43,32,19,2,10,7,13,11,11,0,0,2,0,0,2,11,6,4,0,2,5,5,0,0,5,0,0,0,0,74963
25855,1822,346,875,466,116,19,120,60,42,8,2,32,18,12,3,0,9,6,2,0,4,60,41,13,9,19,19,19,9,3,7,0,0,0,0,74964
25856,3514,963,1253,761,403,134,347,154,130,11,0,119,24,0,0,0,0,24,19,0,5,193,174,46,21,107,19,2,2,0,0,17,0,0,17,74965
25857,2360,377,980,697,193,113,222,101,80,21,6,53,21,21,15,0,6,0,0,0,0,121,94,40,0,54,27,4,0,0,4,23,23,0,0,74966
25858,9978,919,1281,2755,3318,1705,254,173,144,0,29,115,29,0,0,0,0,29,29,0,0,81,64,28,0,36,17,17,17,0,0,0,0,0,0,75001
25859,40744,2136,6146,14280,12670,5512,4144,1962,1751,503,140,1108,211,140,44,43,53,71,51,0,20,2182,2134,1056,144,934,48,33,12,21,0,15,0,0,15,75002
25860,30892,7814,5754,8144,6459,2721,2507,1432,1104,373,13,718,328,191,144,32,15,137,137,0,0,1075,896,210,14,672,179,77,44,0,33,102,0,24,78,75006
25861,34451,3485,6669,10821,9935,3541,3119,1721,1592,378,36,1178,129,105,22,59,24,24,5,0,19,1398,1231,248,98,885,167,132,67,39,26,35,0,14,21,75007
25862,5695,420,1639,1960,1230,446,430,206,144,27,0,117,62,62,62,0,0,0,0,0,0,224,218,52,0,166,6,6,6,0,0,0,0,0,0,75009
25863,16118,867,3259,4961,5206,1825,1024,484,459,49,62,348,25,0,0,0,0,25,0,0,25,540,467,168,34,265,73,73,50,23,0,0,0,0,0,75010
25864,19582,507,1666,4181,8071,5157,1355,776,776,191,88,497,0,0,0,0,0,0,0,0,0,579,579,181,75,323,0,0,0,0,0,0,0,0,0,75013
25865,25326,930,2770,5686,9656,6284,2422,1225,1153,246,44,863,72,55,11,34,10,17,0,0,17,1197,1153,416,21,716,44,36,8,0,28,8,0,0,8,75019
25866,15361,2053,4960,5412,1927,1009,1412,855,589,133,40,416,266,121,93,18,10,145,85,35,25,557,447,154,86,207,110,110,34,8,68,0,0,0,0,75020
25867,5640,800,1983,2136,540,181,351,202,191,67,6,118,11,0,0,0,0,11,11,0,0,149,149,56,0,93,0,0,0,0,0,0,0,0,0,75021
25868,13910,413,1345,3214,6050,2888,1358,755,734,172,33,529,21,9,9,0,0,12,0,0,12,603,596,158,47,391,7,0,0,0,0,7,0,0,7,75022
25869,31616,1742,5280,9405,10258,4931,3053,1630,1420,337,93,990,210,210,77,36,97,0,0,0,0,1423,1224,275,154,795,199,176,111,37,28,23,0,0,23,75023
25870,25980,489,2235,5868,10223,7165,1727,796,766,178,13,575,30,23,23,0,0,7,7,0,0,931,931,211,56,664,0,0,0,0,0,0,0,0,0,75024
25871,33344,997,2964,7450,12885,9048,3074,1689,1648,367,101,1180,41,29,29,0,0,12,0,6,6,1385,1329,449,39,841,56,49,0,15,34,7,0,0,7,75025
25872,27029,561,3345,8384,10507,4232,2981,1341,1215,479,64,672,126,95,66,4,25,31,5,0,26,1640,1586,524,151,911,54,48,18,14,16,6,6,0,0,75028
25873,19472,1759,3919,6008,5197,2589,1710,978,852,219,102,531,126,58,58,0,0,68,56,0,12,732,662,225,25,412,70,40,17,0,23,30,0,0,30,75032
25874,46774,2313,5490,11481,18746,8744,3076,1509,1363,442,79,842,146,38,15,23,0,108,99,9,0,1567,1448,622,22,804,119,113,106,0,7,6,0,6,0,75034
25875,31085,1156,3346,8982,12916,4685,2722,1225,1003,344,53,606,222,181,149,18,14,41,0,0,41,1497,1342,660,79,603,155,117,89,8,20,38,15,0,23,75035
25876,18490,2056,3275,4954,5047,3158,924,413,384,45,35,304,29,19,19,0,0,10,10,0,0,511,446,87,11,348,65,32,20,4,8,33,33,0,0,75038
25877,9675,227,736,1933,4152,2627,104,47,47,0,12,35,0,0,0,0,0,0,0,0,0,57,57,13,0,44,0,0,0,0,0,0,0,0,0,75039
25878,36684,10196,8880,10635,5270,1703,4061,2160,1678,386,227,1065,482,292,197,58,37,190,125,49,16,1901,1603,350,93,1160,298,224,65,64,95,74,21,53,0,75040
25879,18090,6162,4989,4314,1825,800,1916,1011,764,129,49,586,247,162,70,30,62,85,26,46,13,905,782,232,11,539,123,123,66,23,34,0,0,0,0,75041
25880,22171,7642,5929,5849,1881,870,2870,1570,1252,216,229,807,318,265,149,77,39,53,0,31,22,1300,1148,296,80,772,152,77,35,9,33,75,19,0,56,75042
25881,36691,5799,9851,12822,5839,2380,2968,1412,1309,384,221,704,103,53,0,9,44,50,7,22,21,1556,1229,266,251,712,327,228,67,60,101,99,36,0,63,75043
25882,27936,3236,5391,9563,6610,3136,2453,1442,1252,214,144,894,190,49,0,30,19,141,38,103,0,1011,899,200,14,685,112,89,45,33,11,23,6,8,9,75044
25883,13734,978,3218,4928,3169,1441,1226,634,519,178,30,311,115,95,28,0,67,20,20,0,0,592,523,161,47,315,69,27,27,0,0,42,20,0,22,75048
25884,24618,5510,7118,7625,3235,1130,2145,941,777,187,48,542,164,134,104,20,10,30,22,0,8,1204,987,278,97,612,217,137,36,12,89,80,47,0,33,75050
25885,23715,8288,7646,5081,1951,749,2429,1109,902,210,36,656,207,98,84,14,0,109,63,9,37,1320,1027,176,197,654,293,227,92,57,78,66,0,0,66,75051
25886,53667,7836,12827,18094,10724,4186,5406,2884,2414,601,241,1572,470,336,225,70,41,134,83,17,34,2522,2167,466,203,1498,355,355,164,146,45,0,0,0,0,75052
25887,3849,99,602,1058,1291,799,318,209,209,63,64,82,0,0,0,0,0,0,0,0,0,109,109,11,0,98,0,0,0,0,0,0,0,0,0,75054
25888,32101,2031,6310,10779,8403,4578,2500,1355,1242,345,52,845,113,73,44,7,22,40,17,23,0,1145,1037,354,85,598,108,43,9,20,14,65,0,0,65,75056
25889,8337,2291,1945,2568,1111,422,775,493,319,114,15,190,174,44,27,7,10,130,111,19,0,282,223,31,24,168,59,59,46,0,13,0,0,0,0,75057
25890,2109,311,463,598,476,261,200,81,81,15,0,66,0,0,0,0,0,0,0,0,0,119,109,34,0,75,10,10,10,0,0,0,0,0,0,75058
25891,27495,8910,7848,6923,2674,1140,3190,1688,1288,302,94,892,400,170,79,64,27,230,92,0,138,1502,1332,162,230,940,170,90,0,9,81,80,0,41,39,75060
25892,31447,10512,8599,7532,3404,1400,3116,1893,1409,175,224,1010,484,134,115,19,0,350,209,53,88,1223,918,201,89,628,305,231,160,9,62,74,51,5,18,75061
25893,28992,6181,7099,8022,5413,2277,2752,1305,1095,262,73,760,210,41,41,0,0,169,35,0,134,1447,1270,289,86,895,177,58,45,13,0,119,60,28,31,75062
25894,25424,1058,2366,5354,9623,7023,1050,536,500,33,0,467,36,26,8,0,18,10,0,0,10,514,514,75,67,372,0,0,0,0,0,0,0,0,0,75063
25895,7640,379,2386,2733,1657,485,353,234,197,39,17,141,37,0,0,0,0,37,0,0,37,119,91,56,0,35,28,28,16,12,0,0,0,0,0,75065
25896,39565,4908,9076,13164,8903,3514,2905,1860,1446,552,32,862,414,250,73,60,117,164,9,53,102,1045,830,468,20,342,215,207,194,13,0,8,0,0,8,75067
25897,24315,2480,5060,9212,5580,1983,1599,795,654,163,88,403,141,141,81,16,44,0,0,0,0,804,745,341,84,320,59,34,34,0,0,25,25,0,0,75068
25898,21984,4080,5897,5566,4874,1567,2005,1147,806,124,42,640,341,170,41,50,79,171,46,17,108,858,602,134,36,432,256,192,83,3,106,64,2,21,41,75069
25899,48137,1631,5708,14262,18496,8040,4320,2446,2246,448,51,1747,200,116,9,76,31,84,24,0,60,1874,1856,646,96,1114,18,18,0,18,0,0,0,0,0,75070
25900,24531,1441,4302,8111,7581,3096,2170,1258,1099,201,47,851,159,81,34,0,47,78,45,0,33,912,876,169,104,603,36,27,25,2,0,9,0,0,9,75071
25901,29575,5741,6749,7938,6356,2791,2322,1081,918,231,30,657,163,115,74,0,41,48,48,0,0,1241,1146,402,49,695,95,71,57,0,14,24,0,0,24,75074
25902,23826,1695,3618,7223,7513,3777,1750,875,770,201,13,556,105,66,11,22,33,39,38,0,1,875,813,159,22,632,62,8,0,0,8,54,15,0,39,75075
25903,5636,720,1537,2200,685,494,205,116,106,20,11,75,10,6,6,0,0,4,4,0,0,89,82,13,28,41,7,2,0,2,0,5,0,0,5,75076
25904,24470,759,4327,8442,7639,3303,1784,971,941,396,44,501,30,30,30,0,0,0,0,0,0,813,787,388,35,364,26,8,7,0,1,18,18,0,0,75077
25905,6894,294,981,2323,2361,935,540,280,280,52,16,212,0,0,0,0,0,0,0,0,0,260,255,78,0,177,5,0,0,0,0,5,5,0,0,75078
25906,28728,3180,4608,6840,9112,4988,2599,1399,1271,352,62,857,128,107,93,0,14,21,0,0,21,1200,1118,295,33,790,82,29,28,0,1,53,0,53,0,75080
25907,23795,1945,4562,7141,6465,3682,1434,704,692,97,197,398,12,12,0,0,12,0,0,0,0,730,682,113,67,502,48,32,6,0,26,16,16,0,0,75081
25908,14719,806,1693,2854,5555,3811,1017,577,539,57,40,442,38,38,20,0,18,0,0,0,0,440,381,45,15,321,59,59,59,0,0,0,0,0,0,75082
25909,19327,1360,3891,6189,5461,2426,1603,725,632,134,69,429,93,67,32,30,5,26,0,0,26,878,835,299,111,425,43,25,3,22,0,18,0,0,18,75087
25910,17364,1543,3741,6301,4072,1707,1715,941,903,165,68,670,38,37,11,6,20,1,0,0,1,774,687,85,173,429,87,79,49,0,30,8,0,0,8,75088
25911,18088,2101,3681,6043,4396,1867,2968,1468,1298,406,67,825,170,47,37,0,10,123,0,18,105,1500,1453,471,47,935,47,47,14,0,33,0,0,0,0,75089
25912,13961,2894,4933,4384,1156,594,1955,763,535,164,27,344,228,106,11,40,55,122,18,71,33,1192,873,232,28,613,319,207,25,38,144,112,0,19,93,75090
25913,15603,1464,4242,5685,2606,1606,933,450,415,33,71,311,35,29,5,0,24,6,0,4,2,483,463,90,5,368,20,19,4,15,0,1,0,1,0,75092
25914,32773,1003,2598,7960,13062,8150,2676,1559,1445,287,140,1018,114,61,18,0,43,53,46,0,7,1117,1064,446,4,614,53,14,14,0,0,39,0,0,39,75093
25915,11980,512,1893,2963,4562,2050,1221,493,493,199,28,266,0,0,0,0,0,0,0,0,0,728,637,166,28,443,91,38,0,0,38,53,44,0,9,75094
25916,29747,2182,6991,10114,8262,2198,2726,1415,1176,310,127,739,239,215,96,29,90,24,24,0,0,1311,1105,356,69,680,206,144,61,33,50,62,16,20,26,75098
25917,324,149,87,71,12,5,45,24,24,0,0,24,0,0,0,0,0,0,0,0,0,21,19,2,0,17,2,0,0,0,0,2,0,2,0,75101
25918,889,156,311,346,61,15,33,31,31,0,0,31,0,0,0,0,0,0,0,0,0,2,0,0,0,0,2,2,2,0,0,0,0,0,0,75102
25919,9347,1324,3623,2976,945,479,713,402,264,43,28,193,138,85,77,0,8,53,21,0,32,311,311,95,45,171,0,0,0,0,0,0,0,0,0,75103
25920,28311,2343,5799,11136,5655,3378,2984,1519,1238,248,98,892,281,270,124,146,0,11,0,0,11,1465,1295,351,163,781,170,126,51,75,0,44,0,0,44,75104
25921,127,26,57,29,4,11,21,10,3,3,0,0,7,7,7,0,0,0,0,0,0,11,0,0,0,0,11,11,11,0,0,0,0,0,0,75105
25922,3014,464,1071,947,410,122,228,151,110,22,22,66,41,20,18,1,1,21,21,0,0,77,59,39,12,8,18,18,18,0,0,0,0,0,0,75109
25923,17160,3974,5311,4821,2113,941,1924,1091,777,154,45,578,314,253,161,34,58,61,20,23,18,833,578,130,42,406,255,135,15,21,99,120,0,56,64,75110
25924,2805,403,812,1025,354,211,301,166,152,67,5,80,14,8,0,0,8,6,0,0,6,135,110,25,14,71,25,25,0,0,25,0,0,0,0,75114
25925,33031,2686,7485,13454,6356,3050,3330,2025,1569,123,249,1197,456,365,169,196,0,91,0,45,46,1305,1134,330,17,787,171,151,23,13,115,20,0,20,0,75115
25926,11952,2747,3416,3359,1693,737,1344,739,559,41,8,510,180,126,59,0,67,54,53,0,1,605,450,199,11,240,155,144,97,0,47,11,0,0,11,75116
25927,2385,512,821,747,231,74,141,79,55,16,3,36,24,10,10,0,0,14,3,0,11,62,25,1,0,24,37,16,0,5,11,21,18,3,0,75117
25928,15869,4017,4999,4927,1265,661,1501,875,702,137,0,565,173,162,95,51,16,11,0,0,11,626,620,203,64,353,6,6,0,6,0,0,0,0,0,75119
25929,2680,536,974,801,238,131,233,111,89,4,3,82,22,13,7,0,6,9,0,0,9,122,78,9,9,60,44,35,3,6,26,9,0,0,9,75124
25930,4081,1405,1384,951,277,64,753,354,183,14,0,169,171,40,13,27,0,131,83,41,7,399,279,99,7,173,120,120,69,0,51,0,0,0,0,75125
25931,20630,1571,5616,7970,3851,1622,2078,989,890,174,160,556,99,91,61,16,14,8,7,0,1,1089,1047,408,68,571,42,37,37,0,0,5,0,0,5,75126
25932,948,215,411,211,58,53,91,56,52,12,9,31,4,0,0,0,0,4,4,0,0,35,35,0,0,35,0,0,0,0,0,0,0,0,0,75127
25933,437,24,146,135,132,0,0,0,0,0,0,0,0,0,0,0,0,0,0,0,0,0,0,0,0,0,0,0,0,0,0,0,0,0,0,75132
25934,11950,1546,3747,4497,1596,564,1198,502,401,20,50,331,101,44,32,12,0,57,0,43,14,696,462,74,24,364,234,139,0,11,128,95,0,8,87,75134
25935,3349,377,1302,1226,243,201,264,146,140,52,0,88,6,6,6,0,0,0,0,0,0,118,112,33,12,67,6,3,0,0,3,3,0,0,3,75135
25936,12305,1817,2730,4112,2411,1235,1084,647,429,29,30,370,218,126,44,32,50,92,82,10,0,437,417,203,17,197,20,20,20,0,0,0,0,0,0,75137
25937,4803,1283,1751,1228,380,161,330,211,184,39,5,140,27,9,0,9,0,18,17,0,1,119,118,15,0,103,1,0,0,0,0,1,0,0,1,75140
25938,3530,982,1306,946,230,66,201,111,107,9,0,98,4,1,0,0,1,3,0,0,3,90,86,0,23,63,4,4,0,0,4,0,0,0,0,75141
25939,11884,2562,4000,3802,1160,360,1025,561,387,33,7,347,174,156,36,46,74,18,3,0,15,464,406,39,31,336,58,52,31,3,18,6,0,0,6,75142
25940,10986,2730,3856,2990,1079,331,644,306,189,10,12,167,117,48,14,22,12,69,27,42,0,338,244,46,19,179,94,66,37,17,12,28,0,0,28,75143
25941,2199,345,707,800,234,113,321,89,82,7,3,72,7,7,7,0,0,0,0,0,0,232,214,0,5,209,18,0,0,0,0,18,8,0,10,75144
25942,11565,1797,3200,4255,1678,635,1135,559,363,0,0,363,196,100,67,16,17,96,40,56,0,576,478,42,26,410,98,98,69,29,0,0,0,0,0,75146
25943,5232,1079,2077,1354,550,172,610,437,411,89,45,277,26,25,0,25,0,1,0,0,1,173,135,39,36,60,38,19,6,0,13,19,0,19,0,75147
25944,4265,923,1299,1316,442,285,339,157,146,9,8,129,11,11,0,1,10,0,0,0,0,182,148,53,6,89,34,34,2,0,32,0,0,0,0,75148
25945,34900,7796,11076,11151,3175,1702,3922,1770,1502,295,53,1154,268,195,149,0,46,73,0,0,73,2152,1894,279,112,1503,258,203,92,0,111,55,18,10,27,75149
25946,35792,6648,9963,12738,4371,2072,3087,1403,1119,296,55,768,284,76,48,21,7,208,129,39,40,1684,1365,469,124,772,319,196,138,47,11,123,51,35,37,75150
25947,3313,733,1110,1183,238,49,308,153,126,9,60,57,27,13,13,0,0,14,0,0,14,155,131,8,58,65,24,0,0,0,0,24,24,0,0,75152
25948,509,145,197,116,51,0,7,0,0,0,0,0,0,0,0,0,0,0,0,0,0,7,7,0,0,7,0,0,0,0,0,0,0,0,0,75153
25949,22590,3516,6862,7347,3383,1482,2294,1233,915,147,13,755,318,215,184,19,12,103,68,13,22,1061,799,262,53,484,262,128,75,20,33,134,30,71,33,75154
25950,1634,486,548,461,134,5,193,110,88,24,5,59,22,17,13,4,0,5,5,0,0,83,83,16,0,67,0,0,0,0,0,0,0,0,0,75155
25951,10940,2326,3985,3074,1050,505,648,229,161,29,36,96,68,47,11,16,20,21,0,21,0,419,288,15,63,210,131,66,22,28,16,65,0,11,54,75156
25952,223,65,107,44,3,4,38,18,18,0,0,18,0,0,0,0,0,0,0,0,0,20,20,0,6,14,0,0,0,0,0,0,0,0,0,75157
25953,2760,541,892,1014,230,83,271,191,131,57,5,69,60,29,0,16,13,31,31,0,0,80,78,27,4,47,2,0,0,0,0,2,2,0,0,75158
25954,12812,2661,4595,3836,1157,563,874,426,305,50,3,252,121,103,81,3,19,18,18,0,0,448,438,48,12,378,10,10,0,0,10,0,0,0,0,75159
25955,14746,3749,4462,4337,1416,782,1094,561,437,70,68,299,124,57,7,8,42,67,44,12,11,533,426,52,43,331,107,62,60,0,2,45,3,0,42,75160
25956,4780,992,1870,1612,210,96,290,185,89,5,17,67,96,58,16,0,42,38,0,20,18,105,43,3,2,38,62,62,62,0,0,0,0,0,0,75161
25957,1339,198,358,486,234,63,46,20,17,4,0,13,3,3,0,0,3,0,0,0,0,26,24,0,0,24,2,0,0,0,0,2,0,0,2,75163
25958,258,46,125,70,17,0,52,28,6,0,0,6,22,22,7,0,15,0,0,0,0,24,24,6,0,18,0,0,0,0,0,0,0,0,0,75164
25959,24079,3351,7301,7711,3708,2008,2397,1259,1080,229,166,685,179,148,99,34,15,31,0,0,31,1138,1031,378,108,545,107,92,57,35,0,15,0,0,15,75165
25960,2372,90,688,892,524,178,181,112,92,35,4,53,20,20,18,2,0,0,0,0,0,69,69,7,0,62,0,0,0,0,0,0,0,0,0,75166
25961,6264,845,1999,1854,1129,437,654,389,388,55,6,327,1,0,0,0,0,1,0,0,1,265,236,70,6,160,29,29,26,0,3,0,0,0,0,75167
25962,9695,1754,4084,2728,756,373,765,374,339,59,0,280,35,6,6,0,0,29,9,0,20,391,362,44,22,296,29,11,0,11,0,18,18,0,0,75169
25963,2477,1018,595,598,248,18,155,70,27,0,0,27,43,38,27,0,11,5,0,3,2,85,35,9,0,26,50,50,50,0,0,0,0,0,0,75172
25964,3127,451,969,1280,322,105,296,93,93,36,0,57,0,0,0,0,0,0,0,0,0,203,171,56,47,68,32,32,26,0,6,0,0,0,0,75173
25965,12292,4442,3593,2994,1002,261,1561,748,512,19,14,479,236,58,0,0,58,178,85,6,87,813,547,31,53,463,266,94,77,7,10,172,89,0,83,75180
25966,15078,2305,3198,5436,3037,1102,1982,1194,1143,105,205,833,51,51,19,32,0,0,0,0,0,788,677,158,73,446,111,111,111,0,0,0,0,0,0,75181
25967,3695,382,546,1055,949,763,431,165,165,0,0,165,0,0,0,0,0,0,0,0,0,266,266,0,11,255,0,0,0,0,0,0,0,0,0,75182
25968,13823,1669,4662,4569,2078,845,955,667,503,98,28,377,164,117,117,0,0,47,11,0,36,288,191,3,0,188,97,59,40,19,0,38,0,0,38,75189
25969,8599,398,747,1915,3267,2272,21,13,13,7,0,6,0,0,0,0,0,0,0,0,0,8,6,0,0,6,2,2,0,0,2,0,0,0,0,75201
25970,1789,6,191,403,734,455,16,7,7,7,0,0,0,0,0,0,0,0,0,0,0,9,0,0,0,0,9,9,9,0,0,0,0,0,0,75202
25971,9480,4032,2386,2064,705,293,724,427,287,55,16,216,140,44,13,9,22,96,76,0,20,297,224,5,0,219,73,54,31,0,23,19,19,0,0,75203
25972,19372,2511,2049,2939,7070,4803,847,463,343,100,48,195,120,57,29,0,28,63,46,17,0,384,343,124,55,164,41,9,9,0,0,32,0,5,27,75204
25973,13427,224,675,1929,5660,4939,2894,1438,1386,203,87,1096,52,14,0,9,5,38,0,0,38,1456,1438,476,35,927,18,18,0,0,18,0,0,0,0,75205
25974,27093,3566,2776,5672,9398,5681,850,338,273,73,28,172,65,30,30,0,0,35,35,0,0,512,424,260,36,128,88,57,57,0,0,31,0,0,31,75206
25975,7497,2329,2391,2007,535,235,338,242,38,0,0,38,204,110,0,0,110,94,0,0,94,96,15,9,0,6,81,43,0,0,43,38,0,0,38,75207
25976,19641,7753,4139,3179,2827,1743,1632,762,515,125,39,351,247,155,99,3,53,92,75,0,17,870,582,48,16,518,288,131,22,27,82,157,36,0,121,75208
25977,11018,1059,1853,1812,3746,2548,463,199,128,0,0,128,71,0,0,0,0,71,36,0,35,264,240,18,34,188,24,24,20,0,4,0,0,0,0,75209
25978,3830,1400,1594,717,98,21,342,179,121,12,6,103,58,28,0,0,28,30,30,0,0,163,101,6,35,60,62,24,16,8,0,38,0,0,38,75210
25979,40758,20597,10141,7256,2004,760,4964,2181,1649,190,164,1295,532,358,224,36,98,174,90,34,50,2783,2412,500,197,1715,371,267,164,10,93,104,37,10,57,75211
25980,14102,7264,3742,2324,592,180,1760,1034,762,87,150,525,272,166,110,40,16,106,53,0,53,726,547,52,101,394,179,127,66,38,23,52,11,6,35,75212
25981,24857,2199,2711,4870,9120,5957,695,334,290,49,0,241,44,0,0,0,0,44,27,17,0,361,299,54,14,231,62,62,14,48,0,0,0,0,0,75214
25982,10126,2878,3367,2584,835,462,546,353,277,14,50,213,76,46,46,0,0,30,10,11,9,193,153,10,0,143,40,20,2,12,6,20,0,0,20,75215
25983,30219,11590,10490,6338,1145,656,2621,1355,948,123,74,751,407,240,56,63,121,167,66,22,79,1266,995,144,71,780,271,263,90,48,125,8,8,0,0,75216
25984,44367,20746,14203,7458,1556,404,5475,2736,2046,220,322,1504,690,223,88,55,80,467,280,43,144,2739,1982,289,106,1587,757,423,178,171,74,334,42,53,239,75217
25985,16429,1646,3096,4126,4634,2927,1105,703,497,129,11,357,206,37,25,0,12,169,48,0,121,402,387,74,0,313,15,0,0,0,0,15,15,0,0,75218
25986,17616,2870,2071,3520,5560,3595,269,103,86,29,0,57,17,4,4,0,0,13,13,0,0,166,143,24,0,119,23,23,0,0,23,0,0,0,0,75219
25987,25622,12067,5869,3354,2681,1651,2411,1396,954,262,108,584,442,126,100,26,0,316,199,83,34,1015,809,212,68,529,206,105,43,43,19,101,0,38,63,75220
25988,7678,3303,1658,1354,959,404,763,470,290,29,57,204,180,121,61,12,48,59,0,0,59,293,228,38,43,147,65,35,35,0,0,30,0,22,8,75223
25989,18905,7141,5226,4492,1444,602,2775,1405,1091,123,160,808,314,171,49,43,79,143,76,67,0,1370,1083,207,169,707,287,192,75,26,91,95,0,0,95,75224
25990,14407,149,554,2148,6675,4881,935,460,429,24,6,399,31,15,0,15,0,16,0,0,16,475,475,43,12,420,0,0,0,0,0,0,0,0,0,75225
25991,2514,644,444,676,503,247,0,0,0,0,0,0,0,0,0,0,0,0,0,0,0,0,0,0,0,0,0,0,0,0,0,0,0,0,0,75226
25992,31352,11676,9260,7382,2067,967,3706,2098,1784,319,192,1273,314,249,107,102,40,65,20,0,45,1608,1387,211,310,866,221,139,55,25,59,82,26,19,37,75227
25993,42074,14305,11091,9970,4416,2292,3710,1949,1413,165,365,883,536,272,144,71,57,264,172,44,48,1761,1571,391,249,931,190,78,63,0,15,112,29,14,69,75228
25994,21843,5043,3614,3858,5957,3371,1882,1140,834,136,63,635,306,144,121,23,0,162,126,32,4,742,606,145,5,456,136,72,30,42,0,64,0,35,29,75229
25995,19583,1598,2321,3893,6546,5225,839,346,346,111,7,228,0,0,0,0,0,0,0,0,0,493,493,97,63,333,0,0,0,0,0,0,0,0,0,75230
25996,21033,5004,4739,5063,3995,2232,1258,627,489,45,0,444,138,37,0,0,37,101,29,0,72,631,512,72,49,391,119,43,0,15,28,76,34,0,42,75231
25997,18019,3808,5861,5330,1766,1254,1882,829,537,27,40,470,292,173,64,73,36,119,27,0,92,1053,826,56,79,691,227,179,104,10,65,48,20,0,28,75232
25998,8597,2633,2042,2265,955,702,891,258,213,51,21,141,45,0,0,0,0,45,25,20,0,633,415,117,40,258,218,45,0,0,45,173,0,84,89,75233
25999,18945,4520,4772,4937,3115,1601,1897,987,823,196,83,544,164,143,87,31,25,21,21,0,0,910,781,226,58,497,129,81,43,20,18,48,13,0,35,75234
26000,11310,3376,2852,2481,1475,1126,809,334,259,20,0,239,75,8,0,8,0,67,25,0,42,475,451,123,0,328,24,20,10,0,10,4,4,0,0,75235
26001,8543,2386,2391,2332,958,476,779,448,425,40,49,336,23,0,0,0,0,23,23,0,0,331,183,0,69,114,148,137,33,0,104,11,0,0,11,75236
26002,9605,1885,3233,3417,824,246,862,465,392,33,10,349,73,43,0,0,43,30,30,0,0,397,305,72,74,159,92,60,12,0,48,32,0,12,20,75237
26003,20284,3205,3889,4494,5566,3130,1114,578,455,38,0,417,123,48,17,14,17,75,0,0,75,536,436,145,31,260,100,100,49,21,30,0,0,0,0,75238
26004,16060,5559,3298,2887,2969,1347,1268,461,345,157,8,180,116,50,50,0,0,66,50,0,16,807,622,68,69,485,185,125,65,0,60,60,0,43,17,75240
26005,18341,3703,7784,4982,1249,623,1880,1012,803,23,58,722,209,109,9,0,100,100,19,11,70,868,686,117,24,545,182,105,36,11,58,77,0,0,77,75241
26006,35168,6415,8327,10796,6430,3200,2792,1372,1239,203,25,1011,133,68,29,11,28,65,35,0,30,1420,1121,238,58,825,299,169,64,36,69,130,23,0,107,75243
26007,9708,1010,1463,1799,3583,1853,542,263,263,58,16,189,0,0,0,0,0,0,0,0,0,279,256,54,8,194,23,23,22,0,1,0,0,0,0,75244
26008,1820,620,342,480,218,160,107,68,24,0,0,24,44,23,23,0,0,21,0,0,21,39,31,11,0,20,8,0,0,0,0,8,0,0,8,75246
26009,546,190,165,120,29,42,0,0,0,0,0,0,0,0,0,0,0,0,0,0,0,0,0,0,0,0,0,0,0,0,0,0,0,0,0,75247
26010,25896,1382,3391,6832,8813,5478,1711,867,603,127,49,427,264,236,133,66,37,28,28,0,0,844,789,185,61,543,55,55,55,0,0,0,0,0,0,75248
26011,8154,1177,1807,3218,1232,720,733,400,342,42,13,287,58,12,0,0,12,46,41,0,5,333,298,31,0,267,35,35,0,0,35,0,0,0,0,75249
26012,2285,126,249,415,908,587,56,56,56,0,0,56,0,0,0,0,0,0,0,0,0,0,0,0,0,0,0,0,0,0,0,0,0,0,0,75251
26013,18295,1180,2210,5225,5616,4064,1143,618,604,113,18,473,14,14,0,14,0,0,0,0,0,525,508,171,73,264,17,17,17,0,0,0,0,0,0,75252
26014,10289,4572,3206,1857,439,215,971,549,480,68,58,354,69,19,12,0,7,50,15,13,22,422,322,85,40,197,100,75,47,0,28,25,0,0,25,75253
26015,16426,2490,2641,4251,4910,2134,747,336,252,57,30,165,84,26,0,0,26,58,34,24,0,411,293,162,0,131,118,61,35,0,26,57,24,0,33,75254
26016,0,0,0,0,0,0,0,0,0,0,0,0,0,0,0,0,0,0,0,0,0,0,0,0,0,0,0,0,0,0,0,0,0,0,0,75270
26017,35279,2518,5467,11569,10782,4943,1461,715,576,119,43,414,139,110,99,11,0,29,0,19,10,746,627,181,50,396,119,89,74,0,15,30,30,0,0,75287
26018,0,0,0,0,0,0,0,0,0,0,0,0,0,0,0,0,0,0,0,0,0,0,0,0,0,0,0,0,0,0,0,0,0,0,0,75390
26019,11478,3138,4000,3267,738,335,881,541,410,66,72,272,131,74,16,24,34,57,0,49,8,340,259,0,31,228,81,62,29,27,6,19,0,0,19,75401
26020,10960,1046,2827,3947,1983,1157,524,289,266,0,14,252,23,7,0,7,0,16,0,0,16,235,214,76,38,100,21,11,0,0,11,10,0,0,10,75402
26021,9845,1559,3623,2917,1306,440,729,334,241,120,14,107,93,65,42,0,23,28,0,0,28,395,345,163,6,176,50,50,50,0,0,0,0,0,0,75407
26022,7486,1178,2260,2344,1129,575,716,423,359,141,0,218,64,52,38,14,0,12,0,0,12,293,235,97,13,125,58,49,5,0,44,9,0,0,9,75409
26023,3163,834,1210,836,262,21,166,99,75,0,0,75,24,0,0,0,0,24,0,0,24,67,51,23,1,27,16,10,0,0,10,6,0,6,0,75410
26024,921,57,440,333,48,43,27,8,8,0,0,8,0,0,0,0,0,0,0,0,0,19,11,11,0,0,8,8,0,0,8,0,0,0,0,75411
26025,552,85,212,217,30,8,3,3,3,0,0,3,0,0,0,0,0,0,0,0,0,0,0,0,0,0,0,0,0,0,0,0,0,0,0,75412
26026,163,30,77,54,2,0,12,2,0,0,0,0,2,2,2,0,0,0,0,0,0,10,10,3,0,7,0,0,0,0,0,0,0,0,0,75413
26027,2365,220,948,766,324,107,132,86,75,25,15,35,11,11,0,0,11,0,0,0,0,46,42,9,0,33,4,2,2,0,0,2,0,0,2,75414
26028,156,44,74,28,10,0,0,0,0,0,0,0,0,0,0,0,0,0,0,0,0,0,0,0,0,0,0,0,0,0,0,0,0,0,0,75415
26029,1978,292,684,745,202,55,149,99,92,21,17,54,7,7,7,0,0,0,0,0,0,50,41,29,0,12,9,9,0,0,9,0,0,0,0,75416
26030,1783,585,568,344,223,63,135,37,20,12,0,8,17,8,0,0,8,9,0,9,0,98,78,8,3,67,20,20,9,0,11,0,0,0,0,75417
26031,9795,1807,3384,2920,1136,548,491,257,156,55,3,98,101,65,36,13,16,36,0,14,22,234,158,25,45,88,76,27,27,0,0,49,0,0,49,75418
26032,727,157,259,203,66,42,42,37,11,0,0,11,26,26,9,17,0,0,0,0,0,5,5,0,0,5,0,0,0,0,0,0,0,0,0,75420
26033,717,127,322,179,89,0,101,37,23,10,0,13,14,9,0,9,0,5,0,0,5,64,49,6,5,38,15,15,0,15,0,0,0,0,0,75421
26034,1886,268,714,591,144,169,164,125,123,46,6,71,2,2,0,0,2,0,0,0,0,39,24,0,0,24,15,9,8,0,1,6,0,0,6,75422
26035,2041,297,836,601,223,84,216,117,78,16,0,62,39,39,15,18,6,0,0,0,0,99,89,22,14,53,10,10,9,1,0,0,0,0,0,75423
26036,2259,270,858,696,389,46,141,110,101,44,0,57,9,9,9,0,0,0,0,0,0,31,31,15,0,16,0,0,0,0,0,0,0,0,0,75424
26037,3485,868,1457,722,280,158,149,29,21,0,0,21,8,0,0,0,0,8,0,0,8,120,76,7,0,69,44,44,44,0,0,0,0,0,0,75426
26038,5301,992,1515,1327,881,586,1265,471,471,67,55,349,0,0,0,0,0,0,0,0,0,794,756,221,96,439,38,0,0,0,0,38,38,0,0,75428
26039,1080,186,425,330,105,34,160,57,39,0,0,39,18,18,0,14,4,0,0,0,0,103,84,8,3,73,19,6,0,0,6,13,0,13,0,75431
26040,2342,419,815,690,343,75,195,92,68,26,0,42,24,1,0,0,1,23,0,23,0,103,102,15,0,87,1,1,1,0,0,0,0,0,0,75432
26041,1914,304,685,555,242,128,134,75,42,10,10,22,33,33,15,0,18,0,0,0,0,59,38,26,0,12,21,21,11,0,10,0,0,0,0,75433
26042,1081,238,338,322,129,54,57,11,8,2,0,6,3,3,2,1,0,0,0,0,0,46,45,39,0,6,1,1,0,0,1,0,0,0,0,75435
26043,1541,262,684,380,182,33,59,31,13,6,0,7,18,10,0,10,0,8,8,0,0,28,25,9,6,10,3,0,0,0,0,3,3,0,0,75436
26044,900,134,361,279,76,50,32,9,9,5,0,4,0,0,0,0,0,0,0,0,0,23,10,0,0,10,13,0,0,0,0,13,0,4,9,75437
26045,658,92,291,184,49,42,48,32,21,0,4,17,11,11,11,0,0,0,0,0,0,16,16,5,0,11,0,0,0,0,0,0,0,0,0,75438
26046,634,119,247,218,38,12,48,23,14,11,0,3,9,9,2,7,0,0,0,0,0,25,21,13,0,8,4,0,0,0,0,4,0,0,4,75439
26047,4897,821,1806,1558,470,242,374,194,181,60,65,56,13,13,13,0,0,0,0,0,0,180,70,39,8,23,110,69,0,0,69,41,0,41,0,75440
26048,98,10,31,13,44,0,0,0,0,0,0,0,0,0,0,0,0,0,0,0,0,0,0,0,0,0,0,0,0,0,0,0,0,0,0,75441
26049,5968,864,2125,1953,781,245,543,342,297,93,12,192,45,28,11,2,15,17,0,17,0,201,199,101,0,98,2,2,0,2,0,0,0,0,0,75442
26050,2412,456,912,640,299,105,244,159,104,28,0,76,55,38,20,0,18,17,17,0,0,85,76,13,0,63,9,9,3,0,6,0,0,0,0,75446
26051,853,125,351,297,32,48,62,24,0,0,0,0,24,16,0,0,16,8,8,0,0,38,38,13,0,25,0,0,0,0,0,0,0,0,0,75447
26052,411,33,155,155,43,25,16,9,9,0,0,9,0,0,0,0,0,0,0,0,0,7,0,0,0,0,7,0,0,0,0,7,0,0,7,75448
26053,850,144,307,235,102,62,42,24,20,3,0,17,4,0,0,0,0,4,4,0,0,18,13,0,0,13,5,5,5,0,0,0,0,0,0,75449
26054,248,0,127,109,2,10,17,0,0,0,0,0,0,0,0,0,0,0,0,0,0,17,17,0,0,17,0,0,0,0,0,0,0,0,0,75450
26055,554,50,122,201,119,62,22,15,15,0,0,15,0,0,0,0,0,0,0,0,0,7,0,0,0,0,7,0,0,0,0,7,0,0,7,75451
26056,2936,581,1112,886,267,90,287,84,52,10,4,38,32,0,0,0,0,32,32,0,0,203,188,7,8,173,15,15,12,0,3,0,0,0,0,75452
26057,2131,305,890,698,133,105,216,125,120,13,21,86,5,5,0,5,0,0,0,0,0,91,91,5,3,83,0,0,0,0,0,0,0,0,0,75453
26058,3264,396,682,1109,679,398,341,270,260,111,0,149,10,10,10,0,0,0,0,0,0,71,71,15,7,49,0,0,0,0,0,0,0,0,0,75454
26059,16852,4873,4361,5173,1394,1051,1758,964,766,146,51,569,198,140,107,0,33,58,27,13,18,794,662,216,51,395,132,94,56,8,30,38,15,0,23,75455
26060,4043,648,1382,1277,482,254,268,111,90,36,11,43,21,0,0,0,0,21,0,0,21,157,137,77,6,54,20,4,4,0,0,16,0,0,16,75457
26061,2887,288,844,1096,448,211,360,137,137,12,51,74,0,0,0,0,0,0,0,0,0,223,197,5,0,192,26,0,0,0,0,26,0,0,26,75459
26062,14760,3208,4934,4700,1201,717,1368,606,484,85,87,312,122,67,8,15,44,55,0,14,41,762,592,51,61,480,170,99,69,19,11,71,34,0,37,75460
26063,7863,742,2376,2570,1374,801,477,308,279,82,7,190,29,9,4,0,5,20,0,20,0,169,130,4,0,126,39,39,0,0,39,0,0,0,0,75462
26064,512,122,190,186,0,14,26,9,9,0,0,9,0,0,0,0,0,0,0,0,0,17,17,0,0,17,0,0,0,0,0,0,0,0,0,75468
26065,260,27,92,118,20,3,30,11,9,0,0,9,2,0,0,0,0,2,0,0,2,19,19,0,0,19,0,0,0,0,0,0,0,0,0,75469
26066,189,0,137,43,0,9,0,0,0,0,0,0,0,0,0,0,0,0,0,0,0,0,0,0,0,0,0,0,0,0,0,0,0,0,0,75470
26067,783,108,349,274,52,0,50,26,26,0,0,26,0,0,0,0,0,0,0,0,0,24,13,0,0,13,11,11,0,0,11,0,0,0,0,75471
26068,2587,509,1072,777,162,67,141,102,93,20,12,61,9,6,0,0,6,3,3,0,0,39,27,6,0,21,12,12,12,0,0,0,0,0,0,75472
26069,2910,329,1123,962,352,144,288,170,155,40,0,115,15,12,0,0,12,3,0,0,3,118,118,47,0,71,0,0,0,0,0,0,0,0,0,75473
26070,10556,2331,4183,3166,636,240,711,443,348,62,81,205,95,63,50,0,13,32,21,0,11,268,233,22,18,193,35,28,28,0,0,7,0,5,2,75474
26071,158,65,57,36,0,0,0,0,0,0,0,0,0,0,0,0,0,0,0,0,0,0,0,0,0,0,0,0,0,0,0,0,0,0,0,75475
26072,772,80,378,189,88,37,70,33,33,0,0,33,0,0,0,0,0,0,0,0,0,37,25,0,0,25,12,2,2,0,0,10,0,0,10,75476
26073,549,80,194,189,59,27,70,32,17,1,0,16,15,11,8,0,3,4,0,0,4,38,32,0,0,32,6,0,0,0,0,6,0,6,0,75477
26074,761,106,382,191,67,15,64,14,14,0,0,14,0,0,0,0,0,0,0,0,0,50,12,0,0,12,38,13,13,0,0,25,25,0,0,75478
26075,1176,205,392,446,97,36,115,56,56,12,0,44,0,0,0,0,0,0,0,0,0,59,59,8,0,51,0,0,0,0,0,0,0,0,0,75479
26076,1397,263,419,366,195,154,108,46,9,0,0,9,37,37,37,0,0,0,0,0,0,62,13,13,0,0,49,49,0,0,49,0,0,0,0,75480
26077,239,24,115,73,21,6,15,6,6,0,0,6,0,0,0,0,0,0,0,0,0,9,9,9,0,0,0,0,0,0,0,0,0,0,0,75481
26078,16317,3356,5635,4564,1720,1042,1207,680,493,101,37,355,187,158,144,9,5,29,0,0,29,527,272,64,27,181,255,178,51,67,60,77,0,14,63,75482
26079,1420,393,484,411,106,26,148,113,89,52,0,37,24,0,0,0,0,24,0,16,8,35,10,0,0,10,25,10,0,0,10,15,0,0,15,75486
26080,827,168,219,292,80,68,57,26,11,0,0,11,15,15,15,0,0,0,0,0,0,31,27,0,3,24,4,0,0,0,0,4,0,4,0,75487
26081,797,158,342,273,5,19,56,43,43,0,24,19,0,0,0,0,0,0,0,0,0,13,13,9,0,4,0,0,0,0,0,0,0,0,0,75488
26082,595,53,215,269,42,16,65,20,20,0,0,20,0,0,0,0,0,0,0,0,0,45,35,9,0,26,10,0,0,0,0,10,0,0,10,75489
26083,1598,163,604,608,151,72,132,73,62,0,12,50,11,9,9,0,0,2,2,0,0,59,40,0,0,40,19,7,7,0,0,12,0,0,12,75490
26084,3573,501,1258,1176,497,141,303,130,104,11,13,80,26,26,4,22,0,0,0,0,0,173,114,81,2,31,59,21,21,0,0,38,0,17,21,75491
26085,396,53,153,138,49,3,12,12,12,0,0,12,0,0,0,0,0,0,0,0,0,0,0,0,0,0,0,0,0,0,0,0,0,0,0,75492
26086,309,183,77,29,16,4,62,34,34,4,0,30,0,0,0,0,0,0,0,0,0,28,28,13,1,14,0,0,0,0,0,0,0,0,0,75493
26087,7347,1402,2374,2433,741,397,323,221,198,73,0,125,23,11,0,11,0,12,0,0,12,102,85,18,9,58,17,12,7,0,5,5,5,0,0,75494
26088,4553,408,1367,1707,664,407,267,137,130,35,30,65,7,7,7,0,0,0,0,0,0,130,120,24,0,96,10,10,0,0,10,0,0,0,0,75495
26089,2349,343,793,752,277,184,238,136,46,0,8,38,90,31,31,0,0,59,59,0,0,102,97,40,8,49,5,0,0,0,0,5,5,0,0,75496
26090,2819,447,1203,732,260,177,115,78,66,21,1,44,12,12,0,12,0,0,0,0,0,37,37,20,0,17,0,0,0,0,0,0,0,0,0,75497
26091,23870,3533,8590,8523,2170,1054,2118,1059,863,138,101,624,196,153,31,103,19,43,22,0,21,1059,911,69,94,748,148,142,65,51,26,6,0,0,6,75501
26092,17062,1146,4086,5676,3617,2537,1317,626,458,62,45,351,168,167,131,0,36,1,0,0,1,691,488,90,24,374,203,203,83,16,104,0,0,0,0,75503
26093,715,165,196,207,124,23,36,23,21,0,0,21,2,2,2,0,0,0,0,0,0,13,7,0,0,7,6,3,2,0,1,3,0,0,3,75550
26094,7394,962,2919,2369,826,318,581,116,58,11,0,47,58,41,8,18,15,17,0,0,17,465,349,72,0,277,116,96,35,0,61,20,0,0,20,75551
26095,1251,187,454,395,166,49,123,81,81,7,0,74,0,0,0,0,0,0,0,0,0,42,41,2,0,39,1,1,0,0,1,0,0,0,0,75554
26096,1087,239,407,269,119,53,43,28,28,0,4,24,0,0,0,0,0,0,0,0,0,15,15,0,0,15,0,0,0,0,0,0,0,0,0,75555
26097,617,113,318,124,41,21,66,27,27,1,0,26,0,0,0,0,0,0,0,0,0,39,16,3,3,10,23,8,0,8,0,15,0,0,15,75556
26098,1155,164,289,556,105,41,72,49,0,0,0,0,49,49,49,0,0,0,0,0,0,23,23,0,0,23,0,0,0,0,0,0,0,0,0,75558
26099,4006,581,1566,1204,442,213,304,195,154,21,34,99,41,41,24,17,0,0,0,0,0,109,94,13,0,81,15,15,4,11,0,0,0,0,0,75559
26100,785,96,368,225,57,39,90,90,90,0,68,22,0,0,0,0,0,0,0,0,0,0,0,0,0,0,0,0,0,0,0,0,0,0,0,75560
26101,3653,712,1472,1059,323,87,286,207,168,27,25,116,39,37,14,0,23,2,0,2,0,79,68,27,13,28,11,0,0,0,0,11,11,0,0,75561
26102,77,0,77,0,0,0,0,0,0,0,0,0,0,0,0,0,0,0,0,0,0,0,0,0,0,0,0,0,0,0,0,0,0,0,0,75562
26103,3158,551,1383,745,360,119,180,86,69,5,17,47,17,8,0,0,8,9,0,0,9,94,82,21,5,56,12,12,0,8,4,0,0,0,0,75563
26104,241,56,130,34,10,11,21,3,3,0,0,3,0,0,0,0,0,0,0,0,0,18,18,16,0,2,0,0,0,0,0,0,0,0,0,75565
26105,737,136,349,190,44,18,24,9,8,0,0,8,1,1,0,1,0,0,0,0,0,15,15,5,0,10,0,0,0,0,0,0,0,0,0,75566
26106,2785,222,1370,976,152,65,308,220,178,36,0,142,42,12,2,6,4,30,0,15,15,88,63,0,6,57,25,25,3,0,22,0,0,0,0,75567
26107,1880,335,795,590,104,56,222,146,135,35,20,80,11,11,11,0,0,0,0,0,0,76,72,35,13,24,4,0,0,0,0,4,4,0,0,75568
26108,1636,160,711,539,132,94,108,31,31,10,21,0,0,0,0,0,0,0,0,0,0,77,52,0,28,24,25,25,0,0,25,0,0,0,0,75569
26109,7641,1557,3020,2318,443,303,505,322,250,28,3,219,72,34,0,29,5,38,0,0,38,183,134,29,0,105,49,49,10,0,39,0,0,0,0,75570
26110,2145,317,660,840,186,142,128,76,49,0,22,27,27,23,0,23,0,4,0,4,0,52,39,5,4,30,13,5,0,5,0,8,8,0,0,75571
26111,2724,429,1198,835,169,93,211,100,77,0,8,69,23,23,23,0,0,0,0,0,0,111,104,0,3,101,7,7,0,0,7,0,0,0,0,75572
26112,21,0,13,8,0,0,0,0,0,0,0,0,0,0,0,0,0,0,0,0,0,0,0,0,0,0,0,0,0,0,0,0,0,0,0,75573
26113,1334,296,642,257,95,44,173,83,71,5,0,66,12,12,12,0,0,0,0,0,0,90,84,8,0,76,6,6,0,0,6,0,0,0,0,75574
26114,10952,1966,3337,3408,1617,624,861,375,282,66,49,167,93,61,39,16,6,32,6,0,26,486,403,62,11,330,83,52,24,0,28,31,0,5,26,75601
26115,12774,3556,3908,3943,1066,301,1851,1147,1002,280,79,643,145,114,52,42,20,31,8,0,23,704,596,175,30,391,108,92,45,26,21,16,0,0,16,75602
26116,4296,632,1262,1554,691,157,198,107,89,23,21,45,18,18,7,0,11,0,0,0,0,91,89,29,0,60,2,2,0,0,2,0,0,0,0,75603
26117,19386,3148,4981,7220,2668,1369,1577,929,640,125,150,365,289,150,109,0,41,139,80,46,13,648,575,133,113,329,73,50,30,0,20,23,0,0,23,75604
26118,19768,1939,5087,7247,3683,1812,1344,544,318,143,0,175,226,196,114,0,82,30,20,0,10,800,760,313,11,436,40,23,23,0,0,17,17,0,0,75605
26119,2230,612,727,663,123,105,93,54,39,2,0,37,15,15,15,0,0,0,0,0,0,39,27,0,0,27,12,12,0,0,12,0,0,0,0,75630
26120,1785,235,720,675,120,35,141,72,29,19,0,10,43,0,0,0,0,43,0,0,43,69,52,1,0,51,17,0,0,0,0,17,0,0,17,75631
26121,9863,1663,3436,3503,976,285,784,386,339,83,30,226,47,43,0,0,43,4,0,0,4,398,310,103,26,181,88,0,0,0,0,88,2,7,79,75633
26122,4386,731,1482,1524,485,164,323,147,129,32,0,97,18,0,0,0,0,18,0,8,10,176,162,20,0,142,14,0,0,0,0,14,0,0,14,75638
26123,1981,264,826,658,187,46,35,0,0,0,0,0,0,0,0,0,0,0,0,0,0,35,17,0,0,17,18,18,5,0,13,0,0,0,0,75639
26124,2722,453,872,1018,249,130,210,152,124,37,17,70,28,28,28,0,0,0,0,0,0,58,58,9,0,49,0,0,0,0,0,0,0,0,0,75640
26125,167,53,70,31,9,4,6,0,0,0,0,0,0,0,0,0,0,0,0,0,0,6,6,3,0,3,0,0,0,0,0,0,0,0,0,75641
26126,80,38,42,0,0,0,38,13,0,0,0,0,13,13,13,0,0,0,0,0,0,25,25,0,0,25,0,0,0,0,0,0,0,0,0,75642
26127,1525,355,601,434,86,49,117,69,43,34,0,9,26,8,8,0,0,18,0,8,10,48,48,14,0,34,0,0,0,0,0,0,0,0,0,75643
26128,7861,1433,2699,2621,799,309,740,493,370,31,0,339,123,90,22,32,36,33,0,0,33,247,160,39,0,121,87,48,0,15,33,39,15,0,24,75644
26129,6997,1251,2599,2156,709,282,567,299,216,44,0,172,83,83,18,48,17,0,0,0,0,268,210,48,0,162,58,58,45,0,13,0,0,0,0,75645
26130,8706,1563,2965,3200,671,307,595,209,154,19,41,94,55,14,0,0,14,41,41,0,0,386,274,39,16,219,112,59,59,0,0,53,37,0,16,75647
26131,5475,494,1935,1953,871,222,357,143,76,18,5,53,67,33,33,0,0,34,0,34,0,214,214,71,49,94,0,0,0,0,0,0,0,0,0,75650
26132,1741,276,792,517,106,50,173,132,92,14,0,78,40,20,20,0,0,20,10,0,10,41,28,5,0,23,13,0,0,0,0,13,0,0,13,75651
26133,11455,2654,4249,3062,1110,380,806,520,393,174,1,218,127,44,0,7,37,83,19,0,64,286,164,45,0,119,122,95,76,19,0,27,17,0,10,75652
26134,7989,1857,2059,2911,784,378,711,379,350,35,34,281,29,1,1,0,0,28,23,5,0,332,300,106,5,189,32,25,20,0,5,7,0,0,7,75654
26135,3200,546,1111,1265,212,66,253,196,187,47,0,140,9,9,6,0,3,0,0,0,0,57,49,22,2,25,8,8,0,8,0,0,0,0,0,75656
26136,5858,907,2337,1804,464,346,376,290,216,58,0,158,74,55,5,9,41,19,15,0,4,86,54,21,0,33,32,0,0,0,0,32,0,27,5,75657
26137,1949,445,815,407,245,37,53,0,0,0,0,0,0,0,0,0,0,0,0,0,0,53,24,0,0,24,29,8,8,0,0,21,0,0,21,75661
26138,15733,3044,4416,5464,1954,855,1259,535,465,50,65,350,70,59,42,17,0,11,0,11,0,724,621,223,26,372,103,59,38,16,5,44,9,0,35,75662
26139,803,129,210,348,90,26,59,20,20,0,0,20,0,0,0,0,0,0,0,0,0,39,35,3,4,28,4,4,0,4,0,0,0,0,0,75667
26140,1122,278,428,313,70,33,36,10,9,2,0,7,1,0,0,0,0,1,1,0,0,26,7,0,0,7,19,11,11,0,0,8,0,8,0,75668
26141,497,88,144,213,26,26,28,18,18,0,0,18,0,0,0,0,0,0,0,0,0,10,10,0,0,10,0,0,0,0,0,0,0,0,0,75669
26142,10742,2490,3656,3009,1197,390,1461,809,637,112,19,506,172,109,93,16,0,63,0,5,58,652,603,276,61,266,49,49,49,0,0,0,0,0,0,75670
26143,11273,1539,3433,3813,1767,721,607,278,194,40,7,147,84,52,15,19,18,32,24,0,8,329,264,57,12,195,65,65,31,23,11,0,0,0,0,75672
26144,1823,288,748,609,134,44,166,87,87,36,7,44,0,0,0,0,0,0,0,0,0,79,75,4,0,71,4,4,2,0,2,0,0,0,0,75681
26145,464,61,225,164,6,8,26,9,9,0,0,9,0,0,0,0,0,0,0,0,0,17,10,10,0,0,7,7,7,0,0,0,0,0,0,75682
26146,2670,505,1005,914,203,43,322,176,123,29,0,94,53,35,35,0,0,18,9,0,9,146,76,13,37,26,70,70,45,0,25,0,0,0,0,75683
26147,5414,1200,1965,1477,578,194,472,217,178,14,32,132,39,33,8,23,2,6,6,0,0,255,212,49,43,120,43,33,26,0,7,10,0,0,10,75684
26148,8589,2033,2921,2436,755,444,654,259,223,58,10,155,36,21,17,0,4,15,8,0,7,395,345,131,37,177,50,24,0,0,24,26,26,0,0,75686
26149,2199,279,748,862,220,90,273,138,100,0,0,100,38,37,30,0,7,1,0,0,1,135,100,69,0,31,35,31,4,0,27,4,0,0,4,75691
26150,3416,390,1501,1125,226,174,223,59,56,0,0,56,3,3,0,3,0,0,0,0,0,164,145,78,0,67,19,19,7,0,12,0,0,0,0,75692
26151,4342,460,1206,1784,494,398,312,139,124,49,0,75,15,11,0,0,11,4,0,0,4,173,170,88,17,65,3,3,0,0,3,0,0,0,0,75693
26152,21591,2801,5012,7542,4523,1713,2668,1156,1077,282,123,672,79,6,6,0,0,73,67,0,6,1512,1403,338,151,914,109,76,48,24,4,33,0,18,15,75701
26153,15639,5973,4434,4039,762,431,1580,846,511,84,82,345,335,123,79,18,26,212,158,19,35,734,681,173,120,388,53,39,27,12,0,14,0,0,14,75702
26154,24651,1230,4710,9091,6152,3468,1817,931,800,195,46,559,131,92,48,9,35,39,0,37,2,886,766,276,29,461,120,90,7,25,58,30,30,0,0,75703
26155,5634,1151,2140,1675,411,257,376,207,161,0,0,161,46,0,0,0,0,46,46,0,0,169,142,57,31,54,27,19,19,0,0,8,8,0,0,75704
26156,1397,291,649,324,78,55,84,65,48,1,8,39,17,11,11,0,0,6,0,0,6,19,11,0,0,11,8,3,0,0,3,5,5,0,0,75705
26157,5515,1703,1944,1504,213,151,579,298,206,45,0,161,92,34,0,15,19,58,58,0,0,281,247,29,14,204,34,34,0,0,34,0,0,0,0,75706
26158,9519,759,2548,3524,1846,842,922,405,350,36,15,299,55,55,0,55,0,0,0,0,0,517,498,249,103,146,19,12,12,0,0,7,0,0,7,75707
26159,3911,1288,1148,1028,376,71,472,217,185,53,77,55,32,0,0,0,0,32,0,32,0,255,89,8,15,66,166,54,54,0,0,112,28,31,53,75708
26160,4030,304,1340,1573,501,312,111,56,45,18,0,27,11,0,0,0,0,11,0,11,0,55,55,20,0,35,0,0,0,0,0,0,0,0,0,75709
26161,2265,246,856,762,291,110,396,223,177,37,0,140,46,0,0,0,0,46,46,0,0,173,123,10,60,53,50,0,0,0,0,50,0,0,50,75750
26162,10936,2281,3511,3740,896,508,1122,637,500,95,105,300,137,61,7,47,7,76,71,0,5,485,404,130,64,210,81,77,76,0,1,4,0,0,4,75751
26163,4732,787,1570,1602,571,202,221,37,20,4,0,16,17,17,17,0,0,0,0,0,0,184,124,48,0,76,60,60,24,8,28,0,0,0,0,75752
26164,3911,851,1215,1336,359,150,311,129,107,12,3,92,22,0,0,0,0,22,0,0,22,182,182,40,0,142,0,0,0,0,0,0,0,0,0,75754
26165,3741,522,1380,1329,326,184,316,136,136,3,0,133,0,0,0,0,0,0,0,0,0,180,134,28,0,106,46,46,35,0,11,0,0,0,0,75755
26166,2627,325,803,1160,279,60,161,94,77,14,19,44,17,17,17,0,0,0,0,0,0,67,63,31,14,18,4,0,0,0,0,4,0,0,4,75756
26167,7093,953,2157,2162,1304,517,562,223,181,34,20,127,42,13,3,0,10,29,12,0,17,339,286,111,40,135,53,53,9,0,44,0,0,0,0,75757
26168,5950,708,1823,2040,992,387,440,331,259,23,12,224,72,40,0,0,40,32,0,0,32,109,79,25,6,48,30,0,0,0,0,30,0,0,30,75758
26169,97,15,54,24,4,0,7,0,0,0,0,0,0,0,0,0,0,0,0,0,0,7,7,0,0,7,0,0,0,0,0,0,0,0,0,75759
26170,1570,271,551,498,203,47,140,65,60,11,3,46,5,5,5,0,0,0,0,0,0,75,63,3,0,60,12,5,4,1,0,7,0,0,7,75760
26171,9146,603,2175,3155,2430,783,525,301,213,103,11,99,88,76,44,0,32,12,0,12,0,224,158,61,14,83,66,66,54,0,12,0,0,0,0,75762
26172,4736,992,1645,1456,422,221,267,174,135,40,36,59,39,19,10,0,9,20,20,0,0,93,83,14,0,69,10,10,10,0,0,0,0,0,0,75763
26173,85,20,33,20,6,6,6,4,2,0,0,2,2,0,0,0,0,2,0,0,2,2,0,0,0,0,2,2,0,0,2,0,0,0,0,75764
26174,5466,521,1733,1961,908,343,605,284,200,72,7,121,84,75,62,13,0,9,0,0,9,321,310,57,15,238,11,6,2,0,4,5,0,0,5,75765
26175,15828,4309,4982,4301,1598,638,1448,896,613,150,50,413,283,197,152,17,28,86,0,0,86,552,461,109,12,340,91,26,0,22,4,65,5,0,60,75766
26176,2410,376,979,786,157,112,213,108,85,21,0,64,23,23,12,0,11,0,0,0,0,105,65,0,11,54,40,40,37,0,3,0,0,0,0,75770
26177,12396,1316,3309,4709,2348,714,1208,679,587,123,53,411,92,64,0,14,50,28,0,14,14,529,461,80,0,381,68,68,32,21,15,0,0,0,0,75771
26178,8784,1505,3277,2640,904,458,549,328,259,70,40,149,69,69,43,26,0,0,0,0,0,221,172,20,34,118,49,43,35,0,8,6,0,0,6,75773
26179,2752,538,996,905,138,175,201,75,26,6,0,20,49,18,3,0,15,31,0,0,31,126,75,0,6,69,51,0,0,0,0,51,0,0,51,75778
26180,124,23,65,18,18,0,12,0,0,0,0,0,0,0,0,0,0,0,0,0,0,12,12,0,0,12,0,0,0,0,0,0,0,0,0,75779
26181,122,53,37,9,12,11,14,14,14,9,0,5,0,0,0,0,0,0,0,0,0,0,0,0,0,0,0,0,0,0,0,0,0,0,0,75780
26182,5474,938,2025,1632,555,324,313,155,144,23,14,107,11,0,0,0,0,11,0,0,11,158,150,25,0,125,8,2,2,0,0,6,0,0,6,75783
26183,460,102,144,139,65,10,3,3,3,0,0,3,0,0,0,0,0,0,0,0,0,0,0,0,0,0,0,0,0,0,0,0,0,0,0,75784
26184,7877,1828,3041,2019,775,214,387,212,160,21,0,139,52,11,11,0,0,41,0,0,41,175,142,16,7,119,33,0,0,0,0,33,33,0,0,75785
26185,78,0,50,28,0,0,0,0,0,0,0,0,0,0,0,0,0,0,0,0,0,0,0,0,0,0,0,0,0,0,0,0,0,0,0,75788
26186,4933,519,1474,1872,798,270,293,166,142,10,18,114,24,15,15,0,0,9,4,5,0,127,121,22,14,85,6,6,6,0,0,0,0,0,0,75789
26187,2680,416,912,855,315,182,166,109,109,0,13,96,0,0,0,0,0,0,0,0,0,57,36,12,0,24,21,7,0,7,0,14,0,0,14,75790
26188,8242,547,2262,3416,1595,422,869,441,393,111,19,263,48,13,13,0,0,35,0,0,35,428,299,130,0,169,129,114,33,0,81,15,0,0,15,75791
26189,2125,286,731,888,175,45,272,236,173,42,0,131,63,63,62,0,1,0,0,0,0,36,36,17,15,4,0,0,0,0,0,0,0,0,0,75792
26190,10713,2046,4175,2907,1115,470,802,374,329,41,47,241,45,45,0,0,45,0,0,0,0,428,307,32,88,187,121,111,11,8,92,10,0,0,10,75801
26191,17743,3658,7301,5181,1046,557,1057,653,526,73,3,450,127,76,25,33,18,51,8,0,43,404,358,116,0,242,46,31,31,0,0,15,0,15,0,75803
26192,3778,690,1297,1268,413,110,453,195,171,39,28,104,24,20,11,0,9,4,1,3,0,258,245,75,0,170,13,7,0,0,7,6,0,0,6,75831
26193,41,0,20,21,0,0,0,0,0,0,0,0,0,0,0,0,0,0,0,0,0,0,0,0,0,0,0,0,0,0,0,0,0,0,0,75832
26194,2635,402,970,991,210,62,75,56,32,11,0,21,24,24,24,0,0,0,0,0,0,19,19,4,0,15,0,0,0,0,0,0,0,0,0,75833
26195,7878,1642,2877,2102,911,346,735,345,263,17,10,236,82,25,0,0,25,57,19,11,27,390,378,68,36,274,12,0,0,0,0,12,10,0,2,75835
26196,520,34,286,177,23,0,5,5,0,0,0,0,5,5,0,0,5,0,0,0,0,0,0,0,0,0,0,0,0,0,0,0,0,0,0,75838
26197,3576,730,1438,948,362,98,368,180,157,3,0,154,23,19,8,0,11,4,4,0,0,188,119,4,0,115,69,19,19,0,0,50,0,50,0,75839
26198,4672,811,1610,1679,386,186,376,173,173,54,0,119,0,0,0,0,0,0,0,0,0,203,140,45,0,95,63,63,63,0,0,0,0,0,0,75840
26199,4625,795,1678,1309,643,200,178,90,46,23,0,23,44,44,44,0,0,0,0,0,0,88,72,0,13,59,16,16,16,0,0,0,0,0,0,75844
26200,2672,462,1278,727,118,87,355,113,103,7,0,96,10,10,10,0,0,0,0,0,0,242,153,0,0,153,89,0,0,0,0,89,89,0,0,75845
26201,1939,527,640,579,165,28,197,92,69,29,0,40,23,13,4,2,7,10,6,4,0,105,63,16,14,33,42,13,13,0,0,29,0,0,29,75846
26202,1340,196,549,358,180,57,81,70,70,17,37,16,0,0,0,0,0,0,0,0,0,11,11,11,0,0,0,0,0,0,0,0,0,0,0,75847
26203,66,9,32,25,0,0,16,9,9,0,0,9,0,0,0,0,0,0,0,0,0,7,7,7,0,0,0,0,0,0,0,0,0,0,0,75848
26204,172,12,42,115,0,3,3,0,0,0,0,0,0,0,0,0,0,0,0,0,0,3,3,0,0,3,0,0,0,0,0,0,0,0,0,75849
26205,486,66,247,79,69,25,32,21,21,0,0,21,0,0,0,0,0,0,0,0,0,11,11,3,0,8,0,0,0,0,0,0,0,0,0,75850
26206,3659,727,1504,1163,139,126,129,71,37,0,0,37,34,34,0,0,34,0,0,0,0,58,57,10,0,47,1,1,0,0,1,0,0,0,0,75851
26207,3240,868,1290,891,129,62,119,79,21,0,0,21,58,40,0,10,30,18,0,0,18,40,33,33,0,0,7,7,0,0,7,0,0,0,0,75852
26208,743,111,193,364,66,9,47,9,9,0,0,9,0,0,0,0,0,0,0,0,0,38,18,0,0,18,20,20,0,20,0,0,0,0,0,75853
26209,1778,228,689,546,229,86,93,57,57,0,0,57,0,0,0,0,0,0,0,0,0,36,20,0,0,20,16,16,0,0,16,0,0,0,0,75855
26210,221,0,151,43,27,0,0,0,0,0,0,0,0,0,0,0,0,0,0,0,0,0,0,0,0,0,0,0,0,0,0,0,0,0,0,75856
26211,51,0,14,27,0,10,0,0,0,0,0,0,0,0,0,0,0,0,0,0,0,0,0,0,0,0,0,0,0,0,0,0,0,0,0,75858
26212,1512,483,417,383,179,50,71,18,18,12,0,6,0,0,0,0,0,0,0,0,0,53,53,29,0,24,0,0,0,0,0,0,0,0,0,75859
26213,4650,1151,1533,1363,456,147,234,138,118,28,10,80,20,20,0,20,0,0,0,0,0,96,57,0,0,57,39,39,0,39,0,0,0,0,0,75860
26214,5143,1454,1698,1750,208,33,185,117,108,19,0,89,9,9,0,0,9,0,0,0,0,68,57,9,0,48,11,11,0,0,11,0,0,0,0,75861
26215,6659,1383,2889,1698,453,236,348,177,129,19,0,110,48,48,20,0,28,0,0,0,0,171,131,0,0,131,40,0,0,0,0,40,0,0,40,75862
26216,18637,4523,5410,6028,1689,987,1549,912,757,137,96,524,155,40,34,0,6,115,49,18,48,637,476,234,0,242,161,34,18,0,16,127,0,18,109,75901
26217,21363,4150,6469,6541,2754,1449,1673,806,641,163,51,427,165,98,91,6,1,67,14,0,53,867,558,184,0,374,309,246,161,0,85,63,0,11,52,75904
26218,2972,515,938,1118,246,155,270,83,64,5,5,54,19,19,0,0,19,0,0,0,0,187,134,13,38,83,53,35,12,0,23,18,0,0,18,75925
26219,843,129,376,246,89,3,36,11,11,0,0,11,0,0,0,0,0,0,0,0,0,25,19,9,0,10,6,6,0,0,6,0,0,0,0,75926
26220,815,113,460,211,31,0,58,0,0,0,0,0,0,0,0,0,0,0,0,0,0,58,48,0,0,48,10,10,0,0,10,0,0,0,0,75928
26221,1340,283,611,225,171,50,26,5,5,0,0,5,0,0,0,0,0,0,0,0,0,21,0,0,0,0,21,21,0,0,21,0,0,0,0,75929
26222,1351,268,501,506,33,43,37,8,8,0,0,8,0,0,0,0,0,0,0,0,0,29,29,0,10,19,0,0,0,0,0,0,0,0,0,75930
26223,1826,204,630,602,250,140,41,19,18,0,9,9,1,1,0,0,1,0,0,0,0,22,22,0,0,22,0,0,0,0,0,0,0,0,0,75931
26224,1361,271,566,348,95,81,57,45,45,0,0,45,0,0,0,0,0,0,0,0,0,12,12,0,0,12,0,0,0,0,0,0,0,0,0,75932
26225,868,151,565,141,11,0,211,97,9,0,0,9,88,88,88,0,0,0,0,0,0,114,97,11,0,86,17,17,0,17,0,0,0,0,0,75933
26226,27,21,6,0,0,0,0,0,0,0,0,0,0,0,0,0,0,0,0,0,0,0,0,0,0,0,0,0,0,0,0,0,0,0,0,75934
26227,9010,2383,3273,2188,714,452,564,332,230,25,0,205,102,66,30,31,5,36,18,0,18,232,200,60,11,129,32,5,5,0,0,27,0,0,27,75935
26228,823,86,267,324,115,31,56,44,38,6,0,32,6,6,6,0,0,0,0,0,0,12,4,0,4,0,8,0,0,0,0,8,0,0,8,75936
26229,617,84,298,190,30,15,43,19,14,3,0,11,5,5,5,0,0,0,0,0,0,24,21,0,0,21,3,0,0,0,0,3,0,0,3,75937
26230,1748,205,814,556,69,104,51,33,33,3,0,30,0,0,0,0,0,0,0,0,0,18,18,4,0,14,0,0,0,0,0,0,0,0,0,75938
26231,2500,673,906,610,219,92,260,130,111,47,16,48,19,19,0,19,0,0,0,0,0,130,88,39,10,39,42,42,2,11,29,0,0,0,0,75939
26232,6688,1626,2221,2218,471,152,617,385,314,103,49,162,71,46,19,0,27,25,0,25,0,232,181,30,0,151,51,35,0,35,0,16,16,0,0,75941
26233,181,0,131,50,0,0,18,0,0,0,0,0,0,0,0,0,0,0,0,0,0,18,0,0,0,0,18,18,0,18,0,0,0,0,0,75942
26234,896,117,377,164,170,68,77,51,40,13,5,22,11,11,11,0,0,0,0,0,0,26,19,2,0,17,7,7,7,0,0,0,0,0,0,75943
26235,928,191,344,281,73,39,49,26,17,0,0,17,9,3,0,3,0,6,0,0,6,23,7,0,0,7,16,8,8,0,0,8,0,0,8,75944
26236,2460,553,905,615,303,84,81,64,53,19,0,34,11,11,11,0,0,0,0,0,0,17,11,0,0,11,6,6,6,0,0,0,0,0,0,75946
26237,4567,907,2009,1140,340,171,210,91,87,0,0,87,4,0,0,0,0,4,0,0,4,119,93,3,0,90,26,26,22,4,0,0,0,0,0,75948
26238,4769,982,1687,1636,363,101,212,37,14,0,0,14,23,23,5,0,18,0,0,0,0,175,164,23,36,105,11,11,11,0,0,0,0,0,0,75949
26239,10923,2192,4372,3080,854,425,885,503,416,56,96,264,87,87,25,62,0,0,0,0,0,382,265,47,0,218,117,87,9,0,78,30,0,0,30,75951
26240,1912,237,763,557,294,61,150,45,32,0,8,24,13,13,6,0,7,0,0,0,0,105,85,18,0,67,20,20,0,0,20,0,0,0,0,75954
26241,4790,788,2120,1509,271,102,381,215,150,15,51,84,65,53,46,7,0,12,12,0,0,166,148,20,5,123,18,18,18,0,0,0,0,0,0,75956
26242,858,145,137,259,209,108,31,0,0,0,0,0,0,0,0,0,0,0,0,0,0,31,16,0,0,16,15,15,0,0,15,0,0,0,0,75959
26243,579,72,290,97,90,30,0,0,0,0,0,0,0,0,0,0,0,0,0,0,0,0,0,0,0,0,0,0,0,0,0,0,0,0,0,75960
26244,8799,1824,2590,2348,1187,850,662,286,269,25,28,216,17,0,0,0,0,17,0,0,17,376,230,39,16,175,146,85,28,27,30,61,21,0,40,75961
26245,11,0,0,11,0,0,2100,765,765,172,56,537,0,0,0,0,0,0,0,0,0,1335,1335,222,120,993,0,0,0,0,0,0,0,0,0,75962
26246,11848,3444,3555,3108,1107,634,907,400,240,66,24,150,160,89,57,8,24,71,23,0,48,507,411,53,0,358,96,56,36,20,0,40,0,0,40,75964
26247,10185,854,2174,2977,2527,1653,1984,781,768,174,23,571,13,0,0,0,0,13,8,3,2,1203,1120,242,120,758,83,13,1,0,12,70,37,0,33,75965
26248,2786,493,1163,944,143,43,260,175,162,8,0,154,13,8,0,8,0,5,0,0,5,85,56,0,0,56,29,22,7,0,15,7,0,0,7,75966
26249,1255,234,536,382,47,56,41,27,16,0,0,16,11,11,11,0,0,0,0,0,0,14,11,0,0,11,3,3,0,3,0,0,0,0,0,75968
26250,2369,422,806,873,208,60,219,111,47,24,0,23,64,0,0,0,0,64,37,0,27,108,97,24,0,73,11,0,0,0,0,11,11,0,0,75969
26251,4554,1151,1677,1130,404,192,431,259,218,106,0,112,41,0,0,0,0,41,0,0,41,172,151,49,0,102,21,21,0,0,21,0,0,0,0,75972
26252,1943,359,838,538,163,45,133,91,68,1,0,67,23,23,0,0,23,0,0,0,0,42,22,10,0,12,20,0,0,0,0,20,0,0,20,75973
26253,1676,376,627,478,114,81,184,81,58,7,0,51,23,0,0,0,0,23,17,0,6,103,85,4,0,81,18,0,0,0,0,18,0,0,18,75974
26254,2339,400,889,662,275,113,175,58,55,11,0,44,3,3,0,3,0,0,0,0,0,117,77,0,6,71,40,32,0,0,32,8,0,8,0,75975
26255,543,172,173,68,126,4,63,37,37,0,8,29,0,0,0,0,0,0,0,0,0,26,16,11,0,5,10,10,0,0,10,0,0,0,0,75976
26256,985,36,563,290,96,0,37,14,14,0,0,14,0,0,0,0,0,0,0,0,0,23,23,0,0,23,0,0,0,0,0,0,0,0,0,75977
26257,74,20,25,25,4,0,13,13,13,0,0,13,0,0,0,0,0,0,0,0,0,0,0,0,0,0,0,0,0,0,0,0,0,0,0,75978
26258,8210,1800,3240,2210,680,280,642,373,315,72,5,238,58,26,10,0,16,32,0,0,32,269,227,24,7,196,42,42,32,10,0,0,0,0,0,75979
26259,2153,481,864,673,106,29,72,52,43,0,24,19,9,0,0,0,0,9,0,0,9,20,20,0,0,20,0,0,0,0,0,0,0,0,0,75980
26260,18449,1967,3753,6300,4379,2050,2465,1332,1180,225,101,854,152,152,107,28,17,0,0,0,0,1133,998,335,46,617,135,124,43,21,60,11,0,11,0,76001
26261,18358,2173,3759,6608,4454,1364,2059,982,851,207,55,589,131,101,40,36,25,30,0,0,30,1077,929,315,97,517,148,121,43,10,68,27,27,0,0,76002
26262,15638,991,2854,6002,4092,1699,1001,668,621,56,129,436,47,26,26,0,0,21,21,0,0,333,257,74,37,146,76,57,11,46,0,19,0,12,7,76006
26263,9019,458,1657,2691,2878,1335,773,399,357,32,39,286,42,32,9,6,17,10,10,0,0,374,370,76,11,283,4,4,4,0,0,0,0,0,0,76008
26264,12682,3166,4623,3742,855,296,1639,1041,726,126,31,569,315,305,182,123,0,10,0,0,10,598,458,26,17,415,140,99,75,21,3,41,0,0,41,76009
26265,29690,12484,8829,5801,1802,774,4231,2036,1691,431,269,991,345,185,81,79,25,160,84,38,38,2195,1625,363,185,1077,570,272,141,80,51,298,80,64,154,76010
26266,13210,3873,2821,3676,1988,852,1114,503,342,37,59,246,161,43,25,5,13,118,19,45,54,611,427,71,125,231,184,136,63,25,48,48,22,0,26,76011
26267,18038,1822,3915,5366,4443,2492,1315,609,460,151,43,266,149,108,0,23,85,41,0,28,13,706,611,246,10,355,95,69,8,0,61,26,16,0,10,76012
26268,20519,1455,4336,6712,5096,2920,1515,802,735,187,63,485,67,41,26,15,0,26,0,17,9,713,599,141,71,387,114,99,46,53,0,15,0,15,0,76013
26269,19177,4617,5897,5973,2136,554,2744,1352,1141,249,103,789,211,185,85,96,4,26,0,14,12,1392,1228,234,205,789,164,144,51,61,32,20,20,0,0,76014
26270,10559,1196,2871,3664,1932,896,1048,418,362,266,9,87,56,22,22,0,0,34,34,0,0,630,462,187,18,257,168,103,39,38,26,65,0,0,65,76015
26271,21872,1331,4357,6916,6116,3152,1515,800,765,178,83,504,35,33,12,15,6,2,1,0,1,715,653,113,7,533,62,0,0,0,0,62,37,0,25,76016
26272,28904,1680,5872,11048,7250,3054,2121,1015,861,300,68,493,154,119,58,34,27,35,35,0,0,1106,1075,381,19,675,31,17,14,1,2,14,14,0,0,76017
26273,15799,2030,3910,5881,3127,851,2034,992,851,196,138,517,141,57,45,12,0,84,84,0,0,1042,935,298,37,600,107,89,7,15,67,18,12,0,6,76018
26274,18949,2822,5340,7253,2558,976,1092,694,548,173,24,351,146,92,26,16,50,54,18,3,33,398,337,49,2,286,61,16,11,0,5,45,26,3,16,76020
26275,25424,1292,4797,9477,7129,2729,1490,811,789,165,20,604,22,5,5,0,0,17,0,0,17,679,546,249,0,297,133,133,133,0,0,0,0,0,0,76021
26276,8932,671,2118,4045,1530,568,641,270,207,86,15,106,63,19,19,0,0,44,23,20,1,371,306,68,103,135,65,65,33,0,32,0,0,0,0,76022
26277,3951,593,1455,1238,478,187,338,176,176,8,0,168,0,0,0,0,0,0,0,0,0,162,106,52,3,51,56,49,41,0,8,7,0,0,7,76023
26278,40681,3629,12383,14616,6892,3161,3365,1563,1306,383,95,828,257,219,118,101,0,38,0,38,0,1802,1529,479,86,964,273,230,178,2,50,43,25,0,18,76028
26279,11128,2444,3756,3625,1010,293,930,500,381,7,57,317,119,46,36,0,10,73,28,4,41,430,354,23,39,292,76,25,14,11,0,51,0,18,33,76031
26280,15430,2742,5050,4738,2172,728,1112,590,434,83,9,342,156,137,58,45,34,19,0,0,19,522,469,109,13,347,53,44,44,0,0,9,0,0,9,76033
26281,15788,280,1638,3742,6322,3806,1731,773,755,279,43,433,18,18,0,18,0,0,0,0,0,958,907,389,36,482,51,51,51,0,0,0,0,0,0,76034
26282,1025,37,259,368,219,142,74,37,34,0,0,34,3,3,0,0,3,0,0,0,0,37,31,14,0,17,6,2,2,0,0,4,0,0,4,76035
26283,14175,1428,4352,5260,2040,1095,1278,495,409,188,53,168,86,86,58,0,28,0,0,0,0,783,625,275,104,246,158,111,76,0,35,47,47,0,0,76036
26284,21911,1799,4180,8162,5799,1971,1204,715,681,226,27,428,34,34,10,15,9,0,0,0,0,489,454,132,23,299,35,21,21,0,0,14,0,14,0,76039
26285,18620,2468,4846,6689,3605,1012,1589,604,464,94,5,365,140,112,56,43,13,28,0,28,0,985,660,255,35,370,325,224,173,35,16,101,72,0,29,76040
26286,128,10,62,44,0,12,0,0,0,0,0,0,0,0,0,0,0,0,0,0,0,0,0,0,0,0,0,0,0,0,0,0,0,0,0,76041
26287,4864,753,1306,1450,956,399,456,162,147,61,0,86,15,15,6,0,9,0,0,0,0,294,253,65,21,167,41,33,33,0,0,8,4,0,4,76043
26288,2378,374,821,770,323,90,166,109,93,10,35,48,16,15,15,0,0,1,0,0,1,57,50,7,0,43,7,7,0,0,7,0,0,0,0,76044
26289,15617,2872,4977,5125,1881,762,1130,573,396,80,0,316,177,170,140,0,30,7,0,0,7,557,499,235,6,258,58,46,21,25,0,12,0,0,12,76048
26290,18498,1587,4786,6434,3731,1960,897,477,397,67,0,330,80,80,80,0,0,0,0,0,0,420,292,174,0,118,128,61,46,0,15,67,23,43,1,76049
26291,4143,457,1234,1636,587,229,187,156,154,75,11,68,2,2,2,0,0,0,0,0,0,31,31,9,0,22,0,0,0,0,0,0,0,0,0,76050
26292,31955,2550,6139,9013,9813,4440,2169,1023,954,294,102,558,69,50,50,0,0,19,0,0,19,1146,1037,387,35,615,109,16,7,9,0,93,35,0,58,76051
26293,10701,831,2379,4010,2812,669,583,219,219,31,0,188,0,0,0,0,0,0,0,0,0,364,347,81,90,176,17,17,13,0,4,0,0,0,0,76052
26294,18350,3343,5530,6026,2576,875,1239,846,750,168,53,529,96,84,84,0,0,12,3,9,0,393,359,76,52,231,34,34,9,0,25,0,0,0,0,76053
26295,8375,317,1407,2967,2577,1107,647,396,364,141,50,173,32,14,0,13,1,18,0,18,0,251,234,89,10,135,17,17,17,0,0,0,0,0,0,76054
26296,1918,533,497,640,164,84,105,26,19,6,0,13,7,0,0,0,0,7,5,0,2,79,77,20,7,50,2,2,0,0,2,0,0,0,0,76055
26297,10918,2451,3637,3682,893,255,985,374,296,78,2,216,78,78,54,24,0,0,0,0,0,611,406,133,39,234,205,132,92,8,32,73,0,0,73,76058
26298,2835,549,790,1026,325,145,477,253,237,26,27,184,16,12,0,0,12,4,0,0,4,224,217,25,13,179,7,7,0,0,7,0,0,0,0,76059
26299,4916,668,1241,1894,801,312,288,226,210,65,10,135,16,0,0,0,0,16,0,16,0,62,62,26,0,36,0,0,0,0,0,0,0,0,0,76060
26300,182,0,139,43,0,0,0,0,0,0,0,0,0,0,0,0,0,0,0,0,0,0,0,0,0,0,0,0,0,0,0,0,0,0,0,76061
26301,38455,3039,7811,12264,10418,4923,3902,1931,1700,495,120,1085,231,198,94,88,16,33,0,0,33,1971,1739,603,136,1000,232,172,144,13,15,60,0,0,60,76063
26302,951,125,289,284,218,35,147,77,71,18,0,53,6,4,0,0,4,2,0,2,0,70,70,7,0,63,0,0,0,0,0,0,0,0,0,76064
26303,18567,1298,4980,7133,3677,1479,1726,822,716,135,113,468,106,94,42,52,0,12,0,12,0,904,897,382,112,403,7,0,0,0,0,7,0,0,7,76065
26304,2566,368,1000,731,361,106,86,58,45,22,0,23,13,13,13,0,0,0,0,0,0,28,28,0,0,28,0,0,0,0,0,0,0,0,0,76066
26305,14344,3735,4930,3799,1252,628,1173,764,508,58,69,381,256,86,42,34,10,170,26,0,144,409,223,14,22,187,186,178,94,39,45,8,8,0,0,76067
26306,431,71,69,131,128,32,47,0,0,0,0,0,0,0,0,0,0,0,0,0,0,47,47,47,0,0,0,0,0,0,0,0,0,0,0,76070
26307,2383,250,1036,818,200,79,246,141,121,6,0,115,20,9,2,0,7,11,0,4,7,105,71,29,0,42,34,34,0,25,9,0,0,0,0,76071
26308,3864,411,1547,1283,489,134,237,168,160,89,11,60,8,8,6,0,2,0,0,0,0,69,64,26,0,38,5,5,0,0,5,0,0,0,0,76073
26309,333,59,42,127,105,0,63,46,33,0,0,33,13,13,0,0,13,0,0,0,0,17,17,0,7,10,0,0,0,0,0,0,0,0,0,76077
26310,5375,948,1826,1867,563,171,602,302,214,58,15,141,88,62,5,57,0,26,26,0,0,300,202,53,4,145,98,62,40,17,5,36,12,0,24,76078
26311,11951,1831,4142,4400,1182,396,1312,533,461,70,16,375,72,14,0,0,14,58,0,0,58,779,664,291,85,288,115,33,16,11,6,82,0,0,82,76082
26312,5620,1342,2076,1640,391,171,286,155,155,15,28,112,0,0,0,0,0,0,0,0,0,131,107,47,23,37,24,12,0,0,12,12,0,0,12,76084
26313,5663,724,1714,2060,800,365,474,332,240,54,21,165,92,92,0,92,0,0,0,0,0,142,109,25,7,77,33,18,0,18,0,15,0,0,15,76085
26314,13146,1618,3706,5214,1553,1055,971,440,272,50,17,205,168,131,93,24,14,37,19,0,18,531,425,161,0,264,106,90,70,0,20,16,0,0,16,76086
26315,16944,1502,3924,6033,3773,1712,1558,767,693,272,29,392,74,26,0,26,0,48,36,0,12,791,683,190,54,439,108,41,2,28,11,67,42,0,25,76087
26316,8173,816,2458,3045,1462,392,831,421,333,116,37,180,88,88,35,33,20,0,0,0,0,410,376,164,0,212,34,10,1,0,9,24,24,0,0,76088
26317,16911,330,1530,3592,7284,4175,1960,977,939,305,80,554,38,18,18,0,0,20,0,0,20,983,951,150,61,740,32,32,0,0,32,0,0,0,0,76092
26318,1332,237,468,561,46,20,126,100,89,2,17,70,11,11,0,0,11,0,0,0,0,26,24,10,3,11,2,2,0,0,2,0,0,0,0,76093
26319,6435,1233,1565,1653,1140,844,389,237,82,9,0,73,155,57,0,6,51,98,0,11,87,152,54,5,0,49,98,73,0,57,16,25,7,0,18,76102
26320,8988,2926,2361,2210,948,543,852,520,332,93,11,228,188,42,10,32,0,146,28,27,91,332,267,96,34,137,65,46,27,19,0,19,19,0,0,76103
26321,9751,3952,2797,1988,615,399,767,509,351,12,82,257,158,126,73,26,27,32,0,9,23,258,161,22,51,88,97,87,6,43,38,10,10,0,0,76104
26322,11270,5808,3068,1979,338,77,1621,763,488,68,68,352,275,163,129,10,24,112,18,35,59,858,731,192,95,444,127,93,39,24,30,34,21,0,13,76105
26323,20028,10625,5448,3210,643,102,2342,1212,721,160,37,524,491,177,102,26,49,314,185,12,117,1130,841,111,35,695,289,165,88,34,43,124,30,0,94,76106
26324,18088,2740,3093,4001,5515,2739,991,556,421,15,33,373,135,87,24,50,13,48,21,0,27,435,396,70,19,307,39,39,39,0,0,0,0,0,0,76107
26325,25833,3855,7100,8581,4334,1963,1635,916,717,144,114,459,199,184,106,48,30,15,0,7,8,719,559,145,13,401,160,105,44,6,55,55,12,0,43,76108
26326,13794,369,1672,3205,4714,3834,969,549,492,133,48,311,57,57,19,0,38,0,0,0,0,420,397,154,5,238,23,23,23,0,0,0,0,0,0,76109
26327,18027,7044,3440,3193,2682,1668,2018,859,576,63,65,448,283,141,72,16,53,142,44,45,53,1159,934,106,109,719,225,143,94,0,49,82,0,7,75,76110
26328,12415,5521,3305,2470,625,494,1243,561,377,66,26,285,184,89,20,5,64,95,15,36,44,682,475,93,15,367,207,162,59,58,45,45,0,0,45,76111
26329,25480,5586,7726,7398,3065,1705,2122,1075,770,111,77,582,305,141,74,48,19,164,123,5,36,1047,773,271,98,404,274,185,77,74,34,89,43,0,46,76112
26330,15515,4385,4962,4335,1363,470,1079,534,337,82,20,235,197,109,90,0,19,88,44,0,44,545,378,48,72,258,167,96,16,42,38,71,44,0,27,76114
26331,11128,5732,2686,1700,688,322,1102,562,439,78,32,329,123,66,44,9,13,57,57,0,0,540,459,83,0,376,81,35,16,0,19,46,25,9,12,76115
26332,30330,4653,7459,9093,6026,3099,2454,1498,1064,381,71,612,434,180,147,33,0,254,113,35,106,956,773,142,47,584,183,83,66,0,17,100,26,26,48,76116
26333,19174,5940,6494,5069,1186,485,2002,1121,811,167,89,555,310,167,137,0,30,143,42,33,68,881,693,82,41,570,188,151,61,1,89,37,32,0,5,76117
26334,10076,1388,2371,4028,1527,762,829,309,309,61,14,234,0,0,0,0,0,0,0,0,0,520,399,174,25,200,121,113,70,0,43,8,0,8,0,76118
26335,25640,8931,8298,6150,1683,578,2529,1397,1092,174,73,845,305,131,107,8,16,174,38,33,103,1132,854,255,12,587,278,157,51,30,76,121,15,26,80,76119
26336,10632,1528,3246,3630,1604,624,706,311,187,35,34,118,124,70,0,6,64,54,54,0,0,395,285,54,49,182,110,55,40,0,15,55,46,0,9,76120
26337,18072,1596,4828,5207,4114,2327,2012,1099,876,255,71,550,223,210,160,11,39,13,10,0,3,913,907,209,58,640,6,6,6,0,0,0,0,0,0,76123
26338,14165,893,3054,4821,3591,1806,810,506,446,165,15,266,60,48,47,0,1,12,0,11,1,304,261,120,17,124,43,42,10,0,32,1,0,0,1,76126
26339,1661,375,511,620,84,71,21,21,0,0,0,0,21,21,21,0,0,0,0,0,0,0,0,0,0,0,0,0,0,0,0,0,0,0,0,76127
26340,149,0,0,62,63,24,1818,704,704,135,24,545,0,0,0,0,0,0,0,0,0,1114,1114,284,53,777,0,0,0,0,0,0,0,0,0,76129
26341,19080,2051,4259,7077,4516,1177,1589,605,497,82,109,306,108,103,50,20,33,5,1,0,4,984,851,236,140,475,133,105,40,4,61,28,9,0,19,76131
26342,17027,892,3426,4471,5018,3220,903,417,404,128,43,233,13,0,0,0,0,13,13,0,0,486,351,45,13,293,135,113,102,0,11,22,21,0,1,76132
26343,32804,4163,10805,9685,5411,2740,2502,1371,1181,226,75,880,190,160,90,61,9,30,0,0,30,1131,975,210,81,684,156,86,39,5,42,70,0,0,70,76133
26344,14607,2329,4846,5024,1607,801,1536,912,681,125,168,388,231,141,12,58,71,90,43,47,0,624,479,14,15,450,145,72,6,9,57,73,9,0,64,76134
26345,13998,1828,4623,4897,1727,923,1207,621,523,25,44,454,98,84,29,46,9,14,14,0,0,586,512,187,2,323,74,40,40,0,0,34,0,0,34,76135
26346,33521,2790,8053,12277,7766,2635,3187,1789,1501,377,326,798,288,191,97,51,43,97,63,27,7,1398,1278,525,50,703,120,120,74,18,28,0,0,0,0,76137
26347,16419,3210,5830,5091,1665,623,1644,857,744,168,36,540,113,46,38,8,0,67,44,12,11,787,674,186,24,464,113,35,13,9,13,78,0,0,78,76140
26348,15235,1846,4845,6029,1962,553,1325,752,615,209,145,261,137,100,82,0,18,37,0,37,0,573,458,186,0,272,115,79,11,13,55,36,36,0,0,76148
26349,2742,215,551,895,774,307,121,62,62,0,0,62,0,0,0,0,0,0,0,0,0,59,21,0,0,21,38,0,0,0,0,38,0,38,0,76155
26350,10287,6137,2395,1319,343,93,1439,712,453,45,30,378,259,77,62,11,4,182,100,13,69,727,540,176,29,335,187,54,54,0,0,133,41,38,54,76164
26351,3320,87,549,1245,937,502,62,11,11,0,0,11,0,0,0,0,0,0,0,0,0,51,51,0,8,43,0,0,0,0,0,0,0,0,0,76177
26352,30453,2613,7824,11774,5712,2530,2850,1339,1230,467,94,669,109,109,29,44,36,0,0,0,0,1511,1303,676,178,449,208,208,77,28,103,0,0,0,0,76179
26353,22507,2306,5510,8761,4417,1513,2025,883,658,165,79,414,225,176,163,0,13,49,6,0,43,1142,1032,283,63,686,110,69,39,13,17,41,41,0,0,76180
26354,19964,1198,4491,7312,4873,2090,1573,704,636,208,53,375,68,68,59,0,9,0,0,0,0,869,674,254,0,420,195,131,95,16,20,64,0,64,0,76182
26355,10024,913,1586,2983,2767,1775,5704,1880,1806,399,281,1126,74,51,34,17,0,23,23,0,0,3824,3811,1281,488,2042,13,13,8,0,5,0,0,0,0,76201
26356,10578,1739,2039,2987,2114,1699,1745,1009,831,153,178,500,178,71,28,0,43,107,43,0,64,736,679,196,46,437,57,56,44,0,12,1,1,0,0,76205
26357,7447,573,1591,2668,1770,845,578,274,216,57,55,104,58,58,58,0,0,0,0,0,0,304,240,109,37,94,64,31,31,0,0,33,33,0,0,76207
26358,12210,1519,2489,3730,2895,1577,1295,629,487,103,0,384,142,51,25,0,26,91,91,0,0,666,560,128,0,432,106,46,25,13,8,60,0,60,0,76208
26359,15837,2941,3350,4757,2753,2036,1631,803,582,155,22,405,221,164,82,62,20,57,10,0,47,828,743,273,118,352,85,34,17,9,8,51,1,0,50,76209
26360,25103,1382,3954,9884,6610,3273,2397,1550,1145,201,144,800,405,168,129,14,25,237,0,0,237,847,756,143,0,613,91,44,33,0,11,47,0,9,38,76210
26361,2259,224,984,744,198,109,210,164,150,69,0,81,14,14,14,0,0,0,0,0,0,46,42,7,5,30,4,4,4,0,0,0,0,0,0,76225
26362,12556,469,2040,3286,4877,1884,918,499,499,99,9,391,0,0,0,0,0,0,0,0,0,419,391,109,46,236,28,28,0,0,28,0,0,0,0,76226
26363,14371,827,3346,5329,3617,1252,1112,515,467,223,68,176,48,17,8,9,0,31,29,0,2,597,434,149,2,283,163,111,16,15,80,52,32,15,5,76227
26364,792,95,314,248,111,24,53,38,38,8,0,30,0,0,0,0,0,0,0,0,0,15,15,0,2,13,0,0,0,0,0,0,0,0,0,76228
26365,6505,992,2124,2300,797,292,632,316,222,27,12,183,94,74,47,27,0,20,0,0,20,316,253,87,7,159,63,54,0,45,9,9,0,9,0,76230
26366,2166,247,752,702,278,187,196,76,58,28,12,18,18,10,10,0,0,8,8,0,0,120,106,39,36,31,14,0,0,0,0,14,0,0,14,76233
26367,10095,1615,3503,2644,1738,595,626,353,307,57,47,203,46,13,3,0,10,33,8,0,25,273,230,43,47,140,43,30,13,10,7,13,0,0,13,76234
26368,252,19,63,102,51,17,26,18,18,10,0,8,0,0,0,0,0,0,0,0,0,8,8,0,0,8,0,0,0,0,0,0,0,0,0,76238
26369,779,94,344,198,106,37,50,27,5,3,0,2,22,22,4,0,18,0,0,0,0,23,15,0,0,15,8,4,0,0,4,4,4,0,0,76239
26370,17353,3400,5070,5644,2365,874,1562,838,792,106,83,603,46,39,19,8,12,7,1,0,6,724,550,210,54,286,174,124,94,18,12,50,7,20,23,76240
26371,36896,1682,5405,13751,12005,4053,3005,1304,971,445,62,464,333,217,151,39,27,116,9,0,107,1701,1449,691,129,629,252,200,195,0,5,52,52,0,0,76244
26372,1231,317,471,239,141,63,36,36,36,0,0,36,0,0,0,0,0,0,0,0,0,0,0,0,0,0,0,0,0,0,0,0,0,0,0,76245
26373,8211,1008,2409,2915,1296,583,462,262,250,25,9,216,12,11,11,0,0,1,0,0,1,200,175,40,12,123,25,3,0,0,3,22,22,0,0,76247
26374,22867,765,2993,7017,8093,3999,2191,1295,1246,366,49,831,49,49,49,0,0,0,0,0,0,896,821,274,87,460,75,61,15,0,46,14,0,0,14,76248
26375,4274,391,1281,1585,825,192,421,191,191,26,76,89,0,0,0,0,0,0,0,0,0,230,230,129,28,73,0,0,0,0,0,0,0,0,0,76249
26376,591,24,148,252,132,35,58,23,23,8,0,15,0,0,0,0,0,0,0,0,0,35,35,23,0,12,0,0,0,0,0,0,0,0,0,76250
26377,598,98,203,173,81,43,15,15,10,0,10,0,5,5,0,0,5,0,0,0,0,0,0,0,0,0,0,0,0,0,0,0,0,0,0,76251
26378,2010,142,626,653,469,120,137,86,80,30,0,50,6,3,3,0,0,3,3,0,0,51,51,26,7,18,0,0,0,0,0,0,0,0,0,76252
26379,149,37,60,49,3,0,8,0,0,0,0,0,0,0,0,0,0,0,0,0,0,8,8,6,0,2,0,0,0,0,0,0,0,0,0,76253
26380,4007,998,1146,1390,368,105,207,97,97,0,9,88,0,0,0,0,0,0,0,0,0,110,110,22,13,75,0,0,0,0,0,0,0,0,0,76255
26381,4120,967,957,1288,605,303,235,117,103,11,19,73,14,14,14,0,0,0,0,0,0,118,118,27,13,78,0,0,0,0,0,0,0,0,0,76258
26382,3118,370,1022,1216,378,132,303,155,149,8,4,137,6,6,3,3,0,0,0,0,0,148,131,15,20,96,17,17,17,0,0,0,0,0,0,76259
26383,267,47,65,105,41,9,22,8,8,0,0,8,0,0,0,0,0,0,0,0,0,14,10,0,0,10,4,4,4,0,0,0,0,0,0,76261
26384,19847,359,3416,6505,6693,2874,1538,842,790,107,208,475,52,49,17,0,32,3,0,0,3,696,685,233,10,442,11,0,0,0,0,11,0,0,11,76262
26385,27,4,20,3,0,0,0,0,0,0,0,0,0,0,0,0,0,0,0,0,0,0,0,0,0,0,0,0,0,0,0,0,0,0,0,76263
26386,895,24,312,456,90,13,59,19,19,0,0,19,0,0,0,0,0,0,0,0,0,40,39,39,0,0,1,1,0,0,1,0,0,0,0,76264
26387,1223,170,319,416,219,99,98,16,16,0,5,11,0,0,0,0,0,0,0,0,0,82,75,12,0,63,7,7,0,0,7,0,0,0,0,76265
26388,9188,858,3217,3233,1374,506,722,365,303,67,7,229,62,62,51,0,11,0,0,0,0,357,282,96,7,179,75,13,5,0,8,62,0,33,29,76266
26389,104,11,50,36,2,5,15,9,9,9,0,0,0,0,0,0,0,0,0,0,0,6,6,6,0,0,0,0,0,0,0,0,0,0,0,76268
26390,1272,263,440,322,222,25,58,33,25,0,0,25,8,0,0,0,0,8,0,8,0,25,25,0,0,25,0,0,0,0,0,0,0,0,0,76270
26391,911,115,317,352,101,26,63,12,8,3,3,2,4,0,0,0,0,4,4,0,0,51,42,0,3,39,9,9,0,0,9,0,0,0,0,76271
26392,3324,480,1120,1324,266,134,278,174,86,27,6,53,88,85,2,27,56,3,3,0,0,104,40,14,19,7,64,15,13,0,2,49,0,39,10,76272
26393,5799,889,1746,2089,743,332,474,318,275,52,16,207,43,38,14,0,24,5,5,0,0,156,81,18,0,63,75,10,10,0,0,65,0,20,45,76273
26394,10380,2706,3556,2842,835,441,1136,506,398,105,7,286,108,99,79,12,8,9,9,0,0,630,493,121,85,287,137,120,69,15,36,17,4,0,13,76301
26395,8126,936,2616,2703,1205,666,652,317,284,110,14,160,33,17,11,0,6,16,16,0,0,335,260,90,28,142,75,45,37,0,8,30,8,0,22,76302
26396,3288,443,1289,993,411,152,225,136,103,27,0,76,33,28,1,27,0,5,5,0,0,89,82,12,0,70,7,7,2,0,5,0,0,0,0,76305
26397,9910,1670,3554,3345,901,440,923,418,318,109,36,173,100,100,28,42,30,0,0,0,0,505,431,68,35,328,74,51,40,11,0,23,0,0,23,76306
26398,12115,549,3462,3862,2695,1547,1420,815,743,312,41,390,72,63,63,0,0,9,0,7,2,605,527,149,49,329,78,78,59,10,9,0,0,0,0,76308
26399,8915,1350,2535,2881,1337,812,648,358,264,41,43,180,94,94,94,0,0,0,0,0,0,290,264,55,19,190,26,22,0,0,22,4,0,4,0,76309
26400,12169,973,3577,4238,2168,1213,1053,475,430,139,41,250,45,45,27,0,18,0,0,0,0,578,541,211,33,297,37,37,0,17,20,0,0,0,0,76310
26401,1210,43,154,650,284,79,1582,1304,120,109,0,11,1184,1184,1129,0,55,0,0,0,0,278,58,38,0,20,220,220,215,5,0,0,0,0,0,76311
26402,1180,184,485,356,111,44,87,61,51,0,0,51,10,6,6,0,0,4,0,0,4,26,13,13,0,0,13,6,6,0,0,7,7,0,0,76351
26403,7622,974,2609,2757,820,462,433,211,110,8,11,91,101,100,72,26,2,1,1,0,0,222,207,140,16,51,15,15,0,0,15,0,0,0,0,76354
26404,434,36,188,124,64,22,43,22,22,0,0,22,0,0,0,0,0,0,0,0,0,21,17,5,6,6,4,4,0,0,4,0,0,0,0,76357
26405,2475,449,1087,624,242,73,64,21,14,7,0,7,7,0,0,0,0,7,7,0,0,43,32,0,0,32,11,5,0,0,5,6,0,0,6,76360
26406,201,36,112,42,5,6,5,3,2,0,0,2,1,1,0,1,0,0,0,0,0,2,2,0,2,0,0,0,0,0,0,0,0,0,0,76363
26407,122,31,30,33,9,19,17,17,12,2,0,10,5,4,3,1,0,1,0,0,1,0,0,0,0,0,0,0,0,0,0,0,0,0,0,76364
26408,3401,390,1127,1126,458,300,232,115,88,36,0,52,27,19,19,0,0,8,0,8,0,117,106,16,0,90,11,4,0,0,4,7,0,0,7,76365
26409,1597,218,576,528,243,32,217,121,80,3,0,77,41,41,25,7,9,0,0,0,0,96,90,30,0,60,6,6,0,6,0,0,0,0,0,76366
26410,10819,2566,4198,3233,624,198,523,275,207,42,0,165,68,28,3,0,25,40,0,0,40,248,241,85,17,139,7,7,7,0,0,0,0,0,0,76367
26411,223,57,69,74,5,18,7,4,4,0,0,4,0,0,0,0,0,0,0,0,0,3,0,0,0,0,3,0,0,0,0,3,0,0,3,76370
26412,1171,291,461,268,134,17,38,28,27,0,0,27,1,0,0,0,0,1,0,0,1,10,10,0,0,10,0,0,0,0,0,0,0,0,0,76371
26413,671,112,225,234,74,26,27,15,15,3,0,12,0,0,0,0,0,0,0,0,0,12,12,0,0,12,0,0,0,0,0,0,0,0,0,76372
26414,154,23,86,39,6,0,43,0,0,0,0,0,0,0,0,0,0,0,0,0,0,43,43,0,0,43,0,0,0,0,0,0,0,0,0,76373
26415,2561,471,982,729,251,128,267,203,148,0,24,124,55,30,30,0,0,25,25,0,0,64,64,27,0,37,0,0,0,0,0,0,0,0,0,76374
26416,519,71,277,136,16,19,92,37,37,0,0,37,0,0,0,0,0,0,0,0,0,55,51,21,0,30,4,0,0,0,0,4,0,0,4,76377
26417,433,84,174,114,49,12,46,27,27,4,0,23,0,0,0,0,0,0,0,0,0,19,19,10,0,9,0,0,0,0,0,0,0,0,0,76379
26418,2833,456,877,803,520,177,234,84,69,6,10,53,15,15,15,0,0,0,0,0,0,150,137,9,0,128,13,13,0,0,13,0,0,0,0,76380
26419,8233,1752,2455,2650,994,382,884,534,415,92,45,278,119,8,8,0,0,111,39,0,72,350,232,19,34,179,118,64,30,14,20,54,16,7,31,76384
26420,196,19,90,42,35,10,13,5,5,0,0,5,0,0,0,0,0,0,0,0,0,8,8,4,0,4,0,0,0,0,0,0,0,0,0,76388
26421,878,145,386,198,134,15,96,62,33,3,7,23,29,23,13,0,10,6,6,0,0,34,34,2,0,32,0,0,0,0,0,0,0,0,0,76389
26422,14698,2399,3971,4558,2573,1197,1986,876,775,149,46,580,101,71,4,56,11,30,11,0,19,1110,1058,387,40,631,52,52,30,20,2,0,0,0,0,76401
26423,0,0,0,0,0,0,714,374,374,53,66,255,0,0,0,0,0,0,0,0,0,340,340,70,18,252,0,0,0,0,0,0,0,0,0,76402
26424,5849,1164,2002,1770,709,204,474,374,288,41,23,224,86,48,31,7,10,38,0,0,38,100,40,0,0,40,60,52,37,0,15,8,8,0,0,76424
26425,7270,1571,2383,2244,852,220,699,431,366,120,31,215,65,48,48,0,0,17,15,2,0,268,199,19,22,158,69,29,22,0,7,40,8,29,3,76426
26426,645,165,271,162,47,0,141,45,37,0,0,37,8,2,2,0,0,6,0,6,0,96,80,11,0,69,16,16,16,0,0,0,0,0,0,76427
26427,111,0,25,46,30,10,10,10,10,0,0,10,0,0,0,0,0,0,0,0,0,0,0,0,0,0,0,0,0,0,0,0,0,0,0,76429
26428,1808,204,540,566,375,123,156,85,51,25,0,26,34,29,25,0,4,5,0,0,5,71,71,5,0,66,0,0,0,0,0,0,0,0,0,76430
26429,2279,334,1127,665,110,43,212,126,71,19,0,52,55,27,11,0,16,28,17,0,11,86,53,18,0,35,33,30,0,14,16,3,0,3,0,76431
26430,853,144,353,262,64,30,71,52,48,0,0,48,4,2,0,2,0,2,0,0,2,19,19,0,0,19,0,0,0,0,0,0,0,0,0,76432
26431,1103,70,341,373,290,29,220,47,47,0,0,47,0,0,0,0,0,0,0,0,0,173,165,73,0,92,8,8,0,0,8,0,0,0,0,76433
26432,396,90,86,136,63,21,44,16,16,0,0,16,0,0,0,0,0,0,0,0,0,28,19,0,0,19,9,9,0,0,9,0,0,0,0,76435
26433,88,0,30,20,25,13,0,0,0,0,0,0,0,0,0,0,0,0,0,0,0,0,0,0,0,0,0,0,0,0,0,0,0,0,0,76436
26434,3705,415,1304,1258,563,165,501,201,170,70,0,100,31,31,31,0,0,0,0,0,0,300,263,131,0,132,37,37,0,0,37,0,0,0,0,76437
26435,5305,1323,1848,1179,655,300,439,233,196,33,0,163,37,18,10,0,8,19,0,0,19,206,102,4,0,98,104,104,31,19,54,0,0,0,0,76442
26436,1240,291,468,326,135,20,77,39,39,0,0,39,0,0,0,0,0,0,0,0,0,38,38,0,4,34,0,0,0,0,0,0,0,0,0,76443
26437,2291,631,562,668,300,130,109,56,56,0,8,48,0,0,0,0,0,0,0,0,0,53,53,6,5,42,0,0,0,0,0,0,0,0,0,76444
26438,261,32,86,52,45,46,0,0,0,0,0,0,0,0,0,0,0,0,0,0,0,0,0,0,0,0,0,0,0,0,0,0,0,0,0,76445
26439,5582,1290,1666,1502,822,302,507,238,132,49,33,50,106,52,52,0,0,54,5,0,49,269,268,110,37,121,1,1,0,0,1,0,0,0,0,76446
26440,3966,734,1573,1083,487,89,249,175,165,0,0,165,10,9,0,0,9,1,0,0,1,74,60,0,0,60,14,0,0,0,0,14,14,0,0,76448
26441,1764,307,638,603,126,90,79,35,32,10,3,19,3,3,3,0,0,0,0,0,0,44,38,0,0,38,6,6,0,0,6,0,0,0,0,76449
26442,9484,2061,3116,2688,1168,451,508,244,198,60,0,138,46,46,21,0,25,0,0,0,0,264,235,96,4,135,29,0,0,0,0,29,19,0,10,76450
26443,33,27,0,6,0,0,19,14,14,7,0,7,0,0,0,0,0,0,0,0,0,5,5,5,0,0,0,0,0,0,0,0,0,0,0,76452
26444,801,60,271,260,128,82,66,30,25,11,0,14,5,0,0,0,0,5,5,0,0,36,30,11,0,19,6,6,6,0,0,0,0,0,0,76453
26445,972,203,328,287,122,32,95,16,12,0,0,12,4,4,4,0,0,0,0,0,0,79,79,7,0,72,0,0,0,0,0,0,0,0,0,76454
26446,656,184,269,129,54,20,56,30,29,13,0,16,1,1,0,0,1,0,0,0,0,26,20,8,0,12,6,6,0,0,6,0,0,0,0,76455
26447,3041,713,911,852,375,190,360,218,79,0,0,79,139,50,0,32,18,89,21,68,0,142,134,14,9,111,8,0,0,0,0,8,0,0,8,76457
26448,4133,792,1617,1296,283,145,245,134,113,7,0,106,21,8,8,0,0,13,13,0,0,111,92,36,13,43,19,11,0,11,0,8,0,0,8,76458
26449,127,7,66,50,4,0,3,0,0,0,0,0,0,0,0,0,0,0,0,0,0,3,3,0,0,3,0,0,0,0,0,0,0,0,0,76459
26450,368,70,134,84,7,73,28,0,0,0,0,0,0,0,0,0,0,0,0,0,0,28,28,0,0,28,0,0,0,0,0,0,0,0,0,76460
26451,2098,237,714,734,294,119,197,124,86,12,7,67,38,14,4,0,10,24,21,0,3,73,73,4,0,69,0,0,0,0,0,0,0,0,0,76462
26452,479,78,174,181,24,22,25,14,14,10,0,4,0,0,0,0,0,0,0,0,0,11,11,0,0,11,0,0,0,0,0,0,0,0,0,76463
26453,358,62,141,83,46,26,9,1,1,0,0,1,0,0,0,0,0,0,0,0,0,8,8,6,0,2,0,0,0,0,0,0,0,0,0,76464
26454,161,18,0,52,72,19,0,0,0,0,0,0,0,0,0,0,0,0,0,0,0,0,0,0,0,0,0,0,0,0,0,0,0,0,0,76466
26455,15,5,10,0,0,0,5,0,0,0,0,0,0,0,0,0,0,0,0,0,0,5,5,0,0,5,0,0,0,0,0,0,0,0,0,76469
26456,2041,453,718,691,94,85,293,164,164,31,0,133,0,0,0,0,0,0,0,0,0,129,71,31,0,40,58,36,13,0,23,22,0,0,22,76470
26457,1441,391,434,395,127,94,130,101,97,0,3,94,4,4,4,0,0,0,0,0,0,29,25,0,0,25,4,0,0,0,0,4,0,0,4,76471
26458,857,100,305,256,112,84,164,42,42,0,0,42,0,0,0,0,0,0,0,0,0,122,89,37,0,52,33,33,33,0,0,0,0,0,0,76472
26459,211,14,37,82,65,13,5,0,0,0,0,0,0,0,0,0,0,0,0,0,0,5,5,5,0,0,0,0,0,0,0,0,0,0,0,76474
26460,671,79,284,189,79,40,25,19,9,0,0,9,10,0,0,0,0,10,0,0,10,6,0,0,0,0,6,6,6,0,0,0,0,0,0,76475
26461,1854,170,644,673,295,72,136,84,81,7,12,62,3,3,0,0,3,0,0,0,0,52,44,11,4,29,8,8,6,0,2,0,0,0,0,76476
26462,75,24,34,0,17,0,71,71,0,0,0,0,71,0,0,0,0,71,0,0,71,0,0,0,0,0,0,0,0,0,0,0,0,0,0,76481
26463,663,128,205,183,111,36,33,5,5,0,0,5,0,0,0,0,0,0,0,0,0,28,16,0,0,16,12,9,9,0,0,3,3,0,0,76483
26464,796,185,255,239,42,75,62,62,40,0,12,28,22,11,0,0,11,11,0,0,11,0,0,0,0,0,0,0,0,0,0,0,0,0,0,76484
26465,956,118,352,340,106,40,20,12,12,0,0,12,0,0,0,0,0,0,0,0,0,8,8,6,0,2,0,0,0,0,0,0,0,0,0,76486
26466,1490,225,492,515,211,47,53,26,26,7,6,13,0,0,0,0,0,0,0,0,0,27,27,10,0,17,0,0,0,0,0,0,0,0,0,76487
26467,81,14,50,17,0,0,0,0,0,0,0,0,0,0,0,0,0,0,0,0,0,0,0,0,0,0,0,0,0,0,0,0,0,0,0,76490
26468,377,87,127,106,37,20,36,17,12,0,0,12,5,0,0,0,0,5,0,0,5,19,15,0,0,15,4,0,0,0,0,4,0,0,4,76491
26469,11018,1848,4155,3367,1142,506,935,480,413,112,65,236,67,26,26,0,0,41,18,0,23,455,406,156,27,223,49,29,4,20,5,20,0,3,17,76501
26470,22694,1549,6389,7333,4463,2960,1413,700,643,67,33,543,57,56,0,17,39,1,0,0,1,713,627,217,28,382,86,86,86,0,0,0,0,0,0,76502
26471,15658,2702,5568,4576,1768,1044,1096,348,267,103,9,155,81,51,40,0,11,30,16,0,14,748,572,120,54,398,176,176,114,0,62,0,0,0,0,76504
26472,3,1,0,2,0,0,0,0,0,0,0,0,0,0,0,0,0,0,0,0,0,0,0,0,0,0,0,0,0,0,0,0,0,0,0,76508
26473,1724,489,614,377,167,77,112,56,36,0,8,28,20,16,0,0,16,4,0,4,0,56,53,13,0,40,3,3,3,0,0,0,0,0,0,76511
26474,21175,3129,6097,5957,3726,2266,2563,1156,977,342,151,484,179,112,89,23,0,67,12,28,27,1407,1242,434,39,769,165,122,63,40,19,43,0,0,43,76513
26475,959,153,411,237,99,59,63,36,36,0,0,36,0,0,0,0,0,0,0,0,0,27,17,0,4,13,10,0,0,0,0,10,0,0,10,76518
26476,552,125,197,175,55,0,61,30,30,0,0,30,0,0,0,0,0,0,0,0,0,31,22,0,0,22,9,0,0,0,0,9,9,0,0,76519
26477,5349,1217,1971,1394,579,188,466,312,295,2,0,293,17,10,10,0,0,7,0,0,7,154,154,32,24,98,0,0,0,0,0,0,0,0,0,76520
26478,22610,1630,6188,10311,2914,1567,1790,942,834,157,124,553,108,103,47,56,0,5,5,0,0,848,724,96,36,592,124,122,87,0,35,2,0,0,2,76522
26479,0,0,0,0,0,0,0,0,0,0,0,0,0,0,0,0,0,0,0,0,0,0,0,0,0,0,0,0,0,0,0,0,0,0,0,76523
26480,2143,282,702,860,175,124,230,156,128,26,0,102,28,0,0,0,0,28,9,19,0,74,71,20,0,51,3,0,0,0,0,3,0,0,3,76524
26481,828,114,282,243,125,64,65,11,8,0,0,8,3,3,0,3,0,0,0,0,0,54,44,0,0,44,10,10,3,0,7,0,0,0,0,76525
26482,2691,437,843,969,301,141,296,102,100,18,0,82,2,2,0,2,0,0,0,0,0,194,191,69,0,122,3,3,0,0,3,0,0,0,0,76527
26483,12760,2390,4671,3847,1241,611,849,384,281,72,0,209,103,57,35,0,22,46,0,25,21,465,349,134,1,214,116,96,40,8,48,20,20,0,0,76528
26484,1770,335,619,534,173,109,96,68,57,8,0,49,11,11,8,0,3,0,0,0,0,28,23,5,0,18,5,0,0,0,0,5,0,0,5,76530
26485,3502,579,1289,1053,450,131,158,45,45,18,0,27,0,0,0,0,0,0,0,0,0,113,101,23,0,78,12,12,0,0,12,0,0,0,0,76531
26486,1456,194,596,478,153,35,119,78,59,16,0,43,19,19,10,0,9,0,0,0,0,41,32,0,0,32,9,9,9,0,0,0,0,0,0,76534
26487,2537,515,825,929,151,117,164,98,78,32,16,30,20,17,0,9,8,3,0,0,3,66,66,15,0,51,0,0,0,0,0,0,0,0,0,76537
26488,564,42,213,212,82,15,103,52,52,5,0,47,0,0,0,0,0,0,0,0,0,51,51,0,3,48,0,0,0,0,0,0,0,0,0,76538
26489,5252,406,1433,2587,499,327,474,237,223,36,14,173,14,0,0,0,0,14,0,0,14,237,147,24,0,123,90,90,24,0,66,0,0,0,0,76539
26490,11849,1999,3936,4615,1020,279,887,446,336,92,10,234,110,110,100,0,10,0,0,0,0,441,176,87,15,74,265,195,99,0,96,70,16,22,32,76541
26491,23863,1471,6353,10375,3773,1891,2130,1182,1093,197,61,835,89,89,64,0,25,0,0,0,0,948,734,244,131,359,214,214,115,10,89,0,0,0,0,76542
26492,16694,1491,5754,7313,1435,701,1102,693,446,131,72,243,247,130,104,26,0,117,0,37,80,409,298,41,37,220,111,111,93,0,18,0,0,0,0,76543
26493,11655,531,3144,6462,1144,374,2344,1545,407,97,16,294,1138,1070,934,0,136,68,13,0,55,799,381,98,46,237,418,356,231,4,121,62,0,0,62,76544
26494,15890,1592,3756,6158,2870,1514,1791,1022,724,166,101,457,298,284,135,33,116,14,14,0,0,769,660,154,0,506,109,88,35,0,53,21,21,0,0,76548
26495,25749,1772,6313,12873,3600,1191,2755,1483,1199,276,140,783,284,95,95,0,0,189,83,0,106,1272,1065,74,275,716,207,166,32,0,134,41,0,10,31,76549
26496,7977,1530,2455,2326,1082,584,665,384,205,0,0,205,179,102,47,37,18,77,15,50,12,281,209,21,36,152,72,62,7,55,0,10,0,0,10,76550
26497,1248,117,495,453,110,73,125,66,60,12,6,42,6,6,6,0,0,0,0,0,0,59,59,20,0,39,0,0,0,0,0,0,0,0,0,76554
26498,1046,158,442,294,98,54,85,58,30,6,4,20,28,19,19,0,0,9,0,0,9,27,19,1,0,18,8,0,0,0,0,8,0,0,8,76556
26499,3154,404,1014,1285,364,87,356,146,138,33,0,105,8,8,5,0,3,0,0,0,0,210,178,28,10,140,32,26,6,0,20,6,0,6,0,76557
26500,2792,359,680,1201,349,203,196,82,82,0,36,46,0,0,0,0,0,0,0,0,0,114,94,21,0,73,20,20,20,0,0,0,0,0,0,76559
26501,721,128,279,222,74,18,45,21,14,4,0,10,7,6,6,0,0,1,0,1,0,24,24,2,0,22,0,0,0,0,0,0,0,0,0,76561
26502,45,9,21,0,15,0,0,0,0,0,0,0,0,0,0,0,0,0,0,0,0,0,0,0,0,0,0,0,0,0,0,0,0,0,0,76565
26503,132,33,44,33,20,2,10,2,2,1,0,1,0,0,0,0,0,0,0,0,0,8,7,3,0,4,1,1,1,0,0,0,0,0,0,76566
26504,6122,923,2340,1931,675,253,511,194,161,12,41,108,33,0,0,0,0,33,17,0,16,317,195,0,28,167,122,51,51,0,0,71,8,56,7,76567
26505,1276,203,636,343,58,36,79,39,33,0,0,33,6,6,0,0,6,0,0,0,0,40,40,0,5,35,0,0,0,0,0,0,0,0,0,76569
26506,2003,351,791,554,182,125,147,79,69,0,15,54,10,10,6,4,0,0,0,0,0,68,49,9,0,40,19,19,19,0,0,0,0,0,0,76570
26507,4147,261,1016,1184,994,692,223,91,91,33,0,58,0,0,0,0,0,0,0,0,0,132,132,49,6,77,0,0,0,0,0,0,0,0,0,76571
26508,16,0,5,11,0,0,0,0,0,0,0,0,0,0,0,0,0,0,0,0,0,0,0,0,0,0,0,0,0,0,0,0,0,0,0,76573
26509,12157,2429,4656,3229,1306,537,920,404,321,55,33,233,83,83,67,16,0,0,0,0,0,516,450,105,37,308,66,56,48,8,0,10,0,0,10,76574
26510,2356,507,1043,520,224,62,187,133,133,44,19,70,0,0,0,0,0,0,0,0,0,54,46,22,0,24,8,8,8,0,0,0,0,0,0,76577
26511,1141,132,426,354,202,27,140,89,84,21,0,63,5,5,5,0,0,0,0,0,0,51,49,18,0,31,2,2,2,0,0,0,0,0,0,76578
26512,3104,504,1089,990,328,193,173,80,71,3,0,68,9,9,9,0,0,0,0,0,0,93,44,14,0,30,49,29,29,0,0,20,0,5,15,76579
26513,895,235,322,322,12,4,0,0,0,0,0,0,0,0,0,0,0,0,0,0,0,0,0,0,0,0,0,0,0,0,0,0,0,0,0,76596
26514,1832,513,735,514,36,34,0,0,0,0,0,0,0,0,0,0,0,0,0,0,0,0,0,0,0,0,0,0,0,0,0,0,0,0,0,76597
26515,340,117,97,123,0,3,0,0,0,0,0,0,0,0,0,0,0,0,0,0,0,0,0,0,0,0,0,0,0,0,0,0,0,0,0,76598
26516,1223,321,434,432,14,22,0,0,0,0,0,0,0,0,0,0,0,0,0,0,0,0,0,0,0,0,0,0,0,0,0,0,0,0,0,76599
26517,754,58,262,281,103,50,42,24,23,16,0,7,1,1,0,1,0,0,0,0,0,18,18,11,0,7,0,0,0,0,0,0,0,0,0,76621
26518,810,169,293,256,74,18,39,22,7,0,0,7,15,15,15,0,0,0,0,0,0,17,14,0,0,14,3,0,0,0,0,3,0,0,3,76622
26519,95,39,27,24,5,0,6,0,0,0,0,0,0,0,0,0,0,0,0,0,0,6,6,6,0,0,0,0,0,0,0,0,0,0,0,76623
26520,1359,236,485,464,101,73,249,145,127,0,21,106,18,0,0,0,0,18,18,0,0,104,82,9,0,73,22,22,22,0,0,0,0,0,0,76624
26521,1213,138,409,374,235,57,116,49,43,31,0,12,6,6,4,2,0,0,0,0,0,67,50,26,0,24,17,13,10,0,3,4,0,0,4,76626
26522,1105,301,400,352,38,14,50,34,23,0,3,20,11,11,6,0,5,0,0,0,0,16,10,0,3,7,6,6,0,0,6,0,0,0,0,76627
26523,49,18,25,6,0,0,5,0,0,0,0,0,0,0,0,0,0,0,0,0,0,5,0,0,0,0,5,5,0,5,0,0,0,0,0,76628
26524,1445,282,581,433,107,42,81,70,62,2,17,43,8,0,0,0,0,8,0,0,8,11,11,0,0,11,0,0,0,0,0,0,0,0,0,76629
26525,1117,87,346,499,117,68,27,16,13,0,0,13,3,3,3,0,0,0,0,0,0,11,11,0,0,11,0,0,0,0,0,0,0,0,0,76630
26526,385,42,195,94,22,32,21,20,14,2,0,12,6,6,0,0,6,0,0,0,0,1,0,0,0,0,1,1,0,0,1,0,0,0,0,76631
26527,911,351,306,192,38,24,74,48,35,8,0,27,13,0,0,0,0,13,0,0,13,26,26,0,7,19,0,0,0,0,0,0,0,0,0,76632
26528,3995,389,1123,1233,845,405,359,250,217,73,12,132,33,33,0,0,33,0,0,0,0,109,109,42,0,67,0,0,0,0,0,0,0,0,0,76633
26529,4777,762,1663,1489,577,286,312,203,187,18,44,125,16,14,0,0,14,2,0,0,2,109,102,29,11,62,7,7,5,0,2,0,0,0,0,76634
26530,834,283,293,197,15,46,102,78,50,10,0,40,28,19,13,0,6,9,0,2,7,24,15,0,0,15,9,9,9,0,0,0,0,0,0,76635
26531,1030,135,377,410,59,49,84,26,26,2,0,24,0,0,0,0,0,0,0,0,0,58,56,2,6,48,2,2,0,2,0,0,0,0,0,76636
26532,450,70,113,131,98,38,16,7,7,6,1,0,0,0,0,0,0,0,0,0,0,9,9,7,0,2,0,0,0,0,0,0,0,0,0,76637
26533,2050,80,554,659,530,227,163,129,120,14,0,106,9,0,0,0,0,9,9,0,0,34,20,3,0,17,14,7,3,4,0,7,0,0,7,76638
26534,988,153,389,292,117,37,30,14,4,2,0,2,10,8,8,0,0,2,0,0,2,16,16,0,0,16,0,0,0,0,0,0,0,0,0,76639
26535,2017,428,762,657,120,50,69,24,24,7,9,8,0,0,0,0,0,0,0,0,0,45,19,0,0,19,26,0,0,0,0,26,0,0,26,76640
26536,1132,302,456,254,98,22,93,19,17,4,0,13,2,2,2,0,0,0,0,0,0,74,74,6,13,55,0,0,0,0,0,0,0,0,0,76641
26537,4980,1266,1983,1114,451,166,383,280,198,0,47,151,82,72,18,0,54,10,0,0,10,103,78,9,0,69,25,0,0,0,0,25,0,25,0,76642
26538,9131,538,2292,3333,2103,865,729,372,352,128,0,224,20,20,20,0,0,0,0,0,0,357,307,141,19,147,50,0,0,0,0,50,0,0,50,76643
26539,7018,1803,1867,2256,669,423,828,391,335,53,0,282,56,31,28,0,3,25,25,0,0,437,370,90,17,263,67,60,32,6,22,7,0,0,7,76645
26540,1751,313,643,550,167,78,105,58,56,13,3,40,2,0,0,0,0,2,0,0,2,47,43,1,17,25,4,2,2,0,0,2,0,0,2,76648
26541,578,87,223,157,80,31,41,27,25,0,9,16,2,1,1,0,0,1,1,0,0,14,14,13,0,1,0,0,0,0,0,0,0,0,0,76649
26542,49,2,14,20,13,0,6,6,6,0,0,6,0,0,0,0,0,0,0,0,0,0,0,0,0,0,0,0,0,0,0,0,0,0,0,76650
26543,2225,500,675,744,236,70,210,123,113,4,7,102,10,10,5,0,5,0,0,0,0,87,87,20,0,67,0,0,0,0,0,0,0,0,0,76651
26544,718,151,279,212,67,9,53,11,11,0,0,11,0,0,0,0,0,0,0,0,0,42,42,13,0,29,0,0,0,0,0,0,0,0,0,76652
26545,665,78,223,316,28,20,64,17,17,0,2,15,0,0,0,0,0,0,0,0,0,47,22,3,4,15,25,25,22,0,3,0,0,0,0,76653
26546,92,14,18,46,14,0,0,0,0,0,0,0,0,0,0,0,0,0,0,0,0,0,0,0,0,0,0,0,0,0,0,0,0,0,0,76654
26547,5946,606,1558,2149,1080,553,512,378,351,119,0,232,27,27,27,0,0,0,0,0,0,134,134,86,2,46,0,0,0,0,0,0,0,0,0,76655
26548,1640,475,546,456,136,27,183,106,87,3,0,84,19,8,8,0,0,11,11,0,0,77,77,0,0,77,0,0,0,0,0,0,0,0,0,76656
26549,5742,594,1872,1599,1100,577,581,287,261,14,17,230,26,26,0,26,0,0,0,0,0,294,276,61,0,215,18,18,18,0,0,0,0,0,0,76657
26550,330,58,112,120,28,12,18,15,15,0,0,15,0,0,0,0,0,0,0,0,0,3,3,0,0,3,0,0,0,0,0,0,0,0,0,76660
26551,5513,1709,2068,1273,325,138,603,266,218,17,0,201,48,25,25,0,0,23,23,0,0,337,211,70,7,134,126,51,22,20,9,75,63,12,0,76661
26552,1974,335,749,579,193,118,364,279,264,3,4,257,15,0,0,0,0,15,0,0,15,85,70,5,6,59,15,6,6,0,0,9,0,4,5,76664
26553,1641,389,536,531,100,85,178,98,96,27,0,69,2,2,0,0,2,0,0,0,0,80,75,18,0,57,5,5,0,0,5,0,0,0,0,76665
26554,124,26,42,30,22,4,4,1,1,0,0,1,0,0,0,0,0,0,0,0,0,3,3,2,0,1,0,0,0,0,0,0,0,0,0,76666
26555,7480,1441,2704,2364,743,228,744,329,267,18,32,217,62,51,16,0,35,11,3,0,8,415,323,142,40,141,92,23,14,7,2,69,0,1,68,76667
26556,869,167,324,282,87,9,92,25,14,0,0,14,11,5,5,0,0,6,0,6,0,67,57,10,0,47,10,0,0,0,0,10,0,4,6,76670
26557,1526,297,542,545,92,50,111,33,33,6,12,15,0,0,0,0,0,0,0,0,0,78,46,16,6,24,32,32,32,0,0,0,0,0,0,76671
26558,921,219,321,280,60,41,40,27,14,3,2,9,13,8,3,4,1,5,5,0,0,13,7,0,5,2,6,6,6,0,0,0,0,0,0,76673
26559,265,62,87,95,18,3,14,9,3,3,0,0,6,6,0,0,6,0,0,0,0,5,2,0,0,2,3,3,3,0,0,0,0,0,0,76676
26560,166,36,22,81,26,1,2,0,0,0,0,0,0,0,0,0,0,0,0,0,0,2,2,0,0,2,0,0,0,0,0,0,0,0,0,76678
26561,899,128,376,269,87,39,85,37,37,15,4,18,0,0,0,0,0,0,0,0,0,48,48,0,0,48,0,0,0,0,0,0,0,0,0,76679
26562,278,31,174,27,46,0,0,0,0,0,0,0,0,0,0,0,0,0,0,0,0,0,0,0,0,0,0,0,0,0,0,0,0,0,0,76680
26563,459,152,122,117,55,13,6,2,2,0,0,2,0,0,0,0,0,0,0,0,0,4,4,0,0,4,0,0,0,0,0,0,0,0,0,76681
26564,1778,301,650,527,171,129,132,87,77,12,2,63,10,10,10,0,0,0,0,0,0,45,38,8,2,28,7,0,0,0,0,7,7,0,0,76682
26565,4,4,0,0,0,0,0,0,0,0,0,0,0,0,0,0,0,0,0,0,0,0,0,0,0,0,0,0,0,0,0,0,0,0,0,76685
26566,187,30,61,50,35,11,12,8,8,0,0,8,0,0,0,0,0,0,0,0,0,4,4,0,0,4,0,0,0,0,0,0,0,0,0,76686
26567,1389,235,570,458,103,23,115,50,25,22,0,3,25,0,0,0,0,25,19,0,6,65,7,3,0,4,58,17,17,0,0,41,0,0,41,76687
26568,2496,306,716,1003,332,139,204,83,60,0,3,57,23,0,0,0,0,23,17,0,6,121,121,3,12,106,0,0,0,0,0,0,0,0,0,76689
26569,688,165,262,185,64,12,39,25,22,0,7,15,3,2,0,2,0,1,1,0,0,14,3,0,3,0,11,11,11,0,0,0,0,0,0,76690
26570,4189,654,1551,1414,398,172,330,127,110,17,0,93,17,17,0,17,0,0,0,0,0,203,166,94,15,57,37,37,35,2,0,0,0,0,0,76691
26571,7201,1356,2114,2479,977,275,440,224,194,31,0,163,30,28,16,12,0,2,0,0,2,216,147,66,30,51,69,53,0,22,31,16,0,0,16,76692
26572,986,146,345,375,78,42,58,38,24,15,0,9,14,14,7,7,0,0,0,0,0,20,14,0,0,14,6,6,6,0,0,0,0,0,0,76693
26573,1069,341,274,292,85,77,74,38,3,0,0,3,35,10,0,10,0,25,17,0,8,36,36,9,0,27,0,0,0,0,0,0,0,0,0,76701
26574,4298,1085,1564,1299,267,83,445,190,176,44,0,132,14,14,0,11,3,0,0,0,0,255,244,52,65,127,11,11,11,0,0,0,0,0,0,76704
26575,18003,3912,5479,6673,1273,666,2114,1153,976,175,72,729,177,38,15,13,10,139,63,8,68,961,761,211,24,526,200,96,36,8,52,104,38,12,54,76705
26576,15803,3971,4738,4120,1786,1188,4427,2444,2274,414,86,1774,170,79,37,27,15,91,9,0,82,1983,1862,521,57,1284,121,74,31,33,10,47,0,0,47,76706
26577,8537,2945,2586,1980,685,341,1033,537,382,79,19,284,155,146,111,35,0,9,0,0,9,496,379,100,33,246,117,43,17,13,13,74,16,0,58,76707
26578,15784,3274,4080,5467,1895,1068,1521,687,535,93,17,425,152,91,49,15,27,61,17,28,16,834,638,152,30,456,196,89,62,14,13,107,0,64,43,76708
26579,15955,1958,4157,5267,3184,1389,948,465,361,67,0,294,104,57,29,0,28,47,0,0,47,483,464,224,19,221,19,7,0,0,7,12,12,0,0,76710
26580,5191,2103,1496,1239,284,69,386,258,216,69,6,141,42,42,31,0,11,0,0,0,0,128,81,10,6,65,47,36,0,19,17,11,8,0,3,76711
26581,16389,1133,3470,5482,3805,2499,877,570,556,166,11,379,14,14,14,0,0,0,0,0,0,307,293,61,21,211,14,14,14,0,0,0,0,0,0,76712
26582,0,0,0,0,0,0,1620,255,255,44,0,211,0,0,0,0,0,0,0,0,0,1365,1365,210,0,1155,0,0,0,0,0,0,0,0,0,76798
26583,16230,2596,6176,4827,1839,792,1773,804,650,113,14,523,154,135,53,13,69,19,19,0,0,969,903,38,40,825,66,56,2,0,54,10,0,0,10,76801
26584,3432,309,1617,939,399,168,296,184,161,46,8,107,23,18,13,5,0,5,5,0,0,112,96,28,0,68,16,16,6,0,10,0,0,0,0,76802
26585,108,0,46,49,13,0,0,0,0,0,0,0,0,0,0,0,0,0,0,0,0,0,0,0,0,0,0,0,0,0,0,0,0,0,0,76820
26586,3283,727,1321,705,379,151,328,269,252,0,18,234,17,17,0,17,0,0,0,0,0,59,55,0,0,55,4,4,4,0,0,0,0,0,0,76821
26587,2498,469,900,797,281,51,122,65,54,0,0,54,11,8,8,0,0,3,0,0,3,57,54,13,0,41,3,3,3,0,0,0,0,0,0,76823
26588,0,0,0,0,0,0,0,0,0,0,0,0,0,0,0,0,0,0,0,0,0,0,0,0,0,0,0,0,0,0,0,0,0,0,0,76824
26589,4809,1157,1685,1292,494,181,421,209,180,34,5,141,29,19,19,0,0,10,0,0,10,212,109,9,18,82,103,94,89,0,5,9,0,0,9,76825
26590,205,38,99,27,36,5,25,17,14,0,0,14,3,3,3,0,0,0,0,0,0,8,4,0,0,4,4,4,4,0,0,0,0,0,0,76827
26591,117,24,50,38,5,0,0,0,0,0,0,0,0,0,0,0,0,0,0,0,0,0,0,0,0,0,0,0,0,0,0,0,0,0,0,76828
26592,55,10,0,11,34,0,19,0,0,0,0,0,0,0,0,0,0,0,0,0,0,19,19,0,0,19,0,0,0,0,0,0,0,0,0,76831
26593,433,56,170,145,50,12,11,7,7,0,0,7,0,0,0,0,0,0,0,0,0,4,4,0,0,4,0,0,0,0,0,0,0,0,0,76832
26594,3916,712,1481,1197,419,107,239,121,90,10,13,67,31,20,20,0,0,11,0,0,11,118,33,17,0,16,85,31,13,18,0,54,34,0,20,76834
26595,8,0,0,5,3,0,0,0,0,0,0,0,0,0,0,0,0,0,0,0,0,0,0,0,0,0,0,0,0,0,0,0,0,0,0,76836
26596,2556,858,972,458,175,93,69,25,5,0,0,5,20,20,20,0,0,0,0,0,0,44,44,38,0,6,0,0,0,0,0,0,0,0,0,76837
26597,19,8,11,0,0,0,0,0,0,0,0,0,0,0,0,0,0,0,0,0,0,0,0,0,0,0,0,0,0,0,0,0,0,0,0,76841
26598,73,0,15,36,5,17,0,0,0,0,0,0,0,0,0,0,0,0,0,0,0,0,0,0,0,0,0,0,0,0,0,0,0,0,0,76842
26599,2569,531,687,780,401,170,147,69,68,27,0,41,1,0,0,0,0,1,1,0,0,78,75,7,0,68,3,3,3,0,0,0,0,0,0,76844
26600,113,3,66,9,26,9,17,17,17,3,12,2,0,0,0,0,0,0,0,0,0,0,0,0,0,0,0,0,0,0,0,0,0,0,0,76845
26601,75,0,19,22,17,17,0,0,0,0,0,0,0,0,0,0,0,0,0,0,0,0,0,0,0,0,0,0,0,0,0,0,0,0,0,76848
26602,3078,663,1024,799,410,182,148,80,77,17,19,41,3,0,0,0,0,3,3,0,0,68,55,8,0,47,13,13,6,7,0,0,0,0,0,76849
26603,193,16,56,83,29,9,2,2,2,0,0,2,0,0,0,0,0,0,0,0,0,0,0,0,0,0,0,0,0,0,0,0,0,0,0,76852
26604,977,179,352,280,116,50,111,63,62,17,1,44,1,1,1,0,0,0,0,0,0,48,38,15,11,12,10,0,0,0,0,10,0,0,10,76853
26605,177,22,80,75,0,0,0,0,0,0,0,0,0,0,0,0,0,0,0,0,0,0,0,0,0,0,0,0,0,0,0,0,0,0,0,76854
26606,2747,537,730,739,516,225,121,94,94,0,0,94,0,0,0,0,0,0,0,0,0,27,27,13,0,14,0,0,0,0,0,0,0,0,0,76856
26607,1587,175,700,432,210,70,84,27,27,0,0,27,0,0,0,0,0,0,0,0,0,57,57,2,0,55,0,0,0,0,0,0,0,0,0,76857
26608,253,45,71,110,25,2,9,9,9,0,0,9,0,0,0,0,0,0,0,0,0,0,0,0,0,0,0,0,0,0,0,0,0,0,0,76858
26609,1301,343,390,333,151,84,150,40,36,0,16,20,4,4,4,0,0,0,0,0,0,110,106,68,0,38,4,0,0,0,0,4,0,4,0,76859
26610,1512,298,607,373,189,45,141,84,69,25,13,31,15,15,15,0,0,0,0,0,0,57,53,3,0,50,4,0,0,0,0,4,0,0,4,76861
26611,268,7,211,34,14,2,0,0,0,0,0,0,0,0,0,0,0,0,0,0,0,0,0,0,0,0,0,0,0,0,0,0,0,0,0,76862
26612,468,79,189,95,59,46,58,29,24,3,0,21,5,5,0,5,0,0,0,0,0,29,29,0,2,27,0,0,0,0,0,0,0,0,0,76864
26613,153,7,69,57,20,0,0,0,0,0,0,0,0,0,0,0,0,0,0,0,0,0,0,0,0,0,0,0,0,0,0,0,0,0,0,76865
26614,423,90,145,114,45,29,12,8,8,0,0,8,0,0,0,0,0,0,0,0,0,4,4,0,0,4,0,0,0,0,0,0,0,0,0,76866
26615,22,0,9,13,0,0,0,0,0,0,0,0,0,0,0,0,0,0,0,0,0,0,0,0,0,0,0,0,0,0,0,0,0,0,0,76869
26616,135,19,44,47,18,7,18,9,9,0,0,9,0,0,0,0,0,0,0,0,0,9,9,0,0,9,0,0,0,0,0,0,0,0,0,76870
26617,523,63,172,171,104,13,43,31,17,0,0,17,14,14,14,0,0,0,0,0,0,12,6,3,0,3,6,6,0,0,6,0,0,0,0,76871
26618,535,98,172,139,96,30,6,6,6,0,0,6,0,0,0,0,0,0,0,0,0,0,0,0,0,0,0,0,0,0,0,0,0,0,0,76872
26619,78,45,6,8,14,5,0,0,0,0,0,0,0,0,0,0,0,0,0,0,0,0,0,0,0,0,0,0,0,0,0,0,0,0,0,76873
26620,49,0,25,0,24,0,0,0,0,0,0,0,0,0,0,0,0,0,0,0,0,0,0,0,0,0,0,0,0,0,0,0,0,0,0,76874
26621,428,50,171,126,75,6,37,7,7,0,0,7,0,0,0,0,0,0,0,0,0,30,25,20,0,5,5,0,0,0,0,5,0,0,5,76875
26622,3239,696,1175,1023,254,91,214,155,99,46,0,53,56,56,29,27,0,0,0,0,0,59,59,0,14,45,0,0,0,0,0,0,0,0,0,76877
26623,1224,225,509,280,172,38,161,108,98,13,0,85,10,10,10,0,0,0,0,0,0,53,32,5,0,27,21,21,21,0,0,0,0,0,0,76878
26624,214,9,131,64,5,5,24,16,16,0,0,16,0,0,0,0,0,0,0,0,0,8,8,0,0,8,0,0,0,0,0,0,0,0,0,76882
26625,96,3,55,10,12,16,0,0,0,0,0,0,0,0,0,0,0,0,0,0,0,0,0,0,0,0,0,0,0,0,0,0,0,0,0,76884
26626,58,0,44,7,7,0,11,11,11,0,0,11,0,0,0,0,0,0,0,0,0,0,0,0,0,0,0,0,0,0,0,0,0,0,0,76885
26627,110,0,66,0,24,20,23,23,23,23,0,0,0,0,0,0,0,0,0,0,0,0,0,0,0,0,0,0,0,0,0,0,0,0,0,76887
26628,60,8,28,10,14,0,0,0,0,0,0,0,0,0,0,0,0,0,0,0,0,0,0,0,0,0,0,0,0,0,0,0,0,0,0,76888
26629,706,56,340,182,117,11,17,8,8,0,0,8,0,0,0,0,0,0,0,0,0,9,7,0,0,7,2,2,2,0,0,0,0,0,0,76890
26630,18049,3092,6125,5446,2353,1033,1188,560,454,153,0,301,106,22,10,12,0,84,18,31,35,628,471,205,24,242,157,135,94,33,8,22,0,22,0,76901
26631,20480,6245,7346,4854,1562,473,1785,911,575,197,52,326,336,263,207,20,36,73,73,0,0,874,684,146,0,538,190,179,75,0,104,11,0,11,0,76903
26632,20669,1088,4588,7585,4687,2721,2730,1247,932,271,76,585,315,181,167,14,0,134,103,0,31,1483,1290,427,259,604,193,82,37,23,22,111,38,22,51,76904
26633,7725,1411,2503,2358,1081,372,537,274,155,24,7,124,119,97,68,17,12,22,5,17,0,263,256,62,0,194,7,7,0,0,7,0,0,0,0,76905
26634,592,0,76,277,171,68,746,547,12,12,0,0,535,535,523,12,0,0,0,0,0,199,4,4,0,0,195,195,195,0,0,0,0,0,0,76908
26635,97,12,41,44,0,0,6,6,0,0,0,0,6,0,0,0,0,6,0,0,6,0,0,0,0,0,0,0,0,0,0,0,0,0,0,76930
26636,2206,827,733,400,196,50,169,115,91,39,0,52,24,7,0,0,7,17,0,0,17,54,54,1,11,42,0,0,0,0,0,0,0,0,0,76932
26637,906,153,311,266,132,44,139,82,68,0,14,54,14,4,0,0,4,10,0,0,10,57,46,32,0,14,11,11,0,0,11,0,0,0,0,76933
26638,1024,181,530,212,74,27,67,24,14,6,3,5,10,3,0,0,3,7,0,0,7,43,41,8,0,33,2,0,0,0,0,2,0,0,2,76934
26639,957,91,193,287,296,90,45,26,26,0,0,26,0,0,0,0,0,0,0,0,0,19,19,8,0,11,0,0,0,0,0,0,0,0,0,76935
26640,1912,455,562,488,317,90,272,150,84,20,0,64,66,66,36,0,30,0,0,0,0,122,92,50,13,29,30,30,5,17,8,0,0,0,0,76936
26641,18,0,0,10,8,0,0,0,0,0,0,0,0,0,0,0,0,0,0,0,0,0,0,0,0,0,0,0,0,0,0,0,0,0,0,76937
26642,66,24,31,11,0,0,28,28,28,0,0,28,0,0,0,0,0,0,0,0,0,0,0,0,0,0,0,0,0,0,0,0,0,0,0,76939
26643,51,17,1,21,0,12,0,0,0,0,0,0,0,0,0,0,0,0,0,0,0,0,0,0,0,0,0,0,0,0,0,0,0,0,0,76940
26644,983,179,445,246,83,30,48,42,42,22,0,20,0,0,0,0,0,0,0,0,0,6,6,0,0,6,0,0,0,0,0,0,0,0,0,76941
26645,2536,937,652,679,119,149,260,122,74,0,32,42,48,19,19,0,0,29,18,0,11,138,54,10,0,44,84,67,0,0,67,17,17,0,0,76943
26646,1247,189,471,394,113,80,75,37,25,9,0,16,12,12,0,0,12,0,0,0,0,38,30,21,0,9,8,8,8,0,0,0,0,0,0,76945
26647,18,0,8,6,4,0,0,0,0,0,0,0,0,0,0,0,0,0,0,0,0,0,0,0,0,0,0,0,0,0,0,0,0,0,0,76949
26648,2581,593,775,749,334,130,213,123,111,70,0,41,12,0,0,0,0,12,12,0,0,90,71,0,7,64,19,19,0,0,19,0,0,0,0,76950
26649,867,200,271,203,146,47,138,108,91,43,0,48,17,17,0,0,17,0,0,0,0,30,30,27,3,0,0,0,0,0,0,0,0,0,0,76951
26650,29,0,17,12,0,0,0,0,0,0,0,0,0,0,0,0,0,0,0,0,0,0,0,0,0,0,0,0,0,0,0,0,0,0,0,76953
26651,0,0,0,0,0,0,0,0,0,0,0,0,0,0,0,0,0,0,0,0,0,0,0,0,0,0,0,0,0,0,0,0,0,0,0,76955
26652,0,0,0,0,0,0,0,0,0,0,0,0,0,0,0,0,0,0,0,0,0,0,0,0,0,0,0,0,0,0,0,0,0,0,0,76957
26653,196,7,65,48,44,32,18,9,9,0,0,9,0,0,0,0,0,0,0,0,0,9,9,0,0,9,0,0,0,0,0,0,0,0,0,76958
26654,9080,2413,2318,1906,1389,1054,671,659,186,0,0,186,473,172,0,0,172,301,0,0,301,12,3,0,0,3,9,0,0,0,0,9,0,0,9,77002
26655,6887,2191,1384,1426,1141,745,754,325,257,68,0,189,68,68,22,0,46,0,0,0,0,429,311,47,30,234,118,27,27,0,0,91,0,45,46,77003
26656,19014,2998,2899,4437,4387,4293,3265,1483,1395,188,52,1155,88,46,40,0,6,42,28,14,0,1782,1675,463,93,1119,107,41,20,17,4,66,0,35,31,77004
26657,16341,262,689,1969,5473,7948,2191,1172,1172,252,18,902,0,0,0,0,0,0,0,0,0,1019,997,198,70,729,22,22,0,0,22,0,0,0,0,77005
26658,16539,557,1801,3086,5607,5488,359,166,153,59,0,94,13,4,0,2,2,9,2,0,7,193,188,56,7,125,5,3,3,0,0,2,0,2,0,77006
26659,25004,2382,2375,4019,9561,6667,396,125,124,0,0,124,1,0,0,0,0,1,0,0,1,271,261,67,11,183,10,10,10,0,0,0,0,0,0,77007
26660,23893,2755,3310,4705,7974,5149,667,274,185,29,0,156,89,71,37,34,0,18,0,17,1,393,348,61,58,229,45,45,45,0,0,0,0,0,0,77008
26661,25812,8644,6234,4989,3541,2404,2063,1061,672,25,117,530,389,277,209,23,45,112,36,60,16,1002,850,116,41,693,152,79,41,0,38,73,10,0,63,77009
26662,492,9,10,54,168,251,0,0,0,0,0,0,0,0,0,0,0,0,0,0,0,0,0,0,0,0,0,0,0,0,0,0,0,0,0,77010
26663,11923,6796,3275,1590,190,72,1085,542,372,31,48,293,170,122,69,0,53,48,39,0,9,543,479,94,102,283,64,22,22,0,0,42,42,0,0,77011
26664,12996,6655,3594,2051,532,164,1301,727,434,84,85,265,293,213,65,22,126,80,52,13,15,574,403,67,81,255,171,114,73,0,41,57,0,17,40,77012
26665,10899,4583,3426,2159,446,285,1093,574,437,37,91,309,137,51,45,0,6,86,39,34,13,519,471,46,34,391,48,48,0,36,12,0,0,0,0,77013
26666,17232,4332,4370,5678,2112,740,2254,1313,1084,134,81,869,229,127,47,0,80,102,31,0,71,941,799,234,7,558,142,76,37,0,39,66,0,29,37,77014
26667,31731,10979,9612,7902,2264,974,3870,1962,1639,401,225,1013,323,190,117,59,14,133,98,0,35,1908,1482,369,72,1041,426,272,56,41,175,154,0,46,108,77015
26668,18317,5246,7503,4008,1015,545,1403,563,453,69,81,303,110,84,40,4,40,26,2,20,4,840,731,211,10,510,109,102,20,47,35,7,0,4,3,77016
26669,19521,8315,5616,3993,1027,570,2634,1184,844,60,157,627,340,176,122,9,45,164,68,13,83,1450,1057,88,0,969,393,210,58,52,100,183,44,27,112,77017
26670,19036,2885,4370,5187,4254,2340,919,439,411,66,21,324,28,18,4,0,14,10,10,0,0,480,382,38,28,316,98,85,39,0,46,13,0,0,13,77018
26671,14993,684,1209,2682,5549,4869,386,221,221,85,0,136,0,0,0,0,0,0,0,0,0,165,155,23,13,119,10,10,10,0,0,0,0,0,0,77019
26672,15905,7744,4353,2659,843,306,1583,770,620,113,13,494,150,70,70,0,0,80,0,0,80,813,644,50,97,497,169,98,98,0,0,71,20,0,51,77020
26673,16824,3863,4520,4668,2064,1709,1426,824,710,124,54,532,114,94,55,0,39,20,0,0,20,602,401,76,18,307,201,99,45,54,0,102,13,12,77,77021
26674,17187,7699,5210,3341,679,258,2056,945,742,146,62,534,203,78,61,0,17,125,23,0,102,1111,922,106,89,727,189,85,59,26,0,104,17,22,65,77022
26675,18262,8489,4112,3483,1615,563,1798,837,653,97,26,530,184,25,19,0,6,159,104,23,32,961,717,116,62,539,244,168,32,73,63,76,42,8,26,77023
26676,25069,865,2023,4467,9691,8023,1680,867,858,166,9,683,9,9,0,0,9,0,0,0,0,813,808,96,5,707,5,5,0,5,0,0,0,0,0,77024
26677,18555,1366,1535,3525,5559,6570,979,457,349,121,15,213,108,67,55,0,12,41,0,38,3,522,452,20,59,373,70,26,0,12,14,44,0,0,44,77025
26678,14099,5698,4646,2921,545,289,1579,797,645,59,36,550,152,118,23,72,23,34,13,0,21,782,688,147,40,501,94,46,13,0,33,48,0,32,16,77026
26679,12322,285,746,2370,4855,4066,307,123,115,23,44,48,8,8,0,0,8,0,0,0,0,184,184,0,16,168,0,0,0,0,0,0,0,0,0,77027
26680,10617,3247,4419,2324,464,163,856,452,348,69,28,251,104,100,36,0,64,4,0,0,4,404,380,19,9,352,24,24,0,11,13,0,0,0,0,77028
26681,11340,5241,3322,2112,448,217,1052,612,451,134,171,146,161,123,49,34,40,38,38,0,0,440,276,0,34,242,164,134,0,20,114,30,30,0,0,77029
26682,7594,174,311,963,2271,3875,297,190,190,49,0,141,0,0,0,0,0,0,0,0,0,107,98,7,7,84,9,0,0,0,0,9,0,0,9,77030
26683,10450,3179,2392,2529,1715,635,854,391,247,55,0,192,144,28,28,0,0,116,85,0,31,463,369,32,65,272,94,40,0,0,40,54,0,2,52,77031
26684,7149,3124,2202,1563,148,112,823,470,290,5,81,204,180,50,12,13,25,130,0,79,51,353,245,4,33,208,108,82,16,15,51,26,0,0,26,77032
26685,17457,5521,6536,4195,861,344,1591,865,589,50,57,482,276,182,93,16,73,94,0,18,76,726,594,77,40,477,132,46,39,7,0,86,0,20,66,77033
26686,20376,6040,5425,6236,2237,438,1950,890,749,132,105,512,141,101,64,28,9,40,39,0,1,1060,800,268,39,493,260,146,47,31,68,114,0,46,68,77034
26687,21967,5791,4883,5608,3586,2099,1611,679,524,25,47,452,155,109,10,88,11,46,0,0,46,932,845,192,24,629,87,32,10,0,22,55,20,10,25,77035
26688,39000,16438,8822,7444,4675,1621,3795,2230,1327,72,52,1203,903,275,177,34,64,628,272,229,127,1565,955,137,89,729,610,238,108,0,130,372,65,117,190,77036
26689,10874,6232,2792,1524,325,1,1223,450,366,28,20,318,84,68,24,0,44,16,0,0,16,773,574,80,0,494,199,35,13,0,22,164,0,0,164,77037
26690,15605,6530,4811,2890,1116,258,1757,945,727,48,117,562,218,169,135,0,34,49,26,0,23,812,720,66,55,599,92,50,9,0,41,42,0,17,25,77038
26691,15249,7592,4459,2652,418,128,2160,1145,910,180,55,675,235,124,47,0,77,111,100,11,0,1015,787,95,15,677,228,108,30,0,78,120,10,0,110,77039
26692,28754,5485,8431,7940,4408,2490,2502,1102,931,216,16,699,171,120,101,1,18,51,26,25,0,1400,1255,368,53,834,145,117,32,0,85,28,0,0,28,77040
26693,22997,4606,5478,5147,4956,2810,2219,1148,996,172,62,762,152,107,52,41,14,45,45,0,0,1071,971,186,70,715,100,100,47,22,31,0,0,0,0,77041
26694,25210,2687,3947,7799,7075,3702,1078,639,578,141,150,287,61,52,37,0,15,9,9,0,0,439,371,76,26,269,68,44,44,0,0,24,0,24,0,77042
26695,15536,3171,3395,4516,3305,1149,1689,838,660,36,28,596,178,47,5,0,42,131,119,12,0,851,661,138,0,523,190,14,0,0,14,176,60,0,116,77043
26696,19095,3982,4975,5484,2796,1858,1838,971,868,238,17,613,103,91,81,10,0,12,0,0,12,867,809,157,23,629,58,40,24,0,16,18,0,0,18,77044
26697,19061,5527,6482,4458,1766,828,2567,1175,950,108,59,783,225,155,25,60,70,70,49,21,0,1392,1057,65,60,932,335,253,61,68,124,82,0,36,46,77045
26698,982,0,45,218,477,242,12,0,0,0,0,0,0,0,0,0,0,0,0,0,0,12,12,0,0,12,0,0,0,0,0,0,0,0,0,77046
26699,14413,2453,3562,4908,2380,1110,1104,479,391,50,21,320,88,88,76,12,0,0,0,0,0,625,414,65,34,315,211,168,0,65,103,43,0,0,43,77047
26700,9900,2587,3264,2909,813,327,1271,627,603,81,53,469,24,24,0,0,24,0,0,0,0,644,567,156,65,346,77,77,11,0,66,0,0,0,0,77048
26701,16100,4211,4542,4670,1778,899,2687,1507,1417,196,132,1089,90,28,15,0,13,62,25,0,37,1180,971,136,58,777,209,163,81,0,82,46,0,46,0,77049
26702,2891,945,965,787,123,71,178,96,79,28,0,51,17,0,0,0,0,17,17,0,0,82,66,16,0,50,16,16,0,16,0,0,0,0,0,77050
26703,9458,2064,3958,2613,659,164,892,270,237,7,35,195,33,0,0,0,0,33,0,0,33,622,501,95,48,358,121,23,3,20,0,98,0,0,98,77051
26704,18304,6323,5458,4760,1427,336,2271,1244,934,197,61,676,310,223,138,0,85,87,76,0,11,1027,714,169,104,441,313,233,80,0,153,80,0,0,80,77053
26705,14768,297,1879,3934,4539,4119,394,220,166,62,0,104,54,32,0,0,32,22,0,22,0,174,148,46,0,102,26,16,16,0,0,10,0,0,10,77054
26706,27574,9389,5442,4889,5180,2674,1694,891,700,158,34,508,191,133,126,0,7,58,49,0,9,803,678,146,39,493,125,102,50,23,29,23,0,0,23,77055
26707,14260,258,882,2615,6317,4188,460,211,180,53,0,127,31,29,29,0,0,2,0,0,2,249,249,26,103,120,0,0,0,0,0,0,0,0,0,77056
26708,29525,4792,3204,6657,9344,5528,893,557,387,35,6,346,170,72,30,0,42,98,66,0,32,336,250,62,0,188,86,25,0,25,0,61,30,0,31,77057
26709,11779,758,1752,4042,3340,1887,399,246,218,73,33,112,28,0,0,0,0,28,28,0,0,153,153,52,0,101,0,0,0,0,0,0,0,0,0,77058
26710,12544,478,1025,2010,5283,3748,1290,828,813,52,43,718,15,15,15,0,0,0,0,0,0,462,462,103,0,359,0,0,0,0,0,0,0,0,0,77059
26711,22726,11527,6281,3956,536,426,2690,1224,865,232,11,622,359,108,49,44,15,251,156,13,82,1466,1108,188,43,877,358,223,120,38,65,135,25,43,67,77060
26712,14578,5685,4454,2864,1187,388,1568,898,753,90,91,572,145,95,95,0,0,50,22,0,28,670,485,143,12,330,185,71,56,8,7,114,0,30,84,77061
26713,17976,1207,2456,5299,5656,3358,1463,679,637,120,133,384,42,32,19,0,13,10,10,0,0,784,738,442,14,282,46,46,46,0,0,0,0,0,0,77062
26714,26180,3263,3965,7272,7698,3982,883,508,325,22,4,299,183,170,144,12,14,13,13,0,0,375,201,8,58,135,174,140,121,0,19,34,0,0,34,77063
26715,29727,4661,7410,8938,6435,2283,2857,1531,1269,391,34,844,262,262,167,14,81,0,0,0,0,1326,1015,195,26,794,311,299,83,17,199,12,0,0,12,77064
26716,23283,2933,5860,8139,4538,1813,2049,1156,1001,169,74,758,155,59,17,16,26,96,18,16,62,893,834,187,27,620,59,30,30,0,0,29,11,0,18,77065
26717,19330,4036,5348,6037,2676,1233,2012,1121,889,116,30,743,232,105,59,25,21,127,24,5,98,891,744,202,2,540,147,131,55,10,66,16,0,0,16,77066
26718,16557,4945,4850,5027,1407,328,2293,1048,886,69,11,806,162,83,31,14,38,79,0,32,47,1245,1035,285,49,701,210,115,27,0,88,95,0,13,82,77067
26719,7046,1208,1285,2084,1815,654,413,162,162,16,0,146,0,0,0,0,0,0,0,0,0,251,243,76,14,153,8,8,0,0,8,0,0,0,0,77068
26720,11979,507,1874,3782,3823,1993,662,400,326,57,28,241,74,54,54,0,0,20,0,0,20,262,262,64,12,186,0,0,0,0,0,0,0,0,0,77069
26721,31327,2739,6962,10057,8374,3195,2155,1362,1200,318,60,822,162,96,82,14,0,66,0,23,43,793,737,205,15,517,56,56,56,0,0,0,0,0,0,77070
26722,16988,3306,3617,4812,3417,1836,1613,766,681,177,51,453,85,47,47,0,0,38,0,0,38,847,769,157,107,505,78,34,2,0,32,44,44,0,0,77071
26723,33451,11951,8890,7857,3693,1060,3842,2111,1635,195,124,1316,476,322,148,41,133,154,72,0,82,1731,1502,415,67,1020,229,124,82,0,42,105,10,19,76,77072
26724,20774,4400,7067,6223,2213,871,2270,1247,1041,181,35,825,206,177,108,0,69,29,29,0,0,1023,888,207,46,635,135,91,66,12,13,44,8,9,27,77073
26725,23007,7654,5574,5261,3282,1236,2045,894,715,108,50,557,179,84,79,5,0,95,86,9,0,1151,1044,217,30,797,107,72,40,0,32,35,22,0,13,77074
26726,22305,7024,6572,5771,2249,689,2499,939,684,80,75,529,255,152,94,28,30,103,20,25,58,1560,1331,211,118,1002,229,81,43,0,38,148,37,0,111,77075
26727,17979,9030,5757,2598,552,42,2847,1386,1077,218,33,826,309,202,55,31,116,107,77,0,30,1461,1083,137,25,921,378,147,86,27,34,231,104,0,127,77076
26728,36950,1952,5303,10660,12004,7031,2171,1208,1088,192,69,827,120,92,42,50,0,28,0,0,28,963,807,253,0,554,156,19,19,0,0,137,0,0,137,77077
26729,9317,3190,3089,2451,377,210,1135,595,372,40,141,191,223,96,41,0,55,127,0,0,127,540,441,0,26,415,99,36,0,12,24,63,0,14,49,77078
26730,21481,979,2631,4847,8321,4703,1388,663,622,136,62,424,41,41,41,0,0,0,0,0,0,725,725,156,18,551,0,0,0,0,0,0,0,0,0,77079
26731,28878,10904,7817,5931,3167,1059,3122,1572,1107,145,93,869,465,324,168,54,102,141,29,53,59,1550,1132,254,129,749,418,271,219,0,52,147,14,28,105,77080
26732,25372,10973,5925,4152,2841,1481,1864,1192,766,155,29,582,426,201,139,24,38,225,47,65,113,672,509,164,49,296,163,93,68,0,25,70,24,0,46,77081
26733,33274,3911,7291,10486,7694,3892,2578,1245,1112,128,89,895,133,88,47,33,8,45,0,0,45,1333,1279,198,167,914,54,34,34,0,0,20,0,0,20,77082
26734,42834,9791,9999,12845,7506,2693,5347,2841,2458,295,166,1997,383,219,98,28,93,164,126,0,38,2506,2144,294,126,1724,362,243,163,0,80,119,25,40,54,77083
26735,61028,9829,16015,19028,11990,4166,5976,2899,2516,492,143,1881,383,272,204,15,53,111,0,41,70,3077,2597,645,191,1761,480,308,138,38,132,172,43,48,81,77084
26736,9395,2488,2553,2455,1482,417,891,405,331,61,19,251,74,57,17,9,31,17,0,17,0,486,420,77,141,202,66,18,18,0,0,48,0,37,11,77085
26737,15815,5684,5310,3348,1156,317,1850,1035,888,191,74,623,147,107,96,11,0,40,40,0,0,815,672,67,42,563,143,131,60,52,19,12,0,12,0,77086
26738,21990,9701,6828,3788,1292,381,2624,1244,1042,202,82,758,202,178,110,21,47,24,9,0,15,1380,1003,177,113,713,377,259,49,78,132,118,48,7,63,77087
26739,31235,9525,9526,8273,2707,1204,3283,2075,1713,350,130,1233,362,259,76,17,166,103,70,20,13,1208,1063,171,33,859,145,95,54,0,41,50,11,0,39,77088
26740,32620,5858,8306,11482,5034,1940,2866,1464,1297,434,53,810,167,161,86,75,0,6,0,6,0,1402,1192,238,57,897,210,190,123,0,67,20,0,0,20,77089
26741,19801,2826,5017,7294,3053,1611,1630,799,624,54,77,493,175,65,19,46,0,110,39,25,46,831,640,138,41,461,191,66,15,13,38,125,28,14,83,77090
26742,14959,4462,4607,3882,1352,656,1227,632,522,174,15,333,110,47,7,12,28,63,0,12,51,595,486,129,118,239,109,12,12,0,0,97,15,11,71,77091
26743,21778,6994,6350,5136,2400,898,1864,863,652,130,35,487,211,108,36,30,42,103,9,24,70,1001,680,115,100,465,321,268,187,8,73,53,0,0,53,77092
26744,23903,13172,6309,3519,742,161,2988,1891,1374,122,195,1057,517,317,184,20,113,200,160,0,40,1097,930,151,80,699,167,101,32,23,46,66,0,0,66,77093
26745,5693,51,481,862,2773,1526,741,288,288,33,52,203,0,0,0,0,0,0,0,0,0,453,422,57,28,337,31,31,0,0,31,0,0,0,0,77094
26746,42553,2860,7752,13763,12787,5391,4010,2039,1684,527,96,1061,355,322,72,42,208,33,5,0,28,1971,1744,470,152,1122,227,195,183,12,0,32,0,0,32,77095
26747,23785,2224,3277,5638,7141,5505,1553,915,731,116,0,615,184,95,66,0,29,89,77,0,12,638,582,151,78,353,56,56,56,0,0,0,0,0,0,77096
26748,10480,344,347,2073,3823,3893,260,164,164,18,0,146,0,0,0,0,0,0,0,0,0,96,96,33,0,63,0,0,0,0,0,0,0,0,0,77098
26749,27727,8462,7366,7138,3485,1276,2438,1223,1000,80,118,802,223,134,59,43,32,89,29,31,29,1215,1011,165,41,805,204,204,167,0,37,0,0,0,0,77099
26750,0,0,0,0,0,0,0,0,0,0,0,0,0,0,0,0,0,0,0,0,0,0,0,0,0,0,0,0,0,0,0,0,0,0,0,77201
26751,18089,7030,5344,4156,1117,442,1774,929,672,195,5,472,257,108,42,26,40,149,66,0,83,845,665,178,0,487,180,147,81,13,53,33,13,0,20,77301
26752,11568,2435,3560,3717,1358,498,1185,585,410,17,22,371,175,103,63,40,0,72,46,26,0,600,487,98,0,389,113,106,71,0,35,7,0,0,7,77302
26753,11047,2227,4042,3745,756,277,974,438,347,26,27,294,91,40,27,0,13,51,27,24,0,536,306,118,26,162,230,230,135,0,95,0,0,0,0,77303
26754,15477,1566,3526,5384,3541,1460,1262,642,516,54,8,454,126,126,115,0,11,0,0,0,0,620,545,283,13,249,75,8,0,8,0,67,33,0,34,77304
26755,6778,1828,2876,1795,253,26,724,394,255,28,40,187,139,103,0,15,88,36,16,0,20,330,245,69,0,176,85,75,17,0,58,10,0,0,10,77306
26756,10733,1312,3318,3528,1892,683,570,382,360,123,15,222,22,22,22,0,0,0,0,0,0,188,188,53,8,127,0,0,0,0,0,0,0,0,0,77316
26757,9706,906,3131,3136,1803,730,738,352,257,71,0,186,95,95,0,0,95,0,0,0,0,386,368,100,0,268,18,18,0,0,18,0,0,0,0,77318
26758,27400,5771,9876,8230,2484,1039,1412,710,491,11,18,462,219,145,37,0,108,74,0,15,59,702,505,44,25,436,197,150,130,0,20,47,47,0,0,77320
26759,19,0,0,0,19,0,0,0,0,0,0,0,0,0,0,0,0,0,0,0,0,0,0,0,0,0,0,0,0,0,0,0,0,0,0,77326
26760,12985,3068,5350,3470,792,305,1155,614,515,23,108,384,99,45,19,26,0,54,35,19,0,541,513,111,47,355,28,28,21,7,0,0,0,0,0,77327
26761,9538,2540,3802,2581,495,120,856,469,320,53,44,223,149,64,64,0,0,85,0,38,47,387,308,59,38,211,79,79,0,0,79,0,0,0,0,77328
26762,4722,693,1828,1381,587,233,313,140,110,21,0,89,30,28,6,0,22,2,0,0,2,173,119,33,3,83,54,40,40,0,0,14,0,0,14,77331
26763,49,0,30,19,0,0,0,0,0,0,0,0,0,0,0,0,0,0,0,0,0,0,0,0,0,0,0,0,0,0,0,0,0,0,0,77334
26764,1582,584,531,310,125,32,169,161,139,56,36,47,22,22,19,3,0,0,0,0,0,8,8,0,8,0,0,0,0,0,0,0,0,0,0,77335
26765,7708,874,2679,2623,1240,292,891,357,357,9,35,313,0,0,0,0,0,0,0,0,0,534,486,122,68,296,48,48,19,0,29,0,0,0,0,77336
26766,21063,3488,5771,7708,2857,1239,1858,1040,854,152,25,677,186,32,32,0,0,154,20,134,0,818,645,103,76,466,173,94,29,54,11,79,9,36,34,77338
26767,26819,1329,4895,9736,7459,3400,2208,1279,1255,246,170,839,24,11,10,0,1,13,0,0,13,929,832,315,61,456,97,84,21,0,63,13,0,0,13,77339
26768,13166,1600,3978,3893,2594,1101,3519,1487,1360,355,14,991,127,75,75,0,0,52,0,0,52,2032,1884,284,168,1432,148,126,28,45,53,22,0,0,22,77340
26769,292,112,113,51,16,0,9,9,0,0,0,0,9,9,0,0,9,0,0,0,0,0,0,0,0,0,0,0,0,0,0,0,0,0,0,77342
26770,18642,370,2203,5226,6729,4114,1927,995,995,341,91,563,0,0,0,0,0,0,0,0,0,932,916,267,31,618,16,16,16,0,0,0,0,0,0,77345
26771,33785,1903,7159,12669,8337,3717,3525,1700,1492,239,83,1170,208,131,61,0,70,77,15,16,46,1825,1569,672,0,897,256,200,17,166,17,56,24,0,32,77346
26772,74,25,22,27,0,0,21,14,7,0,0,7,7,7,7,0,0,0,0,0,0,7,4,4,0,0,3,3,0,0,3,0,0,0,0,77350
26773,23956,5230,8533,7549,1631,1013,1502,767,558,75,4,479,209,89,39,34,16,120,0,0,120,735,636,111,56,469,99,99,55,11,33,0,0,0,0,77351
26774,20516,2956,5361,6286,4171,1742,2205,1174,1012,174,134,704,162,106,58,0,48,56,24,0,32,1031,826,170,10,646,205,32,21,0,11,173,18,111,44,77354
26775,15837,1714,4503,6239,2487,894,1815,925,800,249,122,429,125,4,0,0,4,121,0,0,121,890,772,150,58,564,118,108,36,0,72,10,0,10,0,77355
26776,17977,1205,3895,5688,4734,2455,1160,585,496,145,24,327,89,0,0,0,0,89,58,31,0,575,449,130,57,262,126,126,126,0,0,0,0,0,0,77356
26777,12112,3212,4547,3475,690,188,1282,651,553,102,146,305,98,58,58,0,0,40,0,21,19,631,611,156,12,443,20,5,3,0,2,15,12,0,3,77357
26778,3552,455,1292,901,534,370,322,208,148,13,0,135,60,57,44,0,13,3,0,0,3,114,96,36,0,60,18,13,0,8,5,5,0,0,5,77358
26779,518,143,234,23,79,39,0,0,0,0,0,0,0,0,0,0,0,0,0,0,0,0,0,0,0,0,0,0,0,0,0,0,0,0,0,77359
26780,3537,868,1134,1179,258,98,160,108,29,0,0,29,79,79,0,79,0,0,0,0,0,52,36,4,0,32,16,10,10,0,0,6,0,0,6,77360
26781,2630,477,1062,742,294,55,552,194,194,57,0,137,0,0,0,0,0,0,0,0,0,358,334,58,0,276,24,24,0,24,0,0,0,0,0,77362
26782,2073,479,637,705,149,103,82,9,5,0,5,0,4,4,0,0,4,0,0,0,0,73,53,38,0,15,20,20,0,0,20,0,0,0,0,77363
26783,1499,336,446,453,167,97,94,60,52,0,0,52,8,2,2,0,0,6,0,0,6,34,34,6,0,28,0,0,0,0,0,0,0,0,0,77364
26784,17099,3742,5299,5384,1893,781,1344,906,815,178,0,637,91,91,38,0,53,0,0,0,0,438,385,79,35,271,53,7,0,0,7,46,0,0,46,77365
26785,140,46,49,35,10,0,11,2,0,0,0,0,2,0,0,0,0,2,0,0,2,9,9,0,0,9,0,0,0,0,0,0,0,0,0,77367
26786,151,25,53,52,14,7,0,0,0,0,0,0,0,0,0,0,0,0,0,0,0,0,0,0,0,0,0,0,0,0,0,0,0,0,0,77368
26787,505,185,139,131,50,0,0,0,0,0,0,0,0,0,0,0,0,0,0,0,0,0,0,0,0,0,0,0,0,0,0,0,0,0,0,77369
26788,5328,1481,2360,1286,158,43,483,228,154,0,55,99,74,42,24,18,0,32,0,32,0,255,255,11,23,221,0,0,0,0,0,0,0,0,0,77371
26789,7715,1940,3003,2380,297,95,825,396,255,93,0,162,141,126,86,31,9,15,15,0,0,429,311,72,5,234,118,82,26,27,29,36,0,36,0,77372
26790,34160,3499,10308,13532,4992,1829,3705,2067,1728,506,208,1014,339,241,175,36,30,98,63,35,0,1638,1470,446,145,879,168,134,104,10,20,34,8,0,26,77373
26791,305,56,103,96,50,0,57,31,31,31,0,0,0,0,0,0,0,0,0,0,0,26,26,0,0,26,0,0,0,0,0,0,0,0,0,77374
26792,25337,2623,7813,8091,5069,1741,1871,1192,999,142,152,705,193,164,90,61,13,29,0,0,29,679,531,82,20,429,148,140,62,16,62,8,0,0,8,77375
26793,189,68,119,0,2,0,37,37,37,0,0,37,0,0,0,0,0,0,0,0,0,0,0,0,0,0,0,0,0,0,0,0,0,0,0,77376
26794,18513,2020,3356,5802,5190,2145,1784,775,642,105,18,519,133,56,11,0,45,77,77,0,0,1009,803,225,60,518,206,206,14,88,104,0,0,0,0,77377
26795,8623,2236,2937,2091,1168,191,979,533,363,53,0,310,170,63,41,17,5,107,107,0,0,446,396,82,33,281,50,1,0,0,1,49,0,0,49,77378
26796,46330,3290,7834,13571,14207,7428,4349,2056,1944,450,140,1354,112,71,43,5,23,41,14,27,0,2293,2193,478,138,1577,100,90,36,0,54,10,10,0,0,77379
26797,16617,1262,3045,5493,4188,2629,995,513,405,103,0,302,108,107,85,0,22,1,1,0,0,482,401,154,0,247,81,81,11,0,70,0,0,0,0,77380
26798,25207,791,3248,6610,9422,5136,1784,946,879,281,0,598,67,67,31,14,22,0,0,0,0,838,794,216,65,513,44,44,44,0,0,0,0,0,0,77381
26799,21864,505,1879,4546,9986,4948,2275,1250,1219,294,67,858,31,0,0,0,0,31,31,0,0,1025,1025,147,50,828,0,0,0,0,0,0,0,0,0,77382
26800,9353,431,2252,2623,2665,1382,410,122,104,23,20,61,18,18,0,0,18,0,0,0,0,288,260,57,13,190,28,28,0,0,28,0,0,0,0,77384
26801,13173,1451,2556,4857,2944,1365,782,372,344,99,8,237,28,24,0,0,24,4,4,0,0,410,379,113,1,265,31,31,22,0,9,0,0,0,0,77385
26802,25510,1746,5177,8753,7211,2623,2542,1340,1171,324,30,817,169,103,91,12,0,66,44,0,22,1202,994,345,51,598,208,208,27,76,105,0,0,0,0,77386
26803,26735,2366,5544,9678,6015,3132,2121,1440,1379,383,109,887,61,61,7,0,54,0,0,0,0,681,600,118,9,473,81,68,68,0,0,13,0,0,13,77388
26804,15492,1293,2915,4872,4757,1655,1101,592,544,140,98,306,48,48,48,0,0,0,0,0,0,509,472,93,0,379,37,37,0,0,37,0,0,0,0,77389
26805,27369,5359,7256,7995,4246,2513,2363,1473,1054,176,85,793,419,277,116,43,118,142,18,47,77,890,703,163,37,503,187,187,56,18,113,0,0,0,0,77396
26806,11932,288,712,1847,3962,5123,1214,712,679,99,16,564,33,33,12,9,12,0,0,0,0,502,482,55,20,407,20,20,0,7,13,0,0,0,0,77401
26807,23920,1577,5003,7430,6928,2982,1910,1066,1027,209,32,786,39,30,0,0,30,9,0,0,9,844,825,176,38,611,19,19,19,0,0,0,0,0,0,77406
26808,19860,1935,2937,6483,5886,2619,1726,668,434,23,0,411,234,177,141,0,36,57,0,0,57,1058,959,260,0,699,99,56,56,0,0,43,13,30,0,77407
26809,79,7,7,43,11,11,19,19,19,0,0,19,0,0,0,0,0,0,0,0,0,0,0,0,0,0,0,0,0,0,0,0,0,0,0,77412
26810,15048,2889,5610,4010,2028,511,1435,598,505,74,6,425,93,75,29,15,31,18,0,0,18,837,620,145,59,416,217,173,60,39,74,44,0,7,37,77414
26811,12,0,0,12,0,0,0,0,0,0,0,0,0,0,0,0,0,0,0,0,0,0,0,0,0,0,0,0,0,0,0,0,0,0,0,77415
26812,1476,423,515,371,141,26,119,22,22,12,7,3,0,0,0,0,0,0,0,0,0,97,82,7,0,75,15,15,15,0,0,0,0,0,0,77417
26813,6442,719,1972,2293,963,495,486,298,274,193,18,63,24,24,23,0,1,0,0,0,0,188,151,95,16,40,37,0,0,0,0,37,0,0,37,77418
26814,881,205,491,157,28,0,84,45,45,0,0,45,0,0,0,0,0,0,0,0,0,39,39,0,0,39,0,0,0,0,0,0,0,0,0,77419
26815,1345,403,341,476,60,65,48,31,26,5,0,21,5,5,0,0,5,0,0,0,0,17,0,0,0,0,17,17,0,0,17,0,0,0,0,77420
26816,9084,1331,3328,3537,664,224,770,529,312,18,15,279,217,61,17,18,26,156,10,19,127,241,186,70,8,108,55,55,43,6,6,0,0,0,0,77422
26817,5813,1476,2577,1165,482,113,492,223,174,46,79,49,49,42,36,0,6,7,0,0,7,269,232,35,0,197,37,15,0,0,15,22,0,22,0,77423
26818,1474,269,598,203,287,117,113,65,65,0,0,65,0,0,0,0,0,0,0,0,0,48,48,0,0,48,0,0,0,0,0,0,0,0,0,77426
26819,0,0,0,0,0,0,0,0,0,0,0,0,0,0,0,0,0,0,0,0,0,0,0,0,0,0,0,0,0,0,0,0,0,0,0,77428
26820,45559,2590,8876,13525,14503,6065,4505,2743,2452,612,193,1647,291,233,82,20,131,58,0,12,46,1762,1573,410,32,1131,189,150,65,0,85,39,39,0,0,77429
26821,1400,314,461,432,164,29,89,30,30,0,22,8,0,0,0,0,0,0,0,0,0,59,39,0,0,39,20,0,0,0,0,20,0,0,20,77430
26822,66,30,0,0,36,0,0,0,0,0,0,0,0,0,0,0,0,0,0,0,0,0,0,0,0,0,0,0,0,0,0,0,0,0,0,77432
26823,31793,2761,6661,8638,9844,3889,3164,2152,2044,327,127,1590,108,93,80,0,13,15,0,0,15,1012,965,204,0,761,47,47,11,0,36,0,0,0,0,77433
26824,3016,849,1192,792,133,50,163,82,74,0,49,25,8,0,0,0,0,8,0,0,8,81,81,11,0,70,0,0,0,0,0,0,0,0,0,77434
26825,3032,514,1083,823,482,130,211,171,138,50,17,71,33,0,0,0,0,33,15,0,18,40,40,14,0,26,0,0,0,0,0,0,0,0,0,77435
26826,0,0,0,0,0,0,0,0,0,0,0,0,0,0,0,0,0,0,0,0,0,0,0,0,0,0,0,0,0,0,0,0,0,0,0,77436
26827,10608,3150,3538,2321,1147,452,998,589,419,130,0,289,170,120,93,0,27,50,25,25,0,409,333,66,39,228,76,22,22,0,0,54,14,0,40,77437
26828,0,0,0,0,0,0,0,0,0,0,0,0,0,0,0,0,0,0,0,0,0,0,0,0,0,0,0,0,0,0,0,0,0,0,0,77440
26829,3764,170,502,1013,1493,586,227,105,97,15,18,64,8,8,0,0,8,0,0,0,0,122,105,0,6,99,17,7,7,0,0,10,0,0,10,77441
26830,678,97,197,255,120,9,45,19,19,0,0,19,0,0,0,0,0,0,0,0,0,26,11,0,0,11,15,0,0,0,0,15,15,0,0,77442
26831,66,53,0,0,13,0,0,0,0,0,0,0,0,0,0,0,0,0,0,0,0,0,0,0,0,0,0,0,0,0,0,0,0,0,0,77443
26832,569,71,334,135,20,9,53,22,0,0,0,0,22,0,0,0,0,22,17,0,5,31,31,0,0,31,0,0,0,0,0,0,0,0,0,77444
26833,7395,1461,2758,1763,1044,369,799,527,473,58,117,298,54,54,51,0,3,0,0,0,0,272,227,72,5,150,45,7,1,0,6,38,0,32,6,77445
26834,745,128,123,158,155,181,2367,604,604,100,32,472,0,0,0,0,0,0,0,0,0,1763,1743,296,94,1353,20,20,8,0,12,0,0,0,0,77446
26835,7940,1446,2756,2599,843,296,877,563,524,44,0,480,39,9,0,0,9,30,12,0,18,314,301,84,0,217,13,0,0,0,0,13,0,0,13,77447
26836,109,17,0,53,39,0,0,0,0,0,0,0,0,0,0,0,0,0,0,0,0,0,0,0,0,0,0,0,0,0,0,0,0,0,0,77448
26837,55397,8784,15112,19193,9186,3122,5887,2957,2542,311,369,1862,415,375,230,53,92,40,0,0,40,2930,2354,592,142,1620,576,495,306,72,117,81,21,44,16,77449
26838,44280,2034,5994,12856,16450,6946,4261,2103,1967,400,238,1329,136,118,93,20,5,18,18,0,0,2158,2037,447,136,1454,121,108,69,26,13,13,13,0,0,77450
26839,71,25,18,28,0,0,0,0,0,0,0,0,0,0,0,0,0,0,0,0,0,0,0,0,0,0,0,0,0,0,0,0,0,0,0,77451
26840,266,91,39,116,20,0,38,9,0,0,0,0,9,0,0,0,0,9,9,0,0,29,0,0,0,0,29,29,0,0,29,0,0,0,0,77453
26841,260,30,107,93,14,16,0,0,0,0,0,0,0,0,0,0,0,0,0,0,0,0,0,0,0,0,0,0,0,0,0,0,0,0,0,77454
26842,1247,191,479,370,171,36,63,42,42,21,4,17,0,0,0,0,0,0,0,0,0,21,21,9,0,12,0,0,0,0,0,0,0,0,0,77455
26843,835,314,320,176,0,25,55,13,13,13,0,0,0,0,0,0,0,0,0,0,0,42,0,0,0,0,42,42,0,0,42,0,0,0,0,77456
26844,450,97,134,126,90,3,31,31,11,0,0,11,20,20,20,0,0,0,0,0,0,0,0,0,0,0,0,0,0,0,0,0,0,0,0,77457
26845,245,91,118,36,0,0,41,41,41,0,0,41,0,0,0,0,0,0,0,0,0,0,0,0,0,0,0,0,0,0,0,0,0,0,0,77458
26846,37810,1460,4843,11840,12991,6676,2978,1327,1245,334,10,901,82,73,10,39,24,9,9,0,0,1651,1651,361,158,1132,0,0,0,0,0,0,0,0,0,77459
26847,91,6,0,56,29,0,31,31,16,0,0,16,15,15,15,0,0,0,0,0,0,0,0,0,0,0,0,0,0,0,0,0,0,0,0,77460
26848,6449,1451,2064,2040,678,216,575,254,193,56,7,130,61,61,61,0,0,0,0,0,0,321,312,35,0,277,9,8,0,0,8,1,1,0,0,77461
26849,143,18,51,62,2,10,13,6,6,0,0,6,0,0,0,0,0,0,0,0,0,7,0,0,0,0,7,0,0,0,0,7,0,0,7,77464
26850,4944,1122,1701,1309,627,185,409,291,254,22,61,171,37,15,15,0,0,22,0,0,22,118,96,2,0,94,22,22,0,22,0,0,0,0,0,77465
26851,537,262,64,141,60,10,11,11,0,0,0,0,11,11,11,0,0,0,0,0,0,0,0,0,0,0,0,0,0,0,0,0,0,0,0,77466
26852,68,0,42,21,5,0,0,0,0,0,0,0,0,0,0,0,0,0,0,0,0,0,0,0,0,0,0,0,0,0,0,0,0,0,0,77467
26853,168,74,85,9,0,0,0,0,0,0,0,0,0,0,0,0,0,0,0,0,0,0,0,0,0,0,0,0,0,0,0,0,0,0,0,77468
26854,23286,4403,6374,6664,3924,1921,2068,1022,717,85,3,629,305,180,82,22,76,125,68,0,57,1046,870,184,33,653,176,83,4,0,79,93,48,0,45,77469
26855,129,78,4,43,4,0,30,15,15,15,0,0,0,0,0,0,0,0,0,0,0,15,0,0,0,0,15,0,0,0,0,15,0,0,15,77470
26856,20783,5744,7290,5411,1588,750,2138,1087,733,130,15,588,354,229,110,38,81,125,22,0,103,1051,896,66,124,706,155,130,63,24,43,25,0,0,25,77471
26857,56,17,18,17,0,4,13,13,13,13,0,0,0,0,0,0,0,0,0,0,0,0,0,0,0,0,0,0,0,0,0,0,0,0,0,77473
26858,8117,1578,2987,2312,1018,222,775,130,123,6,28,89,7,6,6,0,0,1,0,0,1,645,566,59,180,327,79,79,19,9,51,0,0,0,0,77474
26859,409,26,277,106,0,0,21,0,0,0,0,0,0,0,0,0,0,0,0,0,0,21,21,21,0,0,0,0,0,0,0,0,0,0,0,77475
26860,150,41,35,40,22,12,0,0,0,0,0,0,0,0,0,0,0,0,0,0,0,0,0,0,0,0,0,0,0,0,0,0,0,0,0,77476
26861,23471,4236,4274,7211,5631,2119,1771,961,868,115,30,723,93,60,26,34,0,33,1,0,32,810,720,218,13,489,90,50,10,0,40,40,24,0,16,77477
26862,17118,1405,2509,4652,5411,3141,1187,579,483,94,0,389,96,96,10,28,58,0,0,0,0,608,590,65,61,464,18,10,10,0,0,8,0,0,8,77478
26863,50006,2914,5090,12048,17322,12632,4967,2702,2652,439,67,2146,50,28,0,0,28,22,0,11,11,2265,2253,410,26,1817,12,12,0,12,0,0,0,0,0,77479
26864,5185,727,1622,2131,543,162,619,406,379,114,0,265,27,27,11,0,16,0,0,0,0,213,188,9,14,165,25,25,12,0,13,0,0,0,0,77480
26865,3,0,0,3,0,0,0,0,0,0,0,0,0,0,0,0,0,0,0,0,0,0,0,0,0,0,0,0,0,0,0,0,0,0,0,77481
26866,1078,248,356,396,72,6,107,101,101,0,0,101,0,0,0,0,0,0,0,0,0,6,6,0,6,0,0,0,0,0,0,0,0,0,0,77482
26867,322,52,62,185,23,0,39,0,0,0,0,0,0,0,0,0,0,0,0,0,0,39,39,14,0,25,0,0,0,0,0,0,0,0,0,77483
26868,6920,1258,2468,1810,920,464,650,323,263,32,33,198,60,53,2,26,25,7,7,0,0,327,268,33,0,235,59,52,4,8,40,7,0,7,0,77484
26869,2573,404,958,824,312,75,264,173,173,7,9,157,0,0,0,0,0,0,0,0,0,91,78,20,0,58,13,13,0,0,13,0,0,0,0,77485
26870,4806,523,1635,1700,671,277,435,125,98,0,0,98,27,6,0,0,6,21,15,0,6,310,292,156,0,136,18,18,18,0,0,0,0,0,0,77486
26871,9560,2227,3175,2919,846,393,831,279,196,41,38,117,83,56,5,21,30,27,0,19,8,552,415,89,0,326,137,137,137,0,0,0,0,0,0,77488
26872,22128,2748,5452,8388,3387,2153,2566,1300,1106,108,107,891,194,95,34,51,10,99,86,13,0,1266,1055,363,18,674,211,185,0,56,129,26,0,0,26,77489
26873,14646,2100,3469,5138,2762,1177,1747,942,774,186,97,491,168,88,87,0,1,80,23,22,35,805,755,230,99,426,50,50,8,0,42,0,0,0,0,77493
26874,42824,1289,3847,10037,18437,9214,3724,2199,2146,229,194,1723,53,53,20,0,33,0,0,0,0,1525,1478,127,56,1295,47,28,0,0,28,19,19,0,0,77494
26875,32319,4210,6789,10778,7178,3364,4157,2232,2025,469,0,1556,207,191,45,9,137,16,16,0,0,1925,1774,262,0,1512,151,134,45,25,64,17,0,0,17,77498
26876,20356,7201,6621,5077,986,471,2611,1235,1062,353,132,577,173,62,43,14,5,111,64,14,33,1376,1201,186,163,852,175,175,92,16,67,0,0,0,0,77502
26877,14410,4593,5049,3828,770,170,1737,763,677,210,132,335,86,86,35,41,10,0,0,0,0,974,826,349,146,331,148,133,96,24,13,15,15,0,0,77503
26878,14828,3584,4324,4920,1433,567,1301,817,659,100,0,559,158,95,34,61,0,63,0,25,38,484,418,91,59,268,66,28,9,0,19,38,0,0,38,77504
26879,14872,1966,4219,5186,2415,1086,1840,751,669,199,72,398,82,64,39,25,0,18,0,0,18,1089,923,196,59,668,166,97,28,43,26,69,39,0,30,77505
26880,19515,9061,6458,3191,667,138,2203,1308,1123,136,118,869,185,141,98,22,21,44,0,10,34,895,788,203,14,571,107,82,7,6,69,25,25,0,0,77506
26881,0,0,0,0,0,0,0,0,0,0,0,0,0,0,0,0,0,0,0,0,0,0,0,0,0,0,0,0,0,0,0,0,0,0,0,77507
26882,9451,1003,3711,3452,827,458,752,314,302,87,70,145,12,12,0,2,10,0,0,0,0,438,334,81,20,233,104,77,37,14,26,27,8,6,13,77510
26883,29664,6247,8935,10042,3202,1238,2869,1656,1335,142,58,1135,321,215,167,18,30,106,25,0,81,1213,1109,346,47,716,104,28,13,15,0,76,50,0,26,77511
26884,3098,638,1112,932,238,178,185,156,49,5,11,33,107,21,0,0,21,86,62,0,24,29,29,0,0,29,0,0,0,0,0,0,0,0,0,77514
26885,20430,4006,6749,7246,1619,810,1862,802,641,147,35,459,161,93,20,41,32,68,0,0,68,1060,821,309,0,512,239,226,116,38,72,13,0,0,13,77515
26886,3732,376,1329,1609,337,81,552,258,258,46,35,177,0,0,0,0,0,0,0,0,0,294,276,0,17,259,18,18,0,0,18,0,0,0,0,77517
26887,4966,1093,1362,1754,472,285,563,326,218,4,120,94,108,74,60,0,14,34,34,0,0,237,220,36,17,167,17,17,17,0,0,0,0,0,0,77518
26888,977,262,522,138,45,10,95,56,56,0,0,56,0,0,0,0,0,0,0,0,0,39,17,9,0,8,22,22,0,22,0,0,0,0,0,77519
26889,22465,7359,5817,6884,1668,737,2767,1459,1213,388,200,625,246,172,41,47,84,74,24,26,24,1308,1054,276,41,737,254,195,135,39,21,59,5,0,54,77520
26890,30571,5243,8515,11692,3334,1787,2813,1329,1106,206,84,816,223,179,45,65,69,44,27,17,0,1484,1337,133,163,1041,147,111,24,13,74,36,15,0,21,77521
26891,11346,1261,3049,4653,1613,770,1188,600,598,186,85,327,2,0,0,0,0,2,0,0,2,588,564,25,44,495,24,9,0,0,9,15,0,0,15,77523
26892,16834,4701,6236,4322,1211,364,2069,959,787,124,64,599,172,120,68,26,26,52,12,40,0,1110,985,204,188,593,125,125,38,44,43,0,0,0,0,77530
26893,9470,2012,2902,3283,938,335,801,447,257,78,38,141,190,85,69,16,0,105,15,46,44,354,281,91,41,149,73,73,45,10,18,0,0,0,0,77531
26894,17771,2295,6098,6354,2356,668,1546,842,757,92,41,624,85,73,18,42,13,12,0,0,12,704,624,112,70,442,80,30,7,0,23,50,0,0,50,77532
26895,551,117,261,128,36,9,30,26,21,0,0,21,5,5,3,0,2,0,0,0,0,4,4,0,0,4,0,0,0,0,0,0,0,0,0,77533
26896,1869,263,455,771,288,92,161,72,68,41,3,24,4,4,0,0,4,0,0,0,0,89,67,11,0,56,22,22,22,0,0,0,0,0,0,77534
26897,20835,5223,7359,6862,930,461,1875,1020,798,198,99,501,222,142,98,29,15,80,60,3,17,855,694,79,37,578,161,138,55,0,83,23,0,0,23,77535
26898,19727,2442,5249,8046,2813,1177,1943,959,826,170,82,574,133,92,81,11,0,41,0,28,13,984,904,257,74,573,80,52,0,0,52,28,0,0,28,77536
26899,751,182,227,264,71,7,67,37,34,6,11,17,3,3,3,0,0,0,0,0,0,30,26,3,0,23,4,4,4,0,0,0,0,0,0,77538
26900,26441,5007,6744,8691,4269,1730,1688,859,541,127,97,317,318,206,104,25,77,112,84,0,28,829,761,135,92,534,68,64,40,0,24,4,0,0,4,77539
26901,10857,2647,3728,3556,780,146,1179,751,563,119,106,338,188,75,62,13,0,113,25,0,88,428,286,104,35,147,142,112,25,0,87,30,0,0,30,77541
26902,10891,1982,2014,3197,2675,1023,1310,631,539,125,39,375,92,31,16,15,0,61,38,0,23,679,623,77,89,457,56,44,23,21,0,12,0,0,12,77545
26903,31822,1569,5067,10326,10075,4785,3257,1788,1596,194,67,1335,192,179,70,40,69,13,0,13,0,1469,1318,414,32,872,151,97,81,0,16,54,17,0,37,77546
26904,5599,2103,1950,1279,197,70,896,355,190,36,27,127,165,90,90,0,0,75,53,0,22,541,471,90,95,286,70,70,47,19,4,0,0,0,0,77547
26905,15098,3009,4323,3846,1976,1944,1334,663,551,55,87,409,112,65,5,53,7,47,30,5,12,671,545,142,94,309,126,86,39,30,17,40,10,0,30,77550
26906,12770,2836,3497,3427,1688,1322,1090,498,448,76,77,295,50,42,22,0,20,8,0,0,8,592,507,188,110,209,85,25,15,0,10,60,40,0,20,77551
26907,6063,330,1206,1978,1500,1049,1019,602,578,70,65,443,24,24,13,11,0,0,0,0,0,417,370,79,10,281,47,47,47,0,0,0,0,0,0,77554
26908,548,130,208,125,66,19,63,32,32,0,0,32,0,0,0,0,0,0,0,0,0,31,11,11,0,0,20,20,0,20,0,0,0,0,0,77560
26909,99,47,30,10,12,0,6,6,6,0,0,6,0,0,0,0,0,0,0,0,0,0,0,0,0,0,0,0,0,0,0,0,0,0,0,77561
26910,6543,1331,2216,2464,295,237,684,383,307,70,53,184,76,74,52,0,22,2,0,0,2,301,235,112,9,114,66,66,66,0,0,0,0,0,0,77562
26911,6757,1005,2393,2419,651,289,450,293,236,122,43,71,57,23,17,0,6,34,0,18,16,157,126,21,9,96,31,13,13,0,0,18,0,0,18,77563
26912,1219,264,728,200,27,0,247,155,57,42,0,15,98,98,25,0,73,0,0,0,0,92,92,36,0,56,0,0,0,0,0,0,0,0,0,77564
26913,4279,245,783,1620,1145,486,275,216,185,80,0,105,31,31,31,0,0,0,0,0,0,59,52,29,0,23,7,7,0,3,4,0,0,0,0,77565
26914,18370,1312,3830,7358,3940,1930,1886,906,663,200,50,413,243,243,193,40,10,0,0,0,0,980,726,125,16,585,254,212,102,0,110,42,0,0,42,77566
26915,9133,1488,2977,3293,875,500,773,517,358,24,53,281,159,85,57,0,28,74,49,0,25,256,232,22,0,210,24,24,7,17,0,0,0,0,0,77568
26916,23081,3269,7729,8464,2540,1079,2034,961,927,271,84,572,34,23,23,0,0,11,11,0,0,1073,883,221,99,563,190,162,129,0,33,28,0,14,14,77571
26917,47810,2365,9291,15426,13367,7361,3453,1615,1431,402,75,954,184,61,49,0,12,123,74,0,49,1838,1569,432,13,1124,269,158,144,14,0,111,28,69,14,77573
26918,10462,2500,3432,3006,1024,500,698,347,320,38,70,212,27,27,27,0,0,0,0,0,0,351,239,6,8,225,112,112,38,29,45,0,0,0,0,77575
26919,932,176,310,384,45,17,65,42,33,18,0,15,9,0,0,0,0,9,0,0,9,23,12,0,0,12,11,11,11,0,0,0,0,0,0,77577
26920,9205,813,1942,2715,2447,1288,778,438,328,63,0,265,110,98,53,0,45,12,0,0,12,340,327,114,14,199,13,13,0,0,13,0,0,0,0,77578
26921,199,0,30,106,47,16,0,0,0,0,0,0,0,0,0,0,0,0,0,0,0,0,0,0,0,0,0,0,0,0,0,0,0,0,0,77580
26922,26845,2644,6072,9303,5700,3126,2424,1230,1060,294,61,705,170,77,54,23,0,93,17,10,66,1194,925,258,96,571,269,198,107,14,77,71,0,0,71,77581
26923,19982,5084,6212,5085,2598,1003,1243,589,533,138,0,395,56,19,5,6,8,37,0,0,37,654,526,40,35,451,128,121,5,8,108,7,0,0,7,77583
26924,47049,3638,6610,11405,14502,10894,3034,1389,1271,164,63,1044,118,116,87,29,0,2,0,0,2,1645,1586,341,91,1154,59,59,14,0,45,0,0,0,0,77584
26925,717,162,301,210,44,0,44,19,0,0,0,0,19,0,0,0,0,19,0,0,19,25,25,0,0,25,0,0,0,0,0,0,0,0,0,77585
26926,14430,692,1994,4489,4783,2472,1407,776,754,194,119,441,22,7,7,0,0,15,0,0,15,631,503,97,19,387,128,128,61,67,0,0,0,0,0,77586
26927,8974,4228,2648,1438,408,252,1162,658,530,115,133,282,128,112,112,0,0,16,0,16,0,504,450,97,81,272,54,44,12,11,21,10,0,10,0,77587
26928,19559,3986,6307,7097,1451,718,1809,908,751,128,134,489,157,89,69,11,9,68,0,68,0,901,727,228,89,410,174,94,52,42,0,80,43,0,37,77590
26929,9293,1222,2805,3948,926,392,602,298,207,53,44,110,91,91,62,13,16,0,0,0,0,304,288,94,0,194,16,0,0,0,0,16,8,8,0,77591
26930,509,49,158,205,93,4,11,6,6,6,0,0,0,0,0,0,0,0,0,0,0,5,5,0,0,5,0,0,0,0,0,0,0,0,0,77597
26931,14349,1791,3396,5719,2582,861,1140,510,282,137,17,128,228,17,0,0,17,211,211,0,0,630,289,137,0,152,341,196,129,8,59,145,0,0,145,77598
26932,5149,557,1791,2001,504,296,608,305,221,21,0,200,84,84,16,68,0,0,0,0,0,303,255,78,20,157,48,37,9,0,28,11,0,11,0,77611
26933,6164,731,2708,2079,513,133,507,253,120,22,0,98,133,101,25,0,76,32,0,0,32,254,240,0,0,240,14,0,0,0,0,14,0,0,14,77612
26934,704,104,375,185,28,12,73,20,20,14,0,6,0,0,0,0,0,0,0,0,0,53,20,0,0,20,33,0,0,0,0,33,0,0,33,77613
26935,565,25,303,199,22,16,0,0,0,0,0,0,0,0,0,0,0,0,0,0,0,0,0,0,0,0,0,0,0,0,0,0,0,0,0,77614
26936,525,110,250,132,28,5,54,45,45,0,0,45,0,0,0,0,0,0,0,0,0,9,9,9,0,0,0,0,0,0,0,0,0,0,0,77615
26937,704,66,394,227,17,0,50,50,27,0,0,27,23,23,23,0,0,0,0,0,0,0,0,0,0,0,0,0,0,0,0,0,0,0,0,77616
26938,86,5,26,28,27,0,0,0,0,0,0,0,0,0,0,0,0,0,0,0,0,0,0,0,0,0,0,0,0,0,0,0,0,0,0,77617
26939,10642,1263,4210,3959,1046,164,744,469,353,80,49,224,116,44,0,36,8,72,16,23,33,275,222,71,36,115,53,53,27,13,13,0,0,0,0,77619
26940,1123,82,572,228,141,100,70,41,41,0,0,41,0,0,0,0,0,0,0,0,0,29,29,0,0,29,0,0,0,0,0,0,0,0,0,77622
26941,481,64,239,105,63,10,57,15,15,0,0,15,0,0,0,0,0,0,0,0,0,42,42,0,2,40,0,0,0,0,0,0,0,0,0,77623
26942,837,68,305,319,85,60,111,107,107,0,0,107,0,0,0,0,0,0,0,0,0,4,4,4,0,0,0,0,0,0,0,0,0,0,0,77624
26943,5689,907,2560,1628,356,238,336,215,188,54,18,116,27,26,25,0,1,1,0,0,1,121,112,12,7,93,9,0,0,0,0,9,0,0,9,77625
26944,14495,1041,4774,5590,2331,759,1181,704,597,171,56,370,107,107,0,91,16,0,0,0,0,477,446,256,0,190,31,24,0,10,14,7,0,7,0,77627
26945,466,72,197,62,115,20,21,20,15,11,4,0,5,5,0,0,5,0,0,0,0,1,1,1,0,0,0,0,0,0,0,0,0,0,0,77629
26946,18114,2902,7098,5965,1538,611,1798,1053,853,261,0,592,200,119,49,41,29,81,24,36,21,745,624,203,42,379,121,104,63,21,20,17,0,0,17,77630
26947,15824,1930,5808,5260,2117,709,1603,682,543,167,36,340,139,113,57,44,12,26,0,24,2,921,704,160,10,534,217,126,105,9,12,91,0,9,82,77632
26948,10955,2315,3969,3351,981,339,814,455,268,22,35,211,187,57,35,11,11,130,21,22,87,359,260,11,24,225,99,52,23,24,5,47,37,10,0,77640
26949,22719,6961,7162,6491,1444,661,2201,1332,1122,207,66,849,210,128,120,0,8,82,41,12,29,869,562,124,68,370,307,179,83,26,70,128,63,0,65,77642
26950,1124,437,172,408,54,53,0,0,0,0,0,0,0,0,0,0,0,0,0,0,0,0,0,0,0,0,0,0,0,0,0,0,0,0,0,77650
26951,8754,518,2932,2929,1765,610,679,373,255,107,14,134,118,49,49,0,0,69,47,0,22,306,278,86,54,138,28,28,17,0,11,0,0,0,0,77651
26952,232,63,123,29,11,6,28,20,18,14,0,4,2,2,2,0,0,0,0,0,0,8,7,2,0,5,1,1,1,0,0,0,0,0,0,77655
26953,11966,1859,4969,3675,1063,400,867,463,411,123,0,288,52,45,45,0,0,7,0,0,7,404,330,98,13,219,74,6,6,0,0,68,25,0,43,77656
26954,13194,1301,4335,4703,2193,662,931,498,430,106,36,288,68,32,16,14,2,36,0,0,36,433,361,205,4,152,72,72,55,0,17,0,0,0,0,77657
26955,3219,285,1123,1215,481,115,296,158,137,17,4,116,21,3,3,0,0,18,0,18,0,138,100,11,11,78,38,38,31,0,7,0,0,0,0,77659
26956,710,158,241,221,72,18,68,21,14,0,5,9,7,7,7,0,0,0,0,0,0,47,35,0,0,35,12,0,0,0,0,12,0,0,12,77660
26957,508,39,293,69,107,0,78,78,78,22,0,56,0,0,0,0,0,0,0,0,0,0,0,0,0,0,0,0,0,0,0,0,0,0,0,77661
26958,17954,2532,8469,5452,1126,375,1029,542,371,57,67,247,171,112,58,0,54,59,59,0,0,487,362,49,0,313,125,115,70,10,35,10,0,0,10,77662
26959,733,90,126,362,71,84,54,0,0,0,0,0,0,0,0,0,0,0,0,0,0,54,54,54,0,0,0,0,0,0,0,0,0,0,0,77663
26960,1847,251,686,692,149,69,137,56,56,0,0,56,0,0,0,0,0,0,0,0,0,81,81,24,0,57,0,0,0,0,0,0,0,0,0,77664
26961,3684,918,1410,843,370,143,248,93,92,38,0,54,1,1,1,0,0,0,0,0,0,155,74,35,0,39,81,19,19,0,0,62,0,0,62,77665
26962,9595,3135,3489,2381,407,183,1036,503,404,86,49,269,99,55,20,15,20,44,15,0,29,533,383,79,28,276,150,122,16,77,29,28,0,0,28,77701
26963,1615,261,371,434,376,173,163,121,57,30,8,19,64,50,50,0,0,14,0,0,14,42,25,0,0,25,17,0,0,0,0,17,0,0,17,77702
26964,9023,2301,3207,2797,540,178,1564,488,446,48,0,398,42,42,0,37,5,0,0,0,0,1076,965,208,38,719,111,68,0,0,68,43,23,0,20,77703
26965,28061,6882,10949,7871,1636,723,2620,1310,988,180,144,664,322,164,81,18,65,158,0,0,158,1310,1160,344,114,702,150,140,66,25,49,10,0,0,10,77705
26966,19448,1053,3804,6056,5832,2703,1377,605,502,29,38,435,103,94,54,28,12,9,0,8,1,772,693,134,20,539,79,77,42,0,35,2,0,0,2,77706
26967,10715,1417,3104,3705,1698,791,660,380,213,9,8,196,167,167,134,33,0,0,0,0,0,280,199,85,19,95,81,31,20,0,11,50,0,24,26,77707
26968,7253,783,2867,2439,783,381,459,249,197,86,39,72,52,46,38,0,8,6,0,0,6,210,178,59,0,119,32,22,22,0,0,10,0,0,10,77708
26969,8838,809,2474,3146,1748,661,670,380,311,103,22,186,69,23,14,0,9,46,25,21,0,290,272,103,0,169,18,18,16,0,2,0,0,0,0,77713
26970,6842,2025,1553,1553,867,844,744,428,388,108,22,258,40,7,0,0,7,33,33,0,0,316,316,118,25,173,0,0,0,0,0,0,0,0,0,77801
26971,15239,1278,3309,3992,3782,2878,921,365,365,166,50,149,0,0,0,0,0,0,0,0,0,556,486,65,147,274,70,30,21,0,9,40,35,5,0,77802
26972,16908,5600,5981,3857,1058,412,1703,890,619,143,147,329,271,66,22,29,15,205,60,77,68,813,658,212,102,344,155,84,49,12,23,71,44,20,7,77803
26973,6590,1793,1766,1463,885,683,584,284,241,74,41,126,43,28,0,0,28,15,0,0,15,300,136,36,0,100,164,114,86,0,28,50,26,22,2,77807
26974,7186,1090,1876,2324,1410,486,735,409,389,6,0,383,20,18,17,0,1,2,2,0,0,326,321,154,0,167,5,5,0,0,5,0,0,0,0,77808
26975,2317,318,887,701,218,193,222,123,92,24,0,68,31,5,5,0,0,26,24,0,2,99,31,30,0,1,68,9,9,0,0,59,0,0,59,77830
26976,2212,314,1135,569,157,37,348,187,112,2,0,110,75,20,0,0,20,55,15,40,0,161,93,0,6,87,68,6,0,0,6,62,22,0,40,77831
26977,18380,3543,5138,5438,3086,1175,2404,1316,1042,209,125,708,274,192,85,29,78,82,0,0,82,1088,945,283,41,621,143,137,100,0,37,6,0,0,6,77833
26978,1737,198,623,464,372,80,174,157,116,0,0,116,41,26,26,0,0,15,0,0,15,17,17,0,0,17,0,0,0,0,0,0,0,0,0,77835
26979,7868,1949,2697,2256,624,342,678,363,259,128,17,114,104,104,28,45,31,0,0,0,0,315,300,113,25,162,15,15,15,0,0,0,0,0,0,77836
26980,1194,305,510,246,100,33,137,39,18,9,0,9,21,21,14,0,7,0,0,0,0,98,86,31,0,55,12,12,0,0,12,0,0,0,0,77837
26981,15926,1437,2367,3792,4438,3892,11547,5685,5627,871,264,4492,58,38,16,22,0,20,0,4,16,5862,5686,1052,512,4122,176,136,63,0,73,40,11,13,16,77840
26982,29009,1331,3538,7845,8012,8283,2624,1094,1051,257,182,612,43,33,33,0,0,10,9,0,1,1530,1461,535,116,810,69,49,49,0,0,20,0,0,20,77845
26983,779,108,279,260,33,99,54,26,15,8,0,7,11,0,0,0,0,11,11,0,0,28,28,0,0,28,0,0,0,0,0,0,0,0,0,77853
26984,58,13,0,34,11,0,8,8,8,0,8,0,0,0,0,0,0,0,0,0,0,0,0,0,0,0,0,0,0,0,0,0,0,0,0,77855
26985,3159,603,1062,809,408,277,193,132,98,42,0,56,34,0,0,0,0,34,8,26,0,61,49,0,21,28,12,0,0,0,0,12,0,0,12,77856
26986,643,99,309,162,57,16,46,32,32,5,14,13,0,0,0,0,0,0,0,0,0,14,14,4,0,10,0,0,0,0,0,0,0,0,0,77857
26987,4177,1262,1648,775,404,88,485,293,286,114,0,172,7,0,0,0,0,7,7,0,0,192,147,59,0,88,45,20,20,0,0,25,0,0,25,77859
26988,1939,236,695,703,219,86,108,50,48,10,4,34,2,2,2,0,0,0,0,0,0,58,52,19,0,33,6,6,6,0,0,0,0,0,0,77861
26989,4199,816,1572,1209,465,137,588,390,267,75,83,109,123,123,116,7,0,0,0,0,0,198,181,86,9,86,17,17,17,0,0,0,0,0,0,77864
26990,1232,196,410,498,91,37,53,44,14,6,0,8,30,30,30,0,0,0,0,0,0,9,6,0,0,6,3,3,0,3,0,0,0,0,0,77865
26991,76,36,33,7,0,0,6,6,6,5,0,1,0,0,0,0,0,0,0,0,0,0,0,0,0,0,0,0,0,0,0,0,0,0,0,77867
26992,9921,2638,3646,2655,700,282,466,297,252,8,0,244,45,14,5,0,9,31,4,0,27,169,169,82,0,87,0,0,0,0,0,0,0,0,0,77868
26993,2279,197,788,626,409,259,152,107,98,11,5,82,9,9,6,3,0,0,0,0,0,45,45,34,0,11,0,0,0,0,0,0,0,0,0,77871
26994,1060,146,499,295,67,53,54,29,29,0,9,20,0,0,0,0,0,0,0,0,0,25,4,0,4,0,21,13,0,0,13,8,0,0,8,77872
26995,1048,108,332,424,87,97,87,46,28,0,0,28,18,18,18,0,0,0,0,0,0,41,41,9,0,32,0,0,0,0,0,0,0,0,0,77873
26996,194,57,93,44,0,0,0,0,0,0,0,0,0,0,0,0,0,0,0,0,0,0,0,0,0,0,0,0,0,0,0,0,0,0,0,77876
26997,372,62,220,67,23,0,22,4,4,4,0,0,0,0,0,0,0,0,0,0,0,18,12,10,0,2,6,0,0,0,0,6,0,0,6,77878
26998,3372,575,1525,906,302,64,173,103,92,20,8,64,11,11,11,0,0,0,0,0,0,70,58,18,3,37,12,0,0,0,0,12,0,0,12,77879
26999,1098,227,341,381,119,30,89,45,45,45,0,0,0,0,0,0,0,0,0,0,0,44,44,0,0,44,0,0,0,0,0,0,0,0,0,77880
27000,25608,6457,8416,7696,2104,935,2643,1268,915,238,94,583,353,189,58,48,83,164,164,0,0,1375,979,319,88,572,396,163,118,0,45,233,87,0,146,77901
27001,17292,1209,4591,7286,2948,1258,1493,1003,935,404,201,330,68,58,46,0,12,10,0,0,10,490,382,29,19,334,108,102,97,5,0,6,0,0,6,77904
27002,10101,1534,3534,3475,1099,459,606,299,256,55,0,201,43,43,43,0,0,0,0,0,0,307,228,61,38,129,79,75,59,16,0,4,0,0,4,77905
27003,159,42,40,24,42,11,0,0,0,0,0,0,0,0,0,0,0,0,0,0,0,0,0,0,0,0,0,0,0,0,0,0,0,0,0,77950
27004,1481,626,494,300,19,42,0,0,0,0,0,0,0,0,0,0,0,0,0,0,0,0,0,0,0,0,0,0,0,0,0,0,0,0,0,77951
27005,8117,1779,3109,2169,622,438,597,309,228,13,4,211,81,36,9,2,25,45,40,0,5,288,198,74,0,124,90,76,43,12,21,14,0,0,14,77954
27006,5456,1165,1678,1611,774,228,517,197,182,53,0,129,15,0,0,0,0,15,0,15,0,320,263,115,13,135,57,57,8,21,28,0,0,0,0,77957
27007,17,0,11,0,6,0,0,0,0,0,0,0,0,0,0,0,0,0,0,0,0,0,0,0,0,0,0,0,0,0,0,0,0,0,0,77960
27008,59,0,0,0,59,0,0,0,0,0,0,0,0,0,0,0,0,0,0,0,0,0,0,0,0,0,0,0,0,0,0,0,0,0,0,77961
27009,2299,466,872,718,195,48,234,95,80,3,18,59,15,15,3,0,12,0,0,0,0,139,100,25,0,75,39,24,9,0,15,15,0,0,15,77962
27010,4021,670,1271,1439,472,169,273,193,139,32,20,87,54,53,40,0,13,1,0,1,0,80,43,14,0,29,37,32,15,17,0,5,5,0,0,77963
27011,5783,996,2285,1454,834,214,314,147,141,26,30,85,6,6,6,0,0,0,0,0,0,167,167,50,20,97,0,0,0,0,0,0,0,0,0,77964
27012,1665,177,476,674,243,95,273,71,71,26,15,30,0,0,0,0,0,0,0,0,0,202,187,62,0,125,15,15,0,0,15,0,0,0,0,77968
27013,184,35,132,17,0,0,19,19,19,0,0,19,0,0,0,0,0,0,0,0,0,0,0,0,0,0,0,0,0,0,0,0,0,0,0,77969
27014,225,42,97,37,46,3,33,15,15,0,0,15,0,0,0,0,0,0,0,0,0,18,5,0,0,5,13,13,0,0,13,0,0,0,0,77970
27015,427,32,143,142,97,13,31,31,31,0,0,31,0,0,0,0,0,0,0,0,0,0,0,0,0,0,0,0,0,0,0,0,0,0,0,77971
27016,55,0,0,29,26,0,0,0,0,0,0,0,0,0,0,0,0,0,0,0,0,0,0,0,0,0,0,0,0,0,0,0,0,0,0,77973
27017,434,76,235,95,12,16,27,19,18,0,0,18,1,1,0,1,0,0,0,0,0,8,8,0,4,4,0,0,0,0,0,0,0,0,0,77974
27018,1395,298,648,233,159,57,49,37,32,0,0,32,5,5,0,0,5,0,0,0,0,12,12,5,7,0,0,0,0,0,0,0,0,0,0,77975
27019,135,18,49,54,14,0,0,0,0,0,0,0,0,0,0,0,0,0,0,0,0,0,0,0,0,0,0,0,0,0,0,0,0,0,0,77976
27020,338,165,101,72,0,0,71,61,49,0,0,49,12,12,12,0,0,0,0,0,0,10,10,5,0,5,0,0,0,0,0,0,0,0,0,77977
27021,473,61,155,190,47,20,68,37,37,0,0,37,0,0,0,0,0,0,0,0,0,31,9,0,0,9,22,22,0,22,0,0,0,0,0,77978
27022,11055,2613,3503,3063,1180,696,835,426,359,138,15,206,67,25,23,0,2,42,42,0,0,409,380,99,81,200,29,21,0,0,21,8,0,8,0,77979
27023,994,158,329,356,96,55,0,0,0,0,0,0,0,0,0,0,0,0,0,0,0,0,0,0,0,0,0,0,0,0,0,0,0,0,0,77982
27024,1466,295,670,388,86,27,209,141,126,6,30,90,15,0,0,0,0,15,0,0,15,68,68,17,0,51,0,0,0,0,0,0,0,0,0,77983
27025,2865,497,1223,643,363,139,238,134,108,68,18,22,26,16,16,0,0,10,0,0,10,104,104,49,12,43,0,0,0,0,0,0,0,0,0,77984
27026,121,7,35,44,21,14,7,0,0,0,0,0,0,0,0,0,0,0,0,0,0,7,7,0,0,7,0,0,0,0,0,0,0,0,0,77987
27027,235,105,94,36,0,0,9,0,0,0,0,0,0,0,0,0,0,0,0,0,0,9,0,0,0,0,9,9,9,0,0,0,0,0,0,77988
27028,506,145,157,138,48,18,29,10,10,5,0,5,0,0,0,0,0,0,0,0,0,19,19,0,0,19,0,0,0,0,0,0,0,0,0,77990
27029,168,52,67,14,35,0,13,0,0,0,0,0,0,0,0,0,0,0,0,0,0,13,13,0,0,13,0,0,0,0,0,0,0,0,0,77991
27030,139,0,72,49,9,9,6,6,0,0,0,0,6,6,6,0,0,0,0,0,0,0,0,0,0,0,0,0,0,0,0,0,0,0,0,77993
27031,259,48,142,47,20,2,4,4,4,0,0,4,0,0,0,0,0,0,0,0,0,0,0,0,0,0,0,0,0,0,0,0,0,0,0,77994
27032,6210,1586,2363,1569,563,129,419,210,67,19,0,48,143,33,26,0,7,110,77,0,33,209,173,29,81,63,36,25,4,11,10,11,0,0,11,77995
27033,0,0,0,0,0,0,0,0,0,0,0,0,0,0,0,0,0,0,0,0,0,0,0,0,0,0,0,0,0,0,0,0,0,0,0,78001
27034,6019,2097,1624,1814,366,118,567,302,199,37,0,162,103,92,52,40,0,11,0,0,11,265,252,10,48,194,13,0,0,0,0,13,0,0,13,78002
27035,6254,1237,1700,2035,1036,246,337,84,75,34,23,18,9,9,0,0,9,0,0,0,0,253,165,38,0,127,88,88,49,39,0,0,0,0,0,78003
27036,1001,22,177,401,178,223,51,24,24,0,0,24,0,0,0,0,0,0,0,0,0,27,27,11,0,16,0,0,0,0,0,0,0,0,0,78004
27037,255,33,74,108,26,14,39,24,24,0,0,24,0,0,0,0,0,0,0,0,0,15,15,0,0,15,0,0,0,0,0,0,0,0,0,78005
27038,19320,1717,3701,5774,5136,2992,1546,969,888,316,38,534,81,67,67,0,0,14,0,14,0,577,518,155,0,363,59,59,37,22,0,0,0,0,0,78006
27039,4,4,0,0,0,0,0,0,0,0,0,0,0,0,0,0,0,0,0,0,0,0,0,0,0,0,0,0,0,0,0,0,0,0,0,78007
27040,219,67,88,39,25,0,0,0,0,0,0,0,0,0,0,0,0,0,0,0,0,0,0,0,0,0,0,0,0,0,0,0,0,0,0,78008
27041,5156,878,1262,1732,879,405,702,434,356,29,11,316,78,0,0,0,0,78,0,39,39,268,185,46,0,139,83,12,12,0,0,71,0,71,0,78009
27042,2032,322,612,703,270,125,250,123,123,39,12,72,0,0,0,0,0,0,0,0,0,127,71,48,0,23,56,56,47,0,9,0,0,0,0,78010
27043,1208,531,379,190,72,36,110,63,51,12,0,39,12,12,12,0,0,0,0,0,0,47,47,0,0,47,0,0,0,0,0,0,0,0,0,78011
27044,209,89,67,49,1,3,32,20,16,0,0,16,4,4,4,0,0,0,0,0,0,12,7,0,0,7,5,0,0,0,0,5,5,0,0,78012
27045,3855,645,1132,1060,503,515,449,265,195,29,0,166,70,0,0,0,0,70,70,0,0,184,166,34,0,132,18,18,0,18,0,0,0,0,0,78013
27046,3233,1428,922,701,101,81,352,148,92,54,0,38,56,56,56,0,0,0,0,0,0,204,72,0,0,72,132,76,38,38,0,56,42,0,14,78014
27047,6915,125,778,1961,2346,1705,432,219,200,46,29,125,19,19,17,0,2,0,0,0,0,213,211,131,11,69,2,2,0,0,2,0,0,0,0,78015
27048,6175,1450,1701,2061,632,331,763,356,282,13,0,269,74,49,44,0,5,25,0,7,18,407,356,84,3,269,51,9,9,0,0,42,0,0,42,78016
27049,2979,922,1247,630,177,3,310,217,154,16,0,138,63,26,12,0,14,37,0,0,37,93,53,0,0,53,40,40,40,0,0,0,0,0,0,78017
27050,974,486,244,186,58,0,154,74,30,16,0,14,44,29,29,0,0,15,0,0,15,80,74,0,0,74,6,0,0,0,0,6,0,0,6,78019
27051,154,95,31,28,0,0,47,18,18,0,0,18,0,0,0,0,0,0,0,0,0,29,29,0,0,29,0,0,0,0,0,0,0,0,0,78021
27052,2986,695,946,831,344,170,255,133,117,24,0,93,16,13,13,0,0,3,0,3,0,122,87,63,0,24,35,21,0,21,0,14,14,0,0,78022
27053,16788,782,2594,4663,4965,3784,1564,653,538,112,15,411,115,77,43,8,26,38,0,23,15,911,848,181,70,597,63,33,0,6,27,30,0,0,30,78023
27054,998,22,113,299,310,254,50,15,15,0,0,15,0,0,0,0,0,0,0,0,0,35,28,0,0,28,7,7,0,0,7,0,0,0,0,78024
27055,3559,548,1167,1051,695,98,241,164,125,42,22,61,39,34,34,0,0,5,0,0,5,77,75,18,0,57,2,0,0,0,0,2,0,0,2,78025
27056,4087,913,1649,957,356,212,303,82,81,23,0,58,1,0,0,0,0,1,0,0,1,221,150,88,0,62,71,71,0,53,18,0,0,0,0,78026
27057,387,42,149,88,86,22,0,0,0,0,0,0,0,0,0,0,0,0,0,0,0,0,0,0,0,0,0,0,0,0,0,0,0,0,0,78027
27058,27998,3495,7991,8418,5346,2748,1994,1057,847,249,97,501,210,145,53,91,1,65,0,60,5,937,586,186,115,285,351,189,106,12,71,162,91,0,71,78028
27059,0,0,0,0,0,0,0,0,0,0,0,0,0,0,0,0,0,0,0,0,0,0,0,0,0,0,0,0,0,0,0,0,0,0,0,78029
27060,971,106,375,331,101,58,76,48,48,13,0,35,0,0,0,0,0,0,0,0,0,28,23,14,5,4,5,5,5,0,0,0,0,0,0,78039
27061,23354,12209,5366,4298,1061,420,2890,1351,997,77,51,869,354,182,59,12,111,172,0,5,167,1539,1243,158,29,1056,296,58,33,0,25,238,23,0,215,78040
27062,26466,7551,5560,7313,3917,2125,3254,1697,1453,184,131,1138,244,126,74,26,26,118,0,0,118,1557,1397,257,81,1059,160,84,9,0,75,76,47,0,29,78041
27063,23058,9552,5486,5336,1823,861,3415,1641,1307,278,78,951,334,227,139,30,58,107,70,0,37,1774,1473,263,79,1131,301,203,81,22,100,98,14,0,84,78043
27064,111,48,56,7,0,0,0,0,0,0,0,0,0,0,0,0,0,0,0,0,0,0,0,0,0,0,0,0,0,0,0,0,0,0,0,78044
27065,33057,5892,6086,10402,7939,2738,3356,1610,1426,287,111,1028,184,121,79,19,23,63,33,15,15,1746,1651,229,96,1326,95,95,53,0,42,0,0,0,0,78045
27066,30587,13755,7342,6912,2215,363,5115,2810,2496,422,159,1915,314,202,143,8,51,112,69,0,43,2305,1822,326,175,1321,483,195,86,27,82,288,19,68,201,78046
27067,486,183,163,58,62,20,61,18,18,8,0,10,0,0,0,0,0,0,0,0,0,43,9,0,0,9,34,34,15,19,0,0,0,0,0,78050
27068,4278,1278,1166,1049,562,223,491,262,222,99,39,84,40,40,40,0,0,0,0,0,0,229,229,62,84,83,0,0,0,0,0,0,0,0,0,78052
27069,1547,211,605,395,159,177,179,153,153,0,0,153,0,0,0,0,0,0,0,0,0,26,26,0,0,26,0,0,0,0,0,0,0,0,0,78055
27070,1568,13,485,426,451,193,56,40,40,12,0,28,0,0,0,0,0,0,0,0,0,16,0,0,0,0,16,16,16,0,0,0,0,0,0,78056
27071,561,237,66,240,0,18,48,48,48,0,0,48,0,0,0,0,0,0,0,0,0,0,0,0,0,0,0,0,0,0,0,0,0,0,0,78057
27072,650,21,88,325,186,30,5,0,0,0,0,0,0,0,0,0,0,0,0,0,0,5,5,0,0,5,0,0,0,0,0,0,0,0,0,78058
27073,3693,729,1315,1249,299,101,179,67,57,17,0,40,10,0,0,0,0,10,0,0,10,112,65,4,8,53,47,31,0,0,31,16,16,0,0,78059
27074,0,0,0,0,0,0,0,0,0,0,0,0,0,0,0,0,0,0,0,0,0,0,0,0,0,0,0,0,0,0,0,0,0,0,0,78060
27075,7217,2789,2376,1553,370,129,798,358,309,138,32,139,49,10,0,0,10,39,0,0,39,440,306,87,18,201,134,92,62,0,30,42,0,0,42,78061
27076,6929,592,2170,2745,1009,413,382,176,107,22,34,51,69,69,69,0,0,0,0,0,0,206,206,0,0,206,0,0,0,0,0,0,0,0,0,78063
27077,8674,1747,2875,2285,1069,698,724,361,295,54,13,228,66,66,66,0,0,0,0,0,0,363,248,85,10,153,115,115,38,77,0,0,0,0,0,78064
27078,6804,1988,2511,1813,355,137,739,425,328,94,43,191,97,97,16,68,13,0,0,0,0,314,251,49,0,202,63,48,24,24,0,15,0,0,15,78065
27079,426,132,85,150,49,10,47,10,10,0,0,10,0,0,0,0,0,0,0,0,0,37,37,0,0,37,0,0,0,0,0,0,0,0,0,78066
27080,235,70,57,97,11,0,28,11,11,0,0,11,0,0,0,0,0,0,0,0,0,17,17,0,0,17,0,0,0,0,0,0,0,0,0,78067
27081,3301,1107,1119,809,193,73,429,177,140,5,0,135,37,29,29,0,0,8,0,8,0,252,204,16,9,179,48,11,0,0,11,37,0,0,37,78069
27082,10387,873,2324,3322,2486,1382,838,358,257,35,8,214,101,86,72,14,0,15,15,0,0,480,399,51,0,348,81,15,15,0,0,66,0,66,0,78070
27083,3292,780,1165,935,348,64,234,191,120,32,0,88,71,36,20,4,12,35,35,0,0,43,20,0,0,20,23,0,0,0,0,23,23,0,0,78071
27084,406,127,85,164,30,0,54,48,48,48,0,0,0,0,0,0,0,0,0,0,0,6,6,6,0,0,0,0,0,0,0,0,0,0,0,78072
27085,4728,1627,1792,1116,120,73,359,200,119,13,0,106,81,42,12,14,16,39,0,25,14,159,149,3,27,119,10,10,0,0,10,0,0,0,0,78073
27086,105,52,21,10,9,13,0,0,0,0,0,0,0,0,0,0,0,0,0,0,0,0,0,0,0,0,0,0,0,0,0,0,0,0,0,78075
27087,7531,3413,1984,1479,455,200,818,432,409,142,0,267,23,23,23,0,0,0,0,0,0,386,277,0,0,277,109,109,0,0,109,0,0,0,0,78076
27088,5770,777,2181,1810,745,257,380,248,196,47,0,149,52,0,0,0,0,52,0,0,52,132,132,36,0,96,0,0,0,0,0,0,0,0,0,78101
27089,18888,5559,5826,5961,979,563,1517,839,595,40,29,526,244,52,8,0,44,192,24,4,164,678,574,76,15,483,104,104,87,0,17,0,0,0,0,78102
27090,76,0,42,20,9,5,10,10,10,10,0,0,0,0,0,0,0,0,0,0,0,0,0,0,0,0,0,0,0,0,0,0,0,0,0,78104
27091,125,31,85,9,0,0,46,0,0,0,0,0,0,0,0,0,0,0,0,0,0,46,46,0,0,46,0,0,0,0,0,0,0,0,0,78107
27092,17955,1082,3859,6535,3978,2501,2463,1190,1106,340,33,733,84,84,70,14,0,0,0,0,0,1273,1058,291,34,733,215,130,90,0,40,85,0,0,85,78108
27093,22881,2631,6004,8816,3677,1753,1722,896,757,203,40,514,139,76,43,33,0,63,22,41,0,826,721,234,17,470,105,37,26,0,11,68,0,0,68,78109
27094,4484,1089,1711,1364,279,41,593,205,188,59,30,99,17,0,0,0,0,17,0,17,0,388,319,54,28,237,69,57,15,0,42,12,0,12,0,78112
27095,1848,346,691,433,275,103,115,47,25,7,0,18,22,0,0,0,0,22,0,0,22,68,34,0,0,34,34,34,23,0,11,0,0,0,0,78113
27096,13353,2332,4434,4547,1406,634,1233,684,546,167,13,366,138,111,49,40,22,27,8,0,19,549,442,169,47,226,107,26,26,0,0,81,36,37,8,78114
27097,301,38,157,89,8,9,12,0,0,0,0,0,0,0,0,0,0,0,0,0,0,12,12,10,0,2,0,0,0,0,0,0,0,0,0,78116
27098,521,72,190,118,104,37,30,24,24,0,4,20,0,0,0,0,0,0,0,0,0,6,6,0,0,6,0,0,0,0,0,0,0,0,0,78117
27099,2702,883,832,713,210,64,205,94,32,0,0,32,62,32,16,14,2,30,0,0,30,111,98,20,3,75,13,13,13,0,0,0,0,0,0,78118
27100,5211,1684,1848,1216,303,160,252,154,73,21,25,27,81,46,27,0,19,35,0,0,35,98,83,0,8,75,15,15,7,0,8,0,0,0,0,78119
27101,7287,844,2546,2188,1165,544,651,264,251,62,51,138,13,13,13,0,0,0,0,0,0,387,369,77,31,261,18,18,18,0,0,0,0,0,0,78121
27102,152,17,47,73,15,0,0,0,0,0,0,0,0,0,0,0,0,0,0,0,0,0,0,0,0,0,0,0,0,0,0,0,0,0,0,78122
27103,1845,189,788,562,188,118,62,45,32,0,0,32,13,0,0,0,0,13,0,13,0,17,17,17,0,0,0,0,0,0,0,0,0,0,0,78123
27104,3711,588,1114,1159,642,208,290,131,109,46,4,59,22,13,7,6,0,9,0,7,2,159,146,31,8,107,13,7,2,2,3,6,0,0,6,78124
27105,61,0,17,31,11,2,14,14,14,14,0,0,0,0,0,0,0,0,0,0,0,0,0,0,0,0,0,0,0,0,0,0,0,0,0,78125
27106,39543,6005,10595,13302,7371,2270,3134,1594,1227,361,64,802,367,237,216,5,16,130,64,18,48,1540,1285,418,205,662,255,212,125,21,66,43,0,0,43,78130
27107,14314,1116,3037,4087,4029,2045,1391,657,567,173,19,375,90,76,13,0,63,14,0,14,0,734,681,294,0,387,53,53,37,15,1,0,0,0,0,78132
27108,12107,596,3647,4147,2561,1156,801,361,259,23,10,226,102,79,15,0,64,23,0,23,0,440,406,121,92,193,34,34,0,18,16,0,0,0,0,78133
27109,2013,892,557,334,101,129,219,105,82,25,0,57,23,19,19,0,0,4,4,0,0,114,110,8,11,91,4,4,0,0,4,0,0,0,0,78140
27110,570,172,198,107,68,25,9,9,9,0,0,9,0,0,0,0,0,0,0,0,0,0,0,0,0,0,0,0,0,0,0,0,0,0,0,78141
27111,122,16,54,34,10,8,7,2,2,0,0,2,0,0,0,0,0,0,0,0,0,5,0,0,0,0,5,5,0,0,5,0,0,0,0,78142
27112,92,29,32,31,0,0,54,30,30,0,0,30,0,0,0,0,0,0,0,0,0,24,24,0,0,24,0,0,0,0,0,0,0,0,0,78143
27113,8,0,0,8,0,0,0,0,0,0,0,0,0,0,0,0,0,0,0,0,0,0,0,0,0,0,0,0,0,0,0,0,0,0,0,78144
27114,56,17,5,34,0,0,0,0,0,0,0,0,0,0,0,0,0,0,0,0,0,0,0,0,0,0,0,0,0,0,0,0,0,0,0,78145
27115,513,130,162,171,43,7,88,60,40,0,30,10,20,13,0,0,13,7,0,0,7,28,18,0,0,18,10,4,0,0,4,6,0,0,6,78146
27116,1228,346,413,278,139,52,119,50,43,3,0,40,7,7,7,0,0,0,0,0,0,69,51,21,0,30,18,10,10,0,0,8,0,0,8,78147
27117,12912,1230,3007,5120,2206,1349,1233,763,496,210,44,242,267,166,121,13,32,101,101,0,0,470,365,70,38,257,105,83,83,0,0,22,0,0,22,78148
27118,0,0,0,0,0,0,18,18,0,0,0,0,18,18,18,0,0,0,0,0,0,0,0,0,0,0,0,0,0,0,0,0,0,0,0,78150
27119,1000,312,410,196,82,0,127,58,58,0,16,42,0,0,0,0,0,0,0,0,0,69,43,14,0,29,26,16,3,0,13,10,0,10,0,78151
27120,1666,143,661,578,234,50,125,74,68,20,10,38,6,6,6,0,0,0,0,0,0,51,46,19,0,27,5,5,5,0,0,0,0,0,0,78152
27121,20793,1599,4753,8029,3970,2442,1479,845,752,246,82,424,93,93,93,0,0,0,0,0,0,634,599,108,32,459,35,27,11,0,16,8,0,0,8,78154
27122,30627,5944,10381,8910,3719,1673,3569,1881,1543,277,180,1086,338,264,171,58,35,74,11,7,56,1688,1385,454,146,785,303,291,208,74,9,12,12,0,0,78155
27123,647,131,297,135,75,9,18,5,5,2,0,3,0,0,0,0,0,0,0,0,0,13,7,1,0,6,6,6,2,0,4,0,0,0,0,78159
27124,3324,401,1254,1074,515,80,170,64,64,51,0,13,0,0,0,0,0,0,0,0,0,106,106,39,5,62,0,0,0,0,0,0,0,0,0,78160
27125,490,32,226,133,67,32,50,28,28,0,14,14,0,0,0,0,0,0,0,0,0,22,0,0,0,0,22,0,0,0,0,22,0,22,0,78161
27126,254,30,86,103,23,12,10,10,0,0,0,0,10,10,10,0,0,0,0,0,0,0,0,0,0,0,0,0,0,0,0,0,0,0,0,78162
27127,7109,762,1549,2178,1757,863,614,472,443,72,45,326,29,29,29,0,0,0,0,0,0,142,123,16,0,107,19,0,0,0,0,19,0,0,19,78163
27128,2955,780,1055,737,305,78,198,86,75,3,0,72,11,11,11,0,0,0,0,0,0,112,112,34,45,33,0,0,0,0,0,0,0,0,0,78164
27129,28382,8684,8562,7236,2227,1673,2126,986,665,111,76,478,321,222,118,59,45,99,18,47,34,1140,983,140,114,729,157,125,77,35,13,32,5,22,5,78201
27130,7254,2839,2198,1565,477,175,752,457,339,40,17,282,118,81,47,19,15,37,0,37,0,295,188,50,26,112,107,43,22,0,21,64,23,0,41,78202
27131,3563,1379,835,1023,179,147,197,101,84,20,0,64,17,12,12,0,0,5,5,0,0,96,36,9,0,27,60,22,0,22,0,38,14,8,16,78203
27132,7381,2685,2140,1640,601,315,599,314,289,45,33,211,25,15,9,6,0,10,4,6,0,285,231,33,10,188,54,16,0,0,16,38,0,0,38,78204
27133,876,280,83,247,121,145,1,1,0,0,0,0,1,0,0,0,0,1,0,0,1,0,0,0,0,0,0,0,0,0,0,0,0,0,0,78205
27134,31989,15172,9936,5479,866,536,3841,2205,1566,157,217,1192,639,290,55,112,123,349,17,89,243,1636,1360,400,35,925,276,127,70,0,57,149,105,0,44,78207
27135,2337,973,655,524,146,39,167,120,56,0,17,39,64,54,49,0,5,10,10,0,0,47,19,0,0,19,28,12,12,0,0,16,0,4,12,78208
27136,28154,1454,3617,7760,8257,7066,2461,1205,1058,274,62,722,147,147,46,83,18,0,0,0,0,1256,1081,309,69,703,175,112,93,19,0,63,0,31,32,78209
27137,23240,7104,7179,6113,1684,1160,2070,956,689,116,81,492,267,140,85,15,40,127,63,26,38,1114,792,129,44,619,322,101,78,0,23,221,65,13,143,78210
27138,20523,8507,7009,4135,650,222,2235,1141,968,74,59,835,173,111,35,4,72,62,0,14,48,1094,886,99,202,585,208,146,108,6,32,62,34,28,0,78211
27139,19172,4468,3962,4815,3240,2687,2020,943,863,179,59,625,80,45,35,10,0,35,8,6,21,1077,1015,296,35,684,62,50,37,0,13,12,0,0,12,78212
27140,26517,4642,7833,8385,3739,1918,2341,1190,850,114,27,709,340,196,59,0,137,144,91,0,53,1151,889,121,81,687,262,146,67,0,79,116,40,0,76,78213
27141,14918,5574,5176,3302,684,182,1185,605,539,77,34,428,66,20,20,0,0,46,45,0,1,580,511,40,82,389,69,60,25,0,35,9,0,9,0,78214
27142,1022,168,90,455,144,165,34,19,19,0,0,19,0,0,0,0,0,0,0,0,0,15,15,9,0,6,0,0,0,0,0,0,0,0,0,78215
27143,26546,3171,6019,8784,5139,3433,1451,720,493,122,35,336,227,153,73,11,69,74,63,0,11,731,632,112,38,482,99,83,69,0,14,16,0,9,7,78216
27144,21740,2491,5840,7861,3844,1704,1479,909,590,98,75,417,319,257,155,41,61,62,25,18,19,570,424,169,20,235,146,129,69,46,14,17,17,0,0,78217
27145,19983,3546,6135,7105,1945,1252,1991,945,702,91,199,412,243,122,82,10,30,121,121,0,0,1046,850,194,96,560,196,136,36,24,76,60,33,27,0,78218
27146,8902,2241,2509,3055,780,317,803,484,297,87,11,199,187,84,36,0,48,103,33,43,27,319,237,44,20,173,82,82,14,26,42,0,0,0,0,78219
27147,10669,3153,3014,3248,883,371,1092,582,422,0,40,382,160,42,8,11,23,118,31,20,67,510,381,83,0,298,129,106,25,72,9,23,0,0,23,78220
27148,21841,7159,8034,5368,982,298,2182,1139,826,170,126,530,313,189,55,30,104,124,70,46,8,1043,838,226,99,513,205,101,15,48,38,104,44,0,60,78221
27149,12589,2522,3805,4149,1455,658,1256,518,424,27,47,350,94,39,29,0,10,55,17,0,38,738,468,91,31,346,270,75,75,0,0,195,7,0,188,78222
27150,31199,8120,11411,8820,2111,737,3341,1882,1365,266,176,923,517,326,146,65,115,191,113,14,64,1459,1183,230,133,820,276,217,91,21,105,59,0,49,10,78223
27151,10994,3725,3682,2775,635,177,1336,728,602,133,50,419,126,39,0,19,20,87,0,26,61,608,372,80,6,286,236,187,146,0,41,49,35,14,0,78224
27152,8649,3245,2801,1988,481,134,957,472,333,55,8,270,139,105,55,20,30,34,6,0,28,485,450,147,16,287,35,27,27,0,0,8,8,0,0,78225
27153,3654,1386,1070,959,177,62,446,292,207,81,43,83,85,85,82,3,0,0,0,0,0,154,114,59,0,55,40,40,40,0,0,0,0,0,0,78226
27154,26661,7336,9219,8011,1513,582,2821,1324,1043,135,55,853,281,174,89,35,50,107,67,31,9,1497,1150,199,24,927,347,251,78,50,123,96,24,0,72,78227
27155,35972,10695,11401,10282,2413,1181,4222,2067,1791,186,98,1507,276,145,51,30,64,131,18,0,113,2155,1875,446,104,1325,280,280,110,22,148,0,0,0,0,78228
27156,19358,2082,4839,6293,3517,2627,1055,380,334,36,8,290,46,46,0,0,46,0,0,0,0,675,539,51,0,488,136,74,19,0,55,62,0,31,31,78229
27157,27523,2048,3710,8305,7791,5669,1825,1061,956,197,76,683,105,32,13,0,19,73,56,0,17,764,719,156,32,531,45,24,10,0,14,21,0,0,21,78230
27158,5552,186,636,1823,1682,1225,526,204,204,41,41,122,0,0,0,0,0,0,0,0,0,322,314,116,0,198,8,0,0,0,0,8,0,0,8,78231
27159,26097,640,4083,8847,7752,4775,1635,782,754,322,15,417,28,28,28,0,0,0,0,0,0,853,763,229,13,521,90,78,58,0,20,12,0,0,12,78232
27160,28987,3138,8522,11147,4484,1696,2669,1434,1141,194,160,787,293,278,132,120,26,15,0,0,15,1235,1042,432,0,610,193,162,62,87,13,31,14,0,17,78233
27161,2421,45,299,1281,505,291,1509,732,358,252,0,106,374,374,343,0,31,0,0,0,0,777,217,127,0,90,560,560,470,0,90,0,0,0,0,78234
27162,381,22,72,181,69,37,58,34,6,0,0,6,28,28,28,0,0,0,0,0,0,24,17,17,0,0,7,7,7,0,0,0,0,0,0,78235
27163,1689,69,300,842,428,50,2979,2352,484,411,0,73,1868,1866,1788,27,51,2,2,0,0,627,166,139,0,27,461,461,442,0,19,0,0,0,0,78236
27164,22409,10438,7288,3831,696,156,2830,1257,911,41,56,814,346,284,199,46,39,62,0,48,14,1573,1215,141,96,978,358,219,73,44,102,139,34,0,105,78237
27165,16749,2435,4640,6618,1963,1093,1358,789,657,95,101,461,132,111,57,19,35,21,0,0,21,569,463,218,47,198,106,51,39,11,1,55,0,14,41,78238
27166,18510,2508,4845,6990,2439,1728,1564,842,701,223,48,430,141,88,46,4,38,53,40,0,13,722,626,153,64,409,96,96,8,0,88,0,0,0,0,78239
27167,34805,2826,6096,12230,9024,4629,2084,908,746,262,30,454,162,98,98,0,0,64,38,26,0,1176,950,172,69,709,226,156,45,19,92,70,0,0,70,78240
27168,17227,5861,5992,4323,837,214,2096,999,732,82,38,612,267,159,60,76,23,108,42,11,55,1097,772,156,78,538,325,158,52,45,61,167,56,59,52,78242
27169,55,8,0,23,24,0,110,72,25,17,0,8,47,47,37,0,10,0,0,0,0,38,0,0,0,0,38,38,38,0,0,0,0,0,0,78243
27170,17775,2096,4957,7278,2440,1004,1850,914,806,99,156,551,108,81,27,32,22,27,0,0,27,936,722,212,42,468,214,145,26,24,95,69,24,0,45,78244
27171,35030,4313,10078,14197,4576,1866,3863,1941,1691,380,147,1164,250,244,84,51,109,6,0,0,6,1922,1592,508,97,987,330,210,137,39,34,120,29,0,91,78245
27172,32225,1335,6839,13160,7650,3241,2191,1044,891,235,45,611,153,40,26,0,14,113,86,14,13,1147,1027,476,31,520,120,95,28,17,50,25,0,0,25,78247
27173,9983,261,921,2408,3651,2742,719,434,404,38,0,366,30,30,30,0,0,0,0,0,0,285,285,74,0,211,0,0,0,0,0,0,0,0,0,78248
27174,29487,1741,4390,10179,8683,4494,4827,2432,2268,745,291,1232,164,139,91,11,37,25,0,12,13,2395,2328,618,385,1325,67,67,27,40,0,0,0,0,0,78249
27175,34416,2832,8600,14462,5428,3094,3648,2192,1877,478,168,1231,315,268,231,27,10,47,11,0,36,1456,1354,501,67,786,102,91,48,0,43,11,0,0,11,78250
27176,31495,2551,7170,12463,6599,2712,3255,1725,1330,290,194,846,395,288,169,60,59,107,96,11,0,1530,1313,351,191,771,217,180,105,0,75,37,0,0,37,78251
27177,4490,1247,1353,1334,389,167,531,326,115,0,0,115,211,66,48,0,18,145,32,0,113,205,205,60,16,129,0,0,0,0,0,0,0,0,0,78252
27178,19397,1087,3671,6945,4724,2970,1690,942,860,297,65,498,82,61,17,28,16,21,6,0,15,748,667,191,54,422,81,32,31,0,1,49,0,0,49,78253
27179,27849,1640,5420,10251,7451,3087,2631,1652,1501,745,120,636,151,109,91,18,0,42,0,17,25,979,944,231,119,594,35,35,19,0,16,0,0,0,0,78254
27180,7996,257,761,2115,2933,1930,468,225,212,27,59,126,13,0,0,0,0,13,13,0,0,243,223,59,26,138,20,20,20,0,0,0,0,0,0,78255
27181,3774,82,286,678,1392,1336,362,102,102,0,0,102,0,0,0,0,0,0,0,0,0,260,260,77,45,138,0,0,0,0,0,0,0,0,0,78256
27182,2783,111,414,436,825,997,212,102,89,50,0,39,13,0,0,0,0,13,13,0,0,110,110,17,15,78,0,0,0,0,0,0,0,0,0,78257
27183,26071,696,2125,7014,10086,6150,2967,1513,1347,324,41,982,166,150,95,15,40,16,0,0,16,1454,1381,375,48,958,73,73,18,0,55,0,0,0,0,78258
27184,14460,568,1925,4019,4999,2949,1317,663,571,157,36,378,92,63,22,10,31,29,5,0,24,654,636,229,15,392,18,18,18,0,0,0,0,0,0,78259
27185,16037,658,2713,4371,5466,2829,1274,725,680,264,114,302,45,34,13,10,11,11,11,0,0,549,527,71,0,456,22,22,0,0,22,0,0,0,0,78260
27186,8422,281,1023,2419,3045,1654,610,435,435,75,0,360,0,0,0,0,0,0,0,0,0,175,172,43,15,114,3,0,0,0,0,3,0,0,3,78261
27187,2684,291,891,919,417,166,311,189,186,27,18,141,3,3,3,0,0,0,0,0,0,122,122,83,0,39,0,0,0,0,0,0,0,0,0,78263
27188,7037,2385,2703,1567,297,85,1211,494,433,91,83,259,61,37,26,11,0,24,24,0,0,717,654,60,28,566,63,10,10,0,0,53,0,0,53,78264
27189,4224,242,627,1310,1046,999,351,168,129,40,3,86,39,39,0,0,39,0,0,0,0,183,130,0,15,115,53,26,0,26,0,27,0,0,27,78266
27190,562,152,168,177,50,15,49,24,19,0,0,19,5,5,0,5,0,0,0,0,0,25,25,0,0,25,0,0,0,0,0,0,0,0,0,78330
27191,17383,5349,5294,4711,1251,778,1805,1092,897,78,69,750,195,141,87,14,40,54,0,13,41,713,454,79,49,326,259,76,34,9,33,183,92,0,91,78332
27192,0,0,0,0,0,0,0,0,0,0,0,0,0,0,0,0,0,0,0,0,0,0,0,0,0,0,0,0,0,0,0,0,0,0,0,78335
27193,8336,1896,2606,2796,737,301,609,339,226,37,14,175,113,112,52,0,60,1,0,0,1,270,215,63,12,140,55,55,13,0,42,0,0,0,0,78336
27194,0,0,0,0,0,0,0,0,0,0,0,0,0,0,0,0,0,0,0,0,0,0,0,0,0,0,0,0,0,0,0,0,0,0,0,78338
27195,437,152,108,133,44,0,40,18,0,0,0,0,18,18,18,0,0,0,0,0,0,22,22,0,0,22,0,0,0,0,0,0,0,0,0,78339
27196,342,46,109,141,44,2,26,8,8,0,2,6,0,0,0,0,0,0,0,0,0,18,18,0,0,18,0,0,0,0,0,0,0,0,0,78340
27197,1645,590,583,319,120,33,155,96,90,13,0,77,6,6,0,0,6,0,0,0,0,59,46,0,0,46,13,13,0,0,13,0,0,0,0,78341
27198,309,167,57,16,69,0,31,22,22,0,0,22,0,0,0,0,0,0,0,0,0,9,9,0,0,9,0,0,0,0,0,0,0,0,0,78342
27199,2968,770,907,949,287,55,143,69,69,18,7,44,0,0,0,0,0,0,0,0,0,74,65,13,23,29,9,0,0,0,0,9,0,0,9,78343
27200,285,41,69,78,75,22,46,40,40,0,0,40,0,0,0,0,0,0,0,0,0,6,6,0,0,6,0,0,0,0,0,0,0,0,0,78344
27201,476,191,131,116,36,2,16,10,10,0,10,0,0,0,0,0,0,0,0,0,0,6,6,6,0,0,0,0,0,0,0,0,0,0,0,78349
27202,385,96,101,144,17,27,19,11,11,4,0,7,0,0,0,0,0,0,0,0,0,8,8,0,0,8,0,0,0,0,0,0,0,0,0,78351
27203,102,48,25,29,0,0,19,0,0,0,0,0,0,0,0,0,0,0,0,0,0,19,19,0,0,19,0,0,0,0,0,0,0,0,0,78352
27204,450,336,71,43,0,0,21,21,0,0,0,0,21,21,0,0,21,0,0,0,0,0,0,0,0,0,0,0,0,0,0,0,0,0,0,78353
27205,4128,1323,1299,1002,315,189,507,385,263,129,0,134,122,8,8,0,0,114,33,0,81,122,97,4,0,93,25,25,0,0,25,0,0,0,0,78355
27206,1737,638,501,520,78,0,274,131,92,5,0,87,39,11,11,0,0,28,28,0,0,143,86,22,0,64,57,24,24,0,0,33,20,0,13,78357
27207,468,73,163,159,60,13,26,13,13,0,0,13,0,0,0,0,0,0,0,0,0,13,13,0,0,13,0,0,0,0,0,0,0,0,0,78358
27208,1116,490,322,203,78,23,128,87,76,16,0,60,11,6,0,0,6,5,0,0,5,41,28,0,0,28,13,7,0,0,7,6,0,6,0,78359
27209,3345,1154,1101,730,239,121,184,107,103,79,0,24,4,0,0,0,0,4,0,0,4,77,58,0,0,58,19,0,0,0,0,19,18,1,0,78361
27210,5638,805,1777,2305,562,189,708,405,305,45,46,214,100,100,66,8,26,0,0,0,0,303,264,51,0,213,39,26,10,16,0,13,2,11,0,78362
27211,17008,4416,3785,4736,2708,1363,2530,1306,1058,170,102,786,248,161,100,56,5,87,55,0,32,1224,1104,422,96,586,120,21,0,0,21,99,0,61,38,78363
27212,6092,1914,2025,1619,343,191,492,188,140,32,7,101,48,22,18,4,0,26,13,13,0,304,280,93,0,187,24,5,5,0,0,19,0,0,19,78368
27213,246,96,60,66,11,13,51,38,38,0,0,38,0,0,0,0,0,0,0,0,0,13,13,0,0,13,0,0,0,0,0,0,0,0,0,78369
27214,2731,596,859,899,225,152,197,113,105,20,27,58,8,4,3,0,1,4,0,0,4,84,84,30,0,54,0,0,0,0,0,0,0,0,0,78370
27215,242,109,70,63,0,0,19,13,0,0,0,0,13,0,0,0,0,13,0,0,13,6,6,0,0,6,0,0,0,0,0,0,0,0,0,78371
27216,3307,677,1162,1170,146,152,148,79,79,15,0,64,0,0,0,0,0,0,0,0,0,69,69,0,0,69,0,0,0,0,0,0,0,0,0,78372
27217,2819,158,574,1126,528,433,172,47,47,10,0,37,0,0,0,0,0,0,0,0,0,125,125,20,0,105,0,0,0,0,0,0,0,0,0,78373
27218,9946,983,2400,3914,1873,776,1247,704,657,56,7,594,47,39,22,0,17,8,0,0,8,543,426,132,32,262,117,116,116,0,0,1,0,0,1,78374
27219,1969,583,671,594,87,34,233,146,120,16,0,104,26,21,0,6,15,5,0,0,5,87,70,18,0,52,17,17,0,0,17,0,0,0,0,78375
27220,435,157,175,78,7,18,21,2,2,0,0,2,0,0,0,0,0,0,0,0,0,19,12,0,0,12,7,7,0,7,0,0,0,0,0,78376
27221,2445,581,716,923,142,83,254,134,122,2,0,120,12,12,11,0,1,0,0,0,0,120,102,15,0,87,18,18,0,17,1,0,0,0,0,78377
27222,1010,269,207,337,116,81,77,34,21,4,0,17,13,9,9,0,0,4,4,0,0,43,35,4,0,31,8,0,0,0,0,8,0,0,8,78379
27223,14959,4823,4266,4399,921,550,1289,763,615,145,0,470,148,45,2,34,9,103,68,27,8,526,460,92,30,338,66,18,0,0,18,48,3,9,36,78380
27224,14948,1979,4770,4844,2217,1138,1101,561,334,22,0,312,227,177,88,73,16,50,50,0,0,540,341,122,45,174,199,180,113,0,67,19,7,0,12,78382
27225,3049,662,708,1172,138,369,160,103,39,0,0,39,64,64,28,0,36,0,0,0,0,57,57,15,0,42,0,0,0,0,0,0,0,0,0,78383
27226,3870,1197,1366,1105,127,75,510,256,133,6,0,127,123,19,0,19,0,104,0,95,9,254,104,37,0,67,150,80,0,58,22,70,0,70,0,78384
27227,280,113,80,78,8,1,14,4,4,0,0,4,0,0,0,0,0,0,0,0,0,10,10,0,0,10,0,0,0,0,0,0,0,0,0,78385
27228,6707,2215,2114,1648,571,159,586,307,188,25,36,127,119,69,37,23,9,50,16,0,34,279,172,21,0,151,107,96,14,43,39,11,0,11,0,78387
27229,997,383,295,266,11,42,77,27,27,0,0,27,0,0,0,0,0,0,0,0,0,50,20,20,0,0,30,30,0,0,30,0,0,0,0,78389
27230,3524,1054,1114,1030,275,51,382,195,142,66,8,68,53,42,0,42,0,11,0,0,11,187,182,47,20,115,5,5,0,5,0,0,0,0,0,78390
27231,237,107,68,62,0,0,9,9,0,0,0,0,9,9,0,0,9,0,0,0,0,0,0,0,0,0,0,0,0,0,0,0,0,0,0,78391
27232,1591,248,706,436,130,71,137,80,80,13,15,52,0,0,0,0,0,0,0,0,0,57,57,38,0,19,0,0,0,0,0,0,0,0,0,78393
27233,3746,1124,1289,723,349,261,132,57,29,0,7,22,28,0,0,0,0,28,0,0,28,75,31,0,0,31,44,20,8,0,12,24,0,0,24,78401
27234,529,107,145,166,81,30,2,0,0,0,0,0,0,0,0,0,0,0,0,0,0,2,0,0,0,0,2,2,0,2,0,0,0,0,0,78402
27235,10742,2527,2558,3167,1398,1092,714,273,221,53,47,121,52,25,12,0,13,27,0,0,27,441,361,149,7,205,80,56,8,0,48,24,0,0,24,78404
27236,9701,4774,2895,1595,348,89,749,296,232,43,29,160,64,17,17,0,0,47,0,10,37,453,319,39,40,240,134,90,26,0,64,44,13,8,23,78405
27237,859,288,273,261,37,0,90,71,44,0,0,44,27,0,0,0,0,27,0,0,27,19,10,0,0,10,9,9,9,0,0,0,0,0,0,78406
27238,1694,639,464,466,63,62,237,69,49,16,0,33,20,12,12,0,0,8,0,8,0,168,130,27,5,98,38,22,22,0,0,16,6,10,0,78407
27239,7554,2829,2657,1649,324,95,700,329,299,5,33,261,30,30,15,0,15,0,0,0,0,371,247,56,16,175,124,100,51,29,20,24,8,11,5,78408
27240,1763,458,492,713,65,35,136,77,62,0,28,34,15,11,3,8,0,4,0,0,4,59,50,26,0,24,9,9,6,0,3,0,0,0,0,78409
27241,16279,2150,4796,5804,2675,854,1211,591,549,59,33,457,42,31,0,0,31,11,0,0,11,620,565,96,43,426,55,28,20,0,8,27,0,27,0,78410
27242,18414,3283,4956,6632,2093,1450,1648,818,652,159,128,365,166,0,0,0,0,166,90,0,76,830,689,215,0,474,141,115,0,78,37,26,13,0,13,78411
27243,23247,3235,5995,8119,3762,2136,3350,1569,1461,295,99,1067,108,99,58,17,24,9,9,0,0,1781,1651,265,244,1142,130,114,75,0,39,16,0,0,16,78412
27244,24259,1929,5328,9710,4023,3269,2110,988,795,133,214,448,193,102,102,0,0,91,52,39,0,1122,1074,268,134,672,48,48,41,0,7,0,0,0,0,78413
27245,20729,1146,4243,7950,4542,2848,1625,1011,1006,211,56,739,5,5,5,0,0,0,0,0,0,614,610,271,8,331,4,4,0,0,4,0,0,0,0,78414
27246,24397,6572,8224,7312,1514,775,2471,1360,1047,270,137,640,313,190,134,21,35,123,120,3,0,1111,875,188,23,664,236,126,94,14,18,110,50,7,53,78415
27247,9965,4245,3116,2139,328,137,870,358,173,25,20,128,185,100,100,0,0,85,14,0,71,512,384,92,20,272,128,88,66,0,22,40,19,0,21,78416
27248,2556,847,790,777,92,50,465,223,146,49,2,95,77,44,20,10,14,33,33,0,0,242,130,29,0,101,112,97,47,0,50,15,0,0,15,78417
27249,20884,1947,5415,7455,3830,2237,1789,953,843,335,48,460,110,99,99,0,0,11,11,0,0,836,616,121,8,487,220,200,125,0,75,20,20,0,0,78418
27250,433,60,53,236,66,18,25,11,0,0,0,0,11,11,11,0,0,0,0,0,0,14,14,7,0,7,0,0,0,0,0,0,0,0,0,78419
27251,37816,12604,8121,8934,6009,2148,4059,2079,1754,218,73,1463,325,171,132,28,11,154,18,12,124,1980,1598,234,131,1233,382,105,50,10,45,277,88,0,189,78501
27252,12813,4706,2539,2727,1867,974,1808,978,754,89,97,568,224,79,63,16,0,145,30,53,62,830,701,18,32,651,129,71,54,0,17,58,14,13,31,78503
27253,29399,3840,5758,9026,7752,3023,3676,2037,1774,351,51,1372,263,99,73,26,0,164,22,35,107,1639,1489,266,108,1115,150,112,79,0,33,38,0,0,38,78504
27254,20349,9533,5062,4109,1137,508,2603,1501,1097,206,66,825,404,174,143,19,12,230,111,0,119,1102,957,99,54,804,145,130,0,53,77,15,15,0,0,78516
27255,34916,13809,7425,8132,3722,1828,4118,1977,1629,197,104,1328,348,232,84,0,148,116,10,21,85,2141,1821,261,261,1299,320,215,8,58,149,105,39,0,66,78520
27256,49044,22139,11741,10044,4005,1115,7037,3454,2961,255,203,2503,493,311,157,43,111,182,8,75,99,3583,2861,211,117,2533,722,381,87,41,253,341,9,6,326,78521
27257,24189,7044,5049,6508,4010,1578,3327,1494,1251,208,56,987,243,110,40,23,47,133,65,9,59,1833,1605,174,66,1365,228,50,21,0,29,178,43,11,124,78526
27258,399,174,171,54,0,0,28,20,10,4,0,6,10,10,0,0,10,0,0,0,0,8,0,0,0,0,8,8,0,8,0,0,0,0,0,78535
27259,255,92,103,36,9,15,30,30,21,0,0,21,9,9,0,0,9,0,0,0,0,0,0,0,0,0,0,0,0,0,0,0,0,0,0,78536
27260,20011,9092,5552,3711,1230,426,2706,1274,1066,290,59,717,208,28,28,0,0,180,101,11,68,1432,1089,39,62,988,343,188,21,21,146,155,0,126,29,78537
27261,5974,2836,1406,1225,399,108,656,273,243,15,85,143,30,30,6,18,6,0,0,0,0,383,343,10,46,287,40,6,0,0,6,34,0,0,34,78538
27262,20335,3316,4174,6414,4460,1971,1927,1003,780,80,114,586,223,175,141,14,20,48,0,32,16,924,797,217,22,558,127,82,64,0,18,45,26,0,19,78539
27263,21320,7275,4717,5540,2941,847,3342,1837,1795,170,285,1340,42,0,0,0,0,42,33,0,9,1505,1322,175,60,1087,183,103,24,0,79,80,0,0,80,78541
27264,34161,15281,8673,6425,2672,1110,4908,2423,2055,254,179,1622,368,186,24,101,61,182,79,56,47,2485,1990,203,135,1652,495,164,65,10,89,331,39,43,249,78542
27265,4549,1990,1403,831,217,108,662,556,407,22,58,327,149,67,0,15,52,82,0,82,0,106,106,24,0,82,0,0,0,0,0,0,0,0,0,78543
27266,119,53,34,32,0,0,15,15,15,0,15,0,0,0,0,0,0,0,0,0,0,0,0,0,0,0,0,0,0,0,0,0,0,0,0,78545
27267,270,97,71,92,10,0,38,19,0,0,0,0,19,19,0,19,0,0,0,0,0,19,19,0,0,19,0,0,0,0,0,0,0,0,0,78548
27268,281,189,36,46,10,0,48,0,0,0,0,0,0,0,0,0,0,0,0,0,0,48,48,0,0,48,0,0,0,0,0,0,0,0,0,78549
27269,31846,9311,8100,8773,4103,1559,3183,1774,1491,162,90,1239,283,140,25,88,27,143,32,7,104,1409,1184,48,45,1091,225,110,40,7,63,115,0,9,106,78550
27270,21778,4912,6926,5742,3078,1120,2592,1454,1179,116,56,1007,275,212,153,11,48,63,0,5,58,1138,911,48,61,802,227,140,47,0,93,87,5,32,50,78552
27271,6678,2514,1944,1081,849,290,1126,454,426,103,9,314,28,7,0,7,0,21,0,0,21,672,512,169,12,331,160,52,0,30,22,108,0,0,108,78557
27272,502,198,135,81,68,20,54,15,15,0,0,15,0,0,0,0,0,0,0,0,0,39,22,0,0,22,17,17,17,0,0,0,0,0,0,78558
27273,7053,2369,2359,1711,388,226,877,531,439,113,0,326,92,84,61,23,0,8,0,0,8,346,268,29,20,219,78,36,0,10,26,42,12,0,30,78559
27274,2437,1207,455,443,217,115,313,174,131,10,0,121,43,32,0,23,9,11,0,0,11,139,75,7,0,68,64,35,0,0,35,29,0,0,29,78560
27275,291,145,84,49,13,0,39,33,33,0,0,33,0,0,0,0,0,0,0,0,0,6,3,0,0,3,3,3,0,0,3,0,0,0,0,78561
27276,1323,671,290,269,93,0,107,67,38,0,0,38,29,19,11,8,0,10,0,0,10,40,14,0,0,14,26,14,0,0,14,12,0,0,12,78562
27277,136,85,6,9,30,6,6,0,0,0,0,0,0,0,0,0,0,0,0,0,0,6,6,6,0,0,0,0,0,0,0,0,0,0,0,78563
27278,19,19,0,0,0,0,0,0,0,0,0,0,0,0,0,0,0,0,0,0,0,0,0,0,0,0,0,0,0,0,0,0,0,0,0,78564
27279,140,79,24,16,0,21,0,0,0,0,0,0,0,0,0,0,0,0,0,0,0,0,0,0,0,0,0,0,0,0,0,0,0,0,0,78565
27280,9257,3566,2104,2074,1122,391,1339,917,652,145,36,471,265,141,51,29,61,124,0,22,102,422,301,40,18,243,121,93,0,0,93,28,2,0,26,78566
27281,275,141,75,48,0,11,24,17,13,0,0,13,4,4,4,0,0,0,0,0,0,7,3,0,0,3,4,4,0,4,0,0,0,0,0,78567
27282,2155,679,652,600,150,74,349,200,195,27,5,163,5,5,0,0,5,0,0,0,0,149,137,0,0,137,12,12,0,0,12,0,0,0,0,78569
27283,16300,7877,4306,2743,991,383,1955,857,803,135,171,497,54,38,11,27,0,16,16,0,0,1098,924,232,174,518,174,113,80,14,19,61,0,0,61,78570
27284,43209,14652,10948,9475,5458,2676,5049,2468,2129,340,160,1629,339,271,199,34,38,68,0,0,68,2581,2214,422,86,1706,367,148,111,0,37,219,38,10,171,78572
27285,18430,8098,4060,4318,1457,497,2840,1663,1262,258,39,965,401,172,95,73,4,229,66,0,163,1177,856,197,27,632,321,173,115,22,36,148,0,25,123,78573
27286,29649,14852,6010,5742,2217,828,5382,2822,2348,207,92,2049,474,336,216,57,63,138,13,36,89,2560,2047,225,53,1769,513,237,132,34,71,276,0,0,276,78574
27287,5637,1681,974,1218,1004,760,426,242,222,37,49,136,20,20,0,0,20,0,0,0,0,184,151,19,0,132,33,0,0,0,0,33,0,0,33,78575
27288,4811,2665,1116,809,154,67,961,506,319,40,3,276,187,22,0,0,22,165,5,0,160,455,443,120,31,292,12,12,6,0,6,0,0,0,0,78576
27289,39678,15292,11113,8136,3772,1365,3820,1761,1629,339,163,1127,132,60,44,16,0,72,32,0,40,2059,1751,391,130,1230,308,230,113,21,96,78,0,21,57,78577
27290,7210,2198,1855,1649,807,701,574,274,225,51,7,167,49,34,15,13,6,15,15,0,0,300,274,39,0,235,26,19,0,0,19,7,7,0,0,78578
27291,2140,881,682,530,34,13,285,131,118,14,48,56,13,0,0,0,0,13,13,0,0,154,124,0,12,112,30,30,0,0,30,0,0,0,0,78579
27292,9824,3670,3173,2086,727,168,959,549,319,37,0,282,230,203,61,0,142,27,0,0,27,410,306,45,0,261,104,104,0,0,104,0,0,0,0,78580
27293,22494,12223,5120,3249,1494,408,2997,1493,1189,122,154,913,304,171,27,123,21,133,32,0,101,1504,1257,132,82,1043,247,181,0,35,146,66,0,0,66,78582
27294,3749,1342,739,1071,405,192,512,270,258,30,0,228,12,6,0,0,6,6,6,0,0,242,215,0,0,215,27,27,0,0,27,0,0,0,0,78583
27295,10221,6012,1898,1386,620,305,1351,681,555,37,24,494,126,98,57,0,41,28,0,23,5,670,604,70,48,486,66,31,0,0,31,35,0,0,35,78584
27296,190,73,84,31,2,0,60,22,22,0,0,22,0,0,0,0,0,0,0,0,0,38,38,0,0,38,0,0,0,0,0,0,0,0,0,78585
27297,32883,14543,7747,8208,1919,466,3878,2013,1563,166,81,1316,450,277,167,14,96,173,11,50,112,1865,1427,112,44,1271,438,162,36,70,56,276,45,47,184,78586
27298,101,31,22,26,15,7,0,0,0,0,0,0,0,0,0,0,0,0,0,0,0,0,0,0,0,0,0,0,0,0,0,0,0,0,0,78588
27299,20070,9074,5173,3935,1368,520,2310,1398,1073,182,103,788,325,253,169,0,84,72,32,0,40,912,693,105,0,588,219,87,12,0,75,132,26,0,106,78589
27300,196,119,56,17,4,0,29,8,6,0,0,6,2,2,2,0,0,0,0,0,0,21,21,0,0,21,0,0,0,0,0,0,0,0,0,78590
27301,154,23,60,49,19,3,20,14,14,0,0,14,0,0,0,0,0,0,0,0,0,6,6,0,0,6,0,0,0,0,0,0,0,0,0,78591
27302,597,295,138,153,11,0,88,39,39,5,0,34,0,0,0,0,0,0,0,0,0,49,43,0,0,43,6,0,0,0,0,6,0,0,6,78592
27303,3148,1437,785,598,291,37,346,140,104,6,0,98,36,36,0,36,0,0,0,0,0,206,141,0,0,141,65,47,20,5,22,18,0,0,18,78593
27304,895,466,299,96,12,22,166,84,65,0,0,65,19,0,0,0,0,19,0,0,19,82,82,0,0,82,0,0,0,0,0,0,0,0,0,78594
27305,3093,2127,429,385,141,11,637,354,307,10,0,297,47,34,23,0,11,13,0,0,13,283,190,9,0,181,93,66,36,0,30,27,0,0,27,78595
27306,36991,14378,9594,7841,3715,1463,4817,2398,2024,366,283,1375,374,147,72,57,18,227,36,82,109,2419,1905,312,225,1368,514,254,105,40,109,260,122,93,45,78596
27307,2582,224,347,801,663,547,78,44,43,0,0,43,1,1,1,0,0,0,0,0,0,34,34,34,0,0,0,0,0,0,0,0,0,0,0,78597
27308,150,16,54,38,42,0,34,18,0,0,0,0,18,0,0,0,0,18,0,0,18,16,16,8,0,8,0,0,0,0,0,0,0,0,0,78598
27309,17982,2940,5042,6672,2237,1091,1050,514,409,109,50,250,105,86,72,0,14,19,0,0,19,536,429,104,43,282,107,99,33,17,49,8,8,0,0,78602
27310,3616,716,1109,1181,428,182,324,244,192,50,0,142,52,52,43,0,9,0,0,0,0,80,79,31,5,43,1,0,0,0,0,1,0,0,1,78605
27311,3716,510,1232,1060,636,278,351,201,104,10,0,94,97,67,35,32,0,30,29,0,1,150,140,40,0,100,10,10,0,10,0,0,0,0,0,78606
27312,101,0,0,32,47,22,0,0,0,0,0,0,0,0,0,0,0,0,0,0,0,0,0,0,0,0,0,0,0,0,0,0,0,0,0,78607
27313,180,0,13,152,0,15,35,0,0,0,0,0,0,0,0,0,0,0,0,0,0,35,35,20,0,15,0,0,0,0,0,0,0,0,0,78608
27314,1387,145,400,504,234,104,55,31,18,0,0,18,13,13,13,0,0,0,0,0,0,24,18,0,0,18,6,0,0,0,0,6,6,0,0,78609
27315,16293,2040,3768,5221,3801,1463,1408,785,530,145,33,352,255,245,76,142,27,10,9,0,1,623,479,81,33,365,144,125,19,20,86,19,6,0,13,78610
27316,9347,1421,3498,2646,1274,508,804,320,233,87,11,135,87,38,38,0,0,49,0,0,49,484,304,142,0,162,180,174,12,0,162,6,0,0,6,78611
27317,7105,1120,2640,2190,862,293,653,350,249,52,0,197,101,101,22,79,0,0,0,0,0,303,262,0,0,262,41,41,0,16,25,0,0,0,0,78612
27318,42707,1604,6844,14425,14141,5693,3587,1914,1787,358,349,1080,127,121,60,24,37,6,6,0,0,1673,1505,347,100,1058,168,162,134,28,0,6,0,6,0,78613
27319,380,106,111,92,71,0,16,16,7,0,0,7,9,9,9,0,0,0,0,0,0,0,0,0,0,0,0,0,0,0,0,0,0,0,0,78614
27320,670,38,232,233,149,18,0,0,0,0,0,0,0,0,0,0,0,0,0,0,0,0,0,0,0,0,0,0,0,0,0,0,0,0,0,78615
27321,3570,883,1381,790,343,173,360,226,176,90,0,86,50,33,0,0,33,17,0,0,17,134,114,35,0,79,20,20,14,0,6,0,0,0,0,78616
27322,12109,4007,3794,2799,1270,239,1744,1014,764,80,10,674,250,104,0,34,70,146,30,43,73,730,458,110,13,335,272,219,67,32,120,53,39,14,0,78617
27323,264,30,81,90,39,24,5,1,1,1,0,0,0,0,0,0,0,0,0,0,0,4,4,0,3,1,0,0,0,0,0,0,0,0,0,78618
27324,2326,59,270,394,1087,516,169,151,151,3,0,148,0,0,0,0,0,0,0,0,0,18,18,0,0,18,0,0,0,0,0,0,0,0,0,78619
27325,9955,559,1609,2831,3385,1571,783,454,371,75,0,296,83,62,29,33,0,21,7,0,14,329,329,121,0,208,0,0,0,0,0,0,0,0,0,78620
27326,14228,2963,4321,4769,1416,759,907,544,465,110,42,313,79,67,54,9,4,12,0,0,12,363,324,99,66,159,39,0,0,0,0,39,0,0,39,78621
27327,145,38,61,20,26,0,5,0,0,0,0,0,0,0,0,0,0,0,0,0,0,5,0,0,0,0,5,5,0,5,0,0,0,0,0,78622
27328,656,0,95,186,245,130,26,0,0,0,0,0,0,0,0,0,0,0,0,0,0,26,26,0,0,26,0,0,0,0,0,0,0,0,0,78623
27329,15714,2028,4224,4779,3144,1539,1012,522,451,135,0,316,71,43,43,0,0,28,28,0,0,490,466,305,35,126,24,0,0,0,0,24,0,0,24,78624
27330,16705,2744,4756,4636,3315,1254,1955,1050,849,146,85,618,201,89,37,13,39,112,38,0,74,905,716,187,77,452,189,26,0,0,26,163,37,0,126,78626
27331,17174,1240,3131,5120,5074,2609,1421,753,579,193,106,280,174,58,46,0,12,116,31,0,85,668,563,196,108,259,105,40,25,15,0,65,27,0,38,78628
27332,7538,2067,2226,2053,855,337,713,288,203,47,24,132,85,74,0,56,18,11,2,0,9,425,347,77,103,167,78,71,70,0,1,7,7,0,0,78629
27333,1876,214,771,462,247,182,71,66,39,0,0,39,27,27,13,0,14,0,0,0,0,5,5,0,0,5,0,0,0,0,0,0,0,0,0,78631
27334,545,109,217,124,53,42,41,41,24,0,0,24,17,0,0,0,0,17,17,0,0,0,0,0,0,0,0,0,0,0,0,0,0,0,0,78632
27335,16004,336,2739,4626,4902,3401,278,122,115,52,0,63,7,7,7,0,0,0,0,0,0,156,140,17,33,90,16,0,0,0,0,16,16,0,0,78633
27336,15366,1089,4372,6180,3032,693,1327,805,650,78,167,405,155,42,25,17,0,113,0,0,113,522,448,93,53,302,74,74,42,0,32,0,0,0,0,78634
27337,19,0,19,0,0,0,0,0,0,0,0,0,0,0,0,0,0,0,0,0,0,0,0,0,0,0,0,0,0,0,0,0,0,0,0,78635
27338,2978,391,814,955,582,236,185,114,101,13,52,36,13,13,13,0,0,0,0,0,0,71,71,22,0,49,0,0,0,0,0,0,0,0,0,78636
27339,1637,291,720,349,202,75,117,41,23,9,14,0,18,0,0,0,0,18,0,18,0,76,47,26,0,21,29,29,29,0,0,0,0,0,0,78638
27340,4865,959,1668,1457,657,124,359,209,209,0,0,209,0,0,0,0,0,0,0,0,0,150,85,27,16,42,65,24,8,0,16,41,0,41,0,78639
27341,25713,4371,6750,8921,4364,1307,2364,1266,1030,105,134,791,236,75,17,37,21,161,14,25,122,1098,954,109,41,804,144,139,115,0,24,5,0,3,2,78640
27342,30394,3039,6600,11147,7161,2447,2410,1359,1165,274,44,847,194,129,118,11,0,65,0,56,9,1051,984,271,58,655,67,54,12,32,10,13,0,0,13,78641
27343,5909,498,1501,2141,1398,371,741,334,267,98,4,165,67,59,54,5,0,8,0,0,8,407,356,164,72,120,51,37,37,0,0,14,0,0,14,78642
27344,4749,823,1172,1558,834,362,341,187,187,48,0,139,0,0,0,0,0,0,0,0,0,154,99,30,0,69,55,9,9,0,0,46,0,11,35,78643
27345,11822,2256,4581,3204,1209,572,923,626,365,78,38,249,261,242,87,78,77,19,0,0,19,297,281,54,28,199,16,16,16,0,0,0,0,0,0,78644
27346,7983,368,1769,3051,2001,794,365,209,209,84,0,125,0,0,0,0,0,0,0,0,0,156,141,15,25,101,15,15,5,10,0,0,0,0,0,78645
27347,5115,1362,1823,996,781,153,361,185,130,25,0,105,55,55,31,0,24,0,0,0,0,176,176,60,0,116,0,0,0,0,0,0,0,0,0,78648
27348,1128,285,351,325,136,31,130,44,33,11,0,22,11,11,11,0,0,0,0,0,0,86,72,0,0,72,14,14,14,0,0,0,0,0,0,78650
27349,3606,301,764,925,1271,345,216,81,81,1,3,77,0,0,0,0,0,0,0,0,0,135,135,70,23,42,0,0,0,0,0,0,0,0,0,78652
27350,9905,1974,2247,3362,1744,578,854,404,301,58,60,183,103,50,21,29,0,53,53,0,0,450,366,26,0,340,84,17,0,0,17,67,11,53,3,78653
27351,11730,1860,3212,3800,1878,980,960,629,445,82,19,344,184,118,73,45,0,66,66,0,0,331,272,141,3,128,59,59,22,37,0,0,0,0,0,78654
27352,2328,541,748,622,259,158,395,165,136,30,0,106,29,29,6,10,13,0,0,0,0,230,191,18,10,163,39,39,20,0,19,0,0,0,0,78655
27353,1297,210,557,402,128,0,118,86,86,25,0,61,0,0,0,0,0,0,0,0,0,32,21,0,0,21,11,11,11,0,0,0,0,0,0,78656
27354,5142,367,1152,1837,1221,565,145,65,63,23,4,36,2,0,0,0,0,2,0,0,2,80,54,35,0,19,26,26,26,0,0,0,0,0,0,78657
27355,2334,170,1046,727,262,129,123,32,32,0,0,32,0,0,0,0,0,0,0,0,0,91,44,10,0,34,47,47,0,0,47,0,0,0,0,78659
27356,46508,4517,9586,15839,11731,4835,3567,1730,1491,453,127,911,239,171,60,111,0,68,0,0,68,1837,1445,504,95,846,392,229,158,15,56,163,37,0,126,78660
27357,242,53,152,26,11,0,34,22,8,8,0,0,14,14,14,0,0,0,0,0,0,12,0,0,0,0,12,12,0,12,0,0,0,0,0,78661
27358,2041,338,785,664,140,114,293,147,112,0,26,86,35,35,35,0,0,0,0,0,0,146,146,17,0,129,0,0,0,0,0,0,0,0,0,78662
27359,671,93,171,225,90,92,3,3,3,3,0,0,0,0,0,0,0,0,0,0,0,0,0,0,0,0,0,0,0,0,0,0,0,0,0,78663
27360,34651,4428,7833,12087,7320,2983,3013,1428,1172,201,237,734,256,228,141,39,48,28,0,0,28,1585,1350,315,172,863,235,226,162,50,14,9,0,9,0,78664
27361,22238,1109,3657,7678,6797,2997,2095,1010,926,248,40,638,84,64,64,0,0,20,0,20,0,1085,731,157,46,528,354,354,152,150,52,0,0,0,0,78665
27362,31122,4676,7620,9127,6919,2780,8052,3128,2522,386,155,1981,606,286,73,21,192,320,22,0,298,4924,4458,816,325,3317,466,330,77,18,235,136,9,4,123,78666
27363,6480,268,1536,2097,1665,914,260,143,123,57,11,55,20,20,4,16,0,0,0,0,0,117,113,7,0,106,4,2,0,0,2,2,0,0,2,78669
27364,276,63,126,65,10,12,0,0,0,0,0,0,0,0,0,0,0,0,0,0,0,0,0,0,0,0,0,0,0,0,0,0,0,0,0,78670
27365,503,225,128,98,31,21,25,25,25,19,0,6,0,0,0,0,0,0,0,0,0,0,0,0,0,0,0,0,0,0,0,0,0,0,0,78671
27366,920,74,348,354,108,36,11,0,0,0,0,0,0,0,0,0,0,0,0,0,0,11,11,0,0,11,0,0,0,0,0,0,0,0,0,78672
27367,167,37,69,28,21,12,9,9,9,0,0,9,0,0,0,0,0,0,0,0,0,0,0,0,0,0,0,0,0,0,0,0,0,0,0,78675
27368,9425,384,1553,3190,2822,1476,647,328,246,71,66,109,82,81,81,0,0,1,0,0,1,319,296,48,0,248,23,23,20,3,0,0,0,0,0,78676
27369,78,19,40,19,0,0,11,11,11,0,0,11,0,0,0,0,0,0,0,0,0,0,0,0,0,0,0,0,0,0,0,0,0,0,0,78677
27370,33277,2035,5153,10170,10708,5211,2539,1246,1092,192,60,840,154,109,61,0,48,45,21,0,24,1293,1205,427,73,705,88,58,6,0,52,30,0,17,13,78681
27371,5026,251,381,598,1915,1881,38,36,30,0,0,30,6,0,0,0,0,6,0,0,6,2,2,0,0,2,0,0,0,0,0,0,0,0,0,78701
27372,14577,4304,3246,2468,3205,1354,1183,634,505,31,118,356,129,109,68,33,8,20,20,0,0,549,503,105,43,355,46,32,32,0,0,14,0,14,0,78702
27373,14801,109,588,1567,6595,5942,451,277,251,66,9,176,26,26,14,0,12,0,0,0,0,174,174,11,0,163,0,0,0,0,0,0,0,0,0,78703
27374,29947,2025,3447,7188,11110,6177,1682,850,688,151,156,381,162,100,61,0,39,62,62,0,0,832,785,185,32,568,47,22,20,0,2,25,0,0,25,78704
27375,6018,384,376,1482,2165,1611,10257,4478,4446,588,454,3404,32,32,32,0,0,0,0,0,0,5779,5766,1032,198,4536,13,13,13,0,0,0,0,0,0,78705
27376,0,0,0,0,0,0,370,169,169,11,11,147,0,0,0,0,0,0,0,0,0,201,201,11,0,190,0,0,0,0,0,0,0,0,0,78712
27377,15549,355,1938,4537,5546,3173,1014,502,487,41,0,446,15,15,0,15,0,0,0,0,0,512,425,127,53,245,87,58,58,0,0,29,0,0,29,78717
27378,1130,525,290,191,76,48,109,105,77,0,0,77,28,22,0,0,22,6,0,0,6,4,4,4,0,0,0,0,0,0,0,0,0,0,0,78719
27379,7272,2512,2018,1715,783,244,798,396,293,22,30,241,103,57,57,0,0,46,0,6,40,402,317,40,0,277,85,22,0,0,22,63,0,36,27,78721
27380,4865,304,447,978,1978,1158,147,80,52,36,0,16,28,28,28,0,0,0,0,0,0,67,67,0,0,67,0,0,0,0,0,0,0,0,0,78722
27381,19218,4418,4137,4321,4098,2244,1548,668,581,109,34,438,87,47,24,0,23,40,29,0,11,880,638,168,7,463,242,156,107,0,49,86,0,0,86,78723
27382,11543,4341,3322,2631,915,334,1262,685,493,108,63,322,192,83,26,0,57,109,40,19,50,577,415,122,36,257,162,143,0,53,90,19,8,0,11,78724
27383,5230,1890,1250,1351,597,142,452,184,167,0,55,112,17,17,0,0,17,0,0,0,0,268,147,0,44,103,121,121,121,0,0,0,0,0,0,78725
27384,8469,249,798,2302,2793,2327,701,426,426,188,15,223,0,0,0,0,0,0,0,0,0,275,245,61,18,166,30,30,30,0,0,0,0,0,0,78726
27385,19759,1046,2901,5552,7164,3096,1464,723,589,242,74,273,134,125,47,19,59,9,0,0,9,741,627,170,6,451,114,114,85,18,11,0,0,0,0,78727
27386,14119,1147,2462,4848,3850,1812,1076,521,422,47,10,365,99,75,16,59,0,24,0,16,8,555,550,106,0,444,5,5,5,0,0,0,0,0,0,78728
27387,18178,744,2645,6616,5694,2479,1121,657,629,108,78,443,28,28,28,0,0,0,0,0,0,464,451,201,7,243,13,12,0,0,12,1,0,0,1,78729
27388,5878,57,306,1153,2543,1819,362,196,196,74,0,122,0,0,0,0,0,0,0,0,0,166,126,24,0,102,40,40,40,0,0,0,0,0,0,78730
27389,18522,295,1142,3116,7528,6441,611,287,287,13,13,261,0,0,0,0,0,0,0,0,0,324,309,86,19,204,15,15,15,0,0,0,0,0,0,78731
27390,9046,3,769,1422,4010,2842,551,423,393,69,40,284,30,30,30,0,0,0,0,0,0,128,128,52,0,76,0,0,0,0,0,0,0,0,0,78732
27391,6018,128,653,953,2106,2178,534,322,316,26,0,290,6,6,0,0,6,0,0,0,0,212,187,36,0,151,25,25,6,0,19,0,0,0,0,78733
27392,12784,761,2091,3484,4408,2040,1045,579,515,115,54,346,64,16,6,0,10,48,10,38,0,466,415,210,11,194,51,41,41,0,0,10,0,0,10,78734
27393,11988,643,826,2542,4952,3025,884,504,472,118,20,334,32,32,17,0,15,0,0,0,0,380,380,25,0,355,0,0,0,0,0,0,0,0,0,78735
27394,5157,236,762,1375,1803,981,175,127,127,0,8,119,0,0,0,0,0,0,0,0,0,48,39,0,0,39,9,9,0,9,0,0,0,0,0,78736
27395,9096,304,965,2178,3463,2186,519,302,209,12,0,197,93,81,8,0,73,12,2,10,0,217,204,43,16,145,13,2,2,0,0,11,0,0,11,78737
27396,8383,27,675,1731,3865,2085,667,454,429,11,0,418,25,25,14,0,11,0,0,0,0,213,213,18,22,173,0,0,0,0,0,0,0,0,0,78738
27397,10677,101,761,2177,4754,2884,747,383,351,76,13,262,32,0,0,0,0,32,0,0,32,364,364,80,0,284,0,0,0,0,0,0,0,0,0,78739
27398,26005,8387,5560,6379,3866,1813,2821,1372,1045,345,118,582,327,139,83,8,48,188,167,0,21,1449,1258,619,16,623,191,133,60,29,44,58,22,23,13,78741
27399,531,228,107,83,68,45,28,8,0,0,0,0,8,8,8,0,0,0,0,0,0,20,20,13,0,7,0,0,0,0,0,0,0,0,0,78742
27400,24765,8767,6783,5837,2478,900,2895,1556,1160,155,201,804,396,153,68,30,55,243,102,22,119,1339,1108,372,20,716,231,163,75,12,76,68,14,31,23,78744
27401,41162,5393,8759,12602,10258,4150,2036,1183,959,189,91,679,224,130,47,24,59,94,67,21,6,853,608,97,18,493,245,100,47,12,41,145,100,0,45,78745
27402,19141,170,950,2885,8101,7035,1303,734,719,117,18,584,15,2,2,0,0,13,0,0,13,569,569,97,39,433,0,0,0,0,0,0,0,0,0,78746
27403,10222,1556,2628,3027,2354,657,610,331,292,68,0,224,39,10,0,10,0,29,0,0,29,279,212,79,17,116,67,67,0,0,67,0,0,0,0,78747
27404,28427,2018,5270,9236,8639,3264,1652,767,656,227,18,411,111,76,76,0,0,35,35,0,0,885,800,198,125,477,85,48,7,9,32,37,0,0,37,78748
27405,24040,608,2776,5972,9571,5113,1254,591,508,100,41,367,83,27,27,0,0,56,12,0,44,663,624,145,19,460,39,39,22,17,0,0,0,0,0,78749
27406,18829,659,2673,4901,6564,4032,1639,932,807,112,13,682,125,125,113,0,12,0,0,0,0,707,577,233,54,290,130,104,35,14,55,26,0,16,10,78750
27407,9185,240,690,2129,3468,2658,230,49,49,6,12,31,0,0,0,0,0,0,0,0,0,181,181,36,30,115,0,0,0,0,0,0,0,0,0,78751
27408,12008,3976,2555,2367,2095,1015,515,195,68,32,9,27,127,35,16,18,1,92,59,32,1,320,267,178,0,89,53,53,45,0,8,0,0,0,0,78752
27409,31867,9456,7995,8079,4746,1591,2437,1282,995,82,53,860,287,127,14,71,42,160,116,0,44,1155,937,148,76,713,218,113,68,45,0,105,68,0,37,78753
27410,10302,924,2524,3212,2516,1126,505,244,188,44,14,130,56,56,41,15,0,0,0,0,0,261,220,44,0,176,41,41,7,34,0,0,0,0,0,78754
27411,6144,376,480,1227,2218,1843,118,45,41,0,0,41,4,0,0,0,0,4,0,0,4,73,73,5,0,68,0,0,0,0,0,0,0,0,0,78756
27412,16764,1359,2562,4120,5220,3503,487,328,303,41,15,247,25,25,25,0,0,0,0,0,0,159,126,32,24,70,33,0,0,0,0,33,33,0,0,78757
27413,29717,6267,6470,7700,6744,2536,1555,819,572,140,28,404,247,172,97,56,19,75,37,0,38,736,519,72,69,378,217,134,81,0,53,83,49,8,26,78758
27414,29995,892,2900,6973,11325,7905,1234,798,788,153,26,609,10,5,5,0,0,5,0,0,5,436,398,161,29,208,38,34,28,5,1,4,4,0,0,78759
27415,13064,4223,2792,4149,1462,438,1366,766,581,123,83,375,185,62,52,0,10,123,26,10,87,600,506,114,35,357,94,94,29,0,65,0,0,0,0,78801
27416,741,267,392,79,3,0,99,26,26,0,0,26,0,0,0,0,0,0,0,0,0,73,73,34,0,39,0,0,0,0,0,0,0,0,0,78802
27417,1010,482,268,134,94,32,217,84,84,0,25,59,0,0,0,0,0,0,0,0,0,133,113,0,16,97,20,10,10,0,0,10,0,0,10,78827
27418,202,71,7,95,13,16,0,0,0,0,0,0,0,0,0,0,0,0,0,0,0,0,0,0,0,0,0,0,0,0,0,0,0,0,0,78828
27419,706,334,166,167,30,9,104,38,17,0,0,17,21,0,0,0,0,21,0,21,0,66,66,0,14,52,0,0,0,0,0,0,0,0,0,78829
27420,464,256,95,107,6,0,27,19,19,0,0,19,0,0,0,0,0,0,0,0,0,8,0,0,0,0,8,8,0,0,8,0,0,0,0,78830
27421,2552,793,666,720,298,75,172,77,31,0,0,31,46,23,3,0,20,23,8,0,15,95,91,33,0,58,4,4,0,0,4,0,0,0,0,78832
27422,1012,335,221,258,127,71,65,35,28,0,14,14,7,7,0,0,7,0,0,0,0,30,13,0,0,13,17,0,0,0,0,17,11,0,6,78833
27423,4557,1590,1163,1370,263,171,514,280,229,55,41,133,51,39,30,0,9,12,12,0,0,234,178,79,26,73,56,0,0,0,0,56,35,0,21,78834
27424,20,0,12,8,0,0,0,0,0,0,0,0,0,0,0,0,0,0,0,0,0,0,0,0,0,0,0,0,0,0,0,0,0,0,0,78836
27425,123,33,17,35,34,4,0,0,0,0,0,0,0,0,0,0,0,0,0,0,0,0,0,0,0,0,0,0,0,0,0,0,0,0,0,78837
27426,176,7,72,73,13,11,18,0,0,0,0,0,0,0,0,0,0,0,0,0,0,18,0,0,0,0,18,13,0,0,13,5,0,0,5,78838
27427,4968,1912,1271,1296,372,117,624,271,212,8,0,204,59,24,0,23,1,35,0,0,35,353,279,0,7,272,74,13,13,0,0,61,19,0,42,78839
27428,28828,9522,8183,6721,3256,1146,2981,1653,1377,369,238,770,276,176,118,0,58,100,0,67,33,1328,999,260,85,654,329,214,145,33,36,115,23,30,62,78840
27429,26,0,9,11,6,0,36,36,36,36,0,0,0,0,0,0,0,0,0,0,0,0,0,0,0,0,0,0,0,0,0,0,0,0,0,78843
27430,895,188,269,253,154,31,99,35,35,2,7,26,0,0,0,0,0,0,0,0,0,64,51,7,0,44,13,0,0,0,0,13,0,8,5,78850
27431,20,9,0,6,5,0,4,4,4,0,0,4,0,0,0,0,0,0,0,0,0,0,0,0,0,0,0,0,0,0,0,0,0,0,0,78851
27432,29709,12943,6783,6422,2484,1077,3710,1901,1548,127,65,1356,353,193,111,16,66,160,91,49,20,1809,1639,236,259,1144,170,92,16,5,71,78,0,5,73,78852
27433,266,158,23,67,9,9,0,0,0,0,0,0,0,0,0,0,0,0,0,0,0,0,0,0,0,0,0,0,0,0,0,0,0,0,0,78860
27434,8593,1702,2875,2548,1107,361,751,497,412,86,37,289,85,0,0,0,0,85,0,20,65,254,191,91,1,99,63,53,25,28,0,10,10,0,0,78861
27435,612,146,156,181,94,35,120,80,65,30,0,35,15,15,15,0,0,0,0,0,0,40,35,0,15,20,5,0,0,0,0,5,0,5,0,78870
27436,18,0,14,0,0,4,0,0,0,0,0,0,0,0,0,0,0,0,0,0,0,0,0,0,0,0,0,0,0,0,0,0,0,0,0,78871
27437,1185,471,227,381,73,33,165,91,42,13,3,26,49,49,13,10,26,0,0,0,0,74,68,3,0,65,6,6,6,0,0,0,0,0,0,78872
27438,1199,211,432,334,140,82,194,137,113,0,14,99,24,23,10,0,13,1,0,0,1,57,29,8,0,21,28,3,0,0,3,25,0,12,13,78873
27439,724,217,133,212,72,90,62,62,62,17,0,45,0,0,0,0,0,0,0,0,0,0,0,0,0,0,0,0,0,0,0,0,0,0,0,78877
27440,290,27,95,62,44,62,10,0,0,0,0,0,0,0,0,0,0,0,0,0,0,10,0,0,0,0,10,10,0,10,0,0,0,0,0,78879
27441,1283,421,329,241,229,63,124,30,0,0,0,0,30,30,25,5,0,0,0,0,0,94,68,38,0,30,26,26,0,26,0,0,0,0,0,78880
27442,1208,304,280,458,101,65,152,55,28,16,0,12,27,15,0,0,15,12,0,0,12,97,83,0,12,71,14,0,0,0,0,14,0,12,2,78881
27443,259,22,39,61,41,96,0,0,0,0,0,0,0,0,0,0,0,0,0,0,0,0,0,0,0,0,0,0,0,0,0,0,0,0,0,78883
27444,736,69,228,216,166,57,46,15,15,0,0,15,0,0,0,0,0,0,0,0,0,31,31,19,0,12,0,0,0,0,0,0,0,0,0,78884
27445,106,15,38,10,26,17,0,0,0,0,0,0,0,0,0,0,0,0,0,0,0,0,0,0,0,0,0,0,0,0,0,0,0,0,0,78885
27446,435,42,158,98,76,61,15,0,0,0,0,0,0,0,0,0,0,0,0,0,0,15,11,0,0,11,4,4,4,0,0,0,0,0,0,78886
27447,176,0,67,109,0,0,0,0,0,0,0,0,0,0,0,0,0,0,0,0,0,0,0,0,0,0,0,0,0,0,0,0,0,0,0,78931
27448,422,72,101,136,48,65,12,7,7,0,0,7,0,0,0,0,0,0,0,0,0,5,5,0,0,5,0,0,0,0,0,0,0,0,0,78932
27449,1069,53,304,389,226,97,68,63,63,16,0,47,0,0,0,0,0,0,0,0,0,5,5,0,0,5,0,0,0,0,0,0,0,0,0,78933
27450,4429,885,1664,1023,669,188,353,153,129,25,0,104,24,24,24,0,0,0,0,0,0,200,146,74,0,72,54,54,0,0,54,0,0,0,0,78934
27451,752,112,282,195,134,29,31,24,0,0,0,0,24,24,0,0,24,0,0,0,0,7,7,0,0,7,0,0,0,0,0,0,0,0,0,78935
27452,347,45,154,110,38,0,3,3,3,3,0,0,0,0,0,0,0,0,0,0,0,0,0,0,0,0,0,0,0,0,0,0,0,0,0,78938
27453,1843,208,751,503,236,145,97,66,50,11,4,35,16,16,9,7,0,0,0,0,0,31,31,13,0,18,0,0,0,0,0,0,0,0,0,78940
27454,1989,673,524,530,227,35,166,107,88,5,0,83,19,15,15,0,0,4,4,0,0,59,59,12,8,39,0,0,0,0,0,0,0,0,0,78941
27455,5150,1418,1607,1386,510,229,812,539,438,48,0,390,101,8,0,0,8,93,86,0,7,273,267,85,35,147,6,6,0,6,0,0,0,0,0,78942
27456,191,10,73,99,0,9,11,11,11,0,0,11,0,0,0,0,0,0,0,0,0,0,0,0,0,0,0,0,0,0,0,0,0,0,0,78943
27457,499,115,169,145,18,52,35,25,25,0,0,25,0,0,0,0,0,0,0,0,0,10,4,0,4,0,6,6,0,0,6,0,0,0,0,78944
27458,7416,1471,2687,1887,1065,306,513,259,143,50,0,93,116,35,18,17,0,81,81,0,0,254,160,51,6,103,94,92,52,0,40,2,2,0,0,78945
27459,737,143,312,144,119,19,25,5,5,0,0,5,0,0,0,0,0,0,0,0,0,20,20,8,12,0,0,0,0,0,0,0,0,0,0,78946
27460,3378,282,1554,921,458,163,177,36,36,0,9,27,0,0,0,0,0,0,0,0,0,141,81,0,0,81,60,8,8,0,0,52,0,20,32,78947
27461,583,101,212,211,43,16,50,40,14,0,0,14,26,26,26,0,0,0,0,0,0,10,10,0,0,10,0,0,0,0,0,0,0,0,0,78948
27462,284,71,131,73,9,0,25,25,25,16,0,9,0,0,0,0,0,0,0,0,0,0,0,0,0,0,0,0,0,0,0,0,0,0,0,78949
27463,1961,170,765,595,296,135,55,34,20,0,0,20,14,14,0,14,0,0,0,0,0,21,21,6,7,8,0,0,0,0,0,0,0,0,0,78950
27464,34,0,34,0,0,0,0,0,0,0,0,0,0,0,0,0,0,0,0,0,0,0,0,0,0,0,0,0,0,0,0,0,0,0,0,78951
27465,550,94,247,107,89,13,15,15,15,0,0,15,0,0,0,0,0,0,0,0,0,0,0,0,0,0,0,0,0,0,0,0,0,0,0,78953
27466,827,102,312,209,158,46,63,36,36,0,0,36,0,0,0,0,0,0,0,0,0,27,15,0,0,15,12,7,7,0,0,5,5,0,0,78954
27467,3583,638,1386,1014,432,113,312,156,150,80,0,70,6,6,0,0,6,0,0,0,0,156,153,6,13,134,3,3,0,0,3,0,0,0,0,78956
27468,5897,1025,1932,1892,801,247,482,250,121,0,1,120,129,129,129,0,0,0,0,0,0,232,194,27,0,167,38,38,17,0,21,0,0,0,0,78957
27469,1436,565,406,349,104,12,279,201,115,11,5,99,86,56,25,31,0,30,22,0,8,78,54,28,0,26,24,22,22,0,0,2,0,2,0,78959
27470,3553,587,1481,718,552,215,291,111,111,29,0,82,0,0,0,0,0,0,0,0,0,180,175,51,0,124,5,5,5,0,0,0,0,0,0,78962
27471,701,101,309,202,47,42,32,0,0,0,0,0,0,0,0,0,0,0,0,0,0,32,32,0,0,32,0,0,0,0,0,0,0,0,0,78963
27472,202,12,56,58,56,20,9,4,4,4,0,0,0,0,0,0,0,0,0,0,0,5,5,0,5,0,0,0,0,0,0,0,0,0,0,79001
27473,166,12,51,81,22,0,14,9,5,0,0,5,4,4,4,0,0,0,0,0,0,5,5,0,0,5,0,0,0,0,0,0,0,0,0,79003
27474,1004,195,359,271,139,40,132,81,79,13,0,66,2,1,1,0,0,1,1,0,0,51,25,0,0,25,26,26,0,0,26,0,0,0,0,79005
27475,8965,1761,2812,3252,718,422,940,472,384,187,27,170,88,53,28,25,0,35,0,27,8,468,390,111,57,222,78,30,22,8,0,48,0,22,26,79007
27476,1180,561,239,219,150,11,172,99,57,6,0,51,42,16,10,6,0,26,0,6,20,73,44,19,4,21,29,23,18,5,0,6,6,0,0,79009
27477,399,21,175,130,65,8,39,39,39,0,0,39,0,0,0,0,0,0,0,0,0,0,0,0,0,0,0,0,0,0,0,0,0,0,0,79010
27478,218,36,65,84,19,14,0,0,0,0,0,0,0,0,0,0,0,0,0,0,0,0,0,0,0,0,0,0,0,0,0,0,0,0,0,79011
27479,621,0,53,388,172,8,46,0,0,0,0,0,0,0,0,0,0,0,0,0,0,46,46,33,13,0,0,0,0,0,0,0,0,0,0,79012
27480,1573,956,316,197,104,0,269,138,111,6,0,105,27,27,27,0,0,0,0,0,0,131,78,12,33,33,53,43,43,0,0,10,0,0,10,79013
27481,2523,516,735,772,446,54,236,92,87,60,0,27,5,0,0,0,0,5,5,0,0,144,135,45,18,72,9,9,0,0,9,0,0,0,0,79014
27482,11553,953,2416,3763,2881,1540,2026,1033,944,312,37,595,89,60,60,0,0,29,0,9,20,993,953,411,38,504,40,30,30,0,0,10,0,0,10,79015
27483,0,0,0,0,0,0,68,0,0,0,0,0,0,0,0,0,0,0,0,0,0,68,68,36,0,32,0,0,0,0,0,0,0,0,0,79016
27484,250,42,63,105,28,12,15,13,13,0,0,13,0,0,0,0,0,0,0,0,0,2,2,1,0,1,0,0,0,0,0,0,0,0,0,79018
27485,1097,132,268,434,199,64,78,29,22,0,5,17,7,6,6,0,0,1,0,0,1,49,49,20,8,21,0,0,0,0,0,0,0,0,0,79019
27486,54,8,14,23,2,7,4,0,0,0,0,0,0,0,0,0,0,0,0,0,0,4,4,2,0,2,0,0,0,0,0,0,0,0,0,79021
27487,7425,1633,2749,1904,881,258,674,390,165,37,32,96,225,159,159,0,0,66,61,0,5,284,261,140,9,112,23,23,9,14,0,0,0,0,0,79022
27488,203,23,72,40,58,10,20,11,8,2,0,6,3,3,3,0,0,0,0,0,0,9,9,7,0,2,0,0,0,0,0,0,0,0,0,79024
27489,32,20,0,12,0,0,0,0,0,0,0,0,0,0,0,0,0,0,0,0,0,0,0,0,0,0,0,0,0,0,0,0,0,0,0,79025
27490,2964,908,1044,613,326,73,360,211,132,30,31,71,79,38,5,33,0,41,41,0,0,149,140,0,13,127,9,9,9,0,0,0,0,0,0,79027
27491,9593,2848,2929,2388,1066,362,1004,551,462,183,20,259,89,48,26,22,0,41,41,0,0,453,367,55,14,298,86,86,84,0,2,0,0,0,0,79029
27492,857,262,197,225,133,40,84,42,30,21,0,9,12,12,12,0,0,0,0,0,0,42,28,0,0,28,14,14,12,0,2,0,0,0,0,79031
27493,90,2,47,33,8,0,0,0,0,0,0,0,0,0,0,0,0,0,0,0,0,0,0,0,0,0,0,0,0,0,0,0,0,0,0,79032
27494,60,0,17,17,26,0,0,0,0,0,0,0,0,0,0,0,0,0,0,0,0,0,0,0,0,0,0,0,0,0,0,0,0,0,0,79033
27495,553,110,151,162,112,18,40,6,4,1,0,3,2,0,0,0,0,2,0,2,0,34,32,14,5,13,2,2,0,0,2,0,0,0,0,79034
27496,3033,1273,787,541,335,97,339,174,93,7,6,80,81,67,67,0,0,14,14,0,0,165,119,55,0,64,46,41,10,0,31,5,0,0,5,79035
27497,3818,390,1707,1248,378,95,288,154,108,8,0,100,46,15,15,0,0,31,31,0,0,134,100,11,0,89,34,34,34,0,0,0,0,0,0,79036
27498,570,50,180,232,82,26,33,7,7,5,0,2,0,0,0,0,0,0,0,0,0,26,26,10,0,16,0,0,0,0,0,0,0,0,0,79039
27499,962,274,199,188,239,62,79,42,39,13,0,26,3,3,3,0,0,0,0,0,0,37,33,0,6,27,4,0,0,0,0,4,0,0,4,79040
27500,2201,697,760,540,135,69,304,112,82,37,0,45,30,21,13,8,0,9,9,0,0,192,127,0,0,127,65,42,30,0,12,23,0,0,23,79041
27501,847,121,288,268,140,30,60,28,22,0,0,22,6,0,0,0,0,6,0,6,0,32,30,9,0,21,2,2,2,0,0,0,0,0,0,79042
27502,1062,502,315,134,95,16,101,26,22,0,3,19,4,4,4,0,0,0,0,0,0,75,68,12,0,56,7,7,0,0,7,0,0,0,0,79043
27503,373,149,75,68,69,12,29,10,7,0,0,7,3,3,0,3,0,0,0,0,0,19,14,2,0,12,5,0,0,0,0,5,5,0,0,79044
27504,11168,3482,3499,2471,1190,526,1095,475,315,89,0,226,160,110,88,22,0,50,39,0,11,620,573,133,30,410,47,9,0,0,9,38,0,0,38,79045
27505,291,64,95,85,37,10,16,6,6,3,0,3,0,0,0,0,0,0,0,0,0,10,10,2,0,8,0,0,0,0,0,0,0,0,0,79046
27506,30,0,0,17,13,0,0,0,0,0,0,0,0,0,0,0,0,0,0,0,0,0,0,0,0,0,0,0,0,0,0,0,0,0,0,79051
27507,802,119,331,224,55,73,118,63,48,0,0,48,15,15,15,0,0,0,0,0,0,55,44,0,8,36,11,11,11,0,0,0,0,0,0,79052
27508,101,3,12,58,28,0,11,8,8,0,0,8,0,0,0,0,0,0,0,0,0,3,3,0,0,3,0,0,0,0,0,0,0,0,0,79053
27509,299,67,132,60,36,4,22,11,5,0,0,5,6,0,0,0,0,6,6,0,0,11,1,0,1,0,10,6,6,0,0,4,0,0,4,79054
27510,41,0,10,16,9,6,4,1,0,0,0,0,1,0,0,0,0,1,0,0,1,3,3,0,0,3,0,0,0,0,0,0,0,0,0,79056
27511,772,90,271,283,105,23,90,45,20,6,0,14,25,21,21,0,0,4,0,0,4,45,35,0,0,35,10,5,0,0,5,5,5,0,0,79057
27512,0,0,0,0,0,0,0,0,0,0,0,0,0,0,0,0,0,0,0,0,0,0,0,0,0,0,0,0,0,0,0,0,0,0,0,79058
27513,588,32,207,170,150,29,54,8,4,4,0,0,4,4,0,0,4,0,0,0,0,46,46,25,0,21,0,0,0,0,0,0,0,0,0,79059
27514,336,21,165,83,63,4,40,27,27,16,10,1,0,0,0,0,0,0,0,0,0,13,13,0,0,13,0,0,0,0,0,0,0,0,0,79061
27515,205,36,62,48,48,11,19,16,16,5,0,11,0,0,0,0,0,0,0,0,0,3,3,2,0,1,0,0,0,0,0,0,0,0,0,79062
27516,459,19,199,154,68,19,37,11,11,5,0,6,0,0,0,0,0,0,0,0,0,26,26,4,0,22,0,0,0,0,0,0,0,0,0,79063
27517,1521,531,476,353,115,46,144,99,74,6,0,68,25,4,4,0,0,21,3,12,6,45,38,17,0,21,7,0,0,0,0,7,0,0,7,79064
27518,14298,2891,4591,4870,1377,569,934,495,371,147,9,215,124,63,55,0,8,61,59,0,2,439,350,221,20,109,89,80,79,0,1,9,0,9,0,79065
27519,1961,188,568,651,379,175,150,77,74,17,10,47,3,3,0,3,0,0,0,0,0,73,73,23,9,41,0,0,0,0,0,0,0,0,0,79068
27520,6023,1850,1973,1289,658,253,614,317,247,84,21,142,70,29,29,0,0,41,17,0,24,297,233,106,25,102,64,64,24,0,40,0,0,0,0,79070
27521,16702,5111,5234,4183,1339,835,1701,953,684,163,77,444,269,141,72,24,45,128,54,0,74,748,597,188,60,349,151,35,14,21,0,116,0,19,97,79072
27522,262,64,86,77,35,0,0,0,0,0,0,0,0,0,0,0,0,0,0,0,0,0,0,0,0,0,0,0,0,0,0,0,0,0,0,79078
27523,1708,248,498,585,274,103,86,32,7,4,0,3,25,0,0,0,0,25,25,0,0,54,45,15,0,30,9,7,0,7,0,2,0,0,2,79079
27524,422,110,167,85,43,17,53,20,18,0,0,18,2,2,2,0,0,0,0,0,0,33,22,0,0,22,11,11,0,11,0,0,0,0,0,79080
27525,2478,588,807,666,327,90,319,237,189,97,9,83,48,8,8,0,0,40,0,0,40,82,82,67,0,15,0,0,0,0,0,0,0,0,0,79081
27526,254,42,58,67,78,9,28,24,18,0,0,18,6,0,0,0,0,6,0,0,6,4,4,0,0,4,0,0,0,0,0,0,0,0,0,79082
27527,1742,172,563,724,219,64,100,81,66,5,4,57,15,15,0,0,15,0,0,0,0,19,15,11,0,4,4,4,4,0,0,0,0,0,0,79083
27528,1466,363,387,416,218,82,160,59,42,26,3,13,17,11,0,11,0,6,0,0,6,101,95,38,25,32,6,6,6,0,0,0,0,0,0,79084
27529,27,0,27,0,0,0,0,0,0,0,0,0,0,0,0,0,0,0,0,0,0,0,0,0,0,0,0,0,0,0,0,0,0,0,0,79085
27530,1591,358,548,518,129,38,108,71,63,11,0,52,8,8,8,0,0,0,0,0,0,37,37,6,0,31,0,0,0,0,0,0,0,0,0,79086
27531,507,162,155,108,57,25,62,30,25,15,0,10,5,2,2,0,0,3,0,0,3,32,17,0,0,17,15,15,15,0,0,0,0,0,0,79087
27532,3595,850,1302,880,368,195,187,91,48,0,0,48,43,29,29,0,0,14,0,0,14,96,96,19,40,37,0,0,0,0,0,0,0,0,0,79088
27533,77,0,0,26,28,23,0,0,0,0,0,0,0,0,0,0,0,0,0,0,0,0,0,0,0,0,0,0,0,0,0,0,0,0,0,79091
27534,737,105,153,221,168,90,75,43,43,14,9,20,0,0,0,0,0,0,0,0,0,32,32,20,0,12,0,0,0,0,0,0,0,0,0,79092
27535,8,2,0,6,0,0,0,0,0,0,0,0,0,0,0,0,0,0,0,0,0,0,0,0,0,0,0,0,0,0,0,0,0,0,0,79093
27536,82,0,12,40,21,9,0,0,0,0,0,0,0,0,0,0,0,0,0,0,0,0,0,0,0,0,0,0,0,0,0,0,0,0,0,79094
27537,1791,333,539,576,258,85,89,44,30,0,13,17,14,0,0,0,0,14,14,0,0,45,45,35,10,0,0,0,0,0,0,0,0,0,0,79095
27538,1431,427,401,377,184,42,75,32,25,20,0,5,7,0,0,0,0,7,0,0,7,43,35,12,0,23,8,7,3,0,4,1,1,0,0,79096
27539,899,103,187,415,143,51,44,25,21,3,0,18,4,4,4,0,0,0,0,0,0,19,19,0,0,19,0,0,0,0,0,0,0,0,0,79097
27540,355,47,110,134,45,19,32,22,22,1,0,21,0,0,0,0,0,0,0,0,0,10,7,0,4,3,3,3,3,0,0,0,0,0,0,79098
27541,2073,362,763,735,134,79,129,72,43,0,18,25,29,12,0,0,12,17,0,0,17,57,19,16,3,0,38,38,0,0,38,0,0,0,0,79101
27542,5832,1375,1231,1860,963,403,483,238,160,74,39,47,78,78,70,0,8,0,0,0,0,245,207,58,0,149,38,29,23,0,6,9,0,0,9,79102
27543,6716,1779,2069,2310,445,113,686,364,283,41,6,236,81,34,16,8,10,47,6,0,41,322,260,49,40,171,62,62,30,0,32,0,0,0,0,79103
27544,4303,1976,1158,1027,109,33,373,281,234,94,0,140,47,39,27,12,0,8,0,8,0,92,92,45,0,47,0,0,0,0,0,0,0,0,0,79104
27545,0,0,0,0,0,0,0,0,0,0,0,0,0,0,0,0,0,0,0,0,0,0,0,0,0,0,0,0,0,0,0,0,0,0,0,79105
27546,18509,2542,4654,7119,2917,1277,1499,770,561,229,56,276,209,148,120,0,28,61,48,0,13,729,573,191,0,382,156,105,45,21,39,51,0,0,51,79106
27547,19345,7313,5723,5164,893,252,2082,891,558,133,26,399,333,41,28,13,0,292,181,60,51,1191,811,195,51,565,380,223,93,50,80,157,75,0,82,79107
27548,12276,2573,3928,4559,971,245,668,384,305,107,30,168,79,79,15,0,64,0,0,0,0,284,204,45,3,156,80,56,19,0,37,24,11,0,13,79108
27549,29478,2189,6463,11162,6365,3299,1844,951,810,283,92,435,141,66,66,0,0,75,62,0,13,893,723,203,75,445,170,123,123,0,0,47,7,24,16,79109
27550,11550,1674,3179,4767,1513,417,1092,505,454,217,14,223,51,43,26,17,0,8,0,8,0,587,425,71,109,245,162,162,107,11,44,0,0,0,0,79110
27551,942,131,233,466,75,37,67,39,20,0,0,20,19,19,0,0,19,0,0,0,0,28,23,14,0,9,5,5,0,0,5,0,0,0,0,79111
27552,12974,1708,3751,4786,2034,695,1035,512,427,163,38,226,85,80,63,10,7,5,0,0,5,523,438,81,30,327,85,61,36,21,4,24,0,0,24,79118
27553,8017,322,1320,2866,2320,1189,647,277,234,58,15,161,43,43,18,0,25,0,0,0,0,370,316,60,40,216,54,54,54,0,0,0,0,0,0,79119
27554,4600,158,851,1537,1297,757,379,180,159,31,28,100,21,21,21,0,0,0,0,0,0,199,199,52,0,147,0,0,0,0,0,0,0,0,0,79121
27555,5816,371,1123,1987,1410,925,343,200,180,32,1,147,20,20,20,0,0,0,0,0,0,143,138,49,0,89,5,5,5,0,0,0,0,0,0,79124
27556,4836,565,2080,1272,558,361,435,335,144,57,0,87,191,69,29,0,40,122,0,0,122,100,70,59,0,11,30,30,5,0,25,0,0,0,0,79201
27557,207,7,36,101,58,5,17,13,13,0,0,13,0,0,0,0,0,0,0,0,0,4,4,4,0,0,0,0,0,0,0,0,0,0,0,79220
27558,683,171,188,222,72,30,100,67,56,10,0,46,11,7,7,0,0,4,4,0,0,33,25,16,0,9,8,8,8,0,0,0,0,0,0,79225
27559,2026,297,723,718,154,134,341,170,142,32,5,105,28,14,0,14,0,14,5,0,9,171,165,16,6,143,6,0,0,0,0,6,0,0,6,79226
27560,911,201,250,261,138,61,56,31,31,0,11,20,0,0,0,0,0,0,0,0,0,25,14,11,0,3,11,0,0,0,0,11,0,11,0,79227
27561,287,57,120,84,23,3,11,2,2,0,0,2,0,0,0,0,0,0,0,0,0,9,9,5,4,0,0,0,0,0,0,0,0,0,0,79229
27562,137,91,13,6,11,16,12,11,11,0,0,11,0,0,0,0,0,0,0,0,0,1,1,0,0,1,0,0,0,0,0,0,0,0,0,79230
27563,17,5,5,7,0,0,0,0,0,0,0,0,0,0,0,0,0,0,0,0,0,0,0,0,0,0,0,0,0,0,0,0,0,0,0,79231
27564,153,49,54,30,13,7,9,5,5,0,5,0,0,0,0,0,0,0,0,0,0,4,4,4,0,0,0,0,0,0,0,0,0,0,0,79233
27565,43,8,23,8,4,0,6,6,6,0,0,6,0,0,0,0,0,0,0,0,0,0,0,0,0,0,0,0,0,0,0,0,0,0,0,79234
27566,2342,659,757,538,302,86,195,89,52,24,0,28,37,9,9,0,0,28,28,0,0,106,101,10,0,91,5,0,0,0,0,5,5,0,0,79235
27567,225,43,76,57,40,9,13,3,3,0,0,3,0,0,0,0,0,0,0,0,0,10,10,7,0,3,0,0,0,0,0,0,0,0,0,79236
27568,353,43,95,146,45,24,22,8,2,0,0,2,6,6,0,0,6,0,0,0,0,14,14,3,2,9,0,0,0,0,0,0,0,0,0,79237
27569,153,20,78,54,1,0,3,3,3,3,0,0,0,0,0,0,0,0,0,0,0,0,0,0,0,0,0,0,0,0,0,0,0,0,0,79239
27570,24,0,0,21,3,0,0,0,0,0,0,0,0,0,0,0,0,0,0,0,0,0,0,0,0,0,0,0,0,0,0,0,0,0,0,79240
27571,1655,355,487,510,219,84,155,68,47,12,4,31,21,16,5,11,0,5,5,0,0,87,87,6,0,81,0,0,0,0,0,0,0,0,0,79241
27572,63,0,31,32,0,0,0,0,0,0,0,0,0,0,0,0,0,0,0,0,0,0,0,0,0,0,0,0,0,0,0,0,0,0,0,79243
27573,329,33,117,127,43,9,40,29,29,3,0,26,0,0,0,0,0,0,0,0,0,11,11,5,0,6,0,0,0,0,0,0,0,0,0,79244
27574,1473,426,422,418,133,74,239,93,87,0,0,87,6,6,6,0,0,0,0,0,0,146,141,48,0,93,5,5,5,0,0,0,0,0,0,79245
27575,37,2,16,19,0,0,0,0,0,0,0,0,0,0,0,0,0,0,0,0,0,0,0,0,0,0,0,0,0,0,0,0,0,0,0,79247
27576,1085,261,342,320,129,33,71,6,2,1,1,0,4,3,0,0,3,1,0,0,1,65,61,30,0,31,4,0,0,0,0,4,0,0,4,79248
27577,944,273,276,260,122,13,76,37,33,10,0,23,4,4,0,4,0,0,0,0,0,39,33,3,0,30,6,6,0,0,6,0,0,0,0,79250
27578,58,5,33,14,0,6,11,5,5,5,0,0,0,0,0,0,0,0,0,0,0,6,6,0,0,6,0,0,0,0,0,0,0,0,0,79251
27579,2284,413,892,522,344,113,126,43,42,0,0,42,1,0,0,0,0,1,0,0,1,83,39,0,0,39,44,44,0,0,44,0,0,0,0,79252
27580,409,118,96,121,64,10,29,23,23,0,0,23,0,0,0,0,0,0,0,0,0,6,6,0,0,6,0,0,0,0,0,0,0,0,0,79255
27581,306,35,120,90,52,9,41,29,23,8,0,15,6,6,0,0,6,0,0,0,0,12,12,0,12,0,0,0,0,0,0,0,0,0,0,79256
27582,769,177,212,241,94,45,30,26,26,6,0,20,0,0,0,0,0,0,0,0,0,4,4,0,4,0,0,0,0,0,0,0,0,0,0,79257
27583,11,5,6,0,0,0,0,0,0,0,0,0,0,0,0,0,0,0,0,0,0,0,0,0,0,0,0,0,0,0,0,0,0,0,0,79258
27584,67,0,24,43,0,0,0,0,0,0,0,0,0,0,0,0,0,0,0,0,0,0,0,0,0,0,0,0,0,0,0,0,0,0,0,79259
27585,407,124,81,118,77,7,16,9,7,0,1,6,2,2,0,0,2,0,0,0,0,7,7,0,0,7,0,0,0,0,0,0,0,0,0,79261
27586,2373,502,778,669,231,193,254,155,150,16,0,134,5,5,0,0,5,0,0,0,0,99,56,17,0,39,43,22,0,20,2,21,0,21,0,79311
27587,687,225,167,239,33,23,58,34,34,0,0,34,0,0,0,0,0,0,0,0,0,24,17,0,0,17,7,7,0,7,0,0,0,0,0,79312
27588,924,231,203,324,105,61,99,54,47,24,6,17,7,7,0,0,7,0,0,0,0,45,45,20,0,25,0,0,0,0,0,0,0,0,0,79313
27589,50,4,27,16,0,3,0,0,0,0,0,0,0,0,0,0,0,0,0,0,0,0,0,0,0,0,0,0,0,0,0,0,0,0,0,79314
27590,7231,2345,1947,1869,742,328,693,382,308,73,27,208,74,40,40,0,0,34,13,0,21,311,233,41,0,192,78,27,8,19,0,51,0,0,51,79316
27591,1342,333,450,363,156,40,97,34,22,0,0,22,12,10,7,3,0,2,0,0,2,63,41,29,0,12,22,22,22,0,0,0,0,0,0,79322
27592,3811,1104,1161,993,445,108,457,212,97,48,0,49,115,101,59,42,0,14,14,0,0,245,182,75,0,107,63,63,0,40,23,0,0,0,0,79323
27593,6,0,6,0,0,0,0,0,0,0,0,0,0,0,0,0,0,0,0,0,0,0,0,0,0,0,0,0,0,0,0,0,0,0,0,79324
27594,1521,342,413,453,217,96,87,69,56,26,0,30,13,13,5,2,6,0,0,0,0,18,18,2,4,12,0,0,0,0,0,0,0,0,0,79325
27595,0,0,0,0,0,0,0,0,0,0,0,0,0,0,0,0,0,0,0,0,0,0,0,0,0,0,0,0,0,0,0,0,0,0,0,79326
27596,2169,372,643,620,419,115,198,93,86,43,3,40,7,7,7,0,0,0,0,0,0,105,90,71,0,19,15,15,15,0,0,0,0,0,0,79329
27597,130,0,93,26,5,6,0,0,0,0,0,0,0,0,0,0,0,0,0,0,0,0,0,0,0,0,0,0,0,0,0,0,0,0,0,79330
27598,8607,2638,2879,2288,610,192,736,449,351,73,171,107,98,50,1,0,49,48,8,5,35,287,131,20,0,111,156,87,62,0,25,69,0,41,28,79331
27599,10315,2461,2852,3283,1213,506,1393,669,625,296,12,317,44,43,43,0,0,1,0,0,1,724,670,223,61,386,54,17,0,0,17,37,0,28,9,79336
27600,4470,1333,1438,1079,394,226,446,291,269,68,41,160,22,0,0,0,0,22,22,0,0,155,110,25,13,72,45,37,19,0,18,8,0,0,8,79339
27601,350,128,72,82,22,46,42,18,17,0,0,17,1,0,0,0,0,1,0,0,1,24,24,6,9,9,0,0,0,0,0,0,0,0,0,79342
27602,908,269,296,195,97,51,81,52,44,20,0,24,8,8,0,0,8,0,0,0,0,29,21,5,0,16,8,8,0,8,0,0,0,0,0,79343
27603,44,15,6,13,10,0,0,0,0,0,0,0,0,0,0,0,0,0,0,0,0,0,0,0,0,0,0,0,0,0,0,0,0,0,0,79344
27604,637,115,212,209,91,10,28,22,22,6,0,16,0,0,0,0,0,0,0,0,0,6,4,0,0,4,2,2,0,0,2,0,0,0,0,79345
27605,1505,565,454,302,141,43,184,115,75,8,16,51,40,33,32,0,1,7,5,0,2,69,54,0,9,45,15,7,0,7,0,8,0,8,0,79346
27606,4238,1494,1233,1028,313,170,628,374,252,128,0,124,122,122,112,0,10,0,0,0,0,254,241,16,49,176,13,13,13,0,0,0,0,0,0,79347
27607,172,52,70,32,16,2,23,23,14,0,5,9,9,9,9,0,0,0,0,0,0,0,0,0,0,0,0,0,0,0,0,0,0,0,0,79350
27608,902,322,256,232,60,32,100,16,16,4,0,12,0,0,0,0,0,0,0,0,0,84,70,15,10,45,14,14,0,8,6,0,0,0,0,79351
27609,7,0,7,0,0,0,0,0,0,0,0,0,0,0,0,0,0,0,0,0,0,0,0,0,0,0,0,0,0,0,0,0,0,0,0,79353
27610,1317,395,261,443,114,104,108,19,19,0,0,19,0,0,0,0,0,0,0,0,0,89,89,50,0,39,0,0,0,0,0,0,0,0,0,79355
27611,4571,1762,1221,1149,290,149,220,68,51,9,0,42,17,12,7,5,0,5,5,0,0,152,152,38,0,114,0,0,0,0,0,0,0,0,0,79356
27612,1548,585,442,378,115,28,161,49,38,12,0,26,11,9,9,0,0,2,0,0,2,112,105,17,23,65,7,4,0,4,0,3,0,0,3,79357
27613,702,117,195,215,124,51,74,42,42,12,0,30,0,0,0,0,0,0,0,0,0,32,24,9,1,14,8,8,0,0,8,0,0,0,0,79358
27614,1591,668,479,372,52,20,162,86,73,21,22,30,13,13,0,13,0,0,0,0,0,76,70,29,0,41,6,0,0,0,0,6,0,0,6,79359
27615,7589,3173,1957,1469,789,201,1122,607,357,42,23,292,250,193,162,18,13,57,36,0,21,515,282,40,34,208,233,209,148,22,39,24,0,0,24,79360
27616,3136,334,957,946,618,281,378,216,181,7,29,145,35,35,30,0,5,0,0,0,0,162,152,44,19,89,10,10,0,0,10,0,0,0,0,79363
27617,5518,1459,1866,1369,586,238,397,212,179,35,28,116,33,26,0,25,1,7,7,0,0,185,145,29,42,74,40,19,0,19,0,21,0,0,21,79364
27618,982,16,163,345,265,193,32,22,22,10,0,12,0,0,0,0,0,0,0,0,0,10,10,0,0,10,0,0,0,0,0,0,0,0,0,79366
27619,434,55,121,178,56,24,66,43,43,24,0,19,0,0,0,0,0,0,0,0,0,23,17,3,0,14,6,6,0,0,6,0,0,0,0,79367
27620,63,7,16,11,29,0,23,13,13,0,0,13,0,0,0,0,0,0,0,0,0,10,10,0,0,10,0,0,0,0,0,0,0,0,0,79369
27621,1277,347,401,359,103,67,101,67,41,0,0,41,26,11,0,3,8,15,4,0,11,34,31,7,0,24,3,3,0,3,0,0,0,0,0,79370
27622,809,143,270,285,80,31,76,44,29,0,0,29,15,15,11,4,0,0,0,0,0,32,30,11,0,19,2,2,0,0,2,0,0,0,0,79371
27623,706,128,176,292,72,38,62,42,31,8,0,23,11,11,9,0,2,0,0,0,0,20,20,7,0,13,0,0,0,0,0,0,0,0,0,79372
27624,2183,458,781,484,331,129,279,219,128,40,0,88,91,90,81,0,9,1,0,0,1,60,50,11,7,32,10,10,10,0,0,0,0,0,0,79373
27625,72,15,18,39,0,0,0,0,0,0,0,0,0,0,0,0,0,0,0,0,0,0,0,0,0,0,0,0,0,0,0,0,0,0,0,79376
27626,161,57,32,49,21,2,23,8,7,6,0,1,1,1,1,0,0,0,0,0,0,15,15,0,0,15,0,0,0,0,0,0,0,0,0,79377
27627,210,36,42,49,63,20,70,16,16,3,0,13,0,0,0,0,0,0,0,0,0,54,54,24,0,30,0,0,0,0,0,0,0,0,0,79378
27628,365,67,118,125,38,17,43,20,19,2,8,9,1,1,1,0,0,0,0,0,0,23,21,4,0,17,2,0,0,0,0,2,0,0,2,79379
27629,151,42,27,50,32,0,0,0,0,0,0,0,0,0,0,0,0,0,0,0,0,0,0,0,0,0,0,0,0,0,0,0,0,0,0,79380
27630,808,167,278,240,106,17,92,52,47,19,0,28,5,5,0,5,0,0,0,0,0,40,39,0,1,38,1,1,1,0,0,0,0,0,0,79381
27631,3693,514,918,1265,609,387,186,121,94,15,57,22,27,27,7,20,0,0,0,0,0,65,65,26,0,39,0,0,0,0,0,0,0,0,0,79382
27632,2463,633,612,660,280,278,695,377,351,59,0,292,26,1,0,0,1,25,8,0,17,318,277,125,8,144,41,34,19,0,15,7,0,0,7,79401
27633,10581,3311,3750,2544,753,223,1151,598,481,253,18,210,117,20,12,0,8,97,7,5,85,553,456,113,32,311,97,55,22,33,0,42,35,0,7,79403
27634,6719,2315,2149,1825,230,200,693,301,212,96,37,79,89,20,19,0,1,69,20,29,20,392,337,118,12,207,55,12,3,9,0,43,26,0,17,79404
27635,107,32,0,51,24,0,5636,2865,2865,397,297,2171,0,0,0,0,0,0,0,0,0,2771,2771,708,324,1739,0,0,0,0,0,0,0,0,0,79406
27636,10180,1185,2195,3675,2113,1012,895,372,320,125,38,157,52,52,52,0,0,0,0,0,0,523,482,159,48,275,41,41,41,0,0,0,0,0,0,79407
27637,5060,510,904,1689,952,1005,220,103,92,23,15,54,11,11,11,0,0,0,0,0,0,117,83,30,16,37,34,34,0,34,0,0,0,0,0,79410
27638,4501,1437,1202,996,422,444,470,239,132,21,53,58,107,62,53,9,0,45,0,23,22,231,158,15,0,143,73,43,17,0,26,30,0,0,30,79411
27639,9480,2501,3222,2754,724,279,763,385,285,125,33,127,100,90,59,23,8,10,0,10,0,378,185,65,15,105,193,89,39,42,8,104,39,17,48,79412
27640,13387,1378,3279,4513,2571,1646,931,468,410,117,98,195,58,10,10,0,0,48,0,20,28,463,433,93,91,249,30,11,11,0,0,19,0,11,8,79413
27641,10675,1378,3432,3592,1412,861,808,491,333,170,8,155,158,94,94,0,0,64,15,49,0,317,189,148,0,41,128,44,28,0,16,84,84,0,0,79414
27642,9752,3142,2625,2417,1058,510,1117,613,450,186,28,236,163,52,44,0,8,111,61,0,50,504,433,150,23,260,71,24,0,0,24,47,16,10,21,79415
27643,17625,2174,4095,5484,3869,2003,1847,808,709,268,47,394,99,86,78,6,2,13,0,13,0,1039,797,257,196,344,242,231,150,0,81,11,11,0,0,79416
27644,21923,1674,5115,7742,5077,2315,1616,826,768,319,68,381,58,40,35,5,0,18,0,0,18,790,669,210,80,379,121,99,67,8,24,22,13,9,0,79423
27645,27646,1432,4753,9228,7847,4386,1592,742,685,209,59,417,57,57,57,0,0,0,0,0,0,850,807,294,21,492,43,43,34,0,9,0,0,0,0,79424
27646,2128,396,882,552,210,88,249,90,63,13,0,50,27,27,3,14,10,0,0,0,0,159,154,60,0,94,5,5,0,0,5,0,0,0,0,79501
27647,858,245,262,217,91,43,28,28,24,14,0,10,4,4,4,0,0,0,0,0,0,0,0,0,0,0,0,0,0,0,0,0,0,0,0,79502
27648,139,17,20,53,39,10,0,0,0,0,0,0,0,0,0,0,0,0,0,0,0,0,0,0,0,0,0,0,0,0,0,0,0,0,0,79503
27649,2153,251,768,782,250,102,210,155,131,6,0,125,24,24,19,5,0,0,0,0,0,55,51,0,0,51,4,0,0,0,0,4,0,0,4,79504
27650,232,45,84,64,37,2,18,0,0,0,0,0,0,0,0,0,0,0,0,0,0,18,18,0,0,18,0,0,0,0,0,0,0,0,0,79505
27651,555,69,164,199,98,25,40,34,15,0,0,15,19,19,0,0,19,0,0,0,0,6,6,3,0,3,0,0,0,0,0,0,0,0,0,79506
27652,939,95,224,340,222,58,61,27,3,3,0,0,24,24,2,22,0,0,0,0,0,34,31,17,0,14,3,3,3,0,0,0,0,0,0,79508
27653,5452,678,1882,2052,631,209,471,242,236,49,0,187,6,6,6,0,0,0,0,0,0,229,164,62,0,102,65,42,34,0,8,23,0,23,0,79510
27654,728,137,242,234,77,38,36,13,8,8,0,0,5,0,0,0,0,5,5,0,0,23,21,9,0,12,2,2,2,0,0,0,0,0,0,79511
27655,5485,1404,1709,1935,339,98,475,349,208,15,18,175,141,33,14,0,19,108,0,62,46,126,111,25,0,86,15,15,0,0,15,0,0,0,0,79512
27656,116,12,44,17,43,0,1,1,0,0,0,0,1,0,0,0,0,1,1,0,0,0,0,0,0,0,0,0,0,0,0,0,0,0,0,79517
27657,131,17,56,29,25,4,12,12,12,10,0,2,0,0,0,0,0,0,0,0,0,0,0,0,0,0,0,0,0,0,0,0,0,0,0,79518
27658,48,7,25,16,0,0,10,0,0,0,0,0,0,0,0,0,0,0,0,0,0,10,10,10,0,0,0,0,0,0,0,0,0,0,0,79519
27659,1421,254,482,435,192,58,89,41,40,7,0,33,1,1,1,0,0,0,0,0,0,48,48,15,0,33,0,0,0,0,0,0,0,0,0,79520
27660,2771,815,1004,654,207,91,198,92,17,0,7,10,75,64,12,16,36,11,0,0,11,106,39,0,0,39,67,0,0,0,0,67,0,0,67,79521
27661,1691,275,616,667,71,62,135,92,64,0,0,64,28,28,23,0,5,0,0,0,0,43,43,0,19,24,0,0,0,0,0,0,0,0,0,79525
27662,594,65,228,115,119,67,12,11,11,5,0,6,0,0,0,0,0,0,0,0,0,1,1,0,0,1,0,0,0,0,0,0,0,0,0,79526
27663,116,23,43,30,11,9,18,8,8,7,0,1,0,0,0,0,0,0,0,0,0,10,10,5,0,5,0,0,0,0,0,0,0,0,0,79527
27664,495,88,131,159,85,32,21,13,13,9,0,4,0,0,0,0,0,0,0,0,0,8,8,3,0,5,0,0,0,0,0,0,0,0,0,79528
27665,884,169,340,291,68,16,81,28,28,11,3,14,0,0,0,0,0,0,0,0,0,53,49,6,0,43,4,4,4,0,0,0,0,0,0,79529
27666,303,60,100,121,20,2,28,22,12,8,0,4,10,10,10,0,0,0,0,0,0,6,6,0,0,6,0,0,0,0,0,0,0,0,0,79530
27667,725,131,332,176,53,33,37,31,24,7,7,10,7,4,4,0,0,3,0,0,3,6,3,0,0,3,3,3,3,0,0,0,0,0,0,79532
27668,284,22,119,95,48,0,7,6,4,0,0,4,2,2,2,0,0,0,0,0,0,1,1,0,0,1,0,0,0,0,0,0,0,0,0,79533
27669,148,15,58,54,11,10,25,19,19,0,7,12,0,0,0,0,0,0,0,0,0,6,6,0,3,3,0,0,0,0,0,0,0,0,0,79534
27670,72,10,24,29,9,0,0,0,0,0,0,0,0,0,0,0,0,0,0,0,0,0,0,0,0,0,0,0,0,0,0,0,0,0,0,79535
27671,2950,516,1128,818,405,83,233,130,119,45,0,74,11,11,11,0,0,0,0,0,0,103,103,44,18,41,0,0,0,0,0,0,0,0,0,79536
27672,86,10,44,10,14,8,2,2,2,0,0,2,0,0,0,0,0,0,0,0,0,0,0,0,0,0,0,0,0,0,0,0,0,0,0,79537
27673,114,24,45,35,6,4,7,0,0,0,0,0,0,0,0,0,0,0,0,0,0,7,7,0,0,7,0,0,0,0,0,0,0,0,0,79538
27674,152,33,42,67,8,2,12,12,12,5,7,0,0,0,0,0,0,0,0,0,0,0,0,0,0,0,0,0,0,0,0,0,0,0,0,79539
27675,82,5,29,25,19,4,0,0,0,0,0,0,0,0,0,0,0,0,0,0,0,0,0,0,0,0,0,0,0,0,0,0,0,0,0,79540
27676,681,91,201,244,128,17,16,16,16,0,0,16,0,0,0,0,0,0,0,0,0,0,0,0,0,0,0,0,0,0,0,0,0,0,0,79541
27677,801,125,286,299,78,13,78,40,29,4,0,25,11,11,0,11,0,0,0,0,0,38,35,10,0,25,3,3,0,0,3,0,0,0,0,79543
27678,351,108,109,81,51,2,15,6,1,0,0,1,5,5,0,0,5,0,0,0,0,9,9,0,4,5,0,0,0,0,0,0,0,0,0,79544
27679,1165,283,398,313,138,33,99,47,47,19,0,28,0,0,0,0,0,0,0,0,0,52,51,2,0,49,1,1,0,0,1,0,0,0,0,79545
27680,1309,288,436,330,167,88,139,78,66,11,0,55,12,5,0,0,5,7,7,0,0,61,56,12,0,44,5,0,0,0,0,5,5,0,0,79546
27681,514,79,225,152,25,33,22,15,3,0,0,3,12,8,5,3,0,4,4,0,0,7,0,0,0,0,7,7,0,0,7,0,0,0,0,79547
27682,152,11,86,18,37,0,5,5,5,0,0,5,0,0,0,0,0,0,0,0,0,0,0,0,0,0,0,0,0,0,0,0,0,0,0,79548
27683,10354,2563,2703,3715,1003,370,837,382,303,70,0,233,79,51,36,0,15,28,0,0,28,455,408,73,61,274,47,47,0,32,15,0,0,0,0,79549
27684,2338,644,857,565,242,30,193,99,60,10,0,50,39,4,0,4,0,35,0,3,32,94,94,0,53,41,0,0,0,0,0,0,0,0,0,79553
27685,8358,1755,2877,2748,713,265,772,430,322,46,79,197,108,57,44,0,13,51,51,0,0,342,314,94,27,193,28,25,11,14,0,3,0,0,3,79556
27686,75,10,27,20,10,8,0,0,0,0,0,0,0,0,0,0,0,0,0,0,0,0,0,0,0,0,0,0,0,0,0,0,0,0,0,79560
27687,419,49,203,124,38,5,46,34,34,0,14,20,0,0,0,0,0,0,0,0,0,12,12,0,0,12,0,0,0,0,0,0,0,0,0,79561
27688,2561,119,963,876,463,140,219,135,132,3,0,129,3,0,0,0,0,3,0,3,0,84,84,3,3,78,0,0,0,0,0,0,0,0,0,79562
27689,724,145,255,241,71,12,121,81,25,4,0,21,56,56,47,0,9,0,0,0,0,40,35,5,5,25,5,5,0,0,5,0,0,0,0,79563
27690,172,29,77,43,19,4,7,0,0,0,0,0,0,0,0,0,0,0,0,0,0,7,7,0,0,7,0,0,0,0,0,0,0,0,0,79565
27691,249,6,115,67,32,29,5,5,5,5,0,0,0,0,0,0,0,0,0,0,0,0,0,0,0,0,0,0,0,0,0,0,0,0,0,79566
27692,2140,560,807,471,224,78,145,106,81,0,0,81,25,25,19,6,0,0,0,0,0,39,39,0,0,39,0,0,0,0,0,0,0,0,0,79567
27693,16154,3888,4805,4529,1678,1254,2642,1309,1124,319,74,731,185,101,21,23,57,84,0,13,71,1333,1273,345,84,844,60,24,20,0,4,36,11,0,25,79601
27694,14194,1951,4006,4488,2480,1269,866,456,369,167,8,194,87,59,51,8,0,28,0,0,28,410,386,147,27,212,24,16,0,16,0,8,0,8,0,79602
27695,14985,3811,5118,4398,1255,403,1134,453,370,153,25,192,83,55,13,18,24,28,22,6,0,681,533,263,39,231,148,87,8,19,60,61,12,0,49,79603
27696,18448,2633,5307,6232,2990,1286,2004,1005,862,270,37,555,143,78,69,0,9,65,12,53,0,999,874,369,112,393,125,93,72,12,9,32,0,32,0,79605
27697,14644,998,3492,4711,3542,1901,1140,586,547,231,55,261,39,39,16,0,23,0,0,0,0,554,443,101,8,334,111,111,104,0,7,0,0,0,0,79606
27698,1056,31,137,608,201,79,169,118,28,0,7,21,90,90,90,0,0,0,0,0,0,51,20,11,0,9,31,31,31,0,0,0,0,0,0,79607
27699,0,0,0,0,0,0,246,94,94,14,4,76,0,0,0,0,0,0,0,0,0,152,152,72,0,80,0,0,0,0,0,0,0,0,0,79699
27700,16725,6188,3741,4711,1551,534,1709,745,490,198,63,229,255,120,97,0,23,135,32,25,78,964,621,183,58,380,343,143,55,22,66,200,0,0,200,79701
27701,12773,2497,4109,4707,1150,310,1276,749,591,203,78,310,158,148,115,33,0,10,0,0,10,527,411,158,0,253,116,59,11,18,30,57,0,10,47,79703
27702,21238,2622,4562,7307,4572,2175,1704,1047,945,296,61,588,102,71,71,0,0,31,13,0,18,657,572,246,56,270,85,73,0,38,35,12,0,0,12,79705
27703,12774,2937,3318,4190,1854,475,1230,603,374,150,0,224,229,110,51,0,59,119,77,0,42,627,591,204,19,368,36,36,36,0,0,0,0,0,0,79706
27704,22683,1601,4296,8616,5726,2444,1810,815,668,290,12,366,147,78,78,0,0,69,69,0,0,995,744,423,59,262,251,183,137,17,29,68,0,52,16,79707
27705,375,92,129,64,65,25,29,29,21,0,0,21,8,8,8,0,0,0,0,0,0,0,0,0,0,0,0,0,0,0,0,0,0,0,0,79713
27706,9392,2475,2842,2743,976,356,1088,619,534,182,13,339,85,30,9,21,0,55,55,0,0,469,334,102,9,223,135,79,0,42,37,56,28,0,28,79714
27707,636,181,252,103,90,10,37,20,20,0,2,18,0,0,0,0,0,0,0,0,0,17,17,0,0,17,0,0,0,0,0,0,0,0,0,79718
27708,319,132,117,61,9,0,27,4,4,0,0,4,0,0,0,0,0,0,0,0,0,23,10,0,0,10,13,0,0,0,0,13,6,0,7,79719
27709,23115,6044,6706,7591,1972,802,1896,987,870,302,152,416,117,81,25,22,34,36,4,32,0,909,810,272,8,530,99,57,54,3,0,42,7,18,17,79720
27710,193,95,67,31,0,0,13,10,10,0,0,10,0,0,0,0,0,0,0,0,0,3,0,0,0,0,3,3,3,0,0,0,0,0,0,79730
27711,2660,836,775,698,228,123,329,173,154,11,29,114,19,16,16,0,0,3,0,0,3,156,116,42,4,70,40,16,0,0,16,24,0,12,12,79731
27712,112,10,29,54,10,9,19,14,11,0,0,11,3,3,3,0,0,0,0,0,0,5,5,0,0,5,0,0,0,0,0,0,0,0,0,79733
27713,1647,302,309,447,337,252,119,78,58,5,0,53,20,0,0,0,0,20,0,20,0,41,41,8,0,33,0,0,0,0,0,0,0,0,0,79734
27714,8993,2867,3091,1976,660,399,795,444,354,137,0,217,90,74,59,0,15,16,16,0,0,351,327,70,0,257,24,24,24,0,0,0,0,0,0,79735
27715,181,13,59,47,36,26,9,2,2,0,0,2,0,0,0,0,0,0,0,0,0,7,7,0,0,7,0,0,0,0,0,0,0,0,0,79738
27716,617,135,169,183,112,18,45,44,25,0,0,25,19,9,0,0,9,10,0,0,10,1,1,0,0,1,0,0,0,0,0,0,0,0,0,79739
27717,154,24,38,65,25,2,4,0,0,0,0,0,0,0,0,0,0,0,0,0,0,4,0,0,0,0,4,0,0,0,0,4,0,0,4,79741
27718,278,73,130,43,21,11,18,7,7,0,0,7,0,0,0,0,0,0,0,0,0,11,6,0,0,6,5,5,0,0,5,0,0,0,0,79742
27719,221,53,61,72,29,6,25,7,7,0,0,7,0,0,0,0,0,0,0,0,0,18,10,0,0,10,8,8,0,0,8,0,0,0,0,79743
27720,782,223,189,200,129,41,92,49,49,0,4,45,0,0,0,0,0,0,0,0,0,43,34,0,0,34,9,0,0,0,0,9,0,0,9,79744
27721,3785,1240,1089,1128,250,78,324,153,139,77,0,62,14,0,0,0,0,14,7,0,7,171,146,83,5,58,25,0,0,0,0,25,0,0,25,79745
27722,65,23,4,23,12,3,10,0,0,0,0,0,0,0,0,0,0,0,0,0,0,10,4,0,0,4,6,0,0,0,0,6,0,0,6,79748
27723,187,25,82,39,28,13,32,22,22,19,0,3,0,0,0,0,0,0,0,0,0,10,3,0,0,3,7,7,7,0,0,0,0,0,0,79749
27724,1371,380,487,360,87,57,100,37,34,0,0,34,3,3,0,0,3,0,0,0,0,63,45,10,0,35,18,6,6,0,0,12,0,5,7,79752
27725,68,8,44,13,0,3,0,0,0,0,0,0,0,0,0,0,0,0,0,0,0,0,0,0,0,0,0,0,0,0,0,0,0,0,0,79754
27726,125,28,12,42,41,2,4,4,4,0,0,4,0,0,0,0,0,0,0,0,0,0,0,0,0,0,0,0,0,0,0,0,0,0,0,79755
27727,5824,1619,1898,1516,550,241,545,308,186,66,0,120,122,107,82,0,25,15,0,14,1,237,195,43,0,152,42,42,36,0,6,0,0,0,0,79756
27728,1142,47,350,567,128,50,39,9,9,9,0,0,0,0,0,0,0,0,0,0,0,30,30,0,0,30,0,0,0,0,0,0,0,0,0,79758
27729,0,0,0,0,0,0,0,0,0,0,0,0,0,0,0,0,0,0,0,0,0,0,0,0,0,0,0,0,0,0,0,0,0,0,0,79759
27730,18937,5666,5302,5854,1394,721,1871,1003,643,210,0,433,360,82,44,33,5,278,154,56,68,868,763,260,103,400,105,24,24,0,0,81,66,0,15,79761
27731,24925,3747,6515,9108,3960,1595,2234,1192,908,404,68,436,284,203,158,10,35,81,54,0,27,1042,868,328,20,520,174,174,77,16,81,0,0,0,0,79762
27732,19422,6908,6173,4815,1193,333,1826,897,680,151,44,485,217,92,61,10,21,125,65,47,13,929,575,236,75,264,354,99,20,0,79,255,74,48,133,79763
27733,12463,4098,4055,3404,668,238,1369,697,531,198,78,255,166,159,65,86,8,7,7,0,0,672,459,126,0,333,213,180,107,0,73,33,0,33,0,79764
27734,5129,508,1131,1913,980,597,422,121,121,35,13,73,0,0,0,0,0,0,0,0,0,301,249,82,15,152,52,38,0,13,25,14,14,0,0,79765
27735,4701,2143,1115,1091,238,114,487,230,116,86,0,30,114,39,30,0,9,75,0,36,39,257,182,123,0,59,75,50,35,15,0,25,17,0,8,79766
27736,0,0,0,0,0,0,0,0,0,0,0,0,0,0,0,0,0,0,0,0,0,0,0,0,0,0,0,0,0,0,0,0,0,0,0,79770
27737,8094,3110,2442,1853,546,143,882,623,445,191,5,249,178,101,86,0,15,77,0,0,77,259,120,28,0,92,139,75,68,0,7,64,24,0,40,79772
27738,126,8,29,80,9,0,65,51,47,0,0,47,4,4,0,0,4,0,0,0,0,14,13,0,0,13,1,1,0,0,1,0,0,0,0,79777
27739,649,151,245,193,34,26,73,25,25,17,0,8,0,0,0,0,0,0,0,0,0,48,28,9,0,19,20,3,0,0,3,17,0,0,17,79778
27740,372,88,63,52,133,36,33,0,0,0,0,0,0,0,0,0,0,0,0,0,0,33,33,0,0,33,0,0,0,0,0,0,0,0,0,79780
27741,194,27,52,55,34,26,16,0,0,0,0,0,0,0,0,0,0,0,0,0,0,16,16,5,0,11,0,0,0,0,0,0,0,0,0,79781
27742,2490,803,832,656,125,74,294,81,67,16,0,51,14,14,0,0,14,0,0,0,0,213,182,33,0,149,31,0,0,0,0,31,0,0,31,79782
27743,129,36,50,24,19,0,42,14,10,4,0,6,4,0,0,0,0,4,4,0,0,28,28,3,0,25,0,0,0,0,0,0,0,0,0,79783
27744,122,55,36,31,0,0,0,0,0,0,0,0,0,0,0,0,0,0,0,0,0,0,0,0,0,0,0,0,0,0,0,0,0,0,0,79785
27745,250,32,103,94,21,0,5,4,4,0,1,3,0,0,0,0,0,0,0,0,0,1,1,1,0,0,0,0,0,0,0,0,0,0,0,79788
27746,647,83,231,236,69,28,117,62,37,11,6,20,25,11,0,11,0,14,0,0,14,55,44,14,0,30,11,11,0,0,11,0,0,0,0,79789
27747,4507,1088,1568,1444,264,143,401,242,162,42,15,105,80,14,6,0,8,66,7,0,59,159,121,23,8,90,38,38,13,3,22,0,0,0,0,79821
27748,5022,723,979,1481,975,864,274,135,118,26,12,80,17,0,0,0,0,17,0,0,17,139,139,52,9,78,0,0,0,0,0,0,0,0,0,79830
27749,21,0,0,15,0,6,0,0,0,0,0,0,0,0,0,0,0,0,0,0,0,0,0,0,0,0,0,0,0,0,0,0,0,0,0,79831
27750,112,7,34,10,55,6,0,0,0,0,0,0,0,0,0,0,0,0,0,0,0,0,0,0,0,0,0,0,0,0,0,0,0,0,0,79834
27751,6828,2494,2125,1553,461,195,872,457,366,68,48,250,91,58,28,9,21,33,16,17,0,415,350,31,20,299,65,26,26,0,0,39,0,0,39,79835
27752,3090,1133,788,815,265,89,290,158,128,0,13,115,30,30,0,0,30,0,0,0,0,132,103,27,0,76,29,29,29,0,0,0,0,0,0,79836
27753,343,140,84,83,12,24,34,16,16,0,0,16,0,0,0,0,0,0,0,0,0,18,17,0,0,17,1,0,0,0,0,1,0,0,1,79837
27754,4378,2111,1295,755,129,88,826,435,356,27,4,325,79,37,9,28,0,42,0,0,42,391,342,6,10,326,49,29,0,10,19,20,0,20,0,79838
27755,1132,659,235,138,72,28,145,84,70,17,0,53,14,14,14,0,0,0,0,0,0,61,56,16,7,33,5,3,0,3,0,2,0,0,2,79839
27756,520,156,122,89,109,44,24,0,0,0,0,0,0,0,0,0,0,0,0,0,0,24,24,4,2,18,0,0,0,0,0,0,0,0,0,79842
27757,1828,352,373,342,532,229,222,185,178,109,0,69,7,7,0,0,7,0,0,0,0,37,37,24,0,13,0,0,0,0,0,0,0,0,0,79843
27758,3094,1892,548,276,222,156,286,43,43,0,0,43,0,0,0,0,0,0,0,0,0,243,146,35,0,111,97,97,34,0,63,0,0,0,0,79845
27759,30,7,0,8,15,0,0,0,0,0,0,0,0,0,0,0,0,0,0,0,0,0,0,0,0,0,0,0,0,0,0,0,0,0,0,79846
27760,39,0,16,23,0,0,0,0,0,0,0,0,0,0,0,0,0,0,0,0,0,0,0,0,0,0,0,0,0,0,0,0,0,0,0,79847
27761,663,160,197,191,79,36,19,0,0,0,0,0,0,0,0,0,0,0,0,0,0,19,19,0,0,19,0,0,0,0,0,0,0,0,0,79848
27762,6694,3570,1635,1211,233,45,1232,642,500,30,9,461,142,99,56,0,43,43,26,0,17,590,518,45,35,438,72,72,14,0,58,0,0,0,0,79849
27763,557,177,189,152,22,17,30,0,0,0,0,0,0,0,0,0,0,0,0,0,0,30,24,9,0,15,6,6,0,6,0,0,0,0,0,79851
27764,694,91,176,199,123,105,21,21,5,5,0,0,16,16,12,4,0,0,0,0,0,0,0,0,0,0,0,0,0,0,0,0,0,0,0,79852
27765,1531,905,372,223,31,0,337,144,131,5,8,118,13,8,0,8,0,5,5,0,0,193,172,0,32,140,21,10,0,0,10,11,0,0,11,79853
27766,125,30,32,16,26,21,0,0,0,0,0,0,0,0,0,0,0,0,0,0,0,0,0,0,0,0,0,0,0,0,0,0,0,0,0,79854
27767,1485,447,554,236,179,69,186,115,115,32,0,83,0,0,0,0,0,0,0,0,0,71,61,13,0,48,10,5,0,0,5,5,5,0,0,79855
27768,6692,4520,1118,896,109,49,701,327,284,44,35,205,43,21,0,8,13,22,0,0,22,374,285,0,5,280,89,10,0,3,7,79,0,0,79,79901
27769,14112,3282,2033,3682,3015,2100,1413,601,505,18,0,487,96,77,30,23,24,19,0,0,19,812,764,158,0,606,48,41,0,0,41,7,0,0,7,79902
27770,11710,4341,2803,2779,1183,604,975,483,431,173,15,243,52,43,29,0,14,9,0,0,9,492,392,43,35,314,100,8,0,8,0,92,60,0,32,79903
27771,19682,5081,5212,6148,2245,996,2035,999,867,110,51,706,132,41,10,10,21,91,0,43,48,1036,860,159,23,678,176,148,27,0,121,28,10,0,18,79904
27772,15268,6984,3989,3430,592,273,2017,1038,890,128,72,690,148,101,32,11,58,47,11,29,7,979,755,73,45,637,224,93,48,10,35,131,0,26,105,79905
27773,1588,59,354,691,265,219,252,156,84,8,15,61,72,72,69,3,0,0,0,0,0,96,70,48,0,22,26,5,5,0,0,21,21,0,0,79906
27774,32113,12252,9591,7660,1978,632,3727,1963,1643,313,188,1142,320,256,146,24,86,64,46,0,18,1764,1365,195,60,1110,399,330,40,107,183,69,25,7,37,79907
27775,1297,26,170,738,197,166,276,196,73,10,19,44,123,123,104,0,19,0,0,0,0,80,59,5,0,54,21,21,0,4,17,0,0,0,0,79908
27776,1706,100,142,624,556,284,79,58,58,0,0,58,0,0,0,0,0,0,0,0,0,21,21,0,0,21,0,0,0,0,0,0,0,0,0,79911
27777,49732,5162,8579,13592,13874,8525,5364,2550,2289,388,209,1692,261,234,137,28,69,27,10,0,17,2814,2621,715,53,1853,193,155,0,26,129,38,0,0,38,79912
27778,24678,10204,6326,5768,1800,580,2460,1223,947,207,78,662,276,190,54,81,55,86,0,0,86,1237,906,171,75,660,331,232,119,48,65,99,0,0,99,79915
27779,1013,22,311,470,165,45,289,242,0,0,0,0,242,242,242,0,0,0,0,0,0,47,0,0,0,0,47,47,47,0,0,0,0,0,0,79916
27780,13,0,0,13,0,0,26,26,0,0,0,0,26,26,26,0,0,0,0,0,0,0,0,0,0,0,0,0,0,0,0,0,0,0,0,79920
27781,5885,866,916,1163,1667,1273,470,254,203,13,0,190,51,0,0,0,0,51,0,0,51,216,211,46,6,159,5,0,0,0,0,5,0,0,5,79922
27782,35113,7197,9862,12806,3769,1479,3902,2040,1776,296,122,1358,264,210,177,19,14,54,3,0,51,1862,1579,327,89,1163,283,186,41,23,122,97,30,44,23,79924
27783,26151,4619,6373,8865,4276,2018,2461,1458,1147,192,86,869,311,249,221,0,28,62,11,0,51,1003,847,168,66,613,156,154,94,21,39,2,0,0,2,79925
27784,22786,9815,5778,5360,1354,479,3302,1721,1275,243,212,820,446,382,277,0,105,64,4,12,48,1581,1357,184,123,1050,224,162,10,0,152,62,0,10,52,79927
27785,25898,6885,6313,8162,3346,1192,3598,1765,1533,195,91,1247,232,217,72,70,75,15,11,0,4,1833,1613,231,123,1259,220,153,60,19,74,67,0,0,67,79928
27786,18668,6167,4634,5178,1901,788,1623,848,691,38,27,626,157,23,4,0,19,134,11,71,52,775,587,10,34,543,188,111,14,54,43,77,0,25,52,79930
27787,15725,3561,2693,4467,2967,2037,1728,739,601,141,54,406,138,106,60,20,26,32,32,0,0,989,723,141,0,582,266,215,73,30,112,51,0,0,51,79932
27788,12076,1028,1873,5322,2610,1243,1427,786,660,188,74,398,126,112,20,35,57,14,0,14,0,641,629,202,15,412,12,4,0,4,0,8,0,0,8,79934
27789,11578,1989,2865,4197,1785,742,1029,625,473,99,60,314,152,115,48,58,9,37,22,0,15,404,302,34,8,260,102,94,18,13,63,8,0,0,8,79935
27790,66830,11213,17362,22475,11400,4380,7602,4165,3702,523,331,2848,463,407,249,133,25,56,32,0,24,3437,2908,850,291,1767,529,340,182,30,128,189,9,44,136,79936
27791,32079,7981,7730,10250,4703,1415,4147,1862,1489,268,116,1105,373,186,43,67,76,187,28,13,146,2285,2252,441,160,1651,33,18,0,0,18,15,0,0,15,79938
27792,0,0,0,0,0,0,0,0,0,0,0,0,0,0,0,0,0,0,0,0,0,0,0,0,0,0,0,0,0,0,0,0,0,0,0,79942
27793,13216,1866,3487,4535,2227,1101,693,378,335,116,17,202,43,12,0,7,5,31,0,0,31,315,212,86,34,92,103,4,4,0,0,99,23,42,34,80002
27794,23297,2611,6913,8356,3875,1542,1764,867,723,290,69,364,144,80,20,16,44,64,0,19,45,897,678,272,168,238,219,184,167,11,6,35,0,25,10,80003
27795,24930,1608,6534,8238,5455,3095,1728,860,776,236,56,484,84,48,38,10,0,36,0,36,0,868,746,319,103,324,122,114,114,0,0,8,0,8,0,80004
27796,18531,755,3381,5796,5686,2913,1530,834,672,137,60,475,162,146,111,11,24,16,0,0,16,696,676,251,28,397,20,9,1,8,0,11,0,0,11,80005
27797,4766,117,581,1204,1727,1137,438,200,200,70,12,118,0,0,0,0,0,0,0,0,0,238,238,67,24,147,0,0,0,0,0,0,0,0,0,80007
27798,23825,8826,7435,4999,1835,730,2589,1381,808,240,85,483,573,151,118,8,25,422,248,55,119,1208,939,210,141,588,269,206,102,17,87,63,41,12,10,80010
27799,27780,6708,8863,8537,2626,1046,2764,1240,773,123,95,555,467,333,214,0,119,134,90,44,0,1524,1152,297,203,652,372,164,97,12,55,208,24,105,79,80011
27800,30362,4770,8675,10137,4676,2104,2238,1209,907,174,285,448,302,220,129,77,14,82,23,32,27,1029,866,167,146,553,163,43,34,0,9,120,54,32,34,80012
27801,45600,3667,11135,17636,9355,3807,3835,1959,1574,376,299,899,385,243,138,24,81,142,79,25,38,1876,1694,597,199,898,182,135,49,75,11,47,13,10,24,80013
27802,26961,2124,6186,8560,6573,3518,1397,753,541,156,98,287,212,158,28,66,64,54,31,9,14,644,563,131,59,373,81,70,32,8,30,11,0,0,11,80014
27803,40768,2127,7514,14329,11167,5631,4265,2369,1878,388,293,1197,491,334,75,86,173,157,136,0,21,1896,1697,476,135,1086,199,122,21,79,22,77,0,27,50,80015
27804,26772,544,3948,7772,9195,5313,2360,1236,1187,222,74,891,49,47,43,4,0,2,0,0,2,1124,879,260,81,538,245,212,179,17,16,33,0,33,0,80016
27805,20762,2181,5421,8630,3168,1362,1869,698,528,9,121,398,170,71,32,24,15,99,30,39,30,1171,988,245,175,568,183,148,53,29,66,35,0,35,0,80017
27806,6572,356,1333,2551,1593,739,418,234,187,34,0,153,47,20,20,0,0,27,0,0,27,184,151,50,0,101,33,33,0,0,33,0,0,0,0,80018
27807,1381,207,324,537,198,115,179,84,82,12,0,70,2,1,0,0,1,1,0,0,1,95,95,41,0,54,0,0,0,0,0,0,0,0,0,80019
27808,31893,1770,5959,11185,8642,4337,2331,1329,1145,265,54,826,184,123,57,66,0,61,11,22,28,1002,947,323,27,597,55,55,26,13,16,0,0,0,0,80020
27809,20862,956,3783,7203,6164,2756,1509,749,655,177,96,382,94,91,41,28,22,3,3,0,0,760,664,275,30,359,96,96,96,0,0,0,0,0,0,80021
27810,26107,7289,7847,6515,3074,1382,2528,1295,893,151,107,635,402,263,166,30,67,139,115,17,7,1233,927,199,167,561,306,96,46,41,9,210,0,43,167,80022
27811,10271,157,1175,2501,3859,2579,521,217,194,7,34,153,23,0,0,0,0,23,0,0,23,304,304,65,0,239,0,0,0,0,0,0,0,0,0,80023
27812,199,159,6,34,0,0,29,29,29,15,14,0,0,0,0,0,0,0,0,0,0,0,0,0,0,0,0,0,0,0,0,0,0,0,0,80024
27813,188,0,0,59,83,46,0,0,0,0,0,0,0,0,0,0,0,0,0,0,0,0,0,0,0,0,0,0,0,0,0,0,0,0,0,80025
27814,18670,1105,2846,4503,6152,4064,1149,526,440,80,45,315,86,70,63,0,7,16,0,0,16,623,535,142,21,372,88,67,21,0,46,21,21,0,0,80026
27815,20930,274,1663,3972,8010,7011,1736,744,706,221,52,433,38,38,38,0,0,0,0,0,0,992,972,227,85,660,20,9,9,0,0,11,11,0,0,80027
27816,10153,2245,3085,3242,1224,357,730,380,284,41,61,182,96,71,51,20,0,25,25,0,0,350,278,25,42,211,72,61,29,16,16,11,0,5,6,80030
27817,23367,2557,5434,7165,5484,2727,1442,617,406,158,59,189,211,68,68,0,0,143,84,9,50,825,751,182,103,466,74,45,0,11,34,29,0,29,0,80031
27818,18070,1931,4639,5974,3810,1716,1055,539,396,63,48,285,143,91,57,34,0,52,20,0,32,516,442,88,61,293,74,25,12,13,0,49,18,0,31,80033
27819,359,21,29,46,153,110,0,0,0,0,0,0,0,0,0,0,0,0,0,0,0,0,0,0,0,0,0,0,0,0,0,0,0,0,0,80045
27820,199,4,82,56,48,9,8,8,8,0,0,8,0,0,0,0,0,0,0,0,0,0,0,0,0,0,0,0,0,0,0,0,0,0,0,80101
27821,3487,332,1184,1216,623,132,346,209,164,14,14,136,45,31,31,0,0,14,14,0,0,137,113,23,12,78,24,16,0,4,12,8,8,0,0,80102
27822,1687,194,661,579,173,80,74,36,36,13,0,23,0,0,0,0,0,0,0,0,0,38,36,0,4,32,2,2,0,0,2,0,0,0,0,80103
27823,17670,1165,3243,6072,4999,2191,1371,627,558,141,36,381,69,69,32,0,37,0,0,0,0,744,675,272,0,403,69,69,59,10,0,0,0,0,0,80104
27824,831,77,277,362,86,29,19,12,9,0,0,9,3,3,3,0,0,0,0,0,0,7,7,5,0,2,0,0,0,0,0,0,0,0,0,80105
27825,2935,110,518,1121,830,356,313,161,161,39,0,122,0,0,0,0,0,0,0,0,0,152,151,21,6,124,1,0,0,0,0,1,0,0,1,80106
27826,7915,245,2093,3213,1616,748,698,407,299,0,59,240,108,88,88,0,0,20,20,0,0,291,281,71,35,175,10,10,10,0,0,0,0,0,0,80107
27827,15116,302,1539,4160,6078,3037,1236,676,609,333,70,206,67,33,13,20,0,34,16,18,0,560,457,130,40,287,103,38,38,0,0,65,65,0,0,80108
27828,11350,352,1553,3012,4511,1922,780,466,365,157,0,208,101,6,0,0,6,95,23,0,72,314,283,72,0,211,31,26,26,0,0,5,0,0,5,80109
27829,14290,2248,4577,4515,1996,954,971,380,262,104,9,149,118,70,43,27,0,48,28,7,13,591,389,80,73,236,202,109,69,29,11,93,0,38,55,80110
27830,20273,350,1916,4096,7907,6004,1804,1129,1042,210,88,744,87,53,39,14,0,34,0,13,21,675,601,203,0,398,74,40,31,9,0,34,18,0,16,80111
27831,20585,602,1988,5373,8003,4619,1735,953,807,176,53,578,146,103,0,87,16,43,0,0,43,782,665,156,75,434,117,111,0,0,111,6,6,0,0,80112
27832,15217,1158,2950,3934,4234,2941,750,396,349,66,20,263,47,41,26,0,15,6,0,0,6,354,313,39,8,266,41,41,32,8,1,0,0,0,0,80113
27833,2852,115,536,840,872,489,255,142,119,50,0,69,23,23,23,0,0,0,0,0,0,113,108,12,0,96,5,0,0,0,0,5,0,0,5,80116
27834,2039,98,634,729,448,130,105,39,39,0,4,35,0,0,0,0,0,0,0,0,0,66,55,12,0,43,11,11,11,0,0,0,0,0,0,80117
27835,3943,52,720,1335,1190,646,301,206,129,22,0,107,77,48,48,0,0,29,0,0,29,95,80,5,0,75,15,10,10,0,0,5,0,0,5,80118
27836,21018,1230,4052,6886,5773,3077,1479,708,533,94,29,410,175,124,60,64,0,51,0,23,28,771,716,215,76,425,55,32,15,0,17,23,8,0,15,80120
27837,13153,542,2105,3557,4185,2764,739,405,350,59,67,224,55,0,0,0,0,55,43,0,12,334,326,78,0,248,8,0,0,0,0,8,0,0,8,80121
27838,22114,651,3448,6248,7966,3801,1393,701,691,179,136,376,10,10,10,0,0,0,0,0,0,692,647,184,45,418,45,45,38,0,7,0,0,0,0,80122
27839,31189,1039,5924,10020,9624,4582,2120,1075,918,217,112,589,157,121,62,24,35,36,0,25,11,1045,945,336,82,527,100,75,58,17,0,25,9,0,16,80123
27840,12074,164,1520,3049,4698,2643,878,538,375,85,23,267,163,78,33,30,15,85,40,0,45,340,340,179,29,132,0,0,0,0,0,0,0,0,0,80124
27841,6612,155,943,1748,2428,1338,491,284,183,20,32,131,101,13,13,0,0,88,0,0,88,207,201,20,0,181,6,0,0,0,0,6,0,0,6,80125
27842,25605,399,2822,6164,10431,5789,2348,1140,1010,356,77,577,130,111,74,24,13,19,0,19,0,1208,1113,339,125,649,95,83,83,0,0,12,0,12,0,80126
27843,29892,754,4779,8975,9757,5627,2820,1657,1566,434,213,919,91,76,34,26,16,15,15,0,0,1163,1094,373,92,629,69,29,29,0,0,40,6,26,8,80127
27844,25149,1027,5080,8571,7015,3456,2165,1025,735,275,74,386,290,183,135,48,0,107,33,25,49,1140,1038,472,37,529,102,54,14,11,29,48,9,0,39,80128
27845,17752,328,2257,4866,7079,3222,1420,734,675,199,51,425,59,59,38,5,16,0,0,0,0,686,667,135,52,480,19,19,19,0,0,0,0,0,0,80129
27846,18420,413,1782,4709,7727,3789,1214,656,593,175,78,340,63,63,48,15,0,0,0,0,0,558,527,62,39,426,31,31,31,0,0,0,0,0,0,80130
27847,114,10,38,60,6,0,0,0,0,0,0,0,0,0,0,0,0,0,0,0,0,0,0,0,0,0,0,0,0,0,0,0,0,0,0,80131
27848,13311,156,1441,3532,4801,3381,1264,614,557,265,33,259,57,57,39,18,0,0,0,0,0,650,608,171,32,405,42,32,0,32,0,10,0,0,10,80132
27849,1576,107,323,521,508,117,26,23,23,0,0,23,0,0,0,0,0,0,0,0,0,3,3,3,0,0,0,0,0,0,0,0,0,0,0,80133
27850,36046,770,5451,10133,14189,5503,2990,1557,1281,333,122,826,276,207,179,15,13,69,31,0,38,1433,1261,405,64,792,172,172,141,11,20,0,0,0,0,80134
27851,2758,128,562,1007,678,383,212,119,92,51,6,35,27,15,0,8,7,12,0,7,5,93,93,59,6,28,0,0,0,0,0,0,0,0,0,80135
27852,3468,183,1137,1466,518,164,381,218,173,23,22,128,45,5,5,0,0,40,0,0,40,163,163,25,0,138,0,0,0,0,0,0,0,0,0,80136
27853,759,49,292,235,120,63,189,166,141,0,0,141,25,25,25,0,0,0,0,0,0,23,23,0,9,14,0,0,0,0,0,0,0,0,0,80137
27854,19349,376,2991,6834,6658,2490,1775,811,749,125,36,588,62,47,45,0,2,15,0,0,15,964,935,486,90,359,29,29,29,0,0,0,0,0,0,80138
27855,8790,233,748,1734,3678,2397,258,136,136,26,32,78,0,0,0,0,0,0,0,0,0,122,122,38,14,70,0,0,0,0,0,0,0,0,0,80202
27856,16052,792,1613,3685,7009,2953,76,52,52,0,12,40,0,0,0,0,0,0,0,0,0,24,14,0,0,14,10,10,10,0,0,0,0,0,0,80203
27857,19051,5734,4128,4386,3155,1648,1625,725,586,182,24,380,139,47,40,7,0,92,21,9,62,900,671,243,67,361,229,116,71,38,7,113,0,0,113,80204
27858,20909,3785,3640,5038,5493,2953,993,435,333,28,70,235,102,19,17,0,2,83,49,21,13,558,539,130,46,363,19,19,11,7,1,0,0,0,0,80205
27859,17234,338,1088,3229,6986,5593,320,187,159,76,22,61,28,28,19,0,9,0,0,0,0,133,118,24,0,94,15,15,0,0,15,0,0,0,0,80206
27860,14822,2023,2759,3871,3781,2388,823,470,365,11,98,256,105,47,14,0,33,58,0,35,23,353,312,48,11,253,41,32,11,21,0,9,0,0,9,80207
27861,18011,635,1425,3196,6906,5849,449,296,182,27,0,155,114,102,36,8,58,12,0,0,12,153,142,52,0,90,11,11,11,0,0,0,0,0,0,80209
27862,24117,739,2352,4411,9040,7575,2595,1091,1082,304,54,724,9,9,9,0,0,0,0,0,0,1504,1432,460,138,834,72,0,0,0,0,72,36,0,36,80210
27863,24627,3829,4408,5065,7446,3879,1295,783,587,139,21,427,196,100,60,40,0,96,75,7,14,512,415,125,8,282,97,57,49,6,2,40,11,10,19,80211
27864,14223,1237,2819,3377,4234,2556,515,293,247,66,53,128,46,46,46,0,0,0,0,0,0,222,197,115,24,58,25,25,25,0,0,0,0,0,0,80212
27865,17387,3108,4709,5577,2750,1243,1138,716,380,44,24,312,336,90,53,0,37,246,18,185,43,422,353,125,22,206,69,19,0,0,19,50,0,32,18,80214
27866,12963,1171,2848,3576,3337,2031,748,345,231,17,58,156,114,90,90,0,0,24,23,0,1,403,329,146,19,164,74,43,25,0,18,31,22,9,0,80215
27867,6365,2773,1580,1198,682,132,743,421,260,43,9,208,161,84,41,11,32,77,43,18,16,322,295,123,0,172,27,10,10,0,0,17,9,0,8,80216
27868,14932,561,1396,3407,6412,3156,435,103,100,0,0,100,3,1,0,0,1,2,0,0,2,332,268,79,13,176,64,35,35,0,0,29,8,0,21,80218
27869,37587,13708,11532,8307,2958,1082,3800,2089,1489,152,173,1164,600,218,68,67,83,382,104,23,255,1711,1342,347,116,879,369,227,116,43,68,142,71,7,64,80219
27870,24409,1626,3191,5551,7854,6187,1585,801,701,119,120,462,100,68,38,14,16,32,2,21,9,784,713,204,88,421,71,25,19,4,2,46,8,33,5,80220
27871,25899,7647,8624,6329,2309,990,2145,1010,825,168,105,552,185,74,41,14,19,111,40,71,0,1135,899,332,60,507,236,132,76,10,46,104,74,4,26,80221
27872,14494,1002,2852,4353,4002,2285,797,553,342,65,77,200,211,159,127,0,32,52,0,52,0,244,234,81,51,102,10,10,10,0,0,0,0,0,0,80222
27873,11322,3681,2742,2603,1648,648,833,399,290,57,41,192,109,73,73,0,0,36,0,0,36,434,331,82,4,245,103,98,60,12,26,5,0,5,0,80223
27874,12681,712,2694,3336,3500,2439,368,131,108,34,0,74,23,12,12,0,0,11,0,0,11,237,210,125,0,85,27,0,0,0,0,27,0,27,0,80224
27875,21103,2209,5688,6380,4730,2096,1838,891,764,258,82,424,127,115,80,35,0,12,0,12,0,947,862,234,114,514,85,52,30,22,0,33,0,28,5,80226
27876,23070,2517,5380,6953,5206,3014,1586,836,692,206,105,381,144,122,72,14,36,22,0,0,22,750,574,251,41,282,176,139,68,9,62,37,37,0,0,80227
27877,21583,779,4095,6836,6330,3543,1329,591,528,96,38,394,63,16,12,4,0,47,22,12,13,738,630,143,62,425,108,108,108,0,0,0,0,0,0,80228
27878,30280,6350,11021,9053,2765,1091,2751,1438,1045,128,109,808,393,312,230,29,53,81,0,14,67,1313,950,220,45,685,363,179,96,29,54,184,50,70,64,80229
27879,5528,162,441,1071,2009,1845,265,88,88,54,0,34,0,0,0,0,0,0,0,0,0,177,141,88,0,53,36,36,36,0,0,0,0,0,0,80230
27880,24471,1894,5064,6965,6809,3739,1121,470,320,98,71,151,150,108,92,16,0,42,0,0,42,651,482,100,18,364,169,157,75,37,45,12,0,0,12,80231
27881,15485,1545,4114,5171,3051,1604,769,449,387,77,25,285,62,62,24,17,21,0,0,0,0,320,291,100,51,140,29,24,13,0,11,5,0,0,5,80232
27882,29531,3367,9830,10447,4528,1359,2394,1217,968,247,169,552,249,154,71,76,7,95,29,11,55,1177,960,334,118,508,217,178,89,0,89,39,0,0,39,80233
27883,17235,1790,3994,5364,4008,2079,1314,752,692,251,104,337,60,45,19,19,7,15,0,15,0,562,518,115,77,326,44,36,36,0,0,8,0,0,8,80234
27884,6642,475,1835,2392,1181,759,412,263,174,0,8,166,89,41,35,0,6,48,0,7,41,149,142,50,0,92,7,0,0,0,0,7,0,7,0,80235
27885,11246,2202,3333,3375,1601,735,746,447,395,73,8,314,52,38,38,0,0,14,0,0,14,299,243,135,0,108,56,10,10,0,0,46,33,0,13,80236
27886,13796,451,1554,3984,4945,2862,663,252,218,69,6,143,34,0,0,0,0,34,34,0,0,411,312,122,32,158,99,48,48,0,0,51,37,14,0,80237
27887,7382,69,231,1049,2701,3332,70,24,24,0,0,24,0,0,0,0,0,0,0,0,0,46,34,15,0,19,12,12,0,0,12,0,0,0,0,80238
27888,23214,6826,7287,6303,1989,809,2705,1356,1039,203,88,748,317,171,81,74,16,146,34,13,99,1349,1130,243,204,683,219,150,76,74,0,69,29,0,40,80239
27889,20621,1441,4701,7731,4587,2161,1749,1012,836,216,142,478,176,83,83,0,0,93,49,26,18,737,686,235,26,425,51,40,40,0,0,11,0,11,0,80241
27890,8875,827,1520,2140,2550,1838,355,255,136,35,22,79,119,88,60,0,28,31,31,0,0,100,70,14,0,56,30,30,30,0,0,0,0,0,0,80246
27891,18580,1698,4664,5795,4254,2169,1023,388,269,80,61,128,119,51,0,18,33,68,24,0,44,635,343,43,74,226,292,108,56,52,0,184,42,0,142,80247
27892,15477,3280,3551,5172,2357,1117,1220,505,501,17,0,484,4,4,4,0,0,0,0,0,0,715,633,201,28,404,82,72,55,17,0,10,3,7,0,80249
27893,19383,5465,6312,5590,1454,562,1487,823,599,197,30,372,224,120,73,14,33,104,12,36,56,664,531,118,144,269,133,96,6,22,68,37,16,0,21,80260
27894,0,0,0,0,0,0,0,0,0,0,0,0,0,0,0,0,0,0,0,0,0,0,0,0,0,0,0,0,0,0,0,0,0,0,0,80264
27895,0,0,0,0,0,0,0,0,0,0,0,0,0,0,0,0,0,0,0,0,0,0,0,0,0,0,0,0,0,0,0,0,0,0,0,80290
27896,0,0,0,0,0,0,0,0,0,0,0,0,0,0,0,0,0,0,0,0,0,0,0,0,0,0,0,0,0,0,0,0,0,0,0,80293
27897,0,0,0,0,0,0,0,0,0,0,0,0,0,0,0,0,0,0,0,0,0,0,0,0,0,0,0,0,0,0,0,0,0,0,0,80294
27898,17233,851,1505,3873,6222,4782,1020,490,419,27,29,363,71,49,13,0,36,22,13,0,9,530,512,97,44,371,18,18,0,18,0,0,0,0,0,80301
27899,13633,401,860,2308,4779,5285,2723,1279,1251,252,151,848,28,15,0,0,15,13,0,0,13,1444,1430,373,135,922,14,14,14,0,0,0,0,0,0,80302
27900,13895,614,1207,2549,4722,4803,1097,613,563,184,11,368,50,37,37,0,0,13,0,13,0,484,463,204,74,185,21,21,5,0,16,0,0,0,0,80303
27901,18346,822,1357,2899,6877,6391,839,429,345,89,8,248,84,10,9,0,1,74,33,0,41,410,391,66,44,281,19,19,7,12,0,0,0,0,0,80304
27902,10958,110,585,1638,3721,4904,1039,490,414,100,80,234,76,67,67,0,0,9,9,0,0,549,522,259,69,194,27,27,27,0,0,0,0,0,0,80305
27903,37,0,0,2,11,24,5474,2875,2875,522,454,1899,0,0,0,0,0,0,0,0,0,2599,2599,650,202,1747,0,0,0,0,0,0,0,0,0,80310
27904,26332,1302,4553,7035,7482,5960,2667,1591,1448,380,139,929,143,92,77,0,15,51,0,17,34,1076,1015,314,91,610,61,51,28,7,16,10,0,0,10,80401
27905,13537,495,2199,3438,4522,2883,800,437,321,170,0,151,116,79,0,47,32,37,8,0,29,363,356,64,20,272,7,0,0,0,0,7,0,0,7,80403
27906,260,57,82,89,32,0,19,19,0,0,0,0,19,19,0,0,19,0,0,0,0,0,0,0,0,0,0,0,0,0,0,0,0,0,0,80419
27907,510,31,71,177,195,36,33,5,0,0,0,0,5,0,0,0,0,5,0,0,5,28,26,0,0,26,2,2,2,0,0,0,0,0,0,80420
27908,6123,333,1654,2490,1287,359,542,294,212,87,44,81,82,82,81,0,1,0,0,0,0,248,224,73,0,151,24,24,14,9,1,0,0,0,0,80421
27909,3422,185,805,1446,585,401,109,19,19,19,0,0,0,0,0,0,0,0,0,0,0,90,90,14,14,62,0,0,0,0,0,0,0,0,0,80422
27910,129,0,24,34,60,11,10,5,5,0,0,5,0,0,0,0,0,0,0,0,0,5,5,0,0,5,0,0,0,0,0,0,0,0,0,80423
27911,6709,148,989,2054,2622,896,226,88,57,0,18,39,31,31,31,0,0,0,0,0,0,138,95,0,0,95,43,15,15,0,0,28,0,28,0,80424
27912,182,0,12,73,31,66,0,0,0,0,0,0,0,0,0,0,0,0,0,0,0,0,0,0,0,0,0,0,0,0,0,0,0,0,0,80425
27913,217,9,71,137,0,0,0,0,0,0,0,0,0,0,0,0,0,0,0,0,0,0,0,0,0,0,0,0,0,0,0,0,0,0,0,80426
27914,584,32,146,305,56,45,8,7,6,0,6,0,1,0,0,0,0,1,1,0,0,1,1,0,0,1,0,0,0,0,0,0,0,0,0,80427
27915,327,6,69,137,11,104,21,0,0,0,0,0,0,0,0,0,0,0,0,0,0,21,21,0,0,21,0,0,0,0,0,0,0,0,0,80428
27916,65,0,8,57,0,0,0,0,0,0,0,0,0,0,0,0,0,0,0,0,0,0,0,0,0,0,0,0,0,0,0,0,0,0,0,80432
27917,6117,154,1057,1989,1823,1094,476,270,211,75,13,123,59,22,10,12,0,37,0,0,37,206,186,49,0,137,20,20,7,0,13,0,0,0,0,80433
27918,34,0,17,17,0,0,0,0,0,0,0,0,0,0,0,0,0,0,0,0,0,0,0,0,0,0,0,0,0,0,0,0,0,0,0,80434
27919,5459,505,1123,1860,1322,649,417,265,248,115,0,133,17,17,0,0,17,0,0,0,0,152,147,81,0,66,5,5,5,0,0,0,0,0,0,80435
27920,446,21,195,183,34,13,25,25,25,25,0,0,0,0,0,0,0,0,0,0,0,0,0,0,0,0,0,0,0,0,0,0,0,0,0,80436
27921,235,4,85,107,22,17,22,12,6,6,0,0,6,6,0,0,6,0,0,0,0,10,8,8,0,0,2,0,0,0,0,2,2,0,0,80438
27922,17783,404,2078,4425,6423,4453,1267,709,600,124,96,380,109,87,87,0,0,22,0,22,0,558,551,278,11,262,7,7,7,0,0,0,0,0,0,80439
27923,1650,115,360,516,476,183,100,58,50,22,0,28,8,8,8,0,0,0,0,0,0,42,37,1,0,36,5,0,0,0,0,5,0,0,5,80440
27924,1894,21,173,903,573,224,56,42,36,18,0,18,6,6,6,0,0,0,0,0,0,14,0,0,0,0,14,14,14,0,0,0,0,0,0,80442
27925,2611,81,422,710,706,692,9,0,0,0,0,0,0,0,0,0,0,0,0,0,0,9,9,0,0,9,0,0,0,0,0,0,0,0,0,80443
27926,938,58,246,344,196,94,15,0,0,0,0,0,0,0,0,0,0,0,0,0,0,15,10,0,0,10,5,5,5,0,0,0,0,0,0,80444
27927,2587,159,1163,757,350,158,190,148,36,17,19,0,112,0,0,0,0,112,84,28,0,42,32,12,0,20,10,10,10,0,0,0,0,0,0,80446
27928,1309,12,296,482,385,134,60,0,0,0,0,0,0,0,0,0,0,0,0,0,0,60,60,0,0,60,0,0,0,0,0,0,0,0,0,80447
27929,251,0,86,107,34,24,10,0,0,0,0,0,0,0,0,0,0,0,0,0,0,10,10,10,0,0,0,0,0,0,0,0,0,0,0,80448
27930,661,54,148,289,80,90,8,0,0,0,0,0,0,0,0,0,0,0,0,0,0,8,8,0,0,8,0,0,0,0,0,0,0,0,0,80449
27931,616,49,177,248,135,7,24,16,14,0,0,14,2,2,0,2,0,0,0,0,0,8,8,0,8,0,0,0,0,0,0,0,0,0,0,80451
27932,1937,88,673,684,349,143,73,52,52,0,0,52,0,0,0,0,0,0,0,0,0,21,21,0,21,0,0,0,0,0,0,0,0,0,0,80452
27933,143,28,63,45,7,0,51,19,19,0,0,19,0,0,0,0,0,0,0,0,0,32,0,0,0,0,32,32,11,0,21,0,0,0,0,80453
27934,885,25,120,318,284,138,27,8,8,0,0,8,0,0,0,0,0,0,0,0,0,19,9,0,9,0,10,10,10,0,0,0,0,0,0,80454
27935,401,0,14,76,215,96,35,30,29,9,0,20,1,1,1,0,0,0,0,0,0,5,5,0,0,5,0,0,0,0,0,0,0,0,0,80455
27936,607,9,163,184,218,33,0,0,0,0,0,0,0,0,0,0,0,0,0,0,0,0,0,0,0,0,0,0,0,0,0,0,0,0,0,80456
27937,283,11,55,137,40,40,54,0,0,0,0,0,0,0,0,0,0,0,0,0,0,54,54,0,54,0,0,0,0,0,0,0,0,0,0,80457
27938,1617,288,527,495,260,47,174,103,103,25,5,73,0,0,0,0,0,0,0,0,0,71,59,17,0,42,12,12,12,0,0,0,0,0,0,80459
27939,4781,644,1327,1474,941,395,380,113,112,13,21,78,1,0,0,0,0,1,0,0,1,267,207,97,32,78,60,60,0,26,34,0,0,0,0,80461
27940,73,0,31,21,14,7,17,17,4,0,4,0,13,0,0,0,0,13,13,0,0,0,0,0,0,0,0,0,0,0,0,0,0,0,0,80463
27941,11288,523,2119,3786,2986,1874,700,321,271,59,25,187,50,35,22,11,2,15,0,0,15,379,320,82,29,209,59,0,0,0,0,59,25,12,22,80465
27942,2432,34,228,694,850,626,68,51,47,5,0,42,4,4,4,0,0,0,0,0,0,17,17,0,0,17,0,0,0,0,0,0,0,0,0,80466
27943,1585,62,346,545,492,140,55,22,22,6,0,16,0,0,0,0,0,0,0,0,0,33,27,22,5,0,6,6,6,0,0,0,0,0,0,80467
27944,432,9,112,152,159,0,0,0,0,0,0,0,0,0,0,0,0,0,0,0,0,0,0,0,0,0,0,0,0,0,0,0,0,0,0,80468
27945,236,8,66,106,43,13,0,0,0,0,0,0,0,0,0,0,0,0,0,0,0,0,0,0,0,0,0,0,0,0,0,0,0,0,0,80469
27946,2900,70,559,1063,823,385,124,66,66,11,28,27,0,0,0,0,0,0,0,0,0,58,48,0,29,19,10,10,10,0,0,0,0,0,0,80470
27947,0,0,0,0,0,0,0,0,0,0,0,0,0,0,0,0,0,0,0,0,0,0,0,0,0,0,0,0,0,0,0,0,0,0,0,80471
27948,54,0,16,20,11,7,3,0,0,0,0,0,0,0,0,0,0,0,0,0,0,3,3,3,0,0,0,0,0,0,0,0,0,0,0,80473
27949,32,0,0,32,0,0,0,0,0,0,0,0,0,0,0,0,0,0,0,0,0,0,0,0,0,0,0,0,0,0,0,0,0,0,0,80475
27950,191,5,61,73,31,21,4,0,0,0,0,0,0,0,0,0,0,0,0,0,0,4,4,4,0,0,0,0,0,0,0,0,0,0,0,80476
27951,260,100,45,37,0,78,89,89,0,0,0,0,89,89,89,0,0,0,0,0,0,0,0,0,0,0,0,0,0,0,0,0,0,0,0,80477
27952,1121,0,302,336,423,60,72,17,6,6,0,0,11,11,11,0,0,0,0,0,0,55,0,0,0,0,55,55,55,0,0,0,0,0,0,80478
27953,28,0,0,28,0,0,0,0,0,0,0,0,0,0,0,0,0,0,0,0,0,0,0,0,0,0,0,0,0,0,0,0,0,0,0,80479
27954,942,116,347,268,159,52,47,22,17,0,0,17,5,5,5,0,0,0,0,0,0,25,24,3,0,21,1,1,1,0,0,0,0,0,0,80480
27955,684,3,16,335,161,169,15,11,11,0,0,11,0,0,0,0,0,0,0,0,0,4,4,0,4,0,0,0,0,0,0,0,0,0,0,80481
27956,958,54,144,230,401,129,27,0,0,0,0,0,0,0,0,0,0,0,0,0,0,27,27,0,0,27,0,0,0,0,0,0,0,0,0,80482
27957,423,36,140,137,51,59,38,8,4,0,0,4,4,0,0,0,0,4,0,0,4,30,30,5,0,25,0,0,0,0,0,0,0,0,0,80483
27958,11957,220,1731,3405,4634,1967,863,463,380,107,16,257,83,46,30,9,7,37,0,8,29,400,387,118,101,168,13,13,13,0,0,0,0,0,0,80487
27959,31,0,0,31,0,0,0,0,0,0,0,0,0,0,0,0,0,0,0,0,0,0,0,0,0,0,0,0,0,0,0,0,0,0,0,80488
27960,284,0,17,130,115,22,0,0,0,0,0,0,0,0,0,0,0,0,0,0,0,0,0,0,0,0,0,0,0,0,0,0,0,0,0,80497
27961,5271,131,765,1706,1811,858,147,94,94,22,0,72,0,0,0,0,0,0,0,0,0,53,41,24,0,17,12,12,12,0,0,0,0,0,0,80498
27962,26469,5115,6164,7937,4956,2297,2105,1110,944,455,69,420,166,140,83,51,6,26,5,14,7,995,807,409,84,314,188,176,106,19,51,12,0,12,0,80501
27963,21100,450,2519,5850,7041,5240,1825,958,865,206,72,587,93,56,37,19,0,37,0,0,37,867,816,382,62,372,51,51,51,0,0,0,0,0,0,80503
27964,31313,2736,6301,9923,8186,4167,2286,1423,1334,402,146,786,89,46,46,0,0,43,0,14,29,863,693,294,8,391,170,96,71,0,25,74,0,0,74,80504
27965,390,0,70,80,111,129,6,6,6,0,6,0,0,0,0,0,0,0,0,0,0,0,0,0,0,0,0,0,0,0,0,0,0,0,0,80510
27966,60,0,33,8,19,0,9,0,0,0,0,0,0,0,0,0,0,0,0,0,0,9,0,0,0,0,9,9,9,0,0,0,0,0,0,80511
27967,1489,56,313,444,386,290,123,33,33,0,22,11,0,0,0,0,0,0,0,0,0,90,90,0,20,70,0,0,0,0,0,0,0,0,0,80512
27968,7467,476,1539,2645,1648,1159,656,406,356,112,52,192,50,33,33,0,0,17,17,0,0,250,207,70,39,98,43,43,15,13,15,0,0,0,0,80513
27969,3013,659,1124,895,278,57,180,50,0,0,0,0,50,35,35,0,0,15,0,15,0,130,89,30,0,59,41,41,41,0,0,0,0,0,0,80514
27970,775,62,221,215,192,85,0,0,0,0,0,0,0,0,0,0,0,0,0,0,0,0,0,0,0,0,0,0,0,0,0,0,0,0,0,80515
27971,13962,292,1942,4244,4777,2707,902,437,365,102,28,235,72,45,33,0,12,27,27,0,0,465,465,177,9,279,0,0,0,0,0,0,0,0,0,80516
27972,7478,79,1379,2398,2121,1501,332,142,99,31,0,68,43,0,0,0,0,43,43,0,0,190,142,63,5,74,48,10,10,0,0,38,0,0,38,80517
27973,796,16,213,460,57,50,37,14,14,14,0,0,0,0,0,0,0,0,0,0,0,23,23,23,0,0,0,0,0,0,0,0,0,0,0,80520
27974,14609,724,2043,4432,4589,2821,6357,2692,2671,438,472,1761,21,21,0,0,21,0,0,0,0,3665,3634,1085,446,2103,31,11,11,0,0,20,0,0,20,80521
27975,21695,2122,4205,5971,5366,4031,1156,669,562,155,69,338,107,57,35,13,9,50,28,22,0,487,422,160,87,175,65,35,35,0,0,30,0,0,30,80524
27976,32330,1206,4427,9463,9997,7237,2372,1176,1089,288,160,641,87,31,24,0,7,56,0,0,56,1196,1029,532,139,358,167,108,90,10,8,59,5,0,54,80525
27977,27636,1243,3869,8780,8500,5244,2360,1368,1248,397,80,771,120,120,62,34,24,0,0,0,0,992,925,364,64,497,67,67,44,15,8,0,0,0,0,80526
27978,11646,384,1227,2967,4318,2750,971,458,458,145,19,294,0,0,0,0,0,0,0,0,0,513,500,233,24,243,13,0,0,0,0,13,0,0,13,80528
27979,2392,215,714,831,584,48,187,80,80,56,0,24,0,0,0,0,0,0,0,0,0,107,107,49,0,58,0,0,0,0,0,0,0,0,0,80530
27980,0,0,0,0,0,0,0,0,0,0,0,0,0,0,0,0,0,0,0,0,0,0,0,0,0,0,0,0,0,0,0,0,0,0,0,80532
27981,7742,573,2017,3188,1385,579,529,259,259,36,0,223,0,0,0,0,0,0,0,0,0,270,270,66,16,188,0,0,0,0,0,0,0,0,0,80534
27982,2123,179,450,918,296,280,158,100,82,36,0,46,18,18,0,10,8,0,0,0,0,58,51,5,0,46,7,7,0,7,0,0,0,0,0,80535
27983,1726,130,400,500,401,295,42,35,23,0,0,23,12,0,0,0,0,12,12,0,0,7,0,0,0,0,7,7,7,0,0,0,0,0,0,80536
27984,26984,2104,6907,9879,5430,2664,1686,721,504,138,35,331,217,101,84,17,0,116,74,22,20,965,882,267,89,526,83,42,42,0,0,41,0,0,41,80537
27985,31322,1916,7750,10765,7371,3520,2259,1296,1083,339,252,492,213,119,74,19,26,94,55,0,39,963,775,232,122,421,188,159,89,31,39,29,0,0,29,80538
27986,4025,29,693,1041,1296,966,243,133,129,78,27,24,4,4,4,0,0,0,0,0,0,110,110,45,0,65,0,0,0,0,0,0,0,0,0,80540
27987,2327,178,586,677,580,306,191,106,106,35,0,71,0,0,0,0,0,0,0,0,0,85,85,9,0,76,0,0,0,0,0,0,0,0,0,80542
27988,3742,792,1175,1127,444,204,132,87,87,21,0,66,0,0,0,0,0,0,0,0,0,45,45,0,0,45,0,0,0,0,0,0,0,0,0,80543
27989,0,0,0,0,0,0,0,0,0,0,0,0,0,0,0,0,0,0,0,0,0,0,0,0,0,0,0,0,0,0,0,0,0,0,0,80544
27990,589,40,186,144,153,66,19,0,0,0,0,0,0,0,0,0,0,0,0,0,0,19,19,19,0,0,0,0,0,0,0,0,0,0,0,80545
27991,38,14,0,24,0,0,0,0,0,0,0,0,0,0,0,0,0,0,0,0,0,0,0,0,0,0,0,0,0,0,0,0,0,0,0,80546
27992,577,12,53,228,219,65,30,16,16,9,2,5,0,0,0,0,0,0,0,0,0,14,14,9,0,5,0,0,0,0,0,0,0,0,0,80547
27993,5810,272,1461,2378,1247,452,558,322,280,139,15,126,42,10,10,0,0,32,0,32,0,236,225,122,0,103,11,11,11,0,0,0,0,0,0,80549
27994,14073,396,2751,5138,3746,2042,866,560,476,98,81,297,84,75,13,0,62,9,0,0,9,306,275,109,0,166,31,31,31,0,0,0,0,0,0,80550
27995,21514,4054,6687,7059,2631,1083,1901,884,642,210,37,395,242,142,70,0,72,100,13,43,44,1017,891,299,47,545,126,102,42,55,5,24,2,0,22,80601
27996,18297,815,3923,6432,4936,2191,1130,519,459,125,73,261,60,21,0,21,0,39,0,10,29,611,568,189,76,303,43,43,43,0,0,0,0,0,0,80602
27997,7289,943,2217,2499,1261,369,541,368,288,109,24,155,80,80,80,0,0,0,0,0,0,173,151,17,6,128,22,22,22,0,0,0,0,0,0,80603
27998,1853,151,587,667,287,161,125,82,78,0,17,61,4,4,4,0,0,0,0,0,0,43,26,8,0,18,17,17,17,0,0,0,0,0,0,80610
27999,474,43,114,223,66,28,106,72,72,8,11,53,0,0,0,0,0,0,0,0,0,34,34,22,0,12,0,0,0,0,0,0,0,0,0,80611
28000,321,64,139,62,50,6,28,28,28,0,0,28,0,0,0,0,0,0,0,0,0,0,0,0,0,0,0,0,0,0,0,0,0,0,0,80612
28001,5024,345,1492,1875,864,448,323,153,153,80,0,73,0,0,0,0,0,0,0,0,0,170,151,39,29,83,19,7,0,0,7,12,3,0,9,80615
28002,9574,2738,2480,3036,1021,299,1233,627,418,81,40,297,209,209,186,13,10,0,0,0,0,606,451,99,46,306,155,35,25,10,0,120,0,45,75,80620
28003,7571,1665,2612,2366,658,270,585,393,277,26,25,226,116,89,70,0,19,27,0,0,27,192,146,62,17,67,46,35,0,4,31,11,0,0,11,80621
28004,127,3,33,65,12,14,17,0,0,0,0,0,0,0,0,0,0,0,0,0,0,17,17,0,0,17,0,0,0,0,0,0,0,0,0,80622
28005,618,164,218,168,66,2,88,66,29,0,0,29,37,24,10,0,14,13,0,13,0,22,22,2,0,20,0,0,0,0,0,0,0,0,0,80623
28006,660,129,163,234,116,18,62,25,15,0,0,15,10,10,10,0,0,0,0,0,0,37,37,24,0,13,0,0,0,0,0,0,0,0,0,80624
28007,24868,6915,7137,6844,2561,1411,5754,2576,2183,508,218,1457,393,171,79,24,68,222,56,81,85,3178,2868,877,239,1752,310,226,158,15,53,84,0,18,66,80631
28008,35899,3628,8444,12588,7347,3892,2512,1219,1034,228,108,698,185,56,48,8,0,129,106,8,15,1293,1077,320,85,672,216,165,68,38,59,51,0,17,34,80634
28009,6676,1154,1492,2739,1074,217,623,338,213,28,16,169,125,86,86,0,0,39,0,39,0,285,258,113,74,71,27,27,10,17,0,0,0,0,0,80640
28010,3122,442,1186,866,481,147,177,97,88,41,8,39,9,6,6,0,0,3,0,0,3,80,73,21,0,52,7,7,7,0,0,0,0,0,0,80642
28011,2179,371,711,824,200,73,152,49,45,6,6,33,4,4,0,0,4,0,0,0,0,103,102,22,0,80,1,1,1,0,0,0,0,0,0,80643
28012,1878,324,660,504,285,105,161,116,116,15,3,98,0,0,0,0,0,0,0,0,0,45,22,3,5,14,23,23,17,0,6,0,0,0,0,80644
28013,3020,449,1047,1024,341,159,279,107,88,21,0,67,19,19,13,0,6,0,0,0,0,172,168,33,85,50,4,1,0,1,0,3,0,0,3,80645
28014,643,47,246,230,109,11,101,84,74,13,0,61,10,8,2,0,6,2,2,0,0,17,11,7,4,0,6,6,6,0,0,0,0,0,0,80648
28015,177,28,70,61,18,0,6,3,3,0,0,3,0,0,0,0,0,0,0,0,0,3,3,0,0,3,0,0,0,0,0,0,0,0,0,80649
28016,1072,164,391,372,81,64,114,73,47,25,9,13,26,10,10,0,0,16,0,16,0,41,41,12,22,7,0,0,0,0,0,0,0,0,0,80650
28017,2784,557,849,841,365,172,182,147,115,20,0,95,32,27,15,0,12,5,5,0,0,35,35,15,0,20,0,0,0,0,0,0,0,0,0,80651
28018,268,29,50,128,25,36,15,15,0,0,0,0,15,15,15,0,0,0,0,0,0,0,0,0,0,0,0,0,0,0,0,0,0,0,0,80652
28019,562,111,176,238,18,19,23,23,23,0,0,23,0,0,0,0,0,0,0,0,0,0,0,0,0,0,0,0,0,0,0,0,0,0,0,80653
28020,1624,297,511,604,157,55,128,102,69,12,0,57,33,10,7,1,2,23,0,0,23,26,23,4,0,19,3,3,3,0,0,0,0,0,0,80654
28021,9959,2266,2930,3227,879,657,963,496,463,187,48,228,33,20,20,0,0,13,13,0,0,467,383,87,12,284,84,46,0,0,46,38,22,0,16,80701
28022,544,191,167,152,27,7,34,20,17,14,0,3,3,3,3,0,0,0,0,0,0,14,1,1,0,0,13,13,2,8,3,0,0,0,0,80705
28023,2029,197,741,717,290,84,162,102,93,11,0,82,9,5,0,0,5,4,4,0,0,60,60,41,0,19,0,0,0,0,0,0,0,0,0,80720
28024,97,0,48,36,13,0,0,0,0,0,0,0,0,0,0,0,0,0,0,0,0,0,0,0,0,0,0,0,0,0,0,0,0,0,0,80721
28025,201,8,102,61,27,3,6,6,6,0,0,6,0,0,0,0,0,0,0,0,0,0,0,0,0,0,0,0,0,0,0,0,0,0,0,80722
28026,4663,856,1554,1443,600,210,398,110,110,69,0,41,0,0,0,0,0,0,0,0,0,288,272,34,7,231,16,9,9,0,0,7,0,7,0,80723
28027,349,42,151,125,22,9,59,59,59,11,0,48,0,0,0,0,0,0,0,0,0,0,0,0,0,0,0,0,0,0,0,0,0,0,0,80726
28028,192,38,69,79,6,0,22,19,19,3,0,16,0,0,0,0,0,0,0,0,0,3,0,0,0,0,3,0,0,0,0,3,0,0,3,80727
28029,718,17,232,350,92,27,37,11,10,6,0,4,1,0,0,0,0,1,0,0,1,26,22,3,0,19,4,4,4,0,0,0,0,0,0,80728
28030,377,47,73,134,74,49,4,0,0,0,0,0,0,0,0,0,0,0,0,0,0,4,4,1,3,0,0,0,0,0,0,0,0,0,0,80729
28031,1045,67,335,371,181,91,73,53,40,13,0,27,13,10,4,6,0,3,0,0,3,20,16,6,0,10,4,4,4,0,0,0,0,0,0,80731
28032,370,61,126,133,37,13,30,29,29,0,0,29,0,0,0,0,0,0,0,0,0,1,1,0,0,1,0,0,0,0,0,0,0,0,0,80733
28033,1884,348,677,620,179,60,152,83,49,0,0,49,34,14,9,0,5,20,20,0,0,69,61,14,0,47,8,8,8,0,0,0,0,0,0,80734
28034,293,47,66,124,47,9,13,13,13,13,0,0,0,0,0,0,0,0,0,0,0,0,0,0,0,0,0,0,0,0,0,0,0,0,0,80735
28035,446,13,181,126,115,11,27,6,6,0,0,6,0,0,0,0,0,0,0,0,0,21,21,0,0,21,0,0,0,0,0,0,0,0,0,80736
28036,1036,139,348,406,100,43,77,36,36,17,0,19,0,0,0,0,0,0,0,0,0,41,32,6,0,26,9,9,0,0,9,0,0,0,0,80737
28037,65,7,21,21,9,7,10,0,0,0,0,0,0,0,0,0,0,0,0,0,0,10,0,0,0,0,10,0,0,0,0,10,0,0,10,80740
28038,604,37,204,219,100,44,47,31,27,2,2,23,4,0,0,0,0,4,0,4,0,16,14,4,0,10,2,0,0,0,0,2,2,0,0,80741
28039,143,21,43,49,24,6,9,5,5,2,0,3,0,0,0,0,0,0,0,0,0,4,4,0,4,0,0,0,0,0,0,0,0,0,0,80742
28040,728,59,277,268,103,21,42,25,19,1,0,18,6,6,0,0,6,0,0,0,0,17,15,0,1,14,2,2,2,0,0,0,0,0,0,80743
28041,367,59,161,104,39,4,26,10,10,0,0,10,0,0,0,0,0,0,0,0,0,16,14,9,0,5,2,2,0,2,0,0,0,0,0,80744
28042,159,50,36,66,7,0,2,0,0,0,0,0,0,0,0,0,0,0,0,0,0,2,2,0,2,0,0,0,0,0,0,0,0,0,0,80745
28043,23,3,10,8,2,0,2,2,2,0,0,2,0,0,0,0,0,0,0,0,0,0,0,0,0,0,0,0,0,0,0,0,0,0,0,80746
28044,329,12,107,162,38,10,26,9,6,1,0,5,3,3,0,3,0,0,0,0,0,17,16,2,1,13,1,1,1,0,0,0,0,0,0,80747
28045,214,17,55,90,40,12,11,2,2,0,0,2,0,0,0,0,0,0,0,0,0,9,9,9,0,0,0,0,0,0,0,0,0,0,0,80749
28046,265,22,96,124,23,0,14,0,0,0,0,0,0,0,0,0,0,0,0,0,0,14,14,0,0,14,0,0,0,0,0,0,0,0,0,80750
28047,12049,1492,4142,4587,1027,801,1616,689,410,131,15,264,279,279,99,28,152,0,0,0,0,927,635,292,60,283,292,148,15,133,0,144,49,95,0,80751
28048,140,15,23,41,56,5,12,9,9,2,0,7,0,0,0,0,0,0,0,0,0,3,3,0,0,3,0,0,0,0,0,0,0,0,0,80754
28049,80,2,46,21,10,1,8,8,8,0,0,8,0,0,0,0,0,0,0,0,0,0,0,0,0,0,0,0,0,0,0,0,0,0,0,80755
28050,176,15,71,46,26,18,23,16,16,0,6,10,0,0,0,0,0,0,0,0,0,7,7,0,0,7,0,0,0,0,0,0,0,0,0,80757
28051,2340,216,840,930,274,80,261,115,86,21,0,65,29,8,8,0,0,21,0,21,0,146,146,75,0,71,0,0,0,0,0,0,0,0,0,80758
28052,3368,480,1071,1131,520,166,127,27,27,27,0,0,0,0,0,0,0,0,0,0,0,100,100,87,13,0,0,0,0,0,0,0,0,0,0,80759
28053,72,9,21,25,11,6,6,3,3,2,0,1,0,0,0,0,0,0,0,0,0,3,3,0,0,3,0,0,0,0,0,0,0,0,0,80801
28054,143,19,69,23,26,6,0,0,0,0,0,0,0,0,0,0,0,0,0,0,0,0,0,0,0,0,0,0,0,0,0,0,0,0,0,80802
28055,220,24,78,65,25,28,17,1,1,0,0,1,0,0,0,0,0,0,0,0,0,16,10,5,0,5,6,0,0,0,0,6,0,6,0,80804
28056,334,67,107,106,48,6,24,3,3,0,0,3,0,0,0,0,0,0,0,0,0,21,21,4,5,12,0,0,0,0,0,0,0,0,0,80805
28057,3688,602,1162,1448,304,172,137,44,44,35,0,9,0,0,0,0,0,0,0,0,0,93,75,75,0,0,18,18,18,0,0,0,0,0,0,80807
28058,4271,252,1570,1692,547,210,274,152,118,14,4,100,34,34,0,34,0,0,0,0,0,122,102,39,0,63,20,20,20,0,0,0,0,0,0,80808
28059,1262,40,352,445,234,191,69,25,25,13,0,12,0,0,0,0,0,0,0,0,0,44,23,0,0,23,21,21,21,0,0,0,0,0,0,80809
28060,877,131,257,307,125,57,39,11,8,5,0,3,3,3,3,0,0,0,0,0,0,28,24,9,0,15,4,4,4,0,0,0,0,0,0,80810
28061,127,10,46,51,12,8,11,6,6,0,0,6,0,0,0,0,0,0,0,0,0,5,5,0,0,5,0,0,0,0,0,0,0,0,0,80812
28062,1445,148,498,521,231,47,80,35,12,0,0,12,23,4,0,4,0,19,19,0,0,45,45,22,0,23,0,0,0,0,0,0,0,0,0,80813
28063,3014,84,759,1406,463,302,259,212,158,38,0,120,54,45,10,33,2,9,0,0,9,47,19,19,0,0,28,0,0,0,0,28,0,28,0,80814
28064,658,62,217,272,79,28,54,42,24,13,2,9,18,17,17,0,0,1,1,0,0,12,12,4,5,3,0,0,0,0,0,0,0,0,0,80815
28065,4136,318,1366,1460,548,444,180,71,34,0,0,34,37,37,8,29,0,0,0,0,0,109,71,15,9,47,38,38,16,0,22,0,0,0,0,80816
28066,16144,1080,4150,7221,2449,1244,1654,1182,943,210,44,689,239,192,47,64,81,47,47,0,0,472,427,112,13,302,45,45,0,21,24,0,0,0,0,80817
28067,212,18,54,91,40,9,8,7,7,2,0,5,0,0,0,0,0,0,0,0,0,1,1,1,0,0,0,0,0,0,0,0,0,0,0,80818
28068,507,0,65,257,97,88,50,33,22,0,3,19,11,0,0,0,0,11,0,0,11,17,17,6,0,11,0,0,0,0,0,0,0,0,0,80819
28069,601,0,118,128,146,209,8,0,0,0,0,0,0,0,0,0,0,0,0,0,0,8,8,0,0,8,0,0,0,0,0,0,0,0,0,80820
28070,734,86,283,238,117,10,8,6,3,2,1,0,3,1,0,1,0,2,1,0,1,2,2,1,0,1,0,0,0,0,0,0,0,0,0,80821
28071,201,9,78,73,24,17,31,24,24,23,0,1,0,0,0,0,0,0,0,0,0,7,7,0,0,7,0,0,0,0,0,0,0,0,0,80822
28072,142,7,61,51,21,2,23,6,6,0,0,6,0,0,0,0,0,0,0,0,0,17,16,0,0,16,1,1,1,0,0,0,0,0,0,80823
28073,158,18,62,51,12,15,5,0,0,0,0,0,0,0,0,0,0,0,0,0,0,5,5,0,0,5,0,0,0,0,0,0,0,0,0,80824
28074,389,32,115,166,70,6,50,19,19,8,0,11,0,0,0,0,0,0,0,0,0,31,31,7,0,24,0,0,0,0,0,0,0,0,0,80825
28075,551,73,122,193,57,106,27,0,0,0,0,0,0,0,0,0,0,0,0,0,0,27,27,0,0,27,0,0,0,0,0,0,0,0,0,80827
28076,2785,605,1140,606,334,100,138,94,87,19,39,29,7,2,2,0,0,5,0,0,5,44,44,17,0,27,0,0,0,0,0,0,0,0,0,80828
28077,4390,212,713,1276,1124,1065,220,139,81,29,0,52,58,58,0,13,45,0,0,0,0,81,70,8,0,62,11,0,0,0,0,11,11,0,0,80829
28078,151,6,67,42,33,3,0,0,0,0,0,0,0,0,0,0,0,0,0,0,0,0,0,0,0,0,0,0,0,0,0,0,0,0,0,80830
28079,14028,473,2756,5579,3332,1888,1447,984,949,214,146,589,35,0,0,0,0,35,16,0,19,463,379,131,39,209,84,41,24,17,0,43,20,23,0,80831
28080,376,26,123,143,51,33,13,3,2,0,0,2,1,0,0,0,0,1,0,0,1,10,10,0,0,10,0,0,0,0,0,0,0,0,0,80832
28081,385,64,184,105,15,17,3,1,1,1,0,0,0,0,0,0,0,0,0,0,0,2,2,0,0,2,0,0,0,0,0,0,0,0,0,80833
28082,194,22,79,75,13,5,37,23,23,9,8,6,0,0,0,0,0,0,0,0,0,14,14,1,0,13,0,0,0,0,0,0,0,0,0,80834
28083,557,48,200,168,93,48,53,23,23,0,0,23,0,0,0,0,0,0,0,0,0,30,30,3,0,27,0,0,0,0,0,0,0,0,0,80835
28084,783,144,291,256,53,39,101,87,82,46,7,29,5,3,0,1,2,2,0,0,2,14,14,0,0,14,0,0,0,0,0,0,0,0,0,80836
28085,869,14,48,606,106,95,1720,1346,1333,1316,0,17,13,13,13,0,0,0,0,0,0,374,367,341,0,26,7,7,7,0,0,0,0,0,0,80840
28086,451,28,181,153,74,15,44,20,20,20,0,0,0,0,0,0,0,0,0,0,0,24,24,5,0,19,0,0,0,0,0,0,0,0,0,80860
28087,181,23,57,58,34,9,19,2,2,2,0,0,0,0,0,0,0,0,0,0,0,17,17,4,0,13,0,0,0,0,0,0,0,0,0,80861
28088,41,10,11,12,5,3,3,0,0,0,0,0,0,0,0,0,0,0,0,0,0,3,3,0,0,3,0,0,0,0,0,0,0,0,0,80862
28089,8600,469,1627,3044,1830,1630,606,250,221,51,54,116,29,29,29,0,0,0,0,0,0,356,338,79,0,259,18,18,0,18,0,0,0,0,0,80863
28090,740,75,198,361,62,44,88,10,10,0,0,10,0,0,0,0,0,0,0,0,0,78,70,2,0,68,8,5,0,5,0,3,0,0,3,80864
28091,4442,206,1292,2214,486,244,749,534,374,319,0,55,160,151,134,0,17,9,0,0,9,215,187,44,0,143,28,28,16,0,12,0,0,0,0,80902
28092,9551,855,2123,3364,1740,1469,1853,785,672,73,39,560,113,79,44,14,21,34,0,11,23,1068,1050,271,61,718,18,17,0,0,17,1,0,0,1,80903
28093,15352,1034,3348,5212,3656,2102,702,261,182,55,34,93,79,26,26,0,0,53,53,0,0,441,279,133,41,105,162,162,130,14,18,0,0,0,0,80904
28094,11880,1383,2953,4315,2062,1167,752,406,310,23,0,287,96,87,85,0,2,9,0,0,9,346,257,12,23,222,89,89,32,6,51,0,0,0,0,80905
28095,24717,1415,4764,7719,5989,4830,1800,997,762,146,66,550,235,218,98,100,20,17,0,0,17,803,695,121,0,574,108,108,47,0,61,0,0,0,0,80906
28096,19107,1680,4491,6734,3923,2279,1111,581,383,63,108,212,198,83,10,41,32,115,31,62,22,530,422,92,62,268,108,101,52,21,28,7,0,0,7,80907
28097,9628,196,1678,2895,2983,1876,948,563,516,114,13,389,47,47,31,16,0,0,0,0,0,385,330,66,25,239,55,55,0,55,0,0,0,0,0,80908
28098,23640,2600,6560,9627,3262,1591,1554,880,795,347,95,353,85,26,25,0,1,59,12,28,19,674,545,134,67,344,129,126,75,22,29,3,3,0,0,80909
28099,17716,3317,5517,6521,1603,758,1755,821,637,267,49,321,184,83,83,0,0,101,12,56,33,934,731,103,127,501,203,100,61,12,27,103,0,57,46,80910
28100,19836,1574,5566,9139,2351,1206,1636,827,700,139,90,471,127,69,31,38,0,58,21,17,20,809,744,173,159,412,65,46,23,0,23,19,19,0,0,80911
28101,796,0,256,393,124,23,423,418,266,266,0,0,152,152,152,0,0,0,0,0,0,5,0,0,0,0,5,5,5,0,0,0,0,0,0,80913
28102,37,0,10,27,0,0,47,40,7,7,0,0,33,33,33,0,0,0,0,0,0,7,0,0,0,0,7,7,7,0,0,0,0,0,0,80914
28103,12627,857,3816,5282,1955,717,981,575,482,77,43,362,93,79,79,0,0,14,0,12,2,406,253,30,59,164,153,98,85,0,13,55,0,0,55,80915
28104,20347,2714,5656,8985,2102,890,2089,1055,827,100,73,654,228,93,47,35,11,135,102,16,17,1034,807,126,99,582,227,166,57,64,45,61,0,12,49,80916
28105,19554,1279,4851,6906,4384,2134,1638,972,754,350,52,352,218,130,106,24,0,88,66,12,10,666,605,208,34,363,61,17,7,10,0,44,0,44,0,80917
28106,30789,1515,6037,11995,7215,4027,3046,1372,1275,289,269,717,97,48,27,13,8,49,27,6,16,1674,1430,567,122,741,244,189,124,40,25,55,13,0,42,80918
28107,18726,186,1877,5361,6039,5263,1466,713,613,155,23,435,100,87,61,18,8,13,0,0,13,753,632,155,47,430,121,121,28,30,63,0,0,0,0,80919
28108,23887,352,3022,7816,7367,5330,2679,1378,1214,215,136,863,164,131,91,0,40,33,33,0,0,1301,1181,366,107,708,120,120,102,18,0,0,0,0,0,80920
28109,12192,295,1181,3247,3915,3554,1002,532,370,70,9,291,162,121,39,82,0,41,0,9,32,470,460,91,0,369,10,0,0,0,0,10,0,0,10,80921
28110,16409,422,3256,6824,3820,2087,1070,690,656,282,55,319,34,34,34,0,0,0,0,0,0,380,324,78,13,233,56,43,43,0,0,13,13,0,0,80922
28111,17068,586,2843,6002,5080,2557,1214,690,462,98,66,298,228,130,58,49,23,98,0,0,98,524,429,240,3,186,95,74,74,0,0,21,0,0,21,80923
28112,2802,29,304,734,988,747,193,97,86,28,0,58,11,0,0,0,0,11,11,0,0,96,84,14,14,56,12,12,12,0,0,0,0,0,0,80924
28113,4019,209,1049,1904,628,229,326,99,87,0,25,62,12,12,12,0,0,0,0,0,0,227,227,42,25,160,0,0,0,0,0,0,0,0,0,80925
28114,971,46,193,373,214,145,0,0,0,0,0,0,0,0,0,0,0,0,0,0,0,0,0,0,0,0,0,0,0,0,0,0,0,0,0,80926
28115,699,25,91,313,211,59,17,17,17,0,0,17,0,0,0,0,0,0,0,0,0,0,0,0,0,0,0,0,0,0,0,0,0,0,0,80927
28116,795,113,237,339,59,47,56,26,20,3,0,17,6,6,6,0,0,0,0,0,0,30,21,0,3,18,9,9,0,9,0,0,0,0,0,80928
28117,247,0,98,97,38,14,0,0,0,0,0,0,0,0,0,0,0,0,0,0,0,0,0,0,0,0,0,0,0,0,0,0,0,0,0,80929
28118,632,0,248,218,43,123,44,24,24,0,13,11,0,0,0,0,0,0,0,0,0,20,20,20,0,0,0,0,0,0,0,0,0,0,0,80930
28119,34,0,0,34,0,0,0,0,0,0,0,0,0,0,0,0,0,0,0,0,0,0,0,0,0,0,0,0,0,0,0,0,0,0,0,80938
28120,0,0,0,0,0,0,0,0,0,0,0,0,0,0,0,0,0,0,0,0,0,0,0,0,0,0,0,0,0,0,0,0,0,0,0,80939
28121,2274,110,404,997,573,190,109,76,69,0,11,58,7,0,0,0,0,7,7,0,0,33,33,0,0,33,0,0,0,0,0,0,0,0,0,80951
28122,18507,3312,5686,6204,1914,1391,1849,866,660,142,73,445,206,124,107,6,11,82,0,52,30,983,824,298,102,424,159,79,44,35,0,80,80,0,0,81001
28123,10600,2220,3354,3530,1116,380,845,502,329,25,37,267,173,57,13,44,0,116,7,43,66,343,277,99,73,105,66,35,16,11,8,31,0,0,31,81003
28124,16923,2791,5292,5946,1991,903,1322,647,562,76,155,331,85,52,18,31,3,33,11,22,0,675,458,112,57,289,217,51,0,10,41,166,50,62,54,81004
28125,20731,2024,5673,8166,2987,1881,1655,877,684,253,21,410,193,60,15,45,0,133,92,17,24,778,677,160,106,411,101,37,13,24,0,64,34,14,16,81005
28126,8151,835,2816,2764,1171,565,751,416,352,91,86,175,64,25,0,0,25,39,15,0,24,335,286,105,17,164,49,29,25,4,0,20,0,0,20,81006
28127,19386,1365,4884,7876,3215,2046,1558,735,667,159,81,427,68,47,23,10,14,21,0,21,0,823,757,220,50,487,66,33,33,0,0,33,0,8,25,81007
28128,7439,750,1621,2830,1561,677,381,158,113,41,33,39,45,45,30,15,0,0,0,0,0,223,193,40,0,153,30,23,23,0,0,7,7,0,0,81008
28129,1134,56,353,465,216,44,78,55,55,31,0,24,0,0,0,0,0,0,0,0,0,23,23,0,0,23,0,0,0,0,0,0,0,0,0,81019
28130,725,116,306,231,58,14,71,25,25,11,0,14,0,0,0,0,0,0,0,0,0,46,44,0,0,44,2,0,0,0,0,2,0,2,0,81020
28131,9,0,0,0,6,3,0,0,0,0,0,0,0,0,0,0,0,0,0,0,0,0,0,0,0,0,0,0,0,0,0,0,0,0,0,81021
28132,976,142,282,415,79,58,118,54,39,0,26,13,15,15,15,0,0,0,0,0,0,64,37,5,0,32,27,19,0,19,0,8,8,0,0,81022
28133,834,78,152,327,207,70,69,13,13,0,0,13,0,0,0,0,0,0,0,0,0,56,56,11,0,45,0,0,0,0,0,0,0,0,0,81023
28134,78,10,16,19,9,24,0,0,0,0,0,0,0,0,0,0,0,0,0,0,0,0,0,0,0,0,0,0,0,0,0,0,0,0,0,81024
28135,699,130,233,214,89,33,48,10,10,8,0,2,0,0,0,0,0,0,0,0,0,38,32,2,0,30,6,5,5,0,0,1,0,0,1,81025
28136,109,2,29,36,29,13,0,0,0,0,0,0,0,0,0,0,0,0,0,0,0,0,0,0,0,0,0,0,0,0,0,0,0,0,0,81027
28137,216,47,67,65,34,3,10,9,9,0,0,9,0,0,0,0,0,0,0,0,0,1,1,0,0,1,0,0,0,0,0,0,0,0,0,81029
28138,72,0,36,26,8,2,4,1,1,0,0,1,0,0,0,0,0,0,0,0,0,3,3,0,0,3,0,0,0,0,0,0,0,0,0,81030
28139,302,14,65,78,143,2,31,8,8,0,0,8,0,0,0,0,0,0,0,0,0,23,23,0,22,1,0,0,0,0,0,0,0,0,0,81033
28140,657,45,190,300,89,33,72,25,25,0,9,16,0,0,0,0,0,0,0,0,0,47,39,18,3,18,8,8,8,0,0,0,0,0,0,81036
28141,361,145,205,0,11,0,0,0,0,0,0,0,0,0,0,0,0,0,0,0,0,0,0,0,0,0,0,0,0,0,0,0,0,0,0,81038
28142,1156,131,446,392,128,59,76,60,60,0,10,50,0,0,0,0,0,0,0,0,0,16,16,3,3,10,0,0,0,0,0,0,0,0,0,81039
28143,498,48,115,170,116,49,52,12,12,12,0,0,0,0,0,0,0,0,0,0,0,40,40,0,0,40,0,0,0,0,0,0,0,0,0,81040
28144,446,195,123,94,29,5,68,44,31,2,0,29,13,13,13,0,0,0,0,0,0,24,23,4,3,16,1,0,0,0,0,1,1,0,0,81041
28145,42,11,8,23,0,0,0,0,0,0,0,0,0,0,0,0,0,0,0,0,0,0,0,0,0,0,0,0,0,0,0,0,0,0,0,81043
28146,285,21,129,110,9,16,13,1,1,0,0,1,0,0,0,0,0,0,0,0,0,12,12,0,3,9,0,0,0,0,0,0,0,0,0,81044
28147,52,9,23,20,0,0,3,3,1,1,0,0,2,2,2,0,0,0,0,0,0,0,0,0,0,0,0,0,0,0,0,0,0,0,0,81045
28148,1096,240,295,390,128,43,77,46,24,8,0,16,22,22,0,20,2,0,0,0,0,31,25,10,0,15,6,0,0,0,0,6,0,0,6,81047
28149,251,27,83,108,26,7,38,36,36,17,0,19,0,0,0,0,0,0,0,0,0,2,2,0,0,2,0,0,0,0,0,0,0,0,0,81049
28150,6706,1011,2012,2664,736,283,714,396,376,40,57,279,20,12,5,1,6,8,0,0,8,318,298,120,13,165,20,5,5,0,0,15,0,15,0,81050
28151,5806,1115,1689,2199,493,310,639,336,270,33,22,215,66,40,0,26,14,26,17,0,9,303,268,109,34,125,35,7,0,7,0,28,28,0,0,81052
28152,3751,751,1584,1082,233,101,121,70,41,6,0,35,29,14,9,5,0,15,10,0,5,51,47,13,0,34,4,0,0,0,0,4,0,0,4,81054
28153,1165,69,212,364,298,222,27,9,9,4,0,5,0,0,0,0,0,0,0,0,0,18,0,0,0,0,18,0,0,0,0,18,0,0,18,81055
28154,249,65,65,94,18,7,25,15,15,4,0,11,0,0,0,0,0,0,0,0,0,10,10,0,0,10,0,0,0,0,0,0,0,0,0,81057
28155,715,192,256,205,35,27,64,29,23,13,0,10,6,3,0,2,1,3,3,0,0,35,30,0,0,30,5,5,5,0,0,0,0,0,0,81058
28156,291,88,123,72,4,4,17,0,0,0,0,0,0,0,0,0,0,0,0,0,0,17,17,0,0,17,0,0,0,0,0,0,0,0,0,81059
28157,1379,398,568,341,61,11,154,48,48,0,22,26,0,0,0,0,0,0,0,0,0,106,39,11,0,28,67,50,0,0,50,17,0,0,17,81062
28158,1714,438,502,561,142,71,138,43,43,0,19,24,0,0,0,0,0,0,0,0,0,95,92,32,3,57,3,0,0,0,0,3,3,0,0,81063
28159,212,11,86,88,22,5,18,10,10,10,0,0,0,0,0,0,0,0,0,0,0,8,8,0,0,8,0,0,0,0,0,0,0,0,0,81064
28160,4005,874,1104,1360,483,184,275,173,156,8,52,96,17,1,0,0,1,16,1,15,0,102,64,8,0,56,38,38,0,0,38,0,0,0,0,81067
28161,1240,124,369,381,156,210,86,86,86,16,40,30,0,0,0,0,0,0,0,0,0,0,0,0,0,0,0,0,0,0,0,0,0,0,0,81069
28162,189,17,43,73,43,13,18,11,11,2,0,9,0,0,0,0,0,0,0,0,0,7,7,2,0,5,0,0,0,0,0,0,0,0,0,81071
28163,1380,150,466,508,168,88,68,43,38,14,0,24,5,5,3,0,2,0,0,0,0,25,25,17,0,8,0,0,0,0,0,0,0,0,0,81073
28164,386,65,152,112,48,9,93,8,8,1,6,1,0,0,0,0,0,0,0,0,0,85,43,0,6,37,42,42,42,0,0,0,0,0,0,81076
28165,290,10,80,162,30,8,19,6,6,6,0,0,0,0,0,0,0,0,0,0,0,13,10,5,0,5,3,3,3,0,0,0,0,0,0,81077
28166,48,0,21,7,15,5,0,0,0,0,0,0,0,0,0,0,0,0,0,0,0,0,0,0,0,0,0,0,0,0,0,0,0,0,0,81081
28167,8502,1362,2509,3215,911,505,685,336,281,77,6,198,55,49,14,0,35,6,0,0,6,349,300,108,11,181,49,49,10,30,9,0,0,0,0,81082
28168,92,13,29,43,6,1,3,0,0,0,0,0,0,0,0,0,0,0,0,0,0,3,3,0,0,3,0,0,0,0,0,0,0,0,0,81084
28169,104,23,13,55,12,1,0,0,0,0,0,0,0,0,0,0,0,0,0,0,0,0,0,0,0,0,0,0,0,0,0,0,0,0,0,81087
28170,3185,598,998,977,353,259,120,50,50,0,7,43,0,0,0,0,0,0,0,0,0,70,27,4,5,18,43,8,0,8,0,35,35,0,0,81089
28171,772,110,232,291,102,37,67,35,28,19,0,9,7,0,0,0,0,7,7,0,0,32,17,11,0,6,15,9,9,0,0,6,0,0,6,81090
28172,664,72,152,333,71,36,32,13,13,0,0,13,0,0,0,0,0,0,0,0,0,19,19,5,0,14,0,0,0,0,0,0,0,0,0,81091
28173,578,69,170,213,88,38,48,27,27,21,0,6,0,0,0,0,0,0,0,0,0,21,21,10,7,4,0,0,0,0,0,0,0,0,0,81092
28174,8716,1373,2398,2868,987,1090,1435,743,682,147,53,482,61,35,0,32,3,26,4,2,20,692,645,248,83,314,47,41,15,26,0,6,0,6,0,81101
28175,1416,252,546,397,167,54,58,32,32,0,0,32,0,0,0,0,0,0,0,0,0,26,19,6,0,13,7,7,0,0,7,0,0,0,0,81120
28176,191,12,66,55,44,14,0,0,0,0,0,0,0,0,0,0,0,0,0,0,0,0,0,0,0,0,0,0,0,0,0,0,0,0,0,81121
28177,5513,202,1428,2123,1101,659,282,119,112,11,6,95,7,7,0,0,7,0,0,0,0,163,134,42,12,80,29,19,0,0,19,10,0,0,10,81122
28178,663,121,216,175,82,69,85,46,40,0,0,40,6,0,0,0,0,6,6,0,0,39,39,17,0,22,0,0,0,0,0,0,0,0,0,81123
28179,45,14,13,5,13,0,0,0,0,0,0,0,0,0,0,0,0,0,0,0,0,0,0,0,0,0,0,0,0,0,0,0,0,0,0,81124
28180,1965,729,474,481,192,89,211,113,82,20,4,58,31,23,16,0,7,8,8,0,0,98,83,7,7,69,15,15,9,6,0,0,0,0,0,81125
28181,149,83,42,24,0,0,12,12,12,12,0,0,0,0,0,0,0,0,0,0,0,0,0,0,0,0,0,0,0,0,0,0,0,0,0,81126
28182,63,9,39,4,4,7,0,0,0,0,0,0,0,0,0,0,0,0,0,0,0,0,0,0,0,0,0,0,0,0,0,0,0,0,0,81128
28183,173,12,85,50,26,0,0,0,0,0,0,0,0,0,0,0,0,0,0,0,0,0,0,0,0,0,0,0,0,0,0,0,0,0,0,81129
28184,682,24,163,216,173,106,6,6,4,2,0,2,2,2,0,0,2,0,0,0,0,0,0,0,0,0,0,0,0,0,0,0,0,0,0,81130
28185,940,32,130,267,310,201,24,17,17,3,5,9,0,0,0,0,0,0,0,0,0,7,7,0,0,7,0,0,0,0,0,0,0,0,0,81131
28186,2073,339,664,654,338,78,201,119,104,0,3,101,15,0,0,0,0,15,15,0,0,82,79,4,0,75,3,3,0,0,3,0,0,0,0,81132
28187,676,148,138,265,59,66,86,59,59,45,0,14,0,0,0,0,0,0,0,0,0,27,0,0,0,0,27,24,0,24,0,3,0,3,0,81133
28188,150,3,60,52,21,14,13,4,4,0,0,4,0,0,0,0,0,0,0,0,0,9,9,0,0,9,0,0,0,0,0,0,0,0,0,81136
28189,3644,381,1166,1401,500,196,339,208,167,25,6,136,41,22,11,11,0,19,4,2,13,131,81,22,8,51,50,43,0,4,39,7,7,0,0,81137
28190,32,0,0,15,17,0,0,0,0,0,0,0,0,0,0,0,0,0,0,0,0,0,0,0,0,0,0,0,0,0,0,0,0,0,0,81138
28191,1574,321,452,458,186,157,187,107,69,19,0,50,38,29,14,15,0,9,0,9,0,80,71,5,7,59,9,9,0,9,0,0,0,0,0,81140
28192,847,87,346,248,122,44,132,72,52,17,19,16,20,14,0,3,11,6,0,0,6,60,60,21,0,39,0,0,0,0,0,0,0,0,0,81141
28193,415,50,123,149,71,22,40,17,7,0,0,7,10,0,0,0,0,10,0,0,10,23,23,17,0,6,0,0,0,0,0,0,0,0,0,81143
28194,4892,896,1535,1611,584,266,345,193,128,43,0,85,65,52,52,0,0,13,13,0,0,152,132,22,6,104,20,8,0,0,8,12,0,0,12,81144
28195,464,37,105,169,95,58,59,29,19,15,0,4,10,0,0,0,0,10,10,0,0,30,30,0,0,30,0,0,0,0,0,0,0,0,0,81146
28196,8412,707,2430,2465,1799,1011,633,305,256,97,0,159,49,49,12,22,15,0,0,0,0,328,305,186,27,92,23,23,20,0,3,0,0,0,0,81147
28197,233,117,75,24,11,6,57,47,39,14,4,21,8,0,0,0,0,8,6,0,2,10,10,0,0,10,0,0,0,0,0,0,0,0,0,81148
28198,747,113,219,276,76,63,74,48,37,4,0,33,11,11,11,0,0,0,0,0,0,26,26,23,0,3,0,0,0,0,0,0,0,0,0,81149
28199,939,110,312,289,179,49,50,9,9,0,0,9,0,0,0,0,0,0,0,0,0,41,41,0,7,34,0,0,0,0,0,0,0,0,0,81151
28200,959,246,316,225,60,112,39,11,11,0,0,11,0,0,0,0,0,0,0,0,0,28,0,0,0,0,28,0,0,0,0,28,0,0,28,81152
28201,977,39,285,342,138,173,102,30,12,0,6,6,18,18,18,0,0,0,0,0,0,72,30,0,0,30,42,42,42,0,0,0,0,0,0,81154
28202,308,22,117,93,40,36,0,0,0,0,0,0,0,0,0,0,0,0,0,0,0,0,0,0,0,0,0,0,0,0,0,0,0,0,0,81155
28203,6826,533,1718,2246,1638,691,368,180,118,47,0,71,62,36,17,0,19,26,0,0,26,188,188,19,0,169,0,0,0,0,0,0,0,0,0,81201
28204,245,0,0,137,84,24,0,0,0,0,0,0,0,0,0,0,0,0,0,0,0,0,0,0,0,0,0,0,0,0,0,0,0,0,0,81210
28205,5728,607,1814,1360,1101,846,138,99,99,56,17,26,0,0,0,0,0,0,0,0,0,39,13,0,0,13,26,26,0,0,26,0,0,0,0,81211
28206,22857,4209,8156,6810,2305,1377,912,484,355,57,72,226,129,39,18,16,5,90,37,0,53,428,408,168,63,177,20,20,10,0,10,0,0,0,0,81212
28207,89,10,16,28,31,4,0,0,0,0,0,0,0,0,0,0,0,0,0,0,0,0,0,0,0,0,0,0,0,0,0,0,0,0,0,81220
28208,207,25,96,63,23,0,6,4,4,0,0,4,0,0,0,0,0,0,0,0,0,2,2,0,0,2,0,0,0,0,0,0,0,0,0,81221
28209,259,0,59,162,27,11,34,13,13,11,0,2,0,0,0,0,0,0,0,0,0,21,21,0,0,21,0,0,0,0,0,0,0,0,0,81222
28210,1215,89,406,422,236,62,86,38,38,0,0,38,0,0,0,0,0,0,0,0,0,48,24,0,0,24,24,24,0,0,24,0,0,0,0,81223
28211,2607,39,206,591,1466,305,176,89,89,13,4,72,0,0,0,0,0,0,0,0,0,87,48,43,0,5,39,39,39,0,0,0,0,0,0,81224
28212,618,10,42,94,369,103,11,1,1,1,0,0,0,0,0,0,0,0,0,0,0,10,10,0,0,10,0,0,0,0,0,0,0,0,0,81225
28213,7229,986,2965,2602,434,242,411,214,123,23,24,76,91,45,39,6,0,46,15,0,31,197,184,78,36,70,13,13,5,8,0,0,0,0,0,81226
28214,0,0,0,0,0,0,0,0,0,0,0,0,0,0,0,0,0,0,0,0,0,0,0,0,0,0,0,0,0,0,0,0,0,0,0,81227
28215,5493,538,1132,1290,1764,769,632,208,167,54,45,68,41,24,24,0,0,17,0,0,17,424,314,159,0,155,110,14,14,0,0,96,33,20,43,81230
28216,0,0,0,0,0,0,510,315,315,90,35,190,0,0,0,0,0,0,0,0,0,195,195,49,49,97,0,0,0,0,0,0,0,0,0,81231
28217,12,0,8,4,0,0,8,8,8,0,8,0,0,0,0,0,0,0,0,0,0,0,0,0,0,0,0,0,0,0,0,0,0,0,0,81232
28218,896,81,239,245,204,127,7,7,0,0,0,0,7,7,7,0,0,0,0,0,0,0,0,0,0,0,0,0,0,0,0,0,0,0,0,81233
28219,599,43,102,212,145,97,23,9,9,0,4,5,0,0,0,0,0,0,0,0,0,14,14,4,0,10,0,0,0,0,0,0,0,0,0,81235
28220,863,10,242,308,212,91,10,0,0,0,0,0,0,0,0,0,0,0,0,0,0,10,10,10,0,0,0,0,0,0,0,0,0,0,0,81236
28221,88,0,7,0,56,25,0,0,0,0,0,0,0,0,0,0,0,0,0,0,0,0,0,0,0,0,0,0,0,0,0,0,0,0,0,81237
28222,9,0,0,9,0,0,0,0,0,0,0,0,0,0,0,0,0,0,0,0,0,0,0,0,0,0,0,0,0,0,0,0,0,0,0,81239
28223,2905,267,1135,1001,363,139,168,130,130,7,12,111,0,0,0,0,0,0,0,0,0,38,27,19,0,8,11,11,11,0,0,0,0,0,0,81240
28224,40,5,9,9,10,7,0,0,0,0,0,0,0,0,0,0,0,0,0,0,0,0,0,0,0,0,0,0,0,0,0,0,0,0,0,81241
28225,661,97,176,198,132,58,93,32,17,0,0,17,15,15,15,0,0,0,0,0,0,61,31,0,0,31,30,15,15,0,0,15,0,15,0,81242
28226,69,0,6,32,27,4,0,0,0,0,0,0,0,0,0,0,0,0,0,0,0,0,0,0,0,0,0,0,0,0,0,0,0,0,0,81243
28227,215,48,69,59,28,11,14,6,0,0,0,0,6,6,6,0,0,0,0,0,0,8,8,8,0,0,0,0,0,0,0,0,0,0,0,81244
28228,75,0,32,43,0,0,0,0,0,0,0,0,0,0,0,0,0,0,0,0,0,0,0,0,0,0,0,0,0,0,0,0,0,0,0,81248
28229,88,0,30,24,23,11,12,5,5,0,0,5,0,0,0,0,0,0,0,0,0,7,7,7,0,0,0,0,0,0,0,0,0,0,0,81251
28230,2930,172,762,1005,652,339,182,99,85,56,0,29,14,1,0,0,1,13,0,13,0,83,64,16,0,48,19,7,0,0,7,12,0,0,12,81252
28231,446,19,134,185,46,62,16,8,8,0,0,8,0,0,0,0,0,0,0,0,0,8,8,0,0,8,0,0,0,0,0,0,0,0,0,81253
28232,19764,949,2720,6277,6028,3790,2163,1173,1010,273,110,627,163,118,29,16,73,45,32,13,0,990,942,317,27,598,48,48,44,4,0,0,0,0,0,81301
28233,5489,444,1203,1814,1247,781,361,234,149,28,21,100,85,36,36,0,0,49,48,0,1,127,82,34,11,37,45,8,8,0,0,37,0,19,18,81303
28234,214,26,83,69,15,21,0,0,0,0,0,0,0,0,0,0,0,0,0,0,0,0,0,0,0,0,0,0,0,0,0,0,0,0,0,81320
28235,9653,1060,2809,3501,1325,958,789,476,319,141,10,168,157,85,85,0,0,72,0,72,0,313,252,66,45,141,61,61,35,0,26,0,0,0,0,81321
28236,3584,334,1228,994,632,396,272,134,122,74,0,48,12,12,0,0,12,0,0,0,0,138,109,62,13,34,29,23,23,0,0,6,0,0,6,81323
28237,889,115,352,288,98,36,28,15,15,0,0,15,0,0,0,0,0,0,0,0,0,13,13,0,0,13,0,0,0,0,0,0,0,0,0,81324
28238,80,21,14,45,0,0,4,4,0,0,0,0,4,4,0,4,0,0,0,0,0,0,0,0,0,0,0,0,0,0,0,0,0,0,0,81325
28239,1564,100,467,482,359,156,150,72,52,2,0,50,20,17,14,3,0,3,3,0,0,78,62,19,0,43,16,13,13,0,0,3,0,0,3,81326
28240,524,35,154,217,60,58,47,41,22,0,0,22,19,19,0,19,0,0,0,0,0,6,6,0,0,6,0,0,0,0,0,0,0,0,0,81327
28241,3070,208,534,971,750,607,125,90,90,16,0,74,0,0,0,0,0,0,0,0,0,35,24,11,0,13,11,0,0,0,0,11,0,0,11,81328
28242,8,0,0,0,0,8,0,0,0,0,0,0,0,0,0,0,0,0,0,0,0,0,0,0,0,0,0,0,0,0,0,0,0,0,0,81330
28243,216,0,131,36,39,10,0,0,0,0,0,0,0,0,0,0,0,0,0,0,0,0,0,0,0,0,0,0,0,0,0,0,0,0,0,81331
28244,156,4,28,49,55,20,12,7,0,0,0,0,7,0,0,0,0,7,7,0,0,5,5,0,0,5,0,0,0,0,0,0,0,0,0,81332
28245,743,163,334,212,28,6,126,67,62,17,0,45,5,5,5,0,0,0,0,0,0,59,55,0,0,55,4,4,0,0,4,0,0,0,0,81334
28246,97,0,0,85,12,0,0,0,0,0,0,0,0,0,0,0,0,0,0,0,0,0,0,0,0,0,0,0,0,0,0,0,0,0,0,81335
28247,15823,2119,4806,4704,2503,1691,854,474,439,112,62,265,35,35,35,0,0,0,0,0,0,380,320,174,49,97,60,45,6,8,31,15,15,0,0,81401
28248,7859,987,2239,2365,1432,836,740,265,245,119,0,126,20,20,0,20,0,0,0,0,0,475,448,102,45,301,27,8,8,0,0,19,0,0,19,81403
28249,1338,200,583,463,59,33,48,42,26,0,0,26,16,16,9,0,7,0,0,0,0,6,0,0,0,0,6,6,6,0,0,0,0,0,0,81410
28250,6,0,0,0,6,0,0,0,0,0,0,0,0,0,0,0,0,0,0,0,0,0,0,0,0,0,0,0,0,0,0,0,0,0,0,81411
28251,4056,185,1458,1465,565,383,188,113,98,20,0,78,15,7,7,0,0,8,0,8,0,75,67,23,16,28,8,8,0,0,8,0,0,0,0,81413
28252,1062,65,554,298,101,44,42,39,39,0,16,23,0,0,0,0,0,0,0,0,0,3,3,0,0,3,0,0,0,0,0,0,0,0,0,81415
28253,9256,1546,3392,2767,1063,488,733,393,278,129,0,149,115,108,108,0,0,7,0,0,7,340,207,60,18,129,133,133,63,47,23,0,0,0,0,81416
28254,1262,145,464,444,176,33,89,73,73,0,0,73,0,0,0,0,0,0,0,0,0,16,16,0,0,16,0,0,0,0,0,0,0,0,0,81418
28255,2828,337,970,1053,327,141,174,62,36,3,16,17,26,23,0,20,3,3,3,0,0,112,96,4,3,89,16,16,16,0,0,0,0,0,0,81419
28256,371,61,143,131,27,9,44,34,26,26,0,0,8,8,8,0,0,0,0,0,0,10,7,7,0,0,3,3,3,0,0,0,0,0,0,81422
28257,1242,87,416,365,227,147,16,13,13,6,0,7,0,0,0,0,0,0,0,0,0,3,3,0,0,3,0,0,0,0,0,0,0,0,0,81423
28258,760,109,325,225,54,47,70,41,41,0,13,28,0,0,0,0,0,0,0,0,0,29,18,0,0,18,11,11,0,4,7,0,0,0,0,81424
28259,3395,758,1223,985,257,172,338,279,224,0,9,215,55,45,30,0,15,10,10,0,0,59,43,5,0,38,16,0,0,0,0,16,16,0,0,81425
28260,90,0,16,25,43,6,0,0,0,0,0,0,0,0,0,0,0,0,0,0,0,0,0,0,0,0,0,0,0,0,0,0,0,0,0,81426
28261,669,21,119,179,238,112,50,45,45,14,11,20,0,0,0,0,0,0,0,0,0,5,5,0,0,5,0,0,0,0,0,0,0,0,0,81427
28262,2755,254,866,965,431,239,213,95,77,13,0,64,18,18,11,0,7,0,0,0,0,118,113,11,10,92,5,5,0,0,5,0,0,0,0,81428
28263,97,0,29,48,10,10,0,0,0,0,0,0,0,0,0,0,0,0,0,0,0,0,0,0,0,0,0,0,0,0,0,0,0,0,0,81429
28264,458,6,34,88,222,108,24,12,12,0,0,12,0,0,0,0,0,0,0,0,0,12,12,0,0,12,0,0,0,0,0,0,0,0,0,81430
28265,314,17,139,59,64,35,53,25,25,0,0,25,0,0,0,0,0,0,0,0,0,28,21,6,0,15,7,7,7,0,0,0,0,0,0,81431
28266,2141,30,457,581,668,405,130,106,90,0,13,77,16,16,16,0,0,0,0,0,0,24,24,5,0,19,0,0,0,0,0,0,0,0,0,81432
28267,476,28,146,187,87,28,10,10,6,0,0,6,4,4,0,4,0,0,0,0,0,0,0,0,0,0,0,0,0,0,0,0,0,0,0,81433
28268,103,24,13,38,10,18,52,30,30,10,0,20,0,0,0,0,0,0,0,0,0,22,22,0,0,22,0,0,0,0,0,0,0,0,0,81434
28269,3703,96,550,804,1710,543,158,112,40,32,0,8,72,64,64,0,0,8,0,0,8,46,46,33,0,13,0,0,0,0,0,0,0,0,0,81435
28270,14429,1974,3890,5035,2286,1244,2318,1181,1053,343,49,661,128,62,41,0,21,66,13,45,8,1137,1008,329,110,569,129,88,52,7,29,41,0,0,41,81501
28271,9743,1138,3555,3129,1370,551,712,338,229,53,17,159,109,88,41,47,0,21,0,21,0,374,322,193,18,111,52,34,34,0,0,18,7,0,11,81503
28272,19422,2123,6839,7193,2536,731,1328,584,409,260,12,137,175,150,40,0,110,25,0,25,0,744,654,259,25,370,90,62,0,38,24,28,0,16,12,81504
28273,6156,478,1611,1779,1474,814,407,284,221,26,31,164,63,38,38,0,0,25,0,0,25,123,106,26,12,68,17,17,17,0,0,0,0,0,0,81505
28274,7996,282,1838,2477,1986,1413,287,130,129,32,17,80,1,1,1,0,0,0,0,0,0,157,157,16,0,141,0,0,0,0,0,0,0,0,0,81506
28275,11272,523,2583,3496,2962,1708,766,435,361,66,27,268,74,28,15,13,0,46,0,0,46,331,277,169,0,108,54,37,37,0,0,17,0,0,17,81507
28276,8901,1656,3349,2858,764,274,555,253,150,10,38,102,103,50,22,28,0,53,53,0,0,302,191,26,0,165,111,70,40,16,14,41,41,0,0,81520
28277,9960,1140,2502,3625,1636,1057,927,462,350,103,77,170,112,87,87,0,0,25,0,0,25,465,432,117,99,216,33,0,0,0,0,33,0,0,33,81521
28278,0,0,0,0,0,0,0,0,0,0,0,0,0,0,0,0,0,0,0,0,0,0,0,0,0,0,0,0,0,0,0,0,0,0,0,81522
28279,794,0,259,275,134,126,11,0,0,0,0,0,0,0,0,0,0,0,0,0,0,11,11,0,0,11,0,0,0,0,0,0,0,0,0,81523
28280,1457,139,392,629,190,107,189,164,98,29,0,69,66,66,66,0,0,0,0,0,0,25,11,0,0,11,14,0,0,0,0,14,0,0,14,81524
28281,608,46,155,267,90,50,50,37,16,0,0,16,21,0,0,0,0,21,0,0,21,13,13,0,0,13,0,0,0,0,0,0,0,0,0,81525
28282,4047,313,1202,1475,714,343,231,120,84,10,0,74,36,29,29,0,0,7,0,0,7,111,109,31,0,78,2,2,2,0,0,0,0,0,0,81526
28283,1394,148,469,445,247,85,45,10,8,0,0,8,2,2,0,0,2,0,0,0,0,35,28,0,0,28,7,7,7,0,0,0,0,0,0,81527
28284,10755,1446,2467,3151,2544,1147,766,419,320,114,23,183,99,54,43,0,11,45,28,17,0,347,323,127,38,158,24,24,10,14,0,0,0,0,0,81601
28285,308,45,92,134,29,8,6,2,2,2,0,0,0,0,0,0,0,0,0,0,0,4,0,0,0,0,4,0,0,0,0,4,4,0,0,81610
28286,7747,190,570,2082,3374,1531,305,210,202,35,0,167,8,0,0,0,0,8,0,1,7,95,89,54,0,35,6,0,0,0,0,6,0,6,0,81611
28287,0,0,0,0,0,0,0,0,0,0,0,0,0,0,0,0,0,0,0,0,0,0,0,0,0,0,0,0,0,0,0,0,0,0,0,81612
28288,2083,30,360,491,878,324,139,104,104,0,0,104,0,0,0,0,0,0,0,0,0,35,35,17,0,18,0,0,0,0,0,0,0,0,0,81615
28289,7020,846,1213,1377,2872,712,427,265,195,54,0,141,70,13,13,0,0,57,38,0,19,162,82,46,0,36,80,39,0,0,39,41,0,41,0,81620
28290,4615,577,712,1151,1670,505,368,132,103,0,0,103,29,16,16,0,0,13,0,13,0,236,211,14,29,168,25,25,25,0,0,0,0,0,0,81621
28291,9978,1540,1686,2629,2851,1272,909,392,286,104,27,155,106,67,67,0,0,39,30,9,0,517,517,46,79,392,0,0,0,0,0,0,0,0,0,81623
28292,1008,112,375,317,132,72,127,66,39,33,0,6,27,27,12,0,15,0,0,0,0,61,61,47,0,14,0,0,0,0,0,0,0,0,0,81624
28293,8046,853,3046,2850,921,376,775,381,313,107,31,175,68,67,54,0,13,1,0,0,1,394,258,57,15,186,136,94,61,15,18,42,42,0,0,81625
28294,546,84,241,151,34,36,37,26,11,6,0,5,15,6,6,0,0,9,0,7,2,11,5,0,0,5,6,0,0,0,0,6,0,0,6,81630
28295,5623,372,852,1748,2205,446,215,177,177,77,0,100,0,0,0,0,0,0,0,0,0,38,38,38,0,0,0,0,0,0,0,0,0,0,0,81631
28296,6080,553,1257,1084,2111,1075,585,284,169,52,0,117,115,99,98,0,1,16,0,0,16,301,301,95,0,206,0,0,0,0,0,0,0,0,0,81632
28297,0,0,0,0,0,0,0,0,0,0,0,0,0,0,0,0,0,0,0,0,0,0,0,0,0,0,0,0,0,0,0,0,0,0,0,81633
28298,4221,535,1300,1571,598,217,538,262,262,43,30,189,0,0,0,0,0,0,0,0,0,276,249,79,12,158,27,27,27,0,0,0,0,0,0,81635
28299,4935,1047,1145,1314,1035,394,583,328,328,81,90,157,0,0,0,0,0,0,0,0,0,255,193,0,0,193,62,0,0,0,0,62,0,62,0,81637
28300,119,5,58,52,4,0,0,0,0,0,0,0,0,0,0,0,0,0,0,0,0,0,0,0,0,0,0,0,0,0,0,0,0,0,0,81638
28301,1644,83,701,525,283,52,135,78,73,37,0,36,5,5,5,0,0,0,0,0,0,57,47,9,9,29,10,10,10,0,0,0,0,0,0,81639
28302,171,28,60,73,10,0,14,14,14,0,0,14,0,0,0,0,0,0,0,0,0,0,0,0,0,0,0,0,0,0,0,0,0,0,0,81640
28303,2544,222,926,831,375,190,78,34,31,9,13,9,3,3,3,0,0,0,0,0,0,44,43,19,8,16,1,1,0,0,1,0,0,0,0,81641
28304,85,0,16,34,21,14,0,0,0,0,0,0,0,0,0,0,0,0,0,0,0,0,0,0,0,0,0,0,0,0,0,0,0,0,0,81642
28305,538,40,212,130,88,68,69,59,34,18,0,16,25,12,12,0,0,13,0,0,13,10,10,10,0,0,0,0,0,0,0,0,0,0,0,81643
28306,821,96,201,157,288,79,5,5,5,0,0,5,0,0,0,0,0,0,0,0,0,0,0,0,0,0,0,0,0,0,0,0,0,0,0,81645
28307,127,5,71,41,5,5,0,0,0,0,0,0,0,0,0,0,0,0,0,0,0,0,0,0,0,0,0,0,0,0,0,0,0,0,0,81646
28308,4323,689,939,1819,558,318,308,185,185,14,83,88,0,0,0,0,0,0,0,0,0,123,123,24,19,80,0,0,0,0,0,0,0,0,0,81647
28309,1544,148,444,614,249,89,302,146,133,29,17,87,13,13,13,0,0,0,0,0,0,156,119,42,10,67,37,37,11,0,26,0,0,0,0,81648
28310,206,11,82,59,46,8,11,9,9,0,0,9,0,0,0,0,0,0,0,0,0,2,2,0,0,2,0,0,0,0,0,0,0,0,0,81649
28311,8557,1629,2848,2909,845,326,688,372,261,81,31,149,111,96,96,0,0,15,15,0,0,316,270,89,70,111,46,25,17,0,8,21,0,21,0,81650
28312,2876,264,892,1171,414,135,301,99,96,12,30,54,3,3,3,0,0,0,0,0,0,202,202,27,28,147,0,0,0,0,0,0,0,0,0,81652
28313,23,0,0,9,7,7,0,0,0,0,0,0,0,0,0,0,0,0,0,0,0,0,0,0,0,0,0,0,0,0,0,0,0,0,0,81653
28314,771,102,31,274,267,97,0,0,0,0,0,0,0,0,0,0,0,0,0,0,0,0,0,0,0,0,0,0,0,0,0,0,0,0,0,81654
28315,29,29,0,0,0,0,0,0,0,0,0,0,0,0,0,0,0,0,0,0,0,0,0,0,0,0,0,0,0,0,0,0,0,0,0,81655
28316,329,20,74,102,88,45,22,0,0,0,0,0,0,0,0,0,0,0,0,0,0,22,22,0,0,22,0,0,0,0,0,0,0,0,0,81656
28317,4724,42,739,1131,2012,800,66,33,33,0,0,33,0,0,0,0,0,0,0,0,0,33,33,22,0,11,0,0,0,0,0,0,0,0,0,81657
28318,23494,1274,6630,10236,3503,1851,1855,791,692,276,67,349,99,87,51,9,27,12,0,0,12,1064,705,275,0,430,359,281,206,42,33,78,39,0,39,82001
28319,18,0,5,4,6,3,119,104,22,22,0,0,82,80,80,0,0,2,0,0,2,15,0,0,0,0,15,15,12,0,3,0,0,0,0,82005
28320,12469,1421,4475,5110,1170,293,1215,845,657,164,82,411,188,124,61,24,39,64,36,15,13,370,350,76,0,274,20,20,0,0,20,0,0,0,0,82007
28321,22252,1218,4704,8467,4460,3403,1337,783,722,334,94,294,61,44,11,33,0,17,0,17,0,554,506,153,89,264,48,41,41,0,0,7,0,7,0,82009
28322,284,24,95,138,11,16,23,0,0,0,0,0,0,0,0,0,0,0,0,0,0,23,5,0,0,5,18,0,0,0,0,18,18,0,0,82050
28323,7,0,7,0,0,0,0,0,0,0,0,0,0,0,0,0,0,0,0,0,0,0,0,0,0,0,0,0,0,0,0,0,0,0,0,82051
28324,0,0,0,0,0,0,0,0,0,0,0,0,0,0,0,0,0,0,0,0,0,0,0,0,0,0,0,0,0,0,0,0,0,0,0,82052
28325,1108,112,392,383,199,22,196,10,10,2,0,8,0,0,0,0,0,0,0,0,0,186,186,73,0,113,0,0,0,0,0,0,0,0,0,82053
28326,487,42,232,145,60,8,14,14,14,0,0,14,0,0,0,0,0,0,0,0,0,0,0,0,0,0,0,0,0,0,0,0,0,0,0,82054
28327,246,0,35,108,71,32,0,0,0,0,0,0,0,0,0,0,0,0,0,0,0,0,0,0,0,0,0,0,0,0,0,0,0,0,0,82055
28328,34,13,21,0,0,0,0,0,0,0,0,0,0,0,0,0,0,0,0,0,0,0,0,0,0,0,0,0,0,0,0,0,0,0,0,82058
28329,69,0,9,33,27,0,0,0,0,0,0,0,0,0,0,0,0,0,0,0,0,0,0,0,0,0,0,0,0,0,0,0,0,0,0,82059
28330,311,0,31,142,138,0,0,0,0,0,0,0,0,0,0,0,0,0,0,0,0,0,0,0,0,0,0,0,0,0,0,0,0,0,0,82060
28331,13,0,0,13,0,0,0,0,0,0,0,0,0,0,0,0,0,0,0,0,0,0,0,0,0,0,0,0,0,0,0,0,0,0,0,82061
28332,52,0,0,26,0,26,0,0,0,0,0,0,0,0,0,0,0,0,0,0,0,0,0,0,0,0,0,0,0,0,0,0,0,0,0,82063
28333,11551,608,1975,3627,2780,2561,2541,1299,1274,242,90,942,25,25,2,0,23,0,0,0,0,1242,1137,271,90,776,105,73,51,22,0,32,32,0,0,82070
28334,7824,303,980,2492,2429,1620,940,506,473,122,25,326,33,33,22,0,11,0,0,0,0,434,415,150,14,251,19,16,7,0,9,3,0,0,3,82072
28335,0,0,0,0,0,0,22,15,15,0,0,15,0,0,0,0,0,0,0,0,0,7,7,0,0,7,0,0,0,0,0,0,0,0,0,82073
28336,0,0,0,0,0,0,0,0,0,0,0,0,0,0,0,0,0,0,0,0,0,0,0,0,0,0,0,0,0,0,0,0,0,0,0,82081
28337,1015,56,287,383,198,91,84,71,71,12,5,54,0,0,0,0,0,0,0,0,0,13,13,0,0,13,0,0,0,0,0,0,0,0,0,82082
28338,269,13,73,131,46,6,19,14,14,5,0,9,0,0,0,0,0,0,0,0,0,5,5,0,0,5,0,0,0,0,0,0,0,0,0,82083
28339,0,0,0,0,0,0,0,0,0,0,0,0,0,0,0,0,0,0,0,0,0,0,0,0,0,0,0,0,0,0,0,0,0,0,0,82084
28340,647,13,19,210,313,92,3,3,0,0,0,0,3,0,0,0,0,3,3,0,0,0,0,0,0,0,0,0,0,0,0,0,0,0,0,82190
28341,4285,263,1149,1777,664,432,264,169,97,37,0,60,72,72,71,0,1,0,0,0,0,95,95,71,0,24,0,0,0,0,0,0,0,0,0,82201
28342,361,46,85,101,119,10,87,87,85,85,0,0,2,0,0,0,0,2,2,0,0,0,0,0,0,0,0,0,0,0,0,0,0,0,0,82210
28343,224,15,81,85,27,16,22,2,2,0,0,2,0,0,0,0,0,0,0,0,0,20,20,17,0,3,0,0,0,0,0,0,0,0,0,82212
28344,510,36,139,254,56,25,8,0,0,0,0,0,0,0,0,0,0,0,0,0,0,8,8,0,0,8,0,0,0,0,0,0,0,0,0,82213
28345,1072,112,344,426,132,58,108,37,36,20,0,16,1,1,1,0,0,0,0,0,0,71,71,11,3,57,0,0,0,0,0,0,0,0,0,82214
28346,109,2,37,50,17,3,11,11,11,11,0,0,0,0,0,0,0,0,0,0,0,0,0,0,0,0,0,0,0,0,0,0,0,0,0,82215
28347,80,6,26,26,22,0,3,0,0,0,0,0,0,0,0,0,0,0,0,0,0,3,3,2,0,1,0,0,0,0,0,0,0,0,0,82217
28348,15,0,0,0,8,7,0,0,0,0,0,0,0,0,0,0,0,0,0,0,0,0,0,0,0,0,0,0,0,0,0,0,0,0,0,82219
28349,306,21,53,174,51,7,100,51,51,17,1,33,0,0,0,0,0,0,0,0,0,49,49,11,0,38,0,0,0,0,0,0,0,0,0,82221
28350,161,9,79,64,9,0,11,11,11,0,0,11,0,0,0,0,0,0,0,0,0,0,0,0,0,0,0,0,0,0,0,0,0,0,0,82222
28351,900,56,332,323,164,25,55,19,19,2,0,17,0,0,0,0,0,0,0,0,0,36,36,17,0,19,0,0,0,0,0,0,0,0,0,82223
28352,22,0,0,22,0,0,0,0,0,0,0,0,0,0,0,0,0,0,0,0,0,0,0,0,0,0,0,0,0,0,0,0,0,0,0,82224
28353,1458,127,454,590,239,48,102,49,32,10,0,22,17,17,0,0,17,0,0,0,0,53,28,13,0,15,25,14,0,0,14,11,0,11,0,82225
28354,133,30,22,49,19,13,4,0,0,0,0,0,0,0,0,0,0,0,0,0,0,4,4,0,0,4,0,0,0,0,0,0,0,0,0,82227
28355,72,0,27,16,29,0,0,0,0,0,0,0,0,0,0,0,0,0,0,0,0,0,0,0,0,0,0,0,0,0,0,0,0,0,0,82229
28356,7034,858,2331,2433,901,511,467,338,244,76,16,152,94,57,41,0,16,37,26,0,11,129,124,8,0,116,5,5,0,5,0,0,0,0,0,82240
28357,36,0,7,29,0,0,0,0,0,0,0,0,0,0,0,0,0,0,0,0,0,0,0,0,0,0,0,0,0,0,0,0,0,0,0,82242
28358,78,0,10,33,23,12,9,0,0,0,0,0,0,0,0,0,0,0,0,0,0,9,9,0,0,9,0,0,0,0,0,0,0,0,0,82243
28359,542,38,245,167,33,59,57,31,31,0,19,12,0,0,0,0,0,0,0,0,0,26,22,0,4,18,4,4,4,0,0,0,0,0,0,82244
28360,6246,802,2416,2178,592,258,312,130,78,12,0,66,52,48,33,0,15,4,0,0,4,182,125,95,12,18,57,43,38,0,5,14,14,0,0,82301
28361,484,37,179,170,93,5,72,45,41,3,8,30,4,4,4,0,0,0,0,0,0,27,27,3,0,24,0,0,0,0,0,0,0,0,0,82321
28362,111,2,56,34,11,8,1,1,0,0,0,0,1,1,0,1,0,0,0,0,0,0,0,0,0,0,0,0,0,0,0,0,0,0,0,82322
28363,130,10,62,33,7,18,0,0,0,0,0,0,0,0,0,0,0,0,0,0,0,0,0,0,0,0,0,0,0,0,0,0,0,0,0,82323
28364,155,1,43,69,24,18,4,4,4,0,0,4,0,0,0,0,0,0,0,0,0,0,0,0,0,0,0,0,0,0,0,0,0,0,0,82324
28365,628,7,136,318,103,64,46,37,37,30,0,7,0,0,0,0,0,0,0,0,0,9,9,9,0,0,0,0,0,0,0,0,0,0,0,82325
28366,570,76,210,203,50,31,10,10,10,0,0,10,0,0,0,0,0,0,0,0,0,0,0,0,0,0,0,0,0,0,0,0,0,0,0,82327
28367,240,9,133,80,13,5,2,2,0,0,0,0,2,2,0,2,0,0,0,0,0,0,0,0,0,0,0,0,0,0,0,0,0,0,0,82329
28368,1904,178,649,599,314,164,138,83,74,63,0,11,9,9,9,0,0,0,0,0,0,55,51,7,8,36,4,4,0,0,4,0,0,0,0,82331
28369,33,0,0,0,12,21,0,0,0,0,0,0,0,0,0,0,0,0,0,0,0,0,0,0,0,0,0,0,0,0,0,0,0,0,0,82332
28370,313,5,92,150,58,8,32,29,26,6,0,20,3,3,0,3,0,0,0,0,0,3,3,3,0,0,0,0,0,0,0,0,0,0,0,82334
28371,17,0,17,0,0,0,0,0,0,0,0,0,0,0,0,0,0,0,0,0,0,0,0,0,0,0,0,0,0,0,0,0,0,0,0,82335
28372,321,52,144,99,26,0,15,10,8,2,0,6,2,2,2,0,0,0,0,0,0,5,0,0,0,0,5,5,5,0,0,0,0,0,0,82336
28373,5183,511,1547,1963,841,321,426,273,253,39,16,198,20,0,0,0,0,20,0,8,12,153,153,76,47,30,0,0,0,0,0,0,0,0,0,82401
28374,1187,86,382,447,150,122,104,45,45,5,22,18,0,0,0,0,0,0,0,0,0,59,59,30,0,29,0,0,0,0,0,0,0,0,0,82410
28375,304,26,74,108,55,41,47,35,35,17,0,18,0,0,0,0,0,0,0,0,0,12,12,4,0,8,0,0,0,0,0,0,0,0,0,82411
28376,467,38,237,136,31,25,74,34,26,6,3,17,8,8,0,8,0,0,0,0,0,40,25,0,0,25,15,0,0,0,0,15,8,0,7,82412
28377,11157,800,3603,3927,1720,1107,766,347,261,100,18,143,86,86,80,0,6,0,0,0,0,419,330,206,0,124,89,53,25,23,5,36,17,0,19,82414
28378,473,45,121,234,55,18,37,19,19,0,0,19,0,0,0,0,0,0,0,0,0,18,18,13,0,5,0,0,0,0,0,0,0,0,0,82420
28379,262,15,84,121,33,9,11,3,0,0,0,0,3,3,3,0,0,0,0,0,0,8,8,0,0,8,0,0,0,0,0,0,0,0,0,82421
28380,147,51,11,28,57,0,4,4,4,0,0,4,0,0,0,0,0,0,0,0,0,0,0,0,0,0,0,0,0,0,0,0,0,0,0,82422
28381,142,11,53,54,21,3,2,2,2,0,0,2,0,0,0,0,0,0,0,0,0,0,0,0,0,0,0,0,0,0,0,0,0,0,0,82423
28382,2001,312,606,659,326,98,206,96,86,38,8,40,10,10,0,0,10,0,0,0,0,110,110,21,0,89,0,0,0,0,0,0,0,0,0,82426
28383,42,5,0,16,16,5,0,0,0,0,0,0,0,0,0,0,0,0,0,0,0,0,0,0,0,0,0,0,0,0,0,0,0,0,0,82428
28384,82,47,15,14,4,2,16,16,0,0,0,0,16,0,0,0,0,16,0,0,16,0,0,0,0,0,0,0,0,0,0,0,0,0,0,82430
28385,2364,218,693,962,333,158,135,71,66,4,9,53,5,5,5,0,0,0,0,0,0,64,64,17,0,47,0,0,0,0,0,0,0,0,0,82431
28386,138,35,28,32,18,25,0,0,0,0,0,0,0,0,0,0,0,0,0,0,0,0,0,0,0,0,0,0,0,0,0,0,0,0,0,82432
28387,688,75,220,237,121,35,57,30,30,13,0,17,0,0,0,0,0,0,0,0,0,27,27,8,0,19,0,0,0,0,0,0,0,0,0,82433
28388,132,0,54,61,10,7,33,16,0,0,0,0,16,16,16,0,0,0,0,0,0,17,17,8,0,9,0,0,0,0,0,0,0,0,0,82434
28389,7440,450,1868,2947,1403,772,727,425,339,165,22,152,86,86,62,0,24,0,0,0,0,302,252,137,12,103,50,50,50,0,0,0,0,0,0,82435
28390,95,24,0,48,23,0,0,0,0,0,0,0,0,0,0,0,0,0,0,0,0,0,0,0,0,0,0,0,0,0,0,0,0,0,0,82440
28391,177,0,12,119,38,8,12,11,11,0,1,10,0,0,0,0,0,0,0,0,0,1,1,0,0,1,0,0,0,0,0,0,0,0,0,82441
28392,606,37,176,194,131,68,16,14,14,2,0,12,0,0,0,0,0,0,0,0,0,2,2,0,0,2,0,0,0,0,0,0,0,0,0,82442
28393,3470,456,1060,1324,359,271,171,81,70,28,0,42,11,0,0,0,0,11,10,0,1,90,78,52,0,26,12,12,0,6,6,0,0,0,0,82443
28394,131,0,39,26,66,0,0,0,0,0,0,0,0,0,0,0,0,0,0,0,0,0,0,0,0,0,0,0,0,0,0,0,0,0,0,82450
28395,12675,1240,3874,5192,1624,745,1254,608,454,188,85,181,154,76,50,5,21,78,46,25,7,646,556,141,88,327,90,53,37,16,0,37,0,6,31,82501
28396,274,24,91,110,36,13,20,20,10,0,0,10,10,5,5,0,0,5,0,0,5,0,0,0,0,0,0,0,0,0,0,0,0,0,0,82510
28397,197,0,58,103,25,11,0,0,0,0,0,0,0,0,0,0,0,0,0,0,0,0,0,0,0,0,0,0,0,0,0,0,0,0,0,82512
28398,1474,67,362,586,316,143,44,41,33,0,13,20,8,8,8,0,0,0,0,0,0,3,3,0,0,3,0,0,0,0,0,0,0,0,0,82513
28399,839,139,233,331,86,50,50,17,9,3,0,6,8,5,0,0,5,3,0,0,3,33,24,5,0,19,9,0,0,0,0,9,0,0,9,82514
28400,280,29,115,93,30,13,26,3,3,0,0,3,0,0,0,0,0,0,0,0,0,23,21,9,0,12,2,1,0,1,0,1,1,0,0,82515
28401,292,47,97,108,30,10,13,13,13,0,5,8,0,0,0,0,0,0,0,0,0,0,0,0,0,0,0,0,0,0,0,0,0,0,0,82516
28402,9072,622,2569,3545,1537,799,573,343,262,98,27,137,81,35,9,0,26,46,25,5,16,230,150,68,23,59,80,27,27,0,0,53,0,5,48,82520
28403,778,69,297,323,62,27,15,7,7,2,0,5,0,0,0,0,0,0,0,0,0,8,8,8,0,0,0,0,0,0,0,0,0,0,0,82523
28404,18049,1543,4858,7735,2502,1411,1695,944,859,472,91,296,85,43,13,12,18,42,0,0,42,751,599,293,44,262,152,118,90,25,3,34,14,4,16,82601
28405,17648,1358,5577,6888,2597,1228,1560,722,618,256,42,320,104,73,63,10,0,31,9,0,22,838,697,240,86,371,141,85,81,0,4,56,0,33,23,82604
28406,11346,717,2769,4650,2482,728,634,342,292,114,21,157,50,44,15,29,0,6,6,0,0,292,192,68,36,88,100,100,48,0,52,0,0,0,0,82609
28407,214,11,53,101,14,35,12,12,0,0,0,0,12,0,0,0,0,12,12,0,0,0,0,0,0,0,0,0,0,0,0,0,0,0,0,82620
28408,42,12,9,9,12,0,0,0,0,0,0,0,0,0,0,0,0,0,0,0,0,0,0,0,0,0,0,0,0,0,0,0,0,0,0,82630
28409,6528,560,2421,2299,920,328,433,226,193,127,0,66,33,33,32,0,1,0,0,0,0,207,130,85,0,45,77,60,60,0,0,17,17,0,0,82633
28410,252,35,75,112,20,10,18,5,0,0,0,0,5,5,5,0,0,0,0,0,0,13,13,0,0,13,0,0,0,0,0,0,0,0,0,82635
28411,2595,282,959,1080,137,137,110,73,73,38,0,35,0,0,0,0,0,0,0,0,0,37,37,18,0,19,0,0,0,0,0,0,0,0,0,82636
28412,2802,184,1013,1115,324,166,300,190,108,19,0,89,82,26,15,11,0,56,19,0,37,110,89,68,17,4,21,0,0,0,0,21,0,9,12,82637
28413,0,0,0,0,0,0,0,0,0,0,0,0,0,0,0,0,0,0,0,0,0,0,0,0,0,0,0,0,0,0,0,0,0,0,0,82638
28414,547,92,213,134,93,15,26,0,0,0,0,0,0,0,0,0,0,0,0,0,0,26,26,0,0,26,0,0,0,0,0,0,0,0,0,82639
28415,35,0,6,20,9,0,0,0,0,0,0,0,0,0,0,0,0,0,0,0,0,0,0,0,0,0,0,0,0,0,0,0,0,0,0,82640
28416,51,3,17,31,0,0,0,0,0,0,0,0,0,0,0,0,0,0,0,0,0,0,0,0,0,0,0,0,0,0,0,0,0,0,0,82642
28417,357,116,83,125,14,19,31,16,16,6,2,8,0,0,0,0,0,0,0,0,0,15,12,7,0,5,3,0,0,0,0,3,0,0,3,82643
28418,947,87,314,413,101,32,55,40,21,21,0,0,19,0,0,0,0,19,19,0,0,15,0,0,0,0,15,15,15,0,0,0,0,0,0,82644
28419,0,0,0,0,0,0,0,0,0,0,0,0,0,0,0,0,0,0,0,0,0,0,0,0,0,0,0,0,0,0,0,0,0,0,0,82646
28420,19,0,0,19,0,0,0,0,0,0,0,0,0,0,0,0,0,0,0,0,0,0,0,0,0,0,0,0,0,0,0,0,0,0,0,82648
28421,893,85,357,314,83,54,47,18,8,4,0,4,10,0,0,0,0,10,0,10,0,29,17,0,0,17,12,12,0,12,0,0,0,0,0,82649
28422,3693,364,1297,1379,491,162,250,126,123,55,0,68,3,2,0,0,2,1,0,0,1,124,124,54,17,53,0,0,0,0,0,0,0,0,0,82701
28423,206,23,85,65,33,0,0,0,0,0,0,0,0,0,0,0,0,0,0,0,0,0,0,0,0,0,0,0,0,0,0,0,0,0,0,82710
28424,103,0,0,61,25,17,17,17,17,0,0,17,0,0,0,0,0,0,0,0,0,0,0,0,0,0,0,0,0,0,0,0,0,0,0,82711
28425,309,36,42,156,75,0,0,0,0,0,0,0,0,0,0,0,0,0,0,0,0,0,0,0,0,0,0,0,0,0,0,0,0,0,0,82712
28426,120,0,11,83,13,13,0,0,0,0,0,0,0,0,0,0,0,0,0,0,0,0,0,0,0,0,0,0,0,0,0,0,0,0,0,82714
28427,0,0,0,0,0,0,0,0,0,0,0,0,0,0,0,0,0,0,0,0,0,0,0,0,0,0,0,0,0,0,0,0,0,0,0,82715
28428,12077,1309,4883,3892,1590,403,769,414,296,162,33,101,118,58,19,0,39,60,60,0,0,355,286,102,13,171,69,61,50,0,11,8,0,0,8,82716
28429,13926,968,4679,5310,2078,891,1406,743,586,270,41,275,157,155,135,0,20,2,0,0,2,663,560,286,41,233,103,72,47,0,25,31,16,0,15,82718
28430,867,46,341,281,147,52,136,100,100,24,46,30,0,0,0,0,0,0,0,0,0,36,32,20,0,12,4,4,4,0,0,0,0,0,0,82720
28431,1757,97,721,605,178,156,140,39,28,17,0,11,11,0,0,0,0,11,11,0,0,101,101,78,7,16,0,0,0,0,0,0,0,0,0,82721
28432,260,76,88,76,20,0,26,26,26,0,0,26,0,0,0,0,0,0,0,0,0,0,0,0,0,0,0,0,0,0,0,0,0,0,0,82723
28433,175,16,85,57,17,0,8,0,0,0,0,0,0,0,0,0,0,0,0,0,0,8,8,0,0,8,0,0,0,0,0,0,0,0,0,82725
28434,1581,30,556,670,325,0,52,12,12,0,0,12,0,0,0,0,0,0,0,0,0,40,40,0,0,40,0,0,0,0,0,0,0,0,0,82727
28435,1601,152,581,529,231,108,83,49,49,4,0,45,0,0,0,0,0,0,0,0,0,34,24,11,0,13,10,10,0,0,10,0,0,0,0,82729
28436,1138,46,449,424,138,81,107,55,55,17,7,31,0,0,0,0,0,0,0,0,0,52,52,21,4,27,0,0,0,0,0,0,0,0,0,82730
28437,44,8,0,22,0,14,30,0,0,0,0,0,0,0,0,0,0,0,0,0,0,30,30,30,0,0,0,0,0,0,0,0,0,0,0,82731
28438,1408,148,668,440,100,52,199,147,122,41,0,81,25,15,9,0,6,10,10,0,0,52,35,12,0,23,17,10,0,3,7,7,0,0,7,82732
28439,16864,1071,4949,6421,3083,1340,1200,578,467,209,24,234,111,56,56,0,0,55,10,45,0,622,564,208,14,342,58,8,8,0,0,50,11,33,6,82801
28440,121,2,41,25,52,1,3,1,1,1,0,0,0,0,0,0,0,0,0,0,0,2,2,0,0,2,0,0,0,0,0,0,0,0,0,82831
28441,545,4,201,170,101,69,17,0,0,0,0,0,0,0,0,0,0,0,0,0,0,17,17,0,0,17,0,0,0,0,0,0,0,0,0,82832
28442,95,0,0,0,46,49,0,0,0,0,0,0,0,0,0,0,0,0,0,0,0,0,0,0,0,0,0,0,0,0,0,0,0,0,0,82833
28443,5552,259,1806,2009,961,517,361,171,161,113,0,48,10,10,0,0,10,0,0,0,0,190,160,108,0,52,30,30,16,0,14,0,0,0,0,82834
28444,220,11,100,66,32,11,5,4,4,4,0,0,0,0,0,0,0,0,0,0,0,1,1,1,0,0,0,0,0,0,0,0,0,0,0,82835
28445,788,15,218,307,191,57,86,30,25,0,0,25,5,5,0,2,3,0,0,0,0,56,56,21,8,27,0,0,0,0,0,0,0,0,0,82836
28446,19,0,12,4,2,1,0,0,0,0,0,0,0,0,0,0,0,0,0,0,0,0,0,0,0,0,0,0,0,0,0,0,0,0,0,82837
28447,184,25,0,120,27,12,46,19,19,0,8,11,0,0,0,0,0,0,0,0,0,27,27,16,0,11,0,0,0,0,0,0,0,0,0,82838
28448,882,29,234,412,174,33,25,8,0,0,0,0,8,8,2,6,0,0,0,0,0,17,17,2,0,15,0,0,0,0,0,0,0,0,0,82839
28449,934,56,170,329,238,141,38,38,38,38,0,0,0,0,0,0,0,0,0,0,0,0,0,0,0,0,0,0,0,0,0,0,0,0,0,82842
28450,41,0,15,0,12,14,0,0,0,0,0,0,0,0,0,0,0,0,0,0,0,0,0,0,0,0,0,0,0,0,0,0,0,0,0,82844
28451,0,0,0,0,0,0,0,0,0,0,0,0,0,0,0,0,0,0,0,0,0,0,0,0,0,0,0,0,0,0,0,0,0,0,0,82845
28452,17855,1715,6466,6514,2093,1067,1411,728,638,236,45,357,90,56,37,0,19,34,33,0,1,683,652,348,17,287,31,8,8,0,0,23,7,4,12,82901
28453,162,25,15,51,47,24,0,0,0,0,0,0,0,0,0,0,0,0,0,0,0,0,0,0,0,0,0,0,0,0,0,0,0,0,0,82922
28454,296,2,23,150,96,25,0,0,0,0,0,0,0,0,0,0,0,0,0,0,0,0,0,0,0,0,0,0,0,0,0,0,0,0,0,82923
28455,113,0,40,0,73,0,0,0,0,0,0,0,0,0,0,0,0,0,0,0,0,0,0,0,0,0,0,0,0,0,0,0,0,0,0,82925
28456,0,0,0,0,0,0,0,0,0,0,0,0,0,0,0,0,0,0,0,0,0,0,0,0,0,0,0,0,0,0,0,0,0,0,0,82929
28457,9157,1152,3033,3091,1286,595,675,310,169,80,33,56,141,84,40,44,0,57,0,57,0,365,315,163,26,126,50,36,5,22,9,14,0,0,14,82930
28458,661,26,263,223,115,34,56,30,30,30,0,0,0,0,0,0,0,0,0,0,0,26,26,0,0,26,0,0,0,0,0,0,0,0,0,82932
28459,499,50,219,176,27,27,45,45,45,19,0,26,0,0,0,0,0,0,0,0,0,0,0,0,0,0,0,0,0,0,0,0,0,0,0,82933
28460,136,11,60,40,25,0,0,0,0,0,0,0,0,0,0,0,0,0,0,0,0,0,0,0,0,0,0,0,0,0,0,0,0,0,0,82934
28461,8583,705,2864,3382,1351,281,729,442,349,156,35,158,93,76,54,0,22,17,0,0,17,287,243,105,23,115,44,44,44,0,0,0,0,0,0,82935
28462,5,5,0,0,0,0,0,0,0,0,0,0,0,0,0,0,0,0,0,0,0,0,0,0,0,0,0,0,0,0,0,0,0,0,0,82936
28463,2079,148,749,893,210,79,247,150,86,41,0,45,64,47,21,7,19,17,0,17,0,97,94,71,0,23,3,0,0,0,0,3,3,0,0,82937
28464,166,0,33,70,63,0,0,0,0,0,0,0,0,0,0,0,0,0,0,0,0,0,0,0,0,0,0,0,0,0,0,0,0,0,0,82938
28465,1223,62,555,390,160,56,96,22,22,5,11,6,0,0,0,0,0,0,0,0,0,74,69,18,0,51,5,5,5,0,0,0,0,0,0,82939
28466,3595,193,962,1612,455,373,364,177,61,0,0,61,116,108,9,0,99,8,0,0,8,187,111,3,0,108,76,76,76,0,0,0,0,0,0,82941
28467,25,6,4,15,0,0,0,0,0,0,0,0,0,0,0,0,0,0,0,0,0,0,0,0,0,0,0,0,0,0,0,0,0,0,0,82942
28468,69,13,56,0,0,0,0,0,0,0,0,0,0,0,0,0,0,0,0,0,0,0,0,0,0,0,0,0,0,0,0,0,0,0,0,82943
28469,214,20,41,111,42,0,36,23,23,0,0,23,0,0,0,0,0,0,0,0,0,13,13,0,0,13,0,0,0,0,0,0,0,0,0,82944
28470,168,7,71,73,11,6,30,25,25,2,2,21,0,0,0,0,0,0,0,0,0,5,5,2,0,3,0,0,0,0,0,0,0,0,0,82945
28471,11730,494,2875,2936,3712,1713,625,292,289,54,0,235,3,1,1,0,0,2,2,0,0,333,243,27,39,177,90,90,42,48,0,0,0,0,0,83001
28472,32,0,0,32,0,0,1,0,0,0,0,0,0,0,0,0,0,0,0,0,0,1,1,0,0,1,0,0,0,0,0,0,0,0,0,83011
28473,61,0,0,41,20,0,0,0,0,0,0,0,0,0,0,0,0,0,0,0,0,0,0,0,0,0,0,0,0,0,0,0,0,0,0,83012
28474,312,1,82,105,124,0,8,0,0,0,0,0,0,0,0,0,0,0,0,0,0,8,8,2,0,6,0,0,0,0,0,0,0,0,0,83013
28475,3139,0,521,747,1309,562,143,79,79,20,0,59,0,0,0,0,0,0,0,0,0,64,64,0,0,64,0,0,0,0,0,0,0,0,0,83014
28476,102,0,14,0,76,12,0,0,0,0,0,0,0,0,0,0,0,0,0,0,0,0,0,0,0,0,0,0,0,0,0,0,0,0,0,83025
28477,2025,147,667,857,268,86,144,73,48,30,0,18,25,25,9,9,7,0,0,0,0,71,46,26,0,20,25,16,16,0,0,9,9,0,0,83101
28478,2734,173,891,1119,323,228,428,273,169,31,14,124,104,55,55,0,0,49,42,7,0,155,125,29,24,72,30,18,18,0,0,12,0,12,0,83110
28479,334,42,69,112,95,16,24,10,10,0,0,10,0,0,0,0,0,0,0,0,0,14,14,14,0,0,0,0,0,0,0,0,0,0,0,83111
28480,350,0,150,119,64,17,17,0,0,0,0,0,0,0,0,0,0,0,0,0,0,17,17,17,0,0,0,0,0,0,0,0,0,0,0,83112
28481,1930,75,716,831,261,47,144,82,82,0,13,69,0,0,0,0,0,0,0,0,0,62,62,29,0,33,0,0,0,0,0,0,0,0,0,83113
28482,520,8,205,202,92,13,29,26,26,8,0,18,0,0,0,0,0,0,0,0,0,3,3,0,1,2,0,0,0,0,0,0,0,0,0,83114
28483,822,0,257,346,169,50,75,67,67,27,0,40,0,0,0,0,0,0,0,0,0,8,0,0,0,0,8,0,0,0,0,8,8,0,0,83115
28484,489,50,255,121,45,18,10,0,0,0,0,0,0,0,0,0,0,0,0,0,0,10,10,4,0,6,0,0,0,0,0,0,0,0,0,83116
28485,864,34,187,407,155,81,48,10,10,10,0,0,0,0,0,0,0,0,0,0,0,38,38,0,0,38,0,0,0,0,0,0,0,0,0,83118
28486,51,0,29,22,0,0,0,0,0,0,0,0,0,0,0,0,0,0,0,0,0,0,0,0,0,0,0,0,0,0,0,0,0,0,0,83119
28487,493,46,110,278,0,59,109,73,73,34,0,39,0,0,0,0,0,0,0,0,0,36,36,0,0,36,0,0,0,0,0,0,0,0,0,83120
28488,5,0,0,0,5,0,0,0,0,0,0,0,0,0,0,0,0,0,0,0,0,0,0,0,0,0,0,0,0,0,0,0,0,0,0,83121
28489,412,0,125,211,24,52,0,0,0,0,0,0,0,0,0,0,0,0,0,0,0,0,0,0,0,0,0,0,0,0,0,0,0,0,0,83122
28490,427,53,72,276,20,6,29,18,5,0,0,5,13,13,0,13,0,0,0,0,0,11,7,3,0,4,4,0,0,0,0,4,4,0,0,83123
28491,53,5,24,24,0,0,0,0,0,0,0,0,0,0,0,0,0,0,0,0,0,0,0,0,0,0,0,0,0,0,0,0,0,0,0,83124
28492,265,0,14,200,51,0,0,0,0,0,0,0,0,0,0,0,0,0,0,0,0,0,0,0,0,0,0,0,0,0,0,0,0,0,0,83126
28493,1917,239,581,502,403,192,115,20,17,10,0,7,3,3,0,3,0,0,0,0,0,95,88,16,0,72,7,7,7,0,0,0,0,0,0,83127
28494,1076,41,439,381,192,23,26,20,20,13,0,7,0,0,0,0,0,0,0,0,0,6,6,0,0,6,0,0,0,0,0,0,0,0,0,83128
28495,22376,1281,6103,8235,4219,2538,2212,1068,961,316,38,607,107,107,56,31,20,0,0,0,0,1144,950,381,108,461,194,194,138,39,17,0,0,0,0,83201
28496,13242,1491,3919,5200,1899,733,1141,618,460,168,58,234,158,88,18,35,35,70,23,27,20,523,411,177,55,179,112,106,52,0,54,6,6,0,0,83202
28497,269,53,59,157,0,0,11,11,11,0,0,11,0,0,0,0,0,0,0,0,0,0,0,0,0,0,0,0,0,0,0,0,0,0,0,83203
28498,12111,1256,3355,4174,2302,1024,981,642,523,129,46,348,119,95,71,0,24,24,0,18,6,339,262,64,33,165,77,56,29,2,25,21,0,0,21,83204
28499,173,17,0,36,64,56,363,168,168,52,9,107,0,0,0,0,0,0,0,0,0,195,195,68,18,109,0,0,0,0,0,0,0,0,0,83209
28500,1886,508,619,563,154,42,209,137,114,8,13,93,23,23,13,0,10,0,0,0,0,72,69,27,0,42,3,3,3,0,0,0,0,0,0,83210
28501,3409,686,1384,884,336,119,357,210,126,60,0,66,84,69,18,25,26,15,0,15,0,147,83,18,13,52,64,48,42,0,6,16,0,16,0,83211
28502,128,3,32,49,16,28,2,2,0,0,0,0,2,2,0,2,0,0,0,0,0,0,0,0,0,0,0,0,0,0,0,0,0,0,0,83212
28503,1120,149,411,384,112,64,96,60,59,7,0,52,1,1,0,0,1,0,0,0,0,36,14,0,0,14,22,11,11,0,0,11,11,0,0,83213
28504,364,34,116,145,60,9,35,15,15,11,1,3,0,0,0,0,0,0,0,0,0,20,20,8,0,12,0,0,0,0,0,0,0,0,0,83214
28505,20,2,13,5,0,0,0,0,0,0,0,0,0,0,0,0,0,0,0,0,0,0,0,0,0,0,0,0,0,0,0,0,0,0,0,83215
28506,469,46,154,205,40,24,42,28,18,3,0,15,10,10,10,0,0,0,0,0,0,14,14,0,0,14,0,0,0,0,0,0,0,0,0,83217
28507,232,35,105,73,9,10,11,4,4,0,2,2,0,0,0,0,0,0,0,0,0,7,5,2,0,3,2,2,0,0,2,0,0,0,0,83218
28508,87,0,13,39,27,8,18,4,4,0,0,4,0,0,0,0,0,0,0,0,0,14,14,0,0,14,0,0,0,0,0,0,0,0,0,83220
28509,16018,2341,4565,5890,2476,746,1682,783,604,282,4,318,179,129,52,11,66,50,0,0,50,899,799,362,25,412,100,69,69,0,0,31,12,0,19,83221
28510,78,3,55,16,1,3,10,8,8,8,0,0,0,0,0,0,0,0,0,0,0,2,2,2,0,0,0,0,0,0,0,0,0,0,0,83223
28511,1877,261,729,483,275,129,53,18,15,8,0,7,3,0,0,0,0,3,0,0,3,35,29,0,0,29,6,6,0,0,6,0,0,0,0,83226
28512,184,0,151,26,0,7,57,57,30,0,0,30,27,0,0,0,0,27,0,27,0,0,0,0,0,0,0,0,0,0,0,0,0,0,0,83227
28513,301,12,90,146,35,18,47,31,31,4,3,24,0,0,0,0,0,0,0,0,0,16,11,9,0,2,5,5,2,3,0,0,0,0,0,83228
28514,263,27,52,121,38,25,35,8,8,4,1,3,0,0,0,0,0,0,0,0,0,27,25,11,3,11,2,2,0,0,2,0,0,0,0,83232
28515,12,0,0,0,12,0,0,0,0,0,0,0,0,0,0,0,0,0,0,0,0,0,0,0,0,0,0,0,0,0,0,0,0,0,0,83233
28516,721,134,190,288,96,13,126,13,13,10,0,3,0,0,0,0,0,0,0,0,0,113,92,2,0,90,21,0,0,0,0,21,0,0,21,83234
28517,35,9,2,10,7,7,0,0,0,0,0,0,0,0,0,0,0,0,0,0,0,0,0,0,0,0,0,0,0,0,0,0,0,0,0,83235
28518,1257,157,407,385,219,89,144,93,78,17,0,61,15,8,8,0,0,7,3,0,4,51,49,18,0,31,2,2,0,0,2,0,0,0,0,83236
28519,827,167,278,286,87,9,97,52,52,34,0,18,0,0,0,0,0,0,0,0,0,45,30,0,0,30,15,15,0,0,15,0,0,0,0,83237
28520,78,14,35,29,0,0,7,7,7,0,0,7,0,0,0,0,0,0,0,0,0,0,0,0,0,0,0,0,0,0,0,0,0,0,0,83238
28521,341,48,138,121,26,8,40,10,8,5,0,3,2,2,1,1,0,0,0,0,0,30,22,7,0,15,8,1,1,0,0,7,7,0,0,83239
28522,1281,163,578,411,109,20,106,54,43,33,0,10,11,11,11,0,0,0,0,0,0,52,13,0,0,13,39,30,2,28,0,9,0,0,9,83241
28523,88,16,36,36,0,0,0,0,0,0,0,0,0,0,0,0,0,0,0,0,0,0,0,0,0,0,0,0,0,0,0,0,0,0,0,83243
28524,168,0,69,80,19,0,13,4,4,4,0,0,0,0,0,0,0,0,0,0,0,9,9,4,0,5,0,0,0,0,0,0,0,0,0,83244
28525,1401,70,406,614,208,103,156,94,84,6,5,73,10,10,6,0,4,0,0,0,0,62,49,13,0,36,13,6,6,0,0,7,0,0,7,83245
28526,658,85,195,216,71,91,54,40,38,9,0,29,2,2,0,2,0,0,0,0,0,14,14,0,0,14,0,0,0,0,0,0,0,0,0,83246
28527,952,104,367,216,183,82,45,19,19,0,3,16,0,0,0,0,0,0,0,0,0,26,20,10,0,10,6,0,0,0,0,6,0,0,6,83250
28528,861,60,251,246,204,100,57,33,18,11,3,4,15,0,0,0,0,15,0,0,15,24,24,12,0,12,0,0,0,0,0,0,0,0,0,83251
28529,2641,173,1002,1113,222,131,267,232,204,99,37,68,28,22,0,0,22,6,6,0,0,35,35,27,0,8,0,0,0,0,0,0,0,0,0,83252
28530,94,0,12,50,32,0,0,0,0,0,0,0,0,0,0,0,0,0,0,0,0,0,0,0,0,0,0,0,0,0,0,0,0,0,0,83253
28531,2487,253,1068,840,245,81,149,83,72,22,0,50,11,8,8,0,0,3,3,0,0,66,42,5,0,37,24,2,0,0,2,22,11,3,8,83254
28532,748,67,276,225,109,71,66,14,6,0,0,6,8,8,0,8,0,0,0,0,0,52,46,3,3,40,6,6,0,0,6,0,0,0,0,83255
28533,330,22,128,111,64,5,22,13,13,11,0,2,0,0,0,0,0,0,0,0,0,9,6,0,0,6,3,3,3,0,0,0,0,0,0,83261
28534,695,102,171,305,103,14,75,51,51,44,0,7,0,0,0,0,0,0,0,0,0,24,24,10,0,14,0,0,0,0,0,0,0,0,0,83262
28535,5153,361,2110,1785,689,208,442,188,165,102,22,41,23,23,0,14,9,0,0,0,0,254,173,63,36,74,81,81,81,0,0,0,0,0,0,83263
28536,398,62,101,175,57,3,51,41,41,8,0,33,0,0,0,0,0,0,0,0,0,10,5,0,0,5,5,5,5,0,0,0,0,0,0,83271
28537,203,4,49,123,23,4,48,5,5,5,0,0,0,0,0,0,0,0,0,0,0,43,14,0,0,14,29,29,0,0,29,0,0,0,0,83272
28538,5328,698,1908,2003,476,243,569,322,227,10,43,174,95,95,82,0,13,0,0,0,0,247,159,54,25,80,88,54,29,14,11,34,18,0,16,83274
28539,2633,295,849,933,429,127,173,117,117,14,0,103,0,0,0,0,0,0,0,0,0,56,37,9,10,18,19,19,19,0,0,0,0,0,0,83276
28540,225,47,97,76,5,0,10,10,10,0,0,10,0,0,0,0,0,0,0,0,0,0,0,0,0,0,0,0,0,0,0,0,0,0,0,83277
28541,94,0,12,13,62,7,0,0,0,0,0,0,0,0,0,0,0,0,0,0,0,0,0,0,0,0,0,0,0,0,0,0,0,0,0,83278
28542,132,58,11,44,19,0,7,0,0,0,0,0,0,0,0,0,0,0,0,0,0,7,7,0,0,7,0,0,0,0,0,0,0,0,0,83281
28543,67,0,18,26,23,0,2,2,2,0,0,2,0,0,0,0,0,0,0,0,0,0,0,0,0,0,0,0,0,0,0,0,0,0,0,83283
28544,106,13,21,23,41,8,21,16,16,16,0,0,0,0,0,0,0,0,0,0,0,5,5,5,0,0,0,0,0,0,0,0,0,0,0,83285
28545,758,20,226,359,131,22,84,47,33,4,0,29,14,14,12,0,2,0,0,0,0,37,30,14,2,14,7,2,2,0,0,5,0,0,5,83286
28546,251,25,55,67,79,25,0,0,0,0,0,0,0,0,0,0,0,0,0,0,0,0,0,0,0,0,0,0,0,0,0,0,0,0,0,83287
28547,32692,4600,9371,12716,4282,1723,3122,1533,1238,262,116,860,295,186,165,21,0,109,0,31,78,1589,1309,368,143,798,280,200,138,31,31,80,47,0,33,83301
28548,54,9,13,20,7,5,0,0,0,0,0,0,0,0,0,0,0,0,0,0,0,0,0,0,0,0,0,0,0,0,0,0,0,0,0,83302
28549,273,19,69,144,17,24,42,25,17,3,0,14,8,8,3,0,5,0,0,0,0,17,15,6,0,9,2,2,0,2,0,0,0,0,0,83311
28550,80,0,33,16,31,0,4,4,4,0,0,4,0,0,0,0,0,0,0,0,0,0,0,0,0,0,0,0,0,0,0,0,0,0,0,83312
28551,2266,418,640,716,389,103,265,168,124,50,25,49,44,6,6,0,0,38,38,0,0,97,70,19,28,23,27,27,20,7,0,0,0,0,0,83313
28552,625,137,207,174,41,66,45,30,26,7,0,19,4,0,0,0,0,4,0,0,4,15,11,0,0,11,4,0,0,0,0,4,0,0,4,83314
28553,6740,1786,2156,2060,560,178,517,282,185,30,50,105,97,69,40,0,29,28,23,0,5,235,155,34,0,121,80,5,5,0,0,75,31,13,31,83316
28554,10088,2251,2581,3700,1078,478,1108,629,470,156,34,280,159,115,65,20,30,44,33,11,0,479,416,144,63,209,63,63,0,63,0,0,0,0,0,83318
28555,527,13,129,310,55,20,76,55,55,13,0,42,0,0,0,0,0,0,0,0,0,21,21,0,0,21,0,0,0,0,0,0,0,0,0,83320
28556,420,104,143,126,31,16,19,6,6,0,0,6,0,0,0,0,0,0,0,0,0,13,9,0,0,9,4,0,0,0,0,4,0,0,4,83321
28557,47,4,8,17,18,0,0,0,0,0,0,0,0,0,0,0,0,0,0,0,0,0,0,0,0,0,0,0,0,0,0,0,0,0,0,83322
28558,1133,283,429,268,113,40,186,82,82,16,40,26,0,0,0,0,0,0,0,0,0,104,72,34,0,38,32,32,32,0,0,0,0,0,0,83323
28559,460,118,137,162,28,15,32,16,13,8,0,5,3,3,3,0,0,0,0,0,0,16,16,10,0,6,0,0,0,0,0,0,0,0,0,83324
28560,563,52,188,238,60,25,52,30,0,0,0,0,30,26,26,0,0,4,4,0,0,22,9,0,0,9,13,13,13,0,0,0,0,0,0,83325
28561,786,127,228,257,133,41,110,81,74,10,5,59,7,0,0,0,0,7,0,7,0,29,22,4,0,18,7,7,7,0,0,0,0,0,0,83327
28562,3510,587,1165,1410,259,89,200,64,39,2,6,31,25,8,0,8,0,17,9,0,8,136,129,9,17,103,7,7,0,2,5,0,0,0,0,83328
28563,4053,910,1228,1409,313,193,381,201,180,58,37,85,21,20,20,0,0,1,0,0,1,180,141,41,0,100,39,0,0,0,0,39,0,0,39,83330
28564,1842,325,647,600,176,94,141,41,35,0,0,35,6,6,0,6,0,0,0,0,0,100,87,30,0,57,13,13,13,0,0,0,0,0,0,83332
28565,7406,650,1037,2445,2361,913,399,174,174,90,0,84,0,0,0,0,0,0,0,0,0,225,111,85,0,26,114,12,12,0,0,102,102,0,0,83333
28566,1325,285,414,476,110,40,117,55,50,3,4,43,5,5,3,2,0,0,0,0,0,62,58,11,8,39,4,4,4,0,0,0,0,0,0,83334
28567,1153,254,250,517,98,34,144,82,56,4,0,52,26,17,17,0,0,9,9,0,0,62,42,7,4,31,20,6,0,0,6,14,6,0,8,83335
28568,2802,648,826,1056,179,93,283,138,126,67,0,59,12,12,0,12,0,0,0,0,0,145,118,26,0,92,27,21,6,0,15,6,3,0,3,83336
28569,27,0,12,15,0,0,0,0,0,0,0,0,0,0,0,0,0,0,0,0,0,0,0,0,0,0,0,0,0,0,0,0,0,0,0,83337
28570,11605,3673,3211,3143,1212,366,1123,594,395,72,23,300,199,177,158,17,2,22,21,0,1,529,326,110,40,176,203,83,37,0,46,120,0,0,120,83338
28571,3469,256,445,737,1606,425,15,4,4,4,0,0,0,0,0,0,0,0,0,0,0,11,11,0,0,11,0,0,0,0,0,0,0,0,0,83340
28572,4032,503,966,1872,408,283,537,236,229,33,69,127,7,0,0,0,0,7,0,0,7,301,292,125,47,120,9,9,9,0,0,0,0,0,0,83341
28573,848,148,131,386,148,35,73,66,58,16,0,42,8,0,0,0,0,8,8,0,0,7,7,4,0,3,0,0,0,0,0,0,0,0,0,83342
28574,580,199,121,198,57,5,66,11,5,4,0,1,6,3,0,0,3,3,3,0,0,55,26,5,0,21,29,0,0,0,0,29,17,0,12,83344
28575,929,166,249,346,143,25,55,14,14,0,6,8,0,0,0,0,0,0,0,0,0,41,37,15,5,17,4,0,0,0,0,4,0,0,4,83346
28576,2166,382,724,818,192,50,187,62,45,13,6,26,17,8,8,0,0,9,9,0,0,125,78,42,25,11,47,29,23,6,0,18,0,18,0,83347
28577,96,27,22,23,18,6,0,0,0,0,0,0,0,0,0,0,0,0,0,0,0,0,0,0,0,0,0,0,0,0,0,0,0,0,0,83348
28578,665,145,241,226,35,18,61,23,23,10,6,7,0,0,0,0,0,0,0,0,0,38,38,7,2,29,0,0,0,0,0,0,0,0,0,83349
28579,7757,2094,2664,2233,424,342,738,446,322,67,20,235,124,98,93,0,5,26,5,0,21,292,233,98,16,119,59,54,37,0,17,5,5,0,0,83350
28580,2045,527,727,503,189,99,158,85,73,11,13,49,12,0,0,0,0,12,9,3,0,73,65,8,10,47,8,8,4,0,4,0,0,0,0,83352
28581,1051,22,63,229,423,314,29,28,12,3,0,9,16,16,10,0,6,0,0,0,0,1,1,1,0,0,0,0,0,0,0,0,0,0,0,83353
28582,13,0,6,0,0,7,0,0,0,0,0,0,0,0,0,0,0,0,0,0,0,0,0,0,0,0,0,0,0,0,0,0,0,0,0,83354
28583,3037,1054,865,839,208,71,231,62,58,0,0,58,4,0,0,0,0,4,0,0,4,169,147,52,0,95,22,18,17,0,1,4,0,0,4,83355
28584,22981,2390,7127,8310,3657,1497,2379,1076,697,229,142,326,379,194,67,112,15,185,69,24,92,1303,1072,495,76,501,231,126,82,13,31,105,41,0,64,83401
28585,16256,2223,4564,5965,2380,1124,1273,844,716,213,13,490,128,101,101,0,0,27,27,0,0,429,379,141,95,143,50,50,25,0,25,0,0,0,0,83402
28586,14046,674,3237,5346,3257,1532,1299,613,548,219,0,329,65,52,30,20,2,13,12,0,1,686,618,300,24,294,68,58,40,18,0,10,0,0,10,83404
28587,8705,515,2073,3308,1997,812,985,543,417,119,52,246,126,100,74,0,26,26,6,0,20,442,379,122,29,228,63,52,52,0,0,11,11,0,0,83406
28588,296,0,70,112,77,37,0,0,0,0,0,0,0,0,0,0,0,0,0,0,0,0,0,0,0,0,0,0,0,0,0,0,0,0,0,83414
28589,1762,234,533,592,293,110,105,44,29,0,0,29,15,8,8,0,0,7,0,0,7,61,56,31,0,25,5,5,5,0,0,0,0,0,0,83420
28590,231,16,116,80,0,19,0,0,0,0,0,0,0,0,0,0,0,0,0,0,0,0,0,0,0,0,0,0,0,0,0,0,0,0,0,83421
28591,2313,234,435,720,700,224,230,84,84,14,14,56,0,0,0,0,0,0,0,0,0,146,146,60,5,81,0,0,0,0,0,0,0,0,0,83422
28592,427,130,116,130,24,27,51,35,8,0,0,8,27,7,7,0,0,20,13,0,7,16,11,0,0,11,5,5,5,0,0,0,0,0,0,83423
28593,78,0,35,0,43,0,0,0,0,0,0,0,0,0,0,0,0,0,0,0,0,0,0,0,0,0,0,0,0,0,0,0,0,0,0,83424
28594,467,46,142,190,70,19,74,28,25,25,0,0,3,3,3,0,0,0,0,0,0,46,34,21,0,13,12,12,0,2,10,0,0,0,0,83425
28595,751,109,187,310,107,38,137,38,29,11,0,18,9,9,0,0,9,0,0,0,0,99,88,9,0,79,11,5,5,0,0,6,0,0,6,83427
28596,255,21,123,91,19,1,9,9,3,3,0,0,6,6,0,6,0,0,0,0,0,0,0,0,0,0,0,0,0,0,0,0,0,0,0,83428
28597,755,12,156,218,228,141,38,38,38,33,0,5,0,0,0,0,0,0,0,0,0,0,0,0,0,0,0,0,0,0,0,0,0,0,0,83429
28598,527,109,179,160,59,20,23,6,6,0,0,6,0,0,0,0,0,0,0,0,0,17,17,5,0,12,0,0,0,0,0,0,0,0,0,83431
28599,6,0,0,6,0,0,0,0,0,0,0,0,0,0,0,0,0,0,0,0,0,0,0,0,0,0,0,0,0,0,0,0,0,0,0,83433
28600,1137,123,370,342,206,96,150,65,32,19,0,13,33,3,3,0,0,30,23,0,7,85,69,17,0,52,16,2,2,0,0,14,0,0,14,83434
28601,294,39,106,133,13,3,29,21,18,7,0,11,3,3,3,0,0,0,0,0,0,8,8,8,0,0,0,0,0,0,0,0,0,0,0,83435
28602,229,28,64,91,38,8,5,5,5,0,0,5,0,0,0,0,0,0,0,0,0,0,0,0,0,0,0,0,0,0,0,0,0,0,0,83436
28603,14074,694,2140,6586,3151,1503,3645,1239,1148,312,140,696,91,80,76,0,4,11,7,0,4,2406,2307,677,363,1267,99,99,30,39,30,0,0,0,0,83440
28604,10976,821,3004,4518,2015,618,931,487,368,88,88,192,119,79,45,0,34,40,40,0,0,444,419,195,28,196,25,14,0,0,14,11,11,0,0,83442
28605,645,145,238,203,39,20,58,24,24,0,0,24,0,0,0,0,0,0,0,0,0,34,10,3,0,7,24,24,24,0,0,0,0,0,0,83443
28606,688,226,217,174,67,4,111,61,54,19,2,33,7,7,0,7,0,0,0,0,0,50,23,4,0,19,27,27,4,23,0,0,0,0,0,83444
28607,4107,549,1373,1544,469,172,419,250,200,43,0,157,50,43,6,6,31,7,7,0,0,169,134,26,15,93,35,25,13,0,12,10,0,0,10,83445
28608,33,7,12,10,4,0,0,0,0,0,0,0,0,0,0,0,0,0,0,0,0,0,0,0,0,0,0,0,0,0,0,0,0,0,0,83446
28609,1228,105,280,415,280,148,153,78,60,28,0,32,18,15,8,7,0,3,0,0,3,75,62,11,16,35,13,13,0,13,0,0,0,0,0,83448
28610,141,0,55,59,16,11,7,0,0,0,0,0,0,0,0,0,0,0,0,0,0,7,7,0,0,7,0,0,0,0,0,0,0,0,0,83449
28611,567,143,146,169,72,37,59,25,21,7,0,14,4,4,4,0,0,0,0,0,0,34,28,5,0,23,6,6,4,2,0,0,0,0,0,83450
28612,569,104,218,189,40,18,22,10,10,7,0,3,0,0,0,0,0,0,0,0,0,12,4,0,0,4,8,8,0,8,0,0,0,0,0,83451
28613,660,134,173,192,140,21,23,22,9,0,0,9,13,13,0,13,0,0,0,0,0,1,1,0,0,1,0,0,0,0,0,0,0,0,0,83452
28614,328,25,119,128,39,17,21,3,3,0,0,3,0,0,0,0,0,0,0,0,0,18,5,5,0,0,13,13,13,0,0,0,0,0,0,83454
28615,3478,428,815,1120,757,358,379,258,186,36,11,139,72,68,68,0,0,4,0,4,0,121,98,70,0,28,23,6,6,0,0,17,0,12,5,83455
28616,33,0,0,33,0,0,643,150,150,13,9,128,0,0,0,0,0,0,0,0,0,493,493,76,22,395,0,0,0,0,0,0,0,0,0,83460
28617,392,55,72,165,90,10,69,24,24,0,0,24,0,0,0,0,0,0,0,0,0,45,45,0,0,45,0,0,0,0,0,0,0,0,0,83462
28618,81,0,33,48,0,0,0,0,0,0,0,0,0,0,0,0,0,0,0,0,0,0,0,0,0,0,0,0,0,0,0,0,0,0,0,83463
28619,254,19,114,85,21,15,9,0,0,0,0,0,0,0,0,0,0,0,0,0,0,9,4,4,0,0,5,5,0,0,5,0,0,0,0,83464
28620,99,0,21,31,40,7,8,6,6,6,0,0,0,0,0,0,0,0,0,0,0,2,2,0,0,2,0,0,0,0,0,0,0,0,0,83465
28621,227,26,36,138,20,7,13,13,13,0,0,13,0,0,0,0,0,0,0,0,0,0,0,0,0,0,0,0,0,0,0,0,0,0,0,83466
28622,4626,463,1429,1607,829,298,313,170,40,16,0,24,130,101,84,10,7,29,29,0,0,143,91,45,0,46,52,52,1,51,0,0,0,0,0,83467
28623,126,0,67,20,19,20,10,5,5,0,0,5,0,0,0,0,0,0,0,0,0,5,5,0,0,5,0,0,0,0,0,0,0,0,0,83468
28624,43,0,0,27,0,16,0,0,0,0,0,0,0,0,0,0,0,0,0,0,0,0,0,0,0,0,0,0,0,0,0,0,0,0,0,83469
28625,23464,2240,7491,8642,3505,1586,1787,879,620,236,67,317,259,204,109,71,24,55,0,0,55,908,750,339,72,339,158,142,84,37,21,16,0,0,16,83501
28626,138,13,63,47,15,0,12,0,0,0,0,0,0,0,0,0,0,0,0,0,0,12,12,12,0,0,0,0,0,0,0,0,0,0,0,83520
28627,1669,168,722,478,222,79,222,104,38,6,4,28,66,44,11,31,2,22,17,0,5,118,118,26,11,81,0,0,0,0,0,0,0,0,0,83522
28628,520,39,177,180,98,26,19,11,11,0,0,11,0,0,0,0,0,0,0,0,0,8,8,3,0,5,0,0,0,0,0,0,0,0,0,83523
28629,742,103,256,260,74,49,46,15,8,0,0,8,7,6,5,0,1,1,0,1,0,31,23,0,4,19,8,5,5,0,0,3,0,3,0,83524
28630,417,79,159,137,13,29,1,1,1,0,0,1,0,0,0,0,0,0,0,0,0,0,0,0,0,0,0,0,0,0,0,0,0,0,0,83525
28631,248,44,99,68,33,4,20,15,15,0,6,9,0,0,0,0,0,0,0,0,0,5,5,0,1,4,0,0,0,0,0,0,0,0,0,83526
28632,4026,418,1603,1540,371,94,96,64,45,13,0,32,19,19,18,0,1,0,0,0,0,32,17,17,0,0,15,15,15,0,0,0,0,0,0,83530
28633,81,4,44,20,13,0,0,0,0,0,0,0,0,0,0,0,0,0,0,0,0,0,0,0,0,0,0,0,0,0,0,0,0,0,0,83533
28634,811,77,232,310,146,46,61,36,29,0,0,29,7,7,0,7,0,0,0,0,0,25,25,15,0,10,0,0,0,0,0,0,0,0,0,83535
28635,2903,364,1138,979,359,63,186,87,41,3,0,38,46,34,30,4,0,12,0,12,0,99,72,22,0,50,27,26,17,4,5,1,0,0,1,83536
28636,826,111,283,287,79,66,50,36,36,0,0,36,0,0,0,0,0,0,0,0,0,14,14,4,5,5,0,0,0,0,0,0,0,0,0,83537
28637,1583,254,679,485,114,51,112,48,43,0,0,43,5,5,5,0,0,0,0,0,0,64,48,5,0,43,16,16,16,0,0,0,0,0,0,83539
28638,1473,252,413,589,164,55,116,50,41,3,1,37,9,8,0,8,0,1,0,0,1,66,36,5,0,31,30,30,18,12,0,0,0,0,0,83540
28639,798,59,219,343,113,64,13,0,0,0,0,0,0,0,0,0,0,0,0,0,0,13,11,0,0,11,2,2,0,0,2,0,0,0,0,83541
28640,120,6,40,57,10,7,10,10,10,10,0,0,0,0,0,0,0,0,0,0,0,0,0,0,0,0,0,0,0,0,0,0,0,0,0,83542
28641,463,11,136,219,79,18,61,49,37,7,2,28,12,0,0,0,0,12,0,0,12,12,8,0,2,6,4,0,0,0,0,4,4,0,0,83543
28642,4542,658,1653,1542,483,206,213,104,92,0,6,86,12,8,8,0,0,4,4,0,0,109,83,25,7,51,26,20,13,0,7,6,0,0,6,83544
28643,438,67,170,139,46,16,21,21,18,9,0,9,3,1,0,1,0,2,0,1,1,0,0,0,0,0,0,0,0,0,0,0,0,0,0,83545
28644,597,118,239,136,69,35,32,17,17,0,0,17,0,0,0,0,0,0,0,0,0,15,15,3,0,12,0,0,0,0,0,0,0,0,0,83546
28645,173,12,81,27,41,12,25,6,6,6,0,0,0,0,0,0,0,0,0,0,0,19,19,19,0,0,0,0,0,0,0,0,0,0,0,83547
28646,91,3,32,30,18,8,6,5,5,5,0,0,0,0,0,0,0,0,0,0,0,1,1,0,0,1,0,0,0,0,0,0,0,0,0,83548
28647,676,98,279,190,70,39,26,14,9,6,0,3,5,5,5,0,0,0,0,0,0,12,12,12,0,0,0,0,0,0,0,0,0,0,0,83549
28648,682,76,323,184,83,16,125,97,88,0,55,33,9,9,9,0,0,0,0,0,0,28,23,0,1,22,5,5,5,0,0,0,0,0,0,83552
28649,825,172,360,178,88,27,17,11,3,0,0,3,8,2,2,0,0,6,0,6,0,6,6,0,0,6,0,0,0,0,0,0,0,0,0,83553
28650,451,22,142,135,117,35,31,19,19,0,0,19,0,0,0,0,0,0,0,0,0,12,12,12,0,0,0,0,0,0,0,0,0,0,0,83554
28651,397,36,169,138,49,5,12,4,2,0,0,2,2,0,0,0,0,2,2,0,0,8,6,1,0,5,2,0,0,0,0,2,0,0,2,83555
28652,47,0,15,17,15,0,0,0,0,0,0,0,0,0,0,0,0,0,0,0,0,0,0,0,0,0,0,0,0,0,0,0,0,0,0,83601
28653,16,7,3,0,6,0,0,0,0,0,0,0,0,0,0,0,0,0,0,0,0,0,0,0,0,0,0,0,0,0,0,0,0,0,0,83602
28654,530,105,196,144,85,0,32,8,0,0,0,0,8,0,0,0,0,8,8,0,0,24,14,0,0,14,10,0,0,0,0,10,10,0,0,83604
28655,23040,4807,7570,7376,2440,847,2619,1403,929,171,81,677,474,382,167,155,60,92,31,0,61,1216,966,263,164,539,250,174,26,84,64,76,31,12,33,83605
28656,14176,2097,4331,5113,1821,814,1640,859,757,126,83,548,102,96,38,40,18,6,5,0,1,781,640,124,55,461,141,79,55,4,20,62,0,21,41,83607
28657,725,62,264,261,105,33,23,20,20,4,0,16,0,0,0,0,0,0,0,0,0,3,3,0,0,3,0,0,0,0,0,0,0,0,0,83610
28658,2207,303,769,711,270,154,120,38,38,0,27,11,0,0,0,0,0,0,0,0,0,82,46,0,0,46,36,24,24,0,0,12,0,0,12,83611
28659,1578,133,589,515,242,99,82,51,28,6,1,21,23,12,12,0,0,11,8,0,3,31,26,0,0,26,5,0,0,0,0,5,0,0,5,83612
28660,773,39,276,127,271,60,41,41,41,8,0,33,0,0,0,0,0,0,0,0,0,0,0,0,0,0,0,0,0,0,0,0,0,0,0,83615
28661,14834,584,2030,4960,4956,2304,1504,1008,1008,214,66,728,0,0,0,0,0,0,0,0,0,496,435,159,0,276,61,31,0,0,31,30,14,0,16,83616
28662,10667,1473,3916,3642,1213,423,908,463,349,114,110,125,114,72,0,69,3,42,0,17,25,445,382,71,43,268,63,63,45,18,0,0,0,0,0,83617
28663,4643,404,1761,1559,600,319,277,183,77,0,0,77,106,55,0,0,55,51,0,32,19,94,55,0,0,55,39,22,22,0,0,17,17,0,0,83619
28664,1080,51,471,322,135,101,54,22,12,0,0,12,10,10,0,0,10,0,0,0,0,32,32,0,10,22,0,0,0,0,0,0,0,0,0,83622
28665,1100,238,355,379,98,30,66,41,41,0,0,41,0,0,0,0,0,0,0,0,0,25,25,7,0,18,0,0,0,0,0,0,0,0,0,83623
28666,814,204,353,185,47,25,130,79,51,4,15,32,28,14,14,0,0,14,14,0,0,51,51,0,0,51,0,0,0,0,0,0,0,0,0,83624
28667,729,178,171,286,72,22,79,19,19,0,0,19,0,0,0,0,0,0,0,0,0,60,53,7,5,41,7,5,5,0,0,2,2,0,0,83626
28668,472,98,107,174,75,18,11,5,5,0,0,5,0,0,0,0,0,0,0,0,0,6,6,0,0,6,0,0,0,0,0,0,0,0,0,83627
28669,2763,819,1162,650,120,12,283,145,145,51,13,81,0,0,0,0,0,0,0,0,0,138,138,67,0,71,0,0,0,0,0,0,0,0,0,83628
28670,1253,244,427,364,151,67,136,49,32,6,6,20,17,17,0,17,0,0,0,0,0,87,65,17,20,28,22,18,7,0,11,4,0,0,4,83629
28671,883,124,262,377,94,26,26,5,5,0,5,0,0,0,0,0,0,0,0,0,0,21,19,2,0,17,2,0,0,0,0,2,0,2,0,83631
28672,216,21,90,75,14,16,3,0,0,0,0,0,0,0,0,0,0,0,0,0,0,3,3,3,0,0,0,0,0,0,0,0,0,0,0,83632
28673,235,46,71,52,52,14,12,12,12,0,0,12,0,0,0,0,0,0,0,0,0,0,0,0,0,0,0,0,0,0,0,0,0,0,0,83633
28674,16040,1644,5137,6240,2684,335,913,357,217,37,21,159,140,96,83,0,13,44,0,0,44,556,377,95,13,269,179,164,36,7,121,15,0,15,0,83634
28675,14,0,0,14,0,0,0,0,0,0,0,0,0,0,0,0,0,0,0,0,0,0,0,0,0,0,0,0,0,0,0,0,0,0,0,83636
28676,252,51,64,43,89,5,0,0,0,0,0,0,0,0,0,0,0,0,0,0,0,0,0,0,0,0,0,0,0,0,0,0,0,0,0,83637
28677,4103,129,946,1321,1314,393,421,158,157,43,0,114,1,1,0,0,1,0,0,0,0,263,185,90,2,93,78,78,78,0,0,0,0,0,0,83638
28678,1900,362,706,654,133,45,145,78,75,0,0,75,3,3,0,3,0,0,0,0,0,67,67,0,0,67,0,0,0,0,0,0,0,0,0,83639
28679,2329,528,716,788,247,50,296,215,183,12,28,143,32,31,0,31,0,1,1,0,0,81,81,10,0,71,0,0,0,0,0,0,0,0,0,83641
28680,23581,1980,5100,8937,5415,2149,1329,666,538,117,103,318,128,88,69,19,0,40,0,40,0,663,547,160,55,332,116,37,24,0,13,79,67,0,12,83642
28681,93,4,39,31,8,11,16,16,16,13,0,3,0,0,0,0,0,0,0,0,0,0,0,0,0,0,0,0,0,0,0,0,0,0,0,83643
28682,6008,651,2066,2121,826,344,573,264,208,28,35,145,56,44,20,9,15,12,0,0,12,309,177,37,39,101,132,25,14,11,0,107,0,0,107,83644
28683,463,37,184,149,67,26,10,5,5,0,3,2,0,0,0,0,0,0,0,0,0,5,5,2,0,3,0,0,0,0,0,0,0,0,0,83645
28684,30289,1396,6754,11381,7878,2880,2792,1346,882,286,132,464,464,323,230,39,54,141,29,5,107,1446,1338,403,77,858,108,108,95,13,0,0,0,0,0,83646
28685,12686,1982,3819,4785,1253,847,1170,532,348,87,64,197,184,76,10,51,15,108,64,0,44,638,410,44,36,330,228,213,32,56,125,15,0,0,15,83647
28686,1117,100,266,483,170,98,262,184,97,57,0,40,87,87,87,0,0,0,0,0,0,78,44,5,15,24,34,34,20,11,3,0,0,0,0,83648
28687,449,31,165,198,42,13,0,0,0,0,0,0,0,0,0,0,0,0,0,0,0,0,0,0,0,0,0,0,0,0,0,0,0,0,0,83650
28688,17717,3262,5584,6880,1445,546,1818,962,733,116,88,529,229,106,34,12,60,123,0,121,2,856,643,279,33,331,213,174,94,0,80,39,0,13,26,83651
28689,1164,62,406,435,148,113,51,24,23,14,4,5,1,0,0,0,0,1,0,0,1,27,27,0,24,3,0,0,0,0,0,0,0,0,0,83654
28690,2725,348,994,921,369,93,272,144,132,54,0,78,12,0,0,0,0,12,0,0,12,128,103,19,17,67,25,19,0,0,19,6,0,0,6,83655
28691,326,65,135,103,18,5,42,17,8,2,0,6,9,0,0,0,0,9,0,9,0,25,12,0,0,12,13,2,2,0,0,11,0,0,11,83656
28692,170,9,75,39,16,31,7,0,0,0,0,0,0,0,0,0,0,0,0,0,0,7,7,0,0,7,0,0,0,0,0,0,0,0,0,83657
28693,3871,850,1461,1005,365,190,357,169,167,30,0,137,2,0,0,0,0,2,2,0,0,188,181,15,24,142,7,5,5,0,0,2,0,0,2,83660
28694,5974,1162,2020,2019,520,253,359,205,177,53,0,124,28,16,16,0,0,12,12,0,0,154,130,40,0,90,24,9,0,9,0,15,0,12,3,83661
28695,21,2,3,7,7,2,0,0,0,0,0,0,0,0,0,0,0,0,0,0,0,0,0,0,0,0,0,0,0,0,0,0,0,0,0,83666
28696,4960,302,1117,2147,1028,366,428,310,237,39,33,165,73,46,19,0,27,27,0,15,12,118,105,29,6,70,13,0,0,0,0,13,0,13,0,83669
28697,376,42,169,81,81,3,23,12,12,0,0,12,0,0,0,0,0,0,0,0,0,11,0,0,0,0,11,11,11,0,0,0,0,0,0,83670
28698,10,0,0,0,10,0,0,0,0,0,0,0,0,0,0,0,0,0,0,0,0,0,0,0,0,0,0,0,0,0,0,0,0,0,0,83671
28699,5942,1199,1714,2065,659,305,558,285,237,40,12,185,48,8,8,0,0,40,0,21,19,273,231,21,65,145,42,29,11,18,0,13,0,0,13,83672
28700,2714,710,1059,641,202,102,231,134,93,3,3,87,41,10,10,0,0,31,0,31,0,97,78,7,8,63,19,18,10,8,0,1,0,0,1,83676
28701,115,74,19,22,0,0,0,0,0,0,0,0,0,0,0,0,0,0,0,0,0,0,0,0,0,0,0,0,0,0,0,0,0,0,0,83677
28702,27875,3836,8301,9264,4339,2135,2922,1426,960,115,174,671,466,261,89,78,94,205,40,59,106,1496,1262,435,164,663,234,215,131,65,19,19,0,10,9,83686
28703,16633,3196,5057,5877,1921,582,1545,831,590,85,60,445,241,179,0,5,174,62,0,0,62,714,569,164,24,381,145,66,40,0,26,79,43,10,26,83687
28704,16216,908,2579,4538,4510,3681,936,393,350,94,33,223,43,14,13,0,1,29,0,0,29,543,461,140,15,306,82,50,48,0,2,32,11,0,21,83702
28705,11716,586,2128,4015,3041,1946,559,278,215,60,36,119,63,63,20,25,18,0,0,0,0,281,248,67,0,181,33,33,33,0,0,0,0,0,0,83703
28706,26784,2117,7206,10522,4788,2151,2619,1529,1313,303,77,933,216,109,56,18,35,107,35,17,55,1090,841,202,128,511,249,162,162,0,0,87,87,0,0,83704
28707,18631,1655,4837,7126,3825,1188,839,322,266,18,0,248,56,44,44,0,0,12,12,0,0,517,409,133,29,247,108,64,43,21,0,44,11,0,33,83705
28708,19293,650,3363,6273,5596,3411,2885,1415,1275,318,167,790,140,129,102,0,27,11,0,0,11,1470,1361,561,106,694,109,109,52,17,40,0,0,0,0,83706
28709,34158,1961,7781,14159,7227,3030,2561,1395,1238,380,150,708,157,127,57,45,25,30,26,4,0,1166,1088,281,217,590,78,78,52,20,6,0,0,0,0,83709
28710,5929,304,508,1352,2092,1673,373,199,199,72,0,127,0,0,0,0,0,0,0,0,0,174,174,23,0,151,0,0,0,0,0,0,0,0,0,83712
28711,17483,1303,3989,5489,4677,2025,1276,514,442,167,0,275,72,72,72,0,0,0,0,0,0,762,685,119,77,489,77,22,22,0,0,55,0,0,55,83713
28712,13778,1149,2898,4682,3260,1789,828,421,315,63,69,183,106,85,85,0,0,21,0,21,0,407,346,68,103,175,61,40,40,0,0,21,0,0,21,83714
28713,10065,400,1732,3070,3096,1767,943,469,441,110,0,331,28,17,17,0,0,11,11,0,0,474,450,169,63,218,24,24,12,0,12,0,0,0,0,83716
28714,4056,261,1218,1731,523,323,437,196,193,18,23,152,3,3,3,0,0,0,0,0,0,241,218,55,53,110,23,23,23,0,0,0,0,0,0,83801
28715,119,7,21,76,15,0,81,33,33,0,0,33,0,0,0,0,0,0,0,0,0,48,48,0,0,48,0,0,0,0,0,0,0,0,0,83802
28716,465,105,114,174,44,28,23,23,8,0,8,0,15,0,0,0,0,15,0,0,15,0,0,0,0,0,0,0,0,0,0,0,0,0,0,83803
28717,996,157,326,400,81,32,53,31,31,0,0,31,0,0,0,0,0,0,0,0,0,22,22,0,4,18,0,0,0,0,0,0,0,0,0,83804
28718,5739,877,2069,1859,533,401,513,224,194,79,0,115,30,9,9,0,0,21,0,0,21,289,199,43,5,151,90,19,8,0,11,71,0,0,71,83805
28719,141,38,40,53,10,0,22,18,7,0,0,7,11,11,11,0,0,0,0,0,0,4,4,0,0,4,0,0,0,0,0,0,0,0,0,83806
28720,102,22,45,32,2,1,10,0,0,0,0,0,0,0,0,0,0,0,0,0,0,10,10,0,0,10,0,0,0,0,0,0,0,0,0,83808
28721,224,0,136,72,16,0,16,16,16,0,0,16,0,0,0,0,0,0,0,0,0,0,0,0,0,0,0,0,0,0,0,0,0,0,0,83809
28722,1048,98,473,288,101,88,102,55,55,27,0,28,0,0,0,0,0,0,0,0,0,47,22,5,0,17,25,25,0,0,25,0,0,0,0,83810
28723,942,114,305,315,158,50,87,45,31,5,0,26,14,6,0,0,6,8,0,0,8,42,42,7,0,35,0,0,0,0,0,0,0,0,0,83811
28724,73,31,14,14,14,0,15,15,15,0,0,15,0,0,0,0,0,0,0,0,0,0,0,0,0,0,0,0,0,0,0,0,0,0,0,83812
28725,560,120,114,221,99,6,0,0,0,0,0,0,0,0,0,0,0,0,0,0,0,0,0,0,0,0,0,0,0,0,0,0,0,0,0,83813
28726,17174,1305,4494,6239,3561,1575,1014,464,348,128,19,201,116,71,63,0,8,45,0,0,45,550,445,158,56,231,105,72,56,16,0,33,0,0,33,83814
28727,20187,1901,5952,7816,3260,1258,1598,771,702,123,96,483,69,47,30,12,5,22,11,0,11,827,655,153,45,457,172,106,51,55,0,66,0,55,11,83815
28728,293,6,109,59,66,53,16,16,16,0,0,16,0,0,0,0,0,0,0,0,0,0,0,0,0,0,0,0,0,0,0,0,0,0,0,83821
28729,1803,234,763,644,124,38,109,89,50,0,0,50,39,39,0,0,39,0,0,0,0,20,20,0,0,20,0,0,0,0,0,0,0,0,0,83822
28730,1089,71,465,321,197,35,36,17,17,3,3,11,0,0,0,0,0,0,0,0,0,19,19,7,0,12,0,0,0,0,0,0,0,0,0,83823
28731,202,23,61,103,12,3,23,7,7,0,0,7,0,0,0,0,0,0,0,0,0,16,16,8,0,8,0,0,0,0,0,0,0,0,0,83824
28732,196,15,32,67,47,35,15,9,0,0,0,0,9,0,0,0,0,9,0,0,9,6,0,0,0,0,6,0,0,0,0,6,6,0,0,83825
28733,0,0,0,0,0,0,0,0,0,0,0,0,0,0,0,0,0,0,0,0,0,0,0,0,0,0,0,0,0,0,0,0,0,0,0,83826
28734,89,17,25,29,18,0,0,0,0,0,0,0,0,0,0,0,0,0,0,0,0,0,0,0,0,0,0,0,0,0,0,0,0,0,0,83827
28735,685,66,323,182,58,56,39,39,39,0,0,39,0,0,0,0,0,0,0,0,0,0,0,0,0,0,0,0,0,0,0,0,0,0,0,83830
28736,1010,25,208,380,285,112,72,53,53,8,0,45,0,0,0,0,0,0,0,0,0,19,19,8,2,9,0,0,0,0,0,0,0,0,0,83832
28737,872,96,235,240,192,109,11,7,7,4,0,3,0,0,0,0,0,0,0,0,0,4,4,0,4,0,0,0,0,0,0,0,0,0,0,83833
28738,185,7,91,70,9,8,20,10,10,0,0,10,0,0,0,0,0,0,0,0,0,10,0,0,0,0,10,10,10,0,0,0,0,0,0,83834
28739,13957,965,3609,5564,2630,1189,944,624,542,137,116,289,82,67,52,15,0,15,15,0,0,320,270,89,78,103,50,50,39,0,11,0,0,0,0,83835
28740,760,35,126,471,63,65,38,29,29,0,2,27,0,0,0,0,0,0,0,0,0,9,9,0,0,9,0,0,0,0,0,0,0,0,0,83836
28741,2094,383,582,766,308,55,202,124,92,19,0,73,32,32,4,4,24,0,0,0,0,78,68,14,6,48,10,10,3,0,7,0,0,0,0,83837
28742,877,149,260,349,57,62,0,0,0,0,0,0,0,0,0,0,0,0,0,0,0,0,0,0,0,0,0,0,0,0,0,0,0,0,0,83839
28743,144,15,78,40,11,0,5,3,0,0,0,0,3,3,0,0,3,0,0,0,0,2,0,0,0,0,2,0,0,0,0,2,0,0,2,83840
28744,171,66,54,0,0,51,0,0,0,0,0,0,0,0,0,0,0,0,0,0,0,0,0,0,0,0,0,0,0,0,0,0,0,0,0,83841
28745,108,8,26,43,28,3,0,0,0,0,0,0,0,0,0,0,0,0,0,0,0,0,0,0,0,0,0,0,0,0,0,0,0,0,0,83842
28746,13583,389,1922,4036,4093,3143,2260,1225,1091,221,97,773,134,101,53,30,18,33,12,0,21,1035,972,280,53,639,63,40,22,18,0,23,23,0,0,83843
28747,40,0,9,31,0,0,1039,473,473,98,24,351,0,0,0,0,0,0,0,0,0,566,566,213,38,315,0,0,0,0,0,0,0,0,0,83844
28748,1051,174,351,383,105,38,67,61,45,0,0,45,16,16,0,0,16,0,0,0,0,6,6,0,0,6,0,0,0,0,0,0,0,0,0,83845
28749,505,61,195,189,54,6,23,8,2,0,2,0,6,6,0,0,6,0,0,0,0,15,15,6,0,9,0,0,0,0,0,0,0,0,0,83846
28750,717,84,380,177,56,20,26,26,14,0,0,14,12,0,0,0,0,12,0,12,0,0,0,0,0,0,0,0,0,0,0,0,0,0,0,83847
28751,187,5,43,58,77,4,0,0,0,0,0,0,0,0,0,0,0,0,0,0,0,0,0,0,0,0,0,0,0,0,0,0,0,0,0,83848
28752,1353,127,546,516,118,46,85,62,50,8,25,17,12,12,0,12,0,0,0,0,0,23,13,0,0,13,10,10,10,0,0,0,0,0,0,83849
28753,1460,240,555,509,106,50,146,83,61,14,0,47,22,13,13,0,0,9,0,9,0,63,48,12,0,36,15,15,15,0,0,0,0,0,0,83850
28754,970,121,360,325,110,54,88,26,19,9,0,10,7,3,3,0,0,4,2,2,0,62,58,42,6,10,4,4,4,0,0,0,0,0,0,83851
28755,658,50,230,226,142,10,65,30,0,0,0,0,30,14,0,0,14,16,0,0,16,35,3,0,0,3,32,32,28,0,4,0,0,0,0,83852
28756,24637,1622,7468,10727,3238,1582,2073,989,714,167,72,475,275,214,144,13,57,61,0,24,37,1084,843,356,48,439,241,158,98,42,18,83,0,27,56,83854
28757,1536,190,532,481,209,124,77,52,33,14,0,19,19,19,7,0,12,0,0,0,0,25,9,0,0,9,16,13,8,5,0,3,0,3,0,83855
28758,4452,680,1492,1549,548,183,166,106,38,15,0,23,68,52,30,0,22,16,16,0,0,60,43,3,0,40,17,14,14,0,0,3,0,0,3,83856
28759,436,28,174,126,70,38,9,0,0,0,0,0,0,0,0,0,0,0,0,0,0,9,9,0,0,9,0,0,0,0,0,0,0,0,0,83857
28760,9210,824,3263,3503,1133,487,902,597,518,189,36,293,79,79,70,0,9,0,0,0,0,305,256,153,0,103,49,49,27,0,22,0,0,0,0,83858
28761,4125,300,1081,1753,694,297,293,210,200,79,0,121,10,10,0,0,10,0,0,0,0,83,41,13,8,20,42,42,0,0,42,0,0,0,0,83860
28762,4780,608,2092,1481,391,208,385,235,159,41,5,113,76,54,51,0,3,22,0,18,4,150,101,29,4,68,49,46,33,13,0,3,0,3,0,83861
28763,12548,805,3758,4855,2090,1040,823,330,311,57,22,232,19,4,0,0,4,15,15,0,0,493,404,126,0,278,89,64,57,0,7,25,25,0,0,83864
28764,70,0,70,0,0,0,0,0,0,0,0,0,0,0,0,0,0,0,0,0,0,0,0,0,0,0,0,0,0,0,0,0,0,0,0,83866
28765,502,46,175,168,75,38,0,0,0,0,0,0,0,0,0,0,0,0,0,0,0,0,0,0,0,0,0,0,0,0,0,0,0,0,0,83867
28766,486,75,147,231,22,11,52,0,0,0,0,0,0,0,0,0,0,0,0,0,0,52,52,8,0,44,0,0,0,0,0,0,0,0,0,83868
28767,2671,266,967,1051,309,78,196,99,99,47,0,52,0,0,0,0,0,0,0,0,0,97,91,13,5,73,6,6,5,0,1,0,0,0,0,83869
28768,201,29,60,69,34,9,5,2,2,0,0,2,0,0,0,0,0,0,0,0,0,3,3,0,3,0,0,0,0,0,0,0,0,0,0,83870
28769,1396,58,397,509,251,181,94,58,57,5,26,26,1,1,1,0,0,0,0,0,0,36,36,8,6,22,0,0,0,0,0,0,0,0,0,83871
28770,566,29,142,134,148,113,60,49,49,0,0,49,0,0,0,0,0,0,0,0,0,11,11,0,0,11,0,0,0,0,0,0,0,0,0,83872
28771,1489,207,499,579,135,69,70,50,8,0,0,8,42,3,3,0,0,39,0,0,39,20,20,0,0,20,0,0,0,0,0,0,0,0,0,83873
28772,93,46,0,47,0,0,0,0,0,0,0,0,0,0,0,0,0,0,0,0,0,0,0,0,0,0,0,0,0,0,0,0,0,0,0,83874
28773,1184,100,284,475,170,155,103,71,37,15,0,22,34,34,16,18,0,0,0,0,0,32,29,13,4,12,3,3,0,3,0,0,0,0,0,83876
28774,555,47,180,247,56,25,62,25,23,7,2,14,2,2,2,0,0,0,0,0,0,37,12,4,0,8,25,19,0,0,19,6,0,0,6,84001
28775,149,30,87,26,0,6,17,11,11,0,0,11,0,0,0,0,0,0,0,0,0,6,6,0,0,6,0,0,0,0,0,0,0,0,0,84002
28776,21677,881,3493,8161,5953,3189,3194,1709,1427,378,103,946,282,217,186,20,11,65,24,12,29,1485,1317,520,59,738,168,73,33,8,32,95,8,0,87,84003
28777,5275,101,499,1929,1736,1010,884,442,413,110,28,275,29,29,15,0,14,0,0,0,0,442,389,141,13,235,53,53,53,0,0,0,0,0,0,84004
28778,10050,518,1483,4909,2662,478,962,539,466,167,11,288,73,69,69,0,0,4,4,0,0,423,325,205,0,120,98,51,51,0,0,47,17,30,0,84005
28779,388,15,129,175,43,26,27,25,25,25,0,0,0,0,0,0,0,0,0,0,0,2,2,2,0,0,0,0,0,0,0,0,0,0,0,84006
28780,320,46,103,132,39,0,25,7,7,0,0,7,0,0,0,0,0,0,0,0,0,18,18,9,0,9,0,0,0,0,0,0,0,0,0,84007
28781,27823,1075,5442,10351,7210,3745,2710,1428,1132,427,64,641,296,216,191,13,12,80,40,0,40,1282,1066,553,24,489,216,146,21,24,101,70,70,0,0,84010
28782,413,30,128,218,23,14,63,13,10,3,2,5,3,3,3,0,0,0,0,0,0,50,34,20,1,13,16,16,16,0,0,0,0,0,0,84013
28783,9908,362,1837,3594,2851,1264,919,521,439,177,0,262,82,74,36,17,21,8,8,0,0,398,353,168,24,161,45,34,24,0,10,11,5,0,6,84014
28784,34462,2579,10462,14455,5406,1560,3628,2075,1600,436,91,1073,475,394,316,57,21,81,0,42,39,1553,1252,475,79,698,301,281,223,27,31,20,18,0,2,84015
28785,2328,263,647,960,260,198,206,101,87,29,0,58,14,14,10,0,4,0,0,0,0,105,74,43,0,31,31,17,0,0,17,14,0,14,0,84017
28786,49,5,13,26,5,0,0,0,0,0,0,0,0,0,0,0,0,0,0,0,0,0,0,0,0,0,0,0,0,0,0,0,0,0,0,84018
28787,24810,972,4762,9170,6195,3711,2247,1233,1105,354,50,701,128,97,82,0,15,31,0,0,31,1014,877,303,82,492,137,110,60,50,0,27,27,0,0,84020
28788,2315,470,794,770,220,61,264,152,76,4,14,58,76,71,24,14,33,5,0,5,0,112,112,27,0,85,0,0,0,0,0,0,0,0,0,84021
28789,457,39,125,169,85,39,163,85,68,49,0,19,17,17,17,0,0,0,0,0,0,78,48,35,0,13,30,30,30,0,0,0,0,0,0,84022
28790,165,0,45,83,31,6,4,2,2,0,0,2,0,0,0,0,0,0,0,0,0,2,2,0,0,2,0,0,0,0,0,0,0,0,0,84023
28791,43,33,0,10,0,0,0,0,0,0,0,0,0,0,0,0,0,0,0,0,0,0,0,0,0,0,0,0,0,0,0,0,0,0,0,84024
28792,11051,259,1271,4265,3314,1942,1005,353,287,60,32,195,66,48,22,12,14,18,0,0,18,652,566,345,0,221,86,67,22,10,35,19,0,0,19,84025
28793,845,266,415,95,27,42,60,18,10,0,0,10,8,0,0,0,0,8,8,0,0,42,22,5,0,17,20,10,0,0,10,10,0,0,10,84026
28794,454,75,165,138,37,39,0,0,0,0,0,0,0,0,0,0,0,0,0,0,0,0,0,0,0,0,0,0,0,0,0,0,0,0,0,84027
28795,369,5,132,158,50,24,23,7,7,4,0,3,0,0,0,0,0,0,0,0,0,16,13,0,0,13,3,0,0,0,0,3,0,3,0,84028
28796,5384,421,1916,1925,884,238,585,296,253,58,10,185,43,21,21,0,0,22,22,0,0,289,289,88,35,166,0,0,0,0,0,0,0,0,0,84029
28797,171,56,52,63,0,0,12,0,0,0,0,0,0,0,0,0,0,0,0,0,0,12,9,0,0,9,3,0,0,0,0,3,0,0,3,84031
28798,10250,1183,1934,3653,2394,1086,1099,543,493,269,58,166,50,17,15,2,0,33,0,17,16,556,460,280,0,180,96,96,54,42,0,0,0,0,0,84032
28799,602,19,175,272,97,39,69,25,14,7,0,7,11,11,0,11,0,0,0,0,0,44,31,14,4,13,13,13,13,0,0,0,0,0,0,84033
28800,143,19,81,31,12,0,7,0,0,0,0,0,0,0,0,0,0,0,0,0,0,7,5,0,0,5,2,2,0,0,2,0,0,0,0,84034
28801,272,0,109,144,19,0,0,0,0,0,0,0,0,0,0,0,0,0,0,0,0,0,0,0,0,0,0,0,0,0,0,0,0,0,0,84035
28802,3712,337,1281,1349,577,168,252,143,122,48,12,62,21,6,6,0,0,15,12,0,3,109,69,60,0,9,40,40,14,0,26,0,0,0,0,84036
28803,18390,348,2903,6487,5741,2911,2228,1279,1092,540,105,447,187,157,125,0,32,30,10,13,7,949,850,356,75,419,99,90,90,0,0,9,0,0,9,84037
28804,254,22,69,109,48,6,24,5,5,1,0,4,0,0,0,0,0,0,0,0,0,19,19,14,0,5,0,0,0,0,0,0,0,0,0,84038
28805,598,44,267,210,67,10,65,41,31,10,0,21,10,10,10,0,0,0,0,0,0,24,24,13,0,11,0,0,0,0,0,0,0,0,0,84039
28806,13960,421,2609,5414,3824,1692,1750,929,700,251,63,386,229,215,132,13,70,14,0,0,14,821,751,373,108,270,70,35,0,6,29,35,22,0,13,84040
28807,25418,1781,6588,10076,5071,1902,2504,1245,1015,259,47,709,230,224,164,0,60,6,0,0,6,1259,851,355,91,405,408,310,164,49,97,98,33,0,65,84041
28808,5171,275,739,2151,1308,698,920,541,444,223,46,175,97,86,48,11,27,11,0,11,0,379,350,146,22,182,29,4,4,0,0,25,0,19,6,84042
28809,25388,1199,4734,9861,7231,2363,2729,1381,1147,391,105,651,234,134,67,25,42,100,48,7,45,1348,1225,510,93,622,123,102,66,13,23,21,0,21,0,84043
28810,15452,2850,5246,5653,1366,337,1873,1129,726,195,51,480,403,258,153,47,58,145,0,115,30,744,568,126,19,423,176,147,102,20,25,29,0,0,29,84044
28811,8511,257,1183,3382,2632,1057,993,500,378,79,18,281,122,122,83,38,1,0,0,0,0,493,425,131,47,247,68,68,35,33,0,0,0,0,0,84045
28812,425,82,159,110,59,15,18,0,0,0,0,0,0,0,0,0,0,0,0,0,0,18,17,4,0,13,1,1,1,0,0,0,0,0,0,84046
28813,20148,3098,5595,6779,3443,1233,1394,609,365,42,74,249,244,128,103,9,16,116,0,26,90,785,594,254,43,297,191,147,86,36,25,44,17,0,27,84047
28814,2955,196,540,1232,582,405,258,142,114,25,0,89,28,28,28,0,0,0,0,0,0,116,106,43,3,60,10,10,10,0,0,0,0,0,0,84049
28815,5447,127,1438,2053,1298,531,611,282,271,114,11,146,11,11,4,0,7,0,0,0,0,329,292,52,18,222,37,37,33,4,0,0,0,0,0,84050
28816,260,5,54,116,49,36,28,11,11,0,0,11,0,0,0,0,0,0,0,0,0,17,17,17,0,0,0,0,0,0,0,0,0,0,0,84051
28817,815,145,330,284,35,21,46,32,23,5,0,18,9,0,0,0,0,9,9,0,0,14,14,0,0,14,0,0,0,0,0,0,0,0,0,84052
28818,651,54,251,229,79,38,51,21,7,0,0,7,14,14,0,0,14,0,0,0,0,30,27,11,0,16,3,0,0,0,0,3,0,0,3,84053
28819,9426,698,2160,3005,2119,1444,686,429,273,158,41,74,156,156,114,0,42,0,0,0,0,257,185,144,0,41,72,60,17,0,43,12,7,5,0,84054
28820,794,4,253,294,155,88,85,46,24,8,3,13,22,22,0,0,22,0,0,0,0,39,39,17,0,22,0,0,0,0,0,0,0,0,0,84055
28821,1391,12,180,908,233,58,136,55,19,5,0,14,36,36,36,0,0,0,0,0,0,81,67,37,0,30,14,14,8,0,6,0,0,0,0,84056
28822,19778,2046,3828,7728,4550,1626,2704,1324,929,271,86,572,395,255,203,23,29,140,111,0,29,1380,1069,318,158,593,311,200,141,4,55,111,75,11,25,84057
28823,15786,1019,2268,6761,3917,1821,2806,1016,849,280,63,506,167,126,76,35,15,41,15,0,26,1790,1449,867,122,460,341,326,282,32,12,15,3,12,0,84058
28824,5479,592,514,1079,1908,1386,522,309,289,202,0,87,20,20,0,0,20,0,0,0,0,213,112,0,0,112,101,51,51,0,0,50,0,0,50,84060
28825,329,19,155,63,88,4,0,0,0,0,0,0,0,0,0,0,0,0,0,0,0,0,0,0,0,0,0,0,0,0,0,0,0,0,0,84061
28826,21790,1015,3357,8628,5990,2800,2984,1518,1197,449,200,548,321,244,125,69,50,77,35,42,0,1466,1309,544,141,624,157,112,67,14,31,45,0,0,45,84062
28827,238,106,64,40,28,0,38,17,17,0,1,16,0,0,0,0,0,0,0,0,0,21,12,0,0,12,9,0,0,0,0,9,0,0,9,84063
28828,546,24,215,218,85,4,39,18,12,6,0,6,6,6,0,0,6,0,0,0,0,21,21,18,0,3,0,0,0,0,0,0,0,0,0,84064
28829,21243,959,5251,9089,4146,1798,2911,1483,1203,455,159,589,280,244,198,0,46,36,32,0,4,1428,1336,623,125,588,92,69,46,0,23,23,2,21,0,84065
28830,6066,726,2190,2049,817,284,810,419,344,72,8,264,75,46,23,23,0,29,14,0,15,391,275,76,6,193,116,107,78,5,24,9,0,0,9,84066
28831,22680,2467,6774,9284,3094,1061,1974,1064,887,228,47,612,177,154,127,18,9,23,0,0,23,910,700,178,57,465,210,143,54,8,81,67,67,0,0,84067
28832,373,83,105,139,23,23,25,12,10,2,0,8,2,2,1,1,0,0,0,0,0,13,13,3,0,10,0,0,0,0,0,0,0,0,0,84069
28833,15878,1252,4648,5842,3035,1101,1127,548,465,283,82,100,83,76,44,24,8,7,5,0,2,579,369,210,24,135,210,151,78,34,39,59,22,3,34,84070
28834,916,130,360,352,71,3,83,42,42,5,0,37,0,0,0,0,0,0,0,0,0,41,39,15,5,19,2,2,0,2,0,0,0,0,0,84071
28835,299,34,161,82,20,2,16,7,7,0,0,7,0,0,0,0,0,0,0,0,0,9,9,3,0,6,0,0,0,0,0,0,0,0,0,84072
28836,114,4,66,44,0,0,5,5,0,0,0,0,5,5,5,0,0,0,0,0,0,0,0,0,0,0,0,0,0,0,0,0,0,0,0,84073
28837,25282,1711,7477,10774,4157,1163,2650,1351,1038,256,62,720,313,262,207,15,40,51,8,0,43,1299,1099,296,121,682,200,142,75,46,21,58,41,0,17,84074
28838,12839,269,2839,5331,3080,1320,1840,784,697,253,19,425,87,85,85,0,0,2,0,0,2,1056,953,524,46,383,103,90,78,0,12,13,0,0,13,84075
28839,203,0,79,96,15,13,21,0,0,0,0,0,0,0,0,0,0,0,0,0,0,21,21,10,0,11,0,0,0,0,0,0,0,0,0,84076
28840,15711,1959,5332,5682,2021,717,1573,866,641,271,81,289,225,127,111,0,16,98,38,31,29,707,512,203,0,309,195,114,99,11,4,81,29,41,11,84078
28841,128,5,42,59,15,7,15,14,11,1,0,10,3,3,0,3,0,0,0,0,0,1,1,0,0,1,0,0,0,0,0,0,0,0,0,84080
28842,22480,2256,5588,9109,4186,1341,2756,1413,1221,267,142,812,192,166,78,9,79,26,10,0,16,1343,1096,482,101,513,247,199,164,0,35,48,9,15,24,84081
28843,518,34,224,174,84,2,137,80,53,0,0,53,27,0,0,0,0,27,2,0,25,57,2,2,0,0,55,39,39,0,0,16,0,0,16,84082
28844,676,276,211,96,60,33,80,30,11,0,0,11,19,5,2,0,3,14,10,0,4,50,11,0,0,11,39,32,0,0,32,7,0,7,0,84083
28845,22348,2145,6270,8598,3764,1571,2077,1123,889,247,53,589,234,145,93,24,28,89,6,75,8,954,787,364,41,382,167,167,125,42,0,0,0,0,0,84084
28846,284,96,96,41,47,4,39,27,27,0,0,27,0,0,0,0,0,0,0,0,0,12,0,0,0,0,12,0,0,0,0,12,0,12,0,84085
28847,252,16,121,91,19,5,14,8,8,0,0,8,0,0,0,0,0,0,0,0,0,6,6,0,2,4,0,0,0,0,0,0,0,0,0,84086
28848,8011,169,1932,3518,1836,556,832,477,377,77,13,287,100,39,22,0,17,61,46,15,0,355,329,171,20,138,26,26,26,0,0,0,0,0,0,84087
28849,20840,1818,5963,8416,3470,1173,2478,1415,1037,328,86,623,378,216,122,26,68,162,46,65,51,1063,916,361,144,411,147,107,67,15,25,40,0,30,10,84088
28850,18675,549,3322,6352,5411,3041,2179,1070,973,365,71,537,97,61,48,12,1,36,35,0,1,1109,922,318,70,534,187,116,69,11,36,71,25,0,46,84092
28851,15410,514,2460,5217,4489,2730,1239,696,566,161,43,362,130,92,42,50,0,38,38,0,0,543,469,187,19,263,74,39,6,0,33,35,14,7,14,84093
28852,16866,700,3857,6660,3993,1656,1292,653,571,183,101,287,82,82,45,14,23,0,0,0,0,639,563,175,64,324,76,64,54,0,10,12,0,0,12,84094
28853,30568,1091,5059,12646,7809,3963,3266,2022,1751,754,101,896,271,221,79,13,129,50,11,29,10,1244,1103,416,117,570,141,131,108,0,23,10,0,0,10,84095
28854,17003,663,3394,7532,4002,1412,2038,1136,640,222,67,351,496,373,322,51,0,123,55,36,32,902,791,261,95,435,111,84,74,0,10,27,0,7,20,84096
28855,11815,424,1850,4711,3086,1744,1286,717,598,153,55,390,119,83,60,9,14,36,11,25,0,569,504,195,69,240,65,55,52,3,0,10,0,0,10,84097
28856,11528,464,1104,2871,4328,2761,923,494,409,141,39,229,85,85,47,23,15,0,0,0,0,429,398,195,0,203,31,22,14,8,0,9,9,0,0,84098
28857,3842,611,979,958,843,451,218,72,38,30,0,8,34,0,0,0,0,34,0,0,34,146,142,82,10,50,4,4,0,0,4,0,0,0,0,84101
28858,11164,545,1389,3229,3398,2603,890,410,370,97,13,260,40,30,30,0,0,10,0,10,0,480,435,136,101,198,45,29,13,0,16,16,0,6,10,84102
28859,15212,411,1619,4285,4722,4175,849,452,333,86,31,216,119,113,52,45,16,6,0,0,6,397,301,110,15,176,96,96,41,0,55,0,0,0,0,84103
28860,13935,5242,3745,3447,1201,300,1516,805,580,108,67,405,225,118,32,86,0,107,57,50,0,711,524,120,65,339,187,99,47,0,52,88,0,0,88,84104
28861,15439,918,1764,3968,5024,3765,1149,582,516,142,88,286,66,21,12,0,9,45,45,0,0,567,567,169,90,308,0,0,0,0,0,0,0,0,0,84105
28862,23737,1764,5117,7596,5907,3353,1584,840,642,146,72,424,198,129,104,12,13,69,37,0,32,744,660,278,21,361,84,80,0,0,80,4,0,4,0,84106
28863,21322,2230,4837,8161,4082,2012,1238,561,438,195,38,205,123,83,36,42,5,40,9,8,23,677,471,154,79,238,206,186,129,11,46,20,0,8,12,84107
28864,13794,335,1010,2939,4491,5019,896,446,366,107,34,225,80,80,0,49,31,0,0,0,0,450,411,241,0,170,39,39,16,10,13,0,0,0,0,84108
28865,15775,369,1887,4644,5328,3547,1212,629,485,173,10,302,144,74,70,0,4,70,26,0,44,583,536,280,18,238,47,47,25,22,0,0,0,0,0,84109
28866,7758,1395,1549,2374,1482,958,287,152,76,11,0,65,76,20,0,0,20,56,56,0,0,135,107,58,0,49,28,21,21,0,0,7,7,0,0,84111
28867,223,0,40,55,79,49,1164,632,632,248,45,339,0,0,0,0,0,0,0,0,0,532,522,213,81,228,10,0,0,0,0,10,0,0,10,84112
28868,0,0,0,0,0,0,91,32,32,11,0,21,0,0,0,0,0,0,0,0,0,59,59,23,13,23,0,0,0,0,0,0,0,0,0,84113
28869,15622,3610,3468,4538,2789,1217,1113,536,280,102,10,168,256,78,10,21,47,178,6,56,116,577,441,141,4,296,136,124,72,25,27,12,0,0,12,84115
28870,19299,5163,5909,5352,2092,783,2028,1010,671,165,44,462,339,295,189,12,94,44,8,0,36,1018,910,293,90,527,108,93,85,8,0,15,0,0,15,84116
28871,16662,687,2996,5509,4758,2712,1009,529,470,190,18,262,59,48,48,0,0,11,0,11,0,480,402,59,29,314,78,78,78,0,0,0,0,0,0,84117
28872,39246,6380,12528,14600,4421,1317,3773,1786,1344,389,202,753,442,253,176,70,7,189,82,44,63,1987,1591,495,202,894,396,220,175,10,35,176,46,19,111,84118
28873,32576,7989,9985,10537,3109,956,3241,1674,1263,475,81,707,411,259,126,61,72,152,21,86,45,1567,1243,395,197,651,324,282,175,62,45,42,0,10,32,84119
28874,28476,5741,9888,9180,2690,977,2945,1339,984,242,219,523,355,284,242,34,8,71,13,36,22,1606,1187,269,110,808,419,285,171,78,36,134,34,0,100,84120
28875,28499,1321,5001,9918,8251,4008,1943,1009,868,243,102,523,141,79,62,9,8,62,36,0,26,934,728,201,75,452,206,180,122,17,41,26,0,0,26,84121
28876,23990,3059,6163,9246,3821,1701,1549,782,662,165,120,377,120,115,80,10,25,5,5,0,0,767,599,219,80,300,168,78,78,0,0,90,42,41,7,84123
28877,14509,532,2208,4429,4202,3138,841,386,376,100,32,244,10,0,0,0,0,10,0,9,1,455,377,142,26,209,78,43,26,0,17,35,0,0,35,84124
28878,15604,2879,4386,6085,1756,498,1671,733,592,218,56,318,141,127,69,40,18,14,0,9,5,938,815,252,188,375,123,60,30,13,17,63,12,32,19,84128
28879,36,8,7,0,7,14,0,0,0,0,0,0,0,0,0,0,0,0,0,0,0,0,0,0,0,0,0,0,0,0,0,0,0,0,0,84144
28880,0,0,0,0,0,0,0,0,0,0,0,0,0,0,0,0,0,0,0,0,0,0,0,0,0,0,0,0,0,0,0,0,0,0,0,84180
28881,550,43,168,223,82,34,47,32,24,12,3,9,8,8,2,0,6,0,0,0,0,15,15,9,3,3,0,0,0,0,0,0,0,0,0,84301
28882,14280,1176,4440,5224,2408,1032,1520,837,710,271,17,422,127,124,89,14,21,3,0,0,3,683,505,192,47,266,178,97,33,31,33,81,48,0,33,84302
28883,0,0,0,0,0,0,0,0,0,0,0,0,0,0,0,0,0,0,0,0,0,0,0,0,0,0,0,0,0,0,0,0,0,0,0,84304
28884,454,13,205,150,81,5,48,31,29,11,14,4,2,2,2,0,0,0,0,0,0,17,17,12,2,3,0,0,0,0,0,0,0,0,0,84305
28885,189,0,72,42,40,35,15,0,0,0,0,0,0,0,0,0,0,0,0,0,0,15,15,15,0,0,0,0,0,0,0,0,0,0,0,84306
28886,815,60,324,269,93,69,106,68,22,22,0,0,46,46,8,0,38,0,0,0,0,38,26,0,0,26,12,4,4,0,0,8,0,0,8,84307
28887,218,29,74,79,23,13,14,7,7,1,0,6,0,0,0,0,0,0,0,0,0,7,7,1,0,6,0,0,0,0,0,0,0,0,0,84308
28888,338,27,97,163,40,11,19,8,8,4,0,4,0,0,0,0,0,0,0,0,0,11,5,2,1,2,6,6,6,0,0,0,0,0,0,84309
28889,3119,130,973,1163,625,228,278,121,121,53,0,68,0,0,0,0,0,0,0,0,0,157,124,99,0,25,33,33,0,0,33,0,0,0,0,84310
28890,504,25,197,227,26,29,89,16,14,14,0,0,2,2,0,2,0,0,0,0,0,73,68,52,8,8,5,5,2,0,3,0,0,0,0,84311
28891,2074,235,795,714,251,79,231,147,123,25,6,92,24,21,18,3,0,3,0,3,0,84,68,20,11,37,16,14,9,5,0,2,2,0,0,84312
28892,104,0,63,37,4,0,0,0,0,0,0,0,0,0,0,0,0,0,0,0,0,0,0,0,0,0,0,0,0,0,0,0,0,0,0,84313
28893,544,13,190,254,35,52,37,30,30,3,4,23,0,0,0,0,0,0,0,0,0,7,7,0,4,3,0,0,0,0,0,0,0,0,0,84314
28894,4717,267,1264,2148,696,342,511,316,304,51,0,253,12,12,12,0,0,0,0,0,0,195,181,83,0,98,14,14,14,0,0,0,0,0,0,84315
28895,148,8,98,39,2,1,12,10,8,6,0,2,2,2,2,0,0,0,0,0,0,2,2,0,0,2,0,0,0,0,0,0,0,0,0,84316
28896,1505,33,346,582,339,205,121,92,75,33,0,42,17,17,17,0,0,0,0,0,0,29,24,17,0,7,5,5,3,0,2,0,0,0,0,84317
28897,2176,51,377,752,639,357,231,110,94,51,4,39,16,16,4,6,6,0,0,0,0,121,121,59,7,55,0,0,0,0,0,0,0,0,0,84318
28898,4143,612,1323,1311,713,184,453,188,129,20,0,109,59,23,23,0,0,36,36,0,0,265,186,69,21,96,79,37,8,29,0,42,0,0,42,84319
28899,1330,106,441,466,233,84,97,56,52,26,12,14,4,4,2,2,0,0,0,0,0,41,37,31,0,6,4,4,4,0,0,0,0,0,0,84320
28900,20382,1981,3668,6931,5563,2239,4385,1849,1662,424,280,958,187,138,84,12,42,49,18,0,31,2536,2364,787,523,1054,172,172,100,40,32,0,0,0,0,84321
28901,498,24,142,170,103,59,50,19,15,3,0,12,4,4,2,0,2,0,0,0,0,31,27,2,2,23,4,4,4,0,0,0,0,0,0,84324
28902,1065,28,190,406,312,129,142,63,60,24,0,36,3,3,3,0,0,0,0,0,0,79,71,3,0,68,8,8,5,3,0,0,0,0,0,84325
28903,982,44,259,323,277,79,121,61,51,15,3,33,10,10,10,0,0,0,0,0,0,60,52,40,0,12,8,8,8,0,0,0,0,0,0,84326
28904,534,26,105,286,93,24,34,8,4,0,0,4,4,2,2,0,0,2,2,0,0,26,24,0,0,24,2,2,0,0,2,0,0,0,0,84327
28905,1006,70,278,319,171,168,127,52,52,42,0,10,0,0,0,0,0,0,0,0,0,75,61,27,0,34,14,14,9,5,0,0,0,0,0,84328
28906,97,0,49,43,5,0,0,0,0,0,0,0,0,0,0,0,0,0,0,0,0,0,0,0,0,0,0,0,0,0,0,0,0,0,0,84329
28907,308,39,172,80,16,1,28,11,11,5,6,0,0,0,0,0,0,0,0,0,0,17,17,1,7,9,0,0,0,0,0,0,0,0,0,84330
28908,172,7,82,72,10,1,20,5,5,3,0,2,0,0,0,0,0,0,0,0,0,15,9,7,0,2,6,3,3,0,0,3,3,0,0,84331
28909,4089,103,759,1337,1208,682,371,230,188,42,43,103,42,40,29,11,0,2,0,0,2,141,124,50,11,63,17,17,11,5,1,0,0,0,0,84332
28910,1592,108,499,534,352,99,159,100,79,31,2,46,21,21,20,0,1,0,0,0,0,59,54,21,6,27,5,5,2,3,0,0,0,0,0,84333
28911,198,0,0,158,40,0,0,0,0,0,0,0,0,0,0,0,0,0,0,0,0,0,0,0,0,0,0,0,0,0,0,0,0,0,0,84334
28912,6433,354,1795,2557,1216,511,841,433,281,80,47,154,152,148,103,21,24,4,0,2,2,408,354,143,4,207,54,54,28,0,26,0,0,0,0,84335
28913,177,8,81,57,30,1,31,21,21,0,0,21,0,0,0,0,0,0,0,0,0,10,10,10,0,0,0,0,0,0,0,0,0,0,0,84336
28914,6112,620,1777,2538,829,348,760,339,194,65,23,106,145,103,87,16,0,42,42,0,0,421,372,143,25,204,49,10,7,0,3,39,0,29,10,84337
28915,314,36,112,114,33,19,23,12,12,8,0,4,0,0,0,0,0,0,0,0,0,11,11,0,3,8,0,0,0,0,0,0,0,0,0,84338
28916,2636,202,721,978,504,231,350,148,141,42,14,85,7,0,0,0,0,7,0,0,7,202,182,42,4,136,20,20,15,0,5,0,0,0,0,84339
28917,1995,127,678,796,290,104,243,135,106,19,0,87,29,17,11,4,2,12,12,0,0,108,83,31,2,50,25,25,25,0,0,0,0,0,0,84340
28918,10233,576,1573,3048,2826,2210,1300,513,449,148,40,261,64,51,51,0,0,13,13,0,0,787,633,244,43,346,154,148,117,12,19,6,0,0,6,84341
28919,21164,3836,6441,6855,2832,1200,1940,930,744,171,100,473,186,83,57,9,17,103,78,5,20,1010,864,325,47,492,146,82,77,0,5,64,32,0,32,84401
28920,22433,2683,4837,8073,4381,2459,2721,1267,1127,330,108,689,140,93,47,12,34,47,13,18,16,1454,1300,549,68,683,154,122,89,0,33,32,21,0,11,84403
28921,33673,4636,11648,12346,3592,1451,2728,1543,1012,348,23,641,531,277,202,19,56,254,51,132,71,1185,871,317,42,512,314,257,146,88,23,57,8,41,8,84404
28922,18845,1231,5479,7565,3357,1213,1955,959,674,207,71,396,285,218,129,89,0,67,18,28,21,996,849,357,42,450,147,95,61,23,11,52,46,0,6,84405
28923,16255,620,3822,5898,4094,1821,1541,836,679,230,49,400,157,157,102,0,55,0,0,0,0,705,595,206,69,320,110,58,52,0,6,52,0,0,52,84414
28924,8081,1164,2200,3504,806,407,1046,575,502,254,36,212,73,43,10,30,3,30,14,0,16,471,399,155,31,213,72,54,7,38,9,18,0,0,18,84501
28925,2452,256,716,838,384,258,480,242,202,105,0,97,40,37,19,0,18,3,0,0,3,238,179,27,1,151,59,13,13,0,0,46,0,27,19,84511
28926,801,172,248,161,111,109,50,25,12,0,0,12,13,10,10,0,0,3,0,0,3,25,7,4,0,3,18,18,0,0,18,0,0,0,0,84512
28927,1136,76,344,482,148,86,106,54,49,15,0,34,5,5,5,0,0,0,0,0,0,52,43,19,10,14,9,0,0,0,0,9,0,0,9,84513
28928,0,0,0,0,0,0,0,0,0,0,0,0,0,0,0,0,0,0,0,0,0,0,0,0,0,0,0,0,0,0,0,0,0,0,0,84515
28929,97,9,38,45,5,0,3,0,0,0,0,0,0,0,0,0,0,0,0,0,0,3,3,0,0,3,0,0,0,0,0,0,0,0,0,84516
28930,456,13,127,238,70,8,95,24,17,4,0,13,7,7,7,0,0,0,0,0,0,71,40,0,0,40,31,31,0,0,31,0,0,0,0,84518
28931,891,170,306,379,33,3,23,10,10,0,0,10,0,0,0,0,0,0,0,0,0,13,13,0,3,10,0,0,0,0,0,0,0,0,0,84520
28932,395,110,123,143,16,3,20,20,13,3,0,10,7,0,0,0,0,7,0,0,7,0,0,0,0,0,0,0,0,0,0,0,0,0,0,84521
28933,224,14,82,100,22,6,43,25,23,14,0,9,2,2,2,0,0,0,0,0,0,18,4,2,0,2,14,14,0,0,14,0,0,0,0,84522
28934,1068,91,331,517,107,22,115,55,47,15,11,21,8,8,4,4,0,0,0,0,0,60,60,6,0,54,0,0,0,0,0,0,0,0,0,84523
28935,722,95,290,232,98,7,40,23,0,0,0,0,23,23,23,0,0,0,0,0,0,17,5,0,0,5,12,12,0,0,12,0,0,0,0,84525
28936,2695,323,745,1321,217,89,156,50,26,4,0,22,24,24,6,0,18,0,0,0,0,106,78,21,0,57,28,16,0,9,7,12,0,6,6,84526
28937,1638,187,481,808,127,35,155,70,29,4,0,25,41,22,11,11,0,19,7,0,12,85,68,28,15,25,17,17,17,0,0,0,0,0,0,84528
28938,87,12,27,48,0,0,0,0,0,0,0,0,0,0,0,0,0,0,0,0,0,0,0,0,0,0,0,0,0,0,0,0,0,0,0,84529
28939,269,0,79,176,0,14,31,0,0,0,0,0,0,0,0,0,0,0,0,0,0,31,31,0,0,31,0,0,0,0,0,0,0,0,0,84530
28940,400,170,159,60,11,0,52,12,6,0,0,6,6,6,6,0,0,0,0,0,0,40,32,0,0,32,8,8,0,0,8,0,0,0,0,84531
28941,6639,600,1594,2750,1175,520,562,307,141,15,11,115,166,102,102,0,0,64,0,0,64,255,234,164,6,64,21,13,0,0,13,8,0,0,8,84532
28942,120,15,32,73,0,0,48,48,48,41,7,0,0,0,0,0,0,0,0,0,0,0,0,0,0,0,0,0,0,0,0,0,0,0,0,84533
28943,1148,326,408,325,70,19,203,120,72,0,0,72,48,38,22,0,16,10,0,0,10,83,76,0,5,71,7,7,0,0,7,0,0,0,0,84534
28944,1703,169,504,667,179,184,147,86,86,20,0,66,0,0,0,0,0,0,0,0,0,61,58,15,9,34,3,3,0,0,3,0,0,0,0,84535
28945,998,219,468,260,29,22,140,77,73,0,0,73,4,4,0,0,4,0,0,0,0,63,44,0,0,44,19,19,12,0,7,0,0,0,0,84536
28946,896,80,287,434,68,27,106,73,73,36,0,37,0,0,0,0,0,0,0,0,0,33,33,4,7,22,0,0,0,0,0,0,0,0,0,84537
28947,307,43,140,104,14,6,24,11,5,2,1,2,6,3,0,0,3,3,0,0,3,13,10,6,2,2,3,0,0,0,0,3,0,0,3,84539
28948,57,11,22,24,0,0,0,0,0,0,0,0,0,0,0,0,0,0,0,0,0,0,0,0,0,0,0,0,0,0,0,0,0,0,0,84540
28949,1289,173,397,619,55,45,64,29,20,16,0,4,9,3,3,0,0,6,6,0,0,35,35,8,0,27,0,0,0,0,0,0,0,0,0,84542
28950,16490,2605,3350,5940,3547,1048,1815,1018,771,216,79,476,247,217,148,38,31,30,0,30,0,797,597,159,42,396,200,138,27,73,38,62,0,58,4,84601
28951,18983,873,1805,6840,5432,4033,9093,4036,3319,780,205,2334,717,672,199,9,464,45,17,19,9,5057,4841,1899,330,2612,216,207,189,0,18,9,0,0,9,84604
28952,11966,968,1374,4869,3747,1008,2098,482,428,184,34,210,54,54,49,0,5,0,0,0,0,1616,1472,654,52,766,144,119,98,0,21,25,25,0,0,84606
28953,754,30,274,316,65,69,27,12,12,6,0,6,0,0,0,0,0,0,0,0,0,15,15,0,0,15,0,0,0,0,0,0,0,0,0,84620
28954,176,0,86,72,0,18,28,28,28,28,0,0,0,0,0,0,0,0,0,0,0,0,0,0,0,0,0,0,0,0,0,0,0,0,0,84621
28955,805,90,271,345,87,12,78,38,31,14,0,17,7,0,0,0,0,7,5,2,0,40,26,4,0,22,14,10,7,0,3,4,4,0,0,84622
28956,247,0,72,52,78,45,32,32,32,0,0,32,0,0,0,0,0,0,0,0,0,0,0,0,0,0,0,0,0,0,0,0,0,0,0,84623
28957,3388,488,1059,1197,490,154,387,200,118,14,11,93,82,7,7,0,0,75,42,20,13,187,150,81,0,69,37,37,36,0,1,0,0,0,0,84624
28958,180,40,58,20,56,6,29,7,7,0,0,7,0,0,0,0,0,0,0,0,0,22,14,14,0,0,8,8,0,8,0,0,0,0,0,84626
28959,2450,340,362,1033,440,275,1129,403,359,42,92,225,44,44,11,18,15,0,0,0,0,726,641,179,59,403,85,85,85,0,0,0,0,0,0,84627
28960,463,18,208,188,33,16,44,21,11,3,0,8,10,8,8,0,0,2,0,0,2,23,21,8,0,13,2,2,2,0,0,0,0,0,0,84628
28961,1831,150,623,725,237,96,179,111,92,10,3,79,19,19,18,0,1,0,0,0,0,68,64,36,0,28,4,0,0,0,0,4,0,4,0,84629
28962,157,31,21,73,26,6,25,19,12,0,0,12,7,7,7,0,0,0,0,0,0,6,6,4,0,2,0,0,0,0,0,0,0,0,0,84630
28963,1836,297,588,652,175,124,228,92,71,48,11,12,21,21,7,3,11,0,0,0,0,136,98,64,11,23,38,12,6,6,0,26,13,0,13,84631
28964,626,87,234,185,105,15,43,24,17,2,4,11,7,5,4,0,1,2,2,0,0,19,15,8,0,7,4,4,4,0,0,0,0,0,0,84632
28965,601,80,165,268,68,20,32,14,12,0,2,10,2,2,2,0,0,0,0,0,0,18,9,9,0,0,9,0,0,0,0,9,0,0,9,84633
28966,2375,315,748,977,226,109,123,63,43,9,0,34,20,12,12,0,0,8,0,0,8,60,60,12,4,44,0,0,0,0,0,0,0,0,0,84634
28967,479,73,146,204,46,10,55,35,35,10,2,23,0,0,0,0,0,0,0,0,0,20,4,4,0,0,16,0,0,0,0,16,0,0,16,84635
28968,280,18,61,124,57,20,14,3,3,2,0,1,0,0,0,0,0,0,0,0,0,11,11,4,0,7,0,0,0,0,0,0,0,0,0,84636
28969,350,31,131,132,34,22,32,23,21,4,0,17,2,2,2,0,0,0,0,0,0,9,5,4,0,1,4,0,0,0,0,4,0,0,4,84637
28970,174,6,33,80,33,22,44,38,38,0,0,38,0,0,0,0,0,0,0,0,0,6,0,0,0,0,6,6,6,0,0,0,0,0,0,84638
28971,636,30,338,210,45,13,37,5,3,0,0,3,2,2,2,0,0,0,0,0,0,32,32,15,4,13,0,0,0,0,0,0,0,0,0,84639
28972,157,13,31,31,69,13,17,5,1,0,0,1,4,4,4,0,0,0,0,0,0,12,12,10,0,2,0,0,0,0,0,0,0,0,0,84640
28973,1977,172,440,869,338,158,355,216,149,23,3,123,67,50,31,13,6,17,3,5,9,139,134,41,0,93,5,0,0,0,0,5,0,5,0,84642
28974,350,5,94,155,61,35,14,0,0,0,0,0,0,0,0,0,0,0,0,0,0,14,10,2,4,4,4,0,0,0,0,4,0,4,0,84643
28975,1292,148,477,432,174,61,224,140,107,61,4,42,33,17,12,3,2,16,0,0,16,84,54,12,5,37,30,28,19,0,9,2,2,0,0,84645
28976,961,159,331,327,94,50,133,85,37,6,0,31,48,48,4,0,44,0,0,0,0,48,22,4,0,18,26,16,7,0,9,10,10,0,0,84646
28977,2293,280,625,884,259,245,425,198,162,67,21,74,36,26,9,0,17,10,10,0,0,227,150,82,5,63,77,31,31,0,0,46,23,23,0,84647
28978,3246,370,991,1414,281,190,433,219,169,122,0,47,50,30,22,8,0,20,0,9,11,214,189,85,11,93,25,8,0,0,8,17,9,0,8,84648
28979,401,22,68,190,102,19,112,89,38,10,2,26,51,48,48,0,0,3,3,0,0,23,19,0,0,19,4,4,0,4,0,0,0,0,0,84649
28980,12261,822,2941,5546,2101,851,1512,840,637,223,68,346,203,193,77,95,21,10,10,0,0,672,518,169,21,328,154,138,54,67,17,16,0,8,8,84651
28981,481,50,209,153,30,39,123,52,52,13,0,39,0,0,0,0,0,0,0,0,0,71,41,9,21,11,30,30,0,0,30,0,0,0,0,84652
28982,4341,176,998,1622,990,555,583,341,292,124,34,134,49,17,8,0,9,32,16,0,16,242,191,68,14,109,51,37,9,4,24,14,0,0,14,84653
28983,1728,215,657,660,127,69,114,56,56,0,0,56,0,0,0,0,0,0,0,0,0,58,50,16,0,34,8,8,0,0,8,0,0,0,0,84654
28984,5294,514,1399,2378,738,265,669,345,248,102,22,124,97,72,14,27,31,25,0,0,25,324,273,65,28,180,51,31,17,8,6,20,14,0,6,84655
28985,263,21,114,83,41,4,4,4,4,2,0,2,0,0,0,0,0,0,0,0,0,0,0,0,0,0,0,0,0,0,0,0,0,0,0,84656
28986,327,58,85,149,19,16,2,2,2,0,0,2,0,0,0,0,0,0,0,0,0,0,0,0,0,0,0,0,0,0,0,0,0,0,0,84657
28987,19588,1444,4426,8451,3670,1597,2188,1166,929,439,61,429,237,179,77,40,62,58,0,12,46,1022,928,367,66,495,94,94,25,47,22,0,0,0,0,84660
28988,712,72,198,311,63,68,84,47,31,5,0,26,16,4,4,0,0,12,0,0,12,37,35,0,28,7,2,2,2,0,0,0,0,0,0,84662
28989,16165,1143,3060,6077,3980,1905,1730,985,814,271,137,406,171,132,44,82,6,39,31,0,8,745,642,266,36,340,103,4,0,0,4,99,0,0,99,84663
28990,4338,119,655,1924,956,684,561,326,260,95,72,93,66,27,25,0,2,39,27,0,12,235,204,74,39,91,31,31,31,0,0,0,0,0,0,84664
28991,293,34,90,138,18,13,34,24,24,0,0,24,0,0,0,0,0,0,0,0,0,10,10,9,0,1,0,0,0,0,0,0,0,0,0,84665
28992,250,43,54,103,27,23,41,10,8,0,0,8,2,2,2,0,0,0,0,0,0,31,30,3,0,27,1,1,0,1,0,0,0,0,0,84667
28993,4917,386,1523,2150,551,307,527,296,230,134,9,87,66,66,49,8,9,0,0,0,0,231,208,116,22,70,23,20,12,0,8,3,0,0,3,84701
28994,88,2,16,39,24,7,5,1,1,0,0,1,0,0,0,0,0,0,0,0,0,4,4,0,0,4,0,0,0,0,0,0,0,0,0,84710
28995,380,17,91,165,50,57,50,22,22,8,0,14,0,0,0,0,0,0,0,0,0,28,28,9,3,16,0,0,0,0,0,0,0,0,0,84711
28996,180,30,43,79,16,12,0,0,0,0,0,0,0,0,0,0,0,0,0,0,0,0,0,0,0,0,0,0,0,0,0,0,0,0,0,84712
28997,2304,183,850,915,233,123,200,72,46,6,0,40,26,26,16,10,0,0,0,0,0,128,117,50,56,11,11,0,0,0,0,11,0,0,11,84713
28998,481,149,154,149,10,19,108,108,61,7,7,47,47,47,47,0,0,0,0,0,0,0,0,0,0,0,0,0,0,0,0,0,0,0,0,84714
28999,330,13,128,92,57,40,61,28,28,23,0,5,0,0,0,0,0,0,0,0,0,33,29,29,0,0,4,4,4,0,0,0,0,0,0,84715
29000,181,0,31,83,40,27,4,0,0,0,0,0,0,0,0,0,0,0,0,0,0,4,4,0,0,4,0,0,0,0,0,0,0,0,0,84716
29001,132,6,47,50,11,18,20,13,8,0,0,8,5,5,5,0,0,0,0,0,0,7,7,7,0,0,0,0,0,0,0,0,0,0,0,84718
29002,25,0,4,6,5,10,4,4,4,0,0,4,0,0,0,0,0,0,0,0,0,0,0,0,0,0,0,0,0,0,0,0,0,0,0,84719
29003,10165,656,2280,4154,2035,1040,1913,844,790,168,63,559,54,38,0,37,1,16,0,0,16,1069,925,254,258,413,144,132,132,0,0,12,0,0,12,84720
29004,11108,1285,2874,4022,1858,1069,1633,789,560,117,96,347,229,136,15,72,49,93,48,0,45,844,700,81,173,446,144,121,96,5,20,23,23,0,0,84721
29005,439,15,147,166,107,4,22,22,22,22,0,0,0,0,0,0,0,0,0,0,0,0,0,0,0,0,0,0,0,0,0,0,0,0,0,84722
29006,611,45,260,199,70,37,75,20,7,1,0,6,13,7,1,0,6,6,0,6,0,55,48,35,0,13,7,1,1,0,0,6,6,0,0,84723
29007,706,141,250,248,58,9,83,61,33,0,0,33,28,9,9,0,0,19,19,0,0,22,22,10,0,12,0,0,0,0,0,0,0,0,0,84724
29008,886,69,257,388,84,88,78,41,41,12,0,29,0,0,0,0,0,0,0,0,0,37,37,6,4,27,0,0,0,0,0,0,0,0,0,84725
29009,592,65,216,178,88,45,22,14,14,7,0,7,0,0,0,0,0,0,0,0,0,8,8,0,0,8,0,0,0,0,0,0,0,0,0,84726
29010,148,58,0,90,0,0,28,0,0,0,0,0,0,0,0,0,0,0,0,0,0,28,28,0,0,28,0,0,0,0,0,0,0,0,0,84728
29011,195,5,42,105,23,20,21,5,3,1,0,2,2,2,2,0,0,0,0,0,0,16,4,0,0,4,12,12,12,0,0,0,0,0,0,84729
29012,168,11,31,92,19,15,25,18,16,4,2,10,2,2,2,0,0,0,0,0,0,7,7,4,0,3,0,0,0,0,0,0,0,0,0,84730
29013,13,0,13,0,0,0,0,0,0,0,0,0,0,0,0,0,0,0,0,0,0,0,0,0,0,0,0,0,0,0,0,0,0,0,0,84731
29014,7,0,7,0,0,0,0,0,0,0,0,0,0,0,0,0,0,0,0,0,0,0,0,0,0,0,0,0,0,0,0,0,0,0,0,84732
29015,108,0,35,33,40,0,0,0,0,0,0,0,0,0,0,0,0,0,0,0,0,0,0,0,0,0,0,0,0,0,0,0,0,0,0,84733
29016,93,7,27,59,0,0,15,9,7,0,0,7,2,0,0,0,0,2,2,0,0,6,6,4,0,2,0,0,0,0,0,0,0,0,0,84734
29017,176,24,46,73,27,6,3,1,0,0,0,0,1,1,0,1,0,0,0,0,0,2,2,2,0,0,0,0,0,0,0,0,0,0,0,84735
29018,178,18,64,77,16,3,21,16,8,4,0,4,8,5,5,0,0,3,3,0,0,5,5,2,0,3,0,0,0,0,0,0,0,0,0,84736
29019,9206,725,2913,3548,1456,564,761,289,260,86,15,159,29,14,0,0,14,15,15,0,0,472,425,190,11,224,47,47,32,0,15,0,0,0,0,84737
29020,4956,257,1157,1962,890,690,243,138,119,40,0,79,19,19,0,0,19,0,0,0,0,105,78,33,0,45,27,27,27,0,0,0,0,0,0,84738
29021,307,61,90,131,14,11,18,6,5,0,0,5,1,0,0,0,0,1,0,0,1,12,10,3,0,7,2,2,2,0,0,0,0,0,0,84739
29022,146,47,58,32,9,0,28,14,14,0,0,14,0,0,0,0,0,0,0,0,0,14,7,0,0,7,7,0,0,0,0,7,0,0,7,84740
29023,4113,222,1137,1766,713,275,239,158,135,76,12,47,23,23,11,5,7,0,0,0,0,81,70,31,0,39,11,9,0,0,9,2,0,0,2,84741
29024,159,23,69,44,9,14,28,0,0,0,0,0,0,0,0,0,0,0,0,0,0,28,28,11,0,17,0,0,0,0,0,0,0,0,0,84742
29025,22,2,13,7,0,0,10,7,7,0,0,7,0,0,0,0,0,0,0,0,0,3,3,0,0,3,0,0,0,0,0,0,0,0,0,84743
29026,166,14,38,78,21,15,35,24,24,0,0,24,0,0,0,0,0,0,0,0,0,11,11,7,0,4,0,0,0,0,0,0,0,0,0,84744
29027,2325,234,683,995,316,97,244,166,135,41,28,66,31,19,0,19,0,12,0,0,12,78,66,10,20,36,12,9,9,0,0,3,0,0,3,84745
29028,971,33,318,375,105,140,80,39,23,17,0,6,16,16,16,0,0,0,0,0,0,41,41,7,0,34,0,0,0,0,0,0,0,0,0,84746
29029,580,26,156,287,56,55,54,31,28,17,0,11,3,3,3,0,0,0,0,0,0,23,23,14,0,9,0,0,0,0,0,0,0,0,0,84747
29030,165,11,28,100,23,3,11,2,2,2,0,0,0,0,0,0,0,0,0,0,0,9,9,5,0,4,0,0,0,0,0,0,0,0,0,84749
29031,298,34,116,92,26,30,23,23,12,2,0,10,11,0,0,0,0,11,0,0,11,0,0,0,0,0,0,0,0,0,0,0,0,0,0,84750
29032,1003,86,402,271,186,58,136,82,51,13,12,26,31,25,6,19,0,6,6,0,0,54,38,0,0,38,16,16,16,0,0,0,0,0,0,84751
29033,599,80,240,226,44,9,56,23,23,4,0,19,0,0,0,0,0,0,0,0,0,33,24,19,0,5,9,9,0,0,9,0,0,0,0,84752
29034,49,0,31,9,0,9,4,2,1,0,0,1,1,0,0,0,0,1,0,0,1,2,2,0,0,2,0,0,0,0,0,0,0,0,0,84753
29035,2472,272,741,944,347,168,251,179,174,57,7,110,5,5,5,0,0,0,0,0,0,72,60,28,0,32,12,12,12,0,0,0,0,0,0,84754
29036,70,17,6,40,0,7,0,0,0,0,0,0,0,0,0,0,0,0,0,0,0,0,0,0,0,0,0,0,0,0,0,0,0,0,0,84755
29037,215,29,41,78,67,0,23,0,0,0,0,0,0,0,0,0,0,0,0,0,0,23,23,12,0,11,0,0,0,0,0,0,0,0,0,84756
29038,691,28,110,254,174,125,2,0,0,0,0,0,0,0,0,0,0,0,0,0,0,2,2,2,0,0,0,0,0,0,0,0,0,0,0,84757
29039,361,24,92,165,58,22,25,3,3,2,0,1,0,0,0,0,0,0,0,0,0,22,12,5,0,7,10,10,10,0,0,0,0,0,0,84758
29040,1427,103,453,630,164,77,169,106,88,33,0,55,18,8,8,0,0,10,8,0,2,63,56,56,0,0,7,7,7,0,0,0,0,0,0,84759
29041,422,75,123,157,42,25,17,13,11,4,0,7,2,2,0,0,2,0,0,0,0,4,4,2,0,2,0,0,0,0,0,0,0,0,0,84760
29042,1838,78,595,909,154,102,267,173,144,32,37,75,29,29,14,5,10,0,0,0,0,94,68,10,16,42,26,13,0,13,0,13,0,13,0,84761
29043,174,0,22,23,104,25,0,0,0,0,0,0,0,0,0,0,0,0,0,0,0,0,0,0,0,0,0,0,0,0,0,0,0,0,0,84762
29044,237,19,59,97,47,15,3,3,3,0,0,3,0,0,0,0,0,0,0,0,0,0,0,0,0,0,0,0,0,0,0,0,0,0,0,84763
29045,91,8,16,22,14,31,37,13,4,4,0,0,9,7,7,0,0,2,2,0,0,24,24,0,0,24,0,0,0,0,0,0,0,0,0,84764
29046,3306,142,529,1418,810,407,535,371,301,59,51,191,70,70,61,9,0,0,0,0,0,164,164,74,62,28,0,0,0,0,0,0,0,0,0,84765
29047,222,14,169,39,0,0,7,0,0,0,0,0,0,0,0,0,0,0,0,0,0,7,7,0,0,7,0,0,0,0,0,0,0,0,0,84766
29048,532,27,54,156,197,98,77,35,20,18,0,2,15,15,0,0,15,0,0,0,0,42,39,0,0,39,3,3,3,0,0,0,0,0,0,84767
29049,24899,2984,6540,9550,3764,2061,2370,1196,1036,274,245,517,160,93,14,43,36,67,0,27,40,1174,939,317,125,497,235,208,99,79,30,27,14,13,0,84770
29050,96,36,0,40,20,0,7,0,0,0,0,0,0,0,0,0,0,0,0,0,0,7,7,7,0,0,0,0,0,0,0,0,0,0,0,84772
29051,97,0,48,18,31,0,10,5,5,5,0,0,0,0,0,0,0,0,0,0,0,5,5,5,0,0,0,0,0,0,0,0,0,0,0,84773
29052,1036,49,208,488,235,56,99,59,53,20,7,26,6,6,0,0,6,0,0,0,0,40,35,0,6,29,5,5,0,5,0,0,0,0,0,84774
29053,499,19,116,184,125,55,16,15,15,7,0,8,0,0,0,0,0,0,0,0,0,1,1,0,1,0,0,0,0,0,0,0,0,0,0,84775
29054,365,18,119,142,56,30,38,20,17,5,0,12,3,3,3,0,0,0,0,0,0,18,15,5,0,10,3,0,0,0,0,3,3,0,0,84776
29055,287,31,106,108,20,22,32,26,19,4,0,15,7,2,0,2,0,5,3,0,2,6,6,4,0,2,0,0,0,0,0,0,0,0,0,84779
29056,11848,656,3827,4483,2086,796,855,425,326,83,0,243,99,99,22,77,0,0,0,0,0,430,424,241,96,87,6,6,0,0,6,0,0,0,0,84780
29057,101,0,39,31,5,26,0,0,0,0,0,0,0,0,0,0,0,0,0,0,0,0,0,0,0,0,0,0,0,0,0,0,0,0,0,84781
29058,547,66,213,194,44,30,95,10,10,0,0,10,0,0,0,0,0,0,0,0,0,85,48,0,11,37,37,37,23,14,0,0,0,0,0,84782
29059,421,0,112,145,86,78,14,0,0,0,0,0,0,0,0,0,0,0,0,0,0,14,14,0,0,14,0,0,0,0,0,0,0,0,0,84783
29060,833,232,336,221,35,9,291,166,33,0,6,27,133,0,0,0,0,133,33,83,17,125,63,0,0,63,62,25,0,0,25,37,5,22,10,84784
29061,22912,1569,4935,9348,4389,2671,2300,997,872,236,65,571,125,76,64,12,0,49,0,0,49,1303,1135,342,137,656,168,156,37,53,66,12,0,12,0,84790
29062,6680,1566,1331,1574,1282,927,452,170,68,0,0,68,102,34,23,0,11,68,25,0,43,282,227,0,0,227,55,32,0,0,32,23,0,0,23,85003
29063,3185,510,725,855,649,446,334,157,127,38,0,89,30,0,0,0,0,30,0,0,30,177,162,34,0,128,15,0,0,0,0,15,0,0,15,85004
29064,13897,5325,3307,3274,1330,661,1538,1005,649,84,36,529,356,211,70,35,106,145,49,15,81,533,386,22,43,321,147,30,5,0,25,117,43,35,39,85006
29065,8929,2671,2384,1757,1287,830,776,319,234,0,6,228,85,53,0,15,38,32,10,8,14,457,302,42,0,260,155,133,0,61,72,22,7,14,1,85007
29066,31101,10476,7545,7561,3859,1660,3267,1579,1046,127,45,874,533,276,105,42,129,257,190,0,67,1688,1264,174,59,1031,424,177,94,7,76,247,36,51,160,85008
29067,26663,14008,7355,3970,865,465,3565,2027,1314,166,39,1109,713,438,84,107,247,275,34,16,225,1538,1108,149,81,878,430,268,68,56,144,162,14,0,148,85009
29068,4880,249,624,1739,1265,1003,177,74,59,13,34,12,15,15,15,0,0,0,0,0,0,103,102,19,0,83,1,0,0,0,0,1,0,0,1,85012
29069,15027,1300,2727,5197,3682,2121,989,476,385,53,11,321,91,83,14,57,12,8,8,0,0,513,416,111,39,266,97,73,0,0,73,24,0,0,24,85013
29070,17396,2418,4245,5650,3212,1871,1152,628,398,54,0,344,230,126,73,39,14,104,104,0,0,524,453,103,20,330,71,36,0,0,36,35,11,0,24,85014
29071,23476,6250,6419,6969,2470,1368,2683,1374,995,309,54,632,379,143,118,14,11,236,122,78,36,1309,990,274,219,497,319,100,26,6,68,219,14,85,120,85015
29072,24260,3441,4299,7408,5993,3119,1080,565,474,108,0,366,91,45,16,0,29,46,39,0,7,515,511,180,43,288,4,0,0,0,0,4,0,0,4,85016
29073,21374,8302,6560,5122,953,437,3155,1623,1286,129,189,968,337,140,89,0,51,197,151,33,13,1532,1196,167,130,899,336,193,65,22,106,143,42,0,101,85017
29074,26916,2732,4416,7896,7219,4653,1472,724,527,116,69,342,197,85,0,39,46,112,26,0,86,748,646,282,25,339,102,9,0,0,9,93,42,18,33,85018
29075,13449,5284,3826,3441,636,262,1947,1116,877,53,61,763,239,81,8,17,56,158,44,23,91,831,737,98,47,592,94,35,10,7,18,59,42,1,16,85019
29076,23252,2751,5713,7198,4515,3075,1095,544,444,37,16,391,100,8,8,0,0,92,87,5,0,551,393,58,31,304,158,107,107,0,0,51,0,51,0,85020
29077,24034,4352,5667,6861,4081,3073,1721,648,486,63,36,387,162,109,49,7,53,53,27,0,26,1073,927,190,32,705,146,83,5,26,52,63,5,9,49,85021
29078,32747,2835,8036,12117,5990,3769,2209,1377,1051,414,147,490,326,220,86,54,80,106,60,38,8,832,663,243,90,330,169,50,50,0,0,119,0,31,88,85022
29079,20248,2406,5296,6817,3759,1970,1689,988,899,103,143,653,89,50,26,11,13,39,14,9,16,701,543,162,43,338,158,104,57,47,0,54,40,0,14,85023
29080,15773,709,3340,5922,4033,1769,972,547,480,134,31,315,67,56,14,21,21,11,0,11,0,425,378,156,40,182,47,39,13,26,0,8,0,0,8,85024
29081,24742,2852,6000,9587,4066,2237,1886,1204,1042,314,94,634,162,88,75,13,0,74,29,10,35,682,493,161,27,305,189,111,87,0,24,78,0,43,35,85027
29082,14673,579,2490,4637,3736,3231,1056,550,499,108,57,334,51,50,37,13,0,1,0,0,1,506,490,138,21,331,16,0,0,0,0,16,0,0,16,85028
29083,27750,3869,8301,10711,3541,1328,2586,1165,830,166,50,614,335,144,65,0,79,191,10,51,130,1421,1162,295,141,726,259,229,135,52,42,30,0,0,30,85029
29084,15500,7311,4669,3004,385,131,2821,1506,1100,77,96,927,406,240,186,9,45,166,32,14,120,1315,985,6,72,907,330,164,15,31,118,166,28,15,123,85031
29085,46341,6930,11234,15513,8790,3874,3901,2175,1770,418,138,1214,405,238,119,84,35,167,59,63,45,1726,1447,497,48,902,279,168,113,55,0,111,40,18,53,85032
29086,29229,11707,9288,6642,1212,380,4230,2234,1735,211,35,1489,499,346,118,18,210,153,67,11,75,1996,1486,41,165,1280,510,336,97,64,175,174,49,0,125,85033
29087,2413,1102,629,377,227,78,191,139,109,47,0,62,30,6,0,0,6,24,0,0,24,52,19,0,8,11,33,33,1,6,26,0,0,0,0,85034
29088,24022,10894,6685,4746,1348,349,3788,1555,1122,95,164,863,433,284,127,107,50,149,48,36,65,2233,1635,262,126,1247,598,429,139,156,134,169,18,20,131,85035
29089,24790,6031,7352,8542,1861,1004,3272,1723,1334,148,191,995,389,227,130,42,55,162,32,71,59,1549,1107,261,51,795,442,285,124,77,84,157,0,22,135,85037
29090,16227,5940,4892,3168,1617,610,1835,890,568,60,28,480,322,144,102,34,8,178,20,15,143,945,607,54,56,497,338,168,46,32,90,170,22,25,123,85040
29091,31846,10373,8659,8469,2906,1439,3773,1983,1511,201,99,1211,472,268,160,70,38,204,53,20,131,1790,1229,58,122,1049,561,299,53,21,225,262,17,66,179,85041
29092,24706,7067,5686,6528,3257,2168,2214,1241,960,215,12,733,281,154,116,38,0,127,0,0,127,973,880,142,89,649,93,43,43,0,0,50,0,0,50,85042
29093,15463,4742,4780,4097,1449,395,2047,1221,906,117,27,762,315,169,93,62,14,146,69,0,77,826,623,124,55,444,203,134,93,41,0,69,3,18,48,85043
29094,28064,1147,4859,9481,8064,4513,1700,990,892,269,83,540,98,54,37,17,0,44,12,15,17,710,630,218,6,406,80,23,23,0,0,57,55,0,2,85044
29095,5038,49,469,1842,1780,898,511,222,213,60,0,153,9,9,9,0,0,0,0,0,0,289,199,43,12,144,90,90,90,0,0,0,0,0,0,85045
29096,23234,542,2721,7532,7736,4703,2477,1363,1316,227,133,956,47,13,13,0,0,34,0,0,34,1114,1059,316,26,717,55,33,33,0,0,22,0,0,22,85048
29097,18579,768,2878,5530,6327,3076,1099,490,472,116,53,303,18,0,0,0,0,18,0,0,18,609,580,324,0,256,29,29,29,0,0,0,0,0,0,85050
29098,26596,5791,8171,8952,2640,1042,2180,1176,956,185,102,669,220,154,22,89,43,66,0,20,46,1004,677,187,64,426,327,206,103,40,63,121,27,0,94,85051
29099,18884,1718,6130,7255,2730,1051,1889,1010,891,182,46,663,119,27,12,15,0,92,61,0,31,879,808,259,84,465,71,71,59,12,0,0,0,0,0,85053
29100,4565,81,669,1290,1579,946,95,79,79,15,0,64,0,0,0,0,0,0,0,0,0,16,16,16,0,0,0,0,0,0,0,0,0,0,0,85054
29101,11223,165,2135,4265,2926,1732,888,605,506,142,0,364,99,93,50,0,43,6,0,0,6,283,247,17,0,230,36,32,16,16,0,4,0,0,4,85083
29102,11201,315,1771,3834,3658,1623,624,312,293,93,0,200,19,16,16,0,0,3,0,0,3,312,170,48,0,122,142,92,92,0,0,50,0,0,50,85085
29103,25563,1318,5183,9136,7086,2840,2084,1082,959,379,91,489,123,99,28,44,27,24,8,0,16,1002,906,378,80,448,96,81,15,66,0,15,6,0,9,85086
29104,5320,177,1121,2471,1061,490,350,151,141,48,0,93,10,10,0,0,10,0,0,0,0,199,190,108,0,82,9,9,9,0,0,0,0,0,0,85087
29105,10461,405,2516,3869,2245,1426,301,158,158,52,27,79,0,0,0,0,0,0,0,0,0,143,125,0,22,103,18,0,0,0,0,18,18,0,0,85118
29106,17015,1893,5697,6364,2088,973,830,520,344,83,31,230,176,146,146,0,0,30,0,0,30,310,284,74,10,200,26,26,26,0,0,0,0,0,0,85119
29107,19418,3313,6834,7233,1224,814,1397,707,532,162,97,273,175,93,75,0,18,82,0,0,82,690,509,102,21,386,181,114,42,18,54,67,25,0,42,85120
29108,1593,498,597,453,41,4,416,207,111,0,0,111,96,90,0,78,12,6,0,0,6,209,82,0,0,82,127,92,0,0,92,35,0,14,21,85121
29109,33318,5180,10353,12378,3747,1660,2968,1349,1012,205,29,778,337,271,172,26,73,66,7,37,22,1619,1281,430,94,757,338,274,212,35,27,64,61,3,0,85122
29110,5313,370,2149,2169,434,191,590,180,144,0,40,104,36,0,0,0,0,36,0,36,0,410,346,123,0,223,64,38,0,0,38,26,11,0,15,85123
29111,9767,2293,2938,3487,657,392,1057,639,462,101,45,316,177,52,0,33,19,125,11,73,41,418,310,73,8,229,108,70,29,0,41,38,0,38,0,85128
29112,12440,4349,4025,3288,486,292,728,469,257,15,0,242,212,93,25,4,64,119,0,0,119,259,203,52,0,151,56,12,0,0,12,44,0,0,44,85131
29113,25947,6438,7924,9065,1485,1035,1276,813,418,125,51,242,395,150,80,0,70,245,0,0,245,463,372,0,31,341,91,91,80,11,0,0,0,0,0,85132
29114,386,37,148,183,18,0,34,10,10,0,6,4,0,0,0,0,0,0,0,0,0,24,24,0,0,24,0,0,0,0,0,0,0,0,0,85135
29115,1920,225,736,815,82,62,119,75,38,0,3,35,37,12,0,12,0,25,12,0,13,44,29,0,0,29,15,15,5,0,10,0,0,0,0,85137
29116,21259,1570,5641,8650,4018,1380,1606,1057,877,134,26,717,180,145,26,91,28,35,13,16,6,549,466,101,19,346,83,42,42,0,0,41,0,0,41,85138
29117,11071,2023,2842,3954,1478,774,946,372,190,51,0,139,182,75,50,25,0,107,3,13,91,574,489,74,6,409,85,72,0,7,65,13,0,0,13,85139
29118,20562,2432,5423,8927,2760,1020,2148,1248,888,211,96,581,360,165,54,0,111,195,164,31,0,900,585,111,44,430,315,284,217,67,0,31,31,0,0,85140
29119,273,119,58,79,17,0,22,11,0,0,0,0,11,3,0,0,3,8,4,4,0,11,7,0,0,7,4,0,0,0,0,4,0,0,4,85141
29120,28999,2155,6562,11401,6269,2612,2919,1232,1120,342,166,612,112,62,57,5,0,50,20,0,30,1687,1466,510,65,891,221,221,62,71,88,0,0,0,0,85142
29121,20830,1578,5717,9043,3249,1243,1586,638,549,46,50,453,89,74,62,0,12,15,0,15,0,948,840,149,14,677,108,108,108,0,0,0,0,0,0,85143
29122,900,57,235,359,180,69,96,71,65,4,26,35,6,0,0,0,0,6,0,3,3,25,18,6,0,12,7,0,0,0,0,7,0,0,7,85145
29123,2520,871,683,888,78,0,680,388,290,0,0,290,98,33,18,0,15,65,0,60,5,292,141,0,16,125,151,30,0,0,30,121,86,0,35,85147
29124,601,277,189,135,0,0,0,0,0,0,0,0,0,0,0,0,0,0,0,0,0,0,0,0,0,0,0,0,0,0,0,0,0,0,0,85172
29125,1933,299,773,689,128,44,151,102,102,20,0,82,0,0,0,0,0,0,0,0,0,49,37,0,0,37,12,12,0,0,12,0,0,0,0,85173
29126,1027,165,400,381,54,27,26,10,10,0,0,10,0,0,0,0,0,0,0,0,0,16,16,0,0,16,0,0,0,0,0,0,0,0,0,85192
29127,2684,919,810,802,143,10,158,90,20,15,0,5,70,59,15,0,44,11,0,0,11,68,49,0,19,30,19,15,0,0,15,4,0,0,4,85193
29128,4715,833,1327,1502,626,427,246,193,193,47,0,146,0,0,0,0,0,0,0,0,0,53,53,0,0,53,0,0,0,0,0,0,0,0,0,85194
29129,29812,6597,8978,9148,3681,1408,2762,1407,1127,161,103,863,280,179,60,27,92,101,46,28,27,1355,1033,204,16,813,322,249,130,57,62,73,0,18,55,85201
29130,23254,2268,5329,9322,4037,2298,1757,893,666,141,88,437,227,173,68,47,58,54,17,11,26,864,676,184,47,445,188,123,66,29,28,65,32,27,6,85202
29131,20907,3076,5308,7442,3333,1748,1670,914,788,159,53,576,126,75,25,49,1,51,0,20,31,756,623,204,19,400,133,93,37,29,27,40,0,0,40,85203
29132,37250,7708,10342,12975,4323,1902,3561,1597,1341,301,174,866,256,104,71,23,10,152,57,72,23,1964,1478,454,136,888,486,355,90,111,154,131,72,7,52,85204
29133,31306,3208,8717,12088,4598,2695,2011,940,725,261,75,389,215,114,47,49,18,101,0,39,62,1071,955,255,125,575,116,116,80,17,19,0,0,0,0,85205
29134,24104,1839,6795,9407,4172,1891,1409,609,558,152,0,406,51,51,29,0,22,0,0,0,0,800,559,222,18,319,241,174,152,0,22,67,0,0,67,85206
29135,31174,2885,8140,11115,5875,3159,2434,1302,998,162,85,751,304,215,83,33,99,89,37,34,18,1132,894,371,54,469,238,119,36,41,42,119,6,0,113,85207
29136,26292,3356,9048,9522,2978,1388,1636,894,756,156,102,498,138,66,41,15,10,72,30,0,42,742,652,81,88,483,90,77,12,14,51,13,0,0,13,85208
29137,28206,2460,8157,9942,4960,2687,1893,909,730,109,150,471,179,105,75,30,0,74,53,12,9,984,772,301,46,425,212,165,76,80,9,47,0,0,47,85209
29138,21710,5006,5659,7379,2499,1167,2297,1252,1052,163,254,635,200,111,33,38,40,89,55,9,25,1045,839,278,128,433,206,193,105,29,59,13,3,0,10,85210
29139,13720,875,3045,5443,3078,1279,1321,763,699,332,40,327,64,39,39,0,0,25,25,0,0,558,495,187,41,267,63,63,58,5,0,0,0,0,0,85212
29140,22249,1521,5755,8032,4378,2563,2107,944,829,348,73,408,115,102,39,6,57,13,0,0,13,1163,1080,306,193,581,83,83,64,0,19,0,0,0,0,85213
29141,12039,586,3032,4607,2265,1549,680,346,283,56,10,217,63,44,0,27,17,19,0,0,19,334,319,135,0,184,15,15,15,0,0,0,0,0,0,85215
29142,29818,1995,6261,10787,7146,3629,2607,1360,1081,338,142,601,279,272,188,84,0,7,0,0,7,1247,1046,468,58,520,201,162,156,0,6,39,0,11,28,85224
29143,42692,7349,9755,14747,7077,3764,4316,2223,1584,527,226,831,639,470,347,68,55,169,93,34,42,2093,1630,433,89,1108,463,297,90,100,107,166,25,88,53,85225
29144,24776,1140,3831,8890,6679,4236,1762,916,756,252,104,400,160,85,68,0,17,75,45,0,30,846,767,206,78,483,79,25,10,15,0,54,18,0,36,85226
29145,25313,1607,5054,9187,6278,3187,2105,1203,1039,310,117,612,164,144,144,0,0,20,20,0,0,902,777,344,66,367,125,99,87,0,12,26,17,0,9,85233
29146,31072,1399,5882,12010,7832,3949,3195,1410,1269,447,109,713,141,107,94,0,13,34,15,19,0,1785,1610,629,180,801,175,60,51,9,0,115,35,0,80,85234
29147,25103,961,4884,8622,6700,3936,940,587,502,224,74,204,85,55,50,5,0,30,7,23,0,353,353,185,0,168,0,0,0,0,0,0,0,0,0,85248
29148,24785,878,3705,8241,7141,4820,1729,742,706,151,74,481,36,36,14,0,22,0,0,0,0,987,901,380,9,512,86,73,56,0,17,13,13,0,0,85249
29149,13267,399,2125,4571,3591,2581,585,383,347,97,80,170,36,36,36,0,0,0,0,0,0,202,196,47,22,127,6,0,0,0,0,6,0,0,6,85250
29150,25844,1835,4207,8196,7174,4432,1318,690,600,180,53,367,90,16,0,0,16,74,34,1,39,628,542,288,10,244,86,67,67,0,0,19,0,5,14,85251
29151,12529,317,992,2538,4336,4346,926,512,512,54,22,436,0,0,0,0,0,0,0,0,0,414,354,63,12,279,60,60,60,0,0,0,0,0,0,85253
29152,32618,1031,4766,9433,10879,6509,2652,1080,1035,372,20,643,45,27,15,0,12,18,3,7,8,1572,1394,378,69,947,178,101,26,12,63,77,0,0,77,85254
29153,27572,587,3021,6817,9426,7721,2019,1159,1001,227,72,702,158,158,136,9,13,0,0,0,0,860,796,194,107,495,64,24,0,24,0,40,30,0,10,85255
29154,2747,754,928,756,191,118,387,197,157,0,0,157,40,31,0,25,6,9,0,0,9,190,133,0,0,133,57,57,0,0,57,0,0,0,0,85256
29155,20253,1760,5161,6879,4177,2276,1011,506,363,18,20,325,143,118,18,0,100,25,0,14,11,505,437,304,34,99,68,40,40,0,0,28,0,0,28,85257
29156,18381,414,2229,5027,6198,4513,542,250,229,77,49,103,21,21,21,0,0,0,0,0,0,292,278,114,18,146,14,14,0,14,0,0,0,0,0,85258
29157,16339,355,1945,3918,6559,3562,1340,698,685,141,50,494,13,13,13,0,0,0,0,0,0,642,617,97,24,496,25,25,13,12,0,0,0,0,0,85259
29158,27699,879,3550,8085,9520,5665,1609,844,817,267,0,550,27,18,18,0,0,9,0,9,0,765,765,275,66,424,0,0,0,0,0,0,0,0,0,85260
29159,9158,231,955,2684,3301,1987,378,118,118,30,0,88,0,0,0,0,0,0,0,0,0,260,206,21,13,172,54,54,0,0,54,0,0,0,0,85262
29160,2021,59,395,551,579,437,0,0,0,0,0,0,0,0,0,0,0,0,0,0,0,0,0,0,0,0,0,0,0,0,0,0,0,0,0,85263
29161,682,120,235,231,68,28,58,34,28,1,9,18,6,0,0,0,0,6,0,0,6,24,16,3,0,13,8,8,0,0,8,0,0,0,0,85264
29162,8968,152,1183,2403,2923,2307,307,93,93,19,0,74,0,0,0,0,0,0,0,0,0,214,214,56,20,138,0,0,0,0,0,0,0,0,0,85266
29163,18451,667,3707,5955,5449,2673,1031,580,495,109,82,304,85,0,0,0,0,85,11,18,56,451,439,174,0,265,12,0,0,0,0,12,0,0,12,85268
29164,25076,4062,3944,7914,5939,3217,9394,4807,4486,975,455,3056,321,181,116,30,35,140,72,49,19,4587,4317,1848,283,2186,270,201,58,8,135,69,0,0,69,85281
29165,32501,2812,6331,10690,7859,4809,2405,1160,1025,371,61,593,135,44,32,0,12,91,0,24,67,1245,1106,423,163,520,139,116,56,54,6,23,16,0,7,85282
29166,29489,3577,5460,9634,6464,4354,2390,1219,1126,533,35,558,93,69,6,63,0,24,0,0,24,1171,1118,558,34,526,53,22,22,0,0,31,0,0,31,85283
29167,12057,440,1187,2880,3992,3558,1032,600,584,146,45,393,16,16,13,0,3,0,0,0,0,432,400,80,30,290,32,32,17,0,15,0,0,0,0,85284
29168,22848,892,2996,7943,6759,4258,1937,957,791,144,116,531,166,166,137,29,0,0,0,0,0,980,816,175,133,508,164,164,91,73,0,0,0,0,0,85286
29169,22814,1186,3430,8226,7174,2798,2201,991,776,350,93,333,215,197,189,8,0,18,0,0,18,1210,1151,275,209,667,59,59,27,0,32,0,0,0,0,85295
29170,24225,998,4525,9755,6033,2914,2426,1401,1284,512,159,613,117,96,50,39,7,21,0,21,0,1025,963,399,47,517,62,52,41,0,11,10,0,0,10,85296
29171,14821,490,2117,6566,3933,1715,1585,766,754,226,55,473,12,12,12,0,0,0,0,0,0,819,744,372,17,355,75,75,30,45,0,0,0,0,0,85297
29172,13764,224,2281,5103,4506,1650,892,396,385,120,27,238,11,10,10,0,0,1,1,0,0,496,482,155,54,273,14,0,0,0,0,14,0,0,14,85298
29173,33942,11518,10313,9392,1518,1201,4240,2415,1799,275,427,1097,616,321,195,11,115,295,113,93,89,1825,1180,192,36,952,645,384,222,121,41,261,20,122,119,85301
29174,24145,3261,7125,9217,3115,1427,1894,905,710,82,120,508,195,163,26,43,94,32,29,0,3,989,801,118,36,647,188,137,49,27,61,51,26,0,25,85302
29175,16767,4456,5184,5208,1401,518,2696,1640,1327,246,107,974,313,270,49,53,168,43,14,20,9,1056,752,123,10,619,304,218,50,20,148,86,8,12,66,85303
29176,18011,1502,4810,7283,3026,1390,1772,1083,919,132,79,708,164,121,99,13,9,43,0,15,28,689,626,135,33,458,63,33,6,5,22,30,0,30,0,85304
29177,6844,797,1754,2716,1146,431,634,343,298,5,23,270,45,41,22,7,12,4,0,0,4,291,224,53,0,171,67,54,43,0,11,13,0,13,0,85305
29178,16410,1624,4780,6910,2178,918,1713,986,835,205,104,526,151,69,54,15,0,82,26,34,22,727,542,93,96,353,185,161,31,122,8,24,14,10,0,85306
29179,5076,820,1719,1524,777,236,343,181,169,19,45,105,12,12,12,0,0,0,0,0,0,162,149,64,8,77,13,7,0,0,7,6,0,0,6,85307
29180,43603,2848,9253,16243,9963,5296,3964,2107,1823,501,130,1192,284,244,88,62,94,40,14,0,26,1857,1700,541,123,1036,157,123,53,33,37,34,22,0,12,85308
29181,46,0,34,9,3,0,31,15,2,2,0,0,13,13,13,0,0,0,0,0,0,16,0,0,0,0,16,16,16,0,0,0,0,0,0,85309
29182,12298,436,2384,5259,2728,1491,1247,758,642,161,50,431,116,98,81,17,0,18,18,0,0,489,428,149,59,220,61,61,61,0,0,0,0,0,0,85310
29183,625,329,96,99,101,0,68,11,0,0,0,0,11,8,8,0,0,3,3,0,0,57,57,0,2,55,0,0,0,0,0,0,0,0,0,85320
29184,3432,898,1151,882,273,228,179,105,46,0,0,46,59,7,7,0,0,52,0,0,52,74,59,0,2,57,15,7,0,7,0,8,0,0,8,85321
29185,417,144,136,90,37,10,48,31,12,0,0,12,19,19,9,0,10,0,0,0,0,17,8,1,0,7,9,9,0,0,9,0,0,0,0,85322
29186,21735,6841,6456,6011,1766,661,2609,1492,1149,40,176,933,343,215,127,23,65,128,61,0,67,1117,724,154,44,526,393,310,135,88,87,83,0,54,29,85323
29187,1640,172,544,646,208,70,43,31,31,31,0,0,0,0,0,0,0,0,0,0,0,12,12,0,0,12,0,0,0,0,0,0,0,0,0,85324
29188,736,147,264,217,42,66,18,18,18,9,0,9,0,0,0,0,0,0,0,0,0,0,0,0,0,0,0,0,0,0,0,0,0,0,0,85325
29189,30958,6269,10463,10993,2458,775,3042,1550,1308,281,64,963,242,69,0,20,49,173,68,12,93,1492,1224,126,47,1051,268,118,56,10,52,150,14,17,119,85326
29190,216,107,42,59,0,8,5,5,0,0,0,0,5,0,0,0,0,5,0,5,0,0,0,0,0,0,0,0,0,0,0,0,0,0,0,85328
29191,19753,583,2733,6326,6690,3421,1436,653,586,283,9,294,67,44,29,0,15,23,0,23,0,783,727,281,82,364,56,56,37,0,19,0,0,0,0,85331
29192,1196,119,331,617,102,27,38,19,0,0,0,0,19,0,0,0,0,19,19,0,0,19,19,0,0,19,0,0,0,0,0,0,0,0,0,85332
29193,312,134,89,77,10,2,10,5,5,3,0,2,0,0,0,0,0,0,0,0,0,5,0,0,0,0,5,5,5,0,0,0,0,0,0,85333
29194,652,179,191,268,14,0,64,39,32,0,0,32,7,7,0,7,0,0,0,0,0,25,14,0,0,14,11,11,0,0,11,0,0,0,0,85334
29195,17717,3855,4900,6642,1722,598,1948,1046,572,69,55,448,474,318,193,35,90,156,12,0,144,902,709,123,24,562,193,118,20,16,82,75,40,5,30,85335
29196,306,156,52,60,31,7,39,22,16,0,0,16,6,0,0,0,0,6,6,0,0,17,17,0,0,17,0,0,0,0,0,0,0,0,0,85336
29197,1485,650,427,254,140,14,243,124,72,0,7,65,52,28,10,9,9,24,13,0,11,119,72,10,0,62,47,42,5,0,37,5,5,0,0,85337
29198,26862,2605,7383,10305,4789,1780,2434,1246,1080,224,147,709,166,113,86,0,27,53,5,17,31,1188,914,203,42,669,274,186,79,0,107,88,0,0,88,85338
29199,21298,3516,4393,7605,3440,2344,2555,1423,1124,91,0,1033,299,204,52,90,62,95,0,13,82,1132,967,182,76,709,165,130,90,33,7,35,0,11,24,85339
29200,17394,1602,3569,6673,3195,2355,2074,1033,690,173,47,470,343,303,185,107,11,40,32,0,8,1041,771,158,57,556,270,167,44,16,107,103,19,0,84,85340
29201,29,0,14,15,0,0,0,0,0,0,0,0,0,0,0,0,0,0,0,0,0,0,0,0,0,0,0,0,0,0,0,0,0,0,0,85341
29202,1162,194,379,424,112,53,17,4,4,0,2,2,0,0,0,0,0,0,0,0,0,13,13,0,0,13,0,0,0,0,0,0,0,0,0,85342
29203,74,17,12,32,10,3,0,0,0,0,0,0,0,0,0,0,0,0,0,0,0,0,0,0,0,0,0,0,0,0,0,0,0,0,0,85343
29204,7053,1630,2374,2280,533,236,376,156,143,3,20,120,13,4,4,0,0,9,0,0,9,220,171,56,20,95,49,39,2,37,0,10,7,0,3,85344
29205,37661,6486,11926,14528,3272,1449,3520,1890,1578,321,126,1131,312,231,163,18,50,81,35,0,46,1630,1235,267,56,912,395,335,96,118,121,60,23,37,0,85345
29206,4082,566,1641,1666,151,58,53,53,6,0,0,6,47,47,47,0,0,0,0,0,0,0,0,0,0,0,0,0,0,0,0,0,0,0,0,85346
29207,546,179,172,149,40,6,52,24,18,5,3,10,6,6,6,0,0,0,0,0,0,28,28,3,0,25,0,0,0,0,0,0,0,0,0,85347
29208,2395,890,654,513,230,108,83,33,3,0,0,3,30,18,13,5,0,12,12,0,0,50,50,0,0,50,0,0,0,0,0,0,0,0,0,85348
29209,14366,8116,1432,3414,1388,16,2806,1469,1343,223,0,1120,126,87,87,0,0,39,0,0,39,1337,1253,31,92,1130,84,57,0,0,57,27,0,0,27,85349
29210,12308,5451,3560,2565,432,300,1460,749,579,136,25,418,170,113,0,0,113,57,12,0,45,711,553,137,0,416,158,98,24,3,71,60,0,25,35,85350
29211,28284,2787,9407,10234,3627,2229,9,9,9,0,0,9,0,0,0,0,0,0,0,0,0,0,0,0,0,0,0,0,0,0,0,0,0,0,0,85351
29212,176,89,53,29,0,5,10,0,0,0,0,0,0,0,0,0,0,0,0,0,0,10,10,10,0,0,0,0,0,0,0,0,0,0,0,85352
29213,16971,4853,5502,4725,1434,457,2087,1086,763,107,0,656,323,211,146,65,0,112,49,24,39,1001,822,38,40,744,179,110,12,37,61,69,0,21,48,85353
29214,3348,678,1115,1255,180,120,447,296,167,11,11,145,129,106,9,97,0,23,23,0,0,151,127,10,0,117,24,17,13,4,0,7,0,7,0,85354
29215,6010,492,1281,2488,1153,596,283,152,108,46,0,62,44,44,44,0,0,0,0,0,0,131,99,8,9,82,32,11,11,0,0,21,9,12,0,85355
29216,3568,737,1377,1058,222,174,274,201,172,28,46,98,29,12,12,0,0,17,0,7,10,73,45,0,18,27,28,28,0,0,28,0,0,0,0,85356
29217,501,242,124,104,24,7,35,26,26,0,0,26,0,0,0,0,0,0,0,0,0,9,9,7,0,2,0,0,0,0,0,0,0,0,0,85357
29218,186,46,47,69,22,2,6,6,6,6,0,0,0,0,0,0,0,0,0,0,0,0,0,0,0,0,0,0,0,0,0,0,0,0,0,85360
29219,3450,289,1429,1334,302,96,164,89,77,0,0,77,12,12,0,0,12,0,0,0,0,75,42,9,0,33,33,33,0,0,33,0,0,0,0,85361
29220,617,67,209,236,54,51,0,0,0,0,0,0,0,0,0,0,0,0,0,0,0,0,0,0,0,0,0,0,0,0,0,0,0,0,0,85362
29221,4235,951,1430,1125,529,200,324,130,130,17,33,80,0,0,0,0,0,0,0,0,0,194,173,23,11,139,21,21,2,19,0,0,0,0,0,85363
29222,42575,12062,10604,13833,3973,2103,4873,2704,1966,479,160,1327,738,422,344,63,15,316,75,69,172,2169,1657,391,161,1105,512,283,146,62,75,229,34,82,113,85364
29223,29564,4626,7397,12016,3841,1684,2638,1277,869,158,123,588,408,404,316,46,42,4,4,0,0,1361,1088,395,38,655,273,185,87,51,47,88,0,57,31,85365
29224,17703,2539,6013,6082,1767,1302,729,389,302,77,52,173,87,87,77,10,0,0,0,0,0,340,182,74,22,86,158,158,55,24,79,0,0,0,0,85367
29225,332,187,75,70,0,0,22,8,8,0,0,8,0,0,0,0,0,0,0,0,0,14,7,0,0,7,7,0,0,0,0,7,0,0,7,85371
29226,15209,729,4704,5664,2770,1342,371,262,161,35,9,117,101,101,101,0,0,0,0,0,0,109,94,31,12,51,15,15,0,15,0,0,0,0,0,85373
29227,34973,3245,10115,12369,5945,3299,1808,754,577,88,40,449,177,124,71,32,21,53,0,0,53,1054,824,183,0,641,230,230,133,45,52,0,0,0,0,85374
29228,27567,1494,7118,9355,6279,3321,32,32,15,7,0,8,17,17,0,0,17,0,0,0,0,0,0,0,0,0,0,0,0,0,0,0,0,0,0,85375
29229,2826,16,441,569,992,808,82,59,59,57,0,2,0,0,0,0,0,0,0,0,0,23,23,23,0,0,0,0,0,0,0,0,0,0,0,85377
29230,23812,1554,5670,10030,4176,2382,1968,1179,989,82,110,797,190,82,6,37,39,108,12,0,96,789,731,142,32,557,58,46,46,0,0,12,0,12,0,85379
29231,17558,994,4344,6969,3530,1721,1140,634,567,128,31,408,67,62,62,0,0,5,5,0,0,506,467,186,46,235,39,30,8,10,12,9,0,0,9,85381
29232,28173,1647,6537,10904,5708,3377,2155,1042,945,181,51,713,97,97,53,44,0,0,0,0,0,1113,924,263,87,574,189,145,132,0,13,44,0,11,33,85382
29233,24280,814,4377,9454,6066,3569,1859,830,789,249,162,378,41,24,20,0,4,17,0,0,17,1029,893,263,79,551,136,125,21,14,90,11,0,0,11,85383
29234,7880,275,2039,3242,1219,1105,386,299,299,0,0,299,0,0,0,0,0,0,0,0,0,87,87,47,0,40,0,0,0,0,0,0,0,0,0,85387
29235,13009,814,2777,5370,3005,1043,1328,728,642,88,25,529,86,69,0,69,0,17,0,0,17,600,480,155,75,250,120,120,0,120,0,0,0,0,0,85388
29236,7059,850,1965,2437,1159,648,365,148,132,0,0,132,16,16,0,0,16,0,0,0,0,217,148,31,0,117,69,37,0,0,37,32,0,0,32,85390
29237,21612,2796,4604,8465,3779,1968,2477,1541,1257,427,77,753,284,238,166,52,20,46,4,0,42,936,800,302,76,422,136,74,52,22,0,62,46,0,16,85392
29238,18796,1424,3781,7169,3881,2541,751,324,324,42,19,263,0,0,0,0,0,0,0,0,0,427,397,132,46,219,30,30,0,0,30,0,0,0,0,85395
29239,8519,741,2293,2926,1918,641,669,262,240,7,15,218,22,10,6,4,0,12,0,0,12,407,394,49,14,331,13,13,0,4,9,0,0,0,0,85396
29240,9337,1760,2807,3288,727,755,711,429,311,105,10,196,118,67,59,8,0,51,30,0,21,282,202,58,0,144,80,55,55,0,0,25,0,0,25,85501
29241,969,226,429,302,12,0,178,55,36,0,0,36,19,19,0,0,19,0,0,0,0,123,65,0,0,65,58,49,0,0,49,9,0,0,9,85530
29242,263,33,83,113,20,14,0,0,0,0,0,0,0,0,0,0,0,0,0,0,0,0,0,0,0,0,0,0,0,0,0,0,0,0,0,85531
29243,1851,440,655,554,144,58,140,73,52,4,0,48,21,21,20,0,1,0,0,0,0,67,67,19,0,48,0,0,0,0,0,0,0,0,0,85533
29244,1698,221,748,593,83,53,126,88,70,0,6,64,18,6,6,0,0,12,0,0,12,38,33,0,5,28,5,0,0,0,0,5,0,0,5,85534
29245,7,0,0,4,3,0,0,0,0,0,0,0,0,0,0,0,0,0,0,0,0,0,0,0,0,0,0,0,0,0,0,0,0,0,0,85535
29246,279,16,111,75,27,50,0,0,0,0,0,0,0,0,0,0,0,0,0,0,0,0,0,0,0,0,0,0,0,0,0,0,0,0,0,85536
29247,3669,695,1064,1469,184,257,363,136,117,16,0,101,19,4,4,0,0,15,7,8,0,227,140,115,0,25,87,15,0,0,15,72,0,0,72,85539
29248,1770,173,639,716,195,47,189,79,74,5,0,69,5,5,5,0,0,0,0,0,0,110,88,14,0,74,22,22,0,16,6,0,0,0,0,85540
29249,16797,1795,5327,6495,1929,1251,637,389,345,26,36,283,44,35,35,0,0,9,0,0,9,248,248,110,56,82,0,0,0,0,0,0,0,0,0,85541
29250,1739,397,657,539,83,63,251,184,142,0,0,142,42,8,0,8,0,34,1,13,20,67,45,0,8,37,22,22,0,22,0,0,0,0,0,85542
29251,2186,293,574,931,256,132,197,98,90,30,0,60,8,6,6,0,0,2,0,2,0,99,64,9,1,54,35,23,16,0,7,12,0,0,12,85543
29252,1820,138,660,563,296,163,28,10,10,0,0,10,0,0,0,0,0,0,0,0,0,18,18,8,0,10,0,0,0,0,0,0,0,0,0,85544
29253,625,64,71,221,174,95,8,8,0,0,0,0,8,8,0,0,8,0,0,0,0,0,0,0,0,0,0,0,0,0,0,0,0,0,0,85545
29254,12678,1786,4683,5099,793,317,995,466,370,39,79,252,96,64,0,57,7,32,6,0,26,529,462,145,22,295,67,0,0,0,0,67,16,7,44,85546
29255,2826,953,947,847,45,34,423,231,115,0,31,84,116,56,0,17,39,60,0,0,60,192,87,0,5,82,105,50,10,10,30,55,9,17,29,85550
29256,248,38,110,97,3,0,17,17,7,0,0,7,10,10,10,0,0,0,0,0,0,0,0,0,0,0,0,0,0,0,0,0,0,0,0,85551
29257,3214,395,804,1092,420,503,675,287,261,55,12,194,26,26,26,0,0,0,0,0,0,388,344,121,0,223,44,44,27,0,17,0,0,0,0,85552
29258,1321,186,356,662,51,66,0,0,0,0,0,0,0,0,0,0,0,0,0,0,0,0,0,0,0,0,0,0,0,0,0,0,0,0,0,85553
29259,274,79,75,108,0,12,10,10,10,0,0,10,0,0,0,0,0,0,0,0,0,0,0,0,0,0,0,0,0,0,0,0,0,0,0,85554
29260,573,49,153,191,121,59,15,15,15,7,0,8,0,0,0,0,0,0,0,0,0,0,0,0,0,0,0,0,0,0,0,0,0,0,0,85601
29261,6798,811,2041,2850,722,374,350,246,199,21,0,178,47,46,46,0,0,1,0,0,1,104,98,75,0,23,6,6,0,6,0,0,0,0,0,85602
29262,5287,670,1256,1885,782,694,245,147,105,32,0,73,42,22,13,9,0,20,0,0,20,98,79,19,7,53,19,0,0,0,0,19,0,3,16,85603
29263,374,133,98,129,11,3,16,11,9,0,0,9,2,0,0,0,0,2,0,0,2,5,5,0,0,5,0,0,0,0,0,0,0,0,0,85605
29264,1054,144,203,533,113,61,90,73,41,1,0,40,32,0,0,0,0,32,8,0,24,17,17,0,0,17,0,0,0,0,0,0,0,0,0,85606
29265,10868,3568,2665,3111,1053,471,1060,662,603,101,47,455,59,34,15,19,0,25,0,0,25,398,329,75,48,206,69,34,9,0,25,35,13,22,0,85607
29266,4042,1061,1103,1813,52,13,118,118,85,0,0,85,33,17,0,0,17,16,0,0,16,0,0,0,0,0,0,0,0,0,0,0,0,0,0,85608
29267,298,0,136,70,92,0,0,0,0,0,0,0,0,0,0,0,0,0,0,0,0,0,0,0,0,0,0,0,0,0,0,0,0,0,0,85609
29268,836,108,288,291,103,46,70,57,43,3,0,40,14,0,0,0,0,14,0,0,14,13,9,0,0,9,4,4,0,0,4,0,0,0,0,85610
29269,660,30,119,273,105,133,43,30,12,0,0,12,18,18,18,0,0,0,0,0,0,13,13,0,0,13,0,0,0,0,0,0,0,0,0,85611
29270,2032,65,311,907,552,197,1012,697,75,37,0,38,622,605,605,0,0,17,17,0,0,315,125,42,0,83,190,190,190,0,0,0,0,0,0,85613
29271,20139,1114,4864,6420,4442,3299,243,161,156,13,15,128,5,5,0,5,0,0,0,0,0,82,82,4,0,78,0,0,0,0,0,0,0,0,0,85614
29272,6785,615,1187,3112,1220,651,488,240,218,106,0,112,22,13,0,13,0,9,0,0,9,248,229,4,28,197,19,19,0,0,19,0,0,0,0,85615
29273,4025,443,1257,1785,395,145,140,64,57,20,0,37,7,3,3,0,0,4,0,4,0,76,56,0,0,56,20,0,0,0,0,20,0,0,20,85616
29274,1005,142,290,403,119,51,52,14,14,2,0,12,0,0,0,0,0,0,0,0,0,38,35,5,14,16,3,2,0,0,2,1,0,0,1,85617
29275,1121,332,332,370,57,30,72,41,38,0,10,28,3,3,0,3,0,0,0,0,0,31,22,4,0,18,9,0,0,0,0,9,0,0,9,85618
29276,60,0,0,60,0,0,0,0,0,0,0,0,0,0,0,0,0,0,0,0,0,0,0,0,0,0,0,0,0,0,0,0,0,0,0,85619
29277,447,183,179,68,7,10,79,43,0,0,0,0,43,11,11,0,0,32,0,0,32,36,27,8,0,19,9,0,0,0,0,9,0,4,5,85620
29278,13581,4964,4153,2757,1250,457,1629,817,695,51,27,617,122,114,98,0,16,8,0,0,8,812,517,176,41,300,295,207,63,70,74,88,0,0,88,85621
29279,6710,162,1201,2292,1786,1269,6,0,0,0,0,0,0,0,0,0,0,0,0,0,0,6,6,0,0,6,0,0,0,0,0,0,0,0,0,85622
29280,3707,429,982,1600,244,452,395,154,154,29,0,125,0,0,0,0,0,0,0,0,0,241,241,103,40,98,0,0,0,0,0,0,0,0,0,85623
29281,1100,129,201,306,237,227,16,2,2,2,0,0,0,0,0,0,0,0,0,0,0,14,14,0,0,14,0,0,0,0,0,0,0,0,0,85624
29282,1630,285,490,543,170,142,29,23,23,0,0,23,0,0,0,0,0,0,0,0,0,6,6,0,0,6,0,0,0,0,0,0,0,0,0,85625
29283,588,301,199,77,11,0,66,45,45,31,0,14,0,0,0,0,0,0,0,0,0,21,21,0,0,21,0,0,0,0,0,0,0,0,0,85626
29284,621,64,244,219,53,41,57,47,40,6,0,34,7,7,7,0,0,0,0,0,0,10,10,2,0,8,0,0,0,0,0,0,0,0,0,85627
29285,14321,1283,2748,6017,2915,1358,682,299,247,10,55,182,52,52,52,0,0,0,0,0,0,383,363,79,0,284,20,20,10,0,10,0,0,0,0,85629
29286,1705,79,355,840,277,154,116,59,39,21,0,18,20,20,0,0,20,0,0,0,0,57,53,0,0,53,4,0,0,0,0,4,0,0,4,85630
29287,2416,422,624,978,130,262,147,102,91,10,36,45,11,11,0,11,0,0,0,0,0,45,32,8,11,13,13,13,13,0,0,0,0,0,0,85631
29288,737,72,193,240,130,102,30,14,10,0,0,10,4,0,0,0,0,4,0,0,4,16,16,2,0,14,0,0,0,0,0,0,0,0,0,85632
29289,27,9,4,4,5,5,3,2,0,0,0,0,2,0,0,0,0,2,2,0,0,1,0,0,0,0,1,0,0,0,0,1,0,0,1,85633
29290,3396,956,1369,899,97,75,448,189,80,0,0,80,109,17,17,0,0,92,0,0,92,259,106,0,0,106,153,98,0,22,76,55,20,0,35,85634
29291,22903,1891,5260,9699,3947,2106,1831,681,512,253,24,235,169,124,61,27,36,45,8,26,11,1150,895,324,41,530,255,154,44,24,86,101,13,44,44,85635
29292,1033,53,164,293,272,251,41,27,27,6,3,18,0,0,0,0,0,0,0,0,0,14,14,0,0,14,0,0,0,0,0,0,0,0,0,85637
29293,1562,220,489,647,133,73,112,77,53,18,8,27,24,24,9,15,0,0,0,0,0,35,22,0,0,22,13,0,0,0,0,13,0,0,13,85638
29294,336,98,94,77,35,32,20,20,20,0,0,20,0,0,0,0,0,0,0,0,0,0,0,0,0,0,0,0,0,0,0,0,0,0,0,85640
29295,14298,789,2692,6193,2908,1716,1222,712,622,119,82,421,90,65,42,14,9,25,0,0,25,510,454,124,11,319,56,56,42,14,0,0,0,0,0,85641
29296,6346,1485,1975,2058,511,317,508,259,165,99,0,66,94,60,3,0,57,34,0,0,34,249,199,63,17,119,50,50,19,19,12,0,0,0,0,85643
29297,1258,215,326,457,127,133,149,118,89,11,7,71,29,0,0,0,0,29,29,0,0,31,31,26,0,5,0,0,0,0,0,0,0,0,0,85645
29298,1297,65,154,370,378,330,15,15,15,0,0,15,0,0,0,0,0,0,0,0,0,0,0,0,0,0,0,0,0,0,0,0,0,0,0,85646
29299,11027,2543,3232,3114,1659,479,1348,620,581,65,44,472,39,39,33,6,0,0,0,0,0,728,694,54,13,627,34,20,20,0,0,14,0,0,14,85648
29300,10720,714,1824,4207,2129,1846,651,329,287,113,0,174,42,38,38,0,0,4,4,0,0,322,232,42,21,169,90,71,46,0,25,19,19,0,0,85650
29301,9319,1462,2749,3485,1091,532,613,306,242,60,46,136,64,59,41,0,18,5,0,0,5,307,275,122,36,117,32,32,18,0,14,0,0,0,0,85653
29302,180,93,59,28,0,0,14,14,14,0,14,0,0,0,0,0,0,0,0,0,0,0,0,0,0,0,0,0,0,0,0,0,0,0,0,85654
29303,6920,170,1168,2416,2007,1159,260,150,150,53,17,80,0,0,0,0,0,0,0,0,0,110,69,11,0,58,41,41,41,0,0,0,0,0,0,85658
29304,3492,609,520,1004,791,568,88,46,35,10,6,19,11,11,0,11,0,0,0,0,0,42,22,0,0,22,20,20,20,0,0,0,0,0,0,85701
29305,23516,1320,4790,7369,5546,4491,905,535,500,194,73,233,35,30,29,0,1,5,4,0,1,370,342,67,37,238,28,14,14,0,0,14,7,0,7,85704
29306,34260,7630,9806,12001,3060,1763,3547,1779,1469,366,234,869,310,146,115,22,9,164,57,59,48,1768,1515,273,124,1118,253,116,56,41,19,137,42,53,42,85705
29307,30485,10877,9019,8471,1641,477,4457,2336,1874,265,271,1338,462,242,100,117,25,220,20,62,138,2121,1760,363,245,1152,361,162,82,69,11,199,10,63,126,85706
29308,103,32,31,35,0,5,100,100,11,0,0,11,89,89,89,0,0,0,0,0,0,0,0,0,0,0,0,0,0,0,0,0,0,0,0,85707
29309,1545,31,346,897,194,77,100,81,69,8,20,41,12,0,0,0,0,12,0,0,12,19,9,0,0,9,10,10,0,0,10,0,0,0,0,85708
29310,38953,3535,10167,15613,6120,3518,2266,1015,766,247,79,440,249,240,204,7,29,9,0,9,0,1251,991,341,139,511,260,140,130,0,10,120,12,41,67,85710
29311,26282,4142,6548,9006,3734,2852,2065,1129,864,124,151,589,265,145,42,31,72,120,38,80,2,936,748,153,128,467,188,71,23,0,48,117,0,17,100,85711
29312,23443,2317,5206,7969,4553,3398,1460,593,386,69,73,244,207,64,30,33,1,143,39,75,29,867,745,235,25,485,122,89,69,20,0,33,15,6,12,85712
29313,30745,8754,9043,9314,2457,1177,3638,2020,1316,218,223,875,704,257,25,148,84,447,11,95,341,1618,1057,125,158,774,561,294,231,7,56,267,0,32,235,85713
29314,8291,3348,2580,1845,436,82,987,513,480,106,43,331,33,33,10,22,1,0,0,0,0,474,406,101,56,249,68,25,25,0,0,43,27,0,16,85714
29315,14091,677,2139,5381,3392,2502,1166,599,535,178,99,258,64,64,18,46,0,0,0,0,0,567,482,110,5,367,85,85,75,0,10,0,0,0,0,85715
29316,22377,2196,4443,7102,4909,3727,1314,641,478,72,68,338,163,104,59,0,45,59,5,16,38,673,497,166,51,280,176,141,35,59,47,35,12,4,19,85716
29317,21099,468,2038,4960,6435,7198,1303,626,564,210,13,341,62,27,27,0,0,35,21,0,14,677,669,117,7,545,8,8,0,1,7,0,0,0,0,85718
29318,19560,1811,3382,5880,4802,3685,9086,4181,4128,756,315,3057,53,24,6,18,0,29,0,0,29,4905,4796,1234,418,3144,109,76,76,0,0,33,0,9,24,85719
29319,0,0,0,0,0,0,0,0,0,0,0,0,0,0,0,0,0,0,0,0,0,0,0,0,0,0,0,0,0,0,0,0,0,0,0,85723
29320,0,0,0,0,0,0,0,0,0,0,0,0,0,0,0,0,0,0,0,0,0,0,0,0,0,0,0,0,0,0,0,0,0,0,0,85724
29321,0,0,0,0,0,0,0,0,0,0,0,0,0,0,0,0,0,0,0,0,0,0,0,0,0,0,0,0,0,0,0,0,0,0,0,85726
29322,26017,2784,6925,11723,3095,1490,2038,1172,875,244,197,434,297,244,121,36,87,53,6,12,35,866,624,212,106,306,242,161,65,68,28,81,46,23,12,85730
29323,7840,1343,2789,2802,663,243,434,238,203,17,0,186,35,18,18,0,0,17,0,0,17,196,91,20,0,71,105,83,39,0,44,22,0,0,22,85735
29324,3079,913,918,930,155,163,399,219,182,0,0,182,37,9,9,0,0,28,0,0,28,180,148,21,0,127,32,32,0,0,32,0,0,0,0,85736
29325,15147,312,1913,4701,4906,3315,1183,595,586,204,71,311,9,9,0,0,9,0,0,0,0,588,543,100,71,372,45,45,30,15,0,0,0,0,0,85737
29326,14721,699,3269,4613,3454,2686,698,372,284,11,0,273,88,16,0,16,0,72,14,0,58,326,258,56,22,180,68,47,47,0,0,21,21,0,0,85739
29327,22338,2183,5735,8959,3757,1704,1881,1087,891,327,39,525,196,145,46,17,82,51,45,6,0,794,647,260,20,367,147,106,34,72,0,41,0,1,40,85741
29328,16654,913,2850,6485,4032,2374,1623,890,825,217,156,452,65,36,27,9,0,29,3,26,0,733,717,251,51,415,16,0,0,0,0,16,0,0,16,85742
29329,20240,1177,4327,7621,4405,2710,1364,689,560,130,63,367,129,91,44,28,19,38,12,0,26,675,618,81,14,523,57,56,45,0,11,1,0,0,1,85743
29330,24378,3109,4628,8500,4119,4022,2650,1266,1108,265,149,694,158,107,62,11,34,51,7,43,1,1384,1248,365,166,717,136,105,66,9,30,31,0,0,31,85745
29331,24621,5371,8168,7910,2118,1054,3082,1585,1240,153,103,984,345,119,95,10,14,226,0,0,226,1497,1188,290,135,763,309,154,39,74,41,155,52,0,103,85746
29332,14531,466,2359,6073,3414,2219,1216,610,464,109,0,355,146,130,49,58,23,16,0,0,16,606,548,105,50,393,58,58,30,0,28,0,0,0,0,85747
29333,13350,610,2275,5070,3654,1741,899,518,500,88,33,379,18,11,11,0,0,7,0,7,0,381,264,106,0,158,117,103,77,7,19,14,0,0,14,85748
29334,14489,549,2130,4541,4338,2931,708,419,399,124,51,224,20,6,6,0,0,14,7,7,0,289,288,52,52,184,1,0,0,0,0,1,0,0,1,85749
29335,18406,371,1731,5450,4978,5876,842,316,310,28,20,262,6,6,0,0,6,0,0,0,0,526,521,174,41,306,5,5,5,0,0,0,0,0,0,85750
29336,12094,275,1528,4075,3567,2649,907,454,439,86,85,268,15,0,0,0,0,15,0,0,15,453,445,150,47,248,8,0,0,0,0,8,0,0,8,85755
29337,22520,5276,6654,7902,1949,739,1650,872,638,163,63,412,234,148,97,24,27,86,6,0,80,778,687,65,160,462,91,84,37,16,31,7,0,0,7,85756
29338,10359,2335,2722,4116,772,414,1133,566,460,83,21,356,106,63,0,57,6,43,7,4,32,567,520,65,61,394,47,42,0,0,42,5,5,0,0,85757
29339,11513,1173,3431,4817,1454,638,917,358,245,98,69,78,113,69,26,0,43,44,0,7,37,559,426,42,33,351,133,116,29,51,36,17,8,0,9,85901
29340,850,459,243,112,22,14,131,69,53,0,0,53,16,8,0,8,0,8,0,0,8,62,31,0,12,19,31,0,0,0,0,31,0,0,31,85911
29341,64,0,18,46,0,0,0,0,0,0,0,0,0,0,0,0,0,0,0,0,0,0,0,0,0,0,0,0,0,0,0,0,0,0,0,85912
29342,318,33,89,143,41,12,0,0,0,0,0,0,0,0,0,0,0,0,0,0,0,0,0,0,0,0,0,0,0,0,0,0,0,0,0,85920
29343,35,6,3,14,12,0,2,2,0,0,0,0,2,0,0,0,0,2,0,2,0,0,0,0,0,0,0,0,0,0,0,0,0,0,0,85922
29344,321,20,145,141,15,0,41,20,9,0,9,0,11,11,11,0,0,0,0,0,0,21,21,0,0,21,0,0,0,0,0,0,0,0,0,85923
29345,1905,409,677,566,166,87,116,46,44,0,4,40,2,0,0,0,0,2,0,0,2,70,70,21,0,49,0,0,0,0,0,0,0,0,0,85924
29346,2942,389,790,1341,297,125,245,74,61,0,0,61,13,13,13,0,0,0,0,0,0,171,162,78,47,37,9,9,9,0,0,0,0,0,0,85925
29347,100,28,44,17,11,0,0,0,0,0,0,0,0,0,0,0,0,0,0,0,0,0,0,0,0,0,0,0,0,0,0,0,0,0,0,85926
29348,66,17,0,31,9,9,0,0,0,0,0,0,0,0,0,0,0,0,0,0,0,0,0,0,0,0,0,0,0,0,0,0,0,0,0,85927
29349,736,206,179,189,138,24,24,24,24,0,0,24,0,0,0,0,0,0,0,0,0,0,0,0,0,0,0,0,0,0,0,0,0,0,0,85928
29350,5955,917,1380,2233,818,607,431,369,290,38,49,203,79,0,0,0,0,79,42,24,13,62,62,24,17,21,0,0,0,0,0,0,0,0,0,85929
29351,427,83,108,189,20,27,66,37,30,10,0,20,7,3,2,1,0,4,0,2,2,29,17,0,0,17,12,12,0,9,3,0,0,0,0,85930
29352,141,0,57,65,19,0,10,10,10,0,0,10,0,0,0,0,0,0,0,0,0,0,0,0,0,0,0,0,0,0,0,0,0,0,0,85931
29353,305,98,88,72,47,0,0,0,0,0,0,0,0,0,0,0,0,0,0,0,0,0,0,0,0,0,0,0,0,0,0,0,0,0,0,85932
29354,1867,364,515,717,171,100,262,128,124,0,4,120,4,4,0,0,4,0,0,0,0,134,134,0,0,134,0,0,0,0,0,0,0,0,0,85933
29355,317,44,77,75,0,121,59,43,43,0,0,43,0,0,0,0,0,0,0,0,0,16,16,0,0,16,0,0,0,0,0,0,0,0,0,85934
29356,4088,239,788,1627,626,808,196,151,151,43,0,108,0,0,0,0,0,0,0,0,0,45,45,9,0,36,0,0,0,0,0,0,0,0,0,85935
29357,3256,472,756,1493,453,82,227,169,153,0,31,122,16,14,0,0,14,2,0,0,2,58,44,10,0,34,14,0,0,0,0,14,0,0,14,85936
29358,4599,380,1169,2308,437,305,411,118,109,23,0,86,9,9,0,9,0,0,0,0,0,293,293,94,0,199,0,0,0,0,0,0,0,0,0,85937
29359,1508,266,489,574,127,52,279,140,135,3,58,74,5,5,5,0,0,0,0,0,0,139,101,0,66,35,38,38,38,0,0,0,0,0,0,85938
29360,2741,433,832,921,384,171,184,92,92,31,10,51,0,0,0,0,0,0,0,0,0,92,92,16,18,58,0,0,0,0,0,0,0,0,0,85939
29361,941,124,384,216,158,59,24,0,0,0,0,0,0,0,0,0,0,0,0,0,0,24,13,7,6,0,11,11,0,0,11,0,0,0,0,85940
29362,5462,1696,1895,1551,222,98,862,389,244,0,41,203,145,38,8,0,30,107,0,18,89,473,264,31,45,188,209,110,0,93,17,99,21,31,47,85941
29363,43,0,0,43,0,0,0,0,0,0,0,0,0,0,0,0,0,0,0,0,0,0,0,0,0,0,0,0,0,0,0,0,0,0,0,85942
29364,23497,1651,3455,7556,5992,4843,2558,1181,999,334,140,525,182,56,34,0,22,126,106,0,20,1377,1224,332,200,692,153,147,110,0,37,6,0,6,0,86001
29365,0,0,0,0,0,0,0,0,0,0,0,0,0,0,0,0,0,0,0,0,0,0,0,0,0,0,0,0,0,0,0,0,0,0,0,86003
29366,24424,2977,5300,8140,4630,3377,2235,1144,990,530,129,331,154,114,71,25,18,40,30,0,10,1091,959,258,75,626,132,78,14,64,0,54,13,0,41,86004
29367,425,16,66,218,87,38,4074,1612,1612,257,147,1208,0,0,0,0,0,0,0,0,0,2462,2462,504,511,1447,0,0,0,0,0,0,0,0,0,86011
29368,158,0,52,55,2,49,2,2,0,0,0,0,2,2,2,0,0,0,0,0,0,0,0,0,0,0,0,0,0,0,0,0,0,0,0,86015
29369,44,28,8,8,0,0,0,0,0,0,0,0,0,0,0,0,0,0,0,0,0,0,0,0,0,0,0,0,0,0,0,0,0,0,0,86016
29370,578,35,109,265,128,41,0,0,0,0,0,0,0,0,0,0,0,0,0,0,0,0,0,0,0,0,0,0,0,0,0,0,0,0,0,86017
29371,506,23,155,175,109,44,4,4,4,0,0,4,0,0,0,0,0,0,0,0,0,0,0,0,0,0,0,0,0,0,0,0,0,0,0,86018
29372,1108,352,428,265,18,45,135,56,39,3,0,36,17,8,8,0,0,9,4,0,5,79,28,0,0,28,51,25,4,14,7,26,4,5,17,86020
29373,1914,792,426,507,161,28,725,312,165,24,26,115,147,33,12,0,21,114,64,16,34,413,192,58,12,122,221,129,0,0,129,92,28,12,52,86021
29374,1206,157,402,476,66,105,129,46,38,13,7,18,8,8,8,0,0,0,0,0,0,83,54,22,23,9,29,0,0,0,0,29,0,7,22,86022
29375,1258,125,389,566,106,72,164,80,80,57,0,23,0,0,0,0,0,0,0,0,0,84,84,26,22,36,0,0,0,0,0,0,0,0,0,86023
29376,438,33,72,264,45,24,0,0,0,0,0,0,0,0,0,0,0,0,0,0,0,0,0,0,0,0,0,0,0,0,0,0,0,0,0,86024
29377,3734,447,1102,1663,384,138,321,142,107,6,40,61,35,19,0,0,19,16,0,0,16,179,149,29,24,96,30,12,0,0,12,18,0,0,18,86025
29378,0,0,0,0,0,0,0,0,0,0,0,0,0,0,0,0,0,0,0,0,0,0,0,0,0,0,0,0,0,0,0,0,0,0,0,86028
29379,183,44,47,92,0,0,0,0,0,0,0,0,0,0,0,0,0,0,0,0,0,0,0,0,0,0,0,0,0,0,0,0,0,0,0,86029
29380,953,153,387,371,23,19,152,61,34,0,0,34,27,20,0,0,20,7,0,0,7,91,81,0,0,81,10,10,7,3,0,0,0,0,0,86030
29381,1089,457,242,374,16,0,104,68,54,0,0,54,14,11,8,3,0,3,0,0,3,36,18,0,0,18,18,12,0,3,9,6,3,0,3,86031
29382,695,75,199,362,46,13,66,36,36,0,8,28,0,0,0,0,0,0,0,0,0,30,24,7,0,17,6,4,0,4,0,2,0,0,2,86032
29383,3972,1112,1413,1018,218,211,483,224,172,0,3,169,52,49,4,10,35,3,0,0,3,259,194,10,10,174,65,65,1,15,49,0,0,0,0,86033
29384,1134,308,292,405,69,60,118,81,31,0,0,31,50,38,0,11,27,12,0,0,12,37,35,0,0,35,2,2,0,0,2,0,0,0,0,86034
29385,1021,336,262,350,49,24,157,70,54,0,0,54,16,5,0,0,5,11,11,0,0,87,78,0,28,50,9,9,4,0,5,0,0,0,0,86035
29386,309,42,70,135,55,7,7,3,3,0,0,3,0,0,0,0,0,0,0,0,0,4,4,0,0,4,0,0,0,0,0,0,0,0,0,86036
29387,23,0,7,0,0,16,0,0,0,0,0,0,0,0,0,0,0,0,0,0,0,0,0,0,0,0,0,0,0,0,0,0,0,0,0,86038
29388,824,241,210,297,67,9,122,44,32,5,0,27,12,0,0,0,0,12,0,6,6,78,72,3,0,69,6,0,0,0,0,6,0,0,6,86039
29389,6238,1015,1669,2395,808,351,585,306,239,48,45,146,67,3,2,1,0,64,62,0,2,279,144,81,10,53,135,84,4,17,63,51,24,0,27,86040
29390,1307,262,297,586,128,34,176,118,68,0,0,68,50,50,0,20,30,0,0,0,0,58,24,0,0,24,34,34,0,29,5,0,0,0,0,86042
29391,902,158,337,341,51,15,123,48,18,7,0,11,30,21,0,0,21,9,0,0,9,75,55,0,0,55,20,20,20,0,0,0,0,0,0,86043
29392,2017,675,713,493,90,46,318,135,87,0,6,81,48,33,6,7,20,15,0,0,15,183,114,0,10,104,69,58,12,9,37,11,0,0,11,86044
29393,6877,1243,2325,2325,485,499,714,440,331,9,0,322,109,45,4,0,41,64,7,0,57,274,242,2,0,240,32,18,0,0,18,14,0,0,14,86045
29394,4072,415,1173,1620,550,314,193,96,75,7,11,57,21,18,0,0,18,3,3,0,0,97,78,4,8,66,19,19,19,0,0,0,0,0,0,86046
29395,9185,2367,2357,3584,627,250,1026,593,455,4,34,417,138,80,39,11,30,58,0,1,57,433,274,44,16,214,159,51,15,6,30,108,4,5,99,86047
29396,22,0,0,8,14,0,0,0,0,0,0,0,0,0,0,0,0,0,0,0,0,0,0,0,0,0,0,0,0,0,0,0,0,0,0,86052
29397,1221,457,451,267,32,14,207,119,87,0,9,78,32,19,3,4,12,13,0,7,6,88,64,10,4,50,24,21,6,7,8,3,0,0,3,86053
29398,961,287,320,288,43,23,98,44,29,0,6,23,15,11,4,4,3,4,0,0,4,54,38,0,4,34,16,10,0,7,3,6,0,0,6,86054
29399,16323,1675,3600,6030,2947,2071,919,532,453,84,63,306,79,79,64,14,1,0,0,0,0,387,334,117,28,189,53,53,0,37,16,0,0,0,0,86301
29400,13311,669,2446,5113,2968,2115,648,478,375,85,10,280,103,60,13,25,22,43,43,0,0,170,111,22,20,69,59,25,25,0,0,34,34,0,0,86303
29401,14583,812,2636,5654,3381,2100,759,354,271,70,0,201,83,47,47,0,0,36,0,36,0,405,360,152,61,147,45,45,21,20,4,0,0,0,0,86305
29402,87,58,10,19,0,0,0,0,0,0,0,0,0,0,0,0,0,0,0,0,0,0,0,0,0,0,0,0,0,0,0,0,0,0,0,86313
29403,22587,2640,6302,10032,2561,1052,1601,927,725,224,131,370,202,178,139,39,0,24,24,0,0,674,553,248,7,298,121,81,26,0,55,40,14,10,16,86314
29404,4943,455,1607,1935,674,272,405,101,88,13,12,63,13,13,13,0,0,0,0,0,0,304,304,93,51,160,0,0,0,0,0,0,0,0,0,86315
29405,1391,294,409,431,199,58,110,70,40,0,11,29,30,26,0,0,26,4,0,0,4,40,40,0,0,40,0,0,0,0,0,0,0,0,0,86320
29406,1310,92,534,500,142,42,199,164,143,46,11,86,21,21,3,0,18,0,0,0,0,35,35,0,0,35,0,0,0,0,0,0,0,0,0,86321
29407,8318,1121,2789,3197,887,324,529,288,215,147,14,54,73,15,9,0,6,58,0,1,57,241,171,82,13,76,70,8,0,0,8,62,56,0,6,86322
29408,11908,991,3748,5219,1273,677,695,338,287,155,0,132,51,23,16,0,7,28,0,0,28,357,178,26,31,121,179,74,0,0,74,105,86,15,4,86323
29409,3207,207,1057,1537,281,125,331,121,95,41,5,49,26,21,21,0,0,5,0,5,0,210,177,29,0,148,33,25,23,2,0,8,0,8,0,86324
29410,3764,315,824,1373,801,451,152,82,82,0,0,82,0,0,0,0,0,0,0,0,0,70,61,43,0,18,9,9,9,0,0,0,0,0,0,86325
29411,17526,2430,4700,7163,2056,1177,1304,714,391,183,12,196,323,251,62,171,18,72,0,56,16,590,368,49,158,161,222,195,132,0,63,27,27,0,0,86326
29412,7356,531,2334,3196,944,351,343,160,156,44,0,112,4,4,4,0,0,0,0,0,0,183,169,0,30,139,14,14,0,0,14,0,0,0,0,86327
29413,610,41,187,329,15,38,0,0,0,0,0,0,0,0,0,0,0,0,0,0,0,0,0,0,0,0,0,0,0,0,0,0,0,0,0,86329
29414,502,12,152,195,100,43,0,0,0,0,0,0,0,0,0,0,0,0,0,0,0,0,0,0,0,0,0,0,0,0,0,0,0,0,0,86331
29415,1429,299,488,527,94,21,93,35,34,11,5,18,1,0,0,0,0,1,0,0,1,58,45,7,0,38,13,13,0,0,13,0,0,0,0,86332
29416,4173,576,1859,1348,330,60,343,153,153,63,0,90,0,0,0,0,0,0,0,0,0,190,76,21,0,55,114,52,0,52,0,62,0,0,62,86333
29417,3152,565,690,1734,163,0,140,65,20,20,0,0,45,45,45,0,0,0,0,0,0,75,75,0,0,75,0,0,0,0,0,0,0,0,0,86334
29418,4001,572,1070,1472,515,372,293,54,54,13,0,41,0,0,0,0,0,0,0,0,0,239,80,44,0,36,159,0,0,0,0,159,159,0,0,86335
29419,9309,472,1500,3068,2445,1824,211,122,99,0,26,73,23,23,23,0,0,0,0,0,0,89,89,53,1,35,0,0,0,0,0,0,0,0,0,86336
29420,786,121,261,312,46,46,0,0,0,0,0,0,0,0,0,0,0,0,0,0,0,0,0,0,0,0,0,0,0,0,0,0,0,0,0,86337
29421,411,23,120,218,26,24,42,24,13,13,0,0,11,0,0,0,0,11,10,0,1,18,8,0,0,8,10,10,0,10,0,0,0,0,0,86338
29422,80,5,25,42,3,5,0,0,0,0,0,0,0,0,0,0,0,0,0,0,0,0,0,0,0,0,0,0,0,0,0,0,0,0,0,86343
29423,5797,339,951,1841,1966,700,303,201,181,17,71,93,20,20,0,20,0,0,0,0,0,102,75,0,0,75,27,15,0,0,15,12,0,0,12,86351
29424,18830,2469,6533,7368,1566,894,1185,722,549,51,40,458,173,117,96,0,21,56,0,15,41,463,381,62,85,234,82,56,56,0,0,26,0,0,26,86401
29425,11328,1632,4173,4066,824,633,849,523,490,246,46,198,33,33,33,0,0,0,0,0,0,326,300,45,36,219,26,12,12,0,0,14,0,0,14,86403
29426,12692,1700,4366,4985,949,692,555,290,246,39,12,195,44,15,15,0,0,29,29,0,0,265,195,41,0,154,70,70,66,0,4,0,0,0,0,86404
29427,18335,1339,6223,7724,1826,1223,1025,561,429,141,79,209,132,43,40,0,3,89,89,0,0,464,424,112,0,312,40,40,40,0,0,0,0,0,0,86406
29428,18610,3089,6550,6795,1434,742,1407,683,455,79,77,299,228,57,57,0,0,171,9,40,122,724,581,157,99,325,143,109,109,0,0,34,23,0,11,86409
29429,143,9,70,52,12,0,15,5,5,0,0,5,0,0,0,0,0,0,0,0,0,10,10,0,5,5,0,0,0,0,0,0,0,0,0,86411
29430,11544,2608,4252,4172,267,245,538,296,188,40,0,148,108,63,0,13,50,45,0,0,45,242,227,12,64,151,15,15,15,0,0,0,0,0,0,86413
29431,10616,2059,3730,3831,686,310,434,103,50,0,0,50,53,53,0,0,53,0,0,0,0,331,296,0,115,181,35,15,15,0,0,20,0,16,4,86426
29432,5618,668,2266,2012,502,170,236,36,6,0,0,6,30,30,9,0,21,0,0,0,0,200,144,30,0,114,56,0,0,0,0,56,34,0,22,86429
29433,225,36,69,82,34,4,5,5,5,0,0,5,0,0,0,0,0,0,0,0,0,0,0,0,0,0,0,0,0,0,0,0,0,0,0,86431
29434,2050,587,708,560,107,88,95,15,15,0,0,15,0,0,0,0,0,0,0,0,0,80,72,10,0,62,8,0,0,0,0,8,8,0,0,86432
29435,134,73,19,26,16,0,30,15,0,0,0,0,15,15,0,15,0,0,0,0,0,15,0,0,0,0,15,15,15,0,0,0,0,0,0,86433
29436,592,173,173,211,30,5,81,36,22,11,1,10,14,8,0,0,8,6,2,0,4,45,30,22,0,8,15,4,0,4,0,11,2,9,0,86434
29437,136,54,54,19,3,6,4,0,0,0,0,0,0,0,0,0,0,0,0,0,0,4,0,0,0,0,4,0,0,0,0,4,0,0,4,86435
29438,1227,339,334,361,82,111,52,52,52,0,0,52,0,0,0,0,0,0,0,0,0,0,0,0,0,0,0,0,0,0,0,0,0,0,0,86436
29439,54,18,20,14,0,2,3,3,2,0,0,2,1,0,0,0,0,1,0,0,1,0,0,0,0,0,0,0,0,0,0,0,0,0,0,86437
29440,686,127,269,187,91,12,28,28,25,0,0,25,3,3,3,0,0,0,0,0,0,0,0,0,0,0,0,0,0,0,0,0,0,0,0,86438
29441,4991,899,1912,1661,335,184,384,130,65,5,18,42,65,64,58,6,0,1,1,0,0,254,194,8,61,125,60,49,14,3,32,11,0,0,11,86440
29442,2018,329,642,892,111,44,42,0,0,0,0,0,0,0,0,0,0,0,0,0,0,42,42,21,0,21,0,0,0,0,0,0,0,0,0,86441
29443,23996,4604,7829,8635,2069,859,1461,697,488,167,85,236,209,47,9,38,0,162,36,60,66,764,656,170,67,419,108,41,33,0,8,67,0,0,67,86442
29444,0,0,0,0,0,0,0,0,0,0,0,0,0,0,0,0,0,0,0,0,0,0,0,0,0,0,0,0,0,0,0,0,0,0,0,86443
29445,603,59,194,230,74,46,0,0,0,0,0,0,0,0,0,0,0,0,0,0,0,0,0,0,0,0,0,0,0,0,0,0,0,0,0,86444
29446,278,58,71,139,10,0,0,0,0,0,0,0,0,0,0,0,0,0,0,0,0,0,0,0,0,0,0,0,0,0,0,0,0,0,0,86445
29447,917,349,338,192,17,21,113,69,59,0,0,59,10,10,0,10,0,0,0,0,0,44,29,0,6,23,15,8,0,0,8,7,0,3,4,86502
29448,6110,1596,1953,1988,347,226,1131,569,466,4,13,449,103,55,7,3,45,48,0,7,41,562,325,12,18,295,237,191,0,32,159,46,0,36,10,86503
29449,3728,793,1344,1278,188,125,338,194,136,0,0,136,58,22,3,3,16,36,0,0,36,144,129,0,0,129,15,15,12,0,3,0,0,0,0,86504
29450,4599,1403,1379,1455,253,109,580,275,219,0,19,200,56,38,2,26,10,18,0,6,12,305,254,43,14,197,51,38,5,7,26,13,0,12,1,86505
29451,951,381,317,217,26,10,58,18,14,0,0,14,4,2,0,0,2,2,0,0,2,40,35,0,2,33,5,5,0,0,5,0,0,0,0,86506
29452,1178,327,283,456,80,32,258,124,105,10,0,95,19,8,0,0,8,11,0,0,11,134,105,0,11,94,29,18,0,0,18,11,0,0,11,86507
29453,581,185,251,125,11,9,95,65,44,7,0,37,21,12,6,0,6,9,0,0,9,30,30,0,0,30,0,0,0,0,0,0,0,0,0,86508
29454,2738,963,908,672,90,105,455,251,188,0,11,177,63,39,0,13,26,24,6,0,18,204,159,0,13,146,45,38,7,15,16,7,0,5,2,86510
29455,1976,486,682,585,82,141,97,27,20,0,0,20,7,5,0,0,5,2,0,0,2,70,70,59,0,11,0,0,0,0,0,0,0,0,0,86511
29456,1437,504,526,346,26,35,263,141,127,0,17,110,14,14,0,0,14,0,0,0,0,122,109,0,0,109,13,7,0,5,2,6,0,6,0,86512
29457,1586,590,521,362,71,42,215,114,95,0,0,95,19,15,1,10,4,4,0,0,4,101,98,0,0,98,3,3,0,0,3,0,0,0,0,86514
29458,2794,528,1031,847,162,226,597,310,252,0,10,242,58,48,0,0,48,10,0,0,10,287,233,48,12,173,54,28,17,0,11,26,0,0,26,86515
29459,1125,546,324,239,8,8,184,83,52,0,0,52,31,9,2,0,7,22,0,3,19,101,76,0,4,72,25,13,0,8,5,12,0,0,12,86520
29460,600,199,273,117,8,3,149,86,61,7,0,54,25,22,4,0,18,3,0,0,3,63,39,0,0,39,24,16,0,0,16,8,0,4,4,86535
29461,1199,328,347,356,89,79,238,111,84,1,7,76,27,20,7,13,0,7,0,7,0,127,104,11,5,88,23,15,0,0,15,8,0,0,8,86538
29462,503,182,169,143,6,3,65,35,26,0,0,26,9,9,0,6,3,0,0,0,0,30,30,2,5,23,0,0,0,0,0,0,0,0,0,86540
29463,820,331,295,159,19,16,103,64,59,2,0,57,5,5,0,0,5,0,0,0,0,39,21,6,3,12,18,18,0,1,17,0,0,0,0,86544
29464,912,297,295,241,35,44,86,53,26,0,0,26,27,0,0,0,0,27,0,20,7,33,18,0,0,18,15,15,0,0,15,0,0,0,0,86545
29465,582,158,208,175,26,15,146,61,39,0,4,35,22,3,0,0,3,19,0,0,19,85,72,6,0,66,13,13,0,0,13,0,0,0,0,86547
29466,849,241,197,287,92,32,366,201,183,20,22,141,18,4,0,0,4,14,0,0,14,165,160,17,14,129,5,5,0,0,5,0,0,0,0,86556
29467,2431,585,964,708,112,62,243,109,67,0,4,63,42,6,0,6,0,36,16,8,12,134,98,0,0,98,36,21,8,0,13,15,3,5,7,87001
29468,14837,2630,5131,4636,1507,933,1328,706,620,198,49,373,86,38,18,20,0,48,0,0,48,622,534,183,34,317,88,61,7,21,33,27,18,0,9,87002
29469,7015,1364,2569,1980,602,500,506,283,230,13,18,199,53,42,40,0,2,11,0,0,11,223,166,38,24,104,57,40,25,2,13,17,1,2,14,87004
29470,246,12,131,57,15,31,3,0,0,0,0,0,0,0,0,0,0,0,0,0,0,3,3,0,0,3,0,0,0,0,0,0,0,0,0,87005
29471,584,126,164,220,36,38,87,87,87,9,10,68,0,0,0,0,0,0,0,0,0,0,0,0,0,0,0,0,0,0,0,0,0,0,0,87006
29472,590,64,421,92,13,0,19,19,13,0,0,13,6,0,0,0,0,6,0,6,0,0,0,0,0,0,0,0,0,0,0,0,0,0,0,87007
29473,2243,81,274,614,582,692,251,201,196,53,24,119,5,5,5,0,0,0,0,0,0,50,50,15,0,35,0,0,0,0,0,0,0,0,0,87008
29474,903,21,61,249,361,211,0,0,0,0,0,0,0,0,0,0,0,0,0,0,0,0,0,0,0,0,0,0,0,0,0,0,0,0,0,87010
29475,20,0,5,5,10,0,0,0,0,0,0,0,0,0,0,0,0,0,0,0,0,0,0,0,0,0,0,0,0,0,0,0,0,0,0,87011
29476,194,36,96,51,0,11,10,0,0,0,0,0,0,0,0,0,0,0,0,0,0,10,4,0,0,4,6,0,0,0,0,6,0,0,6,87012
29477,2663,982,859,532,131,159,285,167,77,9,3,65,90,70,10,53,7,20,2,2,16,118,93,18,6,69,25,11,0,0,11,14,5,4,5,87013
29478,352,63,129,99,29,32,0,0,0,0,0,0,0,0,0,0,0,0,0,0,0,0,0,0,0,0,0,0,0,0,0,0,0,0,0,87014
29479,9352,636,2335,3515,1487,1379,837,377,370,60,73,237,7,0,0,0,0,7,0,0,7,460,419,73,64,282,41,27,17,10,0,14,0,0,14,87015
29480,2986,847,817,972,208,142,155,89,67,0,2,65,22,22,22,0,0,0,0,0,0,66,62,0,0,62,4,4,0,0,4,0,0,0,0,87016
29481,252,92,97,36,6,21,37,24,0,0,0,0,24,7,7,0,0,17,0,17,0,13,0,0,0,0,13,13,13,0,0,0,0,0,0,87017
29482,242,137,68,35,2,0,14,2,0,0,0,0,2,0,0,0,0,2,0,0,2,12,9,0,0,9,3,3,0,0,3,0,0,0,0,87018
29483,7768,1629,2602,2562,653,322,625,400,354,150,0,204,46,18,0,0,18,28,0,0,28,225,139,5,33,101,86,86,48,0,38,0,0,0,0,87020
29484,2270,666,699,710,101,94,160,69,34,0,28,6,35,25,25,0,0,10,0,0,10,91,91,0,0,91,0,0,0,0,0,0,0,0,0,87021
29485,584,96,189,219,72,8,9,9,9,9,0,0,0,0,0,0,0,0,0,0,0,0,0,0,0,0,0,0,0,0,0,0,0,0,0,87022
29486,321,95,86,120,20,0,21,0,0,0,0,0,0,0,0,0,0,0,0,0,0,21,21,11,0,10,0,0,0,0,0,0,0,0,0,87023
29487,1349,150,589,439,102,69,156,103,84,11,11,62,19,19,0,0,19,0,0,0,0,53,44,3,0,41,9,9,0,0,9,0,0,0,0,87024
29488,946,13,253,311,183,186,25,9,9,0,7,2,0,0,0,0,0,0,0,0,0,16,16,0,0,16,0,0,0,0,0,0,0,0,0,87025
29489,2410,521,935,771,126,57,281,132,130,8,43,79,2,0,0,0,0,2,0,0,2,149,132,29,17,86,17,14,7,7,0,3,0,3,0,87026
29490,304,75,128,73,22,6,5,0,0,0,0,0,0,0,0,0,0,0,0,0,0,5,5,0,0,5,0,0,0,0,0,0,0,0,0,87027
29491,231,37,10,122,55,7,0,0,0,0,0,0,0,0,0,0,0,0,0,0,0,0,0,0,0,0,0,0,0,0,0,0,0,0,0,87028
29492,165,36,74,37,10,8,11,0,0,0,0,0,0,0,0,0,0,0,0,0,0,11,11,0,11,0,0,0,0,0,0,0,0,0,0,87029
29493,27769,5942,8011,9463,2801,1552,2576,1379,929,212,152,565,450,209,104,27,78,241,74,66,101,1197,1022,170,127,725,175,113,57,9,47,62,0,0,62,87031
29494,0,0,0,0,0,0,0,0,0,0,0,0,0,0,0,0,0,0,0,0,0,0,0,0,0,0,0,0,0,0,0,0,0,0,0,87032
29495,1523,157,802,451,105,8,123,44,38,15,7,16,6,6,6,0,0,0,0,0,0,79,77,16,0,61,2,2,2,0,0,0,0,0,0,87034
29496,4599,710,1669,1605,408,207,500,211,163,51,7,105,48,26,13,4,9,22,0,22,0,289,270,33,0,237,19,6,6,0,0,13,0,0,13,87035
29497,1273,214,498,338,114,109,146,49,35,20,0,15,14,14,0,0,14,0,0,0,0,97,97,32,0,65,0,0,0,0,0,0,0,0,0,87036
29498,454,234,118,57,3,42,30,13,6,0,0,6,7,7,2,0,5,0,0,0,0,17,12,0,3,9,5,5,0,0,5,0,0,0,0,87037
29499,334,7,120,166,26,15,25,12,12,0,0,12,0,0,0,0,0,0,0,0,0,13,0,0,0,0,13,0,0,0,0,13,0,0,13,87038
29500,277,12,104,138,9,14,16,16,16,0,0,16,0,0,0,0,0,0,0,0,0,0,0,0,0,0,0,0,0,0,0,0,0,0,0,87040
29501,538,125,195,136,53,29,22,17,10,0,0,10,7,3,3,0,0,4,0,4,0,5,3,0,0,3,2,2,0,2,0,0,0,0,0,87041
29502,2572,448,616,958,412,138,254,140,129,0,17,112,11,0,0,0,0,11,0,0,11,114,114,0,0,114,0,0,0,0,0,0,0,0,0,87042
29503,4532,124,487,1490,1229,1202,92,57,57,26,2,29,0,0,0,0,0,0,0,0,0,35,19,0,0,19,16,0,0,0,0,16,16,0,0,87043
29504,365,63,100,117,45,40,4,0,0,0,0,0,0,0,0,0,0,0,0,0,0,4,4,0,0,4,0,0,0,0,0,0,0,0,0,87044
29505,811,385,206,189,11,20,107,56,39,0,8,31,17,7,7,0,0,10,0,7,3,51,38,2,2,34,13,13,2,0,11,0,0,0,0,87045
29506,38,0,15,18,5,0,0,0,0,0,0,0,0,0,0,0,0,0,0,0,0,0,0,0,0,0,0,0,0,0,0,0,0,0,0,87046
29507,3600,80,626,1054,1001,839,153,102,49,0,0,49,53,0,0,0,0,53,0,0,53,51,51,0,0,51,0,0,0,0,0,0,0,0,0,87047
29508,6864,271,1577,1647,1763,1606,426,187,125,13,8,104,62,34,34,0,0,28,28,0,0,239,223,50,0,173,16,16,4,12,0,0,0,0,0,87048
29509,535,160,182,156,12,25,81,29,29,0,0,29,0,0,0,0,0,0,0,0,0,52,52,0,32,20,0,0,0,0,0,0,0,0,0,87049
29510,764,110,454,144,56,0,0,0,0,0,0,0,0,0,0,0,0,0,0,0,0,0,0,0,0,0,0,0,0,0,0,0,0,0,0,87051
29511,1669,487,601,502,53,26,309,171,119,10,3,106,52,29,9,7,13,23,14,0,9,138,95,3,9,83,43,21,5,0,16,22,0,15,7,87052
29512,682,125,284,205,43,25,67,37,31,0,0,31,6,6,0,0,6,0,0,0,0,30,28,2,0,26,2,2,0,0,2,0,0,0,0,87053
29513,765,55,227,145,281,57,99,99,90,90,0,0,9,9,9,0,0,0,0,0,0,0,0,0,0,0,0,0,0,0,0,0,0,0,0,87056
29514,6954,389,1544,2180,1366,1475,474,242,215,106,59,50,27,10,0,0,10,17,0,0,17,232,187,33,62,92,45,0,0,0,0,45,0,0,45,87059
29515,250,47,130,46,12,15,32,32,17,17,0,0,15,15,15,0,0,0,0,0,0,0,0,0,0,0,0,0,0,0,0,0,0,0,0,87061
29516,1103,413,283,342,48,17,195,102,52,0,0,52,50,0,0,0,0,50,0,0,50,93,93,32,0,61,0,0,0,0,0,0,0,0,0,87062
29517,149,32,76,26,13,2,25,0,0,0,0,0,0,0,0,0,0,0,0,0,0,25,0,0,0,0,25,25,0,0,25,0,0,0,0,87063
29518,98,40,34,17,7,0,5,0,0,0,0,0,0,0,0,0,0,0,0,0,0,5,5,0,0,5,0,0,0,0,0,0,0,0,0,87064
29519,3460,308,1026,1324,451,351,181,48,42,12,0,30,6,4,4,0,0,2,2,0,0,133,82,0,26,56,51,8,0,0,8,43,0,43,0,87068
29520,60,22,13,15,10,0,0,0,0,0,0,0,0,0,0,0,0,0,0,0,0,0,0,0,0,0,0,0,0,0,0,0,0,0,0,87070
29521,319,42,121,132,20,4,25,16,13,0,4,9,3,3,3,0,0,0,0,0,0,9,9,0,3,6,0,0,0,0,0,0,0,0,0,87072
29522,443,17,59,168,102,97,11,11,7,0,0,7,4,4,0,0,4,0,0,0,0,0,0,0,0,0,0,0,0,0,0,0,0,0,0,87083
29523,13390,3293,3535,3535,1725,1302,971,449,363,33,23,307,86,70,56,13,1,16,14,0,2,522,459,134,22,303,63,42,0,30,12,21,0,0,21,87102
29524,8270,1106,1987,2103,1462,1612,640,285,189,46,20,123,96,17,15,0,2,79,0,38,41,355,269,24,0,245,86,53,0,24,29,33,0,0,33,87104
29525,36948,10098,13056,9178,2863,1753,3976,2174,1498,248,119,1131,676,253,179,10,64,423,108,86,229,1802,1544,380,153,1011,258,57,24,8,25,201,0,4,197,87105
29526,15814,1397,1958,4505,3896,4058,1926,974,819,184,75,560,155,108,62,10,36,47,0,33,14,952,817,197,33,587,135,0,0,0,0,135,39,68,28,87106
29527,21986,2954,5800,6082,3685,3465,1557,837,601,90,72,439,236,139,25,66,48,97,76,20,1,720,678,266,30,382,42,28,20,0,8,14,0,0,14,87107
29528,24953,5473,5638,7535,3272,3035,2110,824,500,138,57,305,324,100,67,0,33,224,51,82,91,1286,868,183,49,636,418,269,102,65,102,149,20,0,129,87108
29529,27444,1798,6511,9783,5593,3759,2203,736,493,144,64,285,243,85,58,27,0,158,85,14,59,1467,1217,385,122,710,250,131,116,0,15,119,72,12,35,87109
29530,28006,1740,6581,9126,5678,4881,1094,517,492,245,33,214,25,25,25,0,0,0,0,0,0,577,512,120,55,337,65,33,14,9,10,32,32,0,0,87110
29531,42424,1472,7198,13302,10728,9724,2709,1517,1318,297,121,900,199,91,87,0,4,108,0,68,40,1192,1061,363,53,645,131,99,87,12,0,32,0,11,21,87111
29532,30615,2766,7243,10673,5508,4425,2199,1173,1004,268,130,606,169,50,50,0,0,119,9,28,82,1026,932,299,76,557,94,34,6,1,27,60,0,7,53,87112
29533,10242,1093,1896,3080,2250,1923,951,443,391,37,105,249,52,52,0,52,0,0,0,0,0,508,433,151,15,267,75,35,35,0,0,40,0,40,0,87113
29534,41498,2902,8759,15102,9332,5403,3545,1897,1728,566,132,1030,169,137,88,49,0,32,13,10,9,1648,1409,572,82,755,239,223,50,15,158,16,0,16,0,87114
29535,1911,34,216,1087,344,230,171,103,44,5,0,39,59,59,54,0,5,0,0,0,0,68,45,0,0,45,23,14,9,0,5,9,0,0,9,87116
29536,18,0,0,18,0,0,25,17,9,9,0,0,8,8,8,0,0,0,0,0,0,8,0,0,0,0,8,8,8,0,0,0,0,0,0,87117
29537,39407,2754,8754,14468,8081,5350,2618,1414,1244,261,109,874,170,157,59,63,35,13,0,0,13,1204,1113,415,88,610,91,56,51,0,5,35,7,20,8,87120
29538,42072,11517,14291,12461,2591,1212,4553,2386,1907,310,140,1457,479,232,80,144,8,247,63,60,124,2167,1810,299,102,1409,357,162,84,0,78,195,60,0,135,87121
29539,12593,157,1440,2587,3813,4596,984,439,414,85,0,329,25,25,9,0,16,0,0,0,0,545,545,142,9,394,0,0,0,0,0,0,0,0,0,87122
29540,28387,4035,6750,9875,4365,3362,2351,1182,971,198,57,716,211,182,114,48,20,29,0,29,0,1169,1075,428,34,613,94,69,42,27,0,25,25,0,0,87123
29541,34172,2414,9675,13196,5574,3313,3038,1515,1233,320,99,814,282,236,122,15,99,46,15,0,31,1523,1220,414,95,711,303,215,79,65,71,88,63,0,25,87124
29542,24026,1469,5685,9656,4731,2485,2148,1160,987,195,83,709,173,103,86,7,10,70,70,0,0,988,889,155,147,587,99,71,24,0,47,28,14,14,0,87144
29543,13825,2876,4172,4138,1488,1151,2016,937,786,54,19,713,151,76,45,22,9,75,12,0,63,1079,942,57,55,830,137,75,17,58,0,62,0,0,62,87301
29544,1797,574,644,450,44,85,341,180,157,8,0,149,23,13,0,0,13,10,0,6,4,161,133,3,0,130,28,23,0,0,23,5,0,0,5,87305
29545,470,111,144,199,15,1,51,38,27,0,0,27,11,11,0,0,11,0,0,0,0,13,13,0,0,13,0,0,0,0,0,0,0,0,0,87310
29546,1870,739,561,497,61,12,228,132,90,0,4,86,42,28,0,0,28,14,0,0,14,96,82,0,8,74,14,7,0,0,7,7,0,0,7,87311
29547,257,80,78,62,28,9,16,10,10,6,0,4,0,0,0,0,0,0,0,0,0,6,3,0,0,3,3,3,0,0,3,0,0,0,0,87312
29548,3077,919,851,1048,174,85,508,258,225,0,28,197,33,9,0,4,5,24,0,6,18,250,218,3,2,213,32,28,2,0,26,4,0,0,4,87313
29549,24,0,0,24,0,0,0,0,0,0,0,0,0,0,0,0,0,0,0,0,0,0,0,0,0,0,0,0,0,0,0,0,0,0,0,87315
29550,870,178,202,415,46,29,107,67,65,0,0,65,2,0,0,0,0,2,0,2,0,40,38,0,0,38,2,0,0,0,0,2,0,0,2,87316
29551,472,282,115,46,29,0,54,8,8,0,0,8,0,0,0,0,0,0,0,0,0,46,46,46,0,0,0,0,0,0,0,0,0,0,0,87317
29552,1521,726,511,264,15,5,222,146,133,0,11,122,13,9,2,3,4,4,0,0,4,76,53,2,0,51,23,13,6,0,7,10,7,0,3,87319
29553,407,103,137,157,9,1,73,52,32,0,0,32,20,17,0,0,17,3,0,0,3,21,18,0,0,18,3,3,0,0,3,0,0,0,0,87320
29554,1192,405,388,301,49,49,100,49,40,9,0,31,9,4,0,4,0,5,0,5,0,51,36,0,0,36,15,6,0,0,6,9,0,0,9,87321
29555,133,25,88,20,0,0,23,0,0,0,0,0,0,0,0,0,0,0,0,0,0,23,23,0,0,23,0,0,0,0,0,0,0,0,0,87322
29556,2744,778,1102,485,268,111,322,145,117,8,23,86,28,17,0,5,12,11,0,0,11,177,150,0,0,150,27,9,0,9,0,18,2,2,14,87323
29557,2000,493,630,669,119,89,247,123,84,0,0,84,39,39,0,9,30,0,0,0,0,124,89,0,0,89,35,32,3,5,24,3,0,0,3,87325
29558,1099,385,316,348,28,22,124,75,30,0,4,26,45,12,6,0,6,33,17,0,16,49,37,9,0,28,12,8,4,0,4,4,0,0,4,87326
29559,6675,1501,2624,2085,309,156,475,243,215,26,0,189,28,0,0,0,0,28,0,0,28,232,180,11,0,169,52,42,0,11,31,10,10,0,0,87327
29560,1622,422,577,465,64,94,279,117,91,10,0,81,26,17,7,4,6,9,0,0,9,162,133,16,0,117,29,29,0,0,29,0,0,0,0,87328
29561,168,38,40,55,35,0,0,0,0,0,0,0,0,0,0,0,0,0,0,0,0,0,0,0,0,0,0,0,0,0,0,0,0,0,0,87347
29562,461,119,121,125,50,46,38,31,23,0,5,18,8,8,0,0,8,0,0,0,0,7,0,0,0,0,7,7,0,5,2,0,0,0,0,87357
29563,711,224,274,156,32,25,83,39,25,0,0,25,14,8,0,4,4,6,0,0,6,44,28,1,0,27,16,13,0,0,13,3,0,0,3,87364
29564,1474,430,631,341,72,0,260,138,116,34,0,82,22,16,16,0,0,6,0,6,0,122,94,0,0,94,28,28,25,0,3,0,0,0,0,87375
29565,27841,5114,8754,9451,2778,1744,2641,1275,828,321,13,494,447,175,58,30,87,272,54,33,185,1366,1176,120,96,960,190,130,0,34,96,60,11,0,49,87401
29566,7232,525,2107,2657,1265,678,642,311,227,23,17,187,84,64,24,0,40,20,13,0,7,331,241,69,0,172,90,74,0,0,74,16,0,3,13,87402
29567,10964,1763,3331,4065,1137,668,919,561,459,16,64,379,102,53,30,14,9,49,26,0,23,358,273,118,26,129,85,76,58,13,5,9,0,0,9,87410
29568,606,214,178,157,57,0,22,0,0,0,0,0,0,0,0,0,0,0,0,0,0,22,18,0,0,18,4,0,0,0,0,4,0,0,4,87412
29569,9857,1976,3953,2745,833,350,829,399,332,62,22,248,67,17,14,0,3,50,0,0,50,430,311,82,7,222,119,85,54,1,30,34,0,0,34,87413
29570,1402,362,294,454,218,74,73,1,1,0,1,0,0,0,0,0,0,0,0,0,0,72,71,6,0,65,1,1,0,1,0,0,0,0,0,87415
29571,3529,635,1367,1238,240,49,329,177,148,7,0,141,29,21,0,3,18,8,0,5,3,152,106,4,0,102,46,27,7,11,9,19,0,5,14,87416
29572,3126,410,720,1415,422,159,381,223,223,66,0,157,0,0,0,0,0,0,0,0,0,158,126,26,0,100,32,0,0,0,0,32,0,0,32,87417
29573,982,106,304,451,102,19,162,91,67,0,0,67,24,24,24,0,0,0,0,0,0,71,71,0,0,71,0,0,0,0,0,0,0,0,0,87418
29574,203,29,61,90,23,0,3,2,2,0,2,0,0,0,0,0,0,0,0,0,0,1,0,0,0,0,1,1,0,1,0,0,0,0,0,87419
29575,7488,1378,2691,2618,440,361,986,521,445,44,4,397,76,40,0,5,35,36,0,0,36,465,423,10,15,398,42,7,1,0,6,35,0,0,35,87420
29576,1046,265,367,324,47,43,76,54,44,5,0,39,10,8,3,0,5,2,0,0,2,22,5,0,0,5,17,17,6,0,11,0,0,0,0,87421
29577,1130,386,425,227,53,39,103,57,43,0,2,41,14,12,0,0,12,2,0,0,2,46,33,0,0,33,13,3,0,0,3,10,2,0,8,87455
29578,828,337,298,165,7,21,71,44,28,0,0,28,16,11,0,0,11,5,0,0,5,27,24,0,0,24,3,3,0,0,3,0,0,0,0,87461
29579,270,118,89,60,0,3,20,5,2,0,0,2,3,0,0,0,0,3,0,0,3,15,15,0,0,15,0,0,0,0,0,0,0,0,0,87499
29580,12908,709,1587,3016,3568,4028,254,145,92,5,0,87,53,10,10,0,0,43,0,40,3,109,72,20,35,17,37,33,0,0,33,4,0,0,4,87501
29581,22943,2364,4504,5504,5354,5217,1415,724,642,195,46,401,82,34,4,0,30,48,33,15,0,691,549,142,11,396,142,62,25,0,37,80,26,54,0,87505
29582,9923,831,2027,2623,2012,2430,528,260,204,28,16,160,56,38,5,24,9,18,5,6,7,268,219,54,21,144,49,40,17,5,18,9,0,2,7,87506
29583,29411,6556,7507,7709,4254,3385,2709,1482,1149,304,332,513,333,121,89,16,16,212,83,129,0,1227,859,188,165,506,368,136,73,0,63,232,46,38,148,87507
29584,14745,1405,2725,3677,3957,2981,588,349,332,54,31,247,17,9,9,0,0,8,0,0,8,239,221,75,30,116,18,7,7,0,0,11,11,0,0,87508
29585,615,27,147,180,58,203,43,0,0,0,0,0,0,0,0,0,0,0,0,0,0,43,0,0,0,0,43,0,0,0,0,43,0,0,43,87510
29586,1439,336,437,561,102,3,141,76,41,0,0,41,35,0,0,0,0,35,0,27,8,65,65,39,0,26,0,0,0,0,0,0,0,0,0,87511
29587,179,45,90,0,17,27,0,0,0,0,0,0,0,0,0,0,0,0,0,0,0,0,0,0,0,0,0,0,0,0,0,0,0,0,0,87512
29588,742,77,169,258,120,118,21,0,0,0,0,0,0,0,0,0,0,0,0,0,0,21,21,12,0,9,0,0,0,0,0,0,0,0,0,87513
29589,1079,51,272,180,287,289,56,0,0,0,0,0,0,0,0,0,0,0,0,0,0,56,0,0,0,0,56,0,0,0,0,56,0,0,56,87514
29590,188,46,81,35,8,18,0,0,0,0,0,0,0,0,0,0,0,0,0,0,0,0,0,0,0,0,0,0,0,0,0,0,0,0,0,87515
29591,137,32,58,45,2,0,6,6,6,0,0,6,0,0,0,0,0,0,0,0,0,0,0,0,0,0,0,0,0,0,0,0,0,0,0,87516
29592,89,31,0,18,40,0,0,0,0,0,0,0,0,0,0,0,0,0,0,0,0,0,0,0,0,0,0,0,0,0,0,0,0,0,0,87517
29593,62,0,31,12,0,19,23,14,14,0,0,14,0,0,0,0,0,0,0,0,0,9,9,0,0,9,0,0,0,0,0,0,0,0,0,87518
29594,409,74,170,156,9,0,0,0,0,0,0,0,0,0,0,0,0,0,0,0,0,0,0,0,0,0,0,0,0,0,0,0,0,0,0,87519
29595,1164,192,390,310,206,66,48,36,36,3,5,28,0,0,0,0,0,0,0,0,0,12,12,7,0,5,0,0,0,0,0,0,0,0,0,87520
29596,625,99,277,173,34,42,56,49,41,1,0,40,8,0,0,0,0,8,0,0,8,7,4,3,0,1,3,3,0,0,3,0,0,0,0,87521
29597,1913,503,617,629,84,80,307,117,24,0,15,9,93,57,57,0,0,36,0,0,36,190,96,0,0,96,94,77,27,0,50,17,0,0,17,87522
29598,218,151,0,67,0,0,0,0,0,0,0,0,0,0,0,0,0,0,0,0,0,0,0,0,0,0,0,0,0,0,0,0,0,0,0,87523
29599,47,8,17,0,8,14,37,37,0,0,0,0,37,37,37,0,0,0,0,0,0,0,0,0,0,0,0,0,0,0,0,0,0,0,0,87524
29600,61,0,13,4,21,23,0,0,0,0,0,0,0,0,0,0,0,0,0,0,0,0,0,0,0,0,0,0,0,0,0,0,0,0,0,87525
29601,555,90,140,227,70,28,0,0,0,0,0,0,0,0,0,0,0,0,0,0,0,0,0,0,0,0,0,0,0,0,0,0,0,0,0,87527
29602,1907,378,684,624,152,69,224,69,53,17,0,36,16,6,6,0,0,10,6,4,0,155,113,25,19,69,42,22,11,0,11,20,0,20,0,87528
29603,4126,325,957,1290,704,850,342,163,69,10,0,59,94,9,9,0,0,85,0,85,0,179,111,10,3,98,68,10,0,0,10,58,11,47,0,87529
29604,600,72,304,171,23,30,8,8,8,0,0,8,0,0,0,0,0,0,0,0,0,0,0,0,0,0,0,0,0,0,0,0,0,0,0,87530
29605,379,80,98,138,49,14,36,36,0,0,0,0,36,36,36,0,0,0,0,0,0,0,0,0,0,0,0,0,0,0,0,0,0,0,0,87531
29606,11950,2501,3717,3613,1282,837,1123,572,452,154,60,238,120,48,18,20,10,72,19,16,37,551,438,125,33,280,113,64,61,0,3,49,11,14,24,87532
29607,82,37,8,23,11,3,3,0,0,0,0,0,0,0,0,0,0,0,0,0,0,3,0,0,0,0,3,3,3,0,0,0,0,0,0,87533
29608,777,87,239,237,141,73,81,28,11,0,0,11,17,17,0,17,0,0,0,0,0,53,53,0,0,53,0,0,0,0,0,0,0,0,0,87535
29609,2288,740,690,737,55,66,144,57,39,5,0,34,18,9,0,0,9,9,0,3,6,87,40,0,10,30,47,41,41,0,0,6,0,6,0,87537
29610,289,29,29,54,102,75,0,0,0,0,0,0,0,0,0,0,0,0,0,0,0,0,0,0,0,0,0,0,0,0,0,0,0,0,0,87538
29611,263,0,91,80,50,42,28,28,0,0,0,0,28,0,0,0,0,28,0,0,28,0,0,0,0,0,0,0,0,0,0,0,0,0,0,87539
29612,641,19,70,141,248,163,25,0,0,0,0,0,0,0,0,0,0,0,0,0,0,25,19,0,0,19,6,6,0,0,6,0,0,0,0,87540
29613,337,114,56,78,89,0,64,48,48,0,0,48,0,0,0,0,0,0,0,0,0,16,16,0,0,16,0,0,0,0,0,0,0,0,0,87543
29614,12734,385,1422,2854,3291,4782,934,520,500,175,34,291,20,1,0,0,1,19,0,0,19,414,404,143,2,259,10,10,10,0,0,0,0,0,0,87544
29615,766,217,76,310,84,79,15,15,0,0,0,0,15,15,15,0,0,0,0,0,0,0,0,0,0,0,0,0,0,0,0,0,0,0,0,87548
29616,666,0,73,370,202,21,0,0,0,0,0,0,0,0,0,0,0,0,0,0,0,0,0,0,0,0,0,0,0,0,0,0,0,0,0,87549
29617,243,25,80,86,0,52,0,0,0,0,0,0,0,0,0,0,0,0,0,0,0,0,0,0,0,0,0,0,0,0,0,0,0,0,0,87551
29618,2066,300,825,618,202,121,88,36,0,0,0,0,36,36,0,0,36,0,0,0,0,52,38,0,0,38,14,14,0,0,14,0,0,0,0,87552
29619,750,126,236,274,67,47,42,37,34,11,4,19,3,3,0,0,3,0,0,0,0,5,5,0,0,5,0,0,0,0,0,0,0,0,0,87553
29620,23,12,11,0,0,0,0,0,0,0,0,0,0,0,0,0,0,0,0,0,0,0,0,0,0,0,0,0,0,0,0,0,0,0,0,87554
29621,1674,250,500,622,195,107,111,57,46,28,0,18,11,0,0,0,0,11,0,6,5,54,54,41,3,10,0,0,0,0,0,0,0,0,0,87556
29622,4500,717,1187,1519,648,429,233,56,56,32,0,24,0,0,0,0,0,0,0,0,0,177,113,95,0,18,64,43,43,0,0,21,21,0,0,87557
29623,360,2,72,146,101,39,26,11,11,8,0,3,0,0,0,0,0,0,0,0,0,15,9,9,0,0,6,6,6,0,0,0,0,0,0,87558
29624,1031,162,449,321,52,47,171,0,0,0,0,0,0,0,0,0,0,0,0,0,0,171,171,16,0,155,0,0,0,0,0,0,0,0,0,87560
29625,400,15,186,147,8,44,20,20,20,0,0,20,0,0,0,0,0,0,0,0,0,0,0,0,0,0,0,0,0,0,0,0,0,0,0,87562
29626,324,22,157,62,66,17,46,28,0,0,0,0,28,28,0,28,0,0,0,0,0,18,18,0,0,18,0,0,0,0,0,0,0,0,0,87564
29627,196,20,102,62,0,12,36,36,13,13,0,0,23,0,0,0,0,23,0,23,0,0,0,0,0,0,0,0,0,0,0,0,0,0,0,87565
29628,1917,388,630,787,77,35,198,59,59,0,16,43,0,0,0,0,0,0,0,0,0,139,90,45,4,41,49,17,11,6,0,32,0,23,9,87566
29629,1133,334,228,451,116,4,13,4,4,0,0,4,0,0,0,0,0,0,0,0,0,9,0,0,0,0,9,0,0,0,0,9,9,0,0,87567
29630,408,50,86,171,10,91,0,0,0,0,0,0,0,0,0,0,0,0,0,0,0,0,0,0,0,0,0,0,0,0,0,0,0,0,0,87569
29631,7802,981,1662,2715,1747,697,372,195,171,13,37,121,24,0,0,0,0,24,8,16,0,177,132,3,41,88,45,1,1,0,0,44,0,39,5,87571
29632,0,0,0,0,0,0,0,0,0,0,0,0,0,0,0,0,0,0,0,0,0,0,0,0,0,0,0,0,0,0,0,0,0,0,0,87573
29633,123,49,34,19,0,21,0,0,0,0,0,0,0,0,0,0,0,0,0,0,0,0,0,0,0,0,0,0,0,0,0,0,0,0,0,87574
29634,557,47,156,260,74,20,40,27,23,0,0,23,4,4,0,0,4,0,0,0,0,13,13,0,0,13,0,0,0,0,0,0,0,0,0,87575
29635,28,0,10,9,9,0,0,0,0,0,0,0,0,0,0,0,0,0,0,0,0,0,0,0,0,0,0,0,0,0,0,0,0,0,0,87577
29636,865,61,262,171,208,163,27,27,0,0,0,0,27,0,0,0,0,27,0,0,27,0,0,0,0,0,0,0,0,0,0,0,0,0,0,87578
29637,595,77,185,260,41,32,81,73,71,0,0,71,2,0,0,0,0,2,0,0,2,8,8,2,0,6,0,0,0,0,0,0,0,0,0,87579
29638,447,0,150,147,150,0,0,0,0,0,0,0,0,0,0,0,0,0,0,0,0,0,0,0,0,0,0,0,0,0,0,0,0,0,0,87580
29639,50,33,17,0,0,0,0,0,0,0,0,0,0,0,0,0,0,0,0,0,0,0,0,0,0,0,0,0,0,0,0,0,0,0,0,87581
29640,935,114,214,305,145,157,137,55,55,55,0,0,0,0,0,0,0,0,0,0,0,82,82,0,0,82,0,0,0,0,0,0,0,0,0,87582
29641,115,58,57,0,0,0,0,0,0,0,0,0,0,0,0,0,0,0,0,0,0,0,0,0,0,0,0,0,0,0,0,0,0,0,0,87583
29642,13430,2361,3972,4341,1570,1186,1465,799,694,74,34,586,105,42,42,0,0,63,36,0,27,666,540,42,19,479,126,53,0,14,39,73,38,0,35,87701
29643,1548,71,329,645,282,221,116,99,99,66,0,33,0,0,0,0,0,0,0,0,0,17,17,0,0,17,0,0,0,0,0,0,0,0,0,87710
29644,422,140,139,94,14,35,0,0,0,0,0,0,0,0,0,0,0,0,0,0,0,0,0,0,0,0,0,0,0,0,0,0,0,0,0,87711
29645,134,57,0,39,0,38,0,0,0,0,0,0,0,0,0,0,0,0,0,0,0,0,0,0,0,0,0,0,0,0,0,0,0,0,0,87712
29646,161,100,30,31,0,0,0,0,0,0,0,0,0,0,0,0,0,0,0,0,0,0,0,0,0,0,0,0,0,0,0,0,0,0,0,87713
29647,655,119,261,155,76,44,72,39,39,14,0,25,0,0,0,0,0,0,0,0,0,33,31,6,0,25,2,0,0,0,0,2,2,0,0,87714
29648,530,62,181,239,32,16,0,0,0,0,0,0,0,0,0,0,0,0,0,0,0,0,0,0,0,0,0,0,0,0,0,0,0,0,0,87715
29649,486,15,87,255,115,14,27,25,17,0,0,17,8,2,0,0,2,6,0,0,6,2,2,0,0,2,0,0,0,0,0,0,0,0,0,87718
29650,200,45,46,86,0,23,0,0,0,0,0,0,0,0,0,0,0,0,0,0,0,0,0,0,0,0,0,0,0,0,0,0,0,0,0,87722
29651,120,0,60,47,4,9,9,0,0,0,0,0,0,0,0,0,0,0,0,0,0,9,9,9,0,0,0,0,0,0,0,0,0,0,0,87723
29652,0,0,0,0,0,0,0,0,0,0,0,0,0,0,0,0,0,0,0,0,0,0,0,0,0,0,0,0,0,0,0,0,0,0,0,87724
29653,174,30,48,53,27,16,19,11,11,0,0,11,0,0,0,0,0,0,0,0,0,8,0,0,0,0,8,8,0,0,8,0,0,0,0,87728
29654,116,0,22,38,28,28,0,0,0,0,0,0,0,0,0,0,0,0,0,0,0,0,0,0,0,0,0,0,0,0,0,0,0,0,0,87729
29655,6,0,1,2,2,1,0,0,0,0,0,0,0,0,0,0,0,0,0,0,0,0,0,0,0,0,0,0,0,0,0,0,0,0,0,87730
29656,309,37,56,201,0,15,49,38,38,0,0,38,0,0,0,0,0,0,0,0,0,11,11,0,0,11,0,0,0,0,0,0,0,0,0,87731
29657,859,40,480,265,17,57,22,22,22,0,0,22,0,0,0,0,0,0,0,0,0,0,0,0,0,0,0,0,0,0,0,0,0,0,0,87732
29658,167,11,62,68,20,6,9,2,2,0,0,2,0,0,0,0,0,0,0,0,0,7,7,0,0,7,0,0,0,0,0,0,0,0,0,87733
29659,190,17,134,27,12,0,0,0,0,0,0,0,0,0,0,0,0,0,0,0,0,0,0,0,0,0,0,0,0,0,0,0,0,0,0,87734
29660,46,0,0,18,28,0,0,0,0,0,0,0,0,0,0,0,0,0,0,0,0,0,0,0,0,0,0,0,0,0,0,0,0,0,0,87735
29661,352,32,243,69,0,8,97,37,0,0,0,0,37,37,0,0,37,0,0,0,0,60,60,0,0,60,0,0,0,0,0,0,0,0,0,87736
29662,5446,917,2030,1669,556,274,407,182,110,17,9,84,72,15,15,0,0,57,48,0,9,225,206,81,10,115,19,19,19,0,0,0,0,0,0,87740
29663,557,30,118,215,116,78,0,0,0,0,0,0,0,0,0,0,0,0,0,0,0,0,0,0,0,0,0,0,0,0,0,0,0,0,0,87742
29664,292,36,105,83,48,20,30,3,3,0,0,3,0,0,0,0,0,0,0,0,0,27,21,4,0,17,6,6,0,6,0,0,0,0,0,87743
29665,669,10,402,153,62,42,97,76,76,0,0,76,0,0,0,0,0,0,0,0,0,21,0,0,0,0,21,21,0,0,21,0,0,0,0,87745
29666,12,5,0,4,0,3,0,0,0,0,0,0,0,0,0,0,0,0,0,0,0,0,0,0,0,0,0,0,0,0,0,0,0,0,0,87746
29667,1271,164,519,406,127,55,46,21,21,2,5,14,0,0,0,0,0,0,0,0,0,25,25,5,0,20,0,0,0,0,0,0,0,0,0,87747
29668,102,0,0,22,80,0,0,0,0,0,0,0,0,0,0,0,0,0,0,0,0,0,0,0,0,0,0,0,0,0,0,0,0,0,0,87749
29669,13,13,0,0,0,0,0,0,0,0,0,0,0,0,0,0,0,0,0,0,0,0,0,0,0,0,0,0,0,0,0,0,0,0,0,87750
29670,588,86,295,116,39,52,19,11,11,8,0,3,0,0,0,0,0,0,0,0,0,8,8,0,0,8,0,0,0,0,0,0,0,0,0,87752
29671,124,100,17,7,0,0,0,0,0,0,0,0,0,0,0,0,0,0,0,0,0,0,0,0,0,0,0,0,0,0,0,0,0,0,0,87753
29672,6139,1351,1952,1315,805,716,620,319,258,97,17,144,61,61,0,16,45,0,0,0,0,301,301,71,5,225,0,0,0,0,0,0,0,0,0,87801
29673,73,19,19,35,0,0,0,0,0,0,0,0,0,0,0,0,0,0,0,0,0,0,0,0,0,0,0,0,0,0,0,0,0,0,0,87820
29674,649,44,194,263,97,51,84,31,31,0,0,31,0,0,0,0,0,0,0,0,0,53,53,42,0,11,0,0,0,0,0,0,0,0,0,87821
29675,616,17,148,360,85,6,22,0,0,0,0,0,0,0,0,0,0,0,0,0,0,22,22,0,0,22,0,0,0,0,0,0,0,0,0,87823
29676,234,0,38,96,73,27,0,0,0,0,0,0,0,0,0,0,0,0,0,0,0,0,0,0,0,0,0,0,0,0,0,0,0,0,0,87824
29677,1253,282,580,210,113,68,92,54,37,6,0,31,17,0,0,0,0,17,0,0,17,38,14,0,0,14,24,16,0,13,3,8,0,0,8,87825
29678,172,24,27,90,20,11,0,0,0,0,0,0,0,0,0,0,0,0,0,0,0,0,0,0,0,0,0,0,0,0,0,0,0,0,0,87827
29679,262,15,55,152,40,0,258,77,77,0,0,77,0,0,0,0,0,0,0,0,0,181,90,0,74,16,91,91,0,0,91,0,0,0,0,87828
29680,602,68,146,319,31,38,54,34,34,0,0,34,0,0,0,0,0,0,0,0,0,20,20,0,0,20,0,0,0,0,0,0,0,0,0,87829
29681,1197,196,519,325,88,69,60,24,11,6,0,5,13,13,13,0,0,0,0,0,0,36,30,0,0,30,6,0,0,0,0,6,0,0,6,87830
29682,342,54,168,64,27,29,0,0,0,0,0,0,0,0,0,0,0,0,0,0,0,0,0,0,0,0,0,0,0,0,0,0,0,0,0,87831
29683,587,86,258,174,20,49,0,0,0,0,0,0,0,0,0,0,0,0,0,0,0,0,0,0,0,0,0,0,0,0,0,0,0,0,0,87832
29684,5326,768,2130,1379,631,418,186,60,42,0,31,11,18,18,18,0,0,0,0,0,0,126,87,15,0,72,39,0,0,0,0,39,0,0,39,87901
29685,904,179,103,245,377,0,51,51,51,0,0,51,0,0,0,0,0,0,0,0,0,0,0,0,0,0,0,0,0,0,0,0,0,0,0,87930
29686,745,91,270,282,102,0,0,0,0,0,0,0,0,0,0,0,0,0,0,0,0,0,0,0,0,0,0,0,0,0,0,0,0,0,0,87931
29687,0,0,0,0,0,0,0,0,0,0,0,0,0,0,0,0,0,0,0,0,0,0,0,0,0,0,0,0,0,0,0,0,0,0,0,87933
29688,1296,273,546,210,198,69,86,86,79,19,53,7,7,7,7,0,0,0,0,0,0,0,0,0,0,0,0,0,0,0,0,0,0,0,0,87935
29689,349,83,59,146,0,61,0,0,0,0,0,0,0,0,0,0,0,0,0,0,0,0,0,0,0,0,0,0,0,0,0,0,0,0,0,87936
29690,1600,858,436,192,58,56,99,47,33,8,0,25,14,0,0,0,0,14,0,14,0,52,29,0,10,19,23,5,5,0,0,18,18,0,0,87937
29691,218,0,0,188,12,18,0,0,0,0,0,0,0,0,0,0,0,0,0,0,0,0,0,0,0,0,0,0,0,0,0,0,0,0,0,87939
29692,183,21,81,40,13,28,0,0,0,0,0,0,0,0,0,0,0,0,0,0,0,0,0,0,0,0,0,0,0,0,0,0,0,0,0,87940
29693,373,230,58,0,85,0,93,58,58,32,0,26,0,0,0,0,0,0,0,0,0,35,35,0,0,35,0,0,0,0,0,0,0,0,0,87941
29694,553,44,210,209,69,21,93,59,58,58,0,0,1,1,1,0,0,0,0,0,0,34,34,0,0,34,0,0,0,0,0,0,0,0,0,87942
29695,172,75,41,38,18,0,0,0,0,0,0,0,0,0,0,0,0,0,0,0,0,0,0,0,0,0,0,0,0,0,0,0,0,0,0,87943
29696,20162,3980,4570,6475,3422,1715,2715,1283,1130,84,304,742,153,103,103,0,0,50,0,0,50,1432,1212,282,190,740,220,117,82,0,35,103,46,39,18,88001
29697,533,60,94,286,67,26,48,34,6,0,0,6,28,28,28,0,0,0,0,0,0,14,11,11,0,0,3,3,3,0,0,0,0,0,0,88002
29698,48,0,24,11,13,0,719,309,309,24,105,180,0,0,0,0,0,0,0,0,0,410,410,88,84,238,0,0,0,0,0,0,0,0,0,88003
29699,267,104,113,50,0,0,0,0,0,0,0,0,0,0,0,0,0,0,0,0,0,0,0,0,0,0,0,0,0,0,0,0,0,0,0,88004
29700,19036,3406,3730,5676,3342,2882,2010,1019,901,237,132,532,118,76,44,27,5,42,9,0,33,991,793,255,166,372,198,179,56,41,82,19,1,0,18,88005
29701,17428,3413,4078,5587,2892,1458,1485,832,708,149,0,559,124,24,9,0,15,100,12,34,54,653,544,160,123,261,109,109,44,0,65,0,0,0,0,88007
29702,3656,527,806,1244,639,440,193,74,57,18,15,24,17,0,0,0,0,17,17,0,0,119,119,5,0,114,0,0,0,0,0,0,0,0,0,88008
29703,86,0,0,55,31,0,0,0,0,0,0,0,0,0,0,0,0,0,0,0,0,0,0,0,0,0,0,0,0,0,0,0,0,0,0,88009
29704,17851,854,2546,5215,4651,4585,1301,540,480,61,0,419,60,60,12,48,0,0,0,0,0,761,590,204,96,290,171,171,159,12,0,0,0,0,0,88011
29705,15507,2721,3481,5384,2706,1215,1731,801,666,76,51,539,135,23,0,23,0,112,40,41,31,930,766,112,27,627,164,35,15,0,20,129,0,78,51,88012
29706,484,155,131,120,44,34,14,4,4,0,0,4,0,0,0,0,0,0,0,0,0,10,10,0,0,10,0,0,0,0,0,0,0,0,0,88020
29707,10156,4154,2615,2197,655,535,1232,658,514,133,98,283,144,144,43,66,35,0,0,0,0,574,438,20,17,401,136,28,0,28,0,108,0,0,108,88021
29708,848,155,179,315,111,88,14,14,14,9,5,0,0,0,0,0,0,0,0,0,0,0,0,0,0,0,0,0,0,0,0,0,0,0,0,88022
29709,1741,412,719,415,102,93,201,102,40,11,0,29,62,45,14,17,14,17,0,17,0,99,54,4,12,38,45,12,0,12,0,33,0,17,16,88023
29710,141,0,86,20,17,18,0,0,0,0,0,0,0,0,0,0,0,0,0,0,0,0,0,0,0,0,0,0,0,0,0,0,0,0,0,88024
29711,301,23,31,156,38,53,0,0,0,0,0,0,0,0,0,0,0,0,0,0,0,0,0,0,0,0,0,0,0,0,0,0,0,0,0,88025
29712,953,307,268,292,42,44,56,47,47,0,0,47,0,0,0,0,0,0,0,0,0,9,9,0,0,9,0,0,0,0,0,0,0,0,0,88026
29713,327,73,81,114,23,36,12,12,12,0,12,0,0,0,0,0,0,0,0,0,0,0,0,0,0,0,0,0,0,0,0,0,0,0,0,88027
29714,435,19,117,168,94,37,10,10,10,0,0,10,0,0,0,0,0,0,0,0,0,0,0,0,0,0,0,0,0,0,0,0,0,0,0,88028
29715,1055,565,218,114,25,133,56,36,22,13,0,9,14,0,0,0,0,14,0,14,0,20,16,16,0,0,4,0,0,0,0,4,0,0,4,88029
29716,15081,4513,4878,3624,1193,873,1490,731,511,55,45,411,220,136,94,0,42,84,53,0,31,759,624,137,95,392,135,63,9,23,31,72,12,10,50,88030
29717,99,0,78,21,0,0,0,0,0,0,0,0,0,0,0,0,0,0,0,0,0,0,0,0,0,0,0,0,0,0,0,0,0,0,0,88032
29718,16,0,0,16,0,0,0,0,0,0,0,0,0,0,0,0,0,0,0,0,0,0,0,0,0,0,0,0,0,0,0,0,0,0,0,88033
29719,125,48,13,48,7,9,0,0,0,0,0,0,0,0,0,0,0,0,0,0,0,0,0,0,0,0,0,0,0,0,0,0,0,0,0,88034
29720,347,32,242,24,49,0,0,0,0,0,0,0,0,0,0,0,0,0,0,0,0,0,0,0,0,0,0,0,0,0,0,0,0,0,0,88038
29721,132,12,28,35,57,0,0,0,0,0,0,0,0,0,0,0,0,0,0,0,0,0,0,0,0,0,0,0,0,0,0,0,0,0,0,88039
29722,77,11,17,22,4,23,9,9,0,0,0,0,9,0,0,0,0,9,9,0,0,0,0,0,0,0,0,0,0,0,0,0,0,0,0,88040
29723,951,50,309,335,124,133,0,0,0,0,0,0,0,0,0,0,0,0,0,0,0,0,0,0,0,0,0,0,0,0,0,0,0,0,0,88041
29724,144,40,15,45,23,21,0,0,0,0,0,0,0,0,0,0,0,0,0,0,0,0,0,0,0,0,0,0,0,0,0,0,0,0,0,88042
29725,1140,205,439,316,109,71,73,58,45,5,0,40,13,13,2,11,0,0,0,0,0,15,12,0,0,12,3,3,3,0,0,0,0,0,0,88043
29726,2663,643,774,630,338,278,232,109,109,42,31,36,0,0,0,0,0,0,0,0,0,123,123,34,25,64,0,0,0,0,0,0,0,0,0,88044
29727,2553,561,909,781,204,98,308,224,124,61,17,46,100,95,35,59,1,5,5,0,0,84,78,9,9,60,6,6,6,0,0,0,0,0,0,88045
29728,618,51,174,116,159,118,0,0,0,0,0,0,0,0,0,0,0,0,0,0,0,0,0,0,0,0,0,0,0,0,0,0,0,0,0,88046
29729,978,267,262,295,113,41,103,90,90,39,0,51,0,0,0,0,0,0,0,0,0,13,13,0,0,13,0,0,0,0,0,0,0,0,0,88047
29730,1980,1001,565,314,77,23,397,195,94,0,0,94,101,68,68,0,0,33,0,33,0,202,181,60,0,121,21,0,0,0,0,21,0,0,21,88048
29731,458,42,112,220,62,22,0,0,0,0,0,0,0,0,0,0,0,0,0,0,0,0,0,0,0,0,0,0,0,0,0,0,0,0,0,88049
29732,35,0,5,22,0,8,7,7,0,0,0,0,7,7,7,0,0,0,0,0,0,0,0,0,0,0,0,0,0,0,0,0,0,0,0,88051
29733,71,0,29,42,0,0,0,0,0,0,0,0,0,0,0,0,0,0,0,0,0,0,0,0,0,0,0,0,0,0,0,0,0,0,0,88052
29734,69,0,0,0,11,58,0,0,0,0,0,0,0,0,0,0,0,0,0,0,0,0,0,0,0,0,0,0,0,0,0,0,0,0,0,88053
29735,13,0,0,0,0,13,0,0,0,0,0,0,0,0,0,0,0,0,0,0,0,0,0,0,0,0,0,0,0,0,0,0,0,0,0,88055
29736,105,0,23,39,25,18,0,0,0,0,0,0,0,0,0,0,0,0,0,0,0,0,0,0,0,0,0,0,0,0,0,0,0,0,0,88056
29737,12742,2026,3266,4033,1668,1749,1103,470,429,157,41,231,41,0,0,0,0,41,0,0,41,633,550,127,38,385,83,24,0,5,19,59,0,53,6,88061
29738,6857,3701,1330,1374,364,88,1305,622,485,97,77,311,137,115,67,48,0,22,0,0,22,683,564,137,52,375,119,103,52,41,10,16,0,16,0,88063
29739,456,38,73,157,103,85,12,0,0,0,0,0,0,0,0,0,0,0,0,0,0,12,12,0,0,12,0,0,0,0,0,0,0,0,0,88065
29740,1491,880,425,106,68,12,178,106,97,35,0,62,9,0,0,0,0,9,9,0,0,72,72,48,0,24,0,0,0,0,0,0,0,0,0,88072
29741,8086,3788,2409,1536,234,119,1495,725,538,93,118,327,187,88,40,0,48,99,63,0,36,770,649,64,66,519,121,26,22,4,0,95,0,45,50,88081
29742,27743,5058,6588,10419,3461,2217,2556,1493,1104,340,111,653,389,279,141,124,14,110,94,12,4,1063,913,228,136,549,150,75,36,0,39,75,48,0,27,88101
29743,21,0,6,5,9,1,43,40,0,0,0,0,40,40,40,0,0,0,0,0,0,3,0,0,0,0,3,3,3,0,0,0,0,0,0,88103
29744,148,31,34,49,16,18,11,0,0,0,0,0,0,0,0,0,0,0,0,0,0,11,11,0,0,11,0,0,0,0,0,0,0,0,0,88112
29745,82,38,10,21,11,2,10,3,0,0,0,0,3,3,3,0,0,0,0,0,0,7,7,2,0,5,0,0,0,0,0,0,0,0,0,88113
29746,16,0,8,2,0,6,0,0,0,0,0,0,0,0,0,0,0,0,0,0,0,0,0,0,0,0,0,0,0,0,0,0,0,0,0,88114
29747,14,3,2,7,2,0,0,0,0,0,0,0,0,0,0,0,0,0,0,0,0,0,0,0,0,0,0,0,0,0,0,0,0,0,0,88115
29748,290,47,88,105,30,20,21,8,8,0,0,8,0,0,0,0,0,0,0,0,0,13,13,0,3,10,0,0,0,0,0,0,0,0,0,88116
29749,182,48,49,57,22,6,10,0,0,0,0,0,0,0,0,0,0,0,0,0,0,10,10,7,0,3,0,0,0,0,0,0,0,0,0,88118
29750,1254,229,425,368,152,80,184,76,35,7,0,28,41,6,0,6,0,35,24,10,1,108,91,4,13,74,17,17,0,0,17,0,0,0,0,88119
29751,135,21,36,27,31,20,14,6,6,0,0,6,0,0,0,0,0,0,0,0,0,8,8,0,0,8,0,0,0,0,0,0,0,0,0,88120
29752,111,26,22,39,11,13,4,0,0,0,0,0,0,0,0,0,0,0,0,0,0,4,4,0,0,4,0,0,0,0,0,0,0,0,0,88121
29753,707,97,241,216,95,58,42,22,19,0,0,19,3,3,3,0,0,0,0,0,0,20,20,5,2,13,0,0,0,0,0,0,0,0,0,88124
29754,28,0,8,10,5,5,0,0,0,0,0,0,0,0,0,0,0,0,0,0,0,0,0,0,0,0,0,0,0,0,0,0,0,0,0,88125
29755,28,6,9,13,0,0,2,0,0,0,0,0,0,0,0,0,0,0,0,0,0,2,2,0,0,2,0,0,0,0,0,0,0,0,0,88126
29756,10478,2056,2650,3520,1431,821,1496,680,590,151,100,339,90,34,29,0,5,56,0,56,0,816,737,244,97,396,79,38,22,3,13,41,41,0,0,88130
29757,146,13,73,44,10,6,8,8,8,0,0,8,0,0,0,0,0,0,0,0,0,0,0,0,0,0,0,0,0,0,0,0,0,0,0,88132
29758,33,6,16,11,0,0,0,0,0,0,0,0,0,0,0,0,0,0,0,0,0,0,0,0,0,0,0,0,0,0,0,0,0,0,0,88134
29759,1115,307,236,388,82,102,68,29,21,11,0,10,8,8,8,0,0,0,0,0,0,39,36,24,5,7,3,0,0,0,0,3,3,0,0,88135
29760,58,25,4,20,9,0,0,0,0,0,0,0,0,0,0,0,0,0,0,0,0,0,0,0,0,0,0,0,0,0,0,0,0,0,0,88136
29761,16951,2135,4310,5799,2972,1735,1740,953,878,133,65,680,75,40,26,7,7,35,0,11,24,787,686,212,32,442,101,61,61,0,0,40,28,0,12,88201
29762,18368,4981,4888,6072,1711,716,1751,889,625,202,5,418,264,200,112,65,23,64,47,0,17,862,734,196,118,420,128,68,17,0,51,60,0,17,43,88203
29763,10575,1996,3560,3456,1103,460,955,540,418,191,86,141,122,32,6,0,26,90,58,20,12,415,371,56,14,301,44,9,0,9,0,35,15,3,17,88210
29764,22948,4234,7059,7430,2359,1866,1831,913,778,205,52,521,135,85,78,0,7,50,0,26,24,918,746,210,138,398,172,124,124,0,0,48,40,8,0,88220
29765,3129,1173,972,791,109,84,380,270,206,97,0,109,64,0,0,0,0,64,36,4,24,110,110,55,0,55,0,0,0,0,0,0,0,0,0,88230
29766,2087,582,546,664,144,151,208,149,77,35,4,38,72,66,66,0,0,6,6,0,0,59,50,6,0,44,9,9,0,0,9,0,0,0,0,88231
29767,1698,572,570,446,66,44,266,143,108,10,0,98,35,13,0,0,13,22,8,0,14,123,72,12,14,46,51,24,0,0,24,27,0,0,27,88232
29768,22256,6152,6434,6403,2084,1183,1804,981,769,196,91,482,212,132,63,68,1,80,59,0,21,823,703,214,39,450,120,14,0,14,0,106,26,0,80,88240
29769,4424,864,1435,1394,553,178,540,280,231,18,33,180,49,35,17,18,0,14,0,0,14,260,254,30,78,146,6,6,6,0,0,0,0,0,0,88242
29770,86,18,35,29,0,4,0,0,0,0,0,0,0,0,0,0,0,0,0,0,0,0,0,0,0,0,0,0,0,0,0,0,0,0,0,88250
29771,1455,428,460,412,87,68,132,41,41,6,4,31,0,0,0,0,0,0,0,0,0,91,86,18,0,68,5,5,5,0,0,0,0,0,0,88252
29772,613,203,191,187,27,5,89,52,48,11,0,37,4,0,0,0,0,4,0,4,0,37,29,0,0,29,8,2,2,0,0,6,0,0,6,88253
29773,78,30,0,48,0,0,0,0,0,0,0,0,0,0,0,0,0,0,0,0,0,0,0,0,0,0,0,0,0,0,0,0,0,0,0,88254
29774,68,55,13,0,0,0,0,0,0,0,0,0,0,0,0,0,0,0,0,0,0,0,0,0,0,0,0,0,0,0,0,0,0,0,0,88255
29775,1280,323,455,412,44,46,151,51,45,9,4,32,6,6,0,0,6,0,0,0,0,100,78,6,6,66,22,15,7,0,8,7,0,0,7,88256
29776,8448,3064,2339,2344,355,346,1159,564,367,115,0,252,197,77,43,0,34,120,38,75,7,595,332,57,9,266,263,109,14,47,48,154,0,0,154,88260
29777,7,0,4,0,3,0,0,0,0,0,0,0,0,0,0,0,0,0,0,0,0,0,0,0,0,0,0,0,0,0,0,0,0,0,0,88262
29778,72,34,31,7,0,0,0,0,0,0,0,0,0,0,0,0,0,0,0,0,0,0,0,0,0,0,0,0,0,0,0,0,0,0,0,88263
29779,0,0,0,0,0,0,0,0,0,0,0,0,0,0,0,0,0,0,0,0,0,0,0,0,0,0,0,0,0,0,0,0,0,0,0,88264
29780,250,110,45,81,14,0,0,0,0,0,0,0,0,0,0,0,0,0,0,0,0,0,0,0,0,0,0,0,0,0,0,0,0,0,0,88265
29781,785,209,208,248,98,22,50,17,17,0,0,17,0,0,0,0,0,0,0,0,0,33,33,17,0,16,0,0,0,0,0,0,0,0,0,88267
29782,0,0,0,0,0,0,0,0,0,0,0,0,0,0,0,0,0,0,0,0,0,0,0,0,0,0,0,0,0,0,0,0,0,0,0,88268
29783,972,129,377,307,115,44,70,34,21,0,0,21,13,0,0,0,0,13,0,13,0,36,36,8,0,28,0,0,0,0,0,0,0,0,0,88301
29784,24948,2884,7638,10181,2739,1506,1799,1115,968,270,36,662,147,109,77,26,6,38,5,8,25,684,590,145,53,392,94,67,16,7,44,27,6,0,21,88310
29785,1097,128,375,556,38,0,64,22,22,0,15,7,0,0,0,0,0,0,0,0,0,42,42,0,0,42,0,0,0,0,0,0,0,0,0,88311
29786,2451,93,619,970,334,435,54,31,31,7,0,24,0,0,0,0,0,0,0,0,0,23,23,23,0,0,0,0,0,0,0,0,0,0,0,88312
29787,184,47,58,49,30,0,0,0,0,0,0,0,0,0,0,0,0,0,0,0,0,0,0,0,0,0,0,0,0,0,0,0,0,0,0,88314
29788,1717,217,692,609,155,44,57,49,49,0,0,49,0,0,0,0,0,0,0,0,0,8,2,2,0,0,6,0,0,0,0,6,0,6,0,88316
29789,1096,76,177,413,252,178,48,27,27,8,0,19,0,0,0,0,0,0,0,0,0,21,21,0,0,21,0,0,0,0,0,0,0,0,0,88317
29790,307,20,73,96,80,38,3,3,1,0,0,1,2,2,0,2,0,0,0,0,0,0,0,0,0,0,0,0,0,0,0,0,0,0,0,88318
29791,110,36,43,25,6,0,0,0,0,0,0,0,0,0,0,0,0,0,0,0,0,0,0,0,0,0,0,0,0,0,0,0,0,0,0,88321
29792,0,0,0,0,0,0,6,6,6,0,0,6,0,0,0,0,0,0,0,0,0,0,0,0,0,0,0,0,0,0,0,0,0,0,0,88323
29793,103,35,29,8,27,4,10,7,7,0,0,7,0,0,0,0,0,0,0,0,0,3,3,0,0,3,0,0,0,0,0,0,0,0,0,88324
29794,692,62,122,265,129,114,33,33,33,0,0,33,0,0,0,0,0,0,0,0,0,0,0,0,0,0,0,0,0,0,0,0,0,0,0,88325
29795,1106,8,142,699,155,102,178,61,0,0,0,0,61,48,48,0,0,13,13,0,0,117,23,8,6,9,94,61,45,0,16,33,4,0,29,88330
29796,201,53,58,68,16,6,14,14,14,0,0,14,0,0,0,0,0,0,0,0,0,0,0,0,0,0,0,0,0,0,0,0,0,0,0,88336
29797,1741,100,669,672,162,138,77,51,42,9,0,33,9,9,9,0,0,0,0,0,0,26,26,0,0,26,0,0,0,0,0,0,0,0,0,88337
29798,158,0,96,30,4,28,50,0,0,0,0,0,0,0,0,0,0,0,0,0,0,50,50,0,0,50,0,0,0,0,0,0,0,0,0,88338
29799,668,124,163,193,86,102,40,26,0,0,0,0,26,0,0,0,0,26,0,26,0,14,14,0,0,14,0,0,0,0,0,0,0,0,0,88339
29800,1899,395,639,695,113,57,248,127,43,13,0,30,84,14,14,0,0,70,0,49,21,121,67,6,0,61,54,35,25,0,10,19,0,12,7,88340
29801,230,8,43,103,27,49,24,0,0,0,0,0,0,0,0,0,0,0,0,0,0,24,11,0,0,11,13,13,13,0,0,0,0,0,0,88341
29802,6,0,0,6,0,0,0,0,0,0,0,0,0,0,0,0,0,0,0,0,0,0,0,0,0,0,0,0,0,0,0,0,0,0,0,88342
29803,25,2,9,10,4,0,0,0,0,0,0,0,0,0,0,0,0,0,0,0,0,0,0,0,0,0,0,0,0,0,0,0,0,0,0,88343
29804,150,19,31,65,35,0,0,0,0,0,0,0,0,0,0,0,0,0,0,0,0,0,0,0,0,0,0,0,0,0,0,0,0,0,0,88344
29805,6707,881,1691,2202,1403,530,194,74,74,28,0,46,0,0,0,0,0,0,0,0,0,120,120,10,0,110,0,0,0,0,0,0,0,0,0,88345
29806,2063,587,488,746,167,75,186,110,97,61,0,36,13,11,11,0,0,2,2,0,0,76,76,29,0,47,0,0,0,0,0,0,0,0,0,88346
29807,150,14,46,90,0,0,5,5,1,0,0,1,4,4,0,0,4,0,0,0,0,0,0,0,0,0,0,0,0,0,0,0,0,0,0,88347
29808,212,81,65,53,10,3,18,18,15,3,0,12,3,3,0,0,3,0,0,0,0,0,0,0,0,0,0,0,0,0,0,0,0,0,0,88348
29809,0,0,0,0,0,0,0,0,0,0,0,0,0,0,0,0,0,0,0,0,0,0,0,0,0,0,0,0,0,0,0,0,0,0,0,88349
29810,220,42,66,24,88,0,0,0,0,0,0,0,0,0,0,0,0,0,0,0,0,0,0,0,0,0,0,0,0,0,0,0,0,0,0,88350
29811,160,46,34,68,8,4,12,9,9,0,0,9,0,0,0,0,0,0,0,0,0,3,3,0,0,3,0,0,0,0,0,0,0,0,0,88351
29812,3151,410,843,1129,431,338,266,138,75,0,0,75,63,52,0,52,0,11,0,0,11,128,123,69,0,54,5,0,0,0,0,5,0,5,0,88352
29813,298,43,123,109,20,3,70,23,23,0,0,23,0,0,0,0,0,0,0,0,0,47,45,0,0,45,2,2,0,0,2,0,0,0,0,88353
29814,81,11,11,29,15,15,9,9,9,0,0,9,0,0,0,0,0,0,0,0,0,0,0,0,0,0,0,0,0,0,0,0,0,0,0,88354
29815,0,0,0,0,0,0,0,0,0,0,0,0,0,0,0,0,0,0,0,0,0,0,0,0,0,0,0,0,0,0,0,0,0,0,0,88355
29816,4555,939,1773,1294,364,185,518,338,313,109,0,204,25,23,23,0,0,2,0,0,2,180,135,40,0,95,45,22,22,0,0,23,0,0,23,88401
29817,51,25,0,10,7,9,0,0,0,0,0,0,0,0,0,0,0,0,0,0,0,0,0,0,0,0,0,0,0,0,0,0,0,0,0,88410
29818,43,0,20,11,3,9,6,0,0,0,0,0,0,0,0,0,0,0,0,0,0,6,6,3,3,0,0,0,0,0,0,0,0,0,0,88411
29819,53,19,23,6,5,0,8,8,8,0,0,8,0,0,0,0,0,0,0,0,0,0,0,0,0,0,0,0,0,0,0,0,0,0,0,88414
29820,2467,594,912,568,235,158,113,51,34,9,0,25,17,16,0,15,1,1,0,0,1,62,62,9,26,27,0,0,0,0,0,0,0,0,0,88415
29821,45,0,12,23,10,0,0,0,0,0,0,0,0,0,0,0,0,0,0,0,0,0,0,0,0,0,0,0,0,0,0,0,0,0,0,88416
29822,61,19,12,0,0,30,0,0,0,0,0,0,0,0,0,0,0,0,0,0,0,0,0,0,0,0,0,0,0,0,0,0,0,0,0,88417
29823,222,36,113,55,16,2,3,3,3,0,0,3,0,0,0,0,0,0,0,0,0,0,0,0,0,0,0,0,0,0,0,0,0,0,0,88418
29824,161,0,76,52,27,6,0,0,0,0,0,0,0,0,0,0,0,0,0,0,0,0,0,0,0,0,0,0,0,0,0,0,0,0,0,88419
29825,0,0,0,0,0,0,0,0,0,0,0,0,0,0,0,0,0,0,0,0,0,0,0,0,0,0,0,0,0,0,0,0,0,0,0,88421
29826,99,0,6,30,26,37,0,0,0,0,0,0,0,0,0,0,0,0,0,0,0,0,0,0,0,0,0,0,0,0,0,0,0,0,0,88422
29827,35,0,13,13,0,9,0,0,0,0,0,0,0,0,0,0,0,0,0,0,0,0,0,0,0,0,0,0,0,0,0,0,0,0,0,88424
29828,987,127,448,286,102,24,57,12,12,9,3,0,0,0,0,0,0,0,0,0,0,45,45,11,0,34,0,0,0,0,0,0,0,0,0,88426
29829,99,2,45,22,24,6,0,0,0,0,0,0,0,0,0,0,0,0,0,0,0,0,0,0,0,0,0,0,0,0,0,0,0,0,0,88427
29830,101,12,43,33,13,0,4,4,4,0,0,4,0,0,0,0,0,0,0,0,0,0,0,0,0,0,0,0,0,0,0,0,0,0,0,88430
29831,0,0,0,0,0,0,0,0,0,0,0,0,0,0,0,0,0,0,0,0,0,0,0,0,0,0,0,0,0,0,0,0,0,0,0,88431
29832,300,37,77,132,32,22,25,3,2,0,0,2,1,1,1,0,0,0,0,0,0,22,22,0,0,22,0,0,0,0,0,0,0,0,0,88434
29833,2510,474,1149,626,167,94,60,34,27,9,0,18,7,7,0,7,0,0,0,0,0,26,26,0,15,11,0,0,0,0,0,0,0,0,0,88435
29834,75,37,13,25,0,0,11,0,0,0,0,0,0,0,0,0,0,0,0,0,0,11,0,0,0,0,11,0,0,0,0,11,0,0,11,88436
29835,610,100,256,248,0,6,75,32,32,0,32,0,0,0,0,0,0,0,0,0,0,43,13,0,9,4,30,30,0,22,8,0,0,0,0,89001
29836,22151,1482,6458,8759,3711,1741,1749,796,640,134,89,417,156,124,77,14,33,32,0,6,26,953,766,195,65,506,187,152,138,0,14,35,0,17,18,89002
29837,716,114,285,273,44,0,23,23,23,0,0,23,0,0,0,0,0,0,0,0,0,0,0,0,0,0,0,0,0,0,0,0,0,0,0,89003
29838,231,19,38,99,18,57,17,5,0,0,0,0,5,5,0,5,0,0,0,0,0,12,12,12,0,0,0,0,0,0,0,0,0,0,0,89004
29839,11708,1067,3065,4917,1618,1041,500,225,208,15,0,193,17,17,17,0,0,0,0,0,0,275,219,113,42,64,56,56,39,0,17,0,0,0,0,89005
29840,946,187,482,158,87,32,126,91,41,0,0,41,50,50,42,0,8,0,0,0,0,35,22,0,0,22,13,13,0,0,13,0,0,0,0,89007
29841,885,211,247,295,80,52,138,41,36,0,8,28,5,5,5,0,0,0,0,0,0,97,88,0,6,82,9,0,0,0,0,9,0,0,9,89008
29842,232,89,50,62,24,7,18,11,5,0,5,0,6,6,6,0,0,0,0,0,0,7,7,0,0,7,0,0,0,0,0,0,0,0,0,89010
29843,12324,1106,3749,4298,1950,1221,660,309,259,22,26,211,50,50,38,12,0,0,0,0,0,351,282,70,11,201,69,56,11,23,22,13,0,0,13,89011
29844,20753,1119,4726,7687,4275,2946,954,498,377,71,15,291,121,88,31,28,29,33,0,23,10,456,423,89,46,288,33,33,18,15,0,0,0,0,0,89012
29845,307,35,112,121,16,23,12,12,7,0,4,3,5,5,0,5,0,0,0,0,0,0,0,0,0,0,0,0,0,0,0,0,0,0,0,89013
29846,24810,2414,7055,9162,4151,2028,2117,1162,908,188,64,656,254,178,120,31,27,76,14,34,28,955,754,67,91,596,201,131,66,16,49,70,7,0,63,89014
29847,25435,3590,9601,8708,2207,1329,1948,957,766,326,22,418,191,145,89,9,47,46,0,30,16,991,644,172,32,440,347,244,178,59,7,103,42,9,52,89015
29848,75,0,21,24,30,0,9,0,0,0,0,0,0,0,0,0,0,0,0,0,0,9,9,0,0,9,0,0,0,0,0,0,0,0,0,89017
29849,4036,1196,1394,1301,102,43,236,231,138,0,0,138,93,37,0,0,37,56,0,0,56,5,0,0,0,0,5,5,5,0,0,0,0,0,0,89018
29850,1568,302,498,562,66,140,93,34,34,0,0,34,0,0,0,0,0,0,0,0,0,59,59,14,0,45,0,0,0,0,0,0,0,0,0,89019
29851,757,147,314,210,52,34,63,8,0,0,0,0,8,0,0,0,0,8,0,8,0,55,55,0,11,44,0,0,0,0,0,0,0,0,0,89020
29852,2012,106,472,1022,242,170,270,118,118,51,26,41,0,0,0,0,0,0,0,0,0,152,152,18,26,108,0,0,0,0,0,0,0,0,0,89021
29853,127,30,51,46,0,0,0,0,0,0,0,0,0,0,0,0,0,0,0,0,0,0,0,0,0,0,0,0,0,0,0,0,0,0,0,89022
29854,768,162,273,277,56,0,75,49,49,0,0,49,0,0,0,0,0,0,0,0,0,26,21,18,1,2,5,5,0,3,2,0,0,0,0,89025
29855,347,63,105,179,0,0,16,16,0,0,0,0,16,8,0,0,8,8,0,0,8,0,0,0,0,0,0,0,0,0,0,0,0,0,0,89026
29856,11459,1744,3594,4162,1282,677,542,234,208,38,62,108,26,26,14,12,0,0,0,0,0,308,189,2,47,140,119,80,38,0,42,39,27,0,12,89027
29857,6089,699,1955,2227,665,543,301,130,105,7,23,75,25,5,0,0,5,20,0,20,0,171,100,0,12,88,71,71,26,25,20,0,0,0,0,89029
29858,26477,13911,7463,4090,860,153,3449,2022,1431,168,134,1129,591,284,92,53,139,307,57,52,198,1427,1031,99,16,916,396,248,147,0,101,148,56,34,58,89030
29859,37844,5915,11599,14144,4136,2050,4116,1868,1433,136,45,1252,435,310,157,67,86,125,90,0,35,2248,1735,284,88,1363,513,342,87,9,246,171,72,0,99,89031
29860,25345,5603,8936,7716,2074,1016,3441,1807,1591,243,115,1233,216,187,41,37,109,29,10,14,5,1634,1176,309,86,781,458,294,29,45,220,164,0,96,68,89032
29861,144,51,31,62,0,0,0,0,0,0,0,0,0,0,0,0,0,0,0,0,0,0,0,0,0,0,0,0,0,0,0,0,0,0,0,89039
29862,2204,418,695,746,210,135,265,131,81,17,0,64,50,22,0,0,22,28,28,0,0,134,134,46,0,88,0,0,0,0,0,0,0,0,0,89040
29863,922,86,331,242,242,21,156,70,70,11,0,59,0,0,0,0,0,0,0,0,0,86,86,38,39,9,0,0,0,0,0,0,0,0,0,89042
29864,829,179,215,325,99,11,99,99,52,0,0,52,47,47,40,0,7,0,0,0,0,0,0,0,0,0,0,0,0,0,0,0,0,0,0,89043
29865,13334,405,2732,4630,3361,2206,408,118,116,36,0,80,2,2,2,0,0,0,0,0,0,290,241,97,0,144,49,49,29,20,0,0,0,0,0,89044
29866,1102,164,409,325,154,50,39,26,26,4,0,22,0,0,0,0,0,0,0,0,0,13,13,5,0,8,0,0,0,0,0,0,0,0,0,89045
29867,420,62,167,150,27,14,19,0,0,0,0,0,0,0,0,0,0,0,0,0,0,19,19,0,0,19,0,0,0,0,0,0,0,0,0,89046
29868,111,0,48,40,23,0,0,0,0,0,0,0,0,0,0,0,0,0,0,0,0,0,0,0,0,0,0,0,0,0,0,0,0,0,0,89047
29869,15503,2673,5509,5703,1180,438,1096,639,432,73,12,347,207,115,87,0,28,92,0,56,36,457,345,8,0,337,112,84,78,6,0,28,0,0,28,89048
29870,2410,342,915,826,222,105,117,47,23,0,0,23,24,0,0,0,0,24,24,0,0,70,25,0,0,25,45,0,0,0,0,45,16,0,29,89049
29871,36515,1426,7665,11446,9654,6324,2063,989,737,267,18,452,252,162,99,47,16,90,0,8,82,1074,1005,329,65,611,69,69,34,0,35,0,0,0,0,89052
29872,128,12,56,51,0,9,15,15,15,15,0,0,0,0,0,0,0,0,0,0,0,0,0,0,0,0,0,0,0,0,0,0,0,0,0,89054
29873,7562,1379,2881,2477,546,279,453,242,157,34,0,123,85,11,0,11,0,74,0,43,31,211,202,57,64,81,9,0,0,0,0,9,0,0,9,89060
29874,3442,434,1070,1166,591,181,173,64,64,0,0,64,0,0,0,0,0,0,0,0,0,109,109,0,22,87,0,0,0,0,0,0,0,0,0,89061
29875,34224,2372,8949,11691,7253,3959,2674,1464,1171,257,17,897,293,262,127,128,7,31,0,30,1,1210,1041,239,72,730,169,167,52,28,87,2,0,2,0,89074
29876,18396,2715,5924,6608,2153,996,1928,995,869,166,62,641,126,56,30,17,9,70,2,0,68,933,797,70,110,617,136,125,9,116,0,11,7,4,0,89081
29877,14341,634,3149,5981,3033,1544,659,262,252,49,30,173,10,10,10,0,0,0,0,0,0,397,364,116,59,189,33,33,12,0,21,0,0,0,0,89084
29878,2408,143,603,1134,388,140,279,113,113,0,0,113,0,0,0,0,0,0,0,0,0,166,166,0,20,146,0,0,0,0,0,0,0,0,0,89085
29879,2682,350,670,1194,266,202,280,126,126,0,0,126,0,0,0,0,0,0,0,0,0,154,141,52,0,89,13,13,13,0,0,0,0,0,0,89086
29880,27892,11633,8444,5860,1496,459,2840,1574,1003,66,12,925,571,214,119,19,76,357,145,16,196,1266,775,100,62,613,491,227,0,139,88,264,0,121,143,89101
29881,24219,7285,7163,6333,2380,1058,1868,982,698,133,93,472,284,119,81,17,21,165,89,31,45,886,544,153,49,342,342,140,23,64,53,202,27,114,61,89102
29882,35558,6260,12899,10126,4633,1640,1977,984,697,138,57,502,287,158,94,38,26,129,52,11,66,993,748,153,63,532,245,222,184,38,0,23,2,21,0,89103
29883,25930,8507,8240,6916,1560,707,2032,974,759,49,49,661,215,118,90,0,28,97,71,10,16,1058,665,99,53,513,393,184,100,0,84,209,31,21,157,89104
29884,16107,4949,5713,4069,966,410,1680,959,715,37,78,600,244,93,40,0,53,151,0,57,94,721,468,139,59,270,253,121,16,50,55,132,40,0,92,89106
29885,23012,5994,7980,6160,1791,1087,2261,1037,683,68,103,512,354,306,168,97,41,48,22,26,0,1224,908,96,270,542,316,200,76,31,93,116,11,8,97,89107
29886,44236,9839,15359,13340,4224,1474,3852,2231,1576,221,331,1024,655,469,248,147,74,186,62,44,80,1621,1264,200,287,777,357,213,113,28,72,144,79,22,43,89108
29887,5549,613,1731,1495,1073,637,143,38,38,25,0,13,0,0,0,0,0,0,0,0,0,105,32,0,0,32,73,43,0,26,17,30,0,0,30,89109
29888,40868,13992,11804,10549,2773,1750,5195,2650,1924,276,208,1440,726,343,123,48,172,383,134,157,92,2545,1962,275,212,1475,583,251,77,58,116,332,91,44,197,89110
29889,17586,2276,4842,5272,3680,1516,680,401,247,75,26,146,154,83,31,25,27,71,13,30,28,279,200,7,12,181,79,0,0,0,0,79,2,46,31,89113
29890,31282,11395,9593,8284,1461,549,3444,1872,1339,71,142,1126,533,285,209,68,8,248,32,136,80,1572,1135,95,159,881,437,218,126,52,40,219,0,65,154,89115
29891,39324,3742,9292,14748,7730,3812,1849,803,665,126,41,498,138,52,43,9,0,86,63,0,23,1046,824,268,30,526,222,197,172,11,14,25,8,0,17,89117
29892,14970,1752,4509,5330,2408,971,1055,542,395,76,0,319,147,21,7,0,14,126,100,11,15,513,387,104,12,271,126,107,21,56,30,19,0,0,19,89118
29893,29437,5960,9604,9214,3269,1390,2676,1514,994,175,33,786,520,275,53,97,125,245,75,27,143,1162,995,99,95,801,167,154,133,0,21,13,0,13,0,89119
29894,16249,2410,4919,4903,2427,1590,1142,519,383,67,23,293,136,76,39,9,28,60,6,51,3,623,488,77,117,294,135,79,29,50,0,56,0,25,31,89120
29895,43276,9391,14769,12718,4385,2013,2988,1550,1022,175,44,803,528,300,180,38,82,228,94,68,66,1438,1165,192,49,924,273,135,109,13,13,138,48,38,52,89121
29896,31440,6302,10312,9878,3601,1347,2029,1224,911,121,109,681,313,179,79,41,59,134,11,0,123,805,628,53,55,520,177,99,41,38,20,78,35,31,12,89122
29897,40476,4278,11642,13521,8109,2926,2762,1455,1162,360,107,695,293,159,138,14,7,134,69,2,63,1307,963,172,169,622,344,197,76,18,103,147,43,9,95,89123
29898,669,27,177,177,180,108,14,1,0,0,0,0,1,1,1,0,0,0,0,0,0,13,13,4,0,9,0,0,0,0,0,0,0,0,0,89124
29899,25901,2569,7580,9352,3739,2661,2203,954,700,187,56,457,254,206,42,77,87,48,0,14,34,1249,1063,255,136,672,186,48,36,0,12,138,61,11,66,89128
29900,35002,2444,9705,13051,6195,3607,2839,1485,1182,238,86,858,303,273,169,50,54,30,15,0,15,1354,1136,356,33,747,218,140,59,56,25,78,14,23,41,89129
29901,21933,1883,6966,8700,2973,1411,1661,879,706,145,13,548,173,127,65,35,27,46,17,0,29,782,648,199,102,347,134,87,76,0,11,47,10,0,37,89130
29902,28768,1944,7945,10902,5200,2777,2956,1544,1083,137,61,885,461,385,320,12,53,76,0,74,2,1412,1171,317,65,789,241,161,45,0,116,80,35,0,45,89131
29903,21451,1107,5244,7063,4915,3122,860,516,481,115,19,347,35,0,0,0,0,35,25,10,0,344,327,60,27,240,17,17,17,0,0,0,0,0,0,89134
29904,18960,781,3780,5605,5032,3762,974,502,495,87,0,408,7,7,7,0,0,0,0,0,0,472,435,99,7,329,37,37,37,0,0,0,0,0,0,89135
29905,8091,341,1314,2258,2667,1511,635,282,242,21,16,205,40,23,0,0,23,17,0,0,17,353,324,127,10,187,29,29,18,0,11,0,0,0,0,89138
29906,21643,2623,5155,8093,4352,1420,1547,758,556,97,11,448,202,180,42,43,95,22,0,0,22,789,704,120,16,568,85,85,0,54,31,0,0,0,0,89139
29907,18443,1238,4088,6985,4278,1854,1333,689,424,52,124,248,265,157,7,8,142,108,0,0,108,644,577,121,50,406,67,42,0,32,10,25,0,0,25,89141
29908,19484,4508,6551,5629,2143,653,1963,1070,817,154,7,656,253,174,10,150,14,79,21,35,23,893,765,125,36,604,128,106,70,0,36,22,0,0,22,89142
29909,6799,237,2136,2602,1159,665,900,510,366,69,34,263,144,129,89,40,0,15,0,0,15,390,355,46,40,269,35,25,25,0,0,10,0,0,10,89143
29910,13955,916,2679,4914,3240,2206,1129,604,523,36,19,468,81,0,0,0,0,81,0,81,0,525,511,45,34,432,14,14,7,0,7,0,0,0,0,89144
29911,17121,2250,5054,5822,2245,1750,1296,720,623,188,123,312,97,38,0,0,38,59,11,48,0,576,492,117,45,330,84,69,26,11,32,15,13,0,2,89145
29912,13315,1985,4352,4008,1814,1156,708,348,305,19,44,242,43,5,0,5,0,38,12,26,0,360,282,26,80,176,78,43,20,0,23,35,8,0,27,89146
29913,35282,3795,10914,12137,6111,2325,2756,1257,918,257,86,575,339,248,86,51,111,91,43,0,48,1499,1209,313,139,757,290,123,14,88,21,167,53,32,82,89147
29914,28505,2476,7948,9785,6522,1774,1739,738,663,102,48,513,75,37,25,0,12,38,37,0,1,1001,948,71,13,864,53,0,0,0,0,53,46,0,7,89148
29915,21466,1516,5645,8429,4229,1647,1613,1026,747,115,25,607,279,226,138,17,71,53,18,0,35,587,476,115,53,308,111,111,61,34,16,0,0,0,0,89149
29916,16490,4334,5802,4675,1174,505,1897,1158,919,163,124,632,239,129,14,93,22,110,36,45,29,739,530,97,121,312,209,136,61,32,43,73,24,49,0,89156
29917,78,0,78,0,0,0,15,15,0,0,0,0,15,15,15,0,0,0,0,0,0,0,0,0,0,0,0,0,0,0,0,0,0,0,0,89161
29918,7599,448,1753,3085,1589,724,494,297,213,14,0,199,84,76,46,14,16,8,0,0,8,197,193,0,24,169,4,4,0,4,0,0,0,0,0,89166
29919,14733,3378,4814,4266,1655,620,858,408,312,38,32,242,96,64,46,18,0,32,2,30,0,450,306,67,46,193,144,88,0,0,88,56,6,0,50,89169
29920,19451,1235,4091,7146,5091,1888,741,420,375,51,38,286,45,0,0,0,0,45,18,0,27,321,233,35,40,158,88,67,21,20,26,21,0,0,21,89178
29921,1948,141,397,992,278,140,104,21,21,0,21,0,0,0,0,0,0,0,0,0,0,83,63,33,0,30,20,0,0,0,0,20,20,0,0,89179
29922,24356,2550,6632,8844,4952,1378,2112,989,751,81,18,652,238,138,126,12,0,100,0,56,44,1123,992,254,45,693,131,75,47,12,16,56,10,34,12,89183
29923,41,0,13,15,13,0,170,134,8,8,0,0,126,126,126,0,0,0,0,0,0,36,13,13,0,0,23,23,23,0,0,0,0,0,0,89191
29924,4808,758,1712,1689,425,224,458,243,182,47,5,130,61,53,20,25,8,8,0,0,8,215,196,107,33,56,19,0,0,0,0,19,12,0,7,89301
29925,361,38,167,144,0,12,25,17,17,0,7,10,0,0,0,0,0,0,0,0,0,8,8,0,0,8,0,0,0,0,0,0,0,0,0,89310
29926,86,12,19,8,30,17,0,0,0,0,0,0,0,0,0,0,0,0,0,0,0,0,0,0,0,0,0,0,0,0,0,0,0,0,0,89311
29927,199,23,51,74,50,1,4,4,1,0,0,1,3,0,0,0,0,3,0,2,1,0,0,0,0,0,0,0,0,0,0,0,0,0,0,89314
29928,997,91,280,278,238,110,61,10,6,0,0,6,4,4,4,0,0,0,0,0,0,51,51,29,0,22,0,0,0,0,0,0,0,0,0,89316
29929,277,56,80,130,0,11,55,0,0,0,0,0,0,0,0,0,0,0,0,0,0,55,51,5,46,0,4,4,0,0,4,0,0,0,0,89317
29930,1140,126,352,484,65,113,171,115,32,0,0,32,83,58,43,15,0,25,0,0,25,56,35,5,23,7,21,21,0,21,0,0,0,0,0,89318
29931,433,10,322,101,0,0,28,28,28,0,0,28,0,0,0,0,0,0,0,0,0,0,0,0,0,0,0,0,0,0,0,0,0,0,0,89319
29932,0,0,0,0,0,0,0,0,0,0,0,0,0,0,0,0,0,0,0,0,0,0,0,0,0,0,0,0,0,0,0,0,0,0,0,89402
29933,9840,1221,2372,4248,1258,741,914,394,341,8,35,298,53,29,11,18,0,24,9,0,15,520,502,80,53,369,18,18,0,18,0,0,0,0,0,89403
29934,30,0,0,30,0,0,0,0,0,0,0,0,0,0,0,0,0,0,0,0,0,0,0,0,0,0,0,0,0,0,0,0,0,0,0,89404
29935,94,0,20,32,0,42,39,39,23,0,0,23,16,16,16,0,0,0,0,0,0,0,0,0,0,0,0,0,0,0,0,0,0,0,0,89405
29936,16306,1755,5594,6218,1707,1032,1322,706,599,158,53,388,107,97,54,31,12,10,0,10,0,616,458,143,38,277,158,89,64,9,16,69,0,24,45,89406
29937,12327,1714,3629,4804,1223,957,661,434,329,75,34,220,105,22,22,0,0,83,28,0,55,227,157,27,0,130,70,36,22,14,0,34,0,19,15,89408
29938,102,23,46,16,10,7,9,9,9,0,0,9,0,0,0,0,0,0,0,0,0,0,0,0,0,0,0,0,0,0,0,0,0,0,0,89409
29939,7719,702,2199,3000,1156,662,590,341,320,122,42,156,21,13,0,13,0,8,0,0,8,249,234,31,56,147,15,15,15,0,0,0,0,0,0,89410
29940,628,5,73,253,178,119,97,0,0,0,0,0,0,0,0,0,0,0,0,0,0,97,97,84,0,13,0,0,0,0,0,0,0,0,0,89411
29941,195,20,16,50,35,74,0,0,0,0,0,0,0,0,0,0,0,0,0,0,0,0,0,0,0,0,0,0,0,0,0,0,0,0,0,89412
29942,389,0,92,85,81,131,5,5,5,0,0,5,0,0,0,0,0,0,0,0,0,0,0,0,0,0,0,0,0,0,0,0,0,0,0,89413
29943,265,44,48,115,32,26,0,0,0,0,0,0,0,0,0,0,0,0,0,0,0,0,0,0,0,0,0,0,0,0,0,0,0,0,0,89414
29944,2968,287,1123,1203,260,95,134,123,97,47,0,50,26,26,0,25,1,0,0,0,0,11,11,0,0,11,0,0,0,0,0,0,0,0,0,89415
29945,123,12,70,26,0,15,3,3,3,0,0,3,0,0,0,0,0,0,0,0,0,0,0,0,0,0,0,0,0,0,0,0,0,0,0,89418
29946,4217,926,1466,1375,282,168,224,125,114,21,0,93,11,8,0,0,8,3,0,0,3,99,78,19,0,59,21,21,0,2,19,0,0,0,0,89419
29947,39,12,18,9,0,0,0,0,0,0,0,0,0,0,0,0,0,0,0,0,0,0,0,0,0,0,0,0,0,0,0,0,0,0,0,89420
29948,403,44,197,129,33,0,34,22,11,0,0,11,11,11,0,11,0,0,0,0,0,12,11,0,3,8,1,1,0,1,0,0,0,0,0,89421
29949,82,34,36,12,0,0,0,0,0,0,0,0,0,0,0,0,0,0,0,0,0,0,0,0,0,0,0,0,0,0,0,0,0,0,0,89422
29950,8279,315,1995,3543,1544,882,348,294,246,144,21,81,48,0,0,0,0,48,13,11,24,54,54,13,10,31,0,0,0,0,0,0,0,0,0,89423
29951,210,45,79,75,11,0,18,11,11,0,0,11,0,0,0,0,0,0,0,0,0,7,0,0,0,0,7,7,0,0,7,0,0,0,0,89424
29952,517,197,235,28,57,0,41,41,41,0,0,41,0,0,0,0,0,0,0,0,0,0,0,0,0,0,0,0,0,0,0,0,0,0,0,89425
29953,264,16,108,87,40,13,0,0,0,0,0,0,0,0,0,0,0,0,0,0,0,0,0,0,0,0,0,0,0,0,0,0,0,0,0,89426
29954,444,86,134,191,28,5,45,35,16,0,3,13,19,19,0,19,0,0,0,0,0,10,10,0,0,10,0,0,0,0,0,0,0,0,0,89427
29955,153,29,29,31,19,45,15,15,0,0,0,0,15,15,0,0,15,0,0,0,0,0,0,0,0,0,0,0,0,0,0,0,0,0,0,89428
29956,5568,1151,2045,1814,450,108,333,144,134,0,37,97,10,10,0,0,10,0,0,0,0,189,131,0,0,131,58,58,15,0,43,0,0,0,0,89429
29957,267,41,88,102,36,0,34,34,34,0,0,34,0,0,0,0,0,0,0,0,0,0,0,0,0,0,0,0,0,0,0,0,0,0,0,89430
29958,23858,6133,7825,6954,2091,855,2002,935,795,168,86,541,140,112,76,8,28,28,28,0,0,1067,891,254,87,550,176,36,0,19,17,140,45,0,95,89431
29959,12257,2911,4532,3978,655,181,1040,629,567,70,54,443,62,62,35,0,27,0,0,0,0,411,381,123,45,213,30,15,15,0,0,15,0,0,15,89433
29960,17193,1678,5306,6831,2345,1033,1290,531,440,106,42,292,91,57,55,0,2,34,22,0,12,759,675,147,167,361,84,76,53,15,8,8,8,0,0,89434
29961,25400,1658,5830,10683,4839,2390,1818,893,753,247,119,387,140,91,49,42,0,49,30,8,11,925,810,282,91,437,115,74,19,49,6,41,9,22,10,89436
29962,0,0,0,0,0,0,0,0,0,0,0,0,0,0,0,0,0,0,0,0,0,0,0,0,0,0,0,0,0,0,0,0,0,0,0,89438
29963,1402,74,326,516,234,252,104,83,65,32,0,33,18,18,18,0,0,0,0,0,0,21,21,0,0,21,0,0,0,0,0,0,0,0,0,89439
29964,658,1,177,259,96,125,22,4,0,0,0,0,4,0,0,0,0,4,0,0,4,18,18,0,0,18,0,0,0,0,0,0,0,0,0,89440
29965,7635,520,2198,3111,1240,566,693,328,289,30,29,230,39,37,0,37,0,2,0,0,2,365,315,80,63,172,50,50,17,32,1,0,0,0,0,89441
29966,548,53,205,212,56,22,49,36,35,16,0,19,1,1,0,1,0,0,0,0,0,13,6,3,2,1,7,7,0,5,2,0,0,0,0,89442
29967,2058,235,711,831,195,86,79,36,36,13,2,21,0,0,0,0,0,0,0,0,0,43,35,3,7,25,8,8,1,2,5,0,0,0,0,89444
29968,9955,1662,3638,3425,851,379,951,482,382,80,10,292,100,57,48,9,0,43,6,37,0,469,400,201,10,189,69,27,17,0,10,42,0,42,0,89445
29969,34,0,0,34,0,0,0,0,0,0,0,0,0,0,0,0,0,0,0,0,0,0,0,0,0,0,0,0,0,0,0,0,0,0,0,89446
29970,6067,1193,2165,1903,572,234,627,359,336,15,16,305,23,10,0,8,2,13,0,0,13,268,202,105,31,66,66,66,6,19,41,0,0,0,0,89447
29971,1232,33,122,422,417,238,15,6,6,0,6,0,0,0,0,0,0,0,0,0,0,9,9,0,0,9,0,0,0,0,0,0,0,0,0,89448
29972,2314,252,481,922,502,157,119,75,51,0,0,51,24,24,24,0,0,0,0,0,0,44,44,44,0,0,0,0,0,0,0,0,0,0,0,89449
29973,154,0,9,74,53,18,0,0,0,0,0,0,0,0,0,0,0,0,0,0,0,0,0,0,0,0,0,0,0,0,0,0,0,0,0,89450
29974,6338,442,721,1897,2047,1231,326,171,171,44,0,127,0,0,0,0,0,0,0,0,0,155,143,29,17,97,12,12,12,0,0,0,0,0,0,89451
29975,9263,581,2561,4236,1352,533,479,205,189,30,17,142,16,3,0,0,3,13,13,0,0,274,204,13,79,112,70,37,23,14,0,33,6,0,27,89460
29976,2793,360,664,1050,419,300,177,133,133,79,0,54,0,0,0,0,0,0,0,0,0,44,44,41,0,3,0,0,0,0,0,0,0,0,0,89501
29977,28616,7135,7834,8910,3543,1194,2412,1380,888,162,22,704,492,174,137,14,23,318,139,117,62,1032,824,206,34,584,208,139,96,37,6,69,46,4,19,89502
29978,17603,2027,4034,6740,2875,1927,2682,1267,1177,287,103,787,90,21,8,13,0,69,16,41,12,1415,1370,506,33,831,45,37,31,0,6,8,0,2,6,89503
29979,26082,3851,8371,9917,3060,883,2137,1028,883,123,104,656,145,97,17,15,65,48,26,0,22,1109,927,87,253,587,182,103,28,18,57,79,0,0,79,89506
29980,7904,834,2008,3542,990,530,606,362,327,93,0,234,35,31,0,19,12,4,4,0,0,244,244,44,15,185,0,0,0,0,0,0,0,0,0,89508
29981,24626,2323,4524,7760,5718,4301,1331,470,396,81,51,264,74,64,64,0,0,10,10,0,0,861,803,323,73,407,58,50,14,36,0,8,8,0,0,89509
29982,1201,69,375,537,159,61,61,45,45,8,0,37,0,0,0,0,0,0,0,0,0,16,15,5,0,10,1,1,0,0,1,0,0,0,0,89510
29983,18185,680,2556,6235,5172,3542,1746,1116,1054,218,17,819,62,62,38,13,11,0,0,0,0,630,555,144,65,346,75,10,0,5,5,65,25,0,40,89511
29984,15008,4334,4470,4043,1472,689,1331,721,406,58,8,340,315,272,140,93,39,43,18,10,15,610,483,171,17,295,127,98,51,33,14,29,0,4,25,89512
29985,6313,102,771,1809,1781,1850,183,106,81,13,10,58,25,25,25,0,0,0,0,0,0,77,77,24,0,53,0,0,0,0,0,0,0,0,0,89519
29986,17224,832,3706,6080,4386,2220,834,480,393,50,0,343,87,50,30,20,0,37,37,0,0,354,332,91,40,201,22,6,6,0,0,16,16,0,0,89521
29987,20304,912,3237,7204,5659,3292,1926,816,752,254,62,436,64,56,56,0,0,8,8,0,0,1110,993,489,28,476,117,54,17,31,6,63,23,0,40,89523
29988,18588,2784,5995,6631,2050,1128,1322,595,504,99,126,279,91,71,51,20,0,20,9,11,0,727,614,261,48,305,113,103,53,42,8,10,0,0,10,89701
29989,171,54,58,57,0,2,0,0,0,0,0,0,0,0,0,0,0,0,0,0,0,0,0,0,0,0,0,0,0,0,0,0,0,0,0,89702
29990,7664,464,1665,2629,1514,1392,573,287,282,71,65,146,5,0,0,0,0,5,0,5,0,286,260,86,61,113,26,26,19,0,7,0,0,0,0,89703
29991,3543,190,577,1457,886,433,163,143,128,28,24,76,15,15,15,0,0,0,0,0,0,20,20,0,9,11,0,0,0,0,0,0,0,0,0,89704
29992,3617,439,992,1304,536,346,344,179,116,17,0,99,63,27,27,0,0,36,36,0,0,165,96,49,0,47,69,69,43,26,0,0,0,0,0,89705
29993,13160,2188,4256,4904,1130,682,893,454,338,98,13,227,116,79,44,10,25,37,0,9,28,439,370,96,82,192,69,54,15,30,9,15,0,0,15,89706
29994,13787,2185,3661,5466,1632,843,1448,823,646,191,22,433,177,101,70,31,0,76,13,52,11,625,506,241,5,260,119,17,17,0,0,102,40,13,49,89801
29995,9125,811,2573,4042,1104,595,839,407,301,126,8,167,106,58,11,0,47,48,48,0,0,432,409,257,31,121,23,0,0,0,0,23,0,0,23,89815
29996,3453,670,1152,1191,359,81,313,138,105,4,0,101,33,33,15,18,0,0,0,0,0,175,110,24,0,86,65,65,30,0,35,0,0,0,0,89820
29997,343,41,195,95,6,6,14,11,11,0,0,11,0,0,0,0,0,0,0,0,0,3,3,0,0,3,0,0,0,0,0,0,0,0,0,89821
29998,1696,277,691,595,110,23,84,27,27,20,0,7,0,0,0,0,0,0,0,0,0,57,52,45,0,7,5,0,0,0,0,5,0,0,5,89822
29999,137,0,0,8,120,9,5,0,0,0,0,0,0,0,0,0,0,0,0,0,0,5,5,5,0,0,0,0,0,0,0,0,0,0,0,89823
30000,799,436,151,191,0,21,176,91,48,0,0,48,43,43,43,0,0,0,0,0,0,85,54,16,0,38,31,31,0,0,31,0,0,0,0,89825
30001,93,0,14,62,0,17,0,0,0,0,0,0,0,0,0,0,0,0,0,0,0,0,0,0,0,0,0,0,0,0,0,0,0,0,0,89826
30002,285,74,0,155,56,0,0,0,0,0,0,0,0,0,0,0,0,0,0,0,0,0,0,0,0,0,0,0,0,0,0,0,0,0,0,89828
30003,184,44,31,92,17,0,14,0,0,0,0,0,0,0,0,0,0,0,0,0,0,14,0,0,0,0,14,0,0,0,0,14,0,0,14,89830
30004,30,0,0,0,30,0,0,0,0,0,0,0,0,0,0,0,0,0,0,0,0,0,0,0,0,0,0,0,0,0,0,0,0,0,0,89831
30005,955,216,319,321,80,19,147,97,84,3,0,81,13,4,3,0,1,9,0,7,2,50,25,0,0,25,25,12,3,0,9,13,0,0,13,89832
30006,219,40,0,119,29,31,1,0,0,0,0,0,0,0,0,0,0,0,0,0,0,1,1,0,0,1,0,0,0,0,0,0,0,0,0,89833
30007,124,60,20,36,8,0,0,0,0,0,0,0,0,0,0,0,0,0,0,0,0,0,0,0,0,0,0,0,0,0,0,0,0,0,0,89834
30008,1159,223,344,411,164,17,81,29,9,0,0,9,20,10,10,0,0,10,10,0,0,52,28,28,0,0,24,16,16,0,0,8,8,0,0,89835
30009,2325,834,900,445,95,51,297,186,99,21,0,78,87,28,28,0,0,59,33,0,26,111,65,10,0,55,46,46,46,0,0,0,0,0,0,89883
30010,29401,17618,6588,4130,885,180,3995,2007,1642,115,133,1394,365,202,134,28,40,163,23,50,90,1988,1524,155,126,1243,464,293,130,24,139,171,42,26,103,90001
30011,25501,12662,6469,5368,776,226,3855,1827,1283,135,106,1042,544,352,136,32,184,192,34,16,142,2028,1626,65,86,1475,402,196,69,15,112,206,0,15,191,90002
30012,34385,18120,8235,5994,1677,359,5338,2617,1901,196,119,1586,716,410,135,121,154,306,133,35,138,2721,2228,176,220,1832,493,363,103,87,173,130,26,25,79,90003
30013,43721,12761,7464,9029,10788,3679,2955,1575,1398,247,169,982,177,115,55,0,60,62,22,16,24,1380,1256,110,182,964,124,62,3,29,30,62,0,0,62,90004
30014,27262,8899,6161,5037,5720,1445,1647,988,834,106,99,629,154,69,48,0,21,85,72,13,0,659,510,36,72,402,149,99,62,28,9,50,0,6,44,90005
30015,39022,18188,9493,6025,4135,1181,3365,1668,1225,91,192,942,443,268,103,121,44,175,126,21,28,1697,1308,98,195,1015,389,299,147,79,73,90,43,37,10,90006
30016,19534,7955,3886,3735,2552,1406,5338,2617,2411,357,125,1929,206,101,42,0,59,105,46,8,51,2721,2575,565,144,1866,146,102,32,6,64,44,6,0,38,90007
30017,22901,4198,5531,7187,3481,2504,1999,1077,1023,87,92,844,54,15,0,0,15,39,0,39,0,922,862,74,71,717,60,44,0,44,0,16,0,0,16,90008
30018,3499,346,511,979,1134,529,113,67,67,30,17,20,0,0,0,0,0,0,0,0,0,46,46,0,12,34,0,0,0,0,0,0,0,0,0,90010
30019,54474,35160,10915,6557,1423,419,7789,3834,2993,256,156,2581,841,490,202,66,222,351,108,36,207,3955,3174,241,166,2767,781,529,102,40,387,252,5,41,206,90011
30020,21973,8260,4125,4087,3490,2011,1241,768,366,11,58,297,402,92,0,0,92,310,0,0,310,473,399,17,36,346,74,71,0,0,71,3,3,0,0,90012
30021,9170,2159,1923,2169,1959,960,48,38,15,0,0,15,23,23,0,0,23,0,0,0,0,10,2,1,0,1,8,8,0,8,0,0,0,0,0,90013
30022,5615,1377,818,1588,1193,639,16,16,16,0,0,16,0,0,0,0,0,0,0,0,0,0,0,0,0,0,0,0,0,0,0,0,0,0,0,90014
30023,11841,5263,1809,2013,1889,867,1070,505,392,23,50,319,113,25,25,0,0,88,60,0,28,565,445,65,40,340,120,112,6,32,74,8,0,0,8,90015
30024,30557,8852,7409,9157,3623,1516,2696,1426,1226,146,75,1005,200,104,71,12,21,96,58,0,38,1270,1123,285,105,733,147,124,49,27,48,23,0,0,23,90016
30025,14791,7286,2494,2140,1942,929,1193,736,474,42,39,393,262,94,42,1,51,168,102,0,66,457,414,1,18,395,43,39,32,0,7,4,0,0,4,90017
30026,31091,11591,7955,7355,2826,1364,2789,1400,1079,87,66,926,321,177,84,18,75,144,0,31,113,1389,1171,132,36,1003,218,184,106,6,72,34,0,20,14,90018
30027,45433,12273,9036,9819,9845,4460,3089,1655,1380,123,126,1131,275,205,159,0,46,70,24,16,30,1434,1211,125,155,931,223,94,25,44,25,129,41,62,26,90019
30028,28254,5798,5925,6213,7955,2363,1663,782,709,14,80,615,73,33,0,25,8,40,23,0,17,881,760,141,67,552,121,103,63,15,25,18,0,0,18,90020
30029,2597,821,463,846,381,86,54,51,2,0,0,2,49,31,31,0,0,18,0,0,18,3,3,0,0,3,0,0,0,0,0,0,0,0,0,90021
30030,40761,21750,9637,7184,1697,493,4929,2581,2138,226,291,1621,443,182,55,82,45,261,50,111,100,2348,2040,219,147,1674,308,220,97,29,94,88,19,6,63,90022
30031,25700,14568,6220,3400,1137,375,3232,1727,1354,62,147,1145,373,217,83,43,91,156,40,53,63,1505,1220,32,50,1138,285,199,83,37,79,86,33,10,43,90023
30032,23074,715,2309,3993,8388,7669,10480,4426,4379,852,365,3162,47,20,0,20,0,27,0,0,27,6054,6032,1534,405,4093,22,22,0,0,22,0,0,0,0,90024
30033,33842,2685,2733,5980,13207,9237,791,436,328,39,0,289,108,9,0,0,9,99,47,52,0,355,340,89,60,191,15,15,0,0,15,0,0,0,0,90025
30034,47768,13654,7782,10312,11719,4301,3547,1832,1574,144,55,1375,258,120,38,43,39,138,32,2,104,1715,1408,178,99,1131,307,208,122,36,50,99,17,33,49,90026
30035,36772,4590,5681,9110,11576,5815,1259,592,538,67,46,425,54,29,0,0,29,25,7,0,18,667,598,102,61,435,69,53,46,0,7,16,0,0,16,90027
30036,20537,3610,3193,5185,6459,2090,1287,684,533,116,86,331,151,151,47,30,74,0,0,0,0,603,503,190,0,313,100,77,77,0,0,23,10,13,0,90028
30037,27753,9642,4896,6229,5300,1686,1928,898,676,35,127,514,222,165,51,35,79,57,33,0,24,1030,868,143,95,630,162,82,63,0,19,80,9,6,65,90029
30038,25673,11910,5514,4887,2418,944,2548,1273,1129,127,241,761,144,100,10,28,62,44,44,0,0,1275,1056,130,111,815,219,192,55,53,84,27,10,0,17,90031
30039,29655,11044,7145,7270,2795,1401,3341,1555,1284,131,157,996,271,179,112,67,0,92,16,36,40,1786,1711,215,176,1320,75,52,9,43,0,23,9,0,14,90032
30040,27067,14353,6234,4468,1538,474,4351,2460,2030,157,176,1697,430,212,52,105,55,218,42,122,54,1891,1722,121,222,1379,169,94,17,51,26,75,5,49,21,90033
30041,42829,5211,4850,10293,13913,8562,2103,1119,1077,70,83,924,42,42,29,0,13,0,0,0,0,984,876,161,20,695,108,108,105,3,0,0,0,0,0,90034
30042,22809,1390,2743,5132,8571,4973,950,465,349,84,21,244,116,69,9,54,6,47,47,0,0,485,485,119,22,344,0,0,0,0,0,0,0,0,0,90035
30043,27651,765,2455,6300,12091,6040,857,311,303,8,35,260,8,8,0,0,8,0,0,0,0,546,513,76,31,406,33,19,9,0,10,14,0,0,14,90036
30044,35294,19468,7975,5633,1800,418,4636,2321,1662,131,111,1420,659,346,140,62,144,313,114,51,148,2315,1965,166,131,1668,350,201,87,9,105,149,41,0,108,90037
30045,19874,5696,3926,4974,3941,1337,1378,708,585,78,119,388,123,45,24,0,21,78,16,4,58,670,529,139,90,300,141,84,24,38,22,57,0,35,22,90038
30046,20655,2784,3211,5514,6352,2794,940,454,403,44,0,359,51,33,17,7,9,18,0,18,0,486,392,36,41,315,94,83,40,39,4,11,0,11,0,90039
30047,7778,3619,1894,1747,356,162,1098,590,497,42,90,365,93,60,0,13,47,33,0,0,33,508,439,52,36,351,69,69,58,0,11,0,0,0,0,90040
30048,19406,2659,3085,5297,5588,2777,2013,934,907,331,68,508,27,22,15,0,7,5,0,5,0,1079,1048,331,46,671,31,10,10,0,0,21,16,0,5,90041
30049,40711,12887,7291,10033,7271,3229,3526,1745,1533,182,180,1171,212,141,95,46,0,71,41,13,17,1781,1605,116,282,1207,176,132,15,36,81,44,0,34,10,90042
30050,29049,5741,5939,11000,3425,2944,2276,1185,1032,145,155,732,153,109,0,89,20,44,4,34,6,1091,1025,97,100,828,66,49,26,0,23,17,0,17,0,90043
30051,50501,20245,13284,12353,3530,1089,6214,3085,2519,184,233,2102,566,403,167,21,215,163,25,32,106,3129,2387,147,213,2027,742,482,175,72,235,260,27,56,177,90044
30052,26193,1500,3026,7727,8247,5693,3829,1679,1524,376,77,1071,155,119,71,48,0,36,36,0,0,2150,2122,532,107,1483,28,24,24,0,0,4,0,0,4,90045
30053,42297,1975,4911,11054,17536,6821,844,436,367,31,61,275,69,69,37,0,32,0,0,0,0,408,354,85,0,269,54,54,45,9,0,0,0,0,0,90046
30054,30600,6599,8192,10909,3592,1308,2966,1674,1379,125,92,1162,295,204,42,22,140,91,74,0,17,1292,1121,129,123,869,171,80,6,37,37,91,17,26,48,90047
30055,17492,958,1926,3362,6680,4566,261,76,76,0,0,76,0,0,0,0,0,0,0,0,0,185,145,28,14,103,40,40,0,0,40,0,0,0,0,90048
30056,27035,445,1567,4519,10985,9519,1070,427,365,38,0,327,62,24,24,0,0,38,0,0,38,643,643,192,13,438,0,0,0,0,0,0,0,0,0,90049
30057,6232,139,498,2029,2005,1561,555,235,224,0,12,212,11,0,0,0,0,11,0,0,11,320,305,49,0,256,15,15,15,0,0,0,0,0,0,90056
30058,30323,14436,5778,5003,4145,961,2143,1175,897,77,140,680,278,124,63,42,19,154,122,27,5,968,854,53,125,676,114,57,29,28,0,57,35,0,22,90057
30059,1591,1159,129,184,109,10,250,109,73,0,6,67,36,0,0,0,0,36,13,19,4,141,117,0,0,117,24,19,0,17,2,5,0,0,5,90058
30060,21536,9616,5308,5107,1069,436,3355,1432,952,23,58,871,480,259,104,108,47,221,46,74,101,1923,1379,91,160,1128,544,368,161,44,163,176,0,40,136,90059
30061,14849,6375,3929,3491,822,232,2015,999,689,59,70,560,310,125,30,7,88,185,14,25,146,1016,818,57,98,663,198,93,38,30,25,105,22,33,50,90061
30062,20454,8308,5784,4922,1050,390,2076,1099,924,60,56,808,175,88,40,14,34,87,26,29,32,977,767,68,88,611,210,92,7,6,79,118,17,14,87,90062
30063,31292,17075,7226,5306,1342,343,4193,1973,1682,135,132,1415,291,133,104,16,13,158,96,0,62,2220,1853,91,192,1570,367,250,51,89,110,117,21,13,83,90063
30064,18950,795,2295,4213,5987,5660,743,401,375,27,5,343,26,26,0,0,26,0,0,0,0,342,332,15,31,286,10,10,4,0,6,0,0,0,0,90064
30065,30750,9277,5847,7025,5374,3227,2533,1343,998,126,63,809,345,262,110,48,104,83,49,10,24,1190,1002,95,71,836,188,163,45,79,39,25,4,0,21,90065
30066,43200,5222,5663,11119,13805,7391,1803,997,859,116,46,697,138,80,12,35,33,58,48,0,10,806,660,118,17,525,146,82,5,7,70,64,64,0,0,90066
30067,2070,58,379,463,822,348,14,0,0,0,0,0,0,0,0,0,0,0,0,0,0,14,14,9,0,5,0,0,0,0,0,0,0,0,0,90067
30068,17905,508,1594,4844,7121,3838,506,303,248,27,68,153,55,23,22,0,1,32,0,0,32,203,101,19,49,33,102,93,50,14,29,9,2,0,7,90068
30069,18782,729,2165,4459,7444,3985,178,26,26,0,0,26,0,0,0,0,0,0,0,0,0,152,125,10,0,115,27,27,0,0,27,0,0,0,0,90069
30070,0,0,0,0,0,0,0,0,0,0,0,0,0,0,0,0,0,0,0,0,0,0,0,0,0,0,0,0,0,0,0,0,0,0,0,90071
30071,739,194,205,282,21,37,11,11,0,0,0,0,11,1,1,0,0,10,10,0,0,0,0,0,0,0,0,0,0,0,0,0,0,0,0,90073
30072,6052,108,387,1145,1755,2657,427,176,167,47,0,120,9,9,9,0,0,0,0,0,0,251,251,13,10,228,0,0,0,0,0,0,0,0,0,90077
30073,0,0,0,0,0,0,0,0,0,0,0,0,0,0,0,0,0,0,0,0,0,0,0,0,0,0,0,0,0,0,0,0,0,0,0,90079
30074,100,0,10,43,22,25,2555,1209,1203,196,45,962,6,0,0,0,0,6,6,0,0,1346,1340,327,53,960,6,6,6,0,0,0,0,0,0,90089
30075,0,0,0,0,0,0,0,0,0,0,0,0,0,0,0,0,0,0,0,0,0,0,0,0,0,0,0,0,0,0,0,0,0,0,0,90090
30076,4396,30,174,641,1790,1761,101,77,77,0,0,77,0,0,0,0,0,0,0,0,0,24,24,0,0,24,0,0,0,0,0,0,0,0,0,90094
30077,0,0,0,0,0,0,0,0,0,0,0,0,0,0,0,0,0,0,0,0,0,0,0,0,0,0,0,0,0,0,0,0,0,0,0,90095
30078,55981,31847,12706,8595,2226,607,7761,3784,3045,163,224,2658,739,279,146,17,116,460,207,152,101,3977,3207,204,189,2814,770,466,159,57,250,304,39,43,222,90201
30079,15761,659,2773,3229,4876,4224,919,522,501,0,20,481,21,1,0,0,1,20,0,0,20,397,397,9,61,327,0,0,0,0,0,0,0,0,0,90210
30080,5664,329,843,1593,1600,1299,573,281,223,20,0,203,58,58,58,0,0,0,0,0,0,292,292,105,9,178,0,0,0,0,0,0,0,0,0,90211
30081,9028,422,638,1793,3209,2966,614,274,266,11,0,255,8,8,8,0,0,0,0,0,0,340,314,26,49,239,26,0,0,0,0,26,0,0,26,90212
30082,27756,9882,6940,8695,1709,530,3778,1752,1342,138,197,1007,410,223,111,38,74,187,36,56,95,2026,1620,226,264,1130,406,232,61,63,108,174,49,66,59,90220
30083,27994,13316,7209,6090,961,418,4164,2141,1689,215,203,1271,452,197,89,28,80,255,66,89,100,2023,1654,226,226,1202,369,257,51,167,39,112,0,56,56,90221
30084,17060,7014,4966,4110,720,250,2328,1085,718,73,58,587,367,182,80,48,54,185,56,100,29,1243,924,97,148,679,319,153,71,56,26,166,34,0,132,90222
30085,22845,2965,2605,6652,6206,4417,1503,829,642,38,89,515,187,171,88,65,18,16,0,0,16,674,631,53,53,525,43,10,0,0,10,33,0,0,33,90230
30086,11432,1111,1964,3028,3104,2225,482,287,267,21,60,186,20,0,0,0,0,20,20,0,0,195,194,75,0,119,1,1,0,0,1,0,0,0,0,90232
30087,16600,3793,4189,4386,2928,1304,1319,591,394,88,23,283,197,143,100,22,21,54,12,0,42,728,586,62,19,505,142,108,42,33,33,34,0,0,34,90240
30088,28021,6170,7846,8262,4035,1708,2728,1446,1212,199,140,873,234,119,4,47,68,115,65,0,50,1282,1146,313,88,745,136,67,54,0,13,69,8,33,28,90241
30089,25833,6213,7078,7983,3290,1269,3159,1690,1490,194,251,1045,200,154,30,38,86,46,21,0,25,1469,1289,70,38,1181,180,97,35,0,62,83,36,0,47,90242
30090,11634,463,1912,3617,3726,1916,1218,718,650,121,36,493,68,68,63,5,0,0,0,0,0,500,494,103,9,382,6,6,0,0,6,0,0,0,0,90245
30091,31728,7025,8963,8344,5554,1842,2312,1127,913,186,29,698,214,185,28,62,95,29,0,0,29,1185,1089,118,154,817,96,61,19,14,28,35,0,18,17,90247
30092,6998,1505,1541,2378,1205,369,538,355,320,31,30,259,35,0,0,0,0,35,0,0,35,183,158,14,0,144,25,25,10,3,12,0,0,0,0,90248
30093,17561,3601,4459,5741,2544,1216,1479,768,604,93,11,500,164,56,38,0,18,108,30,0,78,711,617,160,46,411,94,84,24,6,54,10,0,0,10,90249
30094,58487,14697,14213,18843,7996,2738,5741,3103,2652,214,275,2163,451,255,75,50,130,196,65,30,101,2638,2298,329,249,1720,340,238,72,59,107,102,11,32,59,90250
30095,15095,145,1206,3043,7139,3562,383,201,201,35,3,163,0,0,0,0,0,0,0,0,0,182,182,4,0,178,0,0,0,0,0,0,0,0,0,90254
30096,43344,25491,8207,7302,1826,518,5259,2564,2146,188,225,1733,418,203,75,81,47,215,75,82,58,2695,2103,201,159,1743,592,420,222,23,175,172,28,11,133,90255
30097,21699,5864,5766,6163,2727,1179,2145,1126,862,120,86,656,264,191,50,56,85,73,58,14,1,1019,929,106,78,745,90,80,60,8,12,10,0,0,10,90260
30098,38125,18682,9937,7386,1548,572,5816,2956,2224,140,157,1927,732,441,154,91,196,291,81,20,190,2860,2408,143,131,2134,452,244,89,63,92,208,44,0,164,90262
30099,144,11,0,22,63,48,833,279,279,51,28,200,0,0,0,0,0,0,0,0,0,554,554,187,27,340,0,0,0,0,0,0,0,0,0,90263
30100,12417,350,1342,3128,3685,3912,1202,695,640,75,0,565,55,33,9,0,24,22,0,0,22,507,500,134,16,350,7,0,0,0,0,7,0,0,7,90265
30101,25131,463,1513,4548,10615,7992,1403,771,735,74,124,537,36,36,0,12,24,0,0,0,0,632,597,153,0,444,35,35,34,1,0,0,0,0,0,90266
30102,14597,8903,2890,2166,532,106,2095,1078,768,129,15,624,310,173,74,39,60,137,94,43,0,1017,875,63,59,753,142,60,41,0,19,82,21,39,22,90270
30103,16115,197,906,2598,6014,6400,1019,560,541,20,9,512,19,0,0,0,0,19,12,0,7,459,412,35,53,324,47,25,9,0,16,22,0,0,22,90272
30104,18132,375,1197,3327,6911,6322,1270,747,737,39,41,657,10,10,0,0,10,0,0,0,0,523,523,13,18,492,0,0,0,0,0,0,0,0,0,90274
30105,30625,692,3121,6922,10771,9119,1811,828,828,32,11,785,0,0,0,0,0,0,0,0,0,983,956,157,23,776,27,8,8,0,0,19,0,0,19,90275
30106,26886,757,2743,7088,9635,6663,1216,727,564,95,89,380,163,128,68,18,42,35,0,0,35,489,451,106,73,272,38,12,12,0,0,26,0,0,26,90277
30107,28964,1574,3393,8065,9961,5971,1274,486,376,43,22,311,110,99,65,33,1,11,0,11,0,788,754,190,18,546,34,29,12,0,17,5,0,0,5,90278
30108,55816,26540,14635,11181,2675,785,7119,3674,3022,277,290,2455,652,351,113,76,162,301,69,76,156,3445,2949,369,384,2196,496,296,53,96,147,200,36,0,164,90280
30109,4900,161,545,1296,1480,1418,231,145,145,39,0,106,0,0,0,0,0,0,0,0,0,86,86,0,0,86,0,0,0,0,0,0,0,0,0,90290
30110,21489,1590,2287,4558,8488,4566,754,360,281,10,43,228,79,65,24,0,41,14,4,0,10,394,364,80,61,223,30,30,18,8,4,0,0,0,0,90291
30111,17920,308,1489,4102,7256,4765,354,208,205,105,14,86,3,0,0,0,0,3,0,0,3,146,134,14,0,120,12,0,0,0,0,12,0,12,0,90292
30112,10563,334,823,2624,4225,2557,130,71,71,0,0,71,0,0,0,0,0,0,0,0,0,59,59,0,0,59,0,0,0,0,0,0,0,0,0,90293
30113,23359,7691,5323,7176,2345,824,2190,1193,1027,99,233,695,166,135,52,51,32,31,0,31,0,997,834,54,39,741,163,93,53,18,22,70,27,23,20,90301
30114,19405,4224,3915,7394,2427,1445,1472,685,543,35,23,485,142,36,7,0,29,106,69,20,17,787,580,81,84,415,207,151,74,69,8,56,0,11,45,90302
30115,14896,5742,3371,4149,1130,504,1967,1121,948,128,89,731,173,106,44,38,24,67,13,16,38,846,817,112,147,558,29,20,5,0,15,9,0,0,9,90303
30116,15715,8040,3979,2847,692,157,1994,1031,994,139,16,839,37,16,16,0,0,21,6,0,15,963,787,73,87,627,176,103,28,0,75,73,21,0,52,90304
30117,10512,1168,1912,4094,1885,1453,780,510,401,0,51,350,109,47,7,28,12,62,36,17,9,270,236,21,47,168,34,6,6,0,0,28,9,0,19,90305
30118,6011,333,778,1393,2059,1448,45,29,14,0,0,14,15,0,0,0,0,15,0,0,15,16,16,0,0,16,0,0,0,0,0,0,0,0,0,90401
30119,9051,166,430,1413,3254,3788,508,275,275,23,45,207,0,0,0,0,0,0,0,0,0,233,233,42,10,181,0,0,0,0,0,0,0,0,0,90402
30120,19869,679,1375,3411,7631,6773,452,185,167,0,10,157,18,0,0,0,0,18,0,0,18,267,227,53,0,174,40,40,0,32,8,0,0,0,0,90403
30121,15903,1510,2380,3750,5275,2988,954,604,534,76,14,444,70,70,30,40,0,0,0,0,0,350,350,97,45,208,0,0,0,0,0,0,0,0,0,90404
30122,21909,862,2058,4982,7878,6129,955,465,411,54,32,325,54,54,43,0,11,0,0,0,0,490,475,98,55,322,15,15,0,0,15,0,0,0,0,90405
30123,27712,5429,5774,8381,5771,2357,2301,1022,831,97,221,513,191,190,71,24,95,1,0,0,1,1279,1147,104,72,971,132,105,34,42,29,27,9,18,0,90501
30124,12423,2218,2910,3134,3141,1020,744,390,274,44,37,193,116,70,18,39,13,46,46,0,0,354,267,36,52,179,87,51,22,29,0,36,36,0,0,90502
30125,32619,1849,5196,8960,11392,5222,1976,909,862,147,180,535,47,47,35,0,12,0,0,0,0,1067,1016,344,48,624,51,51,28,14,9,0,0,0,0,90503
30126,22534,2154,4940,8007,5057,2376,1489,980,876,145,141,590,104,90,83,7,0,14,0,0,14,509,476,107,38,331,33,33,0,23,10,0,0,0,0,90504
30127,26348,1573,4400,7518,8411,4446,2000,1059,1010,110,61,839,49,49,8,0,41,0,0,0,0,941,930,279,15,636,11,11,0,0,11,0,0,0,0,90505
30128,0,0,0,0,0,0,0,0,0,0,0,0,0,0,0,0,0,0,0,0,0,0,0,0,0,0,0,0,0,0,0,0,0,0,0,90506
30129,22001,3608,5269,7387,3651,2086,1927,924,777,107,16,654,147,124,43,14,67,23,23,0,0,1003,884,89,42,753,119,119,20,28,71,0,0,0,0,90601
30130,15355,3679,4119,4786,1703,1068,2215,971,890,78,42,770,81,52,0,33,19,29,18,0,11,1244,1167,306,17,844,77,64,19,0,45,13,0,0,13,90602
30131,13075,998,2871,5238,2477,1491,1466,642,626,92,63,471,16,0,0,0,0,16,0,0,16,824,779,217,54,508,45,45,7,11,27,0,0,0,0,90603
30132,25346,4838,7103,8715,3423,1267,2826,1345,1237,192,64,981,108,93,51,14,28,15,8,6,1,1481,1303,180,32,1091,178,174,95,49,30,4,0,0,4,90604
30133,26238,7167,6711,8154,2706,1500,2512,1283,1075,14,136,925,208,160,88,38,34,48,39,0,9,1229,996,123,75,798,233,216,70,42,104,17,0,0,17,90605
30134,20918,6630,5886,6120,1703,579,2094,1105,897,135,140,622,208,188,80,27,81,20,19,0,1,989,788,117,50,621,201,170,8,0,162,31,0,0,31,90606
30135,29817,3982,7753,10318,6157,1607,2929,1600,1326,168,45,1113,274,177,67,30,80,97,15,30,52,1329,1143,174,95,874,186,176,37,26,113,10,9,1,0,90620
30136,22498,5360,4746,5597,4870,1925,1869,955,866,121,15,730,89,52,40,0,12,37,12,0,25,914,772,198,71,503,142,89,63,0,26,53,0,13,40,90621
30137,10578,789,1945,3611,2875,1358,953,547,534,51,15,468,13,0,0,0,0,13,12,0,1,406,406,52,41,313,0,0,0,0,0,0,0,0,0,90623
30138,32710,2571,6448,10657,8908,4126,2836,1368,1248,188,30,1030,120,115,62,15,38,5,0,0,5,1468,1236,240,34,962,232,70,3,7,60,162,8,0,154,90630
30139,43745,8282,11115,13914,6734,3700,4320,2350,2116,263,236,1617,234,216,116,82,18,18,10,5,3,1970,1626,429,134,1063,344,226,89,60,77,118,35,0,83,90631
30140,31813,3795,7563,11403,5642,3410,3745,2041,1858,288,138,1432,183,168,86,24,58,15,0,15,0,1704,1650,430,107,1113,54,41,27,0,14,13,0,0,13,90638
30141,42021,12637,11354,10446,5264,2320,3188,1600,1320,86,103,1131,280,145,28,23,94,135,48,31,56,1588,1474,170,114,1190,114,114,19,33,62,0,0,0,0,90640
30142,65404,18041,17237,20428,6781,2917,7024,4067,3421,498,200,2723,646,454,145,147,162,192,47,52,93,2957,2536,308,252,1976,421,292,49,121,122,129,36,37,56,90650
30143,40573,13185,12555,10438,3409,986,3982,1891,1720,239,156,1325,171,141,48,0,93,30,0,0,30,2091,1883,285,96,1502,208,103,58,9,36,105,10,0,95,90660
30144,9963,2550,2928,3306,846,333,1078,632,563,34,74,455,69,69,24,0,45,0,0,0,0,446,436,16,97,323,10,10,0,10,0,0,0,0,0,90670
30145,19242,5469,4526,5249,3004,994,1803,951,690,67,53,570,261,169,45,124,0,92,62,12,18,852,663,146,65,452,189,123,89,18,16,66,0,11,55,90680
30146,11021,2351,2746,3176,1979,769,1021,522,384,20,9,355,138,105,47,22,36,33,33,0,0,499,445,67,2,376,54,40,15,18,7,14,14,0,0,90701
30147,34906,2458,5719,9820,10916,5993,2867,1402,1318,101,91,1126,84,62,17,6,39,22,0,3,19,1465,1426,132,26,1268,39,39,20,19,0,0,0,0,0,90703
30148,2476,624,643,700,296,213,273,98,85,43,0,42,13,0,0,0,0,13,12,0,1,175,141,30,34,77,34,34,22,0,12,0,0,0,0,90704
30149,46700,10251,13727,15251,5802,1669,4651,2500,2175,234,263,1678,325,226,63,93,70,99,47,4,48,2151,1941,208,54,1679,210,134,19,65,50,76,26,0,50,90706
30150,17573,3461,4144,5468,3081,1419,1362,675,578,108,100,370,97,41,37,0,4,56,37,12,7,687,670,90,76,504,17,5,0,0,5,12,0,0,12,90710
30151,20999,2272,5157,7511,4213,1846,1848,1016,820,104,71,645,196,107,64,0,43,89,0,16,73,832,769,184,105,480,63,38,38,0,0,25,0,0,25,90712
30152,18563,1860,4241,7270,3589,1603,1509,832,791,107,71,613,41,29,29,0,0,12,12,0,0,677,621,123,60,438,56,56,14,42,0,0,0,0,0,90713
30153,13472,2523,2982,4615,2676,676,1116,613,551,55,28,468,62,16,7,0,9,46,0,8,38,503,457,66,9,382,46,36,8,13,15,10,0,0,10,90715
30154,8517,3763,2069,1718,826,141,897,373,288,61,27,200,85,15,4,11,0,70,41,0,29,524,319,17,15,287,205,137,57,0,80,68,0,17,51,90716
30155,14820,2071,3775,5059,2758,1157,1024,492,452,143,4,305,40,40,38,2,0,0,0,0,0,532,477,58,44,375,55,45,11,0,34,10,0,10,0,90717
30156,15013,769,2531,4554,4503,2656,1457,776,688,97,34,557,88,81,58,6,17,7,0,0,7,681,648,107,42,499,33,33,8,25,0,0,0,0,0,90720
30157,30484,13118,8333,6631,1877,525,4712,2305,1919,130,142,1647,386,331,142,35,154,55,18,28,9,2407,2075,278,81,1716,332,236,117,94,25,96,45,7,44,90723
30158,40129,9581,10027,12008,6098,2415,3331,1597,1389,144,322,923,208,81,40,25,16,127,80,29,18,1734,1550,181,253,1116,184,153,12,91,50,31,6,18,7,90731
30159,14942,1376,2891,5722,3207,1746,647,310,300,70,10,220,10,0,0,0,0,10,0,10,0,337,310,152,23,135,27,27,27,0,0,0,0,0,0,90732
30160,19803,1228,3265,6637,4983,3690,609,300,280,21,14,245,20,20,15,0,5,0,0,0,0,309,286,102,10,174,23,23,23,0,0,0,0,0,0,90740
30161,776,38,148,191,266,133,45,5,5,0,0,5,0,0,0,0,0,0,0,0,0,40,40,0,19,21,0,0,0,0,0,0,0,0,0,90742
30162,364,0,135,42,74,113,11,0,0,0,0,0,0,0,0,0,0,0,0,0,0,11,11,0,0,11,0,0,0,0,0,0,0,0,0,90743
30163,31311,13533,9284,6322,1852,320,4707,2400,2068,330,457,1281,332,193,37,95,61,139,77,13,49,2307,1892,258,211,1423,415,253,86,87,80,162,41,53,68,90744
30164,37746,8459,8612,12150,6962,1563,3700,1747,1471,99,88,1284,276,144,73,30,41,132,41,64,27,1953,1681,103,173,1405,272,174,53,47,74,98,9,69,20,90745
30165,18738,2389,4009,6947,3634,1759,1332,808,739,102,73,564,69,69,56,0,13,0,0,0,0,524,447,88,96,263,77,61,14,35,12,16,0,0,16,90746
30166,0,0,0,0,0,0,0,0,0,0,0,0,0,0,0,0,0,0,0,0,0,0,0,0,0,0,0,0,0,0,0,0,0,0,0,90747
30167,7298,1069,1529,2083,1729,888,789,357,298,80,97,121,59,9,0,0,9,50,0,0,50,432,418,48,68,302,14,3,0,0,3,11,0,0,11,90755
30168,28744,4498,4787,9493,6165,3801,1155,546,517,42,31,444,29,29,18,5,6,0,0,0,0,609,537,38,100,399,72,54,39,0,15,18,0,0,18,90802
30169,24686,716,2349,6908,8356,6357,601,298,226,10,35,181,72,31,31,0,0,41,0,41,0,303,303,31,0,272,0,0,0,0,0,0,0,0,0,90803
30170,24712,5634,4533,8106,4444,1995,2544,1332,1144,95,114,935,188,115,99,0,16,73,0,44,29,1212,1110,108,74,928,102,65,13,32,20,37,0,14,23,90804
30171,53880,17454,13030,17059,5167,1170,6826,3510,2909,265,540,2104,601,418,127,111,180,183,63,57,63,3316,2944,332,324,2288,372,190,104,35,51,182,24,76,82,90805
30172,24890,7657,5218,7683,2951,1381,3576,1719,1351,121,164,1066,368,148,84,54,10,220,79,27,114,1857,1538,154,211,1173,319,182,104,18,60,137,0,0,137,90806
30173,23348,2203,4262,8080,5555,3248,1455,670,642,101,21,520,28,0,0,0,0,28,0,14,14,785,755,37,134,584,30,22,0,7,15,8,8,0,0,90807
30174,27865,1473,4589,11182,6252,4369,2103,1092,972,277,138,557,120,102,80,15,7,18,0,0,18,1011,894,141,37,716,117,117,49,23,45,0,0,0,0,90808
30175,21974,6148,5400,7073,2891,462,2401,1181,833,145,55,633,348,135,74,14,47,213,19,59,135,1220,970,90,126,754,250,125,8,77,40,125,37,35,53,90810
30176,32744,14796,7163,7745,2187,853,4163,2113,1683,105,256,1322,430,186,42,98,46,244,91,101,52,2050,1779,298,197,1284,271,104,51,22,31,167,22,34,111,90813
30177,14344,1007,1703,4431,4513,2690,863,428,373,72,0,301,55,53,0,53,0,2,0,0,2,435,403,94,64,245,32,32,0,0,32,0,0,0,0,90814
30178,26404,1347,3979,9727,7172,4179,3348,1678,1648,457,138,1053,30,30,19,11,0,0,0,0,0,1670,1647,404,157,1086,23,23,17,0,6,0,0,0,0,90815
30179,154,31,36,56,19,12,2,0,0,0,0,0,0,0,0,0,0,0,0,0,0,2,2,2,0,0,0,0,0,0,0,0,0,0,0,90822
30180,0,0,0,0,0,0,0,0,0,0,0,0,0,0,0,0,0,0,0,0,0,0,0,0,0,0,0,0,0,0,0,0,0,0,0,90831
30181,26101,3229,3451,7812,6452,5157,2168,1153,1032,210,38,784,121,121,34,10,77,0,0,0,0,1015,956,90,70,796,59,59,8,17,34,0,0,0,0,91001
30182,22407,2143,3202,6037,6284,4741,1727,880,861,77,23,761,19,10,8,0,2,9,8,0,1,847,819,81,39,699,28,28,15,0,13,0,0,0,0,91006
30183,24116,2429,4086,5527,7745,4329,1516,807,796,37,30,729,11,0,0,0,0,11,0,0,11,709,707,44,23,640,2,2,0,0,2,0,0,0,0,91007
30184,980,79,101,314,270,216,61,28,28,1,0,27,0,0,0,0,0,0,0,0,0,33,31,6,9,16,2,2,2,0,0,0,0,0,0,91008
30185,17289,3623,4700,4686,2822,1458,1140,522,386,55,19,312,136,132,90,42,0,4,0,0,4,618,592,69,27,496,26,26,19,1,6,0,0,0,0,91010
30186,13308,256,822,2220,5297,4713,1397,768,758,27,15,716,10,10,0,0,10,0,0,0,0,629,618,104,39,475,11,0,0,0,0,11,0,0,11,91011
30187,28622,3534,6429,8932,6148,3579,2091,1030,918,222,45,651,112,76,59,9,8,36,0,23,13,1061,970,169,30,771,91,91,56,5,30,0,0,0,0,91016
30188,5953,604,964,1994,1684,707,351,185,185,30,0,155,0,0,0,0,0,0,0,0,0,166,153,42,9,102,13,13,0,0,13,0,0,0,0,91020
30189,8461,269,752,2438,2583,2419,284,178,169,10,20,139,9,9,0,9,0,0,0,0,0,106,106,12,0,94,0,0,0,0,0,0,0,0,0,91024
30190,18161,676,1556,4494,6039,5396,1057,562,552,47,91,414,10,10,0,10,0,0,0,0,0,495,495,61,11,423,0,0,0,0,0,0,0,0,0,91030
30191,14418,1944,3390,4848,2943,1293,759,335,312,28,0,284,23,10,4,0,6,13,0,9,4,424,364,123,20,221,60,28,0,0,28,32,0,0,32,91040
30192,20879,3463,5108,7131,3298,1879,1274,720,654,62,16,576,66,38,31,7,0,28,28,0,0,554,546,169,32,345,8,0,0,0,0,8,0,0,8,91042
30193,176,89,61,26,0,0,0,0,0,0,0,0,0,0,0,0,0,0,0,0,0,0,0,0,0,0,0,0,0,0,0,0,0,0,0,91046
30194,16122,1844,1650,2919,5297,4412,877,465,397,0,104,293,68,17,0,17,0,51,0,51,0,412,277,7,97,173,135,118,81,37,0,17,0,0,17,91101
30195,17969,4804,3173,4613,2869,2510,1834,1103,890,287,90,513,213,67,36,0,31,146,57,26,63,731,684,54,86,544,47,47,26,5,16,0,0,0,0,91103
30196,26515,4828,4528,6862,6047,4250,1952,956,828,137,81,610,128,79,66,0,13,49,25,6,18,996,923,95,51,777,73,36,10,0,26,37,21,0,16,91104
30197,9435,281,691,1681,3375,3407,293,90,83,14,0,69,7,7,0,0,7,0,0,0,0,203,203,52,0,151,0,0,0,0,0,0,0,0,0,91105
30198,17413,1727,1642,4570,4842,4632,1152,601,556,71,53,432,45,0,0,0,0,45,0,14,31,551,503,116,31,356,48,48,0,0,48,0,0,0,0,91106
30199,24169,2051,3591,6172,7466,4889,1083,556,555,145,37,373,1,1,0,0,1,0,0,0,0,527,488,41,62,385,39,21,0,0,21,18,9,0,9,91107
30200,9530,488,586,1497,3540,3419,564,305,305,24,0,281,0,0,0,0,0,0,0,0,0,259,259,32,9,218,0,0,0,0,0,0,0,0,0,91108
30201,17094,3302,3237,5300,3918,1337,917,477,427,101,17,309,50,50,22,0,28,0,0,0,0,440,425,73,14,338,15,15,0,0,15,0,0,0,0,91201
30202,17099,2141,3380,4138,4927,2513,736,323,291,19,49,223,32,17,4,0,13,15,0,0,15,413,375,59,33,283,38,38,38,0,0,0,0,0,0,91202
30203,9493,1610,2121,2729,2295,738,630,246,203,33,11,159,43,43,0,20,23,0,0,0,0,384,357,108,37,212,27,7,0,0,7,20,0,0,20,91203
30204,11436,2820,2303,3344,2330,639,718,425,409,117,0,292,16,16,0,16,0,0,0,0,0,293,293,51,13,229,0,0,0,0,0,0,0,0,0,91204
30205,26842,6143,5925,6968,5697,2109,1891,993,879,104,88,687,114,84,34,26,24,30,0,0,30,898,826,140,32,654,72,72,36,0,36,0,0,0,0,91205
30206,25203,3607,4192,6547,7399,3458,1250,612,587,55,12,520,25,25,0,0,25,0,0,0,0,638,607,151,25,431,31,31,0,0,31,0,0,0,0,91206
30207,8063,619,1080,2246,2381,1737,467,276,276,133,0,143,0,0,0,0,0,0,0,0,0,191,191,30,0,161,0,0,0,0,0,0,0,0,0,91207
30208,11275,534,1766,3176,3652,2147,879,561,513,57,40,416,48,39,8,0,31,9,0,9,0,318,318,59,14,245,0,0,0,0,0,0,0,0,0,91208
30209,328,0,36,139,98,55,7,7,7,0,0,7,0,0,0,0,0,0,0,0,0,0,0,0,0,0,0,0,0,0,0,0,0,0,0,91210
30210,21254,1141,3375,5849,6917,3972,2203,1183,1162,123,68,971,21,19,19,0,0,2,0,0,2,1020,992,227,45,720,28,28,14,1,13,0,0,0,0,91214
30211,18432,793,2517,5202,5774,4146,1473,745,719,80,32,607,26,26,6,0,20,0,0,0,0,728,646,164,83,399,82,56,42,14,0,26,26,0,0,91301
30212,16903,389,1934,4043,5455,5082,1692,856,794,126,12,656,62,41,19,11,11,21,0,0,21,836,771,162,11,598,65,65,3,11,51,0,0,0,0,91302
30213,16881,4933,3640,4332,2892,1084,1344,766,533,114,50,369,233,124,36,50,38,109,84,25,0,578,415,57,6,352,163,115,63,33,19,48,0,0,48,91303
30214,34885,6759,7720,10684,6377,3345,2950,1507,1334,157,200,977,173,101,63,10,28,72,13,16,43,1443,1279,189,15,1075,164,119,78,15,26,45,0,10,35,91304
30215,31722,8107,7733,8547,5370,1965,2563,1450,1252,110,128,1014,198,149,143,0,6,49,39,0,10,1113,954,93,69,792,159,66,66,0,0,93,4,0,89,91306
30216,17853,931,3199,5345,5117,3261,1600,890,822,115,41,666,68,52,22,6,24,16,0,0,16,710,708,73,37,598,2,2,2,0,0,0,0,0,0,91307
30217,27426,2588,5313,8596,7166,3763,2084,1199,1159,137,34,988,40,16,0,16,0,24,0,12,12,885,791,204,18,569,94,28,28,0,0,66,0,0,66,91311
30218,21347,1287,3639,5853,6893,3675,914,545,533,122,41,370,12,12,0,12,0,0,0,0,0,369,276,33,0,243,93,93,83,0,10,0,0,0,0,91316
30219,29443,2232,4307,8901,8214,5789,2506,1294,1196,228,154,814,98,86,59,19,8,12,0,0,12,1212,1101,419,96,586,111,111,33,63,15,0,0,0,0,91320
30220,21992,5135,4044,7706,3570,1537,2183,1186,1033,237,155,641,153,79,39,27,13,74,73,0,1,997,903,223,121,559,94,39,17,22,0,55,0,0,55,91321
30221,17314,2570,3522,5043,4232,1947,1983,1228,1028,221,168,639,200,113,9,39,65,87,1,26,60,755,715,197,42,476,40,24,0,0,24,16,0,0,16,91324
30222,21335,2439,3976,6804,5323,2793,2363,1280,1045,127,71,847,235,182,110,72,0,53,0,20,33,1083,1074,228,140,706,9,5,0,0,5,4,0,0,4,91325
30223,25351,1422,3870,6539,8986,4534,1876,920,865,98,55,712,55,49,28,14,7,6,0,0,6,956,949,235,43,671,7,7,0,7,0,0,0,0,0,91326
30224,247,7,0,105,95,40,1131,426,426,107,66,253,0,0,0,0,0,0,0,0,0,705,705,169,115,421,0,0,0,0,0,0,0,0,0,91330
30225,59394,29327,15042,10096,3645,1284,6961,3703,2932,226,397,2309,771,572,343,123,106,199,61,74,64,3258,2785,339,360,2086,473,315,94,53,168,158,11,10,137,91331
30226,49747,12591,12707,13227,8112,3110,4286,2135,1756,276,107,1373,379,204,32,79,93,175,29,80,66,2151,1932,227,85,1620,219,81,33,0,48,138,0,72,66,91335
30227,20866,9045,5714,3986,1515,606,1943,1183,1032,277,111,644,151,95,89,6,0,56,22,13,21,760,716,58,53,605,44,24,16,0,8,20,0,0,20,91340
30228,54574,18072,13250,13901,6881,2470,6578,3719,3231,341,187,2703,488,326,239,33,54,162,40,42,80,2859,2497,345,299,1853,362,198,60,42,96,164,65,0,99,91342
30229,38536,11094,8621,10002,6446,2373,3476,1822,1531,266,170,1095,291,159,84,37,38,132,96,0,36,1654,1464,127,134,1203,190,79,42,0,37,111,0,50,61,91343
30230,36675,3942,8765,11308,8517,4143,3006,1619,1495,131,221,1143,124,83,50,0,33,41,5,0,36,1387,1337,204,101,1032,50,39,26,0,13,11,11,0,0,91344
30231,12464,3048,3493,3408,1842,673,694,266,227,22,21,184,39,26,26,0,0,13,13,0,0,428,396,69,38,289,32,21,11,0,10,11,0,0,11,91345
30232,22670,1712,4333,8779,5519,2327,2425,1500,1412,311,234,867,88,88,27,13,48,0,0,0,0,925,911,284,64,563,14,14,14,0,0,0,0,0,0,91350
30233,20438,3520,5044,7308,3246,1320,1745,955,871,234,142,495,84,63,21,38,4,21,0,0,21,790,727,227,74,426,63,51,26,0,25,12,12,0,0,91351
30234,28978,10362,7406,7030,3081,1099,3097,1528,1311,99,158,1054,217,66,14,27,25,151,34,0,117,1569,1417,244,190,983,152,92,34,12,46,60,28,0,32,91352
30235,18533,460,2577,6218,6232,3046,1871,928,839,161,72,606,89,79,5,0,74,10,0,0,10,943,857,244,91,522,86,81,56,12,13,5,0,5,0,91354
30236,22029,1566,3314,8015,6049,3085,1778,781,733,150,85,498,48,29,29,0,0,19,0,0,19,997,928,226,57,645,69,69,52,0,17,0,0,0,0,91355
30237,21651,1564,4005,6192,6631,3259,1127,598,598,33,79,486,0,0,0,0,0,0,0,0,0,529,529,43,27,459,0,0,0,0,0,0,0,0,0,91356
30238,29687,3095,5351,9183,7145,4913,2833,1348,1223,251,123,849,125,114,51,0,63,11,0,11,0,1485,1390,448,114,828,95,95,29,22,44,0,0,0,0,91360
30239,14873,455,1882,3756,4994,3786,1028,478,447,109,24,314,31,21,21,0,0,10,0,10,0,550,517,198,20,299,33,33,0,12,21,0,0,0,0,91361
30240,24317,1267,3204,6866,7574,5406,2130,1106,1080,209,150,721,26,4,0,4,0,22,0,0,22,1024,981,181,79,721,43,43,22,0,21,0,0,0,0,91362
30241,18926,701,3350,5009,6032,3834,986,516,507,19,15,473,9,9,0,9,0,0,0,0,0,470,456,115,27,314,14,14,10,4,0,0,0,0,0,91364
30242,29244,1239,3985,8679,9968,5373,1787,1005,922,175,55,692,83,80,28,3,49,3,3,0,0,782,668,168,47,453,114,72,0,49,23,42,0,0,42,91367
30243,0,0,0,0,0,0,0,0,0,0,0,0,0,0,0,0,0,0,0,0,0,0,0,0,0,0,0,0,0,0,0,0,0,0,0,91371
30244,9460,254,854,2441,3460,2451,1037,534,521,97,0,424,13,13,0,13,0,0,0,0,0,503,469,141,130,198,34,34,34,0,0,0,0,0,0,91377
30245,11823,559,1611,3220,3868,2565,1478,746,670,107,98,465,76,40,14,0,26,36,0,0,36,732,652,230,9,413,80,47,47,0,0,33,0,0,33,91381
30246,17995,3456,3529,6620,3267,1123,2244,1486,982,290,118,574,504,134,30,0,104,370,0,0,370,758,699,206,75,418,59,45,5,0,40,14,0,0,14,91384
30247,25988,3099,4898,10399,5132,2460,2402,1395,1197,270,102,825,198,163,38,60,65,35,0,0,35,1007,950,156,120,674,57,51,41,0,10,6,0,0,6,91387
30248,13275,784,3049,4668,3403,1371,1273,830,749,175,106,468,81,58,21,0,37,23,0,0,23,443,390,129,11,250,53,26,26,0,0,27,0,27,0,91390
30249,27116,5997,5275,7478,5824,2542,2071,994,836,122,95,619,158,132,70,19,43,26,26,0,0,1077,959,201,62,696,118,84,21,15,48,34,0,22,12,91401
30250,42193,16818,10134,8602,5563,1076,4696,2484,2193,205,376,1612,291,156,29,70,57,135,43,37,55,2212,1917,283,125,1509,295,229,88,10,131,66,0,23,43,91402
30251,18673,452,2302,4888,6905,4126,337,105,87,10,0,77,18,7,0,0,7,11,0,0,11,232,225,111,0,114,7,7,7,0,0,0,0,0,0,91403
30252,33895,10939,7907,8363,4823,1863,3276,1839,1476,180,120,1176,363,220,173,1,46,143,122,21,0,1437,1156,143,48,965,281,225,94,64,67,56,0,38,18,91405
30253,34191,8216,8818,9446,5473,2238,2957,1617,1340,211,107,1022,277,230,150,30,50,47,42,5,0,1340,1071,123,82,866,269,235,69,0,166,34,0,23,11,91406
30254,16835,4195,3173,4437,3822,1208,1095,564,419,50,70,299,145,68,60,0,8,77,61,7,9,531,452,22,49,381,79,51,16,0,35,28,0,18,10,91411
30255,23915,1053,2645,7094,8509,4614,760,363,314,58,12,244,49,49,49,0,0,0,0,0,0,397,323,22,67,234,74,53,0,13,40,21,0,21,0,91423
30256,10496,433,1006,2579,3356,3122,657,265,265,29,10,226,0,0,0,0,0,0,0,0,0,392,373,17,51,305,19,19,0,8,11,0,0,0,0,91436
30257,14869,1514,3165,4702,3921,1567,845,522,405,30,20,355,117,36,36,0,0,81,42,0,39,323,311,56,20,235,12,12,0,12,0,0,0,0,0,91501
30258,8586,2169,1577,2317,1913,610,616,312,240,38,88,114,72,72,8,0,64,0,0,0,0,304,261,66,0,195,43,43,20,0,23,0,0,0,0,91502
30259,17906,2442,3199,5542,4535,2188,1260,528,467,30,15,422,61,32,7,16,9,29,0,11,18,732,650,170,38,442,82,82,34,23,25,0,0,0,0,91504
30260,22714,1936,3800,7840,6551,2587,1181,727,612,85,60,467,115,106,45,15,46,9,0,0,9,454,431,123,29,279,23,16,6,10,0,7,0,0,7,91505
30261,13402,1274,2207,4802,3750,1369,706,404,351,0,0,351,53,48,8,17,23,5,0,0,5,302,302,33,0,269,0,0,0,0,0,0,0,0,0,91506
30262,26520,4760,4502,7536,7157,2565,1527,808,632,28,91,513,176,111,81,30,0,65,9,48,8,719,620,23,135,462,99,69,27,0,42,30,0,25,5,91601
30263,14226,652,1807,3814,5948,2005,452,223,223,23,14,186,0,0,0,0,0,0,0,0,0,229,222,41,50,131,7,7,0,7,0,0,0,0,0,91602
30264,22419,729,2679,5621,8561,4829,642,315,261,53,0,208,54,54,9,45,0,0,0,0,0,327,252,57,21,174,75,75,13,43,19,0,0,0,0,91604
30265,35209,12536,8005,8585,4741,1342,3591,2024,1683,264,133,1286,341,156,68,53,35,185,138,21,26,1567,1360,159,90,1111,207,146,42,23,81,61,39,0,22,91605
30266,29950,8795,7067,7564,5061,1463,2796,1376,1204,84,116,1004,172,112,33,20,59,60,21,34,5,1420,1166,223,163,780,254,177,46,28,103,77,29,7,41,91606
30267,21426,1765,3393,6522,6883,2863,721,410,393,23,0,370,17,17,17,0,0,0,0,0,0,311,291,30,1,260,20,20,8,0,12,0,0,0,0,91607
30268,0,0,0,0,0,0,0,0,0,0,0,0,0,0,0,0,0,0,0,0,0,0,0,0,0,0,0,0,0,0,0,0,0,0,0,91608
30269,27073,2068,6172,10696,5630,2507,2331,1331,1218,279,297,642,113,112,15,39,58,1,0,0,1,1000,892,237,68,587,108,108,51,6,51,0,0,0,0,91701
30270,33041,8934,10284,8341,3825,1657,6311,3092,2554,432,138,1984,538,337,176,42,119,201,136,34,31,3219,3034,672,263,2099,185,159,33,46,80,26,5,16,5,91702
30271,46215,19205,13023,8775,4045,1167,5568,2854,2310,236,206,1868,544,380,176,96,108,164,33,35,96,2714,2459,344,218,1897,255,213,56,52,105,42,0,13,29,91706
30272,2760,666,514,1023,355,202,155,65,65,9,0,56,0,0,0,0,0,0,0,0,0,90,76,6,0,70,14,14,14,0,0,0,0,0,0,91708
30273,47429,3790,8048,15060,13680,6851,4685,2655,2379,229,246,1904,276,181,41,86,54,95,54,5,36,2030,1897,419,222,1256,133,100,0,84,16,33,7,0,26,91709
30274,52555,11050,13097,16926,8568,2914,5079,2712,2262,306,320,1636,450,253,98,34,121,197,37,10,150,2367,2172,414,285,1473,195,164,118,10,36,31,0,0,31,91710
30275,22439,1591,2310,6114,5965,6459,4113,1730,1680,339,76,1265,50,49,45,0,4,1,0,0,1,2383,2368,599,171,1598,15,3,0,3,0,12,12,0,0,91711
30276,22880,4756,6527,7357,3000,1240,2152,1108,1003,122,124,757,105,83,46,37,0,22,4,0,18,1044,878,189,75,614,166,130,39,51,40,36,12,0,24,91722
30277,12339,1767,3045,4874,1909,744,1406,687,628,136,29,463,59,36,32,4,0,23,0,13,10,719,652,112,61,479,67,67,0,67,0,0,0,0,0,91723
30278,16280,1852,3934,6158,3058,1278,1573,855,737,103,102,532,118,85,39,46,0,33,0,0,33,718,672,118,117,437,46,21,21,0,0,25,0,0,25,91724
30279,42574,5177,9035,16499,7860,4003,4322,2227,1979,122,243,1614,248,157,11,75,71,91,18,0,73,2095,1990,545,156,1289,105,70,12,0,58,35,0,16,19,91730
30280,19518,8222,5393,3552,1940,411,1726,979,752,44,74,634,227,87,31,17,39,140,9,67,64,747,689,44,52,593,58,30,22,0,8,28,28,0,0,91731
30281,39059,15921,10923,7313,4030,872,4051,2062,1688,48,158,1482,374,221,114,58,49,153,47,28,78,1989,1735,101,143,1491,254,154,85,30,39,100,23,19,58,91732
30282,27194,13977,6819,3873,2064,461,2640,1341,988,56,48,884,353,219,98,10,111,134,37,22,75,1299,1109,47,41,1021,190,99,43,7,49,91,0,0,91,91733
30283,15638,627,2893,6558,3764,1796,1831,847,778,63,67,648,69,69,55,14,0,0,0,0,0,984,911,248,126,537,73,55,0,35,20,18,0,0,18,91737
30284,23006,2016,3975,8160,4773,4082,2367,1147,1051,157,112,782,96,96,41,43,12,0,0,0,0,1220,1155,157,88,910,65,65,7,39,19,0,0,0,0,91739
30285,17529,2313,4211,6863,2816,1326,1481,845,728,68,63,597,117,104,33,45,26,13,0,2,11,636,539,84,132,323,97,97,54,0,43,0,0,0,0,91740
30286,16651,943,2729,6634,3700,2645,1632,982,868,51,97,720,114,114,53,14,47,0,0,0,0,650,586,164,23,399,64,0,0,0,0,64,0,0,64,91741
30287,50473,19954,14916,10583,3819,1201,6382,3275,2647,202,189,2256,628,309,129,72,108,319,84,101,134,3107,2497,251,159,2087,610,439,67,97,275,171,48,20,103,91744
30288,38643,5832,8819,10407,9586,3999,2562,1194,1028,8,40,980,166,116,0,14,102,50,0,13,37,1368,1229,165,69,995,139,139,68,4,67,0,0,0,0,91745
30289,18038,6836,5527,4098,1089,488,1988,981,766,30,51,685,215,157,71,50,36,58,6,31,21,1007,953,104,75,774,54,54,40,14,0,0,0,0,0,91746
30290,33381,4976,7081,9105,9269,2950,2622,1299,1153,117,13,1023,146,76,42,0,34,70,60,0,10,1323,1269,153,46,1070,54,22,0,7,15,32,0,0,32,91748
30291,22869,1965,4248,8492,5069,3095,2172,1232,1158,208,90,860,74,42,32,0,10,32,12,0,20,940,895,194,71,630,45,45,3,34,8,0,0,0,0,91750
30292,18532,4763,4798,5427,2488,1056,2164,880,727,53,4,670,153,67,18,24,25,86,9,58,19,1284,1066,124,116,826,218,142,42,80,20,76,58,0,18,91752
30293,23831,4854,5649,6124,4768,2436,1280,658,589,36,15,538,69,34,8,26,0,35,0,0,35,622,575,36,58,481,47,29,15,13,1,18,0,0,18,91754
30294,20514,5419,5039,4706,3834,1516,1082,589,530,24,29,477,59,54,34,0,20,5,0,5,0,493,471,21,21,429,22,1,0,0,1,21,0,0,21,91755
30295,271,7,41,80,78,65,7,7,7,4,0,3,0,0,0,0,0,0,0,0,0,0,0,0,0,0,0,0,0,0,0,0,0,0,0,91759
30296,34933,9819,9178,10888,4009,1039,5252,2542,2036,167,216,1653,506,349,255,36,58,157,30,35,92,2710,2396,646,212,1538,314,259,57,76,126,55,5,0,50,91761
30297,33845,10461,9729,9708,2716,1231,4063,1918,1681,147,322,1212,237,184,20,98,66,53,14,9,30,2145,1556,137,232,1187,589,500,302,40,158,89,21,0,68,91762
30298,22993,6963,6891,6360,2248,531,2356,1446,1119,39,93,987,327,189,127,41,21,138,65,16,57,910,815,42,73,700,95,73,53,10,10,22,0,0,22,91763
30299,31303,10232,8653,8483,2944,991,3499,1503,1263,99,257,907,240,240,116,94,30,0,0,0,0,1996,1638,358,108,1172,358,256,90,23,143,102,8,65,29,91764
30300,33078,2655,5499,8897,10341,5686,2946,1662,1585,226,85,1274,77,65,0,0,65,12,0,12,0,1284,1229,233,48,948,55,0,0,0,0,55,27,0,28,91765
30301,40274,14772,9662,9367,4731,1742,4975,2396,1857,293,155,1409,539,306,187,53,66,233,60,23,150,2579,2077,261,195,1621,502,287,97,65,125,215,39,92,84,91766
30302,29065,8779,6959,8485,3322,1520,3382,1835,1353,177,136,1040,482,357,162,73,122,125,18,57,50,1547,1324,231,147,946,223,127,30,0,97,96,0,14,82,91767
30303,19675,6740,5215,4623,2172,925,4219,2025,1835,191,92,1552,190,95,59,0,36,95,0,7,88,2194,2072,442,145,1485,122,85,47,0,38,37,4,21,12,91768
30304,44080,15395,11412,10435,5108,1730,3212,1624,1480,85,87,1308,144,116,31,17,68,28,28,0,0,1588,1471,95,78,1298,117,53,2,22,29,64,0,0,64,91770
30305,23221,1793,4885,8555,5025,2963,2132,1298,1102,94,125,883,196,154,35,65,54,42,42,0,0,834,793,138,43,612,41,41,21,0,20,0,0,0,0,91773
30306,18064,1915,3315,4776,5040,3018,1127,656,597,6,25,566,59,16,9,7,0,43,18,0,25,471,447,93,14,340,24,0,0,0,0,24,0,0,24,91775
30307,27387,7209,7265,6253,4897,1763,1727,973,858,60,40,758,115,62,42,0,20,53,47,0,6,754,676,49,35,592,78,62,55,0,7,16,0,7,9,91776
30308,24676,3493,4896,7295,5965,3027,1999,1261,1180,58,24,1098,81,33,13,0,20,48,1,0,47,738,726,106,34,586,12,12,0,7,5,0,0,0,0,91780
30309,18350,1113,3017,6767,4427,3026,1755,979,923,112,122,689,56,56,31,12,13,0,0,0,0,776,743,234,34,475,33,33,28,0,5,0,0,0,0,91784
30310,32617,5207,7638,11621,5463,2688,2863,1298,1049,79,194,776,249,206,14,48,144,43,0,0,43,1565,1362,88,141,1133,203,191,79,0,112,12,12,0,0,91786
30311,29239,2201,4190,8218,10006,4624,2739,1434,1374,141,45,1188,60,57,34,5,18,3,0,0,3,1305,1240,167,69,1004,65,56,56,0,0,9,0,0,9,91789
30312,29002,5857,7767,9086,4849,1443,2928,1433,1283,132,289,862,150,79,38,34,7,71,0,18,53,1495,1281,178,156,947,214,127,9,46,72,87,78,0,9,91790
30313,21058,2939,4663,7172,4407,1877,2147,1060,938,167,101,670,122,98,27,71,0,24,14,0,10,1087,1026,81,195,750,61,50,30,8,12,11,11,0,0,91791
30314,20268,3107,4210,6210,5379,1362,1626,921,796,147,79,570,125,102,17,32,53,23,16,0,7,705,604,104,76,424,101,101,30,49,22,0,0,0,0,91792
30315,39026,7559,7673,10323,8889,4582,2566,1209,1018,105,93,820,191,165,89,0,76,26,0,8,18,1357,1146,183,48,915,211,137,50,0,87,74,0,0,74,91801
30316,21565,4310,4768,6111,4329,2047,1288,716,669,71,13,585,47,42,0,0,42,5,0,0,5,572,547,144,55,348,25,18,7,11,0,7,7,0,0,91803
30317,11866,1037,3007,4477,2083,1262,1145,690,607,203,91,313,83,53,32,0,21,30,0,17,13,455,428,122,25,281,27,27,24,0,3,0,0,0,0,91901
30318,13312,1263,2421,4500,3011,2117,1050,587,565,93,139,333,22,0,0,0,0,22,0,0,22,463,406,25,65,316,57,57,0,0,57,0,0,0,0,91902
30319,764,145,214,374,11,20,15,0,0,0,0,0,0,0,0,0,0,0,0,0,0,15,15,0,0,15,0,0,0,0,0,0,0,0,0,91905
30320,2447,421,735,859,293,139,419,317,244,0,0,244,73,31,28,0,3,42,0,0,42,102,80,0,0,80,22,22,22,0,0,0,0,0,0,91906
30321,50386,9428,11379,17563,7835,4181,4486,2505,2104,258,312,1534,401,296,162,85,49,105,13,78,14,1981,1672,193,146,1333,309,260,120,67,73,49,8,0,41,91910
30322,50176,14706,11796,16391,5052,2231,6063,3251,2784,234,357,2193,467,301,126,81,94,166,20,93,53,2812,2406,348,354,1704,406,313,195,77,41,93,19,18,56,91911
30323,24570,2480,3735,8991,6450,2914,2543,1141,1041,160,127,754,100,52,52,0,0,48,0,0,48,1402,1290,156,61,1073,112,112,37,22,53,0,0,0,0,91913
30324,10567,795,1470,3531,2773,1998,969,507,460,99,26,335,47,13,13,0,0,34,0,0,34,462,462,81,102,279,0,0,0,0,0,0,0,0,0,91914
30325,15221,1156,2016,5284,4920,1845,2308,1168,1109,33,44,1032,59,59,14,45,0,0,0,0,0,1140,1140,135,0,1005,0,0,0,0,0,0,0,0,0,91915
30326,1053,131,247,384,214,77,39,22,13,0,0,13,9,9,0,0,9,0,0,0,0,17,17,8,0,9,0,0,0,0,0,0,0,0,0,91916
30327,510,77,132,268,33,0,43,31,0,0,0,0,31,31,0,0,31,0,0,0,0,12,12,0,0,12,0,0,0,0,0,0,0,0,0,91917
30328,283,42,130,78,9,24,0,0,0,0,0,0,0,0,0,0,0,0,0,0,0,0,0,0,0,0,0,0,0,0,0,0,0,0,0,91931
30329,16008,3082,3729,6426,1915,856,1350,835,698,66,49,583,137,109,82,0,27,28,0,21,7,515,454,126,83,245,61,42,31,0,11,19,19,0,0,91932
30330,191,0,41,136,0,14,0,0,0,0,0,0,0,0,0,0,0,0,0,0,0,0,0,0,0,0,0,0,0,0,0,0,0,0,0,91934
30331,5583,618,1685,1748,799,733,458,211,179,17,0,162,32,18,18,0,0,14,0,0,14,247,198,79,6,113,49,49,9,13,27,0,0,0,0,91935
30332,22575,1490,4159,7571,5355,4000,1459,791,708,183,125,400,83,83,21,62,0,0,0,0,0,668,594,162,58,374,74,61,34,0,27,13,0,0,13,91941
30333,26950,2222,4898,10577,6292,2961,1388,599,486,135,50,301,113,110,47,18,45,3,0,0,3,789,675,172,97,406,114,52,41,11,0,62,0,52,10,91942
30334,16524,3077,4907,6092,1755,693,1858,971,797,38,44,715,174,150,26,69,55,24,17,0,7,887,734,72,103,559,153,153,59,31,63,0,0,0,0,91945
30335,12,0,12,0,0,0,0,0,0,0,0,0,0,0,0,0,0,0,0,0,0,0,0,0,0,0,0,0,0,0,0,0,0,0,0,91948
30336,36574,11062,9900,11109,3604,899,4213,2380,1962,176,74,1712,418,280,198,5,77,138,62,32,44,1833,1539,234,100,1205,294,246,189,6,51,48,26,16,6,91950
30337,1046,26,253,461,176,130,71,56,56,8,24,24,0,0,0,0,0,0,0,0,0,15,15,0,0,15,0,0,0,0,0,0,0,0,0,91962
30338,591,293,98,162,25,13,109,44,12,0,0,12,32,32,0,32,0,0,0,0,0,65,65,0,0,65,0,0,0,0,0,0,0,0,0,91963
30339,37138,6721,9169,14202,4868,2178,3921,1814,1516,224,125,1167,298,181,111,13,57,117,39,18,60,2107,1767,379,138,1250,340,281,161,57,63,59,14,33,12,91977
30340,6311,558,1519,2537,1083,614,616,387,361,50,24,287,26,26,7,19,0,0,0,0,0,229,134,14,8,112,95,63,30,0,33,32,0,0,32,91978
30341,157,127,0,30,0,0,0,0,0,0,0,0,0,0,0,0,0,0,0,0,0,0,0,0,0,0,0,0,0,0,0,0,0,0,0,91980
30342,3126,305,557,1000,868,396,264,83,67,38,0,29,16,16,0,0,16,0,0,0,0,181,131,57,0,74,50,30,30,0,0,20,0,20,0,92003
30343,2132,479,615,519,351,168,130,12,0,0,0,0,12,0,0,0,0,12,12,0,0,118,118,0,0,118,0,0,0,0,0,0,0,0,0,92004
30344,8167,536,945,2177,2495,2014,462,310,277,32,32,213,33,33,0,0,33,0,0,0,0,152,113,66,0,47,39,39,17,0,22,0,0,0,0,92007
30345,20265,1371,3533,7498,4766,3097,1016,638,526,31,61,434,112,98,15,82,1,14,0,0,14,378,372,50,19,303,6,6,0,0,6,0,0,0,0,92008
30346,29107,598,2697,8391,10585,6836,1813,1022,966,183,64,719,56,56,11,19,26,0,0,0,0,791,732,183,14,535,59,26,24,0,2,33,0,0,33,92009
30347,9916,485,1307,3434,2649,2041,777,330,296,80,11,205,34,13,0,0,13,21,8,0,13,447,447,60,0,387,0,0,0,0,0,0,0,0,0,92010
30348,16306,545,1847,4606,5364,3944,911,556,522,69,40,413,34,34,0,15,19,0,0,0,0,355,355,120,12,223,0,0,0,0,0,0,0,0,0,92011
30349,10385,175,593,1641,4120,3856,447,172,172,29,18,125,0,0,0,0,0,0,0,0,0,275,275,39,0,236,0,0,0,0,0,0,0,0,0,92014
30350,29697,3573,7726,10356,5399,2643,3097,1676,1407,302,231,874,269,209,95,42,72,60,0,13,47,1421,1305,195,226,884,116,91,31,35,25,25,0,0,25,92019
30351,36473,7800,9519,11213,5128,2813,3390,1583,1392,254,173,965,191,114,59,30,25,77,18,28,31,1807,1548,276,71,1201,259,160,70,64,26,99,32,0,67,92020
30352,41853,7273,12378,15375,4862,1965,3766,1895,1612,231,139,1242,283,251,147,45,59,32,8,9,15,1871,1456,364,92,1000,415,312,233,25,54,103,25,0,78,92021
30353,35674,2277,4300,9335,11494,8268,2104,1113,1004,254,114,636,109,81,61,0,20,28,24,0,4,991,822,338,36,448,169,93,57,0,36,76,0,0,76,92024
30354,29144,9124,5170,8242,4637,1971,3556,1701,1267,224,137,906,434,162,62,33,67,272,49,65,158,1855,1558,414,84,1060,297,87,7,3,77,210,131,0,79,92025
30355,32745,6111,7011,11060,5999,2564,2874,1327,1125,138,72,915,202,156,53,49,54,46,19,27,0,1547,1291,244,48,999,256,227,122,30,75,29,20,0,9,92026
30356,34869,9874,7678,10875,4707,1735,3074,1451,1218,199,114,905,233,184,117,56,11,49,12,0,37,1623,1414,128,158,1128,209,112,16,8,88,97,8,43,46,92027
30357,32828,5267,7245,11819,5818,2679,2193,1077,917,41,49,827,160,109,34,31,44,51,9,22,20,1116,939,172,83,684,177,177,119,5,53,0,0,0,0,92028
30358,14323,1510,2705,5170,3194,1744,1082,524,523,55,18,450,1,0,0,0,0,1,0,0,1,558,510,101,30,379,48,9,9,0,0,39,0,0,39,92029
30359,2176,202,610,568,392,404,41,19,7,7,0,0,12,5,0,0,5,7,0,0,7,22,22,0,0,22,0,0,0,0,0,0,0,0,0,92036
30360,27533,294,1591,4614,9835,11199,3476,1720,1706,373,184,1149,14,14,0,0,14,0,0,0,0,1756,1703,404,118,1181,53,53,53,0,0,0,0,0,0,92037
30361,26751,2909,7720,11081,3289,1752,1855,1006,849,105,88,656,157,157,96,15,46,0,0,0,0,849,702,128,50,524,147,120,98,19,3,27,12,0,15,92040
30362,26213,5047,6040,9492,3794,1840,2313,1395,1168,81,161,926,227,122,86,11,25,105,0,66,39,918,667,118,32,517,251,193,148,30,15,58,42,0,16,92054
30363,1756,0,539,944,273,0,2365,2270,242,242,0,0,2028,2008,1982,17,9,20,19,0,1,95,0,0,0,0,95,95,95,0,0,0,0,0,0,92055
30364,35367,4018,6928,14104,6741,3576,2711,1489,1265,332,184,749,224,150,114,31,5,74,27,0,47,1222,1025,277,58,690,197,197,80,24,93,0,0,0,0,92056
30365,35105,6174,7530,12419,6034,2948,2871,1359,1293,124,159,1010,66,55,43,0,12,11,0,0,11,1512,1314,252,144,918,198,182,102,0,80,16,13,0,3,92057
30366,22874,3235,6022,9059,3257,1301,2653,1597,798,213,31,554,799,736,706,4,26,63,0,63,0,1056,848,208,114,526,208,186,111,4,71,22,0,0,22,92058
30367,836,227,250,230,129,0,82,45,30,0,4,26,15,7,0,0,7,8,0,0,8,37,26,0,4,22,11,5,0,0,5,6,0,0,6,92059
30368,57,0,18,17,22,0,0,0,0,0,0,0,0,0,0,0,0,0,0,0,0,0,0,0,0,0,0,0,0,0,0,0,0,0,0,92060
30369,1429,243,357,393,240,196,152,132,120,0,0,120,12,8,0,6,2,4,0,2,2,20,18,11,0,7,2,2,0,2,0,0,0,0,0,92061
30370,32447,2025,5483,10124,9436,5379,3150,1552,1408,258,114,1036,144,132,66,7,59,12,0,12,0,1598,1449,453,23,973,149,108,54,25,29,41,31,0,10,92064
30371,24270,3894,6011,8738,3768,1859,2436,1411,1249,209,215,825,162,112,54,48,10,50,11,22,17,1025,869,177,46,646,156,108,41,0,67,48,15,33,0,92065
30372,196,36,45,102,7,6,0,0,0,0,0,0,0,0,0,0,0,0,0,0,0,0,0,0,0,0,0,0,0,0,0,0,0,0,0,92066
30373,5751,53,323,843,2028,2504,486,232,232,45,19,168,0,0,0,0,0,0,0,0,0,254,254,24,0,230,0,0,0,0,0,0,0,0,0,92067
30374,29820,7513,6130,9503,4753,1921,2551,1363,1245,217,54,974,118,94,82,9,3,24,19,5,0,1188,1091,320,125,646,97,97,38,6,53,0,0,0,0,92069
30375,760,132,183,356,46,43,63,22,10,6,2,2,12,10,2,8,0,2,2,0,0,41,39,3,2,34,2,2,0,0,2,0,0,0,0,92070
30376,35628,3175,9329,15091,5460,2573,3715,1774,1456,292,80,1084,318,278,48,112,118,40,8,0,32,1941,1750,617,146,987,191,156,57,0,99,35,19,0,16,92071
30377,9537,818,854,2030,3075,2760,517,343,340,58,44,238,3,3,0,0,3,0,0,0,0,174,168,0,18,150,6,6,6,0,0,0,0,0,0,92075
30378,29747,3362,5004,10922,7468,2991,2350,1043,992,147,96,749,51,51,51,0,0,0,0,0,0,1307,1284,279,85,920,23,23,15,0,8,0,0,0,0,92078
30379,19342,1804,3739,7710,4335,1754,1322,654,541,76,19,446,113,109,54,0,55,4,0,0,4,668,543,153,48,342,125,98,89,0,9,27,0,0,27,92081
30380,13686,2260,2983,5069,2370,1004,1224,705,602,111,25,466,103,97,41,53,3,6,0,0,6,519,425,62,20,343,94,94,21,17,56,0,0,0,0,92082
30381,23184,7581,5877,7247,1725,754,2295,1134,800,126,40,634,334,242,157,5,80,92,82,0,10,1161,1025,129,34,862,136,67,45,8,14,69,0,0,69,92083
30382,31230,8050,7382,9544,4322,1932,1947,1049,792,168,67,557,257,126,45,6,75,131,89,0,42,898,797,156,102,539,101,63,11,30,22,38,0,14,24,92084
30383,1121,112,400,426,83,100,34,25,25,0,0,25,0,0,0,0,0,0,0,0,0,9,9,0,0,9,0,0,0,0,0,0,0,0,0,92086
30384,1037,0,109,218,408,302,66,13,13,0,0,13,0,0,0,0,0,0,0,0,0,53,53,53,0,0,0,0,0,0,0,0,0,0,0,92091
30385,29921,2948,3142,8554,9295,5982,1174,887,321,50,0,271,566,528,446,0,82,38,21,0,17,287,221,35,0,186,66,55,0,9,46,11,0,0,11,92101
30386,26886,7851,6973,6755,3419,1888,2588,1442,1156,76,78,1002,286,158,87,3,68,128,1,9,118,1146,1005,173,85,747,141,132,79,17,36,9,0,0,9,92102
30387,26728,1056,2846,6972,9152,6702,322,215,215,0,16,199,0,0,0,0,0,0,0,0,0,107,107,33,6,68,0,0,0,0,0,0,0,0,0,92103
30388,33538,4005,5829,10175,8433,5096,1560,800,705,144,58,503,95,52,19,0,33,43,32,0,11,760,675,94,57,524,85,75,0,19,56,10,0,10,0,92104
30389,38974,13531,9700,10629,3712,1402,5429,2890,2525,159,122,2244,365,290,102,111,77,75,18,0,57,2539,2109,220,88,1801,430,302,80,38,184,128,13,8,107,92105
30390,12794,660,1702,3957,3618,2857,1621,649,501,109,22,370,148,148,97,0,51,0,0,0,0,972,932,211,65,656,40,21,21,0,0,19,0,19,0,92106
30391,19637,466,2902,5996,6130,4143,1205,619,547,64,31,452,72,23,0,23,0,49,49,0,0,586,513,201,16,296,73,50,18,0,32,23,0,0,23,92107
30392,13706,328,1422,4608,4820,2528,496,390,377,25,35,317,13,13,13,0,0,0,0,0,0,106,97,7,0,90,9,9,0,9,0,0,0,0,0,92108
30393,32681,800,3530,8248,13599,6504,960,388,311,88,45,178,77,77,29,48,0,0,0,0,0,572,505,176,89,240,67,67,29,10,28,0,0,0,0,92109
30394,17698,989,3077,5715,5367,2550,2582,1291,1225,164,42,1019,66,20,14,6,0,46,0,0,46,1291,1238,402,86,750,53,53,53,0,0,0,0,0,0,92110
30395,32013,4987,6258,10347,7034,3387,2241,1024,891,147,107,637,133,45,26,19,0,88,66,0,22,1217,1115,244,74,797,102,31,24,0,7,71,0,15,56,92111
30396,29884,13812,7130,6910,1788,244,4478,2564,1716,290,192,1234,848,639,473,103,63,209,77,23,109,1914,1530,131,173,1226,384,229,54,110,65,155,4,17,134,92113
30397,41690,9895,10932,14701,4983,1179,4724,2258,1629,84,119,1426,629,465,149,153,163,164,77,41,46,2466,2200,186,162,1852,266,200,50,7,143,66,8,5,53,92114
30398,33361,6467,6723,11059,5814,3298,6836,3025,2904,473,248,2183,121,98,91,0,7,23,0,15,8,3811,3697,873,161,2663,114,97,84,0,13,17,0,0,17,92115
30399,25122,1769,3561,8210,6983,4599,798,364,316,56,16,244,48,26,9,17,0,22,0,22,0,434,235,73,8,154,199,154,68,19,67,45,0,0,45,92116
30400,38519,4252,7325,13063,8856,5023,2080,1149,1022,128,98,796,127,115,62,0,53,12,0,0,12,931,870,229,124,517,61,41,11,0,30,20,12,0,8,92117
30401,15188,243,1640,4349,4594,4362,974,538,474,43,24,407,64,55,42,0,13,9,0,0,9,436,424,98,15,311,12,12,12,0,0,0,0,0,0,92118
30402,16595,721,2412,5941,4659,2862,1011,475,444,34,46,364,31,31,31,0,0,0,0,0,0,536,402,75,37,290,134,40,19,0,21,94,0,22,72,92119
30403,18443,942,3023,6371,4801,3306,1111,627,589,106,15,468,38,30,17,3,10,8,0,0,8,484,484,146,12,326,0,0,0,0,0,0,0,0,0,92120
30404,2848,56,191,359,1129,1113,136,78,78,4,0,74,0,0,0,0,0,0,0,0,0,58,45,19,0,26,13,13,13,0,0,0,0,0,0,92121
30405,29392,741,2028,5712,9548,11363,1358,640,626,31,44,551,14,14,9,0,5,0,0,0,0,718,718,224,0,494,0,0,0,0,0,0,0,0,0,92122
30406,19194,1453,4253,6778,4364,2346,1267,700,561,88,24,449,139,39,39,0,0,100,18,0,82,567,545,225,40,280,22,8,0,8,0,14,8,0,6,92123
30407,19050,636,2439,6977,5641,3357,1143,571,561,60,85,416,10,10,10,0,0,0,0,0,0,572,551,176,27,348,21,15,15,0,0,6,0,6,0,92124
30408,51222,4377,9358,17151,14136,6200,4212,2579,1846,402,152,1292,733,642,577,27,38,91,42,14,35,1633,1519,416,67,1036,114,104,54,13,37,10,0,0,10,92126
30409,25967,814,2906,5214,9732,7301,1862,1041,993,210,104,679,48,48,37,11,0,0,0,0,0,821,703,91,0,612,118,118,118,0,0,0,0,0,0,92127
30410,35499,1357,4641,9705,11787,8009,1727,949,945,169,26,750,4,4,4,0,0,0,0,0,0,778,750,213,17,520,28,28,6,15,7,0,0,0,0,92128
30411,34585,1681,3917,9859,11472,7656,3063,1646,1409,296,67,1046,237,169,19,0,150,68,0,19,49,1417,1374,270,112,992,43,43,42,0,1,0,0,0,0,92129
30412,31707,683,1371,4752,10617,14284,2610,1416,1378,124,18,1236,38,38,21,0,17,0,0,0,0,1194,1162,337,44,781,32,32,32,0,0,0,0,0,0,92130
30413,22146,564,1560,5435,7706,6881,1699,956,935,238,91,606,21,8,0,5,3,13,0,13,0,743,743,138,0,605,0,0,0,0,0,0,0,0,0,92131
30414,0,0,0,0,0,0,0,0,0,0,0,0,0,0,0,0,0,0,0,0,0,0,0,0,0,0,0,0,0,0,0,0,0,0,0,92132
30415,22,0,22,0,0,0,11,11,0,0,0,0,11,11,11,0,0,0,0,0,0,0,0,0,0,0,0,0,0,0,0,0,0,0,0,92134
30416,171,0,54,71,34,12,131,105,16,16,0,0,89,89,89,0,0,0,0,0,0,26,3,3,0,0,23,23,23,0,0,0,0,0,0,92135
30417,22928,4327,4942,8924,3960,775,2056,1154,874,52,68,754,280,250,91,54,105,30,0,0,30,902,852,141,25,686,50,40,11,0,29,10,0,0,10,92139
30418,259,0,36,133,90,0,1208,1194,310,310,0,0,884,879,858,7,14,5,5,0,0,14,0,0,0,0,14,14,14,0,0,0,0,0,0,92140
30419,978,53,86,178,422,239,104,60,60,0,0,60,0,0,0,0,0,0,0,0,0,44,44,8,0,36,0,0,0,0,0,0,0,0,0,92145
30420,105,0,0,75,30,0,81,49,9,9,0,0,40,40,40,0,0,0,0,0,0,32,11,11,0,0,21,21,21,0,0,0,0,0,0,92147
30421,51160,14536,12870,15769,5948,2037,6026,3116,2310,387,170,1753,806,560,307,90,163,246,57,0,189,2910,2601,389,332,1880,309,228,56,64,108,81,0,10,71,92154
30422,308,0,95,78,135,0,93,93,29,29,0,0,64,64,62,0,2,0,0,0,0,0,0,0,0,0,0,0,0,0,0,0,0,0,0,92155
30423,17565,8030,4208,3604,1352,371,2368,1309,1078,62,215,801,231,117,37,48,32,114,33,27,54,1059,960,55,86,819,99,99,78,10,11,0,0,0,0,92173
30424,36879,11960,9980,10089,3084,1766,3875,2105,1749,227,254,1268,356,163,53,62,48,193,40,97,56,1770,1326,255,59,1012,444,329,192,47,90,115,6,4,105,92201
30425,17383,1908,3991,6335,3248,1901,1144,570,468,27,70,371,102,102,92,10,0,0,0,0,0,574,478,202,85,191,96,69,69,0,0,27,27,0,0,92203
30426,4609,177,557,1428,1516,931,56,52,52,12,0,40,0,0,0,0,0,0,0,0,0,4,4,0,0,4,0,0,0,0,0,0,0,0,0,92210
30427,19546,1212,3861,6940,4756,2777,637,309,277,48,30,199,32,32,32,0,0,0,0,0,0,328,306,11,40,255,22,22,22,0,0,0,0,0,0,92211
30428,23324,4656,8011,7045,2211,1401,1510,722,386,40,17,329,336,283,80,24,179,53,4,10,39,788,560,62,40,458,228,217,32,49,136,11,9,0,2,92220
30429,0,0,0,0,0,0,0,0,0,0,0,0,0,0,0,0,0,0,0,0,0,0,0,0,0,0,0,0,0,0,0,0,0,0,0,92222
30430,28502,3916,7305,10420,3809,3052,2235,1280,1043,158,39,846,237,237,59,34,144,0,0,0,0,955,891,86,61,744,64,64,9,23,32,0,0,0,0,92223
30431,16736,5554,4827,4948,960,447,1221,635,544,120,68,356,91,48,21,0,27,43,0,0,43,586,503,32,115,356,83,41,33,8,0,42,0,0,42,92225
30432,15146,4705,4021,4765,1167,488,2080,984,824,163,114,547,160,87,16,23,48,73,7,54,12,1096,895,157,52,686,201,167,78,47,42,34,34,0,0,92227
30433,1538,489,602,351,96,0,160,65,31,0,0,31,34,0,0,0,0,34,0,34,0,95,59,17,0,42,36,22,11,0,11,14,0,0,14,92230
30434,22718,10091,3895,5682,2208,842,2872,1504,1384,157,224,1003,120,72,28,14,30,48,26,12,10,1368,1263,31,251,981,105,83,45,19,19,22,0,8,14,92231
30435,7024,3099,2091,1570,202,62,376,161,103,27,0,76,58,7,0,0,7,51,16,0,35,215,167,9,43,115,48,48,0,0,48,0,0,0,0,92233
30436,32288,8604,8818,10051,2947,1868,3075,1895,1519,87,148,1284,376,185,113,53,19,191,119,10,62,1180,905,109,18,778,275,225,89,23,113,50,0,0,50,92234
30437,21300,10733,5831,3748,798,190,3314,1500,1109,129,152,828,391,261,108,98,55,130,33,41,56,1814,1395,246,152,997,419,279,194,48,37,140,19,53,68,92236
30438,327,129,70,120,8,0,0,0,0,0,0,0,0,0,0,0,0,0,0,0,0,0,0,0,0,0,0,0,0,0,0,0,0,0,0,92239
30439,20661,6280,5806,6080,1506,989,2246,1186,724,15,25,684,462,349,99,135,115,113,0,0,113,1060,786,55,17,714,274,232,70,86,76,42,29,0,13,92240
30440,7122,1619,2174,2270,593,466,493,213,208,8,0,200,5,5,0,0,5,0,0,0,0,280,163,12,1,150,117,68,46,6,16,49,0,37,12,92241
30441,1190,189,411,487,57,46,17,11,11,0,0,11,0,0,0,0,0,0,0,0,0,6,6,0,0,6,0,0,0,0,0,0,0,0,0,92242
30442,28674,9313,5125,9265,3224,1747,3093,1537,1291,151,203,937,246,140,34,24,82,106,28,6,72,1556,1500,189,143,1168,56,21,8,5,8,35,0,0,35,92243
30443,3785,1427,770,1126,284,178,457,345,328,18,0,310,17,0,0,0,0,17,17,0,0,112,112,0,0,112,0,0,0,0,0,0,0,0,0,92249
30444,5211,2068,1116,1427,492,108,488,251,227,75,19,133,24,18,0,18,0,6,0,6,0,237,237,4,59,174,0,0,0,0,0,0,0,0,0,92250
30445,13849,3352,3370,4795,1567,765,1531,1044,925,157,60,708,119,84,46,0,38,35,0,0,35,487,487,55,22,410,0,0,0,0,0,0,0,0,0,92251
30446,7272,969,2214,2459,1026,604,356,172,172,33,29,110,0,0,0,0,0,0,0,0,0,184,184,0,9,175,0,0,0,0,0,0,0,0,0,92252
30447,26876,2798,5433,9589,5814,3242,1996,1005,962,281,27,654,43,43,22,0,21,0,0,0,0,991,938,122,19,797,53,53,0,35,18,0,0,0,0,92253
30448,5544,3915,1001,492,57,79,941,463,285,15,48,222,178,93,0,64,29,85,45,27,13,478,300,48,30,222,178,163,13,116,34,15,0,15,0,92254
30449,2503,392,696,1043,193,179,236,130,130,0,46,84,0,0,0,0,0,0,0,0,0,106,106,45,0,61,0,0,0,0,0,0,0,0,0,92256
30450,1267,543,481,186,36,21,40,17,15,0,0,15,2,2,0,2,0,0,0,0,0,23,23,0,0,23,0,0,0,0,0,0,0,0,0,92257
30451,248,106,106,36,0,0,0,0,0,0,0,0,0,0,0,0,0,0,0,0,0,0,0,0,0,0,0,0,0,0,0,0,0,0,0,92258
30452,273,87,82,66,25,13,36,0,0,0,0,0,0,0,0,0,0,0,0,0,0,36,36,0,0,36,0,0,0,0,0,0,0,0,0,92259
30453,25383,2324,5298,9263,5388,3110,921,651,615,83,54,478,36,36,19,17,0,0,0,0,0,270,240,59,23,158,30,30,19,0,11,0,0,0,0,92260
30454,19937,2834,4326,6279,3832,2666,1172,501,361,32,98,231,140,84,44,21,19,56,45,8,3,671,538,67,52,419,133,93,26,28,39,40,0,3,37,92262
30455,17085,1749,3176,6053,3743,2364,464,234,210,8,43,159,24,24,20,0,4,0,0,0,0,230,139,24,36,79,91,89,70,0,19,2,0,0,2,92264
30456,47,0,28,19,0,0,0,0,0,0,0,0,0,0,0,0,0,0,0,0,0,0,0,0,0,0,0,0,0,0,0,0,0,0,0,92266
30457,0,0,0,0,0,0,0,0,0,0,0,0,0,0,0,0,0,0,0,0,0,0,0,0,0,0,0,0,0,0,0,0,0,0,0,92267
30458,488,8,307,109,27,37,25,0,0,0,0,0,0,0,0,0,0,0,0,0,0,25,25,0,0,25,0,0,0,0,0,0,0,0,0,92268
30459,15196,710,3212,5192,3392,2690,449,205,202,69,40,93,3,0,0,0,0,3,0,0,3,244,218,87,0,131,26,26,26,0,0,0,0,0,0,92270
30460,846,357,157,305,27,0,7,4,4,0,0,4,0,0,0,0,0,0,0,0,0,3,3,3,0,0,0,0,0,0,0,0,0,0,0,92273
30461,9975,5512,2508,1490,360,105,1189,784,466,40,24,402,318,240,171,43,26,78,34,10,34,405,333,12,68,253,72,38,4,3,31,34,4,14,16,92274
30462,766,240,254,209,55,8,6,0,0,0,0,0,0,0,0,0,0,0,0,0,0,6,6,0,0,6,0,0,0,0,0,0,0,0,0,92275
30463,5460,1170,1454,2028,487,321,604,272,272,0,0,272,0,0,0,0,0,0,0,0,0,332,254,0,0,254,78,78,0,0,78,0,0,0,0,92276
30464,12939,1529,3960,5039,1638,773,1029,350,255,113,28,114,95,34,29,5,0,61,8,37,16,679,439,119,38,282,240,198,10,83,105,42,0,0,42,92277
30465,1003,0,444,439,112,8,600,598,63,63,0,0,535,535,535,0,0,0,0,0,0,2,0,0,0,0,2,2,2,0,0,0,0,0,0,92278
30466,0,0,0,0,0,0,0,0,0,0,0,0,0,0,0,0,0,0,0,0,0,0,0,0,0,0,0,0,0,0,0,0,0,0,0,92280
30467,1086,507,226,275,65,13,168,81,64,0,20,44,17,4,4,0,0,13,0,13,0,87,70,5,13,52,17,4,0,4,0,13,0,0,13,92281
30468,513,56,196,196,59,6,3,3,3,0,0,3,0,0,0,0,0,0,0,0,0,0,0,0,0,0,0,0,0,0,0,0,0,0,0,92282
30469,1531,516,413,501,84,17,175,95,59,3,21,35,36,4,4,0,0,32,0,0,32,80,57,5,0,52,23,23,0,6,17,0,0,0,0,92283
30470,16798,2443,4639,7564,1448,704,1279,657,582,118,6,458,75,39,0,39,0,36,0,0,36,622,602,15,0,587,20,14,14,0,0,6,0,0,6,92284
30471,2039,442,711,778,90,18,141,34,10,0,0,10,24,24,0,18,6,0,0,0,0,107,107,34,15,58,0,0,0,0,0,0,0,0,0,92285
30472,16002,4871,4952,5012,914,253,2347,1430,1138,46,47,1045,292,231,20,57,154,61,11,0,50,917,786,100,96,590,131,62,0,34,28,69,0,37,32,92301
30473,0,0,0,0,0,0,0,0,0,0,0,0,0,0,0,0,0,0,0,0,0,0,0,0,0,0,0,0,0,0,0,0,0,0,0,92304
30474,215,0,61,51,52,51,6,6,6,6,0,0,0,0,0,0,0,0,0,0,0,0,0,0,0,0,0,0,0,0,0,0,0,0,0,92305
30475,23822,3256,6833,9745,2236,1752,2430,1310,1087,90,79,918,223,107,35,35,37,116,0,69,47,1120,952,65,129,758,168,156,94,51,11,12,12,0,0,92307
30476,25536,3792,8251,9720,1994,1779,2135,959,790,64,65,661,169,155,29,99,27,14,0,14,0,1176,1046,115,99,832,130,117,105,12,0,13,0,13,0,92308
30477,440,187,171,59,13,10,73,32,15,10,0,5,17,17,17,0,0,0,0,0,0,41,36,8,0,28,5,5,5,0,0,0,0,0,0,92309
30478,3749,37,799,1938,679,296,279,156,77,77,0,0,79,79,79,0,0,0,0,0,0,123,74,40,0,34,49,49,0,25,24,0,0,0,0,92310
30479,19867,3568,6601,7488,1287,923,2597,1388,1000,204,49,747,388,377,168,185,24,11,11,0,0,1209,946,140,172,634,263,205,93,60,52,58,8,0,50,92311
30480,8103,992,1984,3148,1169,810,714,458,389,81,24,284,69,15,15,0,0,54,0,43,11,256,240,30,23,187,16,16,16,0,0,0,0,0,0,92313
30481,6962,1220,2199,2547,717,279,557,322,184,40,29,115,138,138,32,0,106,0,0,0,0,235,170,54,10,106,65,58,31,27,0,7,0,0,7,92314
30482,3768,620,873,1449,430,396,228,82,40,12,0,28,42,20,14,6,0,22,0,0,22,146,114,0,0,114,32,32,10,0,22,0,0,0,0,92315
30483,17369,6383,4419,4875,1244,448,2288,1340,1033,49,173,811,307,235,129,29,77,72,13,26,33,948,799,72,72,655,149,49,0,24,25,100,0,0,100,92316
30484,5905,622,2026,2398,616,243,422,152,81,39,8,34,71,19,19,0,0,52,0,0,52,270,252,64,48,140,18,18,0,0,18,0,0,0,0,92320
30485,721,45,146,215,276,39,72,31,31,12,0,19,0,0,0,0,0,0,0,0,0,41,41,14,0,27,0,0,0,0,0,0,0,0,0,92321
30486,533,47,158,241,61,26,28,11,11,0,0,11,0,0,0,0,0,0,0,0,0,17,12,0,6,6,5,5,0,5,0,0,0,0,0,92322
30487,31652,9694,8802,9435,2209,1512,4137,2338,1909,126,187,1596,429,369,176,137,56,60,22,0,38,1799,1392,184,136,1072,407,299,115,102,82,108,24,5,79,92324
30488,5696,496,1515,2458,675,552,623,325,277,46,19,212,48,48,31,17,0,0,0,0,0,298,216,0,26,190,82,25,25,0,0,57,29,0,28,92325
30489,765,33,326,115,149,142,19,0,0,0,0,0,0,0,0,0,0,0,0,0,0,19,0,0,0,0,19,19,0,19,0,0,0,0,0,92327
30490,250,26,88,55,54,27,3,0,0,0,0,0,0,0,0,0,0,0,0,0,0,3,3,3,0,0,0,0,0,0,0,0,0,0,0,92328
30491,8,3,5,0,0,0,0,0,0,0,0,0,0,0,0,0,0,0,0,0,0,0,0,0,0,0,0,0,0,0,0,0,0,0,0,92332
30492,600,6,195,251,122,26,0,0,0,0,0,0,0,0,0,0,0,0,0,0,0,0,0,0,0,0,0,0,0,0,0,0,0,0,0,92333
30493,53661,23014,15139,12046,2579,883,6923,3445,2808,327,267,2214,637,438,162,130,146,199,84,24,91,3478,2849,383,335,2131,629,513,194,176,143,116,2,16,98,92335
30494,51772,9009,12188,18390,8687,3498,6359,3397,2924,450,593,1881,473,236,62,95,79,237,0,50,187,2962,2660,379,377,1904,302,297,49,46,202,5,0,0,5,92336
30495,21983,6293,5812,6977,2216,685,3076,1174,1011,71,145,795,163,160,75,65,20,3,3,0,0,1902,1709,163,191,1355,193,129,112,0,17,64,15,38,11,92337
30496,0,0,0,0,0,0,0,0,0,0,0,0,0,0,0,0,0,0,0,0,0,0,0,0,0,0,0,0,0,0,0,0,0,0,0,92338
30497,655,5,44,329,149,128,45,7,0,0,0,0,7,7,7,0,0,0,0,0,0,38,20,0,0,20,18,12,0,0,12,6,0,0,6,92339
30498,265,11,11,124,81,38,12,12,12,0,0,12,0,0,0,0,0,0,0,0,0,0,0,0,0,0,0,0,0,0,0,0,0,0,0,92341
30499,4666,580,1163,1817,722,384,368,267,97,0,0,97,170,126,94,0,32,44,37,7,0,101,101,20,0,81,0,0,0,0,0,0,0,0,0,92342
30500,11716,1932,3089,4729,1200,766,1297,798,705,68,61,576,93,55,4,36,15,38,0,38,0,499,430,16,142,272,69,30,21,9,0,39,0,0,39,92344
30501,47205,11746,15133,16355,2627,1344,6111,3316,2490,162,258,2070,826,726,243,134,349,100,43,29,28,2795,2398,226,248,1924,397,293,90,61,142,104,17,32,55,92345
30502,36029,7471,9192,11509,4788,3069,3860,2056,1741,418,147,1176,315,128,78,31,19,187,9,80,98,1804,1466,261,80,1125,338,244,120,34,90,94,0,38,56,92346
30503,1074,254,270,358,182,10,54,13,13,0,0,13,0,0,0,0,0,0,0,0,0,41,41,15,0,26,0,0,0,0,0,0,0,0,0,92347
30504,4566,290,745,1814,993,724,263,128,115,41,0,74,13,0,0,0,0,13,0,0,13,135,76,15,17,44,59,18,0,0,18,41,0,22,19,92352
30505,15262,1767,1942,4014,4389,3150,857,546,504,70,32,402,42,32,0,22,10,10,0,10,0,311,228,29,25,174,83,73,28,6,39,10,10,0,0,92354
30506,4686,738,1633,1864,152,299,490,276,203,0,0,203,73,73,11,0,62,0,0,0,0,214,187,0,9,178,27,27,0,0,27,0,0,0,0,92356
30507,681,21,233,323,73,31,95,46,46,0,18,28,0,0,0,0,0,0,0,0,0,49,44,17,0,27,5,5,0,5,0,0,0,0,0,92358
30508,5393,764,1698,1897,531,503,506,401,340,0,13,327,61,59,41,18,0,2,0,0,2,105,86,18,0,68,19,0,0,0,0,19,0,0,19,92359
30509,3419,660,1180,1353,144,82,319,205,178,46,0,132,27,12,0,12,0,15,4,11,0,114,76,21,35,20,38,34,9,25,0,4,0,4,0,92363
30510,26,0,4,22,0,0,4,0,0,0,0,0,0,0,0,0,0,0,0,0,0,4,4,0,0,4,0,0,0,0,0,0,0,0,0,92364
30511,1584,352,406,645,113,68,191,100,100,11,0,89,0,0,0,0,0,0,0,0,0,91,48,0,10,38,43,43,43,0,0,0,0,0,0,92365
30512,658,201,255,166,31,5,29,17,15,0,0,15,2,2,0,2,0,0,0,0,0,12,8,5,0,3,4,2,0,0,2,2,0,0,2,92368
30513,9960,1598,3555,3812,705,290,1062,734,489,37,63,389,245,245,61,49,135,0,0,0,0,328,247,46,0,201,81,39,23,4,12,42,0,0,42,92371
30514,3727,613,1373,1321,314,106,145,68,42,0,0,42,26,0,0,0,0,26,0,0,26,77,75,0,0,75,2,2,0,0,2,0,0,0,0,92372
30515,23471,1542,3395,7008,6195,5331,1490,823,822,98,0,724,1,0,0,0,0,1,0,0,1,667,613,153,17,443,54,54,43,11,0,0,0,0,0,92373
30516,24190,3322,5479,8598,3912,2879,3633,2031,1729,334,175,1220,302,256,48,57,151,46,0,11,35,1602,1558,402,141,1015,44,33,10,9,14,11,0,0,11,92374
30517,46153,15831,13420,13297,2585,1020,6819,3359,2499,348,134,2017,860,669,385,118,166,191,59,37,95,3460,2920,330,286,2304,540,388,165,115,108,152,0,85,67,92376
30518,10926,2318,3120,3612,1151,725,1490,830,671,71,113,487,159,126,18,79,29,33,0,31,2,660,628,52,97,479,32,28,17,0,11,4,0,0,4,92377
30519,117,33,33,34,11,6,0,0,0,0,0,0,0,0,0,0,0,0,0,0,0,0,0,0,0,0,0,0,0,0,0,0,0,0,0,92378
30520,3845,229,798,1969,549,300,272,185,136,43,31,62,49,34,34,0,0,15,0,15,0,87,67,0,0,67,20,20,0,5,15,0,0,0,0,92382
30521,54,14,18,22,0,0,0,0,0,0,0,0,0,0,0,0,0,0,0,0,0,0,0,0,0,0,0,0,0,0,0,0,0,0,0,92384
30522,193,0,24,45,60,64,0,0,0,0,0,0,0,0,0,0,0,0,0,0,0,0,0,0,0,0,0,0,0,0,0,0,0,0,0,92385
30523,1423,87,396,617,224,99,35,0,0,0,0,0,0,0,0,0,0,0,0,0,0,35,13,13,0,0,22,0,0,0,0,22,0,0,22,92386
30524,89,20,33,20,13,3,0,0,0,0,0,0,0,0,0,0,0,0,0,0,0,0,0,0,0,0,0,0,0,0,0,0,0,0,0,92389
30525,1601,291,290,742,148,130,126,74,34,0,0,34,40,40,40,0,0,0,0,0,0,52,44,0,29,15,8,8,0,0,8,0,0,0,0,92391
30526,29400,5302,8363,11867,2568,1300,4066,1831,1555,324,144,1087,276,199,52,80,67,77,0,0,77,2235,1858,150,127,1581,377,304,41,62,201,73,0,50,23,92392
30527,20670,5168,6646,7390,935,531,2428,1020,913,42,66,805,107,50,0,19,31,57,0,0,57,1408,1239,15,126,1098,169,92,58,34,0,77,0,0,77,92394
30528,24425,5294,7198,9087,1660,1186,2854,1548,1273,18,109,1146,275,161,103,28,30,114,54,28,32,1306,985,117,66,802,321,269,46,9,214,52,0,0,52,92395
30529,3218,112,746,1249,676,435,195,95,60,15,0,45,35,35,18,0,17,0,0,0,0,100,100,23,0,77,0,0,0,0,0,0,0,0,0,92397
30530,620,77,134,379,30,0,56,16,16,0,0,16,0,0,0,0,0,0,0,0,0,40,0,0,0,0,40,40,0,0,40,0,0,0,0,92398
30531,34363,3845,9270,13794,4565,2889,3173,1650,1368,201,164,1003,282,226,111,63,52,56,11,11,34,1523,1293,149,83,1061,230,199,41,70,88,31,24,0,7,92399
30532,1114,552,287,217,41,17,116,38,8,0,0,8,30,14,0,14,0,16,0,0,16,78,40,13,0,27,38,21,0,0,21,17,0,0,17,92401
30533,35386,11218,10102,10486,2315,1265,4522,2195,1885,73,46,1766,310,187,50,55,82,123,0,67,56,2327,1831,211,164,1456,496,449,223,45,181,47,0,23,24,92404
30534,16276,5024,4504,5185,953,610,2183,1098,799,97,107,595,299,117,82,26,9,182,75,70,37,1085,807,65,80,662,278,177,41,15,121,101,34,0,67,92405
30535,31895,8577,8901,9888,2985,1544,5648,2648,2312,261,162,1889,336,201,44,104,53,135,0,13,122,3000,2647,460,237,1950,353,239,22,108,109,114,26,0,88,92407
30536,9036,2585,2606,2301,1148,396,818,446,312,27,37,248,134,41,12,16,13,93,17,0,76,372,324,26,14,284,48,38,0,0,38,10,0,0,10,92408
30537,24238,11661,6064,5362,934,217,3898,2229,1849,234,174,1441,380,99,37,47,15,281,121,20,140,1669,1421,101,138,1182,248,136,55,0,81,112,13,0,99,92410
30538,13915,6595,3603,3090,489,138,1920,972,689,54,58,577,283,151,47,18,86,132,44,23,65,948,783,66,67,650,165,110,57,20,33,55,8,27,20,92411
30539,13402,2700,4240,4087,1395,980,1364,810,487,29,123,335,323,274,78,130,66,49,9,0,40,554,458,48,81,329,96,40,22,18,0,56,0,0,56,92501
30540,52809,15482,12778,16666,5031,2852,6495,3124,2565,331,216,2018,559,452,351,32,69,107,0,15,92,3371,2622,296,231,2095,749,521,176,178,167,228,44,21,163,92503
30541,33155,6991,9055,11074,3884,2151,3667,1766,1444,144,144,1156,322,181,113,16,52,141,48,37,56,1901,1469,346,160,963,432,235,25,70,140,197,0,85,112,92504
30542,28739,7414,7515,9122,2973,1715,3807,2063,1854,362,163,1329,209,89,22,26,41,120,30,26,64,1744,1388,175,117,1096,356,270,137,83,50,86,34,0,52,92505
30543,30415,2848,5011,10338,6440,5778,2611,1407,1341,310,201,830,66,52,29,0,23,14,0,0,14,1204,1110,234,101,775,94,32,22,10,0,62,30,9,23,92506
30544,26470,6466,5900,7432,3425,3247,6660,3441,3188,386,336,2466,253,147,75,20,52,106,65,0,41,3219,2972,419,356,2197,247,171,50,18,103,76,0,22,54,92507
30545,21553,2181,4507,7826,3974,3065,2604,1243,985,63,93,829,258,210,103,52,55,48,0,0,48,1361,1279,261,116,902,82,82,57,8,17,0,0,0,0,92508
30546,44849,15344,12870,12371,3063,1201,5805,3059,2462,324,376,1762,597,437,201,121,115,160,47,35,78,2746,2268,213,403,1652,478,340,112,88,140,138,21,27,90,92509
30547,858,141,142,196,161,218,23,11,11,0,0,11,0,0,0,0,0,0,0,0,0,12,6,0,0,6,6,0,0,0,0,6,0,0,6,92518
30548,28511,8141,8334,9314,1873,849,3890,2159,1803,426,211,1166,356,296,121,162,13,60,36,0,24,1731,1440,258,210,972,291,235,68,62,105,56,34,0,22,92530
30549,11688,1657,2724,4583,1942,782,1757,801,614,90,51,473,187,138,47,70,21,49,37,0,12,956,757,19,205,533,199,167,61,0,106,32,32,0,0,92532
30550,2430,306,847,1060,103,114,285,12,12,0,0,12,0,0,0,0,0,0,0,0,0,273,273,95,18,160,0,0,0,0,0,0,0,0,0,92536
30551,2778,695,784,1082,174,43,169,69,52,0,2,50,17,14,14,0,0,3,0,0,3,100,63,32,0,31,37,2,0,0,2,35,0,0,35,92539
30552,21853,5541,7154,7386,1274,498,1734,882,556,25,113,418,326,232,62,66,104,94,7,35,52,852,618,47,112,459,234,142,57,63,22,92,22,42,28,92543
30553,28520,5293,8252,10796,2400,1779,2842,1613,1334,91,179,1064,279,224,76,73,75,55,0,18,37,1229,1088,132,61,895,141,129,64,15,50,12,0,0,12,92544
30554,27768,4758,9362,9703,2249,1696,1964,1226,999,76,140,783,227,124,22,79,23,103,45,0,58,738,549,57,52,440,189,149,54,48,47,40,0,0,40,92545
30555,4410,1415,1550,1117,197,131,529,285,212,0,30,182,73,43,43,0,0,30,0,13,17,244,216,0,24,192,28,28,0,0,28,0,0,0,0,92548
30556,1758,40,519,538,428,233,62,23,4,0,0,4,19,19,0,0,19,0,0,0,0,39,33,33,0,0,6,6,6,0,0,0,0,0,0,92549
30557,16543,4380,4564,5314,1912,373,2607,1293,947,30,218,699,346,224,166,32,26,122,13,31,78,1314,1053,228,172,653,261,208,99,0,109,53,9,0,44,92551
30558,40751,14369,10993,11541,2886,962,5917,2848,2188,169,178,1841,660,481,175,75,231,179,51,77,51,3069,2558,255,97,2206,511,388,172,36,180,123,11,16,96,92553
30559,23724,3882,5597,9409,3246,1590,2709,1323,1098,80,118,900,225,155,70,22,63,70,0,51,19,1386,1190,127,147,916,196,140,42,8,90,56,0,19,37,92555
30560,30150,5155,8074,11492,3601,1828,3602,1402,1166,162,108,896,236,113,33,30,50,123,8,21,94,2200,1908,300,111,1497,292,236,178,17,41,56,0,38,18,92557
30561,1298,69,314,530,207,178,13,2,2,0,0,2,0,0,0,0,0,0,0,0,0,11,11,0,0,11,0,0,0,0,0,0,0,0,0,92561
30562,37842,2889,7569,15649,7703,4032,4545,2530,2245,167,319,1759,285,252,154,54,44,33,0,31,2,2015,1610,241,190,1179,405,363,246,29,88,42,0,0,42,92562
30563,33662,3158,8592,12860,6231,2821,3804,2155,1759,226,164,1369,396,355,157,12,186,41,9,8,24,1649,1388,364,67,957,261,222,111,49,62,39,14,0,25,92563
30564,5240,1156,1777,1584,561,162,597,295,234,11,0,223,61,59,45,0,14,2,0,0,2,302,269,0,9,260,33,33,25,8,0,0,0,0,0,92567
30565,31039,12531,8757,7116,1885,750,3956,2055,1616,273,188,1155,439,218,27,108,83,221,127,24,70,1901,1400,78,163,1159,501,398,181,69,148,103,0,0,103,92570
30566,28162,10388,7183,8347,1628,616,4497,2165,1920,5,162,1753,245,90,22,9,59,155,49,14,92,2332,2034,266,44,1724,298,199,98,22,79,99,31,34,34,92571
30567,9536,1831,2424,3707,1006,568,867,337,263,13,91,159,74,17,17,0,0,57,0,57,0,530,514,152,56,306,16,16,0,7,9,0,0,0,0,92582
30568,18046,4895,5251,5705,1444,751,1885,1037,736,28,163,545,301,259,8,150,101,42,0,0,42,848,689,52,121,516,159,132,35,34,63,27,16,0,11,92583
30569,27972,2875,7272,12107,3898,1820,2795,1478,1184,353,133,698,294,225,148,20,57,69,46,11,12,1317,1090,76,117,897,227,176,176,0,0,51,15,36,0,92584
30570,11840,2327,3212,4255,1460,586,1257,545,439,13,31,395,106,81,0,81,0,25,0,16,9,712,428,47,32,349,284,140,87,32,21,144,6,55,83,92585
30571,15831,2311,5271,6374,1211,664,501,267,180,43,11,126,87,87,41,18,28,0,0,0,0,234,234,67,55,112,0,0,0,0,0,0,0,0,0,92586
30572,10662,1157,3052,4313,1532,608,739,413,329,14,9,306,84,84,0,61,23,0,0,0,0,326,270,52,7,211,56,32,0,32,0,24,0,24,0,92587
30573,2545,449,626,732,429,309,209,120,112,21,0,91,8,8,0,0,8,0,0,0,0,89,89,14,0,75,0,0,0,0,0,0,0,0,0,92590
30574,23087,2563,4893,8769,4719,2143,2980,1271,1007,105,30,872,264,214,67,20,127,50,23,0,27,1709,1470,276,91,1103,239,221,99,15,107,18,0,18,0,92591
30575,44356,2471,9508,19047,9037,4293,5290,2937,2510,417,217,1876,427,377,169,93,115,50,36,14,0,2353,2093,341,244,1508,260,243,163,16,64,17,0,0,17,92592
30576,18733,2561,4931,8005,2265,971,1725,916,737,78,32,627,179,120,31,11,78,59,27,0,32,809,721,75,139,507,88,88,55,25,8,0,0,0,0,92595
30577,14394,1503,3382,6082,2547,880,1426,752,557,92,43,422,195,195,81,24,90,0,0,0,0,674,634,169,0,465,40,40,40,0,0,0,0,0,0,92596
30578,14970,420,1355,3658,5281,4256,1048,520,410,89,0,321,110,110,110,0,0,0,0,0,0,528,528,54,0,474,0,0,0,0,0,0,0,0,0,92602
30579,13701,261,592,1875,5962,5011,1090,481,479,31,26,422,2,0,0,0,0,2,0,0,2,609,556,54,14,488,53,53,53,0,0,0,0,0,0,92603
30580,19104,1417,2318,4787,6122,4460,1569,766,687,70,32,585,79,68,19,0,49,11,11,0,0,803,754,183,64,507,49,49,44,0,5,0,0,0,0,92604
30581,15121,707,1492,3599,5723,3600,821,452,403,82,24,297,49,49,0,49,0,0,0,0,0,369,369,52,16,301,0,0,0,0,0,0,0,0,0,92606
30582,7165,107,659,1947,3097,1355,761,420,377,100,13,264,43,27,0,27,0,16,0,0,16,341,327,188,36,103,14,14,14,0,0,0,0,0,0,92610
30583,16152,610,1355,4119,5494,4574,2435,1207,1129,158,26,945,78,55,55,0,0,23,0,23,0,1228,1228,277,61,890,0,0,0,0,0,0,0,0,0,92612
30584,16908,562,1675,3879,6748,4044,1033,606,606,147,50,409,0,0,0,0,0,0,0,0,0,427,420,71,22,327,7,7,0,7,0,0,0,0,0,92614
30585,5548,72,197,532,1756,2991,5885,2717,2717,417,86,2214,0,0,0,0,0,0,0,0,0,3168,3168,552,173,2443,0,0,0,0,0,0,0,0,0,92617
30586,13470,515,1248,2674,5158,3875,733,507,406,95,39,272,101,86,47,14,25,15,0,0,15,226,226,68,0,158,0,0,0,0,0,0,0,0,0,92618
30587,27598,726,2563,6978,10424,6907,2172,1262,1202,162,23,1017,60,49,20,0,29,11,0,11,0,910,836,164,31,641,74,74,0,74,0,0,0,0,0,92620
30588,4840,298,850,1838,1388,466,187,52,52,29,8,15,0,0,0,0,0,0,0,0,0,135,116,0,43,73,19,0,0,0,0,19,0,0,19,92624
30589,9692,278,796,2235,3588,2795,338,149,149,60,0,89,0,0,0,0,0,0,0,0,0,189,162,8,0,154,27,27,0,0,27,0,0,0,0,92625
30590,35634,3940,5518,11554,10172,4450,2823,1323,1182,210,42,930,141,118,34,68,16,23,0,0,23,1500,1303,440,28,835,197,181,117,21,43,16,0,9,7,92626
30591,40415,7092,7034,13718,8641,3930,2938,1804,1317,317,204,796,487,194,194,0,0,293,142,36,115,1134,1009,160,173,676,125,98,49,17,32,27,14,13,0,92627
30592,20310,922,2783,6671,6098,3836,1035,620,605,174,71,360,15,15,0,15,0,0,0,0,0,415,400,53,28,319,15,0,0,0,0,15,0,15,0,92629
30593,41282,3994,7576,13626,10981,5105,2945,1373,1260,219,56,985,113,89,68,0,21,24,0,0,24,1572,1461,392,35,1034,111,87,79,8,0,24,24,0,0,92630
30594,16207,956,3380,5338,3791,2742,1,0,0,0,0,0,0,0,0,0,0,0,0,0,0,1,0,0,0,0,1,0,0,0,0,1,0,0,1,92637
30595,39189,1734,6351,14815,10690,5599,2689,1202,1119,236,80,803,83,75,24,51,0,8,0,0,8,1487,1330,260,105,965,157,123,65,20,38,34,0,7,27,92646
30596,38795,5332,6873,13783,8745,4062,3234,1822,1551,237,219,1095,271,143,55,22,66,128,73,0,55,1412,1221,349,112,760,191,123,30,44,49,68,0,40,28,92647
30597,33835,1920,5575,11621,9396,5323,2091,1159,949,140,129,680,210,134,52,56,26,76,48,0,28,932,859,213,0,646,73,39,25,14,0,34,0,14,20,92648
30598,24899,1251,4000,8598,6601,4449,1229,697,635,175,112,348,62,62,41,12,9,0,0,0,0,532,392,117,52,223,140,112,22,51,39,28,0,0,28,92649
30599,18321,473,1320,4539,6589,5400,1007,532,454,66,12,376,78,64,64,0,0,14,14,0,0,475,464,167,0,297,11,11,0,0,11,0,0,0,0,92651
30600,20171,1760,3732,5604,5607,3468,1615,857,717,242,60,415,140,96,51,15,30,44,0,11,33,758,703,140,29,534,55,55,0,36,19,0,0,0,0,92653
30601,6183,1977,1129,1892,1020,165,489,212,209,38,33,138,3,3,0,0,3,0,0,0,0,277,186,0,21,165,91,9,9,0,0,82,0,68,14,92655
30602,33834,1596,3673,9238,13654,5673,2429,1131,1037,221,130,686,94,84,47,23,14,10,10,0,0,1298,1214,252,56,906,84,55,42,13,0,29,7,15,7,92656
30603,7162,118,576,1359,2643,2466,395,147,137,14,17,106,10,0,0,0,0,10,0,0,10,248,248,36,0,212,0,0,0,0,0,0,0,0,0,92657
30604,24776,610,2210,5667,9697,6592,1251,679,679,151,25,503,0,0,0,0,0,0,0,0,0,572,546,85,50,411,26,2,0,0,2,24,0,0,24,92660
30605,3079,51,355,772,1070,831,153,134,134,61,0,73,0,0,0,0,0,0,0,0,0,19,19,0,0,19,0,0,0,0,0,0,0,0,0,92661
30606,2293,18,95,738,1046,396,218,131,131,13,0,118,0,0,0,0,0,0,0,0,0,87,87,20,0,67,0,0,0,0,0,0,0,0,0,92662
30607,17249,530,1795,4880,6565,3479,952,556,528,0,51,477,28,28,16,12,0,0,0,0,0,396,388,109,53,226,8,8,0,8,0,0,0,0,0,92663
30608,24811,1648,3480,9477,6335,3871,1562,872,672,169,86,417,200,190,133,13,44,10,0,0,10,690,577,191,30,356,113,42,31,11,0,71,14,17,40,92672
30609,18814,629,2277,6021,6755,3132,1283,660,624,65,32,527,36,36,36,0,0,0,0,0,0,623,565,175,51,339,58,25,0,0,25,33,0,0,33,92673
30610,23388,4023,4418,7229,5071,2647,2215,1097,894,230,69,595,203,188,71,117,0,15,0,0,15,1118,982,313,107,562,136,99,57,42,0,37,37,0,0,92675
30611,1525,64,275,522,382,282,139,92,92,27,0,65,0,0,0,0,0,0,0,0,0,47,47,0,0,47,0,0,0,0,0,0,0,0,0,92676
30612,45273,1664,5374,13548,15450,9237,3263,1634,1538,268,122,1148,96,69,69,0,0,27,0,0,27,1629,1517,283,150,1084,112,96,29,0,67,16,0,0,16,92677
30613,332,4,34,145,123,26,31,18,18,0,0,18,0,0,0,0,0,0,0,0,0,13,13,0,0,13,0,0,0,0,0,0,0,0,0,92678
30614,21131,373,2540,5873,8351,3994,2596,1370,1342,272,118,952,28,18,2,8,8,10,0,0,10,1226,1216,307,101,808,10,0,0,0,0,10,0,0,10,92679
30615,61383,15588,14109,18800,9720,3166,4915,2725,2492,239,267,1986,233,146,44,24,78,87,16,12,59,2190,2002,409,148,1445,188,165,85,56,24,23,10,0,13,92683
30616,28128,1347,4290,9145,8926,4420,2756,1525,1499,416,164,919,26,26,14,0,12,0,0,0,0,1231,1181,266,67,848,50,38,38,0,0,12,12,0,0,92688
30617,32853,2204,6023,11164,8508,4954,2591,1268,1097,182,72,843,171,171,73,35,63,0,0,0,0,1323,1195,369,55,771,128,107,80,11,16,21,0,0,21,92691
30618,33293,1395,4437,10991,10614,5856,2709,1437,1394,248,132,1014,43,12,0,0,12,31,0,0,31,1272,1141,214,92,835,131,98,76,0,22,33,11,0,22,92692
30619,12819,143,1093,3173,5332,3078,925,538,513,62,15,436,25,25,0,25,0,0,0,0,0,387,376,52,24,300,11,11,11,0,0,0,0,0,0,92694
30620,28969,16390,5538,4841,1790,410,3609,1807,1507,151,121,1235,300,233,80,0,153,67,52,0,15,1802,1501,242,63,1196,301,143,87,19,37,158,41,58,59,92701
30621,40528,21306,9322,7265,2011,624,4625,2355,1582,147,117,1318,773,369,161,46,162,404,129,146,129,2270,1880,233,162,1485,390,239,85,47,107,151,39,20,92,92703
30622,50549,22540,10704,10732,4723,1850,6365,3401,2880,428,144,2308,521,362,148,162,52,159,94,0,65,2964,2480,297,89,2094,484,230,130,20,80,254,117,30,107,92704
30623,29390,4333,5259,7639,7494,4665,2626,1552,1249,209,121,919,303,273,137,0,136,30,0,18,12,1074,913,280,87,546,161,124,66,25,33,37,0,0,37,92705
30624,21099,7282,4855,4789,2787,1386,2056,1241,1082,168,89,825,159,133,102,11,20,26,0,19,7,815,760,76,68,616,55,33,7,26,0,22,11,0,11,92706
30625,35451,16383,8368,6447,3073,1180,3902,2097,1799,256,204,1339,298,249,105,116,28,49,21,0,28,1805,1675,294,280,1101,130,102,22,29,51,28,0,0,28,92707
30626,40846,4134,7093,14244,10426,4949,2922,1435,1353,213,101,1039,82,39,16,14,9,43,19,0,24,1487,1324,333,79,912,163,130,71,0,59,33,11,0,22,92708
30627,37349,7660,7789,10856,7656,3388,3413,1807,1518,178,192,1148,289,289,152,49,88,0,0,0,0,1606,1417,313,185,919,189,145,113,15,17,44,29,15,0,92780
30628,14908,505,1451,3578,5361,4013,1031,510,478,97,8,373,32,22,22,0,0,10,10,0,0,521,521,132,12,377,0,0,0,0,0,0,0,0,0,92782
30629,37848,9996,10867,10123,4921,1941,4036,1604,1429,205,217,1007,175,34,25,0,9,141,69,41,31,2432,1921,263,259,1399,511,436,209,71,156,75,29,22,24,92801
30630,24980,8452,6239,6177,3211,901,2861,1473,1181,118,59,1004,292,196,0,90,106,96,53,0,43,1388,1164,170,34,960,224,202,123,6,73,22,22,0,0,92802
30631,53715,13962,13627,14582,8628,2916,5279,2507,1908,222,124,1562,599,325,93,143,89,274,149,60,65,2772,2339,366,193,1780,433,335,225,0,110,98,44,6,48,92804
30632,41192,16742,9602,8803,4386,1659,4987,2637,2136,232,254,1650,501,235,205,6,24,266,91,37,138,2350,1960,456,200,1304,390,264,62,114,88,126,44,72,10,92805
30633,25422,5755,6113,7774,4331,1449,2197,1027,817,104,127,586,210,185,83,55,47,25,15,0,10,1170,1056,266,72,718,114,98,14,24,60,16,0,16,0,92806
30634,25394,1722,4252,8299,7394,3727,1965,907,845,227,82,536,62,62,26,6,30,0,0,0,0,1058,1004,370,85,549,54,54,17,20,17,0,0,0,0,92807
30635,14081,782,1680,4050,4586,2983,1164,604,573,109,93,371,31,17,17,0,0,14,0,0,14,560,560,138,22,400,0,0,0,0,0,0,0,0,0,92808
30636,24931,2125,4213,8508,6406,3679,1923,1178,1059,109,112,838,119,103,103,0,0,16,0,16,0,745,704,189,111,404,41,6,6,0,0,35,0,0,35,92821
30637,1906,226,165,561,645,309,221,117,117,0,13,104,0,0,0,0,0,0,0,0,0,104,104,10,0,94,0,0,0,0,0,0,0,0,0,92823
30638,20692,2843,3445,6533,4931,2940,2812,1064,1018,157,152,709,46,46,31,0,15,0,0,0,0,1748,1748,502,112,1134,0,0,0,0,0,0,0,0,0,92831
30639,16715,3672,3891,4884,2896,1372,1513,635,541,53,189,299,94,29,13,16,0,65,0,49,16,878,803,102,179,522,75,75,11,13,51,0,0,0,0,92832
30640,33595,4964,6597,9952,8713,3369,3028,1641,1240,118,205,917,401,280,174,96,10,121,49,38,34,1387,1183,144,122,917,204,202,66,89,47,2,0,0,2,92833
30641,16596,733,2275,5329,4911,3348,810,335,335,80,0,255,0,0,0,0,0,0,0,0,0,475,396,57,65,274,79,79,12,0,67,0,0,0,0,92835
30642,34594,9773,8471,10167,4715,1468,3906,2294,2039,227,280,1532,255,185,102,28,55,70,15,25,30,1612,1479,279,59,1141,133,112,25,35,52,21,0,0,21,92840
30643,21846,5631,5698,6442,3094,981,1866,1137,979,174,84,721,158,148,69,20,59,10,10,0,0,729,635,123,76,436,94,68,34,0,34,26,9,0,17,92841
30644,27449,9966,6683,7070,2962,768,3111,1391,1234,174,90,970,157,146,62,69,15,11,0,0,11,1720,1608,326,101,1181,112,77,58,7,12,35,17,18,0,92843
30645,16470,4666,4035,4599,2559,611,1472,774,734,74,38,622,40,14,0,0,14,26,10,0,16,698,593,97,15,481,105,85,33,0,52,20,0,9,11,92844
30646,11631,805,2517,4691,2595,1023,1034,550,494,74,32,388,56,47,14,10,23,9,0,0,9,484,446,176,10,260,38,18,18,0,0,20,6,14,0,92845
30647,18791,3503,5110,6809,2224,1145,1407,708,623,21,16,586,85,69,26,16,27,16,11,5,0,699,622,106,39,477,77,69,49,18,2,8,0,0,8,92860
30648,4251,165,565,1194,1276,1051,357,208,208,54,0,154,0,0,0,0,0,0,0,0,0,149,144,24,0,120,5,5,5,0,0,0,0,0,0,92861
30649,12714,1639,2856,3547,3047,1625,1249,704,603,158,48,397,101,62,36,21,5,39,35,0,4,545,449,57,6,386,96,96,88,8,0,0,0,0,0,92865
30650,10404,2132,1848,3725,1849,850,601,190,88,15,0,73,102,38,10,28,0,64,53,0,11,411,317,58,30,229,94,74,6,0,68,20,0,0,20,92866
30651,27516,4856,5089,8536,5621,3414,3536,1789,1624,189,79,1356,165,104,13,0,91,61,10,32,19,1747,1623,220,70,1333,124,116,24,37,55,8,8,0,0,92867
30652,17399,3628,4486,4870,3030,1385,1534,771,455,118,0,337,316,165,0,59,106,151,0,0,151,763,624,64,44,516,139,128,108,0,20,11,0,0,11,92868
30653,26437,4380,4329,8091,5957,3680,2015,992,813,203,37,573,179,123,82,32,9,56,46,0,10,1023,1001,193,43,765,22,22,22,0,0,0,0,0,0,92869
30654,34340,5491,6005,11146,7770,3928,2690,1333,1220,201,174,845,113,60,6,17,37,53,14,0,39,1357,1228,238,23,967,129,100,40,26,34,29,0,0,29,92870
30655,29127,6972,6832,9787,3955,1581,3643,1843,1507,260,208,1039,336,321,210,24,87,15,0,6,9,1800,1624,158,220,1246,176,121,23,51,47,55,9,8,38,92879
30656,39183,5168,7695,13744,8188,4388,4257,2377,1975,185,181,1609,402,365,270,80,15,37,13,0,24,1880,1706,262,138,1306,174,86,16,43,27,88,0,41,47,92880
30657,19446,2335,4648,7020,3294,2149,2637,1429,1294,151,102,1041,135,96,61,15,20,39,0,31,8,1208,1079,148,160,771,129,79,0,0,79,50,32,0,18,92881
30658,41408,7979,9710,13421,7218,3080,4096,2271,1976,296,166,1514,295,235,74,91,70,60,45,15,0,1825,1704,363,295,1046,121,83,62,16,5,38,0,7,31,92882
30659,19777,1572,4351,7221,4493,2140,1486,738,649,146,66,437,89,89,35,54,0,0,0,0,0,748,494,29,45,420,254,160,41,105,14,94,15,41,38,92883
30660,32358,1641,4469,10952,9510,5786,2720,1312,1209,175,96,938,103,90,39,0,51,13,0,0,13,1408,1355,336,88,931,53,53,21,32,0,0,0,0,0,92886
30661,13285,343,1523,4391,4259,2769,1308,701,671,113,67,491,30,30,0,20,10,0,0,0,0,607,600,117,89,394,7,7,7,0,0,0,0,0,0,92887
30662,22636,3710,4815,7163,4279,2669,1364,708,587,199,83,305,121,84,84,0,0,37,22,15,0,656,604,183,97,324,52,38,23,14,1,14,14,0,0,93001
30663,35197,3116,6408,13437,7479,4757,2537,1345,1130,274,97,759,215,171,65,27,79,44,14,0,30,1192,1099,273,99,727,93,55,45,10,0,38,20,0,18,93003
30664,20248,2063,3907,7960,3870,2448,1493,1007,971,165,105,701,36,20,0,0,20,16,8,0,8,486,459,116,55,288,27,27,15,12,0,0,0,0,0,93004
30665,29708,3285,5215,11058,6296,3854,2277,1214,1031,238,83,710,183,127,53,52,22,56,49,0,7,1063,977,315,111,551,86,33,13,0,20,53,20,0,33,93010
30666,23459,914,3613,7902,6826,4204,2408,841,735,174,47,514,106,106,89,17,0,0,0,0,0,1567,1545,569,61,915,22,22,11,0,11,0,0,0,0,93012
30667,11663,1980,2134,3719,2440,1390,778,425,314,68,113,133,111,0,0,0,0,111,111,0,0,353,336,108,29,199,17,0,0,0,0,17,0,0,17,93013
30668,9886,3225,1873,3169,845,774,1015,539,460,73,58,329,79,56,0,33,23,23,0,23,0,476,441,125,24,292,35,19,0,15,4,16,0,16,0,93015
30669,22457,2719,3656,7667,5515,2900,2160,1078,1025,380,0,645,53,24,24,0,0,29,4,0,25,1082,906,234,92,580,176,170,105,24,41,6,6,0,0,93021
30670,4895,537,1060,2076,851,371,373,208,178,29,11,138,30,30,14,0,16,0,0,0,0,165,165,43,42,80,0,0,0,0,0,0,0,0,0,93022
30671,14986,1661,2676,5255,3147,2247,966,590,522,76,24,422,68,48,40,0,8,20,20,0,0,376,366,124,5,237,10,10,10,0,0,0,0,0,0,93023
30672,33936,12126,6804,9794,3599,1613,4127,2440,2179,463,103,1613,261,90,81,9,0,171,103,12,56,1687,1479,323,106,1050,208,115,89,0,26,93,56,6,31,93030
30673,46983,22015,10665,10519,3026,758,5590,3145,2416,333,148,1935,729,441,179,78,184,288,174,42,72,2445,1885,382,125,1378,560,366,181,38,147,194,91,27,76,93033
30674,19348,2755,3313,7364,3822,2094,1549,830,596,223,72,301,234,148,113,13,22,86,33,23,30,719,621,158,28,435,98,98,33,26,39,0,0,0,0,93035
30675,25705,7722,5871,7367,3453,1292,3014,1467,1233,114,90,1029,234,154,132,0,22,80,35,0,45,1547,1472,381,102,989,75,20,20,0,0,55,35,0,20,93036
30676,1077,450,243,309,45,30,126,79,69,0,8,61,10,10,10,0,0,0,0,0,0,47,47,16,0,31,0,0,0,0,0,0,0,0,0,93040
30677,14668,2945,3422,5416,1764,1121,1709,899,567,250,70,247,332,318,255,9,54,14,14,0,0,810,626,120,47,459,184,184,153,0,31,0,0,0,0,93041
30678,27,9,0,11,0,7,15,15,11,11,0,0,4,4,4,0,0,0,0,0,0,0,0,0,0,0,0,0,0,0,0,0,0,0,0,93042
30679,0,0,0,0,0,0,0,0,0,0,0,0,0,0,0,0,0,0,0,0,0,0,0,0,0,0,0,0,0,0,0,0,0,0,0,93043
30680,19386,6794,4285,5609,1730,968,2174,1136,884,244,59,581,252,131,54,12,65,121,105,5,11,1038,918,187,125,606,120,76,38,6,32,44,0,0,44,93060
30681,37466,2943,8064,14516,8900,3043,3274,1863,1720,349,135,1236,143,143,41,63,39,0,0,0,0,1411,1337,295,99,943,74,26,20,6,0,48,0,0,48,93063
30682,0,0,0,0,0,0,0,0,0,0,0,0,0,0,0,0,0,0,0,0,0,0,0,0,0,0,0,0,0,0,0,0,0,0,0,93064
30683,48195,5606,10100,16880,9912,5697,4039,1991,1776,379,142,1255,215,148,86,0,62,67,38,13,16,2048,1739,546,137,1056,309,198,108,19,71,111,45,22,44,93065
30684,2225,330,337,680,575,303,156,113,113,30,33,50,0,0,0,0,0,0,0,0,0,43,43,11,0,32,0,0,0,0,0,0,0,0,0,93066
30685,502,0,13,199,207,83,0,0,0,0,0,0,0,0,0,0,0,0,0,0,0,0,0,0,0,0,0,0,0,0,0,0,0,0,0,93067
30686,20680,5082,3235,5434,4167,2762,1530,797,606,243,48,315,191,126,42,38,46,65,54,0,11,733,534,161,62,311,199,178,111,16,51,21,0,0,21,93101
30687,13939,3312,2424,3764,2884,1555,1106,583,488,59,161,268,95,56,30,0,26,39,39,0,0,523,486,163,78,245,37,37,26,11,0,0,0,0,0,93103
30688,18771,1127,2281,5310,5311,4742,1146,568,539,42,147,350,29,0,0,0,0,29,28,0,1,578,456,151,25,280,122,122,112,0,10,0,0,0,0,93105
30689,7786,164,523,1970,2770,2359,1164,514,487,158,12,317,27,27,9,9,9,0,0,0,0,650,650,139,49,462,0,0,0,0,0,0,0,0,0,93108
30690,7264,298,450,2178,2250,2088,709,347,342,146,0,196,5,0,0,0,0,5,5,0,0,362,336,167,0,169,26,26,26,0,0,0,0,0,0,93109
30691,12546,1415,1713,3432,3495,2491,866,485,402,27,55,320,83,30,10,0,20,53,41,0,12,381,362,94,45,223,19,19,9,0,10,0,0,0,0,93110
30692,12409,1452,1794,3319,3011,2833,954,497,497,133,73,291,0,0,0,0,0,0,0,0,0,457,421,69,86,266,36,20,0,20,0,16,0,14,2,93111
30693,21357,2867,3066,5602,4865,4957,10319,4822,4709,1090,545,3074,113,51,40,0,11,62,61,0,1,5497,5231,1503,467,3261,266,179,96,0,83,87,0,0,87,93117
30694,526,258,134,106,17,11,61,35,32,0,0,32,3,3,3,0,0,0,0,0,0,26,12,0,4,8,14,14,0,0,14,0,0,0,0,93201
30695,2020,767,701,467,36,49,322,153,143,23,25,95,10,10,0,10,0,0,0,0,0,169,149,0,0,149,20,20,20,0,0,0,0,0,0,93202
30696,10133,6306,1923,1544,309,51,1700,898,563,112,81,370,335,115,74,10,31,220,92,0,128,802,668,60,0,608,134,122,48,35,39,12,0,0,12,93203
30697,8820,4895,2076,1500,295,54,813,386,222,21,64,137,164,32,5,0,27,132,103,16,13,427,279,23,43,213,148,20,15,0,5,128,25,0,103,93204
30698,1776,320,410,773,163,110,91,35,35,0,0,35,0,0,0,0,0,0,0,0,0,56,36,0,0,36,20,20,20,0,0,0,0,0,0,93205
30699,1253,570,298,337,37,11,159,66,48,5,4,39,18,18,10,0,8,0,0,0,0,93,79,14,9,56,14,9,0,0,9,5,0,0,5,93206
30700,233,56,56,85,16,20,9,4,4,0,0,4,0,0,0,0,0,0,0,0,0,5,5,0,0,5,0,0,0,0,0,0,0,0,0,93207
30701,142,10,23,89,0,20,0,0,0,0,0,0,0,0,0,0,0,0,0,0,0,0,0,0,0,0,0,0,0,0,0,0,0,0,0,93208
30702,14252,4554,3549,4667,822,660,1163,643,500,128,39,333,143,99,47,13,39,44,0,0,44,520,463,47,55,361,57,29,0,0,29,28,13,0,15,93210
30703,18373,8012,4698,5074,419,170,1157,587,376,18,58,300,211,119,38,46,35,92,24,0,68,570,434,48,0,386,136,128,50,52,26,8,8,0,0,93212
30704,32446,15273,9061,5944,1709,459,3775,1997,1429,208,172,1049,568,280,127,31,122,288,68,14,206,1778,1483,154,135,1194,295,155,91,29,35,140,7,15,118,93215
30705,440,199,111,91,30,9,61,33,17,0,5,12,16,5,5,0,0,11,11,0,0,28,28,0,0,28,0,0,0,0,0,0,0,0,0,93218
30706,4427,2886,849,612,45,35,730,280,162,1,17,144,118,45,21,24,0,73,43,22,8,450,370,0,31,339,80,6,6,0,0,74,0,0,74,93219
30707,114,62,52,0,0,0,16,9,0,0,0,0,9,9,9,0,0,0,0,0,0,7,0,0,0,0,7,7,0,7,0,0,0,0,0,93220
30708,9228,1927,2243,3392,1165,501,1029,655,567,100,50,417,88,86,8,64,14,2,2,0,0,374,364,54,52,258,10,10,0,10,0,0,0,0,0,93221
30709,1217,45,247,582,257,86,63,29,18,0,9,9,11,11,11,0,0,0,0,0,0,34,34,10,0,24,0,0,0,0,0,0,0,0,0,93222
30710,5561,2825,1273,1271,111,81,862,503,385,66,20,299,118,52,0,27,25,66,14,32,20,359,339,35,28,276,20,20,10,0,10,0,0,0,0,93223
30711,305,47,119,114,20,5,33,17,15,1,3,11,2,2,2,0,0,0,0,0,0,16,12,6,0,6,4,0,0,0,0,4,0,0,4,93224
30712,3583,201,1308,1263,572,239,278,173,162,67,4,91,11,11,0,0,11,0,0,0,0,105,80,18,4,58,25,25,25,0,0,0,0,0,0,93225
30713,287,42,75,152,6,12,35,12,12,0,0,12,0,0,0,0,0,0,0,0,0,23,23,0,0,23,0,0,0,0,0,0,0,0,0,93226
30714,39979,8579,10107,14578,4822,1893,4010,2099,1753,280,238,1235,346,203,108,79,16,143,30,4,109,1911,1560,320,240,1000,351,265,135,57,73,86,12,0,74,93230
30715,3143,2281,450,353,36,23,515,244,198,8,29,161,46,0,0,0,0,46,46,0,0,271,209,18,0,191,62,20,0,20,0,42,18,0,24,93234
30716,1999,1243,395,290,71,0,397,180,115,0,25,90,65,40,40,0,0,25,25,0,0,217,149,0,0,149,68,68,0,68,0,0,0,0,0,93235
30717,1351,63,429,457,286,116,77,39,31,0,0,31,8,0,0,0,0,8,0,0,8,38,38,36,0,2,0,0,0,0,0,0,0,0,0,93238
30718,972,535,236,117,83,1,122,38,38,0,0,38,0,0,0,0,0,0,0,0,0,84,76,30,0,46,8,8,0,0,8,0,0,0,0,93239
30719,4057,367,1589,1555,333,213,102,60,37,10,0,27,23,23,0,23,0,0,0,0,0,42,42,0,0,42,0,0,0,0,0,0,0,0,0,93240
30720,9142,5922,1897,1154,86,83,1567,930,659,130,12,517,271,39,0,23,16,232,218,0,14,637,602,91,23,488,35,27,0,5,22,8,0,0,8,93241
30721,1924,628,509,550,142,95,221,79,79,8,4,67,0,0,0,0,0,0,0,0,0,142,118,19,0,99,24,24,0,19,5,0,0,0,0,93242
30722,735,97,309,285,41,3,182,101,76,0,65,11,25,25,25,0,0,0,0,0,0,81,39,0,0,39,42,42,29,13,0,0,0,0,0,93243
30723,236,27,84,78,35,12,12,0,0,0,0,0,0,0,0,0,0,0,0,0,0,12,12,0,0,12,0,0,0,0,0,0,0,0,0,93244
30724,20152,3248,5245,7770,2952,937,2193,1162,729,52,70,607,433,344,312,14,18,89,0,44,45,1031,822,96,149,577,209,155,104,24,27,54,51,0,3,93245
30725,9722,4373,2080,2553,469,247,1632,850,646,84,164,398,204,107,19,71,17,97,50,32,15,782,648,60,94,494,134,77,53,8,16,57,0,0,57,93247
30726,1091,779,236,76,0,0,127,59,40,0,0,40,19,13,8,5,0,6,6,0,0,68,30,0,0,30,38,12,7,0,5,26,0,0,26,93249
30727,6599,3851,1542,963,158,85,936,539,402,58,20,324,137,56,14,12,30,81,37,33,11,397,256,48,0,208,141,134,14,32,88,7,0,0,7,93250
30728,135,55,29,40,11,0,27,20,15,0,0,15,5,0,0,0,0,5,0,0,5,7,7,7,0,0,0,0,0,0,0,0,0,0,0,93251
30729,3053,1182,1251,518,79,23,110,64,45,9,0,36,19,17,0,0,17,2,0,0,2,46,40,9,0,31,6,6,0,6,0,0,0,0,0,93252
30730,379,119,73,109,51,27,16,9,9,0,4,5,0,0,0,0,0,0,0,0,0,7,7,0,4,3,0,0,0,0,0,0,0,0,0,93254
30731,571,33,191,248,57,42,0,0,0,0,0,0,0,0,0,0,0,0,0,0,0,0,0,0,0,0,0,0,0,0,0,0,0,0,0,93255
30732,2590,1582,596,344,68,0,427,215,111,0,23,88,104,47,15,32,0,57,57,0,0,212,157,0,3,154,55,55,0,0,55,0,0,0,0,93256
30733,42780,15028,10249,13337,2982,1184,5485,3090,2399,273,131,1995,691,428,136,82,210,263,117,15,131,2395,2040,331,167,1542,355,297,73,64,160,58,56,0,2,93257
30734,904,530,184,161,13,16,130,61,61,0,0,61,0,0,0,0,0,0,0,0,0,69,57,0,0,57,12,12,0,12,0,0,0,0,0,93258
30735,152,28,46,60,12,6,0,0,0,0,0,0,0,0,0,0,0,0,0,0,0,0,0,0,0,0,0,0,0,0,0,0,0,0,0,93260
30736,1513,1017,239,178,79,0,343,185,126,34,7,85,59,33,11,8,14,26,7,13,6,158,144,18,0,126,14,8,4,4,0,6,0,6,0,93261
30737,30,14,16,0,0,0,0,0,0,0,0,0,0,0,0,0,0,0,0,0,0,0,0,0,0,0,0,0,0,0,0,0,0,0,0,93262
30738,10616,4460,3025,2355,576,200,1372,813,649,134,21,494,164,109,26,18,65,55,46,2,7,559,464,42,17,405,95,95,52,21,22,0,0,0,0,93263
30739,2333,169,425,1249,368,122,185,102,97,41,0,56,5,0,0,0,0,5,0,0,5,83,26,0,0,26,57,57,45,12,0,0,0,0,0,93265
30740,700,358,236,100,6,0,171,108,93,22,13,58,15,15,15,0,0,0,0,0,0,63,63,19,0,44,0,0,0,0,0,0,0,0,0,93266
30741,3874,1573,910,1165,168,58,361,224,163,3,2,158,61,3,3,0,0,58,58,0,0,137,131,0,0,131,6,0,0,0,0,6,0,0,6,93267
30742,9923,2490,3076,3569,486,302,1137,531,425,93,8,324,106,95,62,33,0,11,0,0,11,606,561,131,55,375,45,45,22,0,23,0,0,0,0,93268
30743,3081,1632,546,659,173,71,528,174,165,21,0,144,9,9,0,9,0,0,0,0,0,354,299,24,51,224,55,23,23,0,0,32,0,9,23,93270
30744,1756,70,423,647,376,240,79,45,34,18,0,16,11,5,0,0,5,6,0,6,0,34,34,13,0,21,0,0,0,0,0,0,0,0,0,93271
30745,1633,934,365,283,27,24,237,74,56,2,6,48,18,0,0,0,0,18,7,0,11,163,136,14,10,112,27,27,0,0,27,0,0,0,0,93272
30746,40141,11695,12199,11846,3130,1271,4483,2023,1593,170,269,1154,430,320,146,94,80,110,46,3,61,2460,2114,419,80,1615,346,214,56,101,57,132,59,11,62,93274
30747,68,26,26,16,0,0,17,5,0,0,0,0,5,5,5,0,0,0,0,0,0,12,12,5,0,7,0,0,0,0,0,0,0,0,0,93276
30748,32619,4517,8320,12931,4631,2220,3025,1547,1311,324,74,913,236,125,21,55,49,111,62,26,23,1478,1371,260,123,988,107,90,46,11,33,17,17,0,0,93277
30749,15549,7131,4769,2925,440,284,1811,878,525,61,52,412,353,151,102,7,42,202,59,4,139,933,683,73,38,572,250,145,64,11,70,105,0,11,94,93280
30750,1891,360,735,551,181,64,125,44,0,0,0,0,44,0,0,0,0,44,0,0,44,81,81,0,0,81,0,0,0,0,0,0,0,0,0,93283
30751,1507,201,325,830,68,83,79,30,30,0,0,30,0,0,0,0,0,0,0,0,0,49,49,0,17,32,0,0,0,0,0,0,0,0,0,93285
30752,5288,2047,1008,1718,360,155,635,360,319,59,44,216,41,20,17,3,0,21,21,0,0,275,230,53,29,148,45,39,21,0,18,6,0,0,6,93286
30753,106,3,60,32,11,0,0,0,0,0,0,0,0,0,0,0,0,0,0,0,0,0,0,0,0,0,0,0,0,0,0,0,0,0,0,93287
30754,31336,8590,6647,8955,3938,3206,3330,1734,1236,150,165,921,498,336,161,23,152,162,70,21,71,1596,1335,216,113,1006,261,193,110,24,59,68,61,0,7,93291
30755,22967,4240,5522,9436,2435,1334,2511,1565,1403,86,133,1184,162,93,31,14,48,69,18,3,48,946,882,200,40,642,64,60,11,0,49,4,0,0,4,93292
30756,7140,1898,2109,2299,513,321,499,93,76,9,10,57,17,0,0,0,0,17,0,0,17,406,294,81,56,157,112,103,31,19,53,9,0,0,9,93301
30757,29446,10418,8529,8110,1551,838,3675,1929,1370,103,174,1093,559,385,137,142,106,174,52,10,112,1746,1352,194,131,1027,394,330,94,63,173,64,17,0,47,93304
30758,19626,8138,5014,4960,1015,499,2513,1446,964,62,116,786,482,285,169,40,76,197,25,73,99,1067,666,112,53,501,401,159,17,48,94,242,99,12,131,93305
30759,39083,9698,9352,13307,4345,2381,4441,2067,1516,203,99,1214,551,286,166,88,32,265,140,30,95,2374,1956,377,350,1229,418,279,56,66,157,139,6,0,133,93306
30760,42659,20375,11547,8937,1340,460,6545,3336,2484,231,568,1685,852,689,243,274,172,163,50,65,48,3209,2644,439,264,1941,565,440,182,92,166,125,0,30,95,93307
30761,33332,6071,10462,12008,3247,1544,3019,1682,1131,174,68,889,551,332,239,44,49,219,0,0,219,1337,1055,149,45,861,282,178,57,72,49,104,22,24,58,93308
30762,36240,6325,10420,12660,4368,2467,3845,2077,1598,227,42,1329,479,422,158,167,97,57,0,0,57,1768,1409,253,107,1049,359,358,189,41,128,1,0,0,1,93309
30763,25313,2346,4971,8875,5779,3342,2822,1598,1483,145,76,1262,115,82,60,15,7,33,19,0,14,1224,1143,268,24,851,81,81,17,13,51,0,0,0,0,93311
30764,34037,2440,6946,14176,7186,3289,3369,1742,1467,252,146,1069,275,199,98,35,66,76,11,0,65,1627,1448,426,93,929,179,171,69,31,71,8,0,0,8,93312
30765,25484,6459,6992,8462,2595,976,3276,1859,1522,243,94,1185,337,205,115,24,66,132,76,0,56,1417,1029,274,181,574,388,380,209,42,129,8,0,0,8,93313
30766,14345,1614,3122,5322,2784,1503,1643,723,632,120,27,485,91,77,77,0,0,14,0,0,14,920,889,163,98,628,31,31,31,0,0,0,0,0,0,93314
30767,17371,1066,2633,5480,5087,3105,1399,652,599,166,80,353,53,53,21,0,32,0,0,0,0,747,676,223,34,419,71,71,32,39,0,0,0,0,0,93401
30768,10870,579,1769,4441,2592,1489,638,309,282,17,14,251,27,19,0,19,0,8,0,0,8,329,329,65,12,252,0,0,0,0,0,0,0,0,0,93402
30769,14049,2359,2916,3952,2870,1952,7583,3864,3821,593,223,3005,43,19,0,0,19,24,0,0,24,3719,3704,957,249,2498,15,15,15,0,0,0,0,0,0,93405
30770,0,0,0,0,0,0,0,0,0,0,0,0,0,0,0,0,0,0,0,0,0,0,0,0,0,0,0,0,0,0,0,0,0,0,0,93410
30771,22016,1377,4498,8633,4521,2987,1685,789,699,122,47,530,90,47,0,47,0,43,43,0,0,896,823,338,85,400,73,73,0,15,58,0,0,0,0,93420
30772,22143,1846,4858,9080,4373,1986,1437,976,807,176,52,579,169,138,58,50,30,31,14,17,0,461,418,103,20,295,43,43,27,0,16,0,0,0,0,93422
30773,798,0,127,280,202,189,55,55,25,25,0,0,30,30,30,0,0,0,0,0,0,0,0,0,0,0,0,0,0,0,0,0,0,0,0,93424
30774,972,97,305,387,140,43,109,89,87,77,0,10,2,2,2,0,0,0,0,0,0,20,18,3,0,15,2,2,2,0,0,0,0,0,0,93426
30775,3792,752,736,1325,620,359,207,139,76,24,0,52,63,63,46,0,17,0,0,0,0,68,53,15,12,26,15,15,15,0,0,0,0,0,0,93427
30776,5138,477,778,1557,1344,982,133,96,89,0,5,84,7,7,0,0,7,0,0,0,0,37,31,9,0,22,6,6,6,0,0,0,0,0,0,93428
30777,83,43,23,17,0,0,11,0,0,0,0,0,0,0,0,0,0,0,0,0,0,11,11,11,0,0,0,0,0,0,0,0,0,0,0,93429
30778,2313,197,379,825,508,404,68,26,26,0,0,26,0,0,0,0,0,0,0,0,0,42,42,0,27,15,0,0,0,0,0,0,0,0,0,93430
30779,720,100,138,261,198,23,26,26,26,0,0,26,0,0,0,0,0,0,0,0,0,0,0,0,0,0,0,0,0,0,0,0,0,0,0,93432
30780,9181,1408,2356,3546,1313,558,652,317,225,10,46,169,92,75,75,0,0,17,0,17,0,335,269,73,0,196,66,45,13,9,23,21,0,21,0,93433
30781,4070,2157,696,978,194,45,446,296,207,35,25,147,89,38,38,0,0,51,16,18,17,150,102,35,7,60,48,31,7,7,17,17,0,0,17,93434
30782,34056,7827,8747,11659,3815,2008,3186,1615,1218,177,87,954,397,270,108,101,61,127,119,0,8,1571,1361,242,192,927,210,150,12,70,68,60,15,39,6,93436
30783,1569,63,187,904,259,156,119,75,16,8,0,8,59,44,44,0,0,15,15,0,0,44,28,0,0,28,16,16,0,0,16,0,0,0,0,93437
30784,1098,143,235,461,172,87,99,61,51,12,0,39,10,10,0,10,0,0,0,0,0,38,28,0,0,28,10,10,0,10,0,0,0,0,0,93440
30785,932,74,131,347,198,182,83,55,55,2,30,23,0,0,0,0,0,0,0,0,0,28,19,8,0,11,9,9,9,0,0,0,0,0,0,93441
30786,8684,730,1549,3359,1809,1237,215,156,156,19,33,104,0,0,0,0,0,0,0,0,0,59,42,4,0,38,17,17,0,0,17,0,0,0,0,93442
30787,12870,1727,2916,4446,2394,1387,1195,635,591,74,127,390,44,42,19,8,15,2,0,0,2,560,472,187,32,253,88,88,11,8,69,0,0,0,0,93444
30788,4774,1421,1139,1629,407,178,328,191,114,0,0,114,77,20,2,10,8,57,48,0,9,137,81,45,0,36,56,55,41,0,14,1,0,0,1,93445
30789,29470,3712,6949,12021,4357,2431,2126,1104,971,250,90,631,133,79,35,26,18,54,24,11,19,1022,839,203,45,591,183,135,35,57,43,48,28,20,0,93446
30790,6025,263,1076,2463,1333,890,105,92,75,13,0,62,17,17,0,17,0,0,0,0,0,13,13,8,0,5,0,0,0,0,0,0,0,0,0,93449
30791,407,277,69,30,20,11,56,37,37,0,0,37,0,0,0,0,0,0,0,0,0,19,19,0,0,19,0,0,0,0,0,0,0,0,0,93450
30792,2704,553,727,869,409,146,246,76,73,17,18,38,3,3,3,0,0,0,0,0,0,170,170,43,38,89,0,0,0,0,0,0,0,0,0,93451
30793,405,56,166,173,0,10,36,26,26,0,0,26,0,0,0,0,0,0,0,0,0,10,10,0,10,0,0,0,0,0,0,0,0,0,0,93452
30794,2358,141,615,1059,345,198,220,81,81,19,0,62,0,0,0,0,0,0,0,0,0,139,139,0,0,139,0,0,0,0,0,0,0,0,0,93453
30795,22693,6644,4700,7609,2569,1171,2129,1061,883,62,56,765,178,132,79,30,23,46,0,0,46,1068,883,126,96,661,185,53,53,0,0,132,90,15,27,93454
30796,29117,3185,5935,12095,5112,2790,2361,1031,965,202,120,643,66,47,33,0,14,19,0,0,19,1330,1300,239,85,976,30,11,0,0,11,19,0,10,9,93455
30797,28778,15309,5442,6161,1501,365,3861,2082,1518,194,61,1263,564,194,147,31,16,370,301,50,19,1779,1431,118,71,1242,348,113,62,0,51,235,107,7,121,93458
30798,3985,356,675,1369,1144,441,322,188,170,118,0,52,18,18,0,0,18,0,0,0,0,134,131,35,24,72,3,3,0,3,0,0,0,0,0,93460
30799,1027,217,289,388,89,44,86,52,49,10,0,39,3,3,3,0,0,0,0,0,0,34,27,12,0,15,7,7,7,0,0,0,0,0,0,93461
30800,6191,669,1118,1826,1544,1034,278,189,189,62,0,127,0,0,0,0,0,0,0,0,0,89,89,41,0,48,0,0,0,0,0,0,0,0,0,93463
30801,6702,492,1604,2353,1402,851,301,203,203,127,10,66,0,0,0,0,0,0,0,0,0,98,98,67,17,14,0,0,0,0,0,0,0,0,0,93465
30802,3307,920,1111,1066,155,55,275,120,88,0,6,82,32,21,6,15,0,11,11,0,0,155,93,3,0,90,62,56,6,50,0,6,0,0,6,93501
30803,8959,1895,2688,3297,631,448,775,307,280,45,77,158,27,3,0,0,3,24,0,0,24,468,398,0,44,354,70,49,28,21,0,21,0,0,21,93505
30804,4958,585,1289,1883,737,464,504,313,225,48,23,154,88,88,40,48,0,0,0,0,0,191,178,16,8,154,13,13,13,0,0,0,0,0,0,93510
30805,123,42,25,56,0,0,0,0,0,0,0,0,0,0,0,0,0,0,0,0,0,0,0,0,0,0,0,0,0,0,0,0,0,0,0,93512
30806,1161,108,392,481,93,87,53,47,47,44,0,3,0,0,0,0,0,0,0,0,0,6,6,0,0,6,0,0,0,0,0,0,0,0,0,93513
30807,10438,1171,3112,3733,1520,902,582,273,259,97,19,143,14,14,3,5,6,0,0,0,0,309,267,109,24,134,42,19,0,0,19,23,0,23,0,93514
30808,1497,386,507,446,118,40,172,102,102,0,32,70,0,0,0,0,0,0,0,0,0,70,70,5,0,65,0,0,0,0,0,0,0,0,0,93516
30809,496,70,95,258,37,36,70,70,70,33,37,0,0,0,0,0,0,0,0,0,0,0,0,0,0,0,0,0,0,0,0,0,0,0,0,93517
30810,918,104,257,406,71,80,27,24,16,0,0,16,8,4,0,0,4,4,0,0,4,3,3,0,0,3,0,0,0,0,0,0,0,0,0,93518
30811,89,44,0,23,22,0,0,0,0,0,0,0,0,0,0,0,0,0,0,0,0,0,0,0,0,0,0,0,0,0,0,0,0,0,0,93519
30812,15,7,0,0,0,8,0,0,0,0,0,0,0,0,0,0,0,0,0,0,0,0,0,0,0,0,0,0,0,0,0,0,0,0,0,93522
30813,1524,123,315,593,298,195,51,14,5,0,0,5,9,9,9,0,0,0,0,0,0,37,29,0,0,29,8,8,0,0,8,0,0,0,0,93523
30814,74,6,52,13,3,0,29,29,17,17,0,0,12,12,12,0,0,0,0,0,0,0,0,0,0,0,0,0,0,0,0,0,0,0,0,93524
30815,562,29,136,231,128,38,37,19,0,0,0,0,19,13,13,0,0,6,0,0,6,18,12,8,0,4,6,6,0,0,6,0,0,0,0,93526
30816,1556,280,223,477,432,144,113,77,15,0,0,15,62,0,0,0,0,62,0,0,62,36,19,0,0,19,17,0,0,0,0,17,17,0,0,93527
30817,49,17,13,19,0,0,0,0,0,0,0,0,0,0,0,0,0,0,0,0,0,0,0,0,0,0,0,0,0,0,0,0,0,0,0,93528
30818,355,0,34,189,132,0,0,0,0,0,0,0,0,0,0,0,0,0,0,0,0,0,0,0,0,0,0,0,0,0,0,0,0,0,0,93529
30819,39,7,0,0,9,23,0,0,0,0,0,0,0,0,0,0,0,0,0,0,0,0,0,0,0,0,0,0,0,0,0,0,0,0,0,93530
30820,352,26,35,95,15,181,12,12,12,0,0,12,0,0,0,0,0,0,0,0,0,0,0,0,0,0,0,0,0,0,0,0,0,0,0,93531
30821,1608,112,418,654,262,162,296,179,167,0,0,167,12,5,0,0,5,7,0,0,7,117,98,36,0,62,19,19,0,19,0,0,0,0,0,93532
30822,24566,5072,7085,9303,2162,944,2202,1065,826,57,46,723,239,146,69,10,67,93,21,0,72,1137,961,146,79,736,176,130,46,55,29,46,38,0,8,93534
30823,41282,10305,12999,13665,2961,1352,5706,2817,2326,306,142,1878,491,410,161,68,181,81,40,28,13,2889,2499,338,89,2072,390,321,136,42,143,69,21,23,25,93535
30824,45211,6605,11890,17076,5944,3696,4540,2627,2247,139,260,1848,380,205,65,16,124,175,9,0,166,1913,1763,333,115,1315,150,139,6,13,120,11,0,0,11,93536
30825,396,0,110,103,35,148,0,0,0,0,0,0,0,0,0,0,0,0,0,0,0,0,0,0,0,0,0,0,0,0,0,0,0,0,0,93541
30826,7909,2885,2019,2222,547,236,1038,481,371,13,11,347,110,76,76,0,0,34,34,0,0,557,434,22,32,380,123,123,95,0,28,0,0,0,0,93543
30827,804,141,239,307,117,0,9,0,0,0,0,0,0,0,0,0,0,0,0,0,0,9,9,0,0,9,0,0,0,0,0,0,0,0,0,93544
30828,1456,229,622,465,83,57,158,114,91,0,0,91,23,23,20,3,0,0,0,0,0,44,33,0,0,33,11,3,3,0,0,8,0,8,0,93545
30829,6412,1250,1211,1808,1393,750,559,355,260,104,30,126,95,0,0,0,0,95,95,0,0,204,187,146,15,26,17,0,0,0,0,17,0,17,0,93546
30830,249,19,38,136,38,18,18,18,18,0,0,18,0,0,0,0,0,0,0,0,0,0,0,0,0,0,0,0,0,0,0,0,0,0,0,93549
30831,39538,13252,10662,12245,2561,818,5260,2394,1940,185,121,1634,454,321,83,70,168,133,11,28,94,2866,2415,232,277,1906,451,299,102,62,135,152,39,34,79,93550
30832,31785,3562,6563,12778,5656,3226,3662,1807,1648,144,101,1403,159,150,79,38,33,9,0,0,9,1855,1664,231,70,1363,191,137,44,32,61,54,0,0,54,93551
30833,21298,6324,5371,7474,1527,602,3596,1558,1350,101,46,1203,208,153,43,69,41,55,10,11,34,2038,1903,225,43,1635,135,87,39,31,17,48,0,0,48,93552
30834,1766,274,485,857,116,34,168,116,96,0,0,96,20,11,11,0,0,9,0,9,0,52,52,8,0,44,0,0,0,0,0,0,0,0,0,93553
30835,116,0,54,62,0,0,0,0,0,0,0,0,0,0,0,0,0,0,0,0,0,0,0,0,0,0,0,0,0,0,0,0,0,0,0,93554
30836,20994,2152,4455,8538,3810,2039,1664,682,557,120,74,363,125,104,58,0,46,21,0,12,9,982,924,189,68,667,58,38,37,0,1,20,0,20,0,93555
30837,249,47,95,107,0,0,0,0,0,0,0,0,0,0,0,0,0,0,0,0,0,0,0,0,0,0,0,0,0,0,0,0,0,0,0,93558
30838,11854,2390,3532,4525,955,452,1239,513,452,26,11,415,61,61,47,14,0,0,0,0,0,726,639,43,42,554,87,67,23,0,44,20,0,0,20,93560
30839,24254,3737,6826,9813,2364,1514,2141,1159,1034,327,100,607,125,29,0,14,15,96,11,19,66,982,854,179,0,675,128,60,6,3,51,68,0,39,29,93561
30840,1220,243,453,425,53,46,32,12,12,0,0,12,0,0,0,0,0,0,0,0,0,20,16,0,0,16,4,4,0,4,0,0,0,0,0,93562
30841,325,74,66,93,18,74,12,12,12,0,0,12,0,0,0,0,0,0,0,0,0,0,0,0,0,0,0,0,0,0,0,0,0,0,0,93563
30842,3876,1018,1210,1123,320,205,646,258,258,8,8,242,0,0,0,0,0,0,0,0,0,388,388,36,57,295,0,0,0,0,0,0,0,0,0,93591
30843,16,9,7,0,0,0,0,0,0,0,0,0,0,0,0,0,0,0,0,0,0,0,0,0,0,0,0,0,0,0,0,0,0,0,0,93592
30844,1418,154,386,629,120,129,81,25,25,0,0,25,0,0,0,0,0,0,0,0,0,56,56,50,0,6,0,0,0,0,0,0,0,0,0,93601
30845,2905,259,699,1349,409,189,189,124,108,17,0,91,16,16,0,0,16,0,0,0,0,65,65,0,0,65,0,0,0,0,0,0,0,0,0,93602
30846,260,97,55,52,56,0,0,0,0,0,0,0,0,0,0,0,0,0,0,0,0,0,0,0,0,0,0,0,0,0,0,0,0,0,0,93603
30847,674,9,118,291,200,56,135,59,59,0,0,59,0,0,0,0,0,0,0,0,0,76,76,0,48,28,0,0,0,0,0,0,0,0,0,93604
30848,181,2,18,113,45,3,10,4,4,4,0,0,0,0,0,0,0,0,0,0,0,6,6,0,0,6,0,0,0,0,0,0,0,0,0,93605
30849,212,109,25,65,6,7,35,28,21,7,0,14,7,0,0,0,0,7,7,0,0,7,7,0,0,7,0,0,0,0,0,0,0,0,0,93606
30850,431,352,45,34,0,0,75,41,41,0,0,41,0,0,0,0,0,0,0,0,0,34,20,0,0,20,14,14,10,0,4,0,0,0,0,93608
30851,3210,1365,1089,587,94,75,539,298,257,33,24,200,41,10,0,10,0,31,31,0,0,241,210,39,23,148,31,31,0,0,31,0,0,0,0,93609
30852,16673,5367,4608,5087,1165,446,1372,702,583,22,57,504,119,119,10,35,74,0,0,0,0,670,520,25,29,466,150,116,39,17,60,34,0,0,34,93610
30853,29685,2881,5504,11462,6557,3281,3309,1592,1403,168,112,1123,189,169,56,25,88,20,20,0,0,1717,1660,300,219,1141,57,46,17,0,29,11,11,0,0,93611
30854,20570,3404,5390,8620,2408,748,2180,1248,1082,209,50,823,166,78,20,8,50,88,34,0,54,932,789,198,27,564,143,142,65,0,77,1,0,0,1,93612
30855,8073,856,2015,3275,1164,763,566,368,302,12,5,285,66,66,32,0,34,0,0,0,0,198,173,29,11,133,25,25,12,0,13,0,0,0,0,93614
30856,2905,1705,456,605,121,18,552,232,163,23,16,124,69,60,0,23,37,9,0,9,0,320,272,59,16,197,48,48,28,0,20,0,0,0,0,93615
30857,1492,675,377,360,77,3,237,160,74,4,0,70,86,62,25,12,25,24,24,0,0,77,71,0,0,71,6,6,0,0,6,0,0,0,0,93616
30858,16320,7281,3656,4126,920,337,1909,983,675,50,110,515,308,279,143,29,107,29,0,0,29,926,683,74,84,525,243,166,9,89,68,77,0,0,77,93618
30859,18776,974,2865,6017,5495,3425,1825,870,831,185,30,616,39,39,19,0,20,0,0,0,0,955,814,182,120,512,141,104,47,19,38,37,0,0,37,93619
30860,5612,2208,1565,1402,359,78,759,438,339,0,26,313,99,99,32,38,29,0,0,0,0,321,288,47,0,241,33,33,17,0,16,0,0,0,0,93620
30861,316,29,130,99,44,14,0,0,0,0,0,0,0,0,0,0,0,0,0,0,0,0,0,0,0,0,0,0,0,0,0,0,0,0,0,93621
30862,4863,2701,937,892,245,88,687,402,363,57,28,278,39,23,0,9,14,16,0,0,16,285,229,24,0,205,56,56,22,0,34,0,0,0,0,93622
30863,51,6,40,5,0,0,0,0,0,0,0,0,0,0,0,0,0,0,0,0,0,0,0,0,0,0,0,0,0,0,0,0,0,0,0,93623
30864,738,504,100,91,43,0,123,75,21,5,2,14,54,36,0,0,36,18,18,0,0,48,35,8,0,27,13,6,0,0,6,7,0,0,7,93624
30865,4344,1483,870,1340,481,170,526,261,253,88,28,137,8,8,8,0,0,0,0,0,0,265,213,34,0,179,52,22,0,0,22,30,0,0,30,93625
30866,660,91,227,163,90,89,23,14,14,9,0,5,0,0,0,0,0,0,0,0,0,9,3,0,0,3,6,6,6,0,0,0,0,0,0,93626
30867,20,0,10,0,0,10,10,10,10,0,0,10,0,0,0,0,0,0,0,0,0,0,0,0,0,0,0,0,0,0,0,0,0,0,0,93627
30868,159,29,34,70,26,0,13,13,13,0,13,0,0,0,0,0,0,0,0,0,0,0,0,0,0,0,0,0,0,0,0,0,0,0,0,93628
30869,10747,4427,2335,2893,828,264,816,422,315,62,18,235,107,107,32,0,75,0,0,0,0,394,331,18,22,291,63,18,11,0,7,45,0,24,21,93630
30870,9974,2185,2448,3072,1517,752,1199,481,433,105,56,272,48,33,33,0,0,15,0,0,15,718,622,109,154,359,96,96,44,0,52,0,0,0,0,93631
30871,0,0,0,0,0,0,0,0,0,0,0,0,0,0,0,0,0,0,0,0,0,0,0,0,0,0,0,0,0,0,0,0,0,0,0,93633
30872,23,12,6,5,0,0,0,0,0,0,0,0,0,0,0,0,0,0,0,0,0,0,0,0,0,0,0,0,0,0,0,0,0,0,0,93634
30873,21991,7588,6020,6287,1529,567,2653,1128,852,68,0,784,276,195,30,126,39,81,16,12,53,1525,1154,288,138,728,371,268,93,68,107,103,0,0,103,93635
30874,7758,839,2006,3046,1502,365,701,335,270,91,21,158,65,65,60,5,0,0,0,0,0,366,310,23,20,267,56,43,24,0,19,13,0,0,13,93636
30875,22881,7222,4998,7667,2172,822,2696,1499,1332,116,86,1130,167,76,0,0,76,91,47,0,44,1197,1063,111,54,898,134,66,21,0,45,68,9,0,59,93637
30876,25855,13722,4982,5380,1324,447,3539,1946,1452,141,38,1273,494,193,127,47,19,301,220,0,81,1593,1255,51,99,1105,338,95,35,41,19,243,93,0,150,93638
30877,6465,4536,1017,790,55,67,735,349,255,27,4,224,94,51,7,25,19,43,43,0,0,386,331,0,39,292,55,0,0,0,0,55,25,17,13,93640
30878,321,70,151,60,14,26,111,59,0,0,0,0,59,59,0,0,59,0,0,0,0,52,52,0,0,52,0,0,0,0,0,0,0,0,0,93641
30879,1857,159,461,824,229,184,94,3,3,0,0,3,0,0,0,0,0,0,0,0,0,91,48,8,0,40,43,43,12,0,31,0,0,0,0,93643
30880,5834,685,1379,2479,865,426,188,188,135,33,0,102,53,53,53,0,0,0,0,0,0,0,0,0,0,0,0,0,0,0,0,0,0,0,0,93644
30881,440,95,71,204,37,33,37,37,37,0,0,37,0,0,0,0,0,0,0,0,0,0,0,0,0,0,0,0,0,0,0,0,0,0,0,93645
30882,5350,3080,1380,662,191,37,837,307,191,15,19,157,116,29,7,22,0,87,0,2,85,530,491,6,16,469,39,17,0,0,17,22,0,0,22,93646
30883,6028,3690,1058,971,255,54,1066,586,407,24,40,343,179,86,66,20,0,93,55,0,38,480,291,0,43,248,189,109,55,54,0,80,0,0,80,93647
30884,8101,4652,1647,1375,331,96,1372,549,402,40,0,362,147,96,66,23,7,51,24,0,27,823,724,71,16,637,99,69,48,0,21,30,30,0,0,93648
30885,2106,720,708,557,101,20,270,190,175,62,6,107,15,0,0,0,0,15,0,0,15,80,65,7,12,46,15,0,0,0,0,15,0,15,0,93650
30886,1404,80,317,638,175,194,127,127,118,17,0,101,9,9,9,0,0,0,0,0,0,0,0,0,0,0,0,0,0,0,0,0,0,0,0,93651
30887,244,155,50,33,4,2,9,9,9,0,0,9,0,0,0,0,0,0,0,0,0,0,0,0,0,0,0,0,0,0,0,0,0,0,0,93652
30888,877,83,239,400,123,32,58,16,16,0,0,16,0,0,0,0,0,0,0,0,0,42,42,24,0,18,0,0,0,0,0,0,0,0,0,93653
30889,17703,6387,3702,4906,1898,810,2377,1336,1116,230,181,705,220,123,55,59,9,97,50,47,0,1041,964,157,120,687,77,36,25,0,11,41,7,13,21,93654
30890,3683,1552,1143,696,259,33,504,310,236,14,19,203,74,22,6,16,0,52,0,15,37,194,194,17,25,152,0,0,0,0,0,0,0,0,0,93656
30891,21217,6723,4606,6673,2253,962,2364,1239,956,205,58,693,283,135,104,12,19,148,101,7,40,1125,988,45,58,885,137,77,29,0,48,60,0,1,59,93657
30892,2232,1528,276,311,117,0,350,189,182,0,4,178,7,7,7,0,0,0,0,0,0,161,137,4,0,133,24,21,0,0,21,3,0,0,3,93660
30893,17887,7228,4074,4624,1273,688,1896,993,735,43,71,621,258,224,143,56,25,34,0,18,16,903,808,91,55,662,95,85,25,13,47,10,0,0,10,93662
30894,505,19,91,251,89,55,33,23,23,0,1,22,0,0,0,0,0,0,0,0,0,10,10,3,0,7,0,0,0,0,0,0,0,0,0,93664
30895,341,161,0,93,87,0,0,0,0,0,0,0,0,0,0,0,0,0,0,0,0,0,0,0,0,0,0,0,0,0,0,0,0,0,0,93665
30896,244,200,21,13,10,0,54,32,21,0,10,11,11,11,11,0,0,0,0,0,0,22,22,4,0,18,0,0,0,0,0,0,0,0,0,93666
30897,1393,224,350,525,201,93,131,108,95,0,0,95,13,10,10,0,0,3,0,0,3,23,23,0,0,23,0,0,0,0,0,0,0,0,0,93667
30898,729,405,132,157,17,18,87,39,39,0,0,39,0,0,0,0,0,0,0,0,0,48,48,0,0,48,0,0,0,0,0,0,0,0,0,93668
30899,199,10,49,109,8,23,0,0,0,0,0,0,0,0,0,0,0,0,0,0,0,0,0,0,0,0,0,0,0,0,0,0,0,0,0,93669
30900,503,331,105,50,17,0,68,27,16,0,0,16,11,4,4,0,0,7,7,0,0,41,17,0,8,9,24,24,19,5,0,0,0,0,0,93673
30901,1926,134,473,898,235,186,38,0,0,0,0,0,0,0,0,0,0,0,0,0,0,38,38,0,0,38,0,0,0,0,0,0,0,0,0,93675
30902,5463,3086,1222,863,218,74,728,357,267,43,24,200,90,17,0,7,10,73,73,0,0,371,264,26,19,219,107,55,15,15,25,52,8,0,44,93701
30903,24468,13541,5809,4198,658,262,4124,2004,1388,124,58,1206,616,281,162,12,107,335,218,28,89,2120,1754,174,65,1515,366,182,26,20,136,184,21,37,126,93702
30904,18550,7119,4567,5533,967,364,2495,1514,1282,182,184,916,232,152,66,39,47,80,20,37,23,981,821,109,50,662,160,108,63,0,45,52,26,14,12,93703
30905,17987,2445,3522,6531,3410,2079,1155,721,549,103,13,433,172,97,55,20,22,75,0,0,75,434,416,36,11,369,18,5,0,0,5,13,0,0,13,93704
30906,22592,6461,6752,6953,1707,719,2226,985,832,37,129,666,153,45,13,22,10,108,50,0,58,1241,1167,108,114,945,74,61,0,9,52,13,3,6,4,93705
30907,20837,8876,5281,5048,1096,536,3227,1738,1254,74,93,1087,484,241,72,76,93,243,39,58,146,1489,1251,113,71,1067,238,200,45,63,92,38,10,0,28,93706
30908,17495,2479,3941,6655,3031,1389,3595,1335,1254,215,180,859,81,50,33,8,9,31,12,19,0,2260,2089,712,191,1186,171,104,8,13,83,67,27,29,11,93710
30909,26686,1253,4857,9730,6797,4049,1912,1012,886,178,136,572,126,101,24,35,42,25,0,0,25,900,818,165,32,621,82,82,67,0,15,0,0,0,0,93711
30910,30717,1767,5373,10344,8573,4660,2325,1080,879,35,132,712,201,146,88,39,19,55,0,42,13,1245,1230,316,133,781,15,15,0,0,15,0,0,0,0,93720
30911,4445,1976,953,1059,266,191,393,129,75,12,15,48,54,31,0,0,31,23,0,0,23,264,213,7,14,192,51,44,22,0,22,7,0,0,7,93721
30912,46353,9621,11574,16588,6268,2302,4611,2440,2023,300,203,1520,417,336,153,88,95,81,26,18,37,2171,1802,288,261,1253,369,240,101,52,87,129,5,9,115,93722
30913,5961,1425,1455,1908,845,328,436,196,196,24,38,134,0,0,0,0,0,0,0,0,0,240,226,0,51,175,14,14,0,0,14,0,0,0,0,93723
30914,13815,5859,3960,3019,696,281,2199,951,860,138,60,662,91,68,35,32,1,23,23,0,0,1248,1008,114,66,828,240,179,0,57,122,61,0,0,61,93725
30915,23587,5735,6073,8105,2462,1212,2591,1313,1149,116,170,863,164,54,9,2,43,110,22,0,88,1278,1151,173,147,831,127,74,0,17,57,53,0,9,44,93726
30916,41555,9413,10015,13757,6233,2137,4398,2389,1983,406,126,1451,406,186,71,29,86,220,53,82,85,2009,1765,186,82,1497,244,148,46,9,93,96,11,9,76,93727
30917,9583,2078,2142,3679,1093,591,1009,541,481,53,11,417,60,38,0,8,30,22,0,0,22,468,426,62,102,262,42,31,19,0,12,11,0,0,11,93728
30918,7031,293,730,2340,2134,1534,647,350,350,92,0,258,0,0,0,0,0,0,0,0,0,297,297,62,11,224,0,0,0,0,0,0,0,0,0,93730
30919,16905,3401,3990,6154,2142,1218,1588,800,626,51,30,545,174,140,56,48,36,34,31,0,3,788,697,144,44,509,91,64,64,0,0,27,15,5,7,93901
30920,31765,19060,6517,4615,1287,286,4514,2494,1779,210,32,1537,715,386,224,22,140,329,177,95,57,2020,1668,171,115,1382,352,230,62,20,148,122,41,30,51,93905
30921,35658,11058,8786,10580,3631,1603,4577,2289,1707,187,171,1349,582,431,88,146,197,151,34,26,91,2288,1873,193,118,1562,415,222,97,50,75,193,101,40,52,93906
30922,14402,3106,3272,5134,2018,872,1094,616,451,49,28,374,165,153,13,0,140,12,0,0,12,478,444,88,16,340,34,34,23,0,11,0,0,0,0,93907
30923,8918,757,1440,2901,2421,1399,578,335,314,64,24,226,21,20,20,0,0,1,0,0,1,243,221,31,15,175,22,22,0,0,22,0,0,0,0,93908
30924,584,71,84,184,140,105,48,38,3,3,0,0,35,35,10,0,25,0,0,0,0,10,10,2,0,8,0,0,0,0,0,0,0,0,0,93920
30925,2396,81,326,489,793,707,94,31,31,0,0,31,0,0,0,0,0,0,0,0,0,63,63,0,0,63,0,0,0,0,0,0,0,0,0,93921
30926,10864,237,1202,3117,3675,2633,401,216,203,0,22,181,13,13,0,13,0,0,0,0,0,185,171,96,8,67,14,14,14,0,0,0,0,0,0,93923
30927,4429,229,640,1405,1261,894,398,217,217,20,16,181,0,0,0,0,0,0,0,0,0,181,128,59,1,68,53,36,36,0,0,17,17,0,0,93924
30928,1033,425,260,188,160,0,113,70,48,0,0,48,22,16,16,0,0,6,0,6,0,43,40,0,2,38,3,3,3,0,0,0,0,0,0,93925
30929,4707,2091,1334,1005,221,56,577,359,221,23,0,198,138,82,19,0,63,56,51,0,5,218,168,34,0,134,50,18,0,0,18,32,32,0,0,93926
30930,9009,4833,1698,1675,681,122,1027,433,248,29,28,191,185,35,0,35,0,150,66,51,33,594,370,56,23,291,224,146,53,15,78,78,20,41,17,93927
30931,125,0,32,39,42,12,10,0,0,0,0,0,0,0,0,0,0,0,0,0,0,10,10,0,0,10,0,0,0,0,0,0,0,0,0,93928
30932,8526,4265,2108,1508,442,203,1188,568,381,27,29,325,187,48,39,0,9,139,31,72,36,620,502,42,0,460,118,17,14,3,0,101,60,0,41,93930
30933,354,30,61,202,32,29,12,12,12,0,0,12,0,0,0,0,0,0,0,0,0,0,0,0,0,0,0,0,0,0,0,0,0,0,0,93932
30934,14475,2447,3264,5070,2259,1435,1256,556,511,146,74,291,45,23,23,0,0,22,0,12,10,700,664,219,18,427,36,4,4,0,0,32,23,0,9,93933
30935,23894,1484,3330,7600,6017,5463,1679,842,706,370,22,314,136,136,130,6,0,0,0,0,0,837,766,281,12,473,71,71,71,0,0,0,0,0,0,93940
30936,0,0,0,0,0,0,0,0,0,0,0,0,0,0,0,0,0,0,0,0,0,0,0,0,0,0,0,0,0,0,0,0,0,0,0,93943
30937,11932,533,1928,3455,3466,2550,499,200,150,44,4,102,50,50,28,12,10,0,0,0,0,299,276,112,15,149,23,23,19,4,0,0,0,0,0,93950
30938,3609,49,247,988,1324,1001,239,129,129,28,19,82,0,0,0,0,0,0,0,0,0,110,108,0,15,93,2,2,2,0,0,0,0,0,0,93953
30939,120,80,9,28,3,0,18,13,9,3,0,6,4,0,0,0,0,4,0,4,0,5,5,0,1,4,0,0,0,0,0,0,0,0,0,93954
30940,20403,5257,3812,6757,2947,1630,2386,1021,982,170,138,674,39,23,0,23,0,16,16,0,0,1365,1243,390,55,798,122,65,51,0,14,57,33,10,14,93955
30941,19093,8943,4808,4654,524,164,939,489,367,105,2,260,122,41,11,25,5,81,0,0,81,450,392,28,18,346,58,58,58,0,0,0,0,0,0,93960
30942,564,65,62,217,185,35,14,0,0,0,0,0,0,0,0,0,0,0,0,0,0,14,14,0,0,14,0,0,0,0,0,0,0,0,0,93962
30943,19234,927,2404,5314,5819,4770,1083,689,648,136,53,459,41,41,41,0,0,0,0,0,0,394,382,125,15,242,12,12,0,0,12,0,0,0,0,94002
30944,3267,236,479,852,1175,525,165,55,55,31,0,24,0,0,0,0,0,0,0,0,0,110,97,51,0,46,13,13,0,13,0,0,0,0,0,94005
30945,29410,1284,3281,6272,9679,8894,1744,902,885,82,76,727,17,17,17,0,0,0,0,0,0,842,830,71,38,721,12,0,0,0,0,12,0,0,12,94010
30946,33105,5889,7923,10114,7567,1612,2128,1084,1034,203,69,762,50,20,20,0,0,30,30,0,0,1044,888,126,138,624,156,135,110,25,0,21,11,0,10,94014
30947,44665,4930,8842,14571,13254,3068,2915,1439,1378,190,157,1031,61,34,26,0,8,27,10,9,8,1476,1272,213,109,950,204,204,115,89,0,0,0,0,0,94015
30948,13241,2218,1872,2873,3386,2892,761,323,300,0,47,253,23,23,0,23,0,0,0,0,0,438,403,96,96,211,35,22,0,0,22,13,13,0,0,94019
30949,1211,66,136,322,310,377,84,70,70,0,0,70,0,0,0,0,0,0,0,0,0,14,14,0,0,14,0,0,0,0,0,0,0,0,0,94020
30950,99,0,6,20,58,15,0,0,0,0,0,0,0,0,0,0,0,0,0,0,0,0,0,0,0,0,0,0,0,0,0,0,0,0,0,94021
30951,13944,229,623,1666,4673,6753,700,326,326,39,0,287,0,0,0,0,0,0,0,0,0,374,366,67,0,299,8,8,0,0,8,0,0,0,0,94022
30952,15819,204,873,2241,5272,7229,1075,565,554,93,14,447,11,0,0,0,0,11,0,0,11,510,510,116,0,394,0,0,0,0,0,0,0,0,0,94024
30953,28504,2182,2214,4281,8717,11110,1211,639,519,88,14,417,120,82,37,36,9,38,38,0,0,572,527,115,30,382,45,31,20,11,0,14,14,0,0,94025
30954,4819,107,195,478,2005,2034,530,234,234,7,0,227,0,0,0,0,0,0,0,0,0,296,296,125,6,165,0,0,0,0,0,0,0,0,0,94027
30955,5015,194,176,468,1731,2446,379,187,157,18,0,139,30,11,0,0,11,19,0,0,19,192,192,60,0,132,0,0,0,0,0,0,0,0,0,94028
30956,16105,1350,3068,5067,4265,2355,937,442,382,38,9,335,60,39,12,0,27,21,21,0,0,495,490,135,51,304,5,0,0,0,0,5,0,0,5,94030
30957,2175,92,273,533,808,469,145,58,58,0,0,58,0,0,0,0,0,0,0,0,0,87,87,17,0,70,0,0,0,0,0,0,0,0,0,94037
30958,2150,247,363,629,533,378,165,103,103,0,0,103,0,0,0,0,0,0,0,0,0,62,62,48,0,14,0,0,0,0,0,0,0,0,0,94038
30959,23697,1989,2182,3865,6492,9169,1258,541,485,93,23,369,56,55,26,29,0,1,0,0,1,717,622,162,62,398,95,95,36,59,0,0,0,0,0,94040
30960,10172,713,1307,1975,2801,3376,311,206,163,51,0,112,43,42,42,0,0,1,0,0,1,105,50,0,0,50,55,55,55,0,0,0,0,0,0,94041
30961,20894,1650,2411,4214,6347,6272,875,376,313,12,37,264,63,41,23,0,18,22,22,0,0,499,488,85,44,359,11,11,11,0,0,0,0,0,0,94043
30962,27334,1479,4993,9880,7304,3678,1653,956,878,129,50,699,78,78,28,20,30,0,0,0,0,697,636,202,33,401,61,61,17,0,44,0,0,0,0,94044
30963,1196,386,214,281,167,148,89,52,37,17,0,20,15,7,7,0,0,8,0,0,8,37,37,29,0,8,0,0,0,0,0,0,0,0,0,94060
30964,25514,3875,4472,7266,6144,3757,1366,656,614,121,0,493,42,36,12,15,9,6,3,0,3,710,651,206,25,420,59,59,14,0,45,0,0,0,0,94061
30965,19183,1231,2829,4451,5761,4911,1241,557,523,131,46,346,34,31,19,12,0,3,3,0,0,684,659,238,0,421,25,25,11,6,8,0,0,0,0,94062
30966,19623,6899,5357,4344,1950,1073,1853,966,604,33,10,561,362,147,87,6,54,215,122,57,36,887,692,138,47,507,195,116,28,67,21,79,44,0,35,94063
30967,8163,190,550,1571,3037,2815,332,210,191,17,0,174,19,9,0,9,0,10,10,0,0,122,122,0,11,111,0,0,0,0,0,0,0,0,0,94065
30968,29743,2911,6581,9869,7571,2811,1831,862,743,197,50,496,119,78,70,8,0,41,34,0,7,969,957,306,67,584,12,0,0,0,0,12,0,0,12,94066
30969,21087,697,2398,5400,6863,5729,1190,591,564,66,64,434,27,13,0,13,0,14,0,0,14,599,534,247,0,287,65,43,11,0,32,22,0,0,22,94070
30970,220,0,55,141,24,0,0,0,0,0,0,0,0,0,0,0,0,0,0,0,0,0,0,0,0,0,0,0,0,0,0,0,0,0,0,94074
30971,45278,6860,11051,13825,10010,3532,2648,1548,1420,210,49,1161,128,79,0,62,17,49,36,0,13,1100,1062,283,59,720,38,38,9,12,17,0,0,0,0,94080
30972,15788,2708,2380,3012,3961,3727,1005,476,370,82,56,232,106,106,62,44,0,0,0,0,0,529,511,150,60,301,18,18,0,0,18,0,0,0,0,94085
30973,33262,3159,3566,7024,9921,9592,1061,628,523,68,6,449,105,44,43,0,1,61,48,0,13,433,421,86,30,305,12,0,0,0,0,12,0,0,12,94086
30974,38545,2116,3431,7135,12956,12907,2209,987,913,112,28,773,74,55,41,0,14,19,0,0,19,1222,1172,249,21,902,50,33,32,0,1,17,0,0,17,94087
30975,14414,1836,2380,4067,3660,2471,921,429,356,58,44,254,73,47,36,5,6,26,26,0,0,492,421,157,33,231,71,36,0,13,23,35,35,0,0,94089
30976,21903,4197,3669,5967,5335,2735,863,347,300,80,10,210,47,9,6,0,3,38,31,0,7,516,477,58,52,367,39,39,39,0,0,0,0,0,0,94102
30977,19725,3755,3214,4804,5435,2517,797,315,122,0,22,100,193,66,0,10,56,127,51,0,76,482,437,126,25,286,45,19,10,0,9,26,0,0,26,94103
30978,177,29,36,8,64,40,0,0,0,0,0,0,0,0,0,0,0,0,0,0,0,0,0,0,0,0,0,0,0,0,0,0,0,0,0,94104
30979,5101,88,54,642,2169,2148,44,44,44,0,0,44,0,0,0,0,0,0,0,0,0,0,0,0,0,0,0,0,0,0,0,0,0,0,0,94105
30980,22673,1389,1692,3403,8940,7249,641,225,150,22,18,110,75,65,53,0,12,10,0,0,10,416,416,52,25,339,0,0,0,0,0,0,0,0,0,94107
30981,11202,3263,1514,2043,2980,1402,433,197,197,0,1,196,0,0,0,0,0,0,0,0,0,236,236,41,5,190,0,0,0,0,0,0,0,0,0,94108
30982,46584,4647,4664,9185,17866,10222,1133,516,471,44,37,390,45,29,14,0,15,16,16,0,0,617,605,202,33,370,12,2,0,0,2,10,0,0,10,94109
30983,56005,8320,7574,10413,18024,11674,1835,1040,702,75,37,590,338,82,51,13,18,256,140,65,51,795,748,150,43,555,47,47,36,0,11,0,0,0,0,94110
30984,3066,438,272,376,1090,890,75,27,27,15,0,12,0,0,0,0,0,0,0,0,0,48,48,0,0,48,0,0,0,0,0,0,0,0,0,94111
30985,60610,14148,14692,15615,11521,4634,2943,1532,1318,206,51,1061,214,110,62,24,24,104,21,14,69,1411,1311,223,82,1006,100,62,52,0,10,38,0,0,38,94112
30986,27117,754,1913,3875,10018,10557,532,256,251,34,17,200,5,3,0,0,3,2,0,0,2,276,244,31,41,172,32,27,0,0,27,5,0,5,0,94114
30987,27672,2120,2828,4586,9868,8270,815,451,451,36,0,415,0,0,0,0,0,0,0,0,0,364,353,97,0,256,11,11,0,11,0,0,0,0,0,94115
30988,33550,5360,5158,7679,10219,5134,1998,884,860,66,49,745,24,24,7,0,17,0,0,0,0,1114,996,101,62,833,118,110,94,0,16,8,0,0,8,94116
30989,32556,1191,2087,5575,14548,9155,2212,890,882,148,34,700,8,0,0,0,0,8,0,0,8,1322,1307,343,45,919,15,7,0,0,7,8,0,0,8,94117
30990,31111,3027,3132,6245,10635,8072,744,406,354,13,20,321,52,37,0,14,23,15,0,0,15,338,323,41,0,282,15,15,0,0,15,0,0,0,0,94118
30991,33010,3950,3703,7823,10702,6832,1021,552,539,73,18,448,13,5,5,0,0,8,8,0,0,469,415,47,25,343,54,20,0,4,16,34,0,0,34,94121
30992,44867,4908,5938,10450,14632,8939,1638,909,881,56,25,800,28,7,0,0,7,21,0,0,21,729,691,210,111,370,38,17,9,0,8,21,0,0,21,94122
30993,20942,559,1127,2304,10592,6360,258,197,189,0,0,189,8,8,0,0,8,0,0,0,0,61,61,26,0,35,0,0,0,0,0,0,0,0,0,94123
30994,22742,6502,5132,6383,3287,1438,1776,800,724,41,48,635,76,68,5,51,12,8,0,0,8,976,867,87,118,662,109,58,10,35,13,51,39,0,12,94124
30995,15114,660,1116,3231,5445,4662,541,339,320,11,0,309,19,18,0,0,18,1,0,0,1,202,194,55,48,91,8,8,8,0,0,0,0,0,0,94127
30996,44,21,23,0,0,0,0,0,0,0,0,0,0,0,0,0,0,0,0,0,0,0,0,0,0,0,0,0,0,0,0,0,0,0,0,94128
30997,2006,0,33,223,981,769,9,9,9,0,0,9,0,0,0,0,0,0,0,0,0,0,0,0,0,0,0,0,0,0,0,0,0,0,0,94129
30998,1504,170,295,431,452,156,327,237,170,38,28,104,67,22,0,0,22,45,0,0,45,90,76,41,0,35,14,14,0,0,14,0,0,0,0,94130
30999,22279,940,1813,4652,7532,7342,580,307,266,41,24,201,41,8,0,8,0,33,0,0,33,273,266,100,0,166,7,7,7,0,0,0,0,0,0,94131
31000,19351,2389,2954,4693,6207,3108,3246,1430,1408,230,111,1067,22,21,21,0,0,1,0,0,1,1816,1816,458,230,1128,0,0,0,0,0,0,0,0,0,94132
31001,22675,5787,2730,3561,6951,3646,782,511,449,0,28,421,62,62,24,38,0,0,0,0,0,271,271,12,25,234,0,0,0,0,0,0,0,0,0,94133
31002,27427,8173,6928,6226,4639,1461,2025,1004,863,95,91,677,141,110,13,40,57,31,16,4,11,1021,953,87,65,801,68,54,19,0,35,14,0,0,14,94134
31003,4414,335,248,483,1476,1872,153,75,75,0,0,75,0,0,0,0,0,0,0,0,0,78,78,9,0,69,0,0,0,0,0,0,0,0,0,94158
31004,12202,180,451,1285,3895,6391,494,242,232,25,0,207,10,10,10,0,0,0,0,0,0,252,252,28,0,224,0,0,0,0,0,0,0,0,0,94301
31005,28477,5561,4938,5233,5186,7559,2950,1322,1215,216,115,884,107,57,27,12,18,50,27,11,12,1628,1511,273,142,1096,117,110,32,7,71,7,0,0,7,94303
31006,2945,41,153,261,895,1595,50,37,25,0,0,25,12,0,0,0,0,12,0,0,12,13,13,0,0,13,0,0,0,0,0,0,0,0,0,94304
31007,4205,45,80,151,1263,2666,3591,1874,1874,307,72,1495,0,0,0,0,0,0,0,0,0,1717,1717,454,27,1236,0,0,0,0,0,0,0,0,0,94305
31008,18779,652,1080,2949,4812,9286,1151,785,743,74,7,662,42,29,9,0,20,13,13,0,0,366,366,57,26,283,0,0,0,0,0,0,0,0,0,94306
31009,25927,5374,5334,7166,5220,2833,1644,804,482,103,49,330,322,180,117,32,31,142,66,76,0,840,774,188,4,582,66,20,0,0,20,46,5,0,41,94401
31010,16840,830,1901,4132,5484,4493,990,510,488,87,53,348,22,19,19,0,0,3,0,0,3,480,478,123,12,343,2,0,0,0,0,2,0,0,2,94402
31011,28876,2043,4409,8728,8426,5270,1609,817,758,255,127,376,59,47,20,27,0,12,12,0,0,792,792,328,26,438,0,0,0,0,0,0,0,0,0,94403
31012,25331,936,2550,5863,8671,7311,1262,677,641,166,0,475,36,36,16,0,20,0,0,0,0,585,530,131,9,390,55,55,55,0,0,0,0,0,0,94404
31013,44622,4564,6787,13299,12703,7269,2344,1373,1093,159,67,867,280,213,139,46,28,67,6,0,61,971,891,152,120,619,80,59,7,44,8,21,0,8,13,94501
31014,9517,503,1153,1772,3376,2713,579,268,268,56,0,212,0,0,0,0,0,0,0,0,0,311,311,83,0,228,0,0,0,0,0,0,0,0,0,94502
31015,12245,1902,2236,4200,2598,1309,1260,624,487,39,114,334,137,126,57,34,35,11,0,0,11,636,574,96,20,458,62,50,50,0,0,12,12,0,0,94503
31016,9174,471,1773,4130,2028,772,491,249,205,48,30,127,44,44,20,24,0,0,0,0,0,242,242,91,48,103,0,0,0,0,0,0,0,0,0,94505
31017,14029,243,847,2842,6056,4041,1347,735,704,157,32,515,31,31,17,0,14,0,0,0,0,612,612,73,64,475,0,0,0,0,0,0,0,0,0,94506
31018,10905,137,666,2246,4894,2962,809,452,416,64,22,330,36,21,21,0,0,15,0,0,15,357,357,66,14,277,0,0,0,0,0,0,0,0,0,94507
31019,1951,160,239,684,571,297,567,221,221,49,28,144,0,0,0,0,0,0,0,0,0,346,342,154,40,148,4,4,4,0,0,0,0,0,0,94508
31020,39184,6251,12877,14179,4333,1544,4219,1885,1525,198,111,1216,360,194,97,20,77,166,33,70,63,2334,1886,228,346,1312,448,392,116,50,226,56,0,0,56,94509
31021,19058,1065,2834,7369,4957,2833,1433,699,633,188,40,405,66,54,22,12,20,12,0,0,12,734,714,199,0,515,20,9,0,0,9,11,0,0,11,94510
31022,1862,216,784,644,150,68,54,54,54,0,0,54,0,0,0,0,0,0,0,0,0,0,0,0,0,0,0,0,0,0,0,0,0,0,0,94511
31023,168,42,13,13,100,0,15,0,0,0,0,0,0,0,0,0,0,0,0,0,0,15,15,0,0,15,0,0,0,0,0,0,0,0,0,94512
31024,34454,3763,7067,13771,7429,2424,4059,2018,1817,282,161,1374,201,175,110,15,50,26,21,0,5,2041,1822,551,141,1130,219,210,26,67,117,9,0,0,9,94513
31025,557,65,167,251,7,67,127,72,42,0,0,42,30,6,0,0,6,24,0,0,24,55,42,0,0,42,13,13,13,0,0,0,0,0,0,94514
31026,5343,1106,841,1609,1220,567,272,151,119,7,0,112,32,24,18,0,6,8,5,0,3,121,121,11,0,110,0,0,0,0,0,0,0,0,0,94515
31027,101,0,10,16,38,37,4,4,4,0,0,4,0,0,0,0,0,0,0,0,0,0,0,0,0,0,0,0,0,0,0,0,0,0,0,94516
31028,8721,384,1589,2819,2617,1312,998,505,479,47,0,432,26,8,0,0,8,18,0,0,18,493,425,192,68,165,68,68,0,68,0,0,0,0,0,94517
31029,18986,1922,3942,6005,4549,2568,1272,682,655,50,48,557,27,27,0,15,12,0,0,0,0,590,554,151,107,296,36,8,5,0,3,28,0,19,9,94518
31030,13680,1248,3522,4957,2946,1007,992,400,265,13,54,198,135,102,23,79,0,33,0,33,0,592,538,60,58,420,54,38,0,0,38,16,7,0,9,94519
31031,24107,5885,6790,7032,3212,1188,1690,968,703,125,74,504,265,204,136,30,38,61,5,56,0,722,665,156,111,398,57,24,3,14,7,33,0,33,0,94520
31032,28981,1446,6359,10603,7360,3213,2115,1053,959,228,113,618,94,78,17,27,34,16,0,0,16,1062,825,307,43,475,237,136,83,0,53,101,33,57,11,94521
31033,24706,1033,3738,7734,8401,3800,1616,841,788,131,23,634,53,46,46,0,0,7,0,7,0,775,757,238,13,506,18,5,0,0,5,13,13,0,0,94523
31034,2337,135,623,849,530,200,206,117,117,27,13,77,0,0,0,0,0,0,0,0,0,89,80,37,0,43,9,0,0,0,0,9,0,0,9,94525
31035,22661,542,2331,6042,8753,4993,1585,967,870,128,118,624,97,85,0,30,55,12,0,0,12,618,618,160,58,400,0,0,0,0,0,0,0,0,0,94526
31036,760,43,105,90,301,221,26,26,26,14,0,12,0,0,0,0,0,0,0,0,0,0,0,0,0,0,0,0,0,0,0,0,0,0,0,94528
31037,18863,1328,2177,4235,5631,5492,642,342,261,84,17,160,81,23,1,22,0,58,0,10,48,300,237,48,10,179,63,63,48,0,15,0,0,0,0,94530
31038,24857,1960,5592,10451,5447,1407,2809,1422,1156,194,83,879,266,127,55,6,66,139,80,28,31,1387,1261,159,113,989,126,88,0,0,88,38,0,38,0,94531
31039,42969,7844,12379,15435,5587,1724,4101,1882,1525,277,184,1064,357,250,165,37,48,107,0,9,98,2219,1859,392,177,1290,360,301,120,77,104,59,0,59,0,94533
31040,24505,1263,4864,9471,5892,3015,2255,1275,1006,300,60,646,269,206,63,119,24,63,0,0,63,980,955,213,19,723,25,25,21,0,4,0,0,0,0,94534
31041,1682,9,305,878,396,94,535,391,119,113,0,6,272,272,272,0,0,0,0,0,0,144,132,108,0,24,12,6,6,0,0,6,0,0,6,94535
31042,48007,4870,11815,10939,11930,8453,3083,1708,1500,296,93,1111,208,166,91,24,51,42,0,0,42,1375,1264,286,65,913,111,111,43,17,51,0,0,0,0,94536
31043,43303,4840,9678,10532,10633,7620,2543,1234,1018,239,77,702,216,175,49,54,72,41,34,7,0,1309,1224,197,53,974,85,22,0,0,22,63,27,30,6,94538
31044,34807,1903,3444,5381,11564,12515,2677,1530,1475,115,37,1323,55,49,21,0,28,6,0,0,6,1147,1109,232,20,857,38,27,8,0,19,11,0,0,11,94539
31045,40647,8757,10727,11708,6866,2589,2605,1337,1139,145,168,826,198,87,14,55,18,111,0,94,17,1268,1052,196,137,719,216,120,8,99,13,96,0,86,10,94541
31046,8018,764,1263,2017,2714,1260,845,333,264,37,14,213,69,69,31,18,20,0,0,0,0,512,512,132,64,316,0,0,0,0,0,0,0,0,0,94542
31047,49399,11815,14076,14120,7106,2282,4076,2181,1830,324,263,1243,351,244,143,31,70,107,50,26,31,1895,1611,315,191,1105,284,187,82,52,53,97,23,0,74,94544
31048,20206,3188,5098,6699,4091,1130,1654,829,740,79,94,567,89,59,53,0,6,30,0,0,30,825,799,53,71,675,26,21,13,5,3,5,0,5,0,94545
31049,29789,2342,7433,10348,6539,3127,2248,1288,1073,222,51,800,215,182,100,18,64,33,0,0,33,960,902,318,76,508,58,58,44,13,1,0,0,0,0,94546
31050,16653,1277,2578,5963,5447,1388,1455,872,780,133,27,620,92,92,0,85,7,0,0,0,0,583,559,95,10,454,24,24,0,0,24,0,0,0,0,94547
31051,227,0,37,139,37,14,32,27,27,0,0,27,0,0,0,0,0,0,0,0,0,5,5,0,0,5,0,0,0,0,0,0,0,0,0,94548
31052,19392,467,1382,3689,7365,6489,1355,645,645,99,0,546,0,0,0,0,0,0,0,0,0,710,682,160,34,488,28,11,11,0,0,17,0,0,17,94549
31053,32191,1918,5539,11233,8683,4818,2358,1042,1023,230,82,711,19,19,19,0,0,0,0,0,0,1316,1238,236,57,945,78,46,46,0,0,32,0,0,32,94550
31054,25030,2568,4992,8497,5936,3037,1825,810,669,127,69,473,141,88,69,19,0,53,15,23,15,1015,959,329,77,553,56,32,0,0,32,24,18,6,0,94551
31055,10229,597,1440,2536,3294,2362,694,357,357,71,26,260,0,0,0,0,0,0,0,0,0,337,337,60,13,264,0,0,0,0,0,0,0,0,0,94552
31056,34468,2857,7713,12865,7649,3384,2576,1342,1131,292,197,642,211,131,80,27,24,80,0,14,66,1234,1129,453,51,625,105,43,15,0,28,62,0,19,43,94553
31057,23672,1826,3716,4547,7730,5853,1123,681,658,98,8,552,23,0,0,0,0,23,13,0,10,442,422,88,17,317,20,20,20,0,0,0,0,0,0,94555
31058,10450,223,618,1843,3952,3814,812,413,402,104,8,290,11,11,0,0,11,0,0,0,0,399,399,95,0,304,0,0,0,0,0,0,0,0,0,94556
31059,46203,8100,9433,14957,9073,4640,3525,1824,1575,235,96,1244,249,148,84,46,18,101,83,18,0,1701,1567,570,145,852,134,115,93,0,22,19,6,13,0,94558
31060,18440,3620,3990,5814,3214,1802,1438,757,668,133,72,463,89,36,30,0,6,53,39,0,14,681,668,126,111,431,13,8,0,3,5,5,0,0,5,94559
31061,29864,3416,9775,8368,5671,2634,1923,859,748,79,34,635,111,103,40,10,53,8,0,0,8,1064,837,178,68,591,227,195,65,11,119,32,18,8,6,94560
31062,22952,3339,7275,9156,2573,609,2434,1320,1150,159,32,959,170,110,93,0,17,60,6,0,54,1114,1028,274,41,713,86,84,54,11,19,2,0,0,2,94561
31063,12433,272,650,1823,5344,4344,1045,560,532,78,13,441,28,28,0,28,0,0,0,0,0,485,464,62,10,392,21,18,18,0,0,3,0,0,3,94563
31064,13183,1464,2718,4432,2996,1573,602,329,319,38,22,259,10,10,0,10,0,0,0,0,0,273,214,0,0,214,59,45,0,15,30,14,0,0,14,94564
31065,53082,12742,14346,17098,6538,2358,5399,2800,2278,399,285,1594,522,392,259,94,39,130,110,20,0,2599,2035,298,164,1573,564,460,205,89,166,104,54,18,32,94565
31066,27871,1527,3852,7165,9145,6182,2765,1470,1279,372,90,817,191,181,97,27,57,10,10,0,0,1295,1238,237,37,964,57,45,13,8,24,12,12,0,0,94566
31067,528,157,89,171,96,15,81,60,22,8,0,14,38,38,0,38,0,0,0,0,0,21,21,8,0,13,0,0,0,0,0,0,0,0,0,94567
31068,32487,2785,4911,8451,10655,5685,2593,1536,1275,332,56,887,261,191,21,61,109,70,0,0,70,1057,1005,385,51,569,52,45,11,0,34,7,0,0,7,94568
31069,275,58,100,80,15,22,11,11,11,0,0,11,0,0,0,0,0,0,0,0,0,0,0,0,0,0,0,0,0,0,0,0,0,0,0,94569
31070,6391,703,1666,2471,970,581,217,114,91,15,0,76,23,9,9,0,0,14,14,0,0,103,84,13,35,36,19,19,19,0,0,0,0,0,0,94571
31071,6066,940,1500,2172,1119,335,421,185,185,80,13,92,0,0,0,0,0,0,0,0,0,236,236,31,0,205,0,0,0,0,0,0,0,0,0,94572
31072,60,13,19,28,0,0,12,12,12,0,0,12,0,0,0,0,0,0,0,0,0,0,0,0,0,0,0,0,0,0,0,0,0,0,0,94573
31073,6953,682,934,2288,2091,958,262,148,148,12,26,110,0,0,0,0,0,0,0,0,0,114,114,40,18,56,0,0,0,0,0,0,0,0,0,94574
31074,44,0,3,17,5,19,997,378,375,88,29,258,3,3,3,0,0,0,0,0,0,619,619,114,71,434,0,0,0,0,0,0,0,0,0,94575
31075,67,0,9,45,13,0,0,0,0,0,0,0,0,0,0,0,0,0,0,0,0,0,0,0,0,0,0,0,0,0,0,0,0,0,0,94576
31076,31547,5202,8037,8721,6513,3074,2025,1007,897,107,69,721,110,107,34,33,40,3,0,0,3,1018,904,119,142,643,114,41,41,0,0,73,3,0,70,94577
31077,25624,5643,6834,7183,4476,1488,1903,1029,894,61,64,769,135,85,64,0,21,50,34,14,2,874,807,118,35,654,67,35,0,30,5,32,7,0,25,94578
31078,15703,2907,4748,4608,2395,1045,851,520,415,35,23,357,105,89,47,31,11,16,0,0,16,331,309,109,15,185,22,8,8,0,0,14,14,0,0,94579
31079,18725,3453,5483,5886,3172,731,1724,864,726,155,22,549,138,120,45,61,14,18,0,18,0,860,768,176,83,509,92,57,19,17,21,35,0,8,27,94580
31080,24308,520,1894,4653,9950,7291,1718,889,851,150,92,609,38,7,7,0,0,31,0,0,31,829,750,81,17,652,79,79,0,52,27,0,0,0,0,94582
31081,23801,759,2840,6377,8905,4920,1843,1067,976,318,76,582,91,91,17,38,36,0,0,0,0,776,745,145,53,547,31,28,23,0,5,3,3,0,0,94583
31082,17968,2228,4279,7859,2870,732,1733,799,683,123,85,475,116,72,48,24,0,44,19,25,0,934,792,126,56,610,142,142,110,32,0,0,0,0,0,94585
31083,678,33,89,222,218,116,22,4,4,0,0,4,0,0,0,0,0,0,0,0,0,18,18,10,0,8,0,0,0,0,0,0,0,0,0,94586
31084,47468,6544,11721,11815,12542,4846,3235,1798,1575,242,142,1191,223,173,68,93,12,50,11,0,39,1437,1325,204,60,1061,112,49,4,2,43,63,0,19,44,94587
31085,20320,900,2348,5194,6974,4904,1660,870,832,152,32,648,38,29,21,0,8,9,7,0,2,790,718,216,14,488,72,72,8,15,49,0,0,0,0,94588
31086,19820,3057,6126,7120,2733,784,1709,790,626,81,73,472,164,86,35,0,51,78,0,64,14,919,819,140,64,615,100,76,56,20,0,24,10,0,14,94589
31087,24013,4442,6037,9062,3080,1392,1865,1024,759,105,71,583,265,98,41,41,16,167,135,8,24,841,745,183,63,499,96,62,25,19,18,34,15,0,19,94590
31088,37010,3632,8246,14475,7898,2759,2625,1381,1204,91,246,867,177,118,7,98,13,59,0,21,38,1244,1025,146,70,809,219,50,12,36,2,169,0,0,169,94591
31089,461,6,12,150,156,137,0,0,0,0,0,0,0,0,0,0,0,0,0,0,0,0,0,0,0,0,0,0,0,0,0,0,0,0,0,94592
31090,14091,448,2307,3088,4695,3553,284,155,139,9,27,103,16,16,0,16,0,0,0,0,0,129,129,16,0,113,0,0,0,0,0,0,0,0,0,94595
31091,15034,452,1675,4021,5681,3205,622,263,251,54,1,196,12,0,0,0,0,12,0,0,12,359,359,90,15,254,0,0,0,0,0,0,0,0,0,94596
31092,15615,359,1512,4222,5666,3856,604,432,409,90,46,273,23,20,3,0,17,3,3,0,0,172,160,35,0,125,12,12,0,12,0,0,0,0,0,94597
31093,19125,341,1791,4241,7402,5350,1276,517,517,44,83,390,0,0,0,0,0,0,0,0,0,759,741,126,65,550,18,18,18,0,0,0,0,0,0,94598
31094,2659,232,550,737,703,437,140,112,90,11,0,79,22,22,0,22,0,0,0,0,0,28,28,0,0,28,0,0,0,0,0,0,0,0,0,94599
31095,31054,11704,7294,7303,3335,1418,3100,1660,1221,170,144,907,439,198,85,36,77,241,163,61,17,1440,1181,73,132,976,259,133,58,28,47,126,67,19,40,94601
31096,20570,2497,3618,4731,5314,4410,1118,589,555,58,0,497,34,28,0,28,0,6,0,0,6,529,458,127,38,293,71,44,24,0,20,27,0,0,27,94602
31097,19031,6827,5535,4746,1493,430,2311,1106,874,142,101,631,232,109,52,29,28,123,15,69,39,1205,946,89,129,728,259,154,56,30,68,105,18,13,74,94603
31098,28394,4684,5143,9702,5165,3700,2200,1140,921,34,83,804,219,195,25,112,58,24,0,8,16,1060,923,60,211,652,137,117,55,12,50,20,11,0,9,94605
31099,25487,7402,4756,6779,4231,2319,1874,817,657,101,111,445,160,90,35,24,31,70,27,23,20,1057,962,69,121,772,95,95,30,9,56,0,0,0,0,94606
31100,17341,4179,3186,4864,3431,1681,1333,752,638,37,73,528,114,73,0,60,13,41,16,0,25,581,520,27,138,355,61,48,12,30,6,13,0,7,6,94607
31101,20269,1845,2824,5189,5761,4650,834,535,444,2,49,393,91,11,8,0,3,80,29,46,5,299,298,31,63,204,1,1,0,0,1,0,0,0,0,94608
31102,16504,1366,2554,4286,5177,3121,602,229,227,0,0,227,2,0,0,0,0,2,0,0,2,373,361,43,44,274,12,0,0,0,0,12,0,0,12,94609
31103,24116,1063,1788,5028,8130,8107,670,302,260,11,0,249,42,42,17,0,25,0,0,0,0,368,345,45,4,296,23,15,0,14,1,8,0,0,8,94610
31104,28037,985,1533,5139,10175,10205,1032,438,370,29,8,333,68,68,40,28,0,0,0,0,0,594,563,41,71,451,31,31,15,0,16,0,0,0,0,94611
31105,11318,2483,1897,2702,2624,1612,333,132,96,5,17,74,36,36,36,0,0,0,0,0,0,201,147,0,0,147,54,35,0,35,0,19,0,0,19,94612
31106,101,14,9,26,45,7,479,24,24,0,0,24,0,0,0,0,0,0,0,0,0,455,455,125,26,304,0,0,0,0,0,0,0,0,0,94613
31107,13445,273,808,1432,4963,5969,552,314,314,33,4,277,0,0,0,0,0,0,0,0,0,238,230,50,0,180,8,8,8,0,0,0,0,0,0,94618
31108,16108,2254,2615,4433,3722,3084,1163,647,549,48,38,463,98,45,21,0,24,53,50,3,0,516,393,104,22,267,123,123,58,32,33,0,0,0,0,94619
31109,17518,7453,4871,4062,900,232,2169,1206,1011,39,139,833,195,89,34,55,0,106,35,26,45,963,839,110,69,660,124,97,35,10,52,27,17,0,10,94621
31110,12289,977,1415,2714,3934,3249,483,223,174,0,0,174,49,8,0,8,0,41,0,0,41,260,213,3,55,155,47,0,0,0,0,47,0,0,47,94702
31111,14729,1151,1565,3151,4522,4340,602,250,182,35,2,145,68,41,11,30,0,27,26,0,1,352,240,35,11,194,112,112,15,46,51,0,0,0,0,94703
31112,7716,233,577,1568,2939,2399,6587,2686,2667,204,172,2291,19,19,0,0,19,0,0,0,0,3901,3836,1015,140,2681,65,65,0,53,12,0,0,0,0,94704
31113,10088,242,565,1248,3391,4642,443,215,179,21,0,158,36,36,15,8,13,0,0,0,0,228,228,37,0,191,0,0,0,0,0,0,0,0,0,94705
31114,13535,484,1017,2270,4239,5525,829,488,476,91,4,381,12,12,0,5,7,0,0,0,0,341,329,103,12,214,12,5,5,0,0,7,0,0,7,94706
31115,9429,58,318,1074,2811,5168,346,194,184,23,0,161,10,10,0,10,0,0,0,0,0,152,152,47,0,105,0,0,0,0,0,0,0,0,0,94707
31116,8854,77,357,1030,3014,4376,283,183,161,21,0,140,22,22,7,0,15,0,0,0,0,100,94,11,0,83,6,0,0,0,0,6,0,0,6,94708
31117,7750,195,256,1041,2514,3744,1045,626,626,82,0,544,0,0,0,0,0,0,0,0,0,419,419,68,18,333,0,0,0,0,0,0,0,0,0,94709
31118,4913,709,598,1119,1340,1147,327,121,114,15,0,99,7,7,0,7,0,0,0,0,0,206,134,24,0,110,72,72,68,0,4,0,0,0,0,94710
31119,219,10,0,21,110,78,1799,851,851,70,118,663,0,0,0,0,0,0,0,0,0,948,948,109,44,795,0,0,0,0,0,0,0,0,0,94720
31120,17965,6755,3772,4440,1876,1122,1507,723,621,50,16,555,102,29,9,10,10,73,47,25,1,784,647,38,38,571,137,60,0,0,60,77,37,11,29,94801
31121,18716,1600,4307,6431,4378,2000,1464,757,609,80,10,519,148,125,60,49,16,23,10,13,0,707,691,220,8,463,16,16,0,8,8,0,0,0,0,94803
31122,26251,5550,6460,7623,4246,2372,2324,1176,1046,126,29,891,130,82,53,17,12,48,13,9,26,1148,754,138,42,574,394,189,34,28,127,205,0,75,130,94804
31123,9812,1480,2167,2945,2013,1207,531,284,241,7,7,227,43,43,42,0,1,0,0,0,0,247,164,51,0,113,83,83,27,37,19,0,0,0,0,94805
31124,38386,11013,8808,11675,4833,2057,3416,1389,1029,125,16,888,360,230,117,40,73,130,3,82,45,2027,1750,143,121,1486,277,166,68,11,87,111,14,0,97,94806
31125,0,0,0,0,0,0,0,0,0,0,0,0,0,0,0,0,0,0,0,0,0,0,0,0,0,0,0,0,0,0,0,0,0,0,0,94850
31126,29122,5015,3932,7249,7290,5636,1838,1002,867,176,87,604,135,116,62,35,19,19,19,0,0,836,756,145,43,568,80,32,32,0,0,48,0,48,0,94901
31127,22450,1843,3481,6267,6429,4430,1186,738,659,93,14,552,79,68,62,0,6,11,0,0,11,448,434,173,22,239,14,14,0,0,14,0,0,0,0,94903
31128,9241,234,794,2236,2769,3208,479,258,258,24,0,234,0,0,0,0,0,0,0,0,0,221,207,59,33,115,14,14,14,0,0,0,0,0,0,94904
31129,9143,220,438,1412,3700,3373,455,279,279,19,3,257,0,0,0,0,0,0,0,0,0,176,176,38,5,133,0,0,0,0,0,0,0,0,0,94920
31130,241,54,70,108,0,9,22,0,0,0,0,0,0,0,0,0,0,0,0,0,0,22,22,0,0,22,0,0,0,0,0,0,0,0,0,94922
31131,620,52,85,118,272,93,32,14,14,0,0,14,0,0,0,0,0,0,0,0,0,18,18,5,0,13,0,0,0,0,0,0,0,0,0,94923
31132,942,59,103,267,259,254,27,27,27,14,9,4,0,0,0,0,0,0,0,0,0,0,0,0,0,0,0,0,0,0,0,0,0,0,0,94924
31133,6666,454,720,1188,2744,1560,305,234,223,15,37,171,11,11,11,0,0,0,0,0,0,71,71,0,15,56,0,0,0,0,0,0,0,0,0,94925
31134,25972,3260,6055,10507,4519,1631,3508,1417,1245,444,158,643,172,128,79,31,18,44,0,14,30,2091,2012,502,156,1354,79,44,0,15,29,35,10,0,25,94928
31135,70,0,18,19,9,24,0,0,0,0,0,0,0,0,0,0,0,0,0,0,0,0,0,0,0,0,0,0,0,0,0,0,0,0,0,94929
31136,6394,87,643,1798,2376,1490,334,205,158,42,0,116,47,22,0,0,22,25,25,0,0,129,90,20,0,70,39,10,0,10,0,29,0,0,29,94930
31137,5692,668,1179,2121,1286,438,463,148,115,33,0,82,33,33,24,9,0,0,0,0,0,315,303,31,60,212,12,12,12,0,0,0,0,0,0,94931
31138,742,103,33,145,353,108,53,14,14,14,0,0,0,0,0,0,0,0,0,0,0,39,39,0,30,9,0,0,0,0,0,0,0,0,0,94933
31139,799,120,133,216,117,213,116,90,52,20,0,32,38,38,38,0,0,0,0,0,0,26,26,0,0,26,0,0,0,0,0,0,0,0,0,94937
31140,666,14,129,143,226,154,42,42,17,0,0,17,25,25,0,0,25,0,0,0,0,0,0,0,0,0,0,0,0,0,0,0,0,0,0,94938
31141,5286,77,476,1054,2111,1568,183,47,47,15,0,32,0,0,0,0,0,0,0,0,0,136,133,12,0,121,3,3,0,3,0,0,0,0,0,94939
31142,209,0,20,73,87,29,0,0,0,0,0,0,0,0,0,0,0,0,0,0,0,0,0,0,0,0,0,0,0,0,0,0,0,0,0,94940
31143,22347,531,1485,4317,8200,7814,1541,635,595,90,20,485,40,17,4,0,13,23,6,17,0,906,853,331,40,482,53,37,31,0,6,16,16,0,0,94941
31144,13102,1017,2259,4023,3668,2135,727,302,294,76,0,218,8,8,8,0,0,0,0,0,0,425,425,133,0,292,0,0,0,0,0,0,0,0,0,94945
31145,524,38,52,139,144,151,16,13,13,3,0,10,0,0,0,0,0,0,0,0,0,3,3,0,0,3,0,0,0,0,0,0,0,0,0,94946
31146,17440,1311,3047,5769,4756,2557,1209,660,509,89,13,407,151,88,84,4,0,63,0,63,0,549,524,166,69,289,25,25,13,12,0,0,0,0,0,94947
31147,12208,834,1946,3560,3424,2444,719,448,399,60,4,335,49,33,0,0,33,16,0,0,16,271,252,22,65,165,19,19,19,0,0,0,0,0,0,94949
31148,47,0,17,11,8,11,0,0,0,0,0,0,0,0,0,0,0,0,0,0,0,0,0,0,0,0,0,0,0,0,0,0,0,0,0,94950
31149,3086,247,642,959,917,321,131,58,52,18,11,23,6,6,0,0,6,0,0,0,0,73,58,14,14,30,15,15,15,0,0,0,0,0,0,94951
31150,24595,2350,4525,7870,6298,3552,1541,829,744,124,139,481,85,72,35,0,37,13,13,0,0,712,678,251,62,365,34,34,33,0,1,0,0,0,0,94952
31151,24755,2793,5272,8800,5693,2197,1974,919,734,251,42,441,185,144,66,30,48,41,14,0,27,1055,998,356,16,626,57,57,47,0,10,0,0,0,0,94954
31152,1303,85,155,406,373,284,66,24,24,0,0,24,0,0,0,0,0,0,0,0,0,42,42,0,0,42,0,0,0,0,0,0,0,0,0,94956
31153,650,16,45,49,316,224,48,32,32,6,0,26,0,0,0,0,0,0,0,0,0,16,9,0,0,9,7,7,0,0,7,0,0,0,0,94957
31154,11486,411,819,2903,4356,2997,785,346,331,81,14,236,15,10,10,0,0,5,0,0,5,439,438,57,81,300,1,1,0,0,1,0,0,0,0,94960
31155,350,0,27,72,124,127,22,0,0,0,0,0,0,0,0,0,0,0,0,0,0,22,22,0,0,22,0,0,0,0,0,0,0,0,0,94963
31156,4269,1351,1537,1188,77,116,53,53,2,0,0,2,51,17,0,0,17,34,0,0,34,0,0,0,0,0,0,0,0,0,0,0,0,0,0,94964
31157,9011,289,618,2265,3627,2212,263,134,114,55,0,59,20,20,1,19,0,0,0,0,0,129,113,4,0,109,16,16,0,0,16,0,0,0,0,94965
31158,539,18,5,169,156,191,27,6,6,6,0,0,0,0,0,0,0,0,0,0,0,21,21,0,0,21,0,0,0,0,0,0,0,0,0,94970
31159,280,17,18,79,76,90,46,6,6,6,0,0,0,0,0,0,0,0,0,0,0,40,40,24,0,16,0,0,0,0,0,0,0,0,0,94971
31160,38,0,0,38,0,0,0,0,0,0,0,0,0,0,0,0,0,0,0,0,0,0,0,0,0,0,0,0,0,0,0,0,0,0,0,94972
31161,1258,43,81,309,511,314,55,8,8,8,0,0,0,0,0,0,0,0,0,0,0,47,24,0,0,24,23,23,23,0,0,0,0,0,0,94973
31162,1133,179,361,412,102,79,97,10,10,0,0,10,0,0,0,0,0,0,0,0,0,87,87,11,0,76,0,0,0,0,0,0,0,0,0,95002
31163,17191,733,1828,6408,5140,3082,1154,465,446,117,22,307,19,19,19,0,0,0,0,0,0,689,625,124,43,458,64,64,55,0,9,0,0,0,0,95003
31164,2630,309,559,981,556,225,244,181,164,0,11,153,17,17,17,0,0,0,0,0,0,63,55,32,0,23,8,8,0,0,8,0,0,0,0,95004
31165,4466,126,724,1852,1221,543,249,113,101,51,0,50,12,0,0,0,0,12,0,12,0,136,136,28,31,77,0,0,0,0,0,0,0,0,0,95005
31166,7180,273,1599,2833,1697,778,394,256,233,105,20,108,23,0,0,0,0,23,0,0,23,138,138,68,0,70,0,0,0,0,0,0,0,0,0,95006
31167,448,0,133,119,179,17,0,0,0,0,0,0,0,0,0,0,0,0,0,0,0,0,0,0,0,0,0,0,0,0,0,0,0,0,0,95007
31168,32297,1972,5155,10278,9678,5214,1941,1113,1034,111,39,884,79,77,11,24,42,2,0,0,2,828,738,132,23,583,90,90,31,6,53,0,0,0,0,95008
31169,6291,485,1042,2173,1577,1014,501,258,178,111,0,67,80,80,80,0,0,0,0,0,0,243,230,107,0,123,13,13,0,0,13,0,0,0,0,95010
31170,5625,2955,1219,1142,212,97,862,437,318,57,60,201,119,90,31,30,29,29,19,0,10,425,316,97,18,201,109,21,0,21,0,88,65,0,23,95012
31171,22,0,22,0,0,0,0,0,0,0,0,0,0,0,0,0,0,0,0,0,0,0,0,0,0,0,0,0,0,0,0,0,0,0,0,95013
31172,41480,1496,2682,6247,13940,17115,3073,1669,1665,76,68,1521,4,4,4,0,0,0,0,0,0,1404,1376,184,33,1159,28,0,0,0,0,28,0,0,28,95014
31173,567,57,80,197,148,85,45,6,6,3,0,3,0,0,0,0,0,0,0,0,0,39,19,2,0,17,20,20,3,0,17,0,0,0,0,95017
31174,5813,323,868,2325,1429,868,388,173,173,30,0,143,0,0,0,0,0,0,0,0,0,215,181,56,23,102,34,34,18,0,16,0,0,0,0,95018
31175,3931,1764,1058,788,239,82,563,353,280,14,19,247,73,48,48,0,0,25,25,0,0,210,206,37,6,163,4,4,0,0,4,0,0,0,0,95019
31176,35721,8368,7233,11183,5998,2939,3287,1682,1406,274,208,924,276,161,57,45,59,115,48,25,42,1605,1371,411,66,894,234,174,122,52,0,60,0,32,28,95020
31177,30912,7596,7247,10685,4077,1307,3176,1657,1192,215,113,864,465,367,213,149,5,98,2,20,76,1519,1278,137,195,946,241,212,24,102,86,29,10,0,19,95023
31178,10139,219,588,1873,4028,3431,597,288,288,52,11,225,0,0,0,0,0,0,0,0,0,309,256,11,39,206,53,53,0,0,53,0,0,0,0,95030
31179,18202,375,1384,4563,6655,5225,878,435,435,41,17,377,0,0,0,0,0,0,0,0,0,443,430,60,17,353,13,13,0,13,0,0,0,0,0,95032
31180,7124,159,576,2097,2485,1807,402,198,198,83,34,81,0,0,0,0,0,0,0,0,0,204,204,44,19,141,0,0,0,0,0,0,0,0,0,95033
31181,47210,6703,8908,12361,12504,6734,3327,1526,1349,166,26,1157,177,129,68,0,61,48,0,0,48,1801,1626,411,77,1138,175,151,53,17,81,24,0,7,17,95035
31182,30169,3945,5335,9833,6785,4271,2791,1563,1334,228,52,1054,229,133,64,47,22,96,4,10,82,1228,1173,391,37,745,55,38,6,17,15,17,0,0,17,95037
31183,868,266,285,235,51,31,41,39,37,26,0,11,2,0,0,0,0,2,0,0,2,2,2,0,0,2,0,0,0,0,0,0,0,0,0,95039
31184,113,21,17,33,20,22,27,27,27,17,0,10,0,0,0,0,0,0,0,0,0,0,0,0,0,0,0,0,0,0,0,0,0,0,0,95041
31185,468,79,105,193,64,27,22,8,4,0,0,4,4,4,4,0,0,0,0,0,0,14,14,0,0,14,0,0,0,0,0,0,0,0,0,95043
31186,2556,291,588,1090,332,255,310,169,105,29,4,72,64,26,14,12,0,38,38,0,0,141,129,22,54,53,12,12,0,0,12,0,0,0,0,95045
31187,4643,1051,821,1580,882,309,391,169,139,49,19,71,30,30,24,0,6,0,0,0,0,222,222,50,0,172,0,0,0,0,0,0,0,0,0,95046
31188,24474,2740,5381,6765,6054,3534,1735,777,608,129,17,462,169,71,6,13,52,98,98,0,0,958,861,359,25,477,97,97,19,19,59,0,0,0,0,95050
31189,37362,2451,5291,8839,11209,9572,2075,1229,1142,229,11,902,87,41,40,0,1,46,10,0,36,846,765,132,12,621,81,69,0,30,39,12,0,0,12,95051
31190,53,13,0,1,16,23,1752,948,948,178,87,683,0,0,0,0,0,0,0,0,0,804,804,207,21,576,0,0,0,0,0,0,0,0,0,95053
31191,16138,1194,1578,3474,5048,4844,865,319,289,44,8,237,30,21,15,6,0,9,0,0,9,546,468,73,0,395,78,72,0,66,6,6,0,0,6,95054
31192,29808,2377,4515,8293,8113,6510,2799,1401,1182,362,95,725,219,202,167,0,35,17,0,17,0,1398,1181,333,77,771,217,217,123,36,58,0,0,0,0,95060
31193,25566,2615,3438,8684,6853,3976,1296,798,545,146,10,389,253,241,74,90,77,12,12,0,0,498,457,147,48,262,41,41,22,3,16,0,0,0,0,95062
31194,642,10,54,143,168,267,4680,2162,2162,263,43,1856,0,0,0,0,0,0,0,0,0,2518,2516,273,55,2188,2,2,0,0,2,0,0,0,0,95064
31195,6039,656,863,1841,1705,974,342,150,150,35,8,107,0,0,0,0,0,0,0,0,0,192,173,33,49,91,19,19,17,0,2,0,0,0,0,95065
31196,10049,418,1285,3683,2912,1751,1188,621,604,146,0,458,17,0,0,0,0,17,0,17,0,567,567,238,50,279,0,0,0,0,0,0,0,0,0,95066
31197,22278,347,1188,3416,8032,9295,1614,831,799,51,0,748,32,12,0,0,12,20,0,0,20,783,719,135,15,569,64,43,43,0,0,21,0,0,21,95070
31198,7633,355,1132,3039,2027,1080,465,330,250,51,18,181,80,72,29,43,0,8,0,0,8,135,123,65,8,50,12,4,4,0,0,8,8,0,0,95073
31199,197,18,38,92,43,6,16,5,5,0,0,5,0,0,0,0,0,0,0,0,0,11,11,0,0,11,0,0,0,0,0,0,0,0,0,95075
31200,49932,19232,9615,13538,4885,2662,5706,2920,2389,448,277,1664,531,377,97,93,187,154,106,30,18,2786,2421,541,158,1722,365,194,122,36,36,171,90,4,77,95076
31201,12139,3716,2416,2812,1886,1309,1034,643,528,85,45,398,115,61,40,0,21,54,8,0,46,391,321,103,8,210,70,18,18,0,0,52,0,0,52,95110
31202,36295,12483,8727,9342,4503,1240,3736,1882,1608,189,159,1260,274,125,18,23,84,149,73,59,17,1854,1701,284,41,1376,153,114,16,46,52,39,14,21,4,95111
31203,34011,8048,6950,8641,6494,3878,4680,2413,2176,341,220,1615,237,108,78,25,5,129,31,66,32,2267,2153,606,155,1392,114,59,25,34,0,55,8,0,47,95112
31204,666,48,86,177,235,120,0,0,0,0,0,0,0,0,0,0,0,0,0,0,0,0,0,0,0,0,0,0,0,0,0,0,0,0,0,95113
31205,31956,12295,8259,6693,3559,1150,2622,1259,970,50,40,880,289,195,78,46,71,94,34,28,32,1363,1123,182,49,892,240,57,20,0,37,183,123,6,54,95116
31206,20806,3136,4158,5781,5375,2356,1097,747,487,68,84,335,260,251,76,65,110,9,0,0,9,350,324,113,53,158,26,26,26,0,0,0,0,0,0,95117
31207,21516,2167,3916,7079,5438,2916,1397,657,647,159,30,458,10,10,0,0,10,0,0,0,0,740,649,132,60,457,91,84,26,10,48,7,0,0,7,95118
31208,6885,698,1311,2290,1660,926,611,453,367,117,0,250,86,59,51,0,8,27,0,14,13,158,158,80,0,78,0,0,0,0,0,0,0,0,0,95119
31209,26043,1019,2379,5960,9168,7517,2258,1155,1140,110,94,936,15,1,0,0,1,14,5,0,9,1103,1032,185,99,748,71,41,35,0,6,30,30,0,0,95120
31210,25133,6117,5327,7066,4876,1747,1981,985,874,157,42,675,111,63,45,0,18,48,20,0,28,996,864,141,50,673,132,84,35,49,0,48,13,23,12,95121
31211,33609,13468,8173,7285,3712,971,3371,1608,1282,190,53,1039,326,252,124,70,58,74,20,0,54,1763,1367,140,120,1107,396,266,188,10,68,130,5,56,69,95122
31212,43073,5224,8829,14689,9466,4865,2564,1471,1341,247,89,1005,130,64,22,35,7,66,26,40,0,1093,958,261,38,659,135,114,25,25,64,21,14,0,7,95123
31213,32171,1956,5158,9926,9347,5784,1782,955,887,136,43,708,68,51,31,0,20,17,17,0,0,827,780,183,61,536,47,47,20,27,0,0,0,0,0,95124
31214,38067,3226,6082,10144,11051,7564,2093,878,797,186,127,484,81,64,0,23,41,17,9,8,0,1215,1050,225,151,674,165,119,73,45,1,46,0,0,46,95125
31215,23358,3350,3930,5776,6389,3913,1306,641,601,85,43,473,40,36,23,0,13,4,0,0,4,665,544,192,50,302,121,99,90,0,9,22,7,0,15,95126
31216,41562,12122,11172,10359,5716,2193,4204,2160,1704,229,170,1305,456,211,111,42,58,245,125,17,103,2044,1866,295,152,1419,178,121,34,53,34,57,0,26,31,95127
31217,25904,3663,4954,7314,6564,3409,1240,640,520,55,136,329,120,46,0,0,46,74,28,44,2,600,534,135,14,385,66,59,49,0,10,7,0,0,7,95128
31218,26907,1312,2763,5794,7683,9355,2231,1016,937,113,27,797,79,40,26,0,14,39,0,0,39,1215,1215,131,44,1040,0,0,0,0,0,0,0,0,0,95129
31219,9500,744,1373,3043,2716,1624,504,388,337,24,50,263,51,41,0,23,18,10,10,0,0,116,103,11,7,85,13,13,0,0,13,0,0,0,0,95130
31220,20449,2618,2962,4834,5713,4322,920,536,452,40,0,412,84,50,16,34,0,34,0,0,34,384,376,100,49,227,8,8,0,0,8,0,0,0,0,95131
31221,27755,4239,4998,7727,7091,3700,2034,948,926,138,62,726,22,8,0,0,8,14,7,0,7,1086,1079,150,45,884,7,7,7,0,0,0,0,0,0,95132
31222,18119,4143,3283,4843,4327,1523,1500,841,738,97,36,605,103,8,6,0,2,95,82,0,13,659,635,129,55,451,24,7,0,0,7,17,0,0,17,95133
31223,11594,756,1196,1764,3565,4313,331,184,148,31,21,96,36,36,0,11,25,0,0,0,0,147,107,57,13,37,40,22,0,0,22,18,0,0,18,95134
31224,14628,847,1500,3319,4898,4064,1000,578,571,111,16,444,7,7,4,3,0,0,0,0,0,422,411,44,15,352,11,11,0,0,11,0,0,0,0,95135
31225,29148,3465,4930,9174,7440,4139,1889,757,699,105,14,580,58,49,35,0,14,9,0,0,9,1132,932,239,0,693,200,93,53,40,0,107,0,46,61,95136
31226,12383,822,1538,3133,4188,2702,603,331,329,79,0,250,2,0,0,0,0,2,0,0,2,272,263,48,10,205,9,0,0,0,0,9,0,0,9,95138
31227,4428,313,616,1543,1380,576,357,204,195,14,8,173,9,9,9,0,0,0,0,0,0,153,143,66,28,49,10,10,0,10,0,0,0,0,0,95139
31228,245,0,13,176,5,51,13,13,13,0,13,0,0,0,0,0,0,0,0,0,0,0,0,0,0,0,0,0,0,0,0,0,0,0,0,95140
31229,29638,5454,4726,9009,7183,3266,2901,1599,1462,208,84,1170,137,103,45,0,58,34,6,10,18,1302,1164,121,61,982,138,117,82,0,35,21,0,0,21,95148
31230,3448,1372,825,897,254,100,127,38,31,0,0,31,7,0,0,0,0,7,0,0,7,89,45,0,0,45,44,44,0,23,21,0,0,0,0,95202
31231,9903,3074,2238,3160,729,702,723,335,309,39,14,256,26,0,0,0,0,26,0,0,26,388,303,87,0,216,85,27,0,6,21,58,0,27,31,95203
31232,18365,3346,4490,6969,2186,1374,1858,910,793,192,119,482,117,72,37,17,18,45,0,45,0,948,873,158,125,590,75,66,56,4,6,9,0,0,9,95204
31233,20181,9560,5071,4455,811,284,2199,1054,770,17,82,671,284,167,50,54,63,117,26,0,91,1145,889,119,54,716,256,119,28,15,76,137,95,30,12,95205
31234,35438,13951,9116,9554,2086,731,5358,2873,2447,245,315,1887,426,286,208,42,36,140,26,21,93,2485,2054,531,192,1331,431,274,169,49,56,157,35,5,117,95206
31235,29116,5508,7291,10933,3575,1809,3032,1289,951,188,131,632,338,168,63,43,62,170,61,81,28,1743,1312,215,158,939,431,335,114,19,202,96,17,50,29,95207
31236,26222,3509,5860,10167,4862,1824,2486,1255,1061,138,110,813,194,167,76,80,11,27,0,0,27,1231,1128,159,137,832,103,103,22,9,72,0,0,0,0,95209
31237,23189,7293,5842,7642,1746,666,2547,1522,1219,129,217,873,303,189,43,126,20,114,56,55,3,1025,904,146,106,652,121,31,24,3,4,90,0,35,55,95210
31238,26,0,0,13,13,0,1199,477,477,58,14,405,0,0,0,0,0,0,0,0,0,722,722,171,21,530,0,0,0,0,0,0,0,0,0,95211
31239,15460,2432,3950,5528,2402,1148,1822,842,822,82,58,682,20,0,0,0,0,20,4,16,0,980,940,83,97,760,40,0,0,0,0,40,0,0,40,95212
31240,14527,5155,4298,3630,955,489,1757,1034,746,42,49,655,288,126,37,26,63,162,0,18,144,723,602,124,154,324,121,93,38,0,55,28,0,13,15,95215
31241,17900,1368,2835,6527,4169,3001,1662,981,932,93,131,708,49,31,0,0,31,18,16,0,2,681,670,36,137,497,11,11,0,11,0,0,0,0,0,95219
31242,5175,1023,1492,1535,472,653,356,246,246,17,7,222,0,0,0,0,0,0,0,0,0,110,110,0,0,110,0,0,0,0,0,0,0,0,0,95220
31243,3786,422,975,1443,617,329,248,88,61,22,0,39,27,27,27,0,0,0,0,0,0,160,160,60,22,78,0,0,0,0,0,0,0,0,0,95222
31244,2652,67,539,1070,806,170,68,62,62,29,0,33,0,0,0,0,0,0,0,0,0,6,6,6,0,0,0,0,0,0,0,0,0,0,0,95223
31245,277,49,45,141,35,7,0,0,0,0,0,0,0,0,0,0,0,0,0,0,0,0,0,0,0,0,0,0,0,0,0,0,0,0,0,95224
31246,487,161,86,217,9,14,0,0,0,0,0,0,0,0,0,0,0,0,0,0,0,0,0,0,0,0,0,0,0,0,0,0,0,0,0,95225
31247,99,0,0,99,0,0,0,0,0,0,0,0,0,0,0,0,0,0,0,0,0,0,0,0,0,0,0,0,0,0,0,0,0,0,0,95226
31248,622,21,94,155,203,149,13,13,13,7,0,6,0,0,0,0,0,0,0,0,0,0,0,0,0,0,0,0,0,0,0,0,0,0,0,95227
31249,2900,149,599,1579,398,175,60,24,24,24,0,0,0,0,0,0,0,0,0,0,0,36,36,0,0,36,0,0,0,0,0,0,0,0,0,95228
31250,497,164,89,153,84,7,54,0,0,0,0,0,0,0,0,0,0,0,0,0,0,54,25,3,0,22,29,29,0,0,29,0,0,0,0,95230
31251,3202,1328,881,796,110,87,550,453,208,0,49,159,245,88,18,9,61,157,18,0,139,97,54,0,0,54,43,39,0,35,4,4,0,0,4,95231
31252,194,33,71,42,39,9,0,0,0,0,0,0,0,0,0,0,0,0,0,0,0,0,0,0,0,0,0,0,0,0,0,0,0,0,0,95232
31253,404,59,146,101,75,23,22,0,0,0,0,0,0,0,0,0,0,0,0,0,0,22,0,0,0,0,22,22,22,0,0,0,0,0,0,95233
31254,199,82,38,79,0,0,0,0,0,0,0,0,0,0,0,0,0,0,0,0,0,0,0,0,0,0,0,0,0,0,0,0,0,0,0,95234
31255,2418,337,637,708,363,373,168,116,105,55,8,42,11,0,0,0,0,11,11,0,0,52,52,11,0,41,0,0,0,0,0,0,0,0,0,95236
31256,2240,522,720,736,188,74,116,80,80,19,21,40,0,0,0,0,0,0,0,0,0,36,36,0,0,36,0,0,0,0,0,0,0,0,0,95237
31257,28120,8041,7518,8496,2886,1179,3172,1542,1093,180,209,704,449,247,139,29,79,202,3,120,79,1630,1227,231,148,848,403,173,58,103,12,230,0,20,210,95240
31258,17201,2253,3826,6332,3221,1569,1450,851,690,150,17,523,161,161,67,32,62,0,0,0,0,599,512,88,58,366,87,65,11,54,0,22,0,22,0,95242
31259,1851,68,598,676,403,106,63,43,43,0,0,43,0,0,0,0,0,0,0,0,0,20,20,0,0,20,0,0,0,0,0,0,0,0,0,95245
31260,952,45,251,409,200,47,128,19,19,0,0,19,0,0,0,0,0,0,0,0,0,109,52,52,0,0,57,57,0,0,57,0,0,0,0,95246
31261,3597,125,689,1692,665,426,184,31,25,0,25,0,6,6,1,0,5,0,0,0,0,153,90,0,0,90,63,1,1,0,0,62,31,0,31,95247
31262,101,0,48,19,23,11,30,0,0,0,0,0,0,0,0,0,0,0,0,0,0,30,30,0,30,0,0,0,0,0,0,0,0,0,0,95248
31263,2666,298,687,1051,322,308,138,75,75,27,0,48,0,0,0,0,0,0,0,0,0,63,22,0,0,22,41,23,23,0,0,18,0,0,18,95249
31264,62,0,0,48,0,14,0,0,0,0,0,0,0,0,0,0,0,0,0,0,0,0,0,0,0,0,0,0,0,0,0,0,0,0,0,95250
31265,703,21,255,362,57,8,87,87,87,22,0,65,0,0,0,0,0,0,0,0,0,0,0,0,0,0,0,0,0,0,0,0,0,0,0,95251
31266,10435,626,3652,4839,1030,288,1057,738,527,74,67,386,211,167,51,0,116,44,0,0,44,319,164,20,55,89,155,111,36,20,55,44,0,0,44,95252
31267,333,0,48,64,173,48,0,0,0,0,0,0,0,0,0,0,0,0,0,0,0,0,0,0,0,0,0,0,0,0,0,0,0,0,0,95254
31268,1749,287,579,622,168,93,101,65,33,17,0,16,32,32,32,0,0,0,0,0,0,36,36,10,0,26,0,0,0,0,0,0,0,0,0,95255
31269,314,18,163,101,32,0,0,0,0,0,0,0,0,0,0,0,0,0,0,0,0,0,0,0,0,0,0,0,0,0,0,0,0,0,0,95257
31270,2688,231,681,923,509,344,163,95,95,0,29,66,0,0,0,0,0,0,0,0,0,68,68,16,9,43,0,0,0,0,0,0,0,0,0,95258
31271,22917,6232,5672,7671,2098,1244,2548,1208,1003,119,115,769,205,98,9,16,73,107,26,29,52,1340,1194,158,184,852,146,111,21,40,50,35,0,0,35,95301
31272,590,165,107,191,102,25,128,61,43,0,0,43,18,18,4,0,14,0,0,0,0,67,62,6,4,52,5,5,5,0,0,0,0,0,0,95303
31273,11761,2666,3320,3706,1434,635,814,431,331,53,7,271,100,37,13,0,24,63,0,0,63,383,360,64,3,293,23,23,0,6,17,0,0,0,0,95304
31274,47,16,17,0,14,0,16,0,0,0,0,0,0,0,0,0,0,0,0,0,0,16,16,0,0,16,0,0,0,0,0,0,0,0,0,95305
31275,798,162,242,238,119,37,16,0,0,0,0,0,0,0,0,0,0,0,0,0,0,16,16,0,0,16,0,0,0,0,0,0,0,0,0,95306
31276,25478,8561,7579,7051,1809,478,3045,1479,1237,121,270,846,242,196,102,47,47,46,7,28,11,1566,1323,278,231,814,243,184,88,34,62,59,0,50,9,95307
31277,1393,71,477,584,220,41,136,54,54,30,1,23,0,0,0,0,0,0,0,0,0,82,82,17,0,65,0,0,0,0,0,0,0,0,0,95310
31278,1685,352,579,495,213,46,93,64,64,39,0,25,0,0,0,0,0,0,0,0,0,29,29,0,0,29,0,0,0,0,0,0,0,0,0,95311
31279,156,41,37,59,7,12,17,4,0,0,0,0,4,4,4,0,0,0,0,0,0,13,13,0,13,0,0,0,0,0,0,0,0,0,0,95312
31280,604,269,160,146,25,4,43,41,26,0,0,26,15,15,0,0,15,0,0,0,0,2,2,0,2,0,0,0,0,0,0,0,0,0,0,95313
31281,0,0,0,0,0,0,0,0,0,0,0,0,0,0,0,0,0,0,0,0,0,0,0,0,0,0,0,0,0,0,0,0,0,0,0,95314
31282,6940,3017,1545,1752,477,149,787,550,405,15,11,379,145,131,13,90,28,14,8,0,6,237,237,51,42,144,0,0,0,0,0,0,0,0,0,95315
31283,4283,818,1051,1304,809,301,421,199,187,16,7,164,12,12,12,0,0,0,0,0,0,222,154,75,0,79,68,68,13,45,10,0,0,0,0,95316
31284,513,315,78,64,48,8,53,41,27,2,0,25,14,0,0,0,0,14,0,0,14,12,12,0,0,12,0,0,0,0,0,0,0,0,0,95317
31285,398,0,49,151,157,41,14,14,14,14,0,0,0,0,0,0,0,0,0,0,0,0,0,0,0,0,0,0,0,0,0,0,0,0,0,95318
31286,969,259,259,420,31,0,55,55,10,0,0,10,45,45,24,21,0,0,0,0,0,0,0,0,0,0,0,0,0,0,0,0,0,0,0,95319
31287,8409,1415,2090,3244,1092,568,1271,733,673,72,126,475,60,37,31,0,6,23,0,0,23,538,496,71,48,377,42,0,0,0,0,42,42,0,0,95320
31288,2863,306,786,1089,531,151,103,27,27,21,0,6,0,0,0,0,0,0,0,0,0,76,76,21,0,55,0,0,0,0,0,0,0,0,0,95321
31289,5262,1763,1746,1386,259,108,718,463,361,59,65,237,102,102,39,48,15,0,0,0,0,255,228,73,21,134,27,27,0,27,0,0,0,0,0,95322
31290,742,141,203,219,141,38,87,60,43,4,9,30,17,8,0,8,0,9,0,0,9,27,24,2,5,17,3,3,3,0,0,0,0,0,0,95323
31291,4947,1412,1538,1293,437,267,437,202,160,15,33,112,42,0,0,0,0,42,0,0,42,235,197,17,71,109,38,29,29,0,0,9,0,0,9,95324
31292,37,0,0,0,24,13,0,0,0,0,0,0,0,0,0,0,0,0,0,0,0,0,0,0,0,0,0,0,0,0,0,0,0,0,0,95325
31293,5422,1288,1580,1682,542,330,612,351,329,58,76,195,22,22,8,13,1,0,0,0,0,261,204,10,54,140,57,57,8,29,20,0,0,0,0,95326
31294,7197,1557,2293,2855,361,131,290,259,203,0,0,203,56,49,0,0,49,7,0,0,7,31,31,15,0,16,0,0,0,0,0,0,0,0,0,95327
31295,2379,896,844,512,97,30,317,207,182,5,82,95,25,25,18,0,7,0,0,0,0,110,102,18,18,66,8,8,0,0,8,0,0,0,0,95328
31296,2066,191,853,694,215,113,122,26,14,8,0,6,12,12,9,3,0,0,0,0,0,96,96,60,0,36,0,0,0,0,0,0,0,0,0,95329
31297,9770,2026,2884,3457,1211,192,1264,619,427,78,19,330,192,122,31,75,16,70,20,0,50,645,505,63,0,442,140,120,18,64,38,20,0,0,20,95330
31298,1774,817,388,416,116,37,256,82,79,0,4,75,3,3,0,3,0,0,0,0,0,174,156,22,12,122,18,13,13,0,0,5,0,0,5,95333
31299,8638,3949,2084,1826,484,295,1544,874,664,94,137,433,210,106,17,67,22,104,36,0,68,670,570,96,67,407,100,69,45,17,7,31,15,0,16,95334
31300,506,0,225,157,42,82,65,9,9,0,0,9,0,0,0,0,0,0,0,0,0,56,0,0,0,0,56,56,56,0,0,0,0,0,0,95335
31301,28226,5311,9644,9481,2736,1054,2669,1310,1088,155,137,796,222,187,69,34,84,35,35,0,0,1359,1000,179,225,596,359,268,201,26,41,91,44,14,33,95336
31302,18863,3115,4944,7378,2354,1072,1828,894,716,175,266,275,178,178,125,12,41,0,0,0,0,934,858,276,104,478,76,32,32,0,0,44,0,19,25,95337
31303,8482,988,2163,3595,1175,561,578,209,177,54,0,123,32,0,0,0,0,32,32,0,0,369,367,0,148,219,2,0,0,0,0,2,0,0,2,95338
31304,20869,3631,4557,7748,2943,1990,2567,1389,1218,81,289,848,171,171,43,20,108,0,0,0,0,1178,1056,97,133,826,122,121,79,13,29,1,0,0,1,95340
31305,16771,7616,3756,4451,728,220,2621,1485,1224,143,84,997,261,202,70,16,116,59,27,22,10,1136,933,73,114,746,203,149,76,39,34,54,0,0,54,95341
31306,276,15,21,97,99,44,0,0,0,0,0,0,0,0,0,0,0,0,0,0,0,0,0,0,0,0,0,0,0,0,0,0,0,0,0,95345
31307,1040,150,338,395,15,142,0,0,0,0,0,0,0,0,0,0,0,0,0,0,0,0,0,0,0,0,0,0,0,0,0,0,0,0,0,95346
31308,17319,4116,4075,6321,1946,861,2068,859,734,145,173,416,125,69,44,6,19,56,19,0,37,1209,1097,74,44,979,112,88,23,20,45,24,0,0,24,95348
31309,33727,5982,10132,12099,3743,1771,2592,1310,1018,113,87,818,292,116,23,42,51,176,46,12,118,1282,987,150,96,741,295,253,73,106,74,42,4,23,15,95350
31310,26888,11606,7206,6103,1468,505,2765,1385,1070,77,117,876,315,149,56,24,69,166,45,70,51,1380,1023,104,138,781,357,243,86,91,66,114,21,16,77,95351
31311,15073,3831,4549,4328,1439,926,1523,825,619,65,87,467,206,93,31,12,50,113,28,0,85,698,587,137,52,398,111,74,74,0,0,37,0,21,16,95354
31312,37350,4734,10070,13834,5749,2963,3419,1967,1608,203,71,1334,359,296,89,150,57,63,40,12,11,1452,1256,265,79,912,196,138,63,40,35,58,39,6,13,95355
31313,20852,2327,5704,7712,2954,2155,1761,842,760,31,162,567,82,82,13,61,8,0,0,0,0,919,789,155,52,582,130,105,29,8,68,25,0,0,25,95356
31314,6960,1574,1746,2264,845,531,962,545,455,105,25,325,90,81,0,67,14,9,0,0,9,417,382,85,37,260,35,0,0,0,0,35,0,0,35,95357
31315,18434,6734,4849,5036,1352,463,2348,1135,916,140,83,693,219,121,48,55,18,98,27,32,39,1213,969,241,75,653,244,208,80,78,50,36,0,0,36,95358
31316,6508,1976,1939,1882,584,127,648,223,179,29,44,106,44,12,0,12,0,32,0,32,0,425,285,78,22,185,140,140,55,17,68,0,0,0,0,95360
31317,20761,2875,6454,7845,2276,1311,2124,1010,740,110,66,564,270,254,159,58,37,16,16,0,0,1114,926,258,135,533,188,142,58,32,52,46,0,46,0,95361
31318,15463,4727,4225,4588,1408,515,1773,922,794,84,46,664,128,97,9,11,77,31,0,0,31,851,735,69,94,572,116,47,28,5,14,69,0,26,43,95363
31319,0,0,0,0,0,0,0,0,0,0,0,0,0,0,0,0,0,0,0,0,0,0,0,0,0,0,0,0,0,0,0,0,0,0,0,95364
31320,2643,1492,414,490,185,62,491,268,218,7,30,181,50,37,31,6,0,13,0,0,13,223,186,41,10,135,37,37,21,0,16,0,0,0,0,95365
31321,10626,1095,2567,4133,1932,899,1102,559,486,63,38,385,73,42,41,0,1,31,0,8,23,543,543,124,20,399,0,0,0,0,0,0,0,0,0,95366
31322,13909,3249,4019,4640,1502,499,1576,899,672,167,32,473,227,203,142,55,6,24,0,16,8,677,532,97,24,411,145,132,79,53,0,13,0,13,0,95367
31323,8489,1569,3065,2517,1083,255,1169,626,586,114,76,396,40,19,19,0,0,21,0,0,21,543,356,46,18,292,187,187,28,57,102,0,0,0,0,95368
31324,617,149,186,215,59,8,82,44,33,5,6,22,11,11,0,7,4,0,0,0,0,38,38,7,0,31,0,0,0,0,0,0,0,0,0,95369
31325,20176,1861,5430,8138,3168,1579,1431,764,610,199,57,354,154,140,37,97,6,14,0,14,0,667,597,227,183,187,70,70,65,5,0,0,0,0,0,95370
31326,1031,37,181,666,107,40,164,46,31,0,0,31,15,15,15,0,0,0,0,0,0,118,110,28,55,27,8,8,8,0,0,0,0,0,0,95372
31327,1161,610,207,285,35,24,64,37,15,0,0,15,22,22,0,22,0,0,0,0,0,27,0,0,0,0,27,27,27,0,0,0,0,0,0,95374
31328,115,1,72,42,0,0,27,0,0,0,0,0,0,0,0,0,0,0,0,0,0,27,27,27,0,0,0,0,0,0,0,0,0,0,0,95375
31329,30059,5971,9257,10295,3609,927,3284,1845,1507,198,338,971,338,144,63,35,46,194,85,94,15,1439,1269,347,226,696,170,140,111,29,0,30,0,0,30,95376
31330,18302,2573,3858,6696,4040,1135,1780,1044,913,106,63,744,131,124,57,33,34,7,0,0,7,736,633,175,69,389,103,101,74,0,27,2,0,0,2,95377
31331,2876,203,1061,1155,235,222,131,40,37,0,0,37,3,2,0,0,2,1,0,1,0,91,23,23,0,0,68,27,27,0,0,41,0,41,0,95379
31332,24708,6711,7125,7301,2392,1179,2475,1165,808,139,54,615,357,279,166,86,27,78,33,22,23,1310,1078,225,126,727,232,197,58,67,72,35,0,0,35,95380
31333,23740,3004,6064,7667,4538,2467,2718,1706,1517,224,38,1255,189,150,63,62,25,39,0,39,0,1012,868,144,219,505,144,107,34,41,32,37,20,0,17,95382
31334,2557,162,618,1029,481,267,88,40,40,0,0,40,0,0,0,0,0,0,0,0,0,48,48,0,22,26,0,0,0,0,0,0,0,0,0,95383
31335,263,83,37,87,40,16,0,0,0,0,0,0,0,0,0,0,0,0,0,0,0,0,0,0,0,0,0,0,0,0,0,0,0,0,0,95385
31336,5697,1787,1478,1840,369,223,796,458,415,13,60,342,43,17,0,17,0,26,7,0,19,338,301,83,44,174,37,37,30,0,7,0,0,0,0,95386
31337,479,272,111,68,28,0,42,6,6,6,0,0,0,0,0,0,0,0,0,0,0,36,30,0,0,30,6,6,6,0,0,0,0,0,0,95387
31338,7708,3584,1920,1584,520,100,1085,597,509,49,84,376,88,88,64,0,24,0,0,0,0,488,377,38,50,289,111,111,74,1,36,0,0,0,0,95388
31339,978,56,329,397,118,78,30,0,0,0,0,0,0,0,0,0,0,0,0,0,0,30,0,0,0,0,30,30,30,0,0,0,0,0,0,95389
31340,6906,499,1298,2481,1794,834,668,278,243,88,19,136,35,35,0,0,35,0,0,0,0,390,390,59,72,259,0,0,0,0,0,0,0,0,0,95391
31341,24339,4977,5526,8803,3380,1653,1899,1053,873,275,218,380,180,161,73,42,46,19,19,0,0,846,782,215,57,510,64,52,43,0,9,12,12,0,0,95401
31342,30426,4723,6643,11253,5289,2518,2480,1312,1153,219,104,830,159,117,69,36,12,42,29,0,13,1168,1099,298,86,715,69,41,22,13,6,28,0,0,28,95403
31343,27748,2815,4701,8691,6950,4591,2301,1320,958,145,86,727,362,229,229,0,0,133,87,32,14,981,833,182,77,574,148,123,123,0,0,25,0,0,25,95404
31344,15466,997,2533,5630,4076,2230,997,623,530,206,100,224,93,93,30,63,0,0,0,0,0,374,250,166,15,69,124,124,124,0,0,0,0,0,0,95405
31345,24395,6946,6511,7417,2395,1126,2275,926,749,88,86,575,177,117,64,53,0,60,0,42,18,1349,1174,200,96,878,175,114,96,0,18,61,0,40,21,95407
31346,19504,1218,3007,6959,4762,3558,1213,654,594,90,88,416,60,13,13,0,0,47,0,0,47,559,504,113,63,328,55,55,32,17,6,0,0,0,0,95409
31347,682,13,147,312,184,26,78,52,39,6,0,33,13,13,13,0,0,0,0,0,0,26,26,0,13,13,0,0,0,0,0,0,0,0,0,95410
31348,220,46,49,94,21,10,8,4,4,0,0,4,0,0,0,0,0,0,0,0,0,4,4,0,0,4,0,0,0,0,0,0,0,0,0,95412
31349,1050,341,218,303,149,39,130,39,39,10,0,29,0,0,0,0,0,0,0,0,0,91,76,20,0,56,15,0,0,0,0,15,0,0,15,95415
31350,185,47,12,55,45,26,10,5,5,0,1,4,0,0,0,0,0,0,0,0,0,5,5,4,0,1,0,0,0,0,0,0,0,0,0,95417
31351,283,1,64,108,64,46,1,1,1,1,0,0,0,0,0,0,0,0,0,0,0,0,0,0,0,0,0,0,0,0,0,0,0,0,0,95420
31352,1260,80,293,460,251,176,65,40,40,11,6,23,0,0,0,0,0,0,0,0,0,25,25,0,0,25,0,0,0,0,0,0,0,0,0,95421
31353,10458,1993,3090,4609,516,250,1089,631,384,88,0,296,247,95,0,95,0,152,0,110,42,458,266,0,61,205,192,138,93,0,45,54,0,0,54,95422
31354,2521,496,832,944,135,114,141,116,79,0,0,79,37,0,0,0,0,37,0,0,37,25,25,8,0,17,0,0,0,0,0,0,0,0,0,95423
31355,7572,1380,1802,2687,1048,655,481,248,248,42,24,182,0,0,0,0,0,0,0,0,0,233,214,106,13,95,19,11,11,0,0,8,0,8,0,95425
31356,1274,102,303,405,312,152,43,43,31,0,9,22,12,12,12,0,0,0,0,0,0,0,0,0,0,0,0,0,0,0,0,0,0,0,0,95426
31357,201,20,80,82,19,0,0,0,0,0,0,0,0,0,0,0,0,0,0,0,0,0,0,0,0,0,0,0,0,0,0,0,0,0,0,95427
31358,1608,238,492,710,111,57,112,51,34,0,25,9,17,0,0,0,0,17,17,0,0,61,58,16,4,38,3,0,0,0,0,3,0,0,3,95428
31359,84,11,33,35,0,5,0,0,0,0,0,0,0,0,0,0,0,0,0,0,0,0,0,0,0,0,0,0,0,0,0,0,0,0,0,95429
31360,0,0,0,0,0,0,0,0,0,0,0,0,0,0,0,0,0,0,0,0,0,0,0,0,0,0,0,0,0,0,0,0,0,0,0,95430
31361,399,87,166,146,0,0,15,15,15,0,0,15,0,0,0,0,0,0,0,0,0,0,0,0,0,0,0,0,0,0,0,0,0,0,0,95431
31362,299,8,32,132,82,45,0,0,0,0,0,0,0,0,0,0,0,0,0,0,0,0,0,0,0,0,0,0,0,0,0,0,0,0,0,95432
31363,164,0,43,121,0,0,69,0,0,0,0,0,0,0,0,0,0,0,0,0,0,69,69,0,0,69,0,0,0,0,0,0,0,0,0,95435
31364,4050,391,901,1518,717,523,162,77,37,0,12,25,40,35,19,0,16,5,0,0,5,85,85,56,9,20,0,0,0,0,0,0,0,0,0,95436
31365,10891,1350,2851,3978,1603,1109,449,209,166,27,34,105,43,40,38,2,0,3,3,0,0,240,213,86,9,118,27,27,27,0,0,0,0,0,0,95437
31366,494,88,178,188,40,0,113,69,13,0,0,13,56,56,56,0,0,0,0,0,0,44,0,0,0,0,44,44,0,0,44,0,0,0,0,95439
31367,1583,433,283,481,245,141,134,85,70,2,0,68,15,10,10,0,0,5,0,0,5,49,26,0,0,26,23,12,12,0,0,11,0,0,11,95441
31368,2750,191,545,928,735,351,103,62,55,0,0,55,7,0,0,0,0,7,0,0,7,41,41,41,0,0,0,0,0,0,0,0,0,0,0,95442
31369,197,0,57,114,0,26,0,0,0,0,0,0,0,0,0,0,0,0,0,0,0,0,0,0,0,0,0,0,0,0,0,0,0,0,0,95443
31370,485,130,87,55,139,74,84,45,45,0,0,45,0,0,0,0,0,0,0,0,0,39,19,19,0,0,20,20,20,0,0,0,0,0,0,95444
31371,1399,145,339,583,157,175,85,69,45,0,18,27,24,0,0,0,0,24,0,0,24,16,16,0,0,16,0,0,0,0,0,0,0,0,0,95445
31372,3544,271,542,1447,628,656,234,70,64,22,25,17,6,6,0,6,0,0,0,0,0,164,115,11,21,83,49,49,0,0,49,0,0,0,0,95446
31373,11620,1631,2040,3560,2531,1858,958,515,390,77,18,295,125,21,21,0,0,104,16,0,88,443,347,82,0,265,96,31,0,0,31,65,0,0,65,95448
31374,1206,161,317,528,161,39,61,29,29,8,17,4,0,0,0,0,0,0,0,0,0,32,31,9,2,20,1,1,0,0,1,0,0,0,0,95449
31375,198,14,29,91,46,18,5,5,5,0,2,3,0,0,0,0,0,0,0,0,0,0,0,0,0,0,0,0,0,0,0,0,0,0,0,95450
31376,8958,1085,2083,4186,1272,332,378,207,196,85,15,96,11,11,11,0,0,0,0,0,0,171,119,42,0,77,52,52,0,43,9,0,0,0,0,95451
31377,904,119,151,219,267,148,32,10,10,0,0,10,0,0,0,0,0,0,0,0,0,22,22,0,0,22,0,0,0,0,0,0,0,0,0,95452
31378,7873,1189,1991,3138,1115,440,570,342,241,27,6,208,101,13,6,0,7,88,0,0,88,228,216,78,46,92,12,12,8,0,4,0,0,0,0,95453
31379,1667,221,690,506,145,105,94,22,20,0,1,19,2,0,0,0,0,2,0,2,0,72,64,30,0,34,8,7,0,7,0,1,0,1,0,95454
31380,614,34,70,254,146,110,23,18,18,8,10,0,0,0,0,0,0,0,0,0,0,5,5,0,0,5,0,0,0,0,0,0,0,0,0,95456
31381,2499,427,706,1028,281,57,123,105,105,0,0,105,0,0,0,0,0,0,0,0,0,18,18,18,0,0,0,0,0,0,0,0,0,0,0,95457
31382,2008,299,669,873,112,55,250,83,58,0,0,58,25,25,0,25,0,0,0,0,0,167,154,20,35,99,13,13,0,0,13,0,0,0,0,95458
31383,354,71,73,94,79,37,18,10,6,6,0,0,4,4,0,4,0,0,0,0,0,8,0,0,0,0,8,8,0,8,0,0,0,0,0,95459
31384,2062,74,236,798,553,401,60,13,13,0,13,0,0,0,0,0,0,0,0,0,0,47,47,40,0,7,0,0,0,0,0,0,0,0,0,95460
31385,2841,191,753,1001,634,262,53,42,30,0,30,0,12,0,0,0,0,12,0,12,0,11,0,0,0,0,11,11,0,10,1,0,0,0,0,95461
31386,946,42,225,382,144,153,119,37,22,0,0,22,15,0,0,0,0,15,0,0,15,82,78,14,0,64,4,4,0,0,4,0,0,0,0,95462
31387,0,0,0,0,0,0,0,0,0,0,0,0,0,0,0,0,0,0,0,0,0,0,0,0,0,0,0,0,0,0,0,0,0,0,0,95463
31388,1722,304,701,553,114,50,127,126,54,0,0,54,72,0,0,0,0,72,4,28,40,1,1,1,0,0,0,0,0,0,0,0,0,0,0,95464
31389,1736,9,200,633,473,421,87,59,59,26,0,33,0,0,0,0,0,0,0,0,0,28,28,26,0,2,0,0,0,0,0,0,0,0,0,95465
31390,624,176,175,137,81,55,123,95,79,23,0,56,16,16,16,0,0,0,0,0,0,28,28,13,0,15,0,0,0,0,0,0,0,0,0,95466
31391,3614,225,989,1472,614,314,295,218,205,13,69,123,13,13,0,0,13,0,0,0,0,77,71,0,0,71,6,6,6,0,0,0,0,0,0,95467
31392,823,118,256,225,74,150,77,59,39,12,0,27,20,10,8,0,2,10,0,0,10,18,14,5,0,9,4,4,0,4,0,0,0,0,0,95468
31393,1267,109,351,519,199,89,134,57,57,6,0,51,0,0,0,0,0,0,0,0,0,77,77,14,0,63,0,0,0,0,0,0,0,0,0,95469
31394,4331,725,1035,1786,519,266,341,238,189,53,17,119,49,49,42,7,0,0,0,0,0,103,62,6,29,27,41,41,1,40,0,0,0,0,0,95470
31395,286,44,24,196,22,0,0,0,0,0,0,0,0,0,0,0,0,0,0,0,0,0,0,0,0,0,0,0,0,0,0,0,0,0,0,95471
31396,23062,1650,4152,7774,5701,3785,1432,855,673,192,49,432,182,133,40,71,22,49,32,0,17,577,512,155,17,340,65,40,32,8,0,25,25,0,0,95472
31397,28597,4505,4735,8759,7165,3433,1551,867,738,365,68,305,129,22,7,15,0,107,82,0,25,684,580,90,102,388,104,104,37,50,17,0,0,0,0,95476
31398,21865,3966,5660,7917,2752,1570,2024,1178,858,118,62,678,320,240,48,99,93,80,15,26,39,846,709,370,71,268,137,94,62,14,18,43,0,43,0,95482
31399,1512,380,311,580,119,122,82,56,56,0,11,45,0,0,0,0,0,0,0,0,0,26,26,0,0,26,0,0,0,0,0,0,0,0,0,95485
31400,30,0,0,14,16,0,0,0,0,0,0,0,0,0,0,0,0,0,0,0,0,0,0,0,0,0,0,0,0,0,0,0,0,0,0,95486
31401,217,9,110,54,14,30,0,0,0,0,0,0,0,0,0,0,0,0,0,0,0,0,0,0,0,0,0,0,0,0,0,0,0,0,0,95488
31402,8865,1168,2441,3582,960,714,266,144,133,44,3,86,11,11,11,0,0,0,0,0,0,122,57,0,4,53,65,17,2,0,15,48,0,0,48,95490
31403,18852,2426,4068,6958,3799,1601,1970,954,849,239,110,500,105,78,53,0,25,27,0,12,15,1016,968,376,48,544,48,37,10,27,0,11,0,0,11,95492
31404,276,23,93,136,24,0,0,0,0,0,0,0,0,0,0,0,0,0,0,0,0,0,0,0,0,0,0,0,0,0,0,0,0,0,0,95493
31405,118,54,24,8,20,12,43,34,34,0,0,34,0,0,0,0,0,0,0,0,0,9,9,0,0,9,0,0,0,0,0,0,0,0,0,95494
31406,855,4,62,193,219,377,7,0,0,0,0,0,0,0,0,0,0,0,0,0,0,7,7,0,0,7,0,0,0,0,0,0,0,0,0,95497
31407,16458,1886,4160,6185,2960,1267,945,437,321,76,59,186,116,95,54,19,22,21,8,0,13,508,398,97,57,244,110,110,63,13,34,0,0,0,0,95501
31408,17544,1828,4592,6575,3150,1399,1256,766,724,145,77,502,42,26,26,0,0,16,0,0,16,490,421,169,35,217,69,68,19,26,23,1,0,0,1,95503
31409,340,94,104,142,0,0,0,0,0,0,0,0,0,0,0,0,0,0,0,0,0,0,0,0,0,0,0,0,0,0,0,0,0,0,0,95511
31410,152,2,68,80,2,0,0,0,0,0,0,0,0,0,0,0,0,0,0,0,0,0,0,0,0,0,0,0,0,0,0,0,0,0,0,95514
31411,13244,1209,3251,4494,2975,1315,730,300,278,78,0,200,22,22,12,0,10,0,0,0,0,430,430,202,41,187,0,0,0,0,0,0,0,0,0,95519
31412,11032,812,1906,3646,2783,1885,2677,1062,1002,100,142,760,60,53,42,0,11,7,0,0,7,1615,1453,356,183,914,162,123,44,65,14,39,7,0,32,95521
31413,1330,55,215,370,362,328,66,62,62,4,21,37,0,0,0,0,0,0,0,0,0,4,4,0,0,4,0,0,0,0,0,0,0,0,0,95524
31414,1282,75,385,400,326,96,48,24,16,0,0,16,8,8,8,0,0,0,0,0,0,24,24,5,0,19,0,0,0,0,0,0,0,0,0,95525
31415,239,41,74,86,24,14,5,0,0,0,0,0,0,0,0,0,0,0,0,0,0,5,5,0,0,5,0,0,0,0,0,0,0,0,0,95526
31416,414,41,158,174,35,6,12,12,12,0,0,12,0,0,0,0,0,0,0,0,0,0,0,0,0,0,0,0,0,0,0,0,0,0,0,95527
31417,794,99,225,329,92,49,56,35,35,0,0,35,0,0,0,0,0,0,0,0,0,21,10,0,0,10,11,11,11,0,0,0,0,0,0,95528
31418,16938,3562,5326,5567,1561,922,1319,673,510,82,31,397,163,96,87,0,9,67,0,0,67,646,581,195,67,319,65,58,28,10,20,7,0,0,7,95531
31419,2277,172,711,901,381,112,161,79,79,14,5,60,0,0,0,0,0,0,0,0,0,82,58,34,4,20,24,20,13,0,7,4,0,4,0,95536
31420,44,23,0,21,0,0,0,0,0,0,0,0,0,0,0,0,0,0,0,0,0,0,0,0,0,0,0,0,0,0,0,0,0,0,0,95537
31421,8380,1067,2387,3473,972,481,809,542,436,77,0,359,106,88,84,0,4,18,11,0,7,267,217,76,0,141,50,40,8,0,32,10,0,0,10,95540
31422,1630,68,635,659,224,44,96,59,59,46,0,13,0,0,0,0,0,0,0,0,0,37,37,10,11,16,0,0,0,0,0,0,0,0,0,95542
31423,400,2,149,197,33,19,33,20,20,0,0,20,0,0,0,0,0,0,0,0,0,13,13,0,13,0,0,0,0,0,0,0,0,0,0,95543
31424,64,0,58,0,6,0,0,0,0,0,0,0,0,0,0,0,0,0,0,0,0,0,0,0,0,0,0,0,0,0,0,0,0,0,0,95545
31425,1943,348,591,662,229,113,232,128,88,9,8,71,40,20,20,0,0,20,0,20,0,104,97,6,17,74,7,7,0,3,4,0,0,0,0,95546
31426,969,54,235,408,223,49,99,52,36,0,0,36,16,16,12,0,4,0,0,0,0,47,36,0,0,36,11,11,11,0,0,0,0,0,0,95547
31427,1010,256,329,324,75,26,76,26,20,3,3,14,6,4,4,0,0,2,0,0,2,50,45,15,19,11,5,3,0,0,3,2,0,0,2,95548
31428,594,20,116,277,134,47,84,32,32,19,11,2,0,0,0,0,0,0,0,0,0,52,50,0,24,26,2,2,2,0,0,0,0,0,0,95549
31429,152,8,11,70,63,0,38,15,0,0,0,0,15,15,15,0,0,0,0,0,0,23,23,0,0,23,0,0,0,0,0,0,0,0,0,95550
31430,1307,124,413,474,242,54,246,213,130,23,11,96,83,71,0,0,71,12,4,0,8,33,20,0,17,3,13,13,2,3,8,0,0,0,0,95551
31431,459,27,155,146,93,38,21,21,21,0,0,21,0,0,0,0,0,0,0,0,0,0,0,0,0,0,0,0,0,0,0,0,0,0,0,95552
31432,873,10,127,355,310,71,79,42,42,0,42,0,0,0,0,0,0,0,0,0,0,37,0,0,0,0,37,37,0,0,37,0,0,0,0,95553
31433,308,62,112,39,50,45,14,14,14,0,0,14,0,0,0,0,0,0,0,0,0,0,0,0,0,0,0,0,0,0,0,0,0,0,0,95554
31434,290,28,69,157,27,9,16,16,16,0,0,16,0,0,0,0,0,0,0,0,0,0,0,0,0,0,0,0,0,0,0,0,0,0,0,95555
31435,441,4,85,286,0,66,39,36,32,0,0,32,4,4,4,0,0,0,0,0,0,3,3,0,0,3,0,0,0,0,0,0,0,0,0,95556
31436,277,12,48,103,87,27,3,0,0,0,0,0,0,0,0,0,0,0,0,0,0,3,3,3,0,0,0,0,0,0,0,0,0,0,0,95558
31437,113,48,38,27,0,0,0,0,0,0,0,0,0,0,0,0,0,0,0,0,0,0,0,0,0,0,0,0,0,0,0,0,0,0,0,95559
31438,912,23,298,416,102,73,19,4,0,0,0,0,4,4,0,0,4,0,0,0,0,15,15,0,0,15,0,0,0,0,0,0,0,0,0,95560
31439,2420,251,950,936,234,49,116,49,40,0,6,34,9,9,0,0,9,0,0,0,0,67,67,0,10,57,0,0,0,0,0,0,0,0,0,95562
31440,566,36,132,246,127,25,27,25,13,1,0,12,12,12,0,0,12,0,0,0,0,2,2,0,0,2,0,0,0,0,0,0,0,0,0,95563
31441,301,38,91,79,57,36,42,37,8,4,0,4,29,5,0,0,5,24,24,0,0,5,5,5,0,0,0,0,0,0,0,0,0,0,0,95564
31442,655,61,206,324,53,11,73,41,13,0,0,13,28,28,15,13,0,0,0,0,0,32,32,5,0,27,0,0,0,0,0,0,0,0,0,95565
31443,1189,269,298,516,77,29,62,21,21,0,0,21,0,0,0,0,0,0,0,0,0,41,38,4,0,34,3,3,3,0,0,0,0,0,0,95567
31444,77,6,17,27,23,4,11,0,0,0,0,0,0,0,0,0,0,0,0,0,0,11,0,0,0,0,11,0,0,0,0,11,0,0,11,95568
31445,264,26,136,83,19,0,20,20,0,0,0,0,20,10,0,0,10,10,0,0,10,0,0,0,0,0,0,0,0,0,0,0,0,0,0,95569
31446,1671,116,233,632,455,235,55,7,4,4,0,0,3,3,0,0,3,0,0,0,0,48,40,0,14,26,8,0,0,0,0,8,0,0,8,95570
31447,133,0,43,69,21,0,0,0,0,0,0,0,0,0,0,0,0,0,0,0,0,0,0,0,0,0,0,0,0,0,0,0,0,0,0,95571
31448,1161,12,438,441,178,92,12,0,0,0,0,0,0,0,0,0,0,0,0,0,0,12,12,0,0,12,0,0,0,0,0,0,0,0,0,95573
31449,342,18,71,186,53,14,0,0,0,0,0,0,0,0,0,0,0,0,0,0,0,0,0,0,0,0,0,0,0,0,0,0,0,0,0,95585
31450,120,0,0,70,50,0,0,0,0,0,0,0,0,0,0,0,0,0,0,0,0,0,0,0,0,0,0,0,0,0,0,0,0,0,0,95587
31451,934,63,253,449,137,32,0,0,0,0,0,0,0,0,0,0,0,0,0,0,0,0,0,0,0,0,0,0,0,0,0,0,0,0,0,95589
31452,128,0,58,36,24,10,0,0,0,0,0,0,0,0,0,0,0,0,0,0,0,0,0,0,0,0,0,0,0,0,0,0,0,0,0,95595
31453,126,8,62,29,20,7,2,1,1,0,0,1,0,0,0,0,0,0,0,0,0,1,1,0,0,1,0,0,0,0,0,0,0,0,0,95601
31454,13104,1187,2973,5545,2251,1148,955,492,437,64,38,335,55,55,7,9,39,0,0,0,0,463,433,104,41,288,30,30,9,0,21,0,0,0,0,95602
31455,20556,1765,5292,7896,3750,1853,1501,944,801,202,56,543,143,122,40,23,59,21,0,21,0,557,405,83,67,255,152,145,77,18,50,7,0,0,7,95603
31456,44,0,0,12,10,22,0,0,0,0,0,0,0,0,0,0,0,0,0,0,0,0,0,0,0,0,0,0,0,0,0,0,0,0,0,95604
31457,8550,2117,2594,2682,674,483,833,488,365,48,56,261,123,106,83,23,0,17,0,0,17,345,304,126,9,169,41,25,14,0,11,16,0,0,16,95605
31458,87,7,8,32,31,9,0,0,0,0,0,0,0,0,0,0,0,0,0,0,0,0,0,0,0,0,0,0,0,0,0,0,0,0,0,95606
31459,371,46,63,147,92,23,0,0,0,0,0,0,0,0,0,0,0,0,0,0,0,0,0,0,0,0,0,0,0,0,0,0,0,0,0,95607
31460,42993,3266,8114,16416,9091,6106,3325,1747,1506,192,194,1120,241,181,84,43,54,60,11,41,8,1578,1410,322,235,853,168,114,83,7,24,54,25,0,29,95608
31461,29744,3169,7569,13039,4393,1574,2018,1106,881,242,131,508,225,166,85,64,17,59,0,59,0,912,733,292,121,320,179,150,54,46,50,29,7,0,22,95610
31462,770,95,120,274,171,110,22,8,8,0,0,8,0,0,0,0,0,0,0,0,0,14,14,0,0,14,0,0,0,0,0,0,0,0,0,95612
31463,3014,48,585,1479,562,340,206,122,122,26,20,76,0,0,0,0,0,0,0,0,0,84,84,34,0,50,0,0,0,0,0,0,0,0,0,95614
31464,678,115,133,361,46,23,22,11,7,0,0,7,4,0,0,0,0,4,0,0,4,11,11,0,11,0,0,0,0,0,0,0,0,0,0,95615
31465,21185,1011,1541,3618,6363,8652,7581,3318,3256,532,173,2551,62,29,0,0,29,33,0,0,33,4263,4182,462,196,3524,81,43,0,0,43,38,22,0,16,95616
31466,15261,524,1271,2775,4964,5727,1425,820,795,64,74,657,25,25,11,5,9,0,0,0,0,605,602,85,43,474,3,3,0,0,3,0,0,0,0,95618
31467,3496,240,1227,1462,371,196,385,220,220,13,104,103,0,0,0,0,0,0,0,0,0,165,135,28,0,107,30,30,11,0,19,0,0,0,0,95619
31468,12929,2665,3529,3893,1912,930,1616,859,655,181,36,438,204,64,63,0,1,140,23,88,29,757,617,208,38,371,140,138,138,0,0,2,0,0,2,95620
31469,27768,3024,7849,12010,3677,1208,2346,1161,974,102,185,687,187,151,53,32,66,36,9,27,0,1185,911,270,39,602,274,217,82,44,91,57,31,0,26,95621
31470,3018,202,906,1242,417,251,148,91,75,41,0,34,16,16,16,0,0,0,0,0,0,57,57,0,0,57,0,0,0,0,0,0,0,0,0,95623
31471,38250,4168,7263,14966,8822,3031,4561,2602,2272,422,333,1517,330,290,251,22,17,40,0,12,28,1959,1849,278,319,1252,110,103,77,11,15,7,0,7,0,95624
31472,125,7,28,90,0,0,0,0,0,0,0,0,0,0,0,0,0,0,0,0,0,0,0,0,0,0,0,0,0,0,0,0,0,0,0,95625
31473,3702,557,1304,1438,300,103,352,183,160,33,10,117,23,21,0,21,0,2,0,2,0,169,143,23,9,111,26,26,10,0,16,0,0,0,0,95626
31474,1878,580,458,579,157,104,208,114,77,0,0,77,37,37,0,0,37,0,0,0,0,94,65,13,0,52,29,0,0,0,0,29,0,0,29,95627
31475,29258,1903,5421,10776,7096,4062,2102,1221,1116,184,159,773,105,71,52,17,2,34,0,11,23,881,857,285,124,448,24,9,7,0,2,15,0,0,15,95628
31476,709,180,116,240,128,45,0,0,0,0,0,0,0,0,0,0,0,0,0,0,0,0,0,0,0,0,0,0,0,0,0,0,0,0,0,95629
31477,49213,3705,8512,15008,13676,8312,3044,1714,1566,256,266,1044,148,83,17,11,55,65,0,0,65,1330,1265,453,40,772,65,65,56,9,0,0,0,0,0,95630
31478,4356,318,1173,1742,768,355,332,200,158,41,7,110,42,42,0,0,42,0,0,0,0,132,132,0,0,132,0,0,0,0,0,0,0,0,0,95631
31479,18513,3471,5296,6945,2030,771,1895,919,710,137,106,467,209,188,134,13,41,21,5,16,0,976,797,216,38,543,179,166,57,87,22,13,0,0,13,95632
31480,2620,225,663,1030,444,258,163,27,9,0,0,9,18,18,0,0,18,0,0,0,0,136,121,10,51,60,15,15,0,0,15,0,0,0,0,95633
31481,2209,120,767,1002,191,129,263,156,156,64,37,55,0,0,0,0,0,0,0,0,0,107,106,52,0,54,1,1,1,0,0,0,0,0,0,95634
31482,790,80,156,294,213,47,23,18,5,5,0,0,13,13,13,0,0,0,0,0,0,5,0,0,0,0,5,0,0,0,0,5,5,0,0,95635
31483,521,15,109,258,94,45,35,35,35,0,0,35,0,0,0,0,0,0,0,0,0,0,0,0,0,0,0,0,0,0,0,0,0,0,0,95636
31484,313,63,42,105,74,29,91,31,31,0,0,31,0,0,0,0,0,0,0,0,0,60,60,0,0,60,0,0,0,0,0,0,0,0,0,95637
31485,1431,138,544,512,138,99,123,75,55,0,5,50,20,20,15,5,0,0,0,0,0,48,33,17,10,6,15,15,0,0,15,0,0,0,0,95638
31486,230,41,139,33,17,0,9,9,0,0,0,0,9,9,0,0,9,0,0,0,0,0,0,0,0,0,0,0,0,0,0,0,0,0,0,95639
31487,8073,1702,2212,3031,856,272,637,449,361,80,0,281,88,40,0,0,40,48,0,0,48,188,188,50,27,111,0,0,0,0,0,0,0,0,0,95640
31488,1268,261,395,498,67,47,52,16,10,0,7,3,6,0,0,0,0,6,0,6,0,36,36,0,6,30,0,0,0,0,0,0,0,0,0,95641
31489,4868,480,1298,2164,719,207,380,243,193,19,47,127,50,35,0,27,8,15,12,0,3,137,116,25,7,84,21,17,0,17,0,4,0,0,4,95642
31490,1240,497,300,354,48,41,38,35,18,0,0,18,17,17,0,0,17,0,0,0,0,3,3,3,0,0,0,0,0,0,0,0,0,0,0,95645
31491,18,0,4,3,4,7,25,9,0,0,0,0,9,0,0,0,0,9,9,0,0,16,5,0,0,5,11,11,11,0,0,0,0,0,0,95646
31492,34232,2269,7081,14170,7049,3663,1890,1056,897,228,109,560,159,158,43,56,59,1,0,0,1,834,769,290,59,420,65,65,37,17,11,0,0,0,0,95648
31493,8184,370,2213,2640,2005,956,647,335,276,75,53,148,59,58,8,40,10,1,0,0,1,312,294,75,0,219,18,18,0,18,0,0,0,0,0,95650
31494,355,6,129,96,101,23,16,13,13,1,0,12,0,0,0,0,0,0,0,0,0,3,0,0,0,0,3,1,1,0,0,2,2,0,0,95651
31495,402,24,128,156,69,25,4,4,4,0,0,4,0,0,0,0,0,0,0,0,0,0,0,0,0,0,0,0,0,0,0,0,0,0,0,95652
31496,319,150,76,87,0,6,14,7,7,0,0,7,0,0,0,0,0,0,0,0,0,7,7,0,0,7,0,0,0,0,0,0,0,0,0,95653
31497,2837,205,457,1240,604,331,362,166,153,17,16,120,13,0,0,0,0,13,13,0,0,196,187,27,10,150,9,9,9,0,0,0,0,0,0,95655
31498,4932,199,1043,1899,1135,656,291,168,155,43,21,91,13,0,0,0,0,13,13,0,0,123,108,26,7,75,15,15,12,3,0,0,0,0,0,95658
31499,473,99,118,151,53,52,46,22,22,0,14,8,0,0,0,0,0,0,0,0,0,24,24,2,3,19,0,0,0,0,0,0,0,0,0,95659
31500,19494,3298,6038,8138,1631,389,1769,942,820,58,21,741,122,60,19,6,35,62,19,8,35,827,665,86,64,515,162,61,51,0,10,101,0,30,71,95660
31501,21388,1338,3595,8251,5640,2564,1625,690,581,130,55,396,109,65,23,26,16,44,0,13,31,935,892,172,101,619,43,43,35,8,0,0,0,0,0,95661
31502,21988,1761,5547,9067,3878,1735,1410,710,629,90,51,488,81,51,30,9,12,30,0,28,2,700,613,157,55,401,87,87,49,0,38,0,0,0,0,95662
31503,1595,53,328,535,429,250,206,107,94,6,0,88,13,13,0,13,0,0,0,0,0,99,99,26,0,73,0,0,0,0,0,0,0,0,0,95663
31504,832,43,181,356,173,79,54,54,54,5,0,49,0,0,0,0,0,0,0,0,0,0,0,0,0,0,0,0,0,0,0,0,0,0,0,95664
31505,3425,186,1057,1482,537,163,255,98,68,27,0,41,30,10,0,0,10,20,0,0,20,157,123,60,17,46,34,6,6,0,0,28,0,0,28,95665
31506,4685,353,1376,1807,803,346,164,120,120,25,0,95,0,0,0,0,0,0,0,0,0,44,44,0,0,44,0,0,0,0,0,0,0,0,0,95666
31507,26672,1962,6893,11202,4308,2307,1771,774,656,161,136,359,118,82,23,37,22,36,28,0,8,997,862,265,120,477,135,117,53,54,10,18,0,0,18,95667
31508,607,129,140,220,73,45,72,69,69,11,0,58,0,0,0,0,0,0,0,0,0,3,2,0,0,2,1,1,0,0,1,0,0,0,0,95668
31509,2154,164,858,759,234,139,90,35,30,6,10,14,5,5,5,0,0,0,0,0,0,55,45,10,8,27,10,3,0,0,3,7,7,0,0,95669
31510,35065,3620,8021,13242,6956,3226,2871,1422,1090,157,72,861,332,257,138,89,30,75,0,75,0,1449,1346,284,124,938,103,87,57,8,22,16,8,0,8,95670
31511,3878,131,475,1455,1333,484,258,91,91,38,28,25,0,0,0,0,0,0,0,0,0,167,135,12,12,111,32,31,31,0,0,1,1,0,0,95672
31512,9880,1924,3179,3535,998,244,1026,456,440,6,41,393,16,16,0,11,5,0,0,0,0,570,543,104,72,367,27,17,10,6,1,10,10,0,0,95673
31513,547,77,177,195,54,44,28,17,17,13,0,4,0,0,0,0,0,0,0,0,0,11,9,0,3,6,2,2,0,0,2,0,0,0,0,95674
31514,251,33,87,59,72,0,0,0,0,0,0,0,0,0,0,0,0,0,0,0,0,0,0,0,0,0,0,0,0,0,0,0,0,0,0,95675
31515,15451,942,3068,6602,3383,1456,1111,636,560,129,64,367,76,41,17,19,5,35,0,0,35,475,415,178,35,202,60,50,50,0,0,10,0,0,10,95677
31516,27364,2591,6413,10560,5175,2625,2157,914,780,220,68,492,134,112,96,0,16,22,0,9,13,1243,1080,160,190,730,163,163,110,44,9,0,0,0,0,95678
31517,29,0,0,29,0,0,0,0,0,0,0,0,0,0,0,0,0,0,0,0,0,0,0,0,0,0,0,0,0,0,0,0,0,0,0,95679
31518,68,43,25,0,0,0,20,20,20,0,0,20,0,0,0,0,0,0,0,0,0,0,0,0,0,0,0,0,0,0,0,0,0,0,0,95680
31519,718,79,185,354,79,21,80,61,61,38,0,23,0,0,0,0,0,0,0,0,0,19,19,11,0,8,0,0,0,0,0,0,0,0,0,95681
31520,20360,1186,4448,8034,4540,2152,2065,1181,994,335,84,575,187,134,75,0,59,53,10,14,29,884,802,278,33,491,82,82,27,28,27,0,0,0,0,95682
31521,4838,222,637,1874,1398,707,332,213,213,60,15,138,0,0,0,0,0,0,0,0,0,119,119,0,22,97,0,0,0,0,0,0,0,0,0,95683
31522,2448,186,599,1116,412,135,26,26,26,0,0,26,0,0,0,0,0,0,0,0,0,0,0,0,0,0,0,0,0,0,0,0,0,0,0,95684
31523,3337,192,834,1572,530,209,234,155,145,36,0,109,10,0,0,0,0,10,0,0,10,79,61,17,25,19,18,0,0,0,0,18,0,0,18,95685
31524,629,241,185,163,36,4,42,22,18,0,0,18,4,4,0,4,0,0,0,0,0,20,17,7,0,10,3,3,3,0,0,0,0,0,0,95686
31525,44770,5576,11222,18582,6443,2947,3727,2025,1683,445,105,1133,342,230,137,32,61,112,0,11,101,1702,1467,498,85,884,235,195,150,0,45,40,0,0,40,95687
31526,22872,2677,5256,9132,3742,2065,1791,1093,910,248,54,608,183,156,134,11,11,27,0,27,0,698,522,176,49,297,176,176,124,40,12,0,0,0,0,95688
31527,1105,73,226,536,160,110,0,0,0,0,0,0,0,0,0,0,0,0,0,0,0,0,0,0,0,0,0,0,0,0,0,0,0,0,0,95689
31528,1405,262,283,526,199,135,78,39,6,0,0,6,33,33,33,0,0,0,0,0,0,39,39,0,0,39,0,0,0,0,0,0,0,0,0,95690
31529,22984,3930,4945,7668,4482,1959,1696,866,696,44,124,528,170,157,13,77,67,13,0,0,13,830,742,138,64,540,88,88,66,6,16,0,0,0,0,95691
31530,3106,453,778,1371,329,175,260,146,102,0,33,69,44,31,0,31,0,13,0,13,0,114,103,0,9,94,11,11,0,11,0,0,0,0,0,95692
31531,4131,369,830,1688,764,480,290,194,144,29,18,97,50,50,16,0,34,0,0,0,0,96,92,0,9,83,4,4,0,0,4,0,0,0,0,95693
31532,6678,1430,1515,2115,1109,509,634,251,115,11,6,98,136,136,49,7,80,0,0,0,0,383,369,155,6,208,14,14,0,0,14,0,0,0,0,95694
31533,25199,5235,6023,8345,3649,1947,2131,1067,762,110,61,591,305,223,176,30,17,82,30,52,0,1064,875,185,70,620,189,183,137,0,46,6,0,0,6,95695
31534,219,27,137,41,14,0,15,7,7,0,0,7,0,0,0,0,0,0,0,0,0,8,8,0,0,8,0,0,0,0,0,0,0,0,0,95697
31535,131,17,62,20,32,0,16,0,0,0,0,0,0,0,0,0,0,0,0,0,0,16,16,16,0,0,0,0,0,0,0,0,0,0,0,95698
31536,150,50,17,38,45,0,34,34,34,0,0,34,0,0,0,0,0,0,0,0,0,0,0,0,0,0,0,0,0,0,0,0,0,0,0,95699
31537,605,21,204,246,88,46,21,12,12,0,0,12,0,0,0,0,0,0,0,0,0,9,0,0,0,0,9,9,9,0,0,0,0,0,0,95701
31538,743,15,241,350,90,47,67,41,30,0,0,30,11,11,11,0,0,0,0,0,0,26,26,0,0,26,0,0,0,0,0,0,0,0,0,95703
31539,3550,191,963,1418,625,353,350,161,148,49,52,47,13,13,2,0,11,0,0,0,0,189,161,49,8,104,28,28,19,0,9,0,0,0,0,95709
31540,7094,549,2144,2781,1254,366,494,269,219,62,12,145,50,50,41,0,9,0,0,0,0,225,174,71,0,103,51,51,39,12,0,0,0,0,0,95713
31541,233,5,36,91,53,48,4,4,4,4,0,0,0,0,0,0,0,0,0,0,0,0,0,0,0,0,0,0,0,0,0,0,0,0,0,95714
31542,70,0,18,31,21,0,0,0,0,0,0,0,0,0,0,0,0,0,0,0,0,0,0,0,0,0,0,0,0,0,0,0,0,0,0,95715
31543,179,23,50,96,4,6,0,0,0,0,0,0,0,0,0,0,0,0,0,0,0,0,0,0,0,0,0,0,0,0,0,0,0,0,0,95717
31544,65,10,14,22,7,12,0,0,0,0,0,0,0,0,0,0,0,0,0,0,0,0,0,0,0,0,0,0,0,0,0,0,0,0,0,95720
31545,14,0,0,0,0,14,0,0,0,0,0,0,0,0,0,0,0,0,0,0,0,0,0,0,0,0,0,0,0,0,0,0,0,0,0,95721
31546,3456,204,615,1449,739,449,265,163,149,13,8,128,14,14,14,0,0,0,0,0,0,102,102,53,0,49,0,0,0,0,0,0,0,0,0,95722
31547,0,0,0,0,0,0,0,0,0,0,0,0,0,0,0,0,0,0,0,0,0,0,0,0,0,0,0,0,0,0,0,0,0,0,0,95724
31548,6603,534,1854,3073,754,388,250,225,204,24,20,160,21,21,21,0,0,0,0,0,0,25,23,0,0,23,2,0,0,0,0,2,0,0,2,95726
31549,464,0,105,111,191,57,0,0,0,0,0,0,0,0,0,0,0,0,0,0,0,0,0,0,0,0,0,0,0,0,0,0,0,0,0,95728
31550,19,0,1,6,4,8,4,4,4,0,0,4,0,0,0,0,0,0,0,0,0,0,0,0,0,0,0,0,0,0,0,0,0,0,0,95735
31551,101,0,0,6,40,55,98,52,52,11,0,41,0,0,0,0,0,0,0,0,0,46,46,8,0,38,0,0,0,0,0,0,0,0,0,95736
31552,5500,265,692,1623,1930,990,444,203,196,0,103,93,7,0,0,0,0,7,7,0,0,241,229,0,72,157,12,12,0,12,0,0,0,0,0,95742
31553,16099,494,2131,5004,5010,3460,1460,824,616,100,42,474,208,152,55,30,67,56,0,0,56,636,636,176,38,422,0,0,0,0,0,0,0,0,0,95746
31554,34903,1274,6314,13879,9268,4168,3115,1563,1501,265,71,1165,62,53,3,20,30,9,0,9,0,1552,1311,399,47,865,241,203,171,0,32,38,38,0,0,95747
31555,25293,3106,4181,8286,7181,2539,2740,1423,1235,153,286,796,188,137,30,20,87,51,0,25,26,1317,1231,92,67,1072,86,86,23,57,6,0,0,0,0,95757
31556,38004,3432,6975,14446,9224,3927,4436,2264,2025,248,289,1488,239,177,16,91,70,62,11,5,46,2172,1983,390,193,1400,189,138,74,31,33,51,0,10,41,95758
31557,26214,633,3266,8499,9071,4745,2206,1383,1367,162,203,1002,16,16,10,6,0,0,0,0,0,823,767,197,92,478,56,54,29,12,13,2,2,0,0,95762
31558,21939,860,3023,7763,7279,3014,2383,1191,1144,216,68,860,47,47,21,0,26,0,0,0,0,1192,1016,387,81,548,176,144,144,0,0,32,0,0,32,95765
31559,13078,2940,2548,4343,1917,1330,1449,836,709,94,44,571,127,71,43,28,0,56,28,0,28,613,518,174,44,300,95,60,39,21,0,35,24,0,11,95776
31560,5823,767,807,1980,1568,701,240,83,74,5,11,58,9,0,0,0,0,9,0,9,0,157,143,23,35,85,14,14,0,0,14,0,0,0,0,95811
31561,7877,1448,1613,2150,1794,872,157,125,74,0,0,74,51,0,0,0,0,51,0,0,51,32,32,0,5,27,0,0,0,0,0,0,0,0,0,95814
31562,15753,4797,4007,4840,1451,658,978,421,241,6,38,197,180,26,11,15,0,154,37,32,85,557,345,92,55,198,212,95,44,47,4,117,74,0,43,95815
31563,13342,843,1766,4352,3676,2705,250,110,82,0,8,74,28,0,0,0,0,28,0,0,28,140,140,55,0,85,0,0,0,0,0,0,0,0,0,95816
31564,9454,1652,1801,3164,1739,1098,744,291,232,18,14,200,59,26,0,0,26,33,0,10,23,453,377,65,26,286,76,63,11,0,52,13,0,0,13,95817
31565,14597,1404,1854,3736,4540,3063,690,383,368,99,43,226,15,4,4,0,0,11,0,0,11,307,210,36,19,155,97,76,0,19,57,21,0,0,21,95818
31566,12421,454,965,3501,4386,3115,1266,568,568,72,121,375,0,0,0,0,0,0,0,0,0,698,673,103,142,428,25,25,11,0,14,0,0,0,0,95819
31567,21994,5744,5357,7027,2527,1339,1754,849,802,118,147,537,47,38,15,23,0,9,0,9,0,905,754,152,161,441,151,120,15,15,90,31,16,0,15,95820
31568,22811,3141,4800,9344,3507,2019,1992,701,516,78,71,367,185,167,146,0,21,18,0,18,0,1291,1139,179,90,870,152,89,0,89,0,63,0,33,30,95821
31569,27944,6319,6835,8838,4040,1912,2534,1121,986,155,97,734,135,121,47,63,11,14,0,7,7,1413,1322,310,185,827,91,91,66,19,6,0,0,0,0,95822
31570,43094,10987,11811,14561,4448,1287,4734,2578,2017,280,80,1657,561,502,174,30,298,59,7,13,39,2156,1712,227,154,1331,444,371,128,107,136,73,0,19,54,95823
31571,17134,6707,5067,4223,930,207,2062,1243,1036,158,78,800,207,176,73,84,19,31,0,3,28,819,672,111,13,548,147,68,11,15,42,79,0,46,33,95824
31572,21076,2671,3797,7729,4579,2300,1146,487,324,40,26,258,163,163,141,22,0,0,0,0,0,659,566,141,207,218,93,86,56,16,14,7,0,0,7,95825
31573,24210,2242,4655,9714,5277,2322,1773,919,742,93,191,458,177,138,117,8,13,39,0,14,25,854,827,219,129,479,27,0,0,0,0,27,17,0,10,95826
31574,13621,1762,3254,5398,2042,1165,1131,592,494,154,48,292,98,58,34,15,9,40,0,7,33,539,496,121,65,310,43,43,0,5,38,0,0,0,0,95827
31575,36292,10268,10237,11503,3379,905,4787,2356,1984,184,177,1623,372,255,70,70,115,117,21,47,49,2431,2060,417,181,1462,371,316,83,90,143,55,10,0,45,95828
31576,15665,2079,3242,6098,3142,1104,1878,1093,991,106,89,796,102,77,48,16,13,25,25,0,0,785,715,128,85,502,70,62,48,0,14,8,0,0,8,95829
31577,470,56,79,179,134,22,51,51,51,0,13,38,0,0,0,0,0,0,0,0,0,0,0,0,0,0,0,0,0,0,0,0,0,0,0,95830
31578,30121,2291,4562,10579,7640,5049,1982,1224,1125,143,159,823,99,84,76,0,8,15,0,0,15,758,735,235,92,408,23,23,0,12,11,0,0,0,0,95831
31579,6351,2294,1741,1795,330,191,1034,382,336,38,27,271,46,0,0,0,0,46,37,0,9,652,549,75,111,363,103,100,0,83,17,3,0,0,3,95832
31580,24269,3861,5210,8672,4626,1900,2012,995,740,115,83,542,255,221,75,46,100,34,20,0,14,1017,811,86,269,456,206,116,20,42,54,90,6,40,44,95833
31581,15245,1611,3188,5578,2925,1943,1295,759,703,186,140,377,56,20,9,0,11,36,36,0,0,536,494,96,0,398,42,42,0,42,0,0,0,0,0,95834
31582,24881,1807,4238,8278,7240,3318,1927,1135,987,114,54,819,148,137,47,0,90,11,0,0,11,792,774,41,115,618,18,18,18,0,0,0,0,0,0,95835
31583,196,13,20,59,82,22,4,0,0,0,0,0,0,0,0,0,0,0,0,0,0,4,0,0,0,0,4,4,0,0,4,0,0,0,0,95837
31584,19987,6020,5941,5978,1584,464,2395,1250,1021,155,85,781,229,163,69,16,78,66,0,32,34,1145,919,135,141,643,226,165,94,21,50,61,0,0,61,95838
31585,11741,1919,2725,5061,1400,636,921,568,471,15,36,420,97,66,64,0,2,31,29,0,2,353,202,0,8,194,151,137,112,0,25,14,0,14,0,95841
31586,19721,3107,5534,8223,2214,643,1581,705,518,28,129,361,187,98,47,17,34,89,30,11,48,876,679,174,19,486,197,136,46,81,9,61,17,0,44,95842
31587,27673,2661,7894,11193,4491,1434,2916,1630,1329,285,91,953,301,263,101,45,117,38,0,16,22,1286,1162,162,97,903,124,100,48,40,12,24,0,0,24,95843
31588,15532,572,1886,4774,4410,3890,965,521,407,74,40,293,114,105,12,70,23,9,0,0,9,444,417,124,9,284,27,27,0,0,27,0,0,0,0,95864
31589,19882,4252,5423,7996,1669,542,2031,1029,868,59,96,713,161,92,34,10,48,69,0,0,69,1002,898,212,106,580,104,104,12,82,10,0,0,0,0,95901
31590,707,32,115,345,138,77,132,132,54,54,0,0,78,78,78,0,0,0,0,0,0,0,0,0,0,0,0,0,0,0,0,0,0,0,0,95903
31591,135,21,0,39,75,0,0,0,0,0,0,0,0,0,0,0,0,0,0,0,0,0,0,0,0,0,0,0,0,0,0,0,0,0,0,95910
31592,2732,915,764,666,353,34,459,210,141,0,49,92,69,34,0,0,34,35,0,0,35,249,220,14,10,196,29,17,0,0,17,12,0,0,12,95912
31593,491,91,140,229,28,3,6,0,0,0,0,0,0,0,0,0,0,0,0,0,0,6,6,0,0,6,0,0,0,0,0,0,0,0,0,95914
31594,48,0,21,27,0,0,0,0,0,0,0,0,0,0,0,0,0,0,0,0,0,0,0,0,0,0,0,0,0,0,0,0,0,0,0,95915
31595,1007,171,319,405,72,40,56,9,9,4,0,5,0,0,0,0,0,0,0,0,0,47,40,0,15,25,7,3,0,0,3,4,0,0,4,95916
31596,2177,550,614,857,118,38,149,72,67,23,0,44,5,5,5,0,0,0,0,0,0,77,77,0,16,61,0,0,0,0,0,0,0,0,0,95917
31597,1339,21,302,665,265,86,15,15,15,0,9,6,0,0,0,0,0,0,0,0,0,0,0,0,0,0,0,0,0,0,0,0,0,0,0,95918
31598,848,24,234,402,135,53,181,36,29,0,0,29,7,7,0,7,0,0,0,0,0,145,145,0,0,145,0,0,0,0,0,0,0,0,0,95919
31599,248,105,102,24,17,0,11,0,0,0,0,0,0,0,0,0,0,0,0,0,0,11,11,0,0,11,0,0,0,0,0,0,0,0,0,95920
31600,527,61,154,241,43,28,16,6,6,0,0,6,0,0,0,0,0,0,0,0,0,10,10,0,6,4,0,0,0,0,0,0,0,0,0,95922
31601,33,0,0,16,10,7,0,0,0,0,0,0,0,0,0,0,0,0,0,0,0,0,0,0,0,0,0,0,0,0,0,0,0,0,0,95923
31602,47,15,32,0,0,0,0,0,0,0,0,0,0,0,0,0,0,0,0,0,0,0,0,0,0,0,0,0,0,0,0,0,0,0,0,95925
31603,21090,1587,3551,8486,4623,2843,3885,1910,1801,205,188,1408,109,82,37,35,10,27,18,0,9,1975,1847,508,151,1188,128,101,101,0,0,27,16,0,11,95926
31604,21220,2072,3101,8525,4753,2769,2967,1621,1446,319,95,1032,175,91,42,14,35,84,5,0,79,1346,1302,239,158,905,44,22,4,6,12,22,0,0,22,95928
31605,0,0,0,0,0,0,0,0,0,0,0,0,0,0,0,0,0,0,0,0,0,0,0,0,0,0,0,0,0,0,0,0,0,0,0,95930
31606,5132,1146,1222,1876,729,159,426,271,236,50,0,186,35,11,11,0,0,24,14,0,10,155,140,10,0,130,15,15,15,0,0,0,0,0,0,95932
31607,201,0,60,97,34,10,16,16,16,0,0,16,0,0,0,0,0,0,0,0,0,0,0,0,0,0,0,0,0,0,0,0,0,0,0,95934
31608,366,54,116,99,83,14,0,0,0,0,0,0,0,0,0,0,0,0,0,0,0,0,0,0,0,0,0,0,0,0,0,0,0,0,0,95935
31609,168,0,0,114,39,15,0,0,0,0,0,0,0,0,0,0,0,0,0,0,0,0,0,0,0,0,0,0,0,0,0,0,0,0,0,95936
31610,764,164,320,171,68,41,51,26,0,0,0,0,26,0,0,0,0,26,26,0,0,25,14,14,0,0,11,11,11,0,0,0,0,0,0,95937
31611,2683,73,648,945,605,412,232,140,140,17,0,123,0,0,0,0,0,0,0,0,0,92,92,21,0,71,0,0,0,0,0,0,0,0,0,95938
31612,368,82,122,120,28,16,12,9,5,0,1,4,4,2,0,0,2,2,0,2,0,3,3,0,1,2,0,0,0,0,0,0,0,0,0,95939
31613,389,79,127,145,38,0,0,0,0,0,0,0,0,0,0,0,0,0,0,0,0,0,0,0,0,0,0,0,0,0,0,0,0,0,0,95941
31614,1059,79,63,639,80,198,48,48,48,0,0,48,0,0,0,0,0,0,0,0,0,0,0,0,0,0,0,0,0,0,0,0,0,0,0,95942
31615,530,99,163,156,76,36,48,9,2,2,0,0,7,0,0,0,0,7,7,0,0,39,22,9,8,5,17,6,3,3,0,11,11,0,0,95943
31616,0,0,0,0,0,0,0,0,0,0,0,0,0,0,0,0,0,0,0,0,0,0,0,0,0,0,0,0,0,0,0,0,0,0,0,95944
31617,18662,1458,4235,7750,3432,1787,998,512,500,100,31,369,12,0,0,0,0,12,0,0,12,486,301,42,41,218,185,185,118,10,57,0,0,0,0,95945
31618,7547,334,1685,2990,1709,829,356,166,142,0,18,124,24,15,15,0,0,9,0,0,9,190,189,101,0,88,1,1,0,0,1,0,0,0,0,95946
31619,1349,212,389,515,81,152,43,32,32,0,0,32,0,0,0,0,0,0,0,0,0,11,11,0,0,11,0,0,0,0,0,0,0,0,0,95947
31620,6182,1690,1638,1961,560,333,770,395,316,125,36,155,79,61,1,17,43,18,3,0,15,375,369,98,29,242,6,0,0,0,0,6,0,0,6,95948
31621,14961,682,3600,6602,2531,1546,910,429,360,106,42,212,69,69,14,15,40,0,0,0,0,481,464,105,55,304,17,17,0,0,17,0,0,0,0,95949
31622,415,183,34,118,58,22,16,0,0,0,0,0,0,0,0,0,0,0,0,0,0,16,16,16,0,0,0,0,0,0,0,0,0,0,0,95950
31623,1515,793,386,238,53,45,126,49,37,0,10,27,12,8,8,0,0,4,0,0,4,77,67,0,12,55,10,10,6,0,4,0,0,0,0,95951
31624,6601,2172,1538,2014,666,211,642,354,286,0,4,282,68,64,32,32,0,4,0,0,4,288,267,14,32,221,21,17,17,0,0,4,0,0,4,95953
31625,8933,863,2940,3615,1161,354,551,240,213,33,24,156,27,7,0,0,7,20,0,0,20,311,296,138,11,147,15,15,0,15,0,0,0,0,0,95954
31626,727,192,191,226,115,3,71,42,42,17,8,17,0,0,0,0,0,0,0,0,0,29,20,0,7,13,9,9,0,0,9,0,0,0,0,95955
31627,283,16,33,114,33,87,7,7,7,0,0,7,0,0,0,0,0,0,0,0,0,0,0,0,0,0,0,0,0,0,0,0,0,0,0,95956
31628,605,119,233,151,66,36,48,36,36,3,10,23,0,0,0,0,0,0,0,0,0,12,11,0,0,11,1,0,0,0,0,1,0,0,1,95957
31629,13454,617,2507,5126,3101,2103,1228,661,580,56,11,513,81,62,34,0,28,19,0,19,0,567,416,61,0,355,151,151,114,37,0,0,0,0,0,95959
31630,672,75,271,271,40,15,35,21,21,0,0,21,0,0,0,0,0,0,0,0,0,14,14,14,0,0,0,0,0,0,0,0,0,0,0,95960
31631,15467,4291,3700,5681,1298,497,1443,825,664,33,212,419,161,93,19,24,50,68,0,0,68,618,464,112,31,321,154,109,34,25,50,45,11,0,34,95961
31632,1172,54,109,486,329,194,60,15,15,0,0,15,0,0,0,0,0,0,0,0,0,45,45,0,0,45,0,0,0,0,0,0,0,0,0,95962
31633,9235,2613,2323,2964,1010,325,905,458,364,62,30,272,94,58,40,18,0,36,26,7,3,447,374,44,7,323,73,68,6,62,0,5,5,0,0,95963
31634,12756,2633,4046,4500,1142,435,1253,668,493,48,35,410,175,110,40,46,24,65,31,19,15,585,439,106,38,295,146,128,14,40,74,18,0,0,18,95965
31635,20941,3485,6571,8444,1788,653,1547,754,675,114,107,454,79,44,0,44,0,35,0,16,19,793,670,143,74,453,123,96,8,29,59,27,16,0,11,95966
31636,943,313,255,347,10,18,88,54,54,5,0,49,0,0,0,0,0,0,0,0,0,34,11,0,0,11,23,23,0,0,23,0,0,0,0,95968
31637,20460,1815,4996,8864,3391,1394,1023,562,397,48,39,310,165,153,86,33,34,12,0,12,0,461,345,81,39,225,116,116,100,16,0,0,0,0,0,95969
31638,358,94,128,80,32,24,32,16,16,0,0,16,0,0,0,0,0,0,0,0,0,16,16,5,0,11,0,0,0,0,0,0,0,0,0,95970
31639,3938,343,890,1830,546,329,275,156,126,60,0,66,30,30,30,0,0,0,0,0,0,119,119,101,0,18,0,0,0,0,0,0,0,0,0,95971
31640,21201,1950,3522,9011,4688,2030,1504,724,661,113,44,504,63,56,21,22,13,7,0,0,7,780,707,119,92,496,73,43,20,0,23,30,0,0,30,95973
31641,0,0,0,0,0,0,0,0,0,0,0,0,0,0,0,0,0,0,0,0,0,0,0,0,0,0,0,0,0,0,0,0,0,0,0,95974
31642,1389,77,401,643,246,22,51,8,8,0,0,8,0,0,0,0,0,0,0,0,0,43,43,19,0,24,0,0,0,0,0,0,0,0,0,95975
31643,1107,62,403,403,238,1,247,107,62,0,0,62,45,45,45,0,0,0,0,0,0,140,108,63,0,45,32,32,0,32,0,0,0,0,0,95977
31644,24,0,0,24,0,0,0,0,0,0,0,0,0,0,0,0,0,0,0,0,0,0,0,0,0,0,0,0,0,0,0,0,0,0,0,95978
31645,500,117,218,126,34,5,64,52,52,0,0,52,0,0,0,0,0,0,0,0,0,12,12,0,0,12,0,0,0,0,0,0,0,0,0,95979
31646,169,0,18,142,9,0,0,0,0,0,0,0,0,0,0,0,0,0,0,0,0,0,0,0,0,0,0,0,0,0,0,0,0,0,0,95981
31647,2012,128,620,881,299,84,150,95,77,16,0,61,18,18,9,9,0,0,0,0,0,55,55,0,9,46,0,0,0,0,0,0,0,0,0,95982
31648,380,27,60,185,61,47,0,0,0,0,0,0,0,0,0,0,0,0,0,0,0,0,0,0,0,0,0,0,0,0,0,0,0,0,0,95983
31649,21,0,0,21,0,0,0,0,0,0,0,0,0,0,0,0,0,0,0,0,0,0,0,0,0,0,0,0,0,0,0,0,0,0,0,95984
31650,36,17,19,0,0,0,0,0,0,0,0,0,0,0,0,0,0,0,0,0,0,0,0,0,0,0,0,0,0,0,0,0,0,0,0,95986
31651,3403,1398,878,893,161,73,326,157,52,12,15,25,105,105,59,13,33,0,0,0,0,169,150,5,0,145,19,19,19,0,0,0,0,0,0,95987
31652,6168,1260,1686,2157,644,421,547,320,300,83,18,199,20,0,0,0,0,20,0,14,6,227,193,8,0,185,34,0,0,0,0,34,0,0,34,95988
31653,24749,6175,5711,9156,2589,1118,2534,1197,906,190,102,614,291,216,32,141,43,75,38,37,0,1337,1149,255,215,679,188,148,31,93,24,40,0,40,0,95991
31654,23502,3831,5591,8351,4152,1577,2230,1280,1052,261,91,700,228,62,25,19,18,166,119,0,47,950,784,223,170,391,166,132,57,36,39,34,0,0,34,95993
31655,23497,2155,5718,9497,3799,2328,1609,948,841,157,129,555,107,82,42,10,30,25,14,0,11,661,620,167,24,429,41,34,19,0,15,7,0,0,7,96001
31656,22412,2571,5858,9581,2965,1437,2163,1199,955,86,82,787,244,184,84,90,10,60,0,0,60,964,845,224,31,590,119,78,33,0,45,41,13,0,28,96002
31657,29855,2784,7937,13198,4050,1886,2607,1309,1188,198,127,863,121,90,54,21,15,31,28,0,3,1298,1017,416,43,558,281,170,137,0,33,111,13,33,65,96003
31658,396,60,102,204,19,11,0,0,0,0,0,0,0,0,0,0,0,0,0,0,0,0,0,0,0,0,0,0,0,0,0,0,0,0,0,96006
31659,15656,2793,4631,6823,1085,324,1349,725,617,117,64,436,108,108,46,15,47,0,0,0,0,624,569,112,32,425,55,55,0,16,39,0,0,0,0,96007
31660,787,251,161,278,57,40,56,56,27,19,0,8,29,29,0,12,17,0,0,0,0,0,0,0,0,0,0,0,0,0,0,0,0,0,0,96008
31661,321,5,91,163,57,5,0,0,0,0,0,0,0,0,0,0,0,0,0,0,0,0,0,0,0,0,0,0,0,0,0,0,0,0,0,96009
31662,165,15,34,105,11,0,14,10,7,7,0,0,3,3,3,0,0,0,0,0,0,4,4,2,0,2,0,0,0,0,0,0,0,0,0,96010
31663,107,5,34,53,6,9,2,0,0,0,0,0,0,0,0,0,0,0,0,0,0,2,0,0,0,0,2,0,0,0,0,2,0,0,2,96011
31664,2583,321,897,1141,193,31,124,52,52,16,7,29,0,0,0,0,0,0,0,0,0,72,67,0,53,14,5,5,0,0,5,0,0,0,0,96013
31665,132,7,25,69,22,9,31,22,22,0,0,22,0,0,0,0,0,0,0,0,0,9,9,0,0,9,0,0,0,0,0,0,0,0,0,96014
31666,572,63,204,220,40,45,43,4,4,0,0,4,0,0,0,0,0,0,0,0,0,39,39,0,9,30,0,0,0,0,0,0,0,0,0,96015
31667,522,63,168,261,18,12,0,0,0,0,0,0,0,0,0,0,0,0,0,0,0,0,0,0,0,0,0,0,0,0,0,0,0,0,0,96016
31668,144,20,36,59,20,9,7,7,7,6,0,1,0,0,0,0,0,0,0,0,0,0,0,0,0,0,0,0,0,0,0,0,0,0,0,96017
31669,7106,1022,1988,3262,646,188,353,167,167,24,0,143,0,0,0,0,0,0,0,0,0,186,186,84,0,102,0,0,0,0,0,0,0,0,0,96019
31670,1734,172,374,877,229,82,97,78,78,0,0,78,0,0,0,0,0,0,0,0,0,19,19,0,14,5,0,0,0,0,0,0,0,0,0,96020
31671,10053,2553,3032,3409,727,332,1124,479,412,100,15,297,67,48,0,5,43,19,19,0,0,645,625,54,46,525,20,11,0,0,11,9,0,0,9,96021
31672,11343,1909,2841,4955,1058,580,1122,526,393,11,63,319,133,117,21,50,46,16,0,0,16,596,587,95,44,448,9,9,0,0,9,0,0,0,0,96022
31673,779,150,275,270,72,12,50,17,13,5,0,8,4,4,0,4,0,0,0,0,0,33,30,7,8,15,3,3,0,0,3,0,0,0,0,96023
31674,870,40,212,401,161,56,41,19,19,0,0,19,0,0,0,0,0,0,0,0,0,22,14,0,0,14,8,8,0,0,8,0,0,0,0,96024
31675,1728,281,429,674,232,112,72,45,37,10,0,27,8,8,0,0,8,0,0,0,0,27,27,2,10,15,0,0,0,0,0,0,0,0,0,96025
31676,1788,212,564,540,349,123,77,48,48,12,0,36,0,0,0,0,0,0,0,0,0,29,23,19,0,4,6,6,6,0,0,0,0,0,0,96027
31677,1184,92,473,433,135,51,51,21,13,0,0,13,8,0,0,0,0,8,0,0,8,30,25,25,0,0,5,5,5,0,0,0,0,0,0,96028
31678,99,12,34,35,16,2,4,0,0,0,0,0,0,0,0,0,0,0,0,0,0,4,4,0,0,4,0,0,0,0,0,0,0,0,0,96029
31679,171,16,62,47,39,7,0,0,0,0,0,0,0,0,0,0,0,0,0,0,0,0,0,0,0,0,0,0,0,0,0,0,0,0,0,96031
31680,1578,140,390,606,319,123,105,93,44,2,0,42,49,49,28,0,21,0,0,0,0,12,9,0,0,9,3,0,0,0,0,3,0,3,0,96032
31681,369,42,153,140,5,29,30,20,9,1,0,8,11,11,0,0,11,0,0,0,0,10,10,0,0,10,0,0,0,0,0,0,0,0,0,96033
31682,294,73,99,99,20,3,9,7,7,0,0,7,0,0,0,0,0,0,0,0,0,2,2,0,0,2,0,0,0,0,0,0,0,0,0,96034
31683,2219,503,648,809,185,74,260,145,76,12,35,29,69,43,0,12,31,26,0,26,0,115,61,24,9,28,54,51,0,51,0,3,0,0,3,96035
31684,215,7,125,19,64,0,0,0,0,0,0,0,0,0,0,0,0,0,0,0,0,0,0,0,0,0,0,0,0,0,0,0,0,0,0,96037
31685,447,69,189,150,34,5,11,6,0,0,0,0,6,6,6,0,0,0,0,0,0,5,4,0,0,4,1,1,1,0,0,0,0,0,0,96038
31686,941,109,318,324,147,43,69,44,38,4,3,31,6,6,6,0,0,0,0,0,0,25,24,0,0,24,1,1,0,1,0,0,0,0,0,96039
31687,170,64,19,61,17,9,23,0,0,0,0,0,0,0,0,0,0,0,0,0,0,23,17,9,8,0,6,6,6,0,0,0,0,0,0,96040
31688,2252,245,712,760,426,109,91,16,6,0,6,0,10,10,0,10,0,0,0,0,0,75,47,6,5,36,28,28,0,0,28,0,0,0,0,96041
31689,720,101,227,303,51,38,16,7,7,0,0,7,0,0,0,0,0,0,0,0,0,9,6,0,0,6,3,3,3,0,0,0,0,0,0,96044
31690,192,9,85,98,0,0,8,8,0,0,0,0,8,8,0,8,0,0,0,0,0,0,0,0,0,0,0,0,0,0,0,0,0,0,0,96046
31691,547,71,138,223,83,32,54,27,21,12,0,9,6,3,3,0,0,3,0,3,0,27,11,0,0,11,16,16,0,16,0,0,0,0,0,96047
31692,755,102,166,299,139,49,48,21,19,14,0,5,2,2,2,0,0,0,0,0,0,27,27,0,4,23,0,0,0,0,0,0,0,0,0,96048
31693,42,14,4,24,0,0,10,10,0,0,0,0,10,0,0,0,0,10,0,0,10,0,0,0,0,0,0,0,0,0,0,0,0,0,0,96049
31694,345,29,119,135,39,23,14,3,3,0,0,3,0,0,0,0,0,0,0,0,0,11,6,0,3,3,5,5,0,0,5,0,0,0,0,96050
31695,942,55,248,403,145,91,20,0,0,0,0,0,0,0,0,0,0,0,0,0,0,20,0,0,0,0,20,14,0,0,14,6,0,0,6,96051
31696,1224,150,307,582,143,42,38,33,16,0,7,9,17,17,0,11,6,0,0,0,0,5,5,5,0,0,0,0,0,0,0,0,0,0,0,96052
31697,159,38,40,75,0,6,18,18,18,0,0,18,0,0,0,0,0,0,0,0,0,0,0,0,0,0,0,0,0,0,0,0,0,0,0,96054
31698,2909,627,772,1111,237,162,194,100,80,0,0,80,20,20,0,0,20,0,0,0,0,94,86,0,0,86,8,8,8,0,0,0,0,0,0,96055
31699,1325,125,280,617,211,92,51,7,0,0,0,0,7,0,0,0,0,7,7,0,0,44,44,0,21,23,0,0,0,0,0,0,0,0,0,96056
31700,1192,94,251,591,196,60,22,7,1,0,0,1,6,6,6,0,0,0,0,0,0,15,4,0,0,4,11,11,11,0,0,0,0,0,0,96057
31701,622,121,165,178,117,41,19,0,0,0,0,0,0,0,0,0,0,0,0,0,0,19,19,0,0,19,0,0,0,0,0,0,0,0,0,96058
31702,588,91,111,309,56,21,36,22,22,0,0,22,0,0,0,0,0,0,0,0,0,14,12,7,0,5,2,2,2,0,0,0,0,0,0,96059
31703,27,0,10,15,2,0,0,0,0,0,0,0,0,0,0,0,0,0,0,0,0,0,0,0,0,0,0,0,0,0,0,0,0,0,0,96061
31704,803,81,199,288,152,83,45,23,23,6,0,17,0,0,0,0,0,0,0,0,0,22,14,0,4,10,8,8,0,8,0,0,0,0,0,96062
31705,188,3,28,70,37,50,0,0,0,0,0,0,0,0,0,0,0,0,0,0,0,0,0,0,0,0,0,0,0,0,0,0,0,0,0,96063
31706,3275,381,877,1518,328,171,185,64,45,7,5,33,19,19,11,8,0,0,0,0,0,121,110,25,16,69,11,11,6,0,5,0,0,0,0,96064
31707,269,31,22,158,28,30,10,8,8,0,0,8,0,0,0,0,0,0,0,0,0,2,0,0,0,0,2,2,2,0,0,0,0,0,0,96065
31708,5638,233,1123,2044,1534,704,345,216,178,75,45,58,38,38,38,0,0,0,0,0,0,129,129,53,40,36,0,0,0,0,0,0,0,0,0,96067
31709,141,33,40,56,9,3,4,4,4,0,0,4,0,0,0,0,0,0,0,0,0,0,0,0,0,0,0,0,0,0,0,0,0,0,0,96068
31710,662,80,210,271,74,27,27,14,14,10,0,4,0,0,0,0,0,0,0,0,0,13,13,3,0,10,0,0,0,0,0,0,0,0,0,96069
31711,78,9,12,57,0,0,0,0,0,0,0,0,0,0,0,0,0,0,0,0,0,0,0,0,0,0,0,0,0,0,0,0,0,0,0,96071
31712,3227,118,659,1464,604,382,362,220,200,34,7,159,20,20,0,18,2,0,0,0,0,142,140,10,0,130,2,2,2,0,0,0,0,0,0,96073
31713,180,79,55,44,0,2,0,0,0,0,0,0,0,0,0,0,0,0,0,0,0,0,0,0,0,0,0,0,0,0,0,0,0,0,0,96074
31714,279,66,59,112,33,9,22,6,0,0,0,0,6,6,1,3,2,0,0,0,0,16,16,5,0,11,0,0,0,0,0,0,0,0,0,96075
31715,163,0,113,26,24,0,5,5,0,0,0,0,5,0,0,0,0,5,0,0,5,0,0,0,0,0,0,0,0,0,0,0,0,0,0,96076
31716,18808,2844,5688,7689,1686,901,1426,805,691,165,188,338,114,87,40,34,13,27,0,0,27,621,470,39,125,306,151,151,33,16,102,0,0,0,0,96080
31717,529,64,154,223,27,61,4,4,4,0,0,4,0,0,0,0,0,0,0,0,0,0,0,0,0,0,0,0,0,0,0,0,0,0,0,96084
31718,39,7,11,16,5,0,2,2,2,0,2,0,0,0,0,0,0,0,0,0,0,0,0,0,0,0,0,0,0,0,0,0,0,0,0,96085
31719,298,38,58,145,50,7,15,4,4,0,0,4,0,0,0,0,0,0,0,0,0,11,5,0,0,5,6,0,0,0,0,6,0,6,0,96086
31720,447,77,106,128,133,3,8,8,8,0,0,8,0,0,0,0,0,0,0,0,0,0,0,0,0,0,0,0,0,0,0,0,0,0,0,96087
31721,3530,413,751,1660,434,272,153,126,120,0,0,120,6,6,0,0,6,0,0,0,0,27,20,15,0,5,7,7,7,0,0,0,0,0,0,96088
31722,262,40,60,106,47,9,23,20,20,0,14,6,0,0,0,0,0,0,0,0,0,3,3,0,0,3,0,0,0,0,0,0,0,0,0,96090
31723,569,45,145,256,102,21,10,0,0,0,0,0,0,0,0,0,0,0,0,0,0,10,10,5,0,5,0,0,0,0,0,0,0,0,0,96091
31724,214,19,49,90,31,25,7,7,7,0,0,7,0,0,0,0,0,0,0,0,0,0,0,0,0,0,0,0,0,0,0,0,0,0,0,96092
31725,2732,201,746,1199,428,158,203,191,122,0,0,122,69,69,69,0,0,0,0,0,0,12,12,12,0,0,0,0,0,0,0,0,0,0,0,96093
31726,4401,413,930,1901,719,438,442,295,185,48,44,93,110,101,101,0,0,9,0,0,9,147,71,22,12,37,76,76,65,11,0,0,0,0,0,96094
31727,639,65,129,301,82,62,33,16,16,13,2,1,0,0,0,0,0,0,0,0,0,17,9,5,0,4,8,8,0,0,8,0,0,0,0,96096
31728,6549,784,2017,2552,717,479,583,298,210,48,14,148,88,20,7,10,3,68,0,22,46,285,273,108,21,144,12,11,0,1,10,1,0,0,1,96097
31729,3481,571,1046,1231,477,156,245,155,119,6,0,113,36,0,0,0,0,36,15,21,0,90,79,33,0,46,11,0,0,0,0,11,11,0,0,96101
31730,1107,65,173,531,208,130,46,1,1,0,0,1,0,0,0,0,0,0,0,0,0,45,45,0,45,0,0,0,0,0,0,0,0,0,0,96103
31731,586,48,109,276,134,19,23,5,5,5,0,0,0,0,0,0,0,0,0,0,0,18,18,0,0,18,0,0,0,0,0,0,0,0,0,96104
31732,231,54,91,53,0,33,17,0,0,0,0,0,0,0,0,0,0,0,0,0,0,17,17,0,0,17,0,0,0,0,0,0,0,0,0,96105
31733,215,30,25,39,56,65,9,9,9,9,0,0,0,0,0,0,0,0,0,0,0,0,0,0,0,0,0,0,0,0,0,0,0,0,0,96106
31734,911,172,237,399,69,34,3,3,0,0,0,0,3,3,3,0,0,0,0,0,0,0,0,0,0,0,0,0,0,0,0,0,0,0,0,96107
31735,16,0,8,8,0,0,0,0,0,0,0,0,0,0,0,0,0,0,0,0,0,0,0,0,0,0,0,0,0,0,0,0,0,0,0,96108
31736,623,73,149,359,42,0,0,0,0,0,0,0,0,0,0,0,0,0,0,0,0,0,0,0,0,0,0,0,0,0,0,0,0,0,0,96109
31737,107,17,24,44,19,3,0,0,0,0,0,0,0,0,0,0,0,0,0,0,0,0,0,0,0,0,0,0,0,0,0,0,0,0,0,96110
31738,60,0,10,31,13,6,0,0,0,0,0,0,0,0,0,0,0,0,0,0,0,0,0,0,0,0,0,0,0,0,0,0,0,0,0,96111
31739,141,27,33,50,21,10,31,14,14,0,0,14,0,0,0,0,0,0,0,0,0,17,17,0,0,17,0,0,0,0,0,0,0,0,0,96112
31740,1619,557,509,450,54,49,35,28,15,0,0,15,13,2,1,0,1,11,0,0,11,7,7,0,4,3,0,0,0,0,0,0,0,0,0,96113
31741,2377,221,396,1229,444,87,234,112,112,30,0,82,0,0,0,0,0,0,0,0,0,122,122,0,34,88,0,0,0,0,0,0,0,0,0,96114
31742,168,0,73,42,41,12,0,0,0,0,0,0,0,0,0,0,0,0,0,0,0,0,0,0,0,0,0,0,0,0,0,0,0,0,0,96115
31743,190,41,33,108,8,0,0,0,0,0,0,0,0,0,0,0,0,0,0,0,0,0,0,0,0,0,0,0,0,0,0,0,0,0,0,96116
31744,144,9,41,71,7,16,23,0,0,0,0,0,0,0,0,0,0,0,0,0,0,23,23,0,0,23,0,0,0,0,0,0,0,0,0,96117
31745,1199,93,599,416,84,7,80,80,4,4,0,0,76,47,0,0,47,29,0,0,29,0,0,0,0,0,0,0,0,0,0,0,0,0,0,96118
31746,69,44,25,0,0,0,2,2,2,0,0,2,0,0,0,0,0,0,0,0,0,0,0,0,0,0,0,0,0,0,0,0,0,0,0,96119
31747,761,78,238,210,142,93,68,43,43,0,0,43,0,0,0,0,0,0,0,0,0,25,25,0,0,25,0,0,0,0,0,0,0,0,0,96120
31748,247,9,70,107,44,17,0,0,0,0,0,0,0,0,0,0,0,0,0,0,0,0,0,0,0,0,0,0,0,0,0,0,0,0,0,96121
31749,3325,478,886,1465,283,213,291,222,189,64,0,125,33,30,3,27,0,3,0,3,0,69,34,11,0,23,35,35,35,0,0,0,0,0,0,96122
31750,5,1,1,3,0,0,0,0,0,0,0,0,0,0,0,0,0,0,0,0,0,0,0,0,0,0,0,0,0,0,0,0,0,0,0,96123
31751,328,60,169,57,32,10,0,0,0,0,0,0,0,0,0,0,0,0,0,0,0,0,0,0,0,0,0,0,0,0,0,0,0,0,0,96124
31752,248,5,26,118,99,0,62,0,0,0,0,0,0,0,0,0,0,0,0,0,0,62,62,31,0,31,0,0,0,0,0,0,0,0,0,96125
31753,61,47,2,0,12,0,0,0,0,0,0,0,0,0,0,0,0,0,0,0,0,0,0,0,0,0,0,0,0,0,0,0,0,0,0,96126
31754,458,12,122,275,34,15,71,32,21,9,0,12,11,11,11,0,0,0,0,0,0,39,16,3,0,13,23,23,23,0,0,0,0,0,0,96128
31755,133,0,37,67,29,0,0,0,0,0,0,0,0,0,0,0,0,0,0,0,0,0,0,0,0,0,0,0,0,0,0,0,0,0,0,96129
31756,15573,3471,4042,6095,1284,681,766,544,330,62,15,253,214,83,4,43,36,131,0,0,131,222,169,42,2,125,53,53,16,0,37,0,0,0,0,96130
31757,48,14,3,31,0,0,0,0,0,0,0,0,0,0,0,0,0,0,0,0,0,0,0,0,0,0,0,0,0,0,0,0,0,0,0,96132
31758,76,0,22,38,16,0,0,0,0,0,0,0,0,0,0,0,0,0,0,0,0,0,0,0,0,0,0,0,0,0,0,0,0,0,0,96133
31759,1766,405,361,596,315,89,152,97,75,0,6,69,22,12,0,0,12,10,7,3,0,55,46,4,10,32,9,9,3,6,0,0,0,0,0,96134
31760,0,0,0,0,0,0,0,0,0,0,0,0,0,0,0,0,0,0,0,0,0,0,0,0,0,0,0,0,0,0,0,0,0,0,0,96135
31761,78,0,5,66,0,7,0,0,0,0,0,0,0,0,0,0,0,0,0,0,0,0,0,0,0,0,0,0,0,0,0,0,0,0,0,96136
31762,2987,231,685,1207,515,349,76,32,30,15,0,15,2,0,0,0,0,2,0,0,2,44,25,12,8,5,19,19,0,0,19,0,0,0,0,96137
31763,862,19,174,308,252,109,22,12,12,0,0,12,0,0,0,0,0,0,0,0,0,10,10,0,0,10,0,0,0,0,0,0,0,0,0,96140
31764,593,27,37,206,236,87,0,0,0,0,0,0,0,0,0,0,0,0,0,0,0,0,0,0,0,0,0,0,0,0,0,0,0,0,0,96141
31765,422,40,111,157,74,40,35,12,12,0,0,12,0,0,0,0,0,0,0,0,0,23,23,13,0,10,0,0,0,0,0,0,0,0,0,96142
31766,2822,925,443,771,584,99,300,180,113,23,27,63,67,25,25,0,0,42,42,0,0,120,82,36,0,46,38,38,38,0,0,0,0,0,0,96143
31767,2173,41,367,689,835,241,96,17,15,0,0,15,2,1,0,0,1,1,0,0,1,79,79,0,76,3,0,0,0,0,0,0,0,0,0,96145
31768,602,0,75,272,153,102,84,53,36,17,0,19,17,0,0,0,0,17,17,0,0,31,0,0,0,0,31,31,31,0,0,0,0,0,0,96146
31769,502,64,76,227,103,32,21,13,13,5,8,0,0,0,0,0,0,0,0,0,0,8,8,0,0,8,0,0,0,0,0,0,0,0,0,96148
31770,19919,2793,4508,7688,3685,1245,1576,726,537,196,75,266,189,174,103,47,24,15,0,0,15,850,788,227,56,505,62,38,15,0,23,24,16,0,8,96150
31771,0,0,0,0,0,0,0,0,0,0,0,0,0,0,0,0,0,0,0,0,0,0,0,0,0,0,0,0,0,0,0,0,0,0,0,96155
31772,12907,736,1975,4757,3834,1605,750,458,287,68,18,201,171,171,116,29,26,0,0,0,0,292,234,19,26,189,58,58,51,0,7,0,0,0,0,96161
31773,29001,2284,7419,9626,6618,3054,1322,672,498,86,18,394,174,153,98,12,43,21,0,0,21,650,524,140,13,371,126,95,25,18,52,31,0,0,31,96701
31774,1668,139,704,486,281,58,159,97,69,2,0,67,28,28,26,0,2,0,0,0,0,62,40,3,0,37,22,22,9,0,13,0,0,0,0,96703
31775,5099,568,2006,1493,654,378,356,142,108,23,0,85,34,25,25,0,0,9,0,0,9,214,191,93,13,85,23,23,23,0,0,0,0,0,0,96704
31776,1720,254,540,615,233,78,186,86,69,18,11,40,17,9,9,0,0,8,8,0,0,100,80,23,0,57,20,0,0,0,0,20,0,0,20,96705
31777,41393,4134,12652,14546,7371,2690,3394,1557,1204,134,107,963,353,253,93,138,22,100,5,0,95,1837,1626,426,26,1174,211,143,132,11,0,68,0,23,45,96706
31778,25227,1599,6308,9798,5345,2177,2225,1183,958,341,84,533,225,196,137,39,20,29,16,12,1,1042,770,105,80,585,272,232,114,78,40,40,4,0,36,96707
31779,7331,298,1960,2773,1287,1013,411,222,168,0,0,168,54,54,32,13,9,0,0,0,0,189,169,35,0,134,20,20,20,0,0,0,0,0,0,96708
31780,474,27,43,173,231,0,21,0,0,0,0,0,0,0,0,0,0,0,0,0,0,21,21,0,0,21,0,0,0,0,0,0,0,0,0,96710
31781,5598,252,1228,2175,1324,619,378,156,57,9,0,48,99,88,28,50,10,11,0,0,11,222,170,32,58,80,52,36,36,0,0,16,0,0,16,96712
31782,1129,78,411,370,205,65,100,52,43,0,0,43,9,9,9,0,0,0,0,0,0,48,41,5,0,36,7,7,7,0,0,0,0,0,0,96713
31783,659,39,136,267,130,87,20,10,8,0,0,8,2,0,0,0,0,2,2,0,0,10,8,2,0,6,2,0,0,0,0,2,0,0,2,96714
31784,2042,157,657,805,385,38,172,83,52,9,0,43,31,28,13,0,15,3,0,0,3,89,53,16,0,37,36,36,36,0,0,0,0,0,0,96716
31785,3107,265,1017,968,518,339,387,160,112,14,0,98,48,20,0,10,10,28,20,8,0,227,201,32,15,154,26,26,0,10,16,0,0,0,0,96717
31786,1665,87,857,436,280,5,169,68,34,0,0,34,34,34,34,0,0,0,0,0,0,101,92,0,0,92,9,9,9,0,0,0,0,0,0,96719
31787,32540,2671,9892,10505,6000,3472,2957,1572,1232,55,88,1089,340,287,128,55,104,53,0,0,53,1385,1232,238,177,817,153,150,51,65,34,3,2,0,1,96720
31788,1877,40,387,672,563,215,22,0,0,0,0,0,0,0,0,0,0,0,0,0,0,22,22,0,0,22,0,0,0,0,0,0,0,0,0,96722
31789,2876,374,1014,1009,372,107,151,82,49,17,0,32,33,13,10,3,0,20,20,0,0,69,69,0,0,69,0,0,0,0,0,0,0,0,0,96725
31790,635,96,345,126,55,13,40,13,0,0,0,0,13,13,13,0,0,0,0,0,0,27,12,12,0,0,15,15,15,0,0,0,0,0,0,96726
31791,3646,304,1390,1336,421,195,271,156,149,17,41,91,7,7,0,7,0,0,0,0,0,115,113,54,6,53,2,0,0,0,0,2,0,2,0,96727
31792,430,31,81,137,166,15,22,9,9,4,0,5,0,0,0,0,0,0,0,0,0,13,13,6,0,7,0,0,0,0,0,0,0,0,0,96728
31793,736,70,322,256,37,51,97,43,24,12,0,12,19,16,16,0,0,3,3,0,0,54,48,2,0,46,6,6,0,2,4,0,0,0,0,96729
31794,836,61,176,300,211,88,54,43,25,0,0,25,18,3,0,0,3,15,4,0,11,11,4,4,0,0,7,7,7,0,0,0,0,0,0,96730
31795,1842,236,527,691,303,85,266,99,65,14,0,51,34,23,19,0,4,11,0,0,11,167,166,102,16,48,1,1,1,0,0,0,0,0,0,96731
31796,17025,2722,6392,4887,2085,939,1510,489,414,55,118,241,75,75,43,32,0,0,0,0,0,1021,796,206,38,552,225,129,43,45,41,96,0,0,96,96732
31797,34024,1585,6865,11161,8490,5923,2713,1588,866,168,99,599,722,623,475,108,40,99,11,13,75,1125,985,139,104,742,140,95,56,0,39,45,23,4,18,96734
31798,2665,225,1152,1003,114,171,58,17,17,0,0,17,0,0,0,0,0,0,0,0,0,41,41,5,0,36,0,0,0,0,0,0,0,0,0,96737
31799,4540,142,1126,2019,746,507,500,289,239,0,11,228,50,50,50,0,0,0,0,0,0,211,211,0,65,146,0,0,0,0,0,0,0,0,0,96738
31800,25688,2201,7890,8596,4789,2212,1550,837,631,123,16,492,206,161,96,65,0,45,45,0,0,713,386,95,2,289,327,246,142,32,72,81,52,0,29,96740
31801,3810,290,1119,1241,703,457,144,63,63,0,0,63,0,0,0,0,0,0,0,0,0,81,81,0,0,81,0,0,0,0,0,0,0,0,0,96741
31802,65,8,18,12,7,20,3,0,0,0,0,0,0,0,0,0,0,0,0,0,0,3,0,0,0,0,3,3,3,0,0,0,0,0,0,96742
31803,7807,376,2367,2387,1700,977,365,161,149,45,34,70,12,12,12,0,0,0,0,0,0,204,164,18,2,144,40,40,35,0,5,0,0,0,0,96743
31804,38063,2348,10856,11313,9018,4528,2307,1160,993,201,98,694,167,115,103,0,12,52,0,0,52,1147,1030,342,70,618,117,83,15,11,57,34,22,0,12,96744
31805,13407,1171,3467,5289,2346,1134,1133,572,505,114,19,372,67,48,36,12,0,19,0,19,0,561,425,28,62,335,136,136,118,18,0,0,0,0,0,96746
31806,548,101,228,152,67,0,36,7,0,0,0,0,7,7,0,0,7,0,0,0,0,29,27,7,0,20,2,2,0,0,2,0,0,0,0,96747
31807,2829,345,856,1024,413,191,159,85,83,15,4,64,2,2,2,0,0,0,0,0,0,74,69,31,15,23,5,3,2,0,1,2,0,0,2,96748
31808,10956,1192,3988,3069,1623,1084,834,436,343,17,22,304,93,65,65,0,0,28,17,11,0,398,324,9,13,302,74,50,46,0,4,24,0,0,24,96749
31809,2620,161,1035,825,449,150,114,65,43,4,0,39,22,12,8,0,4,10,0,0,10,49,30,0,9,21,19,19,15,0,4,0,0,0,0,96750
31810,100,0,52,0,41,7,0,0,0,0,0,0,0,0,0,0,0,0,0,0,0,0,0,0,0,0,0,0,0,0,0,0,0,0,0,96751
31811,2270,280,732,863,274,121,192,51,31,9,0,22,20,20,19,0,1,0,0,0,0,141,114,3,0,111,27,27,0,0,27,0,0,0,0,96752
31812,20168,1485,5221,7408,4244,1810,980,498,316,28,0,288,182,86,28,46,12,96,96,0,0,482,328,39,59,230,154,139,87,0,52,15,0,0,15,96753
31813,2955,212,727,999,730,287,223,117,47,0,7,40,70,23,23,0,0,47,17,0,30,106,65,16,0,49,41,18,0,0,18,23,17,0,6,96754
31814,2165,192,973,635,256,109,68,20,14,4,0,10,6,6,3,3,0,0,0,0,0,48,45,5,0,40,3,3,0,0,3,0,0,0,0,96755
31815,3982,431,890,1573,752,336,193,109,97,25,3,69,12,12,5,7,0,0,0,0,0,84,54,7,5,42,30,11,11,0,0,19,0,0,19,96756
31816,474,87,137,148,58,44,55,5,5,0,0,5,0,0,0,0,0,0,0,0,0,50,50,6,0,44,0,0,0,0,0,0,0,0,0,96757
31817,295,75,151,27,42,0,27,27,27,0,0,27,0,0,0,0,0,0,0,0,0,0,0,0,0,0,0,0,0,0,0,0,0,0,0,96759
31818,1718,208,339,775,268,128,137,70,61,6,0,55,9,9,9,0,0,0,0,0,0,67,59,0,0,59,8,8,0,8,0,0,0,0,0,96760
31819,15105,1405,4521,4985,3309,885,771,411,261,97,28,136,150,145,103,0,42,5,0,0,5,360,346,146,25,175,14,14,14,0,0,0,0,0,0,96761
31820,2414,79,348,965,634,388,786,351,291,30,9,252,60,32,16,0,16,28,9,0,19,435,405,112,20,273,30,30,30,0,0,0,0,0,0,96762
31821,2242,317,794,625,351,155,182,97,75,14,0,61,22,22,22,0,0,0,0,0,0,85,85,16,50,19,0,0,0,0,0,0,0,0,0,96763
31822,524,39,163,131,158,33,24,0,0,0,0,0,0,0,0,0,0,0,0,0,0,24,15,5,0,10,9,9,0,0,9,0,0,0,0,96764
31823,418,36,104,171,76,31,6,0,0,0,0,0,0,0,0,0,0,0,0,0,0,6,6,0,0,6,0,0,0,0,0,0,0,0,0,96765
31824,10612,1426,3383,3604,1466,733,578,353,251,55,10,186,102,102,102,0,0,0,0,0,0,225,159,48,0,111,66,66,66,0,0,0,0,0,0,96766
31825,12183,879,3219,4910,1905,1270,808,410,288,36,12,240,122,82,29,50,3,40,0,0,40,398,317,33,0,284,81,81,12,34,35,0,0,0,0,96768
31826,267,64,140,41,14,8,17,17,11,0,0,11,6,0,0,0,0,6,3,0,3,0,0,0,0,0,0,0,0,0,0,0,0,0,0,96769
31827,496,62,104,124,130,76,31,17,17,0,0,17,0,0,0,0,0,0,0,0,0,14,14,0,0,14,0,0,0,0,0,0,0,0,0,96770
31828,4504,393,1388,1887,517,319,327,146,104,0,9,95,42,42,0,9,33,0,0,0,0,181,55,8,14,33,126,117,52,0,65,9,9,0,0,96771
31829,1688,252,633,456,308,39,76,17,13,7,0,6,4,1,0,0,1,3,0,0,3,59,59,3,0,56,0,0,0,0,0,0,0,0,0,96772
31830,120,0,7,40,31,42,25,0,0,0,0,0,0,0,0,0,0,0,0,0,0,25,25,4,0,21,0,0,0,0,0,0,0,0,0,96773
31831,241,63,26,103,49,0,17,17,17,0,17,0,0,0,0,0,0,0,0,0,0,0,0,0,0,0,0,0,0,0,0,0,0,0,0,96774
31832,1125,70,390,296,306,63,88,61,61,15,4,42,0,0,0,0,0,0,0,0,0,27,21,13,2,6,6,6,0,6,0,0,0,0,0,96776
31833,993,167,479,238,92,17,15,15,12,0,0,12,3,3,0,3,0,0,0,0,0,0,0,0,0,0,0,0,0,0,0,0,0,0,0,96777
31834,9294,1112,2993,3173,1206,810,753,313,153,11,25,117,160,39,1,3,35,121,0,36,85,440,305,45,35,225,135,132,40,21,71,3,0,3,0,96778
31835,2138,173,648,519,536,262,182,92,60,0,0,60,32,32,32,0,0,0,0,0,0,90,82,4,4,74,8,8,0,8,0,0,0,0,0,96779
31836,524,56,169,239,43,17,32,32,0,0,0,0,32,32,32,0,0,0,0,0,0,0,0,0,0,0,0,0,0,0,0,0,0,0,0,96780
31837,1223,151,411,376,228,57,43,26,20,0,0,20,6,6,0,0,6,0,0,0,0,17,9,0,0,9,8,8,0,0,8,0,0,0,0,96781
31838,27838,1911,9141,9854,4992,1940,1878,1148,819,156,81,582,329,313,256,14,43,16,16,0,0,730,529,89,1,439,201,201,161,9,31,0,0,0,0,96782
31839,1473,220,460,431,221,141,127,23,14,2,0,12,9,9,0,0,9,0,0,0,0,104,60,0,0,60,44,36,16,0,20,8,0,0,8,96783
31840,1984,264,364,646,416,294,91,52,23,0,0,23,29,0,0,0,0,29,0,0,29,39,23,0,0,23,16,16,0,16,0,0,0,0,0,96785
31841,24144,2252,8259,9479,3023,1131,1916,1070,608,90,28,490,462,445,380,31,34,17,16,0,1,846,621,120,93,408,225,183,65,17,101,42,0,6,36,96786
31842,36416,1626,8114,12927,9957,3792,2897,1551,1419,265,63,1091,132,74,36,0,38,58,0,0,58,1346,1188,311,78,799,158,149,85,0,64,9,9,0,0,96789
31843,5990,366,1513,1997,1199,915,303,164,133,37,6,90,31,31,2,29,0,0,0,0,0,139,121,0,39,82,18,18,13,0,5,0,0,0,0,96790
31844,5025,639,1383,1599,942,462,368,158,79,11,0,68,79,45,45,0,0,34,8,5,21,210,172,32,58,82,38,21,5,16,0,17,6,0,11,96791
31845,26903,4622,11881,7753,1826,821,3387,1701,1156,77,96,983,545,372,101,132,139,173,3,62,108,1686,1174,158,170,846,512,358,98,55,205,154,19,15,120,96792
31846,21037,2365,7444,6638,2842,1748,1426,808,533,162,44,327,275,253,193,57,3,22,7,0,15,618,455,137,29,289,163,117,63,54,0,46,20,0,26,96793
31847,6477,576,3045,2070,527,259,773,340,225,28,0,197,115,72,32,0,40,43,7,0,36,433,285,49,49,187,148,120,50,0,70,28,18,3,7,96795
31848,1289,92,535,345,248,69,42,21,21,4,0,17,0,0,0,0,0,0,0,0,0,21,21,0,0,21,0,0,0,0,0,0,0,0,0,96796
31849,50814,7067,15656,17186,8717,2188,3886,2002,1559,347,29,1183,443,361,255,43,63,82,11,11,60,1884,1479,274,88,1117,405,341,162,67,112,64,42,0,22,96797
31850,16748,1663,4025,4068,4683,2309,759,471,300,117,28,155,171,164,134,12,18,7,0,0,7,288,242,65,14,163,46,26,21,5,0,20,0,0,20,96813
31851,14706,1281,3154,3958,3832,2481,523,334,290,117,0,173,44,26,0,26,0,18,0,0,18,189,172,11,21,140,17,17,10,0,7,0,0,0,0,96814
31852,23589,1453,4593,7647,6042,3854,979,422,263,46,16,201,159,151,93,24,34,8,0,7,1,557,483,101,35,347,74,31,31,0,0,43,43,0,0,96815
31853,37820,2693,9235,10283,9663,5946,1984,980,877,199,55,623,103,87,46,41,0,16,9,0,7,1004,917,276,28,613,87,57,16,19,22,30,0,0,30,96816
31854,40939,8836,11025,9637,7378,4063,2226,1148,890,113,56,721,258,151,88,22,41,107,0,33,74,1078,896,293,71,532,182,106,45,19,42,76,7,17,52,96817
31855,31803,2778,7168,12074,6906,2877,2331,1217,961,227,81,653,256,217,196,0,21,39,7,0,32,1114,869,207,0,662,245,245,148,51,46,0,0,0,0,96818
31856,34173,6945,11945,9423,4410,1450,3102,1704,1268,267,49,952,436,299,179,28,92,137,75,0,62,1398,1172,255,33,884,226,87,71,0,16,139,65,20,54,96819
31857,14912,516,2454,3664,4402,3876,711,385,364,64,13,287,21,21,13,0,8,0,0,0,0,326,326,126,8,192,0,0,0,0,0,0,0,0,0,96821
31858,32358,1743,5919,8529,9085,7082,2297,1100,967,195,62,710,133,120,75,9,36,13,0,0,13,1197,1103,285,11,807,94,79,41,0,38,15,0,0,15,96822
31859,22451,777,3802,6249,6628,4995,1327,713,666,130,39,497,47,46,21,25,0,1,0,0,1,614,549,205,31,313,65,65,0,17,48,0,0,0,0,96825
31860,22542,2632,5652,7231,4806,2221,1408,718,640,143,41,456,78,77,20,0,57,1,0,0,1,690,647,223,27,397,43,40,16,7,17,3,0,0,3,96826
31861,0,0,0,0,0,0,0,0,0,0,0,0,0,0,0,0,0,0,0,0,0,0,0,0,0,0,0,0,0,0,0,0,0,0,0,96850
31862,89,0,29,57,3,0,55,44,0,0,0,0,44,39,39,0,0,5,5,0,0,11,0,0,0,0,11,11,11,0,0,0,0,0,0,96853
31863,519,25,179,256,50,9,237,232,15,15,0,0,217,217,217,0,0,0,0,0,0,5,0,0,0,0,5,5,5,0,0,0,0,0,0,96857
31864,0,0,0,0,0,0,0,0,0,0,0,0,0,0,0,0,0,0,0,0,0,0,0,0,0,0,0,0,0,0,0,0,0,0,0,96859
31865,314,8,116,165,17,8,89,69,10,10,0,0,59,59,59,0,0,0,0,0,0,20,0,0,0,0,20,20,20,0,0,0,0,0,0,96860
31866,0,0,0,0,0,0,0,0,0,0,0,0,0,0,0,0,0,0,0,0,0,0,0,0,0,0,0,0,0,0,0,0,0,0,0,96863
31867,193,30,28,41,63,31,0,0,0,0,0,0,0,0,0,0,0,0,0,0,0,0,0,0,0,0,0,0,0,0,0,0,0,0,0,97001
31868,3831,317,1200,1257,751,306,462,237,195,0,2,193,42,40,31,0,9,2,0,0,2,225,207,65,6,136,18,0,0,0,0,18,18,0,0,97002
31869,3258,228,902,1288,626,214,364,198,150,21,45,84,48,0,0,0,0,48,48,0,0,166,158,25,0,133,8,8,8,0,0,0,0,0,0,97004
31870,16680,2390,4265,5831,3042,1152,1209,591,417,48,18,351,174,164,51,83,30,10,10,0,0,618,516,230,6,280,102,87,54,33,0,15,15,0,0,97005
31871,42092,4144,7409,14121,10994,5424,2941,1531,1250,262,167,821,281,257,248,9,0,24,0,12,12,1410,1111,404,171,536,299,187,130,47,10,112,64,40,8,97006
31872,45688,3702,9126,14516,12230,6114,3704,1756,1482,249,154,1079,274,219,106,77,36,55,0,30,25,1948,1739,351,172,1216,209,160,100,9,51,49,17,32,0,97007
31873,20390,2261,3845,6217,5582,2485,1589,757,684,186,89,409,73,73,18,22,33,0,0,0,0,832,686,223,21,442,146,89,23,22,44,57,16,18,23,97008
31874,5665,517,1768,2355,719,306,339,107,99,53,0,46,8,8,8,0,0,0,0,0,0,232,187,69,5,113,45,25,18,7,0,20,20,0,0,97009
31875,711,204,62,305,115,25,38,0,0,0,0,0,0,0,0,0,0,0,0,0,0,38,0,0,0,0,38,31,31,0,0,7,0,0,7,97011
31876,14767,2038,3602,5330,2560,1237,1273,751,425,45,111,269,326,115,66,48,1,211,186,25,0,522,315,98,0,217,207,118,80,14,24,89,0,15,74,97013
31877,769,118,282,253,81,35,48,34,7,0,0,7,27,15,15,0,0,12,0,12,0,14,14,0,0,14,0,0,0,0,0,0,0,0,0,97014
31878,13156,1348,3018,5013,2610,1167,1566,816,616,173,79,364,200,179,124,55,0,21,11,0,10,750,604,153,29,422,146,146,120,0,26,0,0,0,0,97015
31879,4896,529,1796,1837,536,198,359,198,198,82,0,116,0,0,0,0,0,0,0,0,0,161,142,36,8,98,19,19,0,9,10,0,0,0,0,97016
31880,1730,132,539,743,239,77,181,65,42,0,0,42,23,23,23,0,0,0,0,0,0,116,102,75,0,27,14,14,14,0,0,0,0,0,0,97017
31881,1575,93,420,682,248,132,126,52,46,0,0,46,6,6,0,6,0,0,0,0,0,74,74,25,0,49,0,0,0,0,0,0,0,0,0,97018
31882,2449,177,767,984,407,114,156,83,83,20,0,63,0,0,0,0,0,0,0,0,0,73,73,0,0,73,0,0,0,0,0,0,0,0,0,97019
31883,558,40,183,243,62,30,20,20,20,0,0,20,0,0,0,0,0,0,0,0,0,0,0,0,0,0,0,0,0,0,0,0,0,0,0,97020
31884,564,37,159,237,76,55,17,7,3,3,0,0,4,4,4,0,0,0,0,0,0,10,10,0,0,10,0,0,0,0,0,0,0,0,0,97021
31885,2175,270,813,637,307,148,210,141,128,21,15,92,13,13,13,0,0,0,0,0,0,69,63,21,17,25,6,6,0,0,6,0,0,0,0,97022
31886,7432,958,2517,2885,690,382,666,286,183,35,33,115,103,38,24,0,14,65,18,0,47,380,293,52,13,228,87,35,9,0,26,52,52,0,0,97023
31887,6770,912,1805,2745,966,342,470,180,129,18,21,90,51,32,32,0,0,19,0,19,0,290,269,61,66,142,21,17,17,0,0,4,0,0,4,97024
31888,2394,732,558,670,310,124,216,89,50,3,10,37,39,35,19,4,12,4,0,0,4,127,100,32,9,59,27,27,27,0,0,0,0,0,0,97026
31889,8752,1004,2682,3423,1187,456,886,455,362,28,13,321,93,81,80,0,1,12,0,0,12,431,296,102,24,170,135,118,27,45,46,17,0,0,17,97027
31890,136,0,0,51,41,44,0,0,0,0,0,0,0,0,0,0,0,0,0,0,0,0,0,0,0,0,0,0,0,0,0,0,0,0,0,97028
31891,204,1,78,68,44,13,23,16,14,4,0,10,2,2,2,0,0,0,0,0,0,7,6,0,0,6,1,1,0,1,0,0,0,0,0,97029
31892,24204,3977,6944,8932,3075,1276,2075,1026,841,226,138,477,185,135,96,0,39,50,38,12,0,1049,807,146,116,545,242,166,112,9,45,76,0,0,76,97030
31893,12401,1869,3351,3241,2511,1429,1043,524,369,95,0,274,155,125,106,0,19,30,30,0,0,519,457,181,34,242,62,62,44,6,12,0,0,0,0,97031
31894,2895,540,958,1021,221,155,310,165,142,30,0,112,23,23,12,0,11,0,0,0,0,145,111,35,6,70,34,34,15,0,19,0,0,0,0,97032
31895,70,3,19,16,29,3,0,0,0,0,0,0,0,0,0,0,0,0,0,0,0,0,0,0,0,0,0,0,0,0,0,0,0,0,0,97033
31896,13702,231,1292,3048,5357,3774,1163,627,560,131,56,373,67,67,7,60,0,0,0,0,0,536,468,131,64,273,68,68,15,53,0,0,0,0,0,97034
31897,16963,337,1797,4042,6385,4402,1106,541,491,169,35,287,50,50,24,16,10,0,0,0,0,565,517,112,21,384,48,48,7,7,34,0,0,0,0,97035
31898,661,45,281,205,83,47,47,6,6,6,0,0,0,0,0,0,0,0,0,0,0,41,41,33,4,4,0,0,0,0,0,0,0,0,0,97037
31899,10071,1365,3123,4336,808,439,1039,433,368,55,75,238,65,55,30,0,25,10,10,0,0,606,521,80,111,330,85,78,13,57,8,7,0,0,7,97038
31900,383,40,115,165,48,15,21,12,0,0,0,0,12,12,10,2,0,0,0,0,0,9,1,0,0,1,8,8,8,0,0,0,0,0,0,97039
31901,854,95,108,320,152,179,38,8,8,0,0,8,0,0,0,0,0,0,0,0,0,30,19,0,0,19,11,10,10,0,0,1,1,0,0,97040
31902,1776,388,359,534,378,117,111,53,53,53,0,0,0,0,0,0,0,0,0,0,0,58,58,8,0,50,0,0,0,0,0,0,0,0,0,97041
31903,2300,260,767,868,282,123,137,100,100,49,0,51,0,0,0,0,0,0,0,0,0,37,37,23,0,14,0,0,0,0,0,0,0,0,0,97042
31904,34805,2558,10072,14261,5887,2027,2803,1522,1108,273,81,754,414,311,177,129,5,103,38,0,65,1281,1086,276,63,747,195,189,108,31,50,6,0,4,2,97045
31905,4616,596,1652,1678,455,235,326,181,147,0,0,147,34,34,0,0,34,0,0,0,0,145,137,71,19,47,8,8,0,0,8,0,0,0,0,97048
31906,1356,11,311,708,223,103,77,20,20,0,20,0,0,0,0,0,0,0,0,0,0,57,57,16,18,23,0,0,0,0,0,0,0,0,0,97049
31907,166,21,65,61,15,4,7,7,7,0,0,7,0,0,0,0,0,0,0,0,0,0,0,0,0,0,0,0,0,0,0,0,0,0,0,97050
31908,10200,1241,3233,3869,1317,540,738,365,315,23,58,234,50,43,0,22,21,7,0,0,7,373,244,38,36,170,129,100,88,0,12,29,0,0,29,97051
31909,2262,118,786,949,260,149,101,74,51,11,0,40,23,23,0,23,0,0,0,0,0,27,27,9,0,18,0,0,0,0,0,0,0,0,0,97053
31910,1022,86,398,445,71,22,103,55,55,0,0,55,0,0,0,0,0,0,0,0,0,48,48,0,18,30,0,0,0,0,0,0,0,0,0,97054
31911,11607,639,3846,4879,1500,743,582,219,172,28,0,144,47,38,11,27,0,9,0,0,9,363,343,118,127,98,20,0,0,0,0,20,0,20,0,97055
31912,7981,765,2567,3001,899,749,582,290,282,60,0,222,8,0,0,0,0,8,8,0,0,292,292,97,0,195,0,0,0,0,0,0,0,0,0,97056
31913,7,4,3,0,0,0,0,0,0,0,0,0,0,0,0,0,0,0,0,0,0,0,0,0,0,0,0,0,0,0,0,0,0,0,0,97057
31914,14007,2194,3871,5242,1641,1059,1162,633,508,122,27,359,125,100,86,0,14,25,10,6,9,529,416,100,0,316,113,50,22,28,0,63,11,0,52,97058
31915,13596,1589,3524,5417,2279,787,1261,718,447,76,33,338,271,234,208,0,26,37,14,0,23,543,472,168,38,266,71,53,10,13,30,18,13,0,5,97060
31916,18109,1494,3449,5691,5446,2029,1567,829,677,77,83,517,152,93,0,85,8,59,52,7,0,738,676,180,49,447,62,20,20,0,0,42,15,12,15,97062
31917,739,81,294,304,26,34,3,0,0,0,0,0,0,0,0,0,0,0,0,0,0,3,3,0,0,3,0,0,0,0,0,0,0,0,0,97063
31918,2482,256,749,1032,343,102,122,99,75,11,0,64,24,17,7,0,10,7,0,0,7,23,23,0,0,23,0,0,0,0,0,0,0,0,0,97064
31919,521,37,183,250,36,15,25,5,3,3,0,0,2,2,2,0,0,0,0,0,0,20,20,0,0,20,0,0,0,0,0,0,0,0,0,97065
31920,1502,46,484,632,231,109,49,45,45,0,0,45,0,0,0,0,0,0,0,0,0,4,0,0,0,0,4,0,0,0,0,4,4,0,0,97067
31921,19929,269,2546,6427,6708,3979,1490,771,700,126,23,551,71,56,48,8,0,15,15,0,0,719,677,175,84,418,42,33,21,12,0,9,0,0,9,97068
31922,14708,1284,2690,4702,4008,2024,946,480,311,15,7,289,169,14,0,14,0,155,74,63,18,466,437,123,97,217,29,12,0,0,12,17,17,0,0,97070
31923,16830,5881,4276,4544,1510,619,2142,1170,910,118,170,622,260,130,33,53,44,130,76,0,54,972,785,103,49,633,187,170,62,62,46,17,0,17,0,97071
31924,26090,1974,6817,11012,4187,2100,2637,1411,1221,346,170,705,190,105,70,26,9,85,34,15,36,1226,995,341,96,558,231,213,40,70,103,18,18,0,0,97080
31925,17547,1383,3616,5764,4376,2408,1576,830,753,67,145,541,77,49,30,19,0,28,9,0,19,746,600,201,11,388,146,81,36,14,31,65,60,0,5,97086
31926,8445,554,2193,3390,1231,1077,806,387,240,91,17,132,147,113,29,66,18,34,0,34,0,419,359,124,13,222,60,51,12,0,39,9,0,0,9,97089
31927,2760,220,914,1055,319,252,208,141,92,11,0,81,49,24,11,0,13,25,13,0,12,67,48,13,0,35,19,19,5,0,14,0,0,0,0,97101
31928,183,0,0,114,0,69,0,0,0,0,0,0,0,0,0,0,0,0,0,0,0,0,0,0,0,0,0,0,0,0,0,0,0,0,0,97102
31929,12165,973,3117,5309,1662,1104,1090,619,526,161,71,294,93,22,13,0,9,71,56,0,15,471,388,157,42,189,83,15,15,0,0,68,15,8,45,97103
31930,2720,159,768,948,607,238,194,82,75,11,0,64,7,0,0,0,0,7,4,0,3,112,104,34,0,70,8,8,2,0,6,0,0,0,0,97106
31931,1190,105,569,340,138,38,58,45,45,15,0,30,0,0,0,0,0,0,0,0,0,13,13,0,0,13,0,0,0,0,0,0,0,0,0,97107
31932,335,31,113,109,71,11,8,2,2,1,0,1,0,0,0,0,0,0,0,0,0,6,6,0,5,1,0,0,0,0,0,0,0,0,0,97108
31933,603,33,150,331,67,22,37,23,23,4,0,19,0,0,0,0,0,0,0,0,0,14,14,0,0,14,0,0,0,0,0,0,0,0,0,97109
31934,922,85,171,282,239,145,66,37,37,0,0,37,0,0,0,0,0,0,0,0,0,29,16,7,0,9,13,13,13,0,0,0,0,0,0,97110
31935,2303,160,959,806,245,133,145,112,48,15,12,21,64,64,54,10,0,0,0,0,0,33,26,0,0,26,7,7,3,0,4,0,0,0,0,97111
31936,1311,121,488,297,307,98,201,82,82,66,8,8,0,0,0,0,0,0,0,0,0,119,119,69,10,40,0,0,0,0,0,0,0,0,0,97112
31937,8630,2269,1932,2975,961,493,888,542,296,85,37,174,246,246,34,212,0,0,0,0,0,346,233,128,9,96,113,113,94,19,0,0,0,0,0,97113
31938,3217,449,1005,1175,396,192,296,161,69,0,4,65,92,63,43,0,20,29,15,0,14,135,126,15,14,97,9,3,3,0,0,6,0,6,0,97114
31939,2719,223,664,1054,565,213,251,144,120,14,42,64,24,6,6,0,0,18,0,0,18,107,75,38,7,30,32,32,22,10,0,0,0,0,0,97115
31940,15974,2153,5025,5293,2118,1385,1983,1130,1031,186,98,747,99,99,42,18,39,0,0,0,0,853,753,272,34,447,100,77,16,16,45,23,0,0,23,97116
31941,344,5,168,118,53,0,6,6,6,0,0,6,0,0,0,0,0,0,0,0,0,0,0,0,0,0,0,0,0,0,0,0,0,0,0,97117
31942,590,49,223,243,43,32,16,14,13,8,0,5,1,1,1,0,0,0,0,0,0,2,2,0,0,2,0,0,0,0,0,0,0,0,0,97118
31943,3064,358,896,1073,568,169,287,82,60,18,7,35,22,10,6,4,0,12,0,12,0,205,148,32,36,80,57,57,8,17,32,0,0,0,0,97119
31944,957,39,249,528,90,51,71,28,28,0,0,28,0,0,0,0,0,0,0,0,0,43,24,24,0,0,19,19,19,0,0,0,0,0,0,97121
31945,461,52,124,276,0,9,19,19,19,0,0,19,0,0,0,0,0,0,0,0,0,0,0,0,0,0,0,0,0,0,0,0,0,0,0,97122
31946,28403,4669,6367,9909,5291,2167,2420,1186,1077,246,112,719,109,58,45,11,2,51,26,0,25,1234,999,168,134,697,235,106,58,31,17,129,6,40,83,97123
31947,32082,3404,6064,10212,7070,5332,2570,1153,842,172,87,583,311,269,67,85,117,42,27,0,15,1417,1324,356,104,864,93,74,0,12,62,19,19,0,0,97124
31948,114,9,64,26,0,15,0,0,0,0,0,0,0,0,0,0,0,0,0,0,0,0,0,0,0,0,0,0,0,0,0,0,0,0,0,97125
31949,2204,429,903,605,145,122,148,63,47,9,0,38,16,4,0,4,0,12,12,0,0,85,71,5,17,49,14,10,0,0,10,4,0,0,4,97127
31950,22907,3050,7342,7335,3121,2059,2425,1012,880,241,133,506,132,94,36,19,39,38,38,0,0,1413,1149,258,72,819,264,251,173,44,34,13,0,13,0,97128
31951,382,14,86,107,119,56,8,8,8,0,0,8,0,0,0,0,0,0,0,0,0,0,0,0,0,0,0,0,0,0,0,0,0,0,0,97130
31952,1946,283,661,658,326,18,117,67,49,38,0,11,18,18,18,0,0,0,0,0,0,50,36,17,0,19,14,0,0,0,0,14,14,0,0,97131
31953,17981,1861,4883,6285,3398,1554,2345,1215,1155,297,261,597,60,35,0,22,13,25,9,16,0,1130,1079,366,141,572,51,45,14,0,31,6,6,0,0,97132
31954,3071,324,749,1144,510,344,224,121,100,48,4,48,21,13,0,13,0,8,8,0,0,103,102,45,7,50,1,1,1,0,0,0,0,0,0,97133
31955,92,0,18,6,31,37,0,0,0,0,0,0,0,0,0,0,0,0,0,0,0,0,0,0,0,0,0,0,0,0,0,0,0,0,0,97134
31956,646,82,149,209,60,146,9,9,9,0,0,9,0,0,0,0,0,0,0,0,0,0,0,0,0,0,0,0,0,0,0,0,0,0,0,97135
31957,1302,107,428,466,196,105,59,32,11,0,0,11,21,21,16,5,0,0,0,0,0,27,22,10,0,12,5,5,5,0,0,0,0,0,0,97136
31958,878,159,191,334,158,36,64,34,30,10,0,20,4,4,4,0,0,0,0,0,0,30,30,8,0,22,0,0,0,0,0,0,0,0,0,97137
31959,7254,646,2127,2734,1060,687,376,180,145,42,20,83,35,35,0,22,13,0,0,0,0,196,186,106,0,80,10,10,10,0,0,0,0,0,0,97138
31960,15068,702,2590,5268,4510,1998,1059,598,540,137,23,380,58,58,10,17,31,0,0,0,0,461,430,68,44,318,31,18,18,0,0,13,0,0,13,97140
31961,9811,1337,3410,3313,1236,515,723,415,314,61,31,222,101,88,54,0,34,13,0,0,13,308,253,41,24,188,55,27,8,0,19,28,0,0,28,97141
31962,136,9,39,38,50,0,18,0,0,0,0,0,0,0,0,0,0,0,0,0,0,18,18,0,0,18,0,0,0,0,0,0,0,0,0,97144
31963,245,17,27,134,45,22,0,0,0,0,0,0,0,0,0,0,0,0,0,0,0,0,0,0,0,0,0,0,0,0,0,0,0,0,0,97145
31964,3975,371,1061,1663,652,228,331,158,128,22,0,106,30,30,0,25,5,0,0,0,0,173,173,87,0,86,0,0,0,0,0,0,0,0,0,97146
31965,297,40,105,85,50,17,15,11,11,0,0,11,0,0,0,0,0,0,0,0,0,4,4,4,0,0,0,0,0,0,0,0,0,0,0,97147
31966,2245,146,830,843,314,112,92,35,35,6,0,29,0,0,0,0,0,0,0,0,0,57,57,32,6,19,0,0,0,0,0,0,0,0,0,97148
31967,308,0,71,34,135,68,13,0,0,0,0,0,0,0,0,0,0,0,0,0,0,13,0,0,0,0,13,0,0,0,0,13,0,0,13,97149
31968,9901,306,711,2229,3355,3300,1191,423,413,82,101,230,10,0,0,0,0,10,10,0,0,768,682,196,81,405,86,86,59,27,0,0,0,0,0,97201
31969,28786,1457,3860,8005,8442,7022,1813,1059,962,165,31,766,97,54,28,14,12,43,14,0,29,754,716,201,4,511,38,7,7,0,0,31,0,0,31,97202
31970,19867,2926,4485,6404,4111,1941,1900,1046,908,180,135,593,138,72,34,0,38,66,0,60,6,854,775,247,84,444,79,77,40,8,29,2,0,0,2,97203
31971,1199,298,279,498,95,29,1,1,1,0,0,1,0,0,0,0,0,0,0,0,0,0,0,0,0,0,0,0,0,0,0,0,0,0,0,97204
31972,5667,254,658,1565,1785,1405,82,46,46,11,3,32,0,0,0,0,0,0,0,0,0,36,31,4,21,6,5,5,5,0,0,0,0,0,0,97205
31973,35592,3852,7881,11997,8069,3793,1659,899,711,129,98,484,188,93,35,49,9,95,17,0,78,760,684,135,88,461,76,56,56,0,0,20,13,7,0,97206
31974,0,0,0,0,0,0,0,0,0,0,0,0,0,0,0,0,0,0,0,0,0,0,0,0,0,0,0,0,0,0,0,0,0,0,0,97208
31975,12810,473,1061,3162,4386,3728,200,38,12,0,7,5,26,26,26,0,0,0,0,0,0,162,147,16,0,131,15,0,0,0,0,15,0,0,15,97209
31976,9234,259,481,1510,3552,3432,371,172,159,45,0,114,13,0,0,0,0,13,0,0,13,199,199,26,0,173,0,0,0,0,0,0,0,0,0,97210
31977,23112,1440,3794,6285,7512,4081,1193,669,498,221,25,252,171,97,25,6,66,74,0,0,74,524,481,125,46,310,43,10,10,0,0,33,0,33,0,97211
31978,18477,592,1636,4147,6275,5827,856,412,368,79,15,274,44,11,0,0,11,33,12,21,0,444,444,135,41,268,0,0,0,0,0,0,0,0,0,97212
31979,23201,1120,3496,7037,7217,4331,926,557,455,64,43,348,102,66,0,8,58,36,0,0,36,369,312,102,0,210,57,46,7,38,1,11,11,0,0,97213
31980,19069,550,1935,4777,7099,4708,641,385,242,58,8,176,143,131,20,64,47,12,0,0,12,256,220,85,16,119,36,36,9,0,27,0,0,0,0,97214
31981,12108,547,1544,3267,4356,2394,361,145,128,27,0,101,17,4,4,0,0,13,0,0,13,216,197,88,15,94,19,0,0,0,0,19,9,0,10,97215
31982,11342,2180,2874,3486,1777,1025,818,361,328,16,14,298,33,11,11,0,0,22,8,0,14,457,319,20,93,206,138,138,73,0,65,0,0,0,0,97216
31983,24483,2035,4052,7916,6599,3881,889,434,368,42,36,290,66,43,28,10,5,23,0,0,23,455,404,134,38,232,51,51,33,0,18,0,0,0,0,97217
31984,10472,1956,2299,2909,2190,1118,700,332,274,58,19,197,58,34,19,0,15,24,10,14,0,368,210,45,19,146,158,95,0,22,73,63,0,13,50,97218
31985,28170,730,3186,7846,9154,7254,1903,850,808,177,39,592,42,42,21,7,14,0,0,0,0,1053,1040,362,47,631,13,13,9,0,4,0,0,0,0,97219
31986,20192,2646,5135,7361,3610,1440,1347,663,607,173,25,409,56,17,12,0,5,39,26,13,0,684,566,174,63,329,118,74,20,29,25,44,0,18,26,97220
31987,8854,370,657,1851,3172,2804,471,234,231,42,35,154,3,3,3,0,0,0,0,0,0,237,237,29,28,180,0,0,0,0,0,0,0,0,0,97221
31988,24789,2173,6654,10330,3930,1702,1440,704,503,73,43,387,201,103,20,38,45,98,71,12,15,736,529,115,92,322,207,100,46,40,14,107,15,0,92,97222
31989,31922,2104,5168,11257,8805,4588,2577,1366,998,198,95,705,368,150,77,0,73,218,86,44,88,1211,977,274,108,595,234,190,129,22,39,44,0,31,13,97223
31990,23444,1016,5286,7713,6801,2628,1041,432,412,82,51,279,20,7,6,0,1,13,6,0,7,609,539,195,31,313,70,33,19,0,14,37,0,0,37,97224
31991,19113,441,2427,4780,7036,4429,899,506,467,156,0,311,39,19,11,8,0,20,0,0,20,393,343,69,20,254,50,8,8,0,0,42,0,29,13,97225
31992,3036,218,424,789,1128,477,92,22,22,7,0,15,0,0,0,0,0,0,0,0,0,70,61,25,0,36,9,0,0,0,0,9,0,0,9,97227
31993,40007,1394,3679,9979,14061,10894,2555,1510,1453,249,103,1101,57,44,21,0,23,13,0,13,0,1045,966,141,74,751,79,55,0,21,34,24,0,13,11,97229
31994,27689,4297,7669,9975,3941,1807,1918,894,684,142,105,437,210,116,49,35,32,94,18,20,56,1024,815,131,48,636,209,166,86,0,80,43,13,0,30,97230
31995,3223,102,391,1026,936,768,164,99,99,13,0,86,0,0,0,0,0,0,0,0,0,65,65,39,10,16,0,0,0,0,0,0,0,0,0,97231
31996,9213,360,1008,2389,3281,2175,175,73,73,0,0,73,0,0,0,0,0,0,0,0,0,102,101,34,7,60,1,1,0,0,1,0,0,0,0,97232
31997,24585,6149,7439,8163,2158,676,2142,1076,811,88,92,631,265,152,71,47,34,113,53,10,50,1066,961,80,77,804,105,96,49,28,19,9,0,0,9,97233
31998,23568,5105,7579,7232,2717,935,2079,977,730,119,137,474,247,99,4,29,66,148,0,141,7,1102,996,59,98,839,106,96,74,0,22,10,0,0,10,97236
31999,12130,353,716,2539,4262,4260,427,253,218,23,3,192,35,34,4,26,4,1,0,0,1,174,166,26,75,65,8,8,8,0,0,0,0,0,0,97239
32000,22543,5214,6154,7465,2661,1049,1636,896,750,126,61,563,146,137,73,26,38,9,9,0,0,740,659,63,81,515,81,29,26,0,3,52,0,0,52,97266
32001,22532,1821,6015,9565,3531,1600,1464,826,597,168,10,419,229,217,113,23,81,12,0,0,12,638,537,183,62,292,101,73,26,34,13,28,0,16,12,97267
32002,34191,7922,9710,11281,3651,1627,3865,2068,1550,277,127,1146,518,264,156,51,57,254,72,122,60,1797,1483,322,177,984,314,254,165,21,68,60,0,31,29,97301
32003,25910,1818,5564,9455,5227,3846,1867,1051,852,109,57,686,199,118,20,59,39,81,0,55,26,816,654,221,106,327,162,151,129,0,22,11,0,0,11,97302
32004,24803,3475,6326,9211,3915,1876,2257,1044,862,164,45,653,182,81,53,28,0,101,0,92,9,1213,952,415,68,469,261,180,146,18,16,81,37,0,44,97303
32005,19620,1642,4159,6254,4519,3046,1651,773,587,126,41,420,186,142,47,64,31,44,44,0,0,878,700,256,74,370,178,141,28,11,102,37,0,19,18,97304
32006,23636,5342,6777,8378,2320,819,1930,1003,811,116,183,512,192,139,66,31,42,53,36,17,0,927,613,93,85,435,314,203,183,0,20,111,0,19,92,97305
32007,18698,899,4008,7412,3863,2516,1376,669,501,80,70,351,168,112,17,51,44,56,20,0,36,707,684,238,100,346,23,23,23,0,0,0,0,0,0,97306
32008,16131,2770,4556,5879,2006,920,1525,809,722,137,64,521,87,70,45,0,25,17,0,0,17,716,604,152,59,393,112,90,65,0,25,22,9,0,13,97317
32009,17018,1348,3541,6212,3755,2162,1281,624,532,192,60,280,92,69,37,21,11,23,14,0,9,657,515,135,76,304,142,112,93,0,19,30,0,7,23,97321
32010,22704,2754,6773,9925,2417,835,1813,997,884,161,109,614,113,112,40,0,72,1,0,0,1,816,748,230,107,411,68,17,9,0,8,51,39,0,12,97322
32011,941,134,278,336,112,81,43,21,16,0,3,13,5,0,0,0,0,5,0,0,5,22,22,9,0,13,0,0,0,0,0,0,0,0,0,97324
32012,4525,627,1401,1918,444,135,396,202,185,15,2,168,17,17,13,0,4,0,0,0,0,194,165,52,0,113,29,14,14,0,0,15,15,0,0,97325
32013,773,95,248,248,89,93,24,24,24,18,0,6,0,0,0,0,0,0,0,0,0,0,0,0,0,0,0,0,0,0,0,0,0,0,0,97326
32014,2030,195,610,889,193,143,96,39,39,0,0,39,0,0,0,0,0,0,0,0,0,57,50,0,6,44,7,4,0,0,4,3,0,0,3,97327
32015,56,10,0,46,0,0,0,0,0,0,0,0,0,0,0,0,0,0,0,0,0,0,0,0,0,0,0,0,0,0,0,0,0,0,0,97329
32016,24300,1205,2850,7020,6871,6354,2808,1433,1331,228,170,933,102,67,51,0,16,35,21,0,14,1375,1240,346,86,808,135,105,81,0,24,30,0,0,30,97330
32017,0,0,0,0,0,0,1896,959,950,85,105,760,9,9,0,0,9,0,0,0,0,937,937,184,53,700,0,0,0,0,0,0,0,0,0,97331
32018,12623,590,2084,3168,3954,2827,1547,718,634,158,21,455,84,77,30,0,47,7,7,0,0,829,809,279,90,440,20,20,20,0,0,0,0,0,0,97333
32019,13441,1182,4200,5293,1856,910,1021,476,337,69,10,258,139,103,0,20,83,36,0,32,4,545,453,93,59,301,92,60,0,9,51,32,32,0,0,97338
32020,2119,320,383,798,371,247,169,87,19,3,0,16,68,30,20,10,0,38,19,19,0,82,35,20,9,6,47,0,0,0,0,47,47,0,0,97341
32021,146,0,43,69,21,13,10,0,0,0,0,0,0,0,0,0,0,0,0,0,0,10,10,3,0,7,0,0,0,0,0,0,0,0,0,97342
32022,208,51,82,61,14,0,0,0,0,0,0,0,0,0,0,0,0,0,0,0,0,0,0,0,0,0,0,0,0,0,0,0,0,0,0,97343
32023,757,146,256,255,59,41,131,56,50,11,12,27,6,1,0,1,0,5,0,2,3,75,70,12,18,40,5,5,0,0,5,0,0,0,0,97344
32024,273,109,71,51,42,0,0,0,0,0,0,0,0,0,0,0,0,0,0,0,0,0,0,0,0,0,0,0,0,0,0,0,0,0,0,97345
32025,707,130,179,243,81,74,36,13,0,0,0,0,13,0,0,0,0,13,0,0,13,23,23,0,13,10,0,0,0,0,0,0,0,0,0,97346
32026,1226,203,537,386,93,7,42,12,12,0,0,12,0,0,0,0,0,0,0,0,0,30,27,0,2,25,3,2,0,1,1,1,1,0,0,97347
32027,1032,94,254,511,133,40,82,48,39,7,0,32,9,9,9,0,0,0,0,0,0,34,20,12,0,8,14,14,14,0,0,0,0,0,0,97348
32028,132,22,53,48,6,3,8,8,8,0,0,8,0,0,0,0,0,0,0,0,0,0,0,0,0,0,0,0,0,0,0,0,0,0,0,97350
32029,5375,1067,1325,1897,657,429,696,395,213,0,0,213,182,182,60,0,122,0,0,0,0,301,208,69,0,139,93,93,0,0,93,0,0,0,0,97351
32030,4140,683,1073,1745,480,159,316,166,97,8,2,87,69,56,56,0,0,13,0,0,13,150,143,34,16,93,7,3,0,3,0,4,0,0,4,97352
32031,19634,1824,6448,8223,2298,841,1342,562,471,66,52,353,91,77,5,16,56,14,0,0,14,780,671,187,42,442,109,83,33,14,36,26,0,4,22,97355
32032,211,14,56,67,36,38,0,0,0,0,0,0,0,0,0,0,0,0,0,0,0,0,0,0,0,0,0,0,0,0,0,0,0,0,0,97357
32033,1672,135,715,578,195,49,136,55,55,0,44,11,0,0,0,0,0,0,0,0,0,81,77,0,16,61,4,4,0,0,4,0,0,0,0,97358
32034,1387,232,510,464,139,42,86,73,69,20,0,49,4,4,0,4,0,0,0,0,0,13,13,0,0,13,0,0,0,0,0,0,0,0,0,97360
32035,5879,485,1232,2157,1293,712,1249,427,360,68,76,216,67,26,0,0,26,41,24,0,17,822,822,269,50,503,0,0,0,0,0,0,0,0,0,97361
32036,2795,459,864,1065,287,120,352,163,152,27,0,125,11,11,11,0,0,0,0,0,0,189,183,13,21,149,6,0,0,0,0,6,0,0,6,97362
32037,635,15,230,264,93,33,43,26,26,6,3,17,0,0,0,0,0,0,0,0,0,17,17,0,0,17,0,0,0,0,0,0,0,0,0,97364
32038,7933,748,2022,2784,1552,827,452,196,147,36,38,73,49,49,30,0,19,0,0,0,0,256,223,53,15,155,33,27,0,16,11,6,6,0,0,97365
32039,1043,63,202,499,130,149,37,12,6,6,0,0,6,6,6,0,0,0,0,0,0,25,25,16,0,9,0,0,0,0,0,0,0,0,0,97366
32040,6954,787,2155,2444,1054,514,311,174,140,12,55,73,34,23,23,0,0,11,0,11,0,137,73,64,0,9,64,10,0,10,0,54,21,0,33,97367
32041,2622,318,949,802,399,154,234,124,95,34,0,61,29,29,17,0,12,0,0,0,0,110,95,52,25,18,15,15,15,0,0,0,0,0,0,97368
32042,300,0,45,216,39,0,0,0,0,0,0,0,0,0,0,0,0,0,0,0,0,0,0,0,0,0,0,0,0,0,0,0,0,0,0,97369
32043,5415,233,912,2015,1277,978,628,332,288,61,33,194,44,28,9,19,0,16,0,8,8,296,276,165,5,106,20,20,20,0,0,0,0,0,0,97370
32044,625,74,173,190,138,50,36,9,9,0,0,9,0,0,0,0,0,0,0,0,0,27,27,0,21,6,0,0,0,0,0,0,0,0,0,97371
32045,148,0,12,51,42,43,20,20,20,10,0,10,0,0,0,0,0,0,0,0,0,0,0,0,0,0,0,0,0,0,0,0,0,0,0,97373
32046,4009,461,1477,1487,375,209,425,244,125,32,0,93,119,59,41,0,18,60,25,35,0,181,130,17,29,84,51,4,0,0,4,47,45,0,2,97374
32047,790,161,263,231,42,93,100,69,32,19,0,13,37,37,32,0,5,0,0,0,0,31,31,16,0,15,0,0,0,0,0,0,0,0,0,97375
32048,1131,25,135,541,214,216,32,25,25,0,0,25,0,0,0,0,0,0,0,0,0,7,7,0,7,0,0,0,0,0,0,0,0,0,0,97376
32049,553,54,256,197,30,16,29,12,12,0,0,12,0,0,0,0,0,0,0,0,0,17,17,0,0,17,0,0,0,0,0,0,0,0,0,97377
32050,6368,917,2450,2215,552,234,313,223,144,15,44,85,79,79,31,25,23,0,0,0,0,90,90,45,20,25,0,0,0,0,0,0,0,0,0,97378
32051,1755,190,706,642,132,85,159,84,64,7,6,51,20,10,10,0,0,10,0,0,10,75,56,2,14,40,19,19,19,0,0,0,0,0,0,97380
32052,9570,965,2340,3700,1779,786,867,423,250,94,0,156,173,160,77,66,17,13,0,0,13,444,366,71,12,283,78,78,23,55,0,0,0,0,0,97381
32053,6330,986,2105,2156,636,447,763,433,355,58,0,297,78,49,32,17,0,29,29,0,0,330,278,137,51,90,52,52,39,0,13,0,0,0,0,97383
32054,0,0,0,0,0,0,0,0,0,0,0,0,0,0,0,0,0,0,0,0,0,0,0,0,0,0,0,0,0,0,0,0,0,0,0,97384
32055,2335,181,682,821,403,248,119,51,42,5,8,29,9,0,0,0,0,9,0,0,9,68,64,32,0,32,4,4,0,0,4,0,0,0,0,97385
32056,9757,1325,3621,3619,774,418,578,329,288,57,0,231,41,13,0,13,0,28,28,0,0,249,189,57,21,111,60,36,36,0,0,24,13,11,0,97386
32057,811,17,87,218,168,321,2,0,0,0,0,0,0,0,0,0,0,0,0,0,0,2,2,2,0,0,0,0,0,0,0,0,0,0,0,97388
32058,1091,75,295,509,162,50,57,25,25,7,0,18,0,0,0,0,0,0,0,0,0,32,32,7,0,25,0,0,0,0,0,0,0,0,0,97389
32059,349,33,142,138,34,2,25,20,20,9,0,11,0,0,0,0,0,0,0,0,0,5,5,0,0,5,0,0,0,0,0,0,0,0,0,97390
32060,3660,476,1420,1353,271,140,116,32,32,7,6,19,0,0,0,0,0,0,0,0,0,84,67,15,5,47,17,17,6,0,11,0,0,0,0,97391
32061,3541,337,983,1461,573,187,353,102,56,8,0,48,46,46,23,23,0,0,0,0,0,251,190,27,23,140,61,61,25,27,9,0,0,0,0,97392
32062,3554,324,1027,1402,629,172,154,85,60,1,0,59,25,25,16,0,9,0,0,0,0,69,54,14,5,35,15,11,11,0,0,4,0,4,0,97394
32063,1888,266,672,735,133,82,215,157,69,13,15,41,88,73,42,29,2,15,0,15,0,58,31,5,5,21,27,27,6,0,21,0,0,0,0,97396
32064,22801,1205,3981,8041,5845,3729,3082,1507,1370,167,245,958,137,111,39,20,52,26,0,0,26,1575,1460,445,29,986,115,115,27,0,88,0,0,0,0,97401
32065,34690,3780,8826,14611,5044,2429,2325,1058,814,218,146,450,244,128,84,33,11,116,25,57,34,1267,1081,350,60,671,186,106,37,23,46,80,10,7,63,97402
32066,4925,178,787,1054,1397,1509,3304,1437,1437,156,27,1254,0,0,0,0,0,0,0,0,0,1867,1838,420,76,1342,29,29,5,24,0,0,0,0,0,97403
32067,22897,2164,5504,9726,3693,1810,1598,741,557,201,38,318,184,150,108,18,24,34,3,0,31,857,747,187,66,494,110,103,71,0,32,7,0,0,7,97404
32068,31300,874,4098,9043,9178,8107,2170,1118,1041,216,76,749,77,60,27,33,0,17,0,0,17,1052,939,220,28,691,113,43,22,21,0,70,15,44,11,97405
32069,108,6,74,28,0,0,0,0,0,0,0,0,0,0,0,0,0,0,0,0,0,0,0,0,0,0,0,0,0,0,0,0,0,0,0,97406
32070,8442,403,1801,3171,1808,1259,591,316,299,74,16,209,17,17,17,0,0,0,0,0,0,275,250,58,18,174,25,11,11,0,0,14,0,14,0,97408
32071,625,81,315,148,54,27,15,0,0,0,0,0,0,0,0,0,0,0,0,0,0,15,15,0,0,15,0,0,0,0,0,0,0,0,0,97410
32072,6052,691,1838,2378,687,458,247,132,121,53,9,59,11,11,11,0,0,0,0,0,0,115,115,35,0,80,0,0,0,0,0,0,0,0,0,97411
32073,396,37,138,137,55,29,35,17,15,2,0,13,2,2,0,0,2,0,0,0,0,18,17,6,0,11,1,1,1,0,0,0,0,0,0,97412
32074,787,73,228,319,91,76,9,0,0,0,0,0,0,0,0,0,0,0,0,0,0,9,9,2,0,7,0,0,0,0,0,0,0,0,0,97413
32075,157,0,62,18,59,18,14,14,0,0,0,0,14,14,0,14,0,0,0,0,0,0,0,0,0,0,0,0,0,0,0,0,0,0,0,97414
32076,11061,839,3301,4711,1481,729,435,291,189,35,28,126,102,87,30,0,57,15,0,0,15,144,100,0,0,100,44,44,44,0,0,0,0,0,0,97415
32077,590,72,252,192,55,19,51,22,20,0,0,20,2,2,0,2,0,0,0,0,0,29,16,0,0,16,13,11,11,0,0,2,2,0,0,97416
32078,1767,340,652,610,104,61,72,21,10,3,0,7,11,11,0,4,7,0,0,0,0,51,51,13,13,25,0,0,0,0,0,0,0,0,0,97417
32079,1115,32,305,585,132,61,30,0,0,0,0,0,0,0,0,0,0,0,0,0,0,30,30,9,0,21,0,0,0,0,0,0,0,0,0,97419
32080,18589,2212,5863,7358,2066,1090,1307,791,519,80,60,379,272,157,104,38,15,115,45,24,46,516,464,114,47,303,52,30,30,0,0,22,22,0,0,97420
32081,5413,698,1743,2029,620,323,372,88,56,0,0,56,32,20,0,0,20,12,0,0,12,284,284,0,0,284,0,0,0,0,0,0,0,0,0,97423
32082,12126,1604,3984,4870,1099,569,617,354,221,54,22,145,133,123,99,24,0,10,7,0,3,263,162,48,19,95,101,101,49,27,25,0,0,0,0,97424
32083,6686,638,1918,2955,640,535,247,114,86,10,25,51,28,28,11,0,17,0,0,0,0,133,133,33,0,100,0,0,0,0,0,0,0,0,0,97426
32084,535,68,134,206,78,49,14,10,10,4,0,6,0,0,0,0,0,0,0,0,0,4,4,0,4,0,0,0,0,0,0,0,0,0,0,97429
32085,231,37,51,86,46,11,4,0,0,0,0,0,0,0,0,0,0,0,0,0,0,4,4,0,0,4,0,0,0,0,0,0,0,0,0,97430
32086,1801,199,555,739,181,127,27,22,22,8,0,14,0,0,0,0,0,0,0,0,0,5,5,0,0,5,0,0,0,0,0,0,0,0,0,97431
32087,680,117,274,233,50,6,41,26,26,11,9,6,0,0,0,0,0,0,0,0,0,15,15,0,0,15,0,0,0,0,0,0,0,0,0,97434
32088,1563,210,604,620,95,34,90,68,47,14,6,27,21,14,0,0,14,7,7,0,0,22,22,0,0,22,0,0,0,0,0,0,0,0,0,97435
32089,641,21,195,272,64,89,43,35,29,0,0,29,6,6,6,0,0,0,0,0,0,8,5,0,0,5,3,3,3,0,0,0,0,0,0,97436
32090,1916,213,475,787,280,161,95,41,41,7,0,34,0,0,0,0,0,0,0,0,0,54,54,0,0,54,0,0,0,0,0,0,0,0,0,97437
32091,734,21,251,296,118,48,99,87,55,16,35,4,32,32,32,0,0,0,0,0,0,12,12,0,0,12,0,0,0,0,0,0,0,0,0,97438
32092,12053,1004,3429,5017,1735,868,360,216,152,36,41,75,64,64,60,0,4,0,0,0,0,144,106,33,11,62,38,38,15,23,0,0,0,0,0,97439
32093,137,38,9,90,0,0,65,0,0,0,0,0,0,0,0,0,0,0,0,0,0,65,65,0,0,65,0,0,0,0,0,0,0,0,0,97441
32094,1627,195,543,678,169,42,77,48,48,28,0,20,0,0,0,0,0,0,0,0,0,29,22,0,0,22,7,7,7,0,0,0,0,0,0,97442
32095,1443,89,411,612,153,178,139,88,88,37,0,51,0,0,0,0,0,0,0,0,0,51,51,17,15,19,0,0,0,0,0,0,0,0,0,97443
32096,3644,325,1216,1307,410,386,269,147,105,97,0,8,42,42,22,0,20,0,0,0,0,122,122,20,8,94,0,0,0,0,0,0,0,0,0,97444
32097,3308,286,1135,1322,401,164,311,221,171,91,0,80,50,50,0,50,0,0,0,0,0,90,79,38,0,41,11,11,11,0,0,0,0,0,0,97446
32098,625,58,212,236,79,40,17,17,0,0,0,0,17,8,0,0,8,9,9,0,0,0,0,0,0,0,0,0,0,0,0,0,0,0,0,97447
32099,8729,967,2876,3423,999,464,597,352,324,78,39,207,28,16,16,0,0,12,12,0,0,245,223,82,11,130,22,22,0,16,6,0,0,0,0,97448
32100,1657,207,513,652,215,70,38,31,31,6,0,25,0,0,0,0,0,0,0,0,0,7,7,4,0,3,0,0,0,0,0,0,0,0,0,97449
32101,616,141,218,107,144,6,10,10,0,0,0,0,10,10,0,0,10,0,0,0,0,0,0,0,0,0,0,0,0,0,0,0,0,0,0,97450
32102,329,60,151,71,32,15,0,0,0,0,0,0,0,0,0,0,0,0,0,0,0,0,0,0,0,0,0,0,0,0,0,0,0,0,0,97451
32103,1102,133,462,380,92,35,70,37,37,12,0,25,0,0,0,0,0,0,0,0,0,33,33,19,0,14,0,0,0,0,0,0,0,0,0,97452
32104,559,42,194,219,74,30,28,15,12,5,0,7,3,0,0,0,0,3,3,0,0,13,13,7,0,6,0,0,0,0,0,0,0,0,0,97453
32105,1034,69,350,408,154,53,35,26,26,3,0,23,0,0,0,0,0,0,0,0,0,9,7,3,0,4,2,2,2,0,0,0,0,0,0,97454
32106,1849,158,716,624,195,156,93,19,19,0,0,19,0,0,0,0,0,0,0,0,0,74,74,0,38,36,0,0,0,0,0,0,0,0,0,97455
32107,2223,346,923,648,183,123,112,31,31,19,0,12,0,0,0,0,0,0,0,0,0,81,68,8,0,60,13,13,0,5,8,0,0,0,0,97456
32108,6980,1228,2492,2596,483,181,545,263,230,27,0,203,33,23,12,0,11,10,10,0,0,282,273,0,17,256,9,9,0,9,0,0,0,0,0,97457
32109,3162,630,977,1107,303,145,225,101,92,18,3,71,9,5,0,5,0,4,0,4,0,124,91,0,0,91,33,9,0,0,9,24,24,0,0,97458
32110,10373,997,3311,3900,1404,761,552,236,214,40,22,152,22,11,0,11,0,11,0,0,11,316,242,66,14,162,74,74,25,49,0,0,0,0,0,97459
32111,416,74,125,139,69,9,41,16,16,5,0,11,0,0,0,0,0,0,0,0,0,25,25,11,0,14,0,0,0,0,0,0,0,0,0,97461
32112,3084,363,940,1369,291,121,194,88,70,23,0,47,18,0,0,0,0,18,7,2,9,106,79,9,5,65,27,15,0,6,9,12,0,12,0,97462
32113,3005,521,907,1026,304,247,119,37,37,0,15,22,0,0,0,0,0,0,0,0,0,82,82,0,34,48,0,0,0,0,0,0,0,0,0,97463
32114,2058,212,567,806,297,176,122,46,28,0,0,28,18,18,0,18,0,0,0,0,0,76,47,0,0,47,29,20,20,0,0,9,0,0,9,97465
32115,779,113,218,371,63,14,151,72,52,39,0,13,20,8,8,0,0,12,0,12,0,79,63,10,21,32,16,0,0,0,0,16,0,0,16,97466
32116,3910,609,1391,1240,385,285,234,127,81,43,9,29,46,23,23,0,0,23,0,23,0,107,107,31,0,76,0,0,0,0,0,0,0,0,0,97467
32117,1898,310,682,661,178,67,91,41,41,5,0,36,0,0,0,0,0,0,0,0,0,50,50,11,6,33,0,0,0,0,0,0,0,0,0,97469
32118,13971,1511,4582,5696,1302,880,1184,580,424,64,45,315,156,81,65,16,0,75,0,0,75,604,479,64,38,377,125,80,42,14,24,45,0,45,0,97470
32119,22419,2123,6559,8415,3407,1915,1287,758,583,141,24,418,175,144,57,42,45,31,0,0,31,529,437,137,58,242,92,21,7,0,14,71,0,36,35,97471
32120,285,94,50,78,48,15,10,10,10,0,0,10,0,0,0,0,0,0,0,0,0,0,0,0,0,0,0,0,0,0,0,0,0,0,0,97473
32121,46,0,15,23,0,8,0,0,0,0,0,0,0,0,0,0,0,0,0,0,0,0,0,0,0,0,0,0,0,0,0,0,0,0,0,97476
32122,24575,3288,7017,9733,2956,1581,2023,1014,679,65,144,470,335,309,117,45,147,26,12,0,14,1009,780,265,148,367,229,196,150,0,46,33,0,0,33,97477
32123,25151,2707,8324,10180,2530,1410,2338,1296,972,328,95,549,324,195,125,61,9,129,0,0,129,1042,671,203,99,369,371,344,184,112,48,27,14,0,13,97478
32124,6456,1012,2081,2856,331,176,344,165,110,17,0,93,55,19,11,0,8,36,0,36,0,179,169,115,0,54,10,10,0,0,10,0,0,0,0,97479
32125,284,32,106,94,39,13,4,4,0,0,0,0,4,4,0,4,0,0,0,0,0,0,0,0,0,0,0,0,0,0,0,0,0,0,0,97480
32126,373,48,158,107,33,27,12,5,0,0,0,0,5,5,5,0,0,0,0,0,0,7,7,0,0,7,0,0,0,0,0,0,0,0,0,97481
32127,239,22,78,124,15,0,10,6,0,0,0,0,6,6,6,0,0,0,0,0,0,4,4,0,0,4,0,0,0,0,0,0,0,0,0,97484
32128,542,69,152,196,78,47,0,0,0,0,0,0,0,0,0,0,0,0,0,0,0,0,0,0,0,0,0,0,0,0,0,0,0,0,0,97486
32129,5445,405,1596,2384,746,314,509,342,325,101,31,193,17,17,0,11,6,0,0,0,0,167,162,33,7,122,5,5,5,0,0,0,0,0,0,97487
32130,760,79,262,231,125,63,17,5,5,0,0,5,0,0,0,0,0,0,0,0,0,12,12,0,0,12,0,0,0,0,0,0,0,0,0,97488
32131,588,0,132,199,159,98,3,0,0,0,0,0,0,0,0,0,0,0,0,0,0,3,3,3,0,0,0,0,0,0,0,0,0,0,0,97489
32132,315,0,122,133,51,9,42,11,11,0,11,0,0,0,0,0,0,0,0,0,0,31,31,0,0,31,0,0,0,0,0,0,0,0,0,97490
32133,452,62,133,140,67,50,45,15,13,2,5,6,2,2,0,0,2,0,0,0,0,30,3,0,0,3,27,2,0,2,0,25,0,0,25,97492
32134,232,7,77,68,57,23,7,3,3,1,0,2,0,0,0,0,0,0,0,0,0,4,4,0,1,3,0,0,0,0,0,0,0,0,0,97493
32135,0,0,0,0,0,0,0,0,0,0,0,0,0,0,0,0,0,0,0,0,0,0,0,0,0,0,0,0,0,0,0,0,0,0,0,97494
32136,1025,39,288,370,286,42,45,0,0,0,0,0,0,0,0,0,0,0,0,0,0,45,45,21,0,24,0,0,0,0,0,0,0,0,0,97495
32137,4983,659,1471,2432,304,117,472,273,273,89,0,184,0,0,0,0,0,0,0,0,0,199,125,28,0,97,74,48,0,23,25,26,0,26,0,97496
32138,1370,201,392,611,54,112,108,54,43,28,3,12,11,11,11,0,0,0,0,0,0,54,54,39,0,15,0,0,0,0,0,0,0,0,0,97497
32139,1530,99,347,610,255,219,168,110,97,21,7,69,13,13,13,0,0,0,0,0,0,58,47,16,0,31,11,11,4,0,7,0,0,0,0,97498
32140,1540,181,576,694,68,21,91,40,25,10,0,15,15,15,0,15,0,0,0,0,0,51,48,8,0,40,3,3,0,0,3,0,0,0,0,97499
32141,27846,5134,8138,10353,2923,1298,2462,1286,770,194,80,496,516,367,276,28,63,149,47,35,67,1176,832,166,126,540,344,207,173,34,0,137,71,6,60,97501
32142,19544,2239,6572,7117,2341,1275,1355,606,415,43,100,272,191,112,25,50,37,79,69,0,10,749,676,189,69,418,73,73,60,0,13,0,0,0,0,97502
32143,7398,1549,2305,2929,448,167,440,247,99,0,0,99,148,73,73,0,0,75,75,0,0,193,107,0,58,49,86,71,27,44,0,15,0,15,0,97503
32144,31902,2524,8081,11665,5878,3754,2220,1149,859,253,64,542,290,205,154,13,38,85,37,40,8,1071,810,208,67,535,261,254,134,88,32,7,7,0,0,97504
32145,17224,503,2082,5288,4838,4513,1606,704,630,108,23,499,74,49,18,0,31,25,0,0,25,902,837,224,57,556,65,50,0,48,2,15,0,15,0,97520
32146,416,47,106,189,70,4,59,30,23,0,0,23,7,7,7,0,0,0,0,0,0,29,17,3,0,14,12,12,6,0,6,0,0,0,0,97522
32147,4572,843,1578,1464,424,263,156,80,60,19,0,41,20,11,0,0,11,9,0,9,0,76,57,0,0,57,19,7,0,0,7,12,0,0,12,97523
32148,8969,823,2997,3881,893,375,713,372,318,114,71,133,54,47,19,11,17,7,0,0,7,341,211,22,0,189,130,130,96,6,28,0,0,0,0,97524
32149,3485,283,1200,1576,278,148,116,62,25,0,0,25,37,37,0,18,19,0,0,0,0,54,54,23,0,31,0,0,0,0,0,0,0,0,0,97525
32150,25032,2869,7780,10263,2615,1505,1957,1189,1024,162,72,790,165,126,63,59,4,39,0,14,25,768,584,196,99,289,184,70,10,0,60,114,77,0,37,97526
32151,24189,2694,7824,9498,2605,1568,1603,676,533,50,61,422,143,128,74,11,43,15,0,15,0,927,757,185,46,526,170,144,24,90,30,26,0,0,26,97527
32152,5817,268,1303,2217,1068,961,398,221,122,20,18,84,99,99,67,0,32,0,0,0,0,177,177,25,20,132,0,0,0,0,0,0,0,0,0,97530
32153,212,79,46,42,26,19,0,0,0,0,0,0,0,0,0,0,0,0,0,0,0,0,0,0,0,0,0,0,0,0,0,0,0,0,0,97531
32154,1818,57,587,882,116,176,195,175,118,17,0,101,57,57,0,0,57,0,0,0,0,20,20,0,0,20,0,0,0,0,0,0,0,0,0,97532
32155,261,26,104,109,10,12,0,0,0,0,0,0,0,0,0,0,0,0,0,0,0,0,0,0,0,0,0,0,0,0,0,0,0,0,0,97534
32156,4043,517,1034,1673,611,208,206,88,61,0,0,61,27,15,0,0,15,12,0,12,0,118,107,17,0,90,11,0,0,0,0,11,0,0,11,97535
32157,790,76,293,280,110,31,27,3,0,0,0,0,3,0,0,0,0,3,0,0,3,24,24,4,0,20,0,0,0,0,0,0,0,0,0,97536
32158,5482,561,1895,2248,519,259,343,246,215,45,46,124,31,26,0,0,26,5,0,0,5,97,81,25,25,31,16,16,0,0,16,0,0,0,0,97537
32159,1423,150,498,466,206,103,38,37,27,14,0,13,10,10,0,0,10,0,0,0,0,1,1,0,0,1,0,0,0,0,0,0,0,0,0,97538
32160,2816,457,953,1046,206,154,99,15,6,6,0,0,9,9,8,0,1,0,0,0,0,84,66,0,0,66,18,0,0,0,0,18,18,0,0,97539
32161,5819,417,1479,1986,1217,720,291,208,107,0,11,96,101,96,33,0,63,5,5,0,0,83,65,0,17,48,18,9,0,0,9,9,9,0,0,97540
32162,733,83,261,265,96,28,34,17,0,0,0,0,17,0,0,0,0,17,0,17,0,17,17,0,0,17,0,0,0,0,0,0,0,0,0,97541
32163,581,67,317,151,17,29,8,8,8,0,0,8,0,0,0,0,0,0,0,0,0,0,0,0,0,0,0,0,0,0,0,0,0,0,0,97543
32164,1835,162,546,598,369,160,134,32,0,0,0,0,32,32,0,32,0,0,0,0,0,102,49,0,0,49,53,0,0,0,0,53,0,53,0,97544
32165,15058,2148,4214,5348,1999,1349,1329,732,668,181,66,421,64,26,0,23,3,38,16,14,8,597,473,77,103,293,124,78,43,19,16,46,9,37,0,97601
32166,19755,1882,6678,6971,2805,1419,1639,882,680,241,87,352,202,77,47,13,17,125,90,21,14,757,631,176,35,420,126,51,24,9,18,75,17,11,47,97603
32167,60,0,7,32,21,0,0,0,0,0,0,0,0,0,0,0,0,0,0,0,0,0,0,0,0,0,0,0,0,0,0,0,0,0,0,97604
32168,70,7,5,35,18,5,0,0,0,0,0,0,0,0,0,0,0,0,0,0,0,0,0,0,0,0,0,0,0,0,0,0,0,0,0,97620
32169,203,0,76,106,0,21,0,0,0,0,0,0,0,0,0,0,0,0,0,0,0,0,0,0,0,0,0,0,0,0,0,0,0,0,0,97621
32170,351,66,73,157,46,9,0,0,0,0,0,0,0,0,0,0,0,0,0,0,0,0,0,0,0,0,0,0,0,0,0,0,0,0,0,97622
32171,1730,197,649,666,152,66,47,45,31,0,0,31,14,2,0,1,1,12,0,0,12,2,2,0,0,2,0,0,0,0,0,0,0,0,0,97623
32172,2359,280,678,1108,217,76,84,77,57,21,0,36,20,0,0,0,0,20,0,20,0,7,0,0,0,0,7,7,0,7,0,0,0,0,0,97624
32173,162,9,84,40,29,0,0,0,0,0,0,0,0,0,0,0,0,0,0,0,0,0,0,0,0,0,0,0,0,0,0,0,0,0,0,97625
32174,183,0,19,43,87,34,0,0,0,0,0,0,0,0,0,0,0,0,0,0,0,0,0,0,0,0,0,0,0,0,0,0,0,0,0,97626
32175,695,65,211,320,75,24,0,0,0,0,0,0,0,0,0,0,0,0,0,0,0,0,0,0,0,0,0,0,0,0,0,0,0,0,0,97627
32176,3967,656,1187,1283,594,247,223,115,76,5,17,54,39,38,6,32,0,1,0,1,0,108,101,81,16,4,7,7,7,0,0,0,0,0,0,97630
32177,866,251,243,204,74,94,60,36,20,5,2,13,16,8,0,8,0,8,0,8,0,24,24,3,0,21,0,0,0,0,0,0,0,0,0,97632
32178,902,299,353,203,27,20,70,46,35,23,3,9,11,11,11,0,0,0,0,0,0,24,15,0,0,15,9,9,9,0,0,0,0,0,0,97633
32179,191,10,98,79,4,0,85,16,16,0,0,16,0,0,0,0,0,0,0,0,0,69,13,0,0,13,56,30,30,0,0,26,0,0,26,97634
32180,302,73,97,118,0,14,36,0,0,0,0,0,0,0,0,0,0,0,0,0,0,36,36,3,33,0,0,0,0,0,0,0,0,0,0,97635
32181,366,50,127,137,45,7,44,27,20,0,0,20,7,0,0,0,0,7,0,0,7,17,15,9,0,6,2,0,0,0,0,2,0,0,2,97636
32182,61,8,19,13,17,4,5,5,5,5,0,0,0,0,0,0,0,0,0,0,0,0,0,0,0,0,0,0,0,0,0,0,0,0,0,97637
32183,336,8,148,66,79,35,31,0,0,0,0,0,0,0,0,0,0,0,0,0,0,31,31,0,19,12,0,0,0,0,0,0,0,0,0,97638
32184,442,11,260,137,9,25,0,0,0,0,0,0,0,0,0,0,0,0,0,0,0,0,0,0,0,0,0,0,0,0,0,0,0,0,0,97639
32185,72,0,46,5,19,2,0,0,0,0,0,0,0,0,0,0,0,0,0,0,0,0,0,0,0,0,0,0,0,0,0,0,0,0,0,97640
32186,799,187,345,256,2,9,56,30,13,6,0,7,17,17,17,0,0,0,0,0,0,26,26,19,0,7,0,0,0,0,0,0,0,0,0,97641
32187,41065,2311,7759,16043,9989,4963,2642,1082,837,292,62,483,245,193,76,51,66,52,11,19,22,1560,1469,486,66,917,91,91,52,37,2,0,0,0,0,97701
32188,29457,1641,5498,11543,7316,3459,1634,991,900,401,34,465,91,91,70,0,21,0,0,0,0,643,625,202,112,311,18,18,18,0,0,0,0,0,0,97702
32189,4683,274,1179,1728,716,786,246,48,48,0,0,48,0,0,0,0,0,0,0,0,0,198,161,47,0,114,37,0,0,0,0,37,37,0,0,97707
32190,134,20,44,36,6,28,11,11,11,0,0,11,0,0,0,0,0,0,0,0,0,0,0,0,0,0,0,0,0,0,0,0,0,0,0,97710
32191,68,9,14,38,4,3,0,0,0,0,0,0,0,0,0,0,0,0,0,0,0,0,0,0,0,0,0,0,0,0,0,0,0,0,0,97711
32192,32,0,0,9,23,0,0,0,0,0,0,0,0,0,0,0,0,0,0,0,0,0,0,0,0,0,0,0,0,0,0,0,0,0,0,97712
32193,3029,344,1193,1022,279,191,319,245,174,7,23,144,71,46,44,0,2,25,21,0,4,74,71,46,0,25,3,3,0,2,1,0,0,0,0,97720
32194,355,79,163,97,14,2,3,3,3,3,0,0,0,0,0,0,0,0,0,0,0,0,0,0,0,0,0,0,0,0,0,0,0,0,0,97721
32195,67,0,31,26,7,3,1,1,1,0,1,0,0,0,0,0,0,0,0,0,0,0,0,0,0,0,0,0,0,0,0,0,0,0,0,97722
32196,304,1,34,80,147,42,9,9,9,0,0,9,0,0,0,0,0,0,0,0,0,0,0,0,0,0,0,0,0,0,0,0,0,0,0,97730
32197,332,91,107,60,74,0,7,0,0,0,0,0,0,0,0,0,0,0,0,0,0,7,7,0,0,7,0,0,0,0,0,0,0,0,0,97731
32198,106,0,51,36,19,0,23,10,10,0,0,10,0,0,0,0,0,0,0,0,0,13,13,0,0,13,0,0,0,0,0,0,0,0,0,97732
32199,570,55,150,288,66,11,9,9,9,0,0,9,0,0,0,0,0,0,0,0,0,0,0,0,0,0,0,0,0,0,0,0,0,0,0,97733
32200,1941,365,554,736,199,87,121,48,48,13,6,29,0,0,0,0,0,0,0,0,0,73,49,5,9,35,24,4,4,0,0,20,20,0,0,97734
32201,71,5,11,37,0,18,47,30,28,0,28,0,2,2,2,0,0,0,0,0,0,17,17,17,0,0,0,0,0,0,0,0,0,0,0,97735
32202,130,21,53,28,24,4,2,2,2,0,0,2,0,0,0,0,0,0,0,0,0,0,0,0,0,0,0,0,0,0,0,0,0,0,0,97736
32203,356,49,184,83,40,0,0,0,0,0,0,0,0,0,0,0,0,0,0,0,0,0,0,0,0,0,0,0,0,0,0,0,0,0,0,97737
32204,1148,151,352,457,81,107,77,34,33,6,16,11,1,0,0,0,0,1,0,0,1,43,37,0,0,37,6,6,6,0,0,0,0,0,0,97738
32205,8994,1425,3562,3287,460,260,233,190,169,14,25,130,21,4,4,0,0,17,0,0,17,43,19,3,4,12,24,24,24,0,0,0,0,0,0,97739
32206,7663,1354,2709,2226,878,496,648,312,237,45,27,165,75,31,23,0,8,44,31,5,8,336,253,41,0,212,83,11,11,0,0,72,0,0,72,97741
32207,290,46,107,94,26,17,10,8,8,6,0,2,0,0,0,0,0,0,0,0,0,2,2,1,1,0,0,0,0,0,0,0,0,0,0,97750
32208,84,27,8,17,32,0,0,0,0,0,0,0,0,0,0,0,0,0,0,0,0,0,0,0,0,0,0,0,0,0,0,0,0,0,0,97751
32209,43,8,0,35,0,0,0,0,0,0,0,0,0,0,0,0,0,0,0,0,0,0,0,0,0,0,0,0,0,0,0,0,0,0,0,97752
32210,1567,62,405,522,426,152,16,6,6,0,0,6,0,0,0,0,0,0,0,0,0,10,10,0,0,10,0,0,0,0,0,0,0,0,0,97753
32211,13388,2193,4979,4659,1039,518,906,581,465,24,70,371,116,115,54,50,11,1,0,0,1,325,285,87,13,185,40,28,28,0,0,12,10,0,2,97754
32212,22740,1973,6426,9711,3052,1578,2266,1184,816,164,201,451,368,249,156,93,0,119,0,42,77,1082,853,224,103,526,229,179,37,45,97,50,20,30,0,97756
32213,68,13,8,32,12,3,6,0,0,0,0,0,0,0,0,0,0,0,0,0,0,6,6,0,0,6,0,0,0,0,0,0,0,0,0,97758
32214,4692,128,1086,1650,992,836,465,275,248,72,35,141,27,8,8,0,0,19,8,11,0,190,170,53,0,117,20,20,4,0,16,0,0,0,0,97759
32215,5027,343,1481,2051,774,378,193,117,108,20,33,55,9,9,9,0,0,0,0,0,0,76,76,0,39,37,0,0,0,0,0,0,0,0,0,97760
32216,2143,448,642,841,103,109,262,118,69,21,4,44,49,27,19,7,1,22,6,0,16,144,101,31,0,70,43,3,0,3,0,40,20,14,6,97761
32217,14531,1562,4020,6068,1785,1096,1140,526,453,115,61,277,73,46,12,16,18,27,7,0,20,614,516,242,74,200,98,71,67,0,4,27,25,0,2,97801
32218,604,29,189,261,90,35,36,23,19,0,0,19,4,4,4,0,0,0,0,0,0,13,13,11,0,2,0,0,0,0,0,0,0,0,0,97810
32219,686,71,251,240,94,30,52,25,25,0,0,25,0,0,0,0,0,0,0,0,0,27,23,4,4,15,4,4,4,0,0,0,0,0,0,97812
32220,752,98,190,297,90,77,63,51,27,11,3,13,24,18,0,18,0,6,0,0,6,12,12,2,0,10,0,0,0,0,0,0,0,0,0,97813
32221,8927,942,2681,3392,1340,572,600,323,254,59,11,184,69,13,13,0,0,56,14,10,32,277,228,21,55,152,49,0,0,0,0,49,21,0,28,97814
32222,39,0,4,16,19,0,0,0,0,0,0,0,0,0,0,0,0,0,0,0,0,0,0,0,0,0,0,0,0,0,0,0,0,0,0,97817
32223,2158,836,718,493,53,58,217,106,106,32,27,47,0,0,0,0,0,0,0,0,0,111,98,26,5,67,13,13,13,0,0,0,0,0,0,97818
32224,26,5,0,12,9,0,0,0,0,0,0,0,0,0,0,0,0,0,0,0,0,0,0,0,0,0,0,0,0,0,0,0,0,0,0,97819
32225,671,64,247,225,84,51,21,4,3,3,0,0,1,0,0,0,0,1,0,0,1,17,8,0,0,8,9,9,0,9,0,0,0,0,0,97820
32226,679,48,242,315,48,26,13,13,13,2,7,4,0,0,0,0,0,0,0,0,0,0,0,0,0,0,0,0,0,0,0,0,0,0,0,97823
32227,1394,231,421,384,261,97,138,52,27,4,0,23,25,0,0,0,0,25,0,25,0,86,34,10,8,16,52,15,15,0,0,37,11,14,12,97824
32228,226,12,77,76,43,18,11,9,7,0,4,3,2,0,0,0,0,2,0,0,2,2,2,0,0,2,0,0,0,0,0,0,0,0,0,97825
32229,656,96,184,253,96,27,60,39,36,18,0,18,3,0,0,0,0,3,0,0,3,21,21,0,0,21,0,0,0,0,0,0,0,0,0,97826
32230,1633,145,715,630,96,47,134,84,84,24,12,48,0,0,0,0,0,0,0,0,0,50,26,3,0,23,24,15,15,0,0,9,0,0,9,97827
32231,2311,177,821,787,340,186,111,33,33,26,0,7,0,0,0,0,0,0,0,0,0,78,49,35,14,0,29,0,0,0,0,29,0,17,12,97828
32232,541,63,155,219,77,27,45,37,35,11,0,24,2,0,0,0,0,2,2,0,0,8,8,0,0,8,0,0,0,0,0,0,0,0,0,97830
32233,603,59,209,243,60,32,41,30,30,2,2,26,0,0,0,0,0,0,0,0,0,11,11,0,11,0,0,0,0,0,0,0,0,0,0,97833
32234,699,57,197,221,123,101,5,0,0,0,0,0,0,0,0,0,0,0,0,0,0,5,5,2,3,0,0,0,0,0,0,0,0,0,0,97834
32235,230,18,58,100,30,24,33,9,0,0,0,0,9,1,1,0,0,8,0,8,0,24,16,0,0,16,8,0,0,0,0,8,0,0,8,97835
32236,1470,172,564,578,119,37,140,99,99,29,14,56,0,0,0,0,0,0,0,0,0,41,41,4,0,37,0,0,0,0,0,0,0,0,0,97836
32237,64,4,10,39,8,3,10,5,5,0,0,5,0,0,0,0,0,0,0,0,0,5,5,0,0,5,0,0,0,0,0,0,0,0,0,97837
32238,15632,3321,4436,5621,1381,873,1664,761,440,64,145,231,321,233,151,82,0,88,56,0,32,903,765,177,56,532,138,82,38,18,26,56,21,0,35,97838
32239,340,30,117,97,63,33,13,3,3,3,0,0,0,0,0,0,0,0,0,0,0,10,10,0,0,10,0,0,0,0,0,0,0,0,0,97839
32240,132,0,72,44,16,0,26,26,26,0,10,16,0,0,0,0,0,0,0,0,0,0,0,0,0,0,0,0,0,0,0,0,0,0,0,97840
32241,272,9,101,86,65,11,27,23,20,13,0,7,3,0,0,0,0,3,0,0,3,4,1,1,0,0,3,3,0,0,3,0,0,0,0,97841
32242,149,8,53,55,20,13,0,0,0,0,0,0,0,0,0,0,0,0,0,0,0,0,0,0,0,0,0,0,0,0,0,0,0,0,0,97842
32243,474,15,138,188,105,28,47,27,24,4,12,8,3,0,0,0,0,3,0,0,3,20,20,5,4,11,0,0,0,0,0,0,0,0,0,97843
32244,2612,638,866,903,160,45,274,181,181,0,12,169,0,0,0,0,0,0,0,0,0,93,77,15,0,62,16,9,0,0,9,7,0,7,0,97844
32245,1815,215,521,606,252,221,111,58,51,20,0,31,7,7,0,7,0,0,0,0,0,53,28,0,0,28,25,10,0,3,7,15,0,0,15,97845
32246,1440,73,455,501,254,157,75,70,50,3,0,47,20,12,0,0,12,8,8,0,0,5,5,0,0,5,0,0,0,0,0,0,0,0,0,97846
32247,167,22,55,50,27,13,14,11,11,0,0,11,0,0,0,0,0,0,0,0,0,3,1,0,0,1,2,2,0,0,2,0,0,0,0,97848
32248,11013,949,3516,3761,1798,989,1193,625,528,147,21,360,97,79,24,26,29,18,16,0,2,568,492,171,48,273,76,48,32,0,16,28,0,0,28,97850
32249,327,30,94,154,33,16,21,15,15,0,3,12,0,0,0,0,0,0,0,0,0,6,6,5,0,1,0,0,0,0,0,0,0,0,0,97856
32250,403,18,144,129,75,37,42,27,13,0,0,13,14,14,14,0,0,0,0,0,0,15,12,0,0,12,3,3,3,0,0,0,0,0,0,97857
32251,74,0,30,30,14,0,0,0,0,0,0,0,0,0,0,0,0,0,0,0,0,0,0,0,0,0,0,0,0,0,0,0,0,0,0,97859
32252,7723,2090,2120,2459,604,450,744,474,372,85,116,171,102,52,41,11,0,50,0,50,0,270,209,41,32,136,61,61,21,0,40,0,0,0,0,97862
32253,189,21,70,81,15,2,23,13,7,2,0,5,6,0,0,0,0,6,6,0,0,10,5,0,0,5,5,0,0,0,0,5,0,5,0,97864
32254,968,116,361,334,103,54,52,23,20,13,0,7,3,3,3,0,0,0,0,0,0,29,29,4,0,25,0,0,0,0,0,0,0,0,0,97865
32255,544,73,142,213,81,35,27,15,11,0,2,9,4,0,0,0,0,4,4,0,0,12,7,2,0,5,5,0,0,0,0,5,0,0,5,97867
32256,1291,80,485,561,119,46,119,66,63,0,10,53,3,3,0,3,0,0,0,0,0,53,53,23,8,22,0,0,0,0,0,0,0,0,0,97868
32257,932,82,307,382,79,82,75,40,40,12,20,8,0,0,0,0,0,0,0,0,0,35,35,14,0,21,0,0,0,0,0,0,0,0,0,97869
32258,392,24,188,108,43,29,6,0,0,0,0,0,0,0,0,0,0,0,0,0,0,6,6,0,0,6,0,0,0,0,0,0,0,0,0,97870
32259,118,14,44,43,17,0,2,1,1,0,0,1,0,0,0,0,0,0,0,0,0,1,1,0,0,1,0,0,0,0,0,0,0,0,0,97873
32260,243,20,118,75,15,15,18,10,10,2,3,5,0,0,0,0,0,0,0,0,0,8,8,2,1,5,0,0,0,0,0,0,0,0,0,97874
32261,1717,257,588,643,143,86,144,67,60,23,10,27,7,7,7,0,0,0,0,0,0,77,73,22,8,43,4,4,4,0,0,0,0,0,0,97875
32262,684,23,247,230,106,78,42,30,30,24,0,6,0,0,0,0,0,0,0,0,0,12,12,3,0,9,0,0,0,0,0,0,0,0,0,97876
32263,183,9,67,88,12,7,0,0,0,0,0,0,0,0,0,0,0,0,0,0,0,0,0,0,0,0,0,0,0,0,0,0,0,0,0,97877
32264,152,6,55,58,15,18,21,13,13,0,0,13,0,0,0,0,0,0,0,0,0,8,6,0,0,6,2,2,0,0,2,0,0,0,0,97880
32265,4723,1243,1612,1508,218,142,390,225,146,46,0,100,79,53,53,0,0,26,0,0,26,165,144,26,53,65,21,21,8,0,13,0,0,0,0,97882
32266,1671,199,638,614,154,66,108,61,47,8,0,39,14,10,3,3,4,4,0,0,4,47,36,13,0,23,11,8,0,8,0,3,0,0,3,97883
32267,91,5,35,35,11,5,4,4,4,0,0,4,0,0,0,0,0,0,0,0,0,0,0,0,0,0,0,0,0,0,0,0,0,0,0,97884
32268,952,68,325,381,113,65,73,54,54,0,0,54,0,0,0,0,0,0,0,0,0,19,4,0,4,0,15,15,15,0,0,0,0,0,0,97885
32269,951,120,325,387,77,42,30,19,19,0,0,19,0,0,0,0,0,0,0,0,0,11,6,6,0,0,5,5,0,0,5,0,0,0,0,97886
32270,500,62,149,171,89,29,20,8,8,0,0,8,0,0,0,0,0,0,0,0,0,12,12,0,0,12,0,0,0,0,0,0,0,0,0,97901
32271,148,26,5,117,0,0,0,0,0,0,0,0,0,0,0,0,0,0,0,0,0,0,0,0,0,0,0,0,0,0,0,0,0,0,0,97903
32272,153,2,69,53,29,0,5,5,5,4,0,1,0,0,0,0,0,0,0,0,0,0,0,0,0,0,0,0,0,0,0,0,0,0,0,97904
32273,195,27,62,65,19,22,13,0,0,0,0,0,0,0,0,0,0,0,0,0,0,13,13,0,0,13,0,0,0,0,0,0,0,0,0,97905
32274,197,21,71,83,11,11,4,0,0,0,0,0,0,0,0,0,0,0,0,0,0,4,4,0,1,3,0,0,0,0,0,0,0,0,0,97906
32275,413,103,144,149,14,3,16,2,0,0,0,0,2,0,0,0,0,2,0,0,2,14,14,0,0,14,0,0,0,0,0,0,0,0,0,97907
32276,64,3,22,23,3,13,3,3,0,0,0,0,3,0,0,0,0,3,0,0,3,0,0,0,0,0,0,0,0,0,0,0,0,0,0,97908
32277,4,0,0,4,0,0,0,0,0,0,0,0,0,0,0,0,0,0,0,0,0,0,0,0,0,0,0,0,0,0,0,0,0,0,0,97909
32278,426,29,165,154,58,20,58,38,38,13,0,25,0,0,0,0,0,0,0,0,0,20,11,0,0,11,9,9,9,0,0,0,0,0,0,97910
32279,43,8,11,17,7,0,2,1,1,0,0,1,0,0,0,0,0,0,0,0,0,1,1,0,0,1,0,0,0,0,0,0,0,0,0,97911
32280,3413,765,1081,1232,200,135,269,176,162,62,17,83,14,10,0,10,0,4,0,0,4,93,93,28,8,57,0,0,0,0,0,0,0,0,0,97913
32281,12293,2652,3699,4349,880,713,1020,472,313,72,42,199,159,128,43,76,9,31,0,31,0,548,481,164,39,278,67,46,46,0,0,21,18,0,3,97914
32282,2894,361,924,1154,347,108,282,141,111,71,0,40,30,30,12,4,14,0,0,0,0,141,141,34,3,104,0,0,0,0,0,0,0,0,0,97918
32283,91,2,57,32,0,0,2,2,2,0,0,2,0,0,0,0,0,0,0,0,0,0,0,0,0,0,0,0,0,0,0,0,0,0,0,97920
32284,22379,1957,6727,8874,3655,1166,2272,1231,977,104,121,752,254,212,122,23,67,42,23,19,0,1041,970,356,47,567,71,68,32,21,15,3,0,0,3,98001
32285,21801,3924,7738,7415,1968,756,1852,938,758,163,96,499,180,77,66,0,11,103,53,42,8,914,711,223,112,376,203,144,96,48,0,59,10,17,32,98002
32286,28718,3570,8698,10348,4438,1664,3037,1598,1251,322,42,887,347,144,97,13,34,203,109,34,60,1439,1204,291,0,913,235,184,21,6,157,51,0,0,51,98003
32287,22395,653,1977,4682,8945,6138,1090,753,713,100,20,593,40,27,27,0,0,13,6,0,7,337,337,116,31,190,0,0,0,0,0,0,0,0,0,98004
32288,12306,454,1096,2733,4743,3280,734,341,291,34,93,164,50,12,12,0,0,38,38,0,0,393,342,23,0,319,51,0,0,0,0,51,0,51,0,98005
32289,24973,559,2484,5709,9539,6682,2000,993,955,119,81,755,38,38,14,24,0,0,0,0,0,1007,979,207,128,644,28,9,0,0,9,19,13,6,0,98006
32290,17849,1410,2239,3714,6192,4294,896,543,514,80,167,267,29,12,12,0,0,17,0,0,17,353,329,153,35,141,24,24,0,0,24,0,0,0,0,98007
32291,17568,1077,2772,4063,6456,3200,1220,648,552,99,34,419,96,70,62,0,8,26,0,26,0,572,524,149,103,272,48,22,14,0,8,26,0,0,26,98008
32292,3314,225,961,1348,516,264,413,169,122,11,27,84,47,47,36,11,0,0,0,0,0,244,244,93,0,151,0,0,0,0,0,0,0,0,0,98010
32293,21120,1206,3316,7152,6478,2968,1381,585,520,179,42,299,65,44,30,14,0,21,0,0,21,796,776,283,107,386,20,20,0,20,0,0,0,0,0,98011
32294,35645,1640,6067,11685,10803,5450,2303,1074,954,177,47,730,120,99,69,25,5,21,21,0,0,1229,1117,259,62,796,112,77,37,10,30,35,23,0,12,98012
32295,4869,391,862,1499,1421,696,451,233,229,11,39,179,4,4,4,0,0,0,0,0,0,218,188,94,14,80,30,30,30,0,0,0,0,0,0,98014
32296,7176,317,1667,2475,2035,682,802,299,256,113,0,143,43,11,11,0,0,32,0,0,32,503,427,126,74,227,76,76,0,45,31,0,0,0,0,98019
32297,14057,473,1887,4269,4675,2753,905,516,497,71,0,426,19,19,0,0,19,0,0,0,0,389,389,136,1,252,0,0,0,0,0,0,0,0,0,98020
32298,19106,890,3531,5853,5899,2933,1037,442,430,131,28,271,12,12,0,0,12,0,0,0,0,595,552,142,0,410,43,42,18,0,24,1,0,0,1,98021
32299,15087,1412,5375,5133,2221,946,870,368,308,65,34,209,60,60,60,0,0,0,0,0,0,502,439,147,34,258,63,63,29,23,11,0,0,0,0,98022
32300,31683,2708,7853,11981,6249,2892,2959,1690,1278,262,104,912,412,205,160,29,16,207,87,15,105,1269,1031,206,66,759,238,122,15,13,94,116,55,7,54,98023
32301,4186,236,930,1187,1386,447,271,138,121,48,30,43,17,0,0,0,0,17,17,0,0,133,133,0,0,133,0,0,0,0,0,0,0,0,0,98024
32302,26004,1331,4727,9236,7329,3381,2084,995,846,177,48,621,149,108,50,50,8,41,18,0,23,1089,1033,296,52,685,56,56,33,23,0,0,0,0,0,98026
32303,20298,703,2152,5940,7140,4363,1341,734,690,110,8,572,44,44,35,9,0,0,0,0,0,607,597,142,85,370,10,10,0,10,0,0,0,0,0,98027
32304,14706,1008,2054,4489,4386,2769,894,477,433,107,36,290,44,29,29,0,0,15,0,15,0,417,407,140,20,247,10,10,10,0,0,0,0,0,0,98028
32305,17745,400,1503,4620,7014,4208,1180,746,725,144,106,475,21,21,21,0,0,0,0,0,0,434,336,100,0,236,98,39,39,0,0,59,0,0,59,98029
32306,19884,3728,5266,6274,3520,1096,1974,1053,906,108,224,574,147,86,73,0,13,61,40,0,21,921,699,140,101,458,222,44,24,20,0,178,23,10,145,98030
32307,22271,3323,5848,7115,4139,1846,2313,1287,1086,222,49,815,201,67,35,10,22,134,86,0,48,1026,892,261,73,558,134,79,72,0,7,55,41,0,14,98031
32308,21306,3726,5727,7148,3581,1124,2053,1090,918,153,55,710,172,23,14,9,0,149,55,1,93,963,768,187,30,551,195,117,117,0,0,78,26,23,29,98032
32309,23151,757,2227,5691,9003,5473,1494,825,768,199,117,452,57,16,9,0,7,41,0,8,33,669,620,212,38,370,49,39,11,0,28,10,10,0,0,98033
32310,27283,1624,4094,8499,8570,4496,1542,744,599,131,34,434,145,84,79,5,0,61,0,0,61,798,685,152,83,450,113,104,4,97,3,9,0,0,9,98034
32311,25144,2327,5899,8939,5655,2324,1735,959,784,171,63,550,175,127,104,0,23,48,22,8,18,776,693,204,5,484,83,69,32,0,37,14,8,0,6,98036
32312,18709,1798,4790,6561,4213,1347,1462,746,626,111,145,370,120,112,24,43,45,8,0,0,8,716,492,150,34,308,224,141,126,0,15,83,31,11,41,98037
32313,21701,833,5224,8538,5014,2092,2034,1062,978,176,145,657,84,60,17,0,43,24,0,15,9,972,886,190,68,628,86,75,21,17,37,11,0,0,11,98038
32314,1877,12,94,264,922,585,172,88,88,0,0,88,0,0,0,0,0,0,0,0,0,84,71,0,0,71,13,13,0,0,13,0,0,0,0,98039
32315,16696,291,1011,2753,6842,5799,1000,535,517,125,19,373,18,18,18,0,0,0,0,0,0,465,456,100,0,356,9,9,9,0,0,0,0,0,0,98040
32316,29384,2181,7923,10756,5868,2656,2845,1389,1217,149,110,958,172,103,39,30,34,69,28,29,12,1456,1265,469,71,725,191,184,127,18,39,7,0,0,7,98042
32317,14414,1654,3566,5418,2521,1255,785,342,290,55,0,235,52,47,39,8,0,5,0,0,5,443,312,129,32,151,131,86,56,0,30,45,13,0,32,98043
32318,9677,598,1754,3641,2751,933,678,368,343,141,72,130,25,14,0,0,14,11,11,0,0,310,310,93,9,208,0,0,0,0,0,0,0,0,0,98045
32319,4087,634,1441,1576,344,92,458,227,192,75,33,84,35,12,12,0,0,23,0,11,12,231,210,62,10,138,21,0,0,0,0,21,21,0,0,98047
32320,112,0,14,26,61,11,13,13,13,0,13,0,0,0,0,0,0,0,0,0,0,0,0,0,0,0,0,0,0,0,0,0,0,0,0,98050
32321,2707,171,1051,1097,285,103,195,109,76,0,0,76,33,19,0,12,7,14,0,0,14,86,77,50,0,27,9,9,9,0,0,0,0,0,0,98051
32322,42658,2061,4301,10055,15250,10991,1730,1063,1010,234,79,697,53,23,15,8,0,30,0,10,20,667,576,129,11,436,91,91,28,0,63,0,0,0,0,98052
32323,15190,282,1303,3954,5562,4089,1039,524,442,156,43,243,82,71,58,13,0,11,0,0,11,515,507,126,0,381,8,8,0,8,0,0,0,0,0,98053
32324,15167,1738,3769,4974,3422,1264,826,613,466,27,0,439,147,98,31,9,58,49,0,49,0,213,202,29,0,173,11,11,11,0,0,0,0,0,0,98055
32325,23850,2837,4966,7674,5886,2487,1518,752,538,47,6,485,214,196,59,36,101,18,0,18,0,766,668,214,38,416,98,62,49,0,13,36,20,0,16,98056
32326,7913,943,1973,2937,1391,669,154,102,59,0,0,59,43,43,0,0,43,0,0,0,0,52,35,20,0,15,17,17,0,0,17,0,0,0,0,98057
32327,29747,2447,6364,10354,7929,2653,1836,968,834,194,75,565,134,56,56,0,0,78,46,23,9,868,724,209,6,509,144,109,33,11,65,35,0,0,35,98058
32328,24852,1524,5154,7512,7113,3549,1587,842,677,230,38,409,165,86,86,0,0,79,31,9,39,745,637,248,101,288,108,84,62,22,0,24,0,15,9,98059
32329,8043,234,825,2577,2941,1466,421,220,186,8,21,157,34,24,24,0,0,10,0,0,10,201,186,24,0,162,15,15,4,0,11,0,0,0,0,98065
32330,337,6,54,62,213,2,2,0,0,0,0,0,0,0,0,0,0,0,0,0,0,2,2,0,0,2,0,0,0,0,0,0,0,0,0,98068
32331,8571,365,1082,2390,2576,2158,579,286,286,67,38,181,0,0,0,0,0,0,0,0,0,293,209,0,0,209,84,84,84,0,0,0,0,0,0,98070
32332,15758,480,2298,4676,5398,2906,1176,578,572,118,37,417,6,0,0,0,0,6,0,0,6,598,565,120,60,385,33,33,25,0,8,0,0,0,0,98072
32333,16583,347,856,3421,7145,4814,1620,981,963,145,35,783,18,6,6,0,0,12,12,0,0,639,639,168,0,471,0,0,0,0,0,0,0,0,0,98074
32334,12918,176,1036,2559,5619,3528,1333,712,706,146,58,502,6,6,6,0,0,0,0,0,0,621,621,181,12,428,0,0,0,0,0,0,0,0,0,98075
32335,9771,226,979,2957,3447,2162,834,430,415,116,47,252,15,15,15,0,0,0,0,0,0,404,349,110,0,239,55,42,27,0,15,13,0,0,13,98077
32336,20030,1849,4454,8182,4248,1297,1260,530,459,87,22,350,71,37,25,12,0,34,9,9,16,730,660,147,78,435,70,50,29,0,21,20,20,0,0,98087
32337,25772,2183,5841,9924,5380,2444,2745,1536,1328,219,106,1003,208,178,76,62,40,30,18,0,12,1209,1064,294,80,690,145,135,81,54,0,10,0,3,7,98092
32338,9492,547,1274,2616,2808,2247,66,43,23,0,0,23,20,20,20,0,0,0,0,0,0,23,0,0,0,0,23,23,7,0,16,0,0,0,0,98101
32339,18531,282,942,4165,7931,5211,285,148,133,16,34,83,15,15,0,0,15,0,0,0,0,137,120,40,0,80,17,0,0,0,0,17,0,0,17,98102
32340,36397,1070,2413,7077,15476,10361,815,412,377,94,0,283,35,35,9,26,0,0,0,0,0,403,337,36,11,290,66,66,66,0,0,0,0,0,0,98103
32341,10407,2377,1671,2735,2490,1134,336,229,146,38,24,84,83,57,18,0,39,26,0,0,26,107,94,9,13,72,13,13,0,0,13,0,0,0,0,98104
32342,19801,533,1338,3480,7494,6956,7569,3413,3197,727,207,2263,216,196,165,23,8,20,20,0,0,4156,4077,1265,318,2494,79,77,77,0,0,2,0,0,2,98105
32343,16773,2528,3179,5779,4056,1231,1212,587,518,137,38,343,69,34,34,0,0,35,0,35,0,625,548,173,47,328,77,59,0,39,20,18,11,0,7,98106
32344,18550,589,1667,4444,7566,4284,334,137,122,16,33,73,15,0,0,0,0,15,0,0,15,197,180,29,36,115,17,17,0,0,17,0,0,0,0,98107
32345,16244,3876,3227,4504,3361,1276,745,374,339,88,23,228,35,20,0,0,20,15,4,0,11,371,344,125,0,219,27,15,15,0,0,12,0,12,0,98108
32346,18085,344,1185,4332,7818,4406,373,167,113,18,20,75,54,54,0,0,54,0,0,0,0,206,206,66,5,135,0,0,0,0,0,0,0,0,0,98109
32347,17084,283,1688,3871,6113,5129,1363,799,769,87,41,641,30,23,13,0,10,7,0,0,7,564,548,117,22,409,16,0,0,0,0,16,8,0,8,98110
32348,16518,266,960,2760,6183,6349,615,267,223,14,5,204,44,44,0,0,44,0,0,0,0,348,348,53,42,253,0,0,0,0,0,0,0,0,0,98112
32349,35288,413,2899,6863,13099,12014,1349,639,594,119,26,449,45,22,0,14,8,23,0,23,0,710,658,171,27,460,52,40,40,0,0,12,12,0,0,98115
32350,18191,480,2153,5019,6763,3776,766,431,383,76,37,270,48,48,48,0,0,0,0,0,0,335,299,69,0,230,36,16,16,0,0,20,0,0,20,98116
32351,23018,646,2550,5075,8779,5968,689,377,347,93,34,220,30,14,0,14,0,16,0,0,16,312,232,45,3,184,80,80,80,0,0,0,0,0,0,98117
32352,29479,6139,5824,7369,6074,4073,2024,881,743,135,82,526,138,99,45,54,0,39,30,0,9,1143,994,99,130,765,149,24,16,0,8,125,14,17,94,98118
32353,15524,334,1285,3210,6009,4686,1531,655,635,155,56,424,20,19,14,5,0,1,0,0,1,876,871,415,42,414,5,5,5,0,0,0,0,0,0,98119
32354,9977,369,776,2591,3447,2794,537,268,268,38,26,204,0,0,0,0,0,0,0,0,0,269,246,38,88,120,23,23,23,0,0,0,0,0,0,98121
32355,23661,1504,2361,5746,8238,5812,1832,621,558,97,70,391,63,44,0,0,44,19,0,0,19,1211,1143,330,175,638,68,64,0,0,64,4,0,0,4,98122
32356,27616,2229,4269,7369,8201,5548,1120,415,415,51,43,321,0,0,0,0,0,0,0,0,0,705,640,298,29,313,65,18,0,0,18,47,0,0,47,98125
32357,15700,1260,2386,4384,5106,2564,687,312,294,36,11,247,18,18,10,8,0,0,0,0,0,375,339,55,51,233,36,3,3,0,0,33,0,0,33,98126
32358,34160,2972,6674,10995,9165,4354,1988,1072,854,104,58,692,218,218,78,94,46,0,0,0,0,916,745,222,56,467,171,152,83,2,67,19,0,0,19,98133
32359,681,174,147,149,71,140,13,10,0,0,0,0,10,10,10,0,0,0,0,0,0,3,0,0,0,0,3,3,3,0,0,0,0,0,0,98134
32360,11798,277,1383,3401,4311,2426,409,146,97,10,0,87,49,8,8,0,0,41,15,0,26,263,229,0,27,202,34,34,34,0,0,0,0,0,0,98136
32361,19940,2750,3162,4297,5889,3842,821,463,367,62,77,228,96,85,0,85,0,11,11,0,0,358,278,30,7,241,80,58,50,0,8,22,0,0,22,98144
32362,17442,2959,4336,5592,2965,1590,1280,642,535,126,19,390,107,68,12,43,13,39,0,0,39,638,591,108,46,437,47,24,7,0,17,23,0,13,10,98146
32363,6806,1299,1852,2418,926,311,665,323,313,16,56,241,10,0,0,0,0,10,0,0,10,342,275,57,12,206,67,55,19,23,13,12,0,0,12,98148
32364,0,0,0,0,0,0,0,0,0,0,0,0,0,0,0,0,0,0,0,0,0,0,0,0,0,0,0,0,0,0,0,0,0,0,0,98154
32365,23949,1854,3638,7989,6535,3933,1165,546,504,74,48,382,42,25,25,0,0,17,0,17,0,619,573,136,44,393,46,22,22,0,0,24,17,0,7,98155
32366,0,0,0,0,0,0,0,0,0,0,0,0,0,0,0,0,0,0,0,0,0,0,0,0,0,0,0,0,0,0,0,0,0,0,0,98158
32367,57,0,0,0,0,57,0,0,0,0,0,0,0,0,0,0,0,0,0,0,0,0,0,0,0,0,0,0,0,0,0,0,0,0,0,98164
32368,14623,1301,2911,4738,3586,2087,668,269,217,21,0,196,52,27,6,13,8,25,0,0,25,399,375,174,0,201,24,18,18,0,0,6,6,0,0,98166
32369,22097,4083,7473,6720,2668,1153,1599,940,743,131,59,553,197,181,145,0,36,16,0,0,16,659,608,97,25,486,51,15,15,0,0,36,0,8,28,98168
32370,51,18,19,14,0,0,0,0,0,0,0,0,0,0,0,0,0,0,0,0,0,0,0,0,0,0,0,0,0,0,0,0,0,0,0,98174
32371,13783,578,1504,3275,4933,3493,1039,460,441,55,25,361,19,0,0,0,0,19,0,0,19,579,539,103,11,425,40,40,40,0,0,0,0,0,0,98177
32372,17324,2794,4273,5590,3334,1333,714,291,228,25,18,185,63,56,18,0,38,7,0,0,7,423,352,122,18,212,71,51,42,9,0,20,0,0,20,98178
32373,15698,2141,5318,5084,2302,853,1159,508,354,33,17,304,154,145,49,7,89,9,0,0,9,651,445,84,45,316,206,176,30,0,146,30,0,0,30,98188
32374,29,17,9,0,3,0,0,0,0,0,0,0,0,0,0,0,0,0,0,0,0,0,0,0,0,0,0,0,0,0,0,0,0,0,0,98195
32375,24200,4043,6322,8493,3773,1569,1565,896,743,203,78,462,153,100,77,0,23,53,49,0,4,669,582,111,39,432,87,76,71,0,5,11,0,11,0,98198
32376,15469,353,1039,3602,6447,4028,431,189,175,0,0,175,14,0,0,0,0,14,0,0,14,242,227,10,0,217,15,15,0,0,15,0,0,0,0,98199
32377,20071,3033,4719,7873,3234,1212,1440,620,451,69,69,313,169,57,57,0,0,112,38,28,46,820,715,200,70,445,105,66,17,37,12,39,13,4,22,98201
32378,24151,2899,6232,9796,3677,1547,1584,987,928,149,196,583,59,59,22,11,26,0,0,0,0,597,402,157,40,205,195,173,92,9,72,22,19,0,3,98203
32379,25084,3826,7622,9244,3391,1001,1691,959,599,47,78,474,360,218,127,53,38,142,26,82,34,732,424,87,68,269,308,276,101,34,141,32,0,0,32,98204
32380,7981,893,2351,3057,1239,441,697,406,317,75,47,195,89,27,0,0,27,62,12,0,50,291,241,59,0,182,50,50,44,6,0,0,0,0,0,98205
32381,309,0,107,143,38,21,155,138,0,0,0,0,138,138,138,0,0,0,0,0,0,17,2,2,0,0,15,15,15,0,0,0,0,0,0,98207
32382,34342,3093,7915,13406,7156,2772,2563,1182,1068,328,89,651,114,93,53,6,34,21,0,0,21,1381,1065,200,135,730,316,315,171,10,134,1,0,0,1,98208
32383,524,16,149,257,102,0,29,29,29,0,0,29,0,0,0,0,0,0,0,0,0,0,0,0,0,0,0,0,0,0,0,0,0,0,0,98220
32384,15435,861,3358,5576,3394,2246,835,410,330,93,26,211,80,51,26,8,17,29,4,3,22,425,354,94,26,234,71,60,33,7,20,11,2,0,9,98221
32385,39,0,2,3,21,13,2,2,2,0,0,2,0,0,0,0,0,0,0,0,0,0,0,0,0,0,0,0,0,0,0,0,0,0,0,98222
32386,28157,2518,9458,11463,3614,1104,2119,1222,914,175,93,646,308,200,82,67,51,108,11,0,97,897,746,184,49,513,151,99,61,31,7,52,8,0,44,98223
32387,254,10,97,113,22,12,0,0,0,0,0,0,0,0,0,0,0,0,0,0,0,0,0,0,0,0,0,0,0,0,0,0,0,0,0,98224
32388,25407,1471,4496,8688,6965,3787,4647,1779,1614,430,194,990,165,104,71,22,11,61,61,0,0,2868,2600,915,306,1379,268,162,81,15,66,106,61,33,12,98225
32389,28194,2599,6565,10628,5611,2791,1971,1096,909,213,48,648,187,68,36,16,16,119,9,68,42,875,762,255,40,467,113,67,18,0,49,46,16,0,30,98226
32390,21518,1205,2958,8074,5812,3469,1762,920,739,233,78,428,181,0,0,0,0,181,116,22,43,842,730,201,28,501,112,75,36,28,11,37,0,25,12,98229
32391,10904,1097,2653,3983,1997,1174,627,303,245,58,0,187,58,58,0,43,15,0,0,0,0,324,273,41,0,232,51,38,7,31,0,13,0,0,13,98230
32392,2858,88,862,1045,550,313,184,78,57,0,0,57,21,21,21,0,0,0,0,0,0,106,83,29,0,54,23,0,0,0,0,23,23,0,0,98232
32393,9399,1434,2580,3679,1069,637,1035,644,543,175,65,303,101,17,17,0,0,84,66,0,18,391,248,73,18,157,143,74,18,0,56,69,53,0,16,98233
32394,17,0,17,0,0,0,0,0,0,0,0,0,0,0,0,0,0,0,0,0,0,0,0,0,0,0,0,0,0,0,0,0,0,0,0,98235
32395,4569,213,707,1641,1178,830,196,75,75,17,6,52,0,0,0,0,0,0,0,0,0,121,112,85,0,27,9,0,0,0,0,9,0,0,9,98236
32396,2814,409,842,1146,310,107,179,134,91,0,0,91,43,20,0,2,18,23,0,23,0,45,45,0,27,18,0,0,0,0,0,0,0,0,0,98237
32397,21,0,0,9,6,6,10,0,0,0,0,0,0,0,0,0,0,0,0,0,0,10,10,0,0,10,0,0,0,0,0,0,0,0,0,98238
32398,5456,304,1181,1856,1108,1007,258,183,157,72,14,71,26,26,0,26,0,0,0,0,0,75,51,0,6,45,24,24,5,19,0,0,0,0,0,98239
32399,2424,220,851,961,331,61,225,111,72,13,10,49,39,13,13,0,0,26,0,26,0,114,114,43,0,71,0,0,0,0,0,0,0,0,0,98240
32400,1519,199,465,655,116,84,122,55,43,33,0,10,12,0,0,0,0,12,0,0,12,67,53,13,4,36,14,13,0,10,3,1,1,0,0,98241
32401,313,10,40,101,111,51,0,0,0,0,0,0,0,0,0,0,0,0,0,0,0,0,0,0,0,0,0,0,0,0,0,0,0,0,0,98243
32402,1979,114,616,782,286,181,135,36,34,31,0,3,2,2,2,0,0,0,0,0,0,99,42,0,0,42,57,55,5,0,50,2,0,2,0,98244
32403,2816,182,531,875,723,505,90,50,43,5,0,38,7,7,7,0,0,0,0,0,0,40,37,11,7,19,3,3,0,0,3,0,0,0,0,98245
32404,5838,1019,1824,1914,809,272,781,466,364,72,69,223,102,75,24,48,3,27,0,27,0,315,248,73,0,175,67,51,51,0,0,16,0,13,3,98247
32405,14850,1718,3455,6119,2647,911,1307,714,556,73,49,434,158,98,72,6,20,60,0,17,43,593,485,168,110,207,108,108,92,16,0,0,0,0,0,98248
32406,3678,142,828,1301,869,538,186,62,62,12,9,41,0,0,0,0,0,0,0,0,0,124,124,6,8,110,0,0,0,0,0,0,0,0,0,98249
32407,6230,361,1194,2115,1376,1184,429,190,156,30,17,109,34,12,3,0,9,22,0,6,16,239,212,58,41,113,27,27,15,0,12,0,0,0,0,98250
32408,3223,347,857,1474,445,100,294,174,134,16,11,107,40,3,0,0,3,37,14,10,13,120,86,24,19,43,34,20,14,6,0,14,8,0,6,98251
32409,5845,796,1949,2171,749,180,576,306,252,34,0,218,54,30,9,8,13,24,24,0,0,270,243,82,21,140,27,19,19,0,0,8,0,0,8,98252
32410,1549,32,339,429,343,406,63,47,47,0,0,47,0,0,0,0,0,0,0,0,0,16,16,16,0,0,0,0,0,0,0,0,0,0,0,98253
32411,226,94,38,75,11,8,1,0,0,0,0,0,0,0,0,0,0,0,0,0,0,1,0,0,0,0,1,1,0,1,0,0,0,0,0,98255
32412,366,15,101,166,64,20,11,5,5,0,0,5,0,0,0,0,0,0,0,0,0,6,6,0,0,6,0,0,0,0,0,0,0,0,0,98256
32413,3143,243,619,1273,605,403,189,73,66,11,8,47,7,0,0,0,0,7,0,7,0,116,95,18,0,77,21,9,4,0,5,12,0,0,12,98257
32414,19947,1494,5495,8532,3389,1037,2249,1221,955,246,106,603,266,154,108,0,46,112,26,86,0,1028,849,316,99,434,179,158,105,23,30,21,21,0,0,98258
32415,4219,120,687,1289,1257,866,120,68,63,15,13,35,5,0,0,0,0,5,0,0,5,52,48,21,0,27,4,4,0,4,0,0,0,0,0,98260
32416,2037,87,289,626,550,485,54,31,31,12,4,15,0,0,0,0,0,0,0,0,0,23,23,9,0,14,0,0,0,0,0,0,0,0,0,98261
32417,936,87,213,223,283,130,18,8,8,0,0,8,0,0,0,0,0,0,0,0,0,10,10,0,0,10,0,0,0,0,0,0,0,0,0,98262
32418,58,1,26,30,1,0,2,2,2,0,0,2,0,0,0,0,0,0,0,0,0,0,0,0,0,0,0,0,0,0,0,0,0,0,0,98263
32419,11993,1344,3526,4256,2030,837,983,565,378,218,34,126,187,90,90,0,0,97,68,28,1,418,388,210,4,174,30,30,25,0,5,0,0,0,0,98264
32420,2886,677,1011,938,203,57,263,98,98,0,0,98,0,0,0,0,0,0,0,0,0,165,148,0,0,148,17,17,0,17,0,0,0,0,0,98266
32421,374,98,135,47,60,34,23,0,0,0,0,0,0,0,0,0,0,0,0,0,0,23,7,0,7,0,16,0,0,0,0,16,16,0,0,98267
32422,29459,3288,8573,12186,3927,1485,2534,1386,1051,193,90,768,335,276,113,146,17,59,43,0,16,1148,979,472,109,398,169,61,49,0,12,108,37,33,38,98270
32423,18058,1987,5347,7772,2212,740,1415,575,485,73,39,373,90,65,48,8,9,25,5,10,10,840,692,231,29,432,148,112,93,0,19,36,9,5,22,98271
32424,18655,2262,5023,7139,2900,1331,1888,1263,1083,221,100,762,180,122,58,16,48,58,12,9,37,625,556,201,37,318,69,69,49,20,0,0,0,0,0,98272
32425,18015,3470,4707,6322,2290,1226,1789,844,561,131,0,430,283,194,110,14,70,89,48,0,41,945,822,216,61,545,123,57,49,0,8,66,34,0,32,98273
32426,11755,1122,2515,5063,1978,1077,837,408,333,42,24,267,75,75,60,0,15,0,0,0,0,429,371,141,78,152,58,31,11,7,13,27,8,0,19,98274
32427,14023,352,2389,4623,4395,2264,1607,983,831,72,55,704,152,137,124,13,0,15,0,15,0,624,567,145,16,406,57,57,49,0,8,0,0,0,0,98275
32428,320,5,132,131,40,12,37,20,20,18,0,2,0,0,0,0,0,0,0,0,0,17,17,8,0,9,0,0,0,0,0,0,0,0,0,98276
32429,24417,1526,6313,10261,4411,1906,1431,821,663,263,59,341,158,130,62,12,56,28,0,0,28,610,493,88,64,341,117,111,62,20,29,6,0,0,6,98277
32430,303,0,30,178,85,10,228,143,9,9,0,0,134,134,134,0,0,0,0,0,0,85,0,0,0,0,85,85,85,0,0,0,0,0,0,98278
32431,516,14,44,147,190,121,23,8,8,5,0,3,0,0,0,0,0,0,0,0,0,15,15,0,6,9,0,0,0,0,0,0,0,0,0,98279
32432,334,9,22,94,114,95,0,0,0,0,0,0,0,0,0,0,0,0,0,0,0,0,0,0,0,0,0,0,0,0,0,0,0,0,0,98280
32433,950,106,261,278,197,108,65,36,36,6,0,30,0,0,0,0,0,0,0,0,0,29,29,5,0,24,0,0,0,0,0,0,0,0,0,98281
32434,11635,654,3228,4857,1908,988,715,382,362,129,38,195,20,20,11,9,0,0,0,0,0,333,301,17,42,242,32,22,8,8,6,10,0,0,10,98282
32435,436,0,120,139,128,49,5,5,0,0,0,0,5,0,0,0,0,5,0,0,5,0,0,0,0,0,0,0,0,0,0,0,0,0,0,98283
32436,16876,1735,5043,7087,1867,1144,1099,568,439,86,13,340,129,52,16,16,20,77,0,43,34,531,407,90,33,284,124,89,32,33,24,35,16,12,7,98284
32437,193,25,23,62,37,46,9,8,8,0,0,8,0,0,0,0,0,0,0,0,0,1,1,0,0,1,0,0,0,0,0,0,0,0,0,98286
32438,164,25,39,69,24,7,0,0,0,0,0,0,0,0,0,0,0,0,0,0,0,0,0,0,0,0,0,0,0,0,0,0,0,0,0,98288
32439,22820,1787,5818,8925,4337,1953,1703,861,685,256,71,358,176,75,34,25,16,101,9,0,92,842,740,201,89,450,102,83,66,10,7,19,0,0,19,98290
32440,14596,1410,3855,5727,2400,1204,1199,554,486,119,25,342,68,0,0,0,0,68,37,15,16,645,556,169,53,334,89,89,56,10,23,0,0,0,0,98292
32441,4344,545,1484,1649,494,172,378,262,200,37,50,113,62,62,12,50,0,0,0,0,0,116,108,13,27,68,8,2,2,0,0,6,0,0,6,98294
32442,1483,189,533,480,195,86,57,18,18,15,0,3,0,0,0,0,0,0,0,0,0,39,33,3,20,10,6,6,3,3,0,0,0,0,0,98295
32443,18570,751,3714,6791,5288,2026,2186,1073,965,182,67,716,108,57,25,15,17,51,0,0,51,1113,1113,408,115,590,0,0,0,0,0,0,0,0,0,98296
32444,80,0,5,23,34,18,3,0,0,0,0,0,0,0,0,0,0,0,0,0,0,3,3,0,0,3,0,0,0,0,0,0,0,0,0,98297
32445,795,35,137,338,144,141,13,13,13,0,0,13,0,0,0,0,0,0,0,0,0,0,0,0,0,0,0,0,0,0,0,0,0,0,0,98303
32446,622,89,239,211,38,45,0,0,0,0,0,0,0,0,0,0,0,0,0,0,0,0,0,0,0,0,0,0,0,0,0,0,0,0,0,98304
32447,248,32,113,77,17,9,5,0,0,0,0,0,0,0,0,0,0,0,0,0,0,5,5,5,0,0,0,0,0,0,0,0,0,0,0,98305
32448,13203,1124,3776,5811,1776,716,768,403,308,67,41,200,95,57,31,26,0,38,5,0,33,365,250,82,21,147,115,83,34,10,39,32,0,0,32,98310
32449,17714,1083,4340,8148,2896,1247,1584,754,659,218,82,359,95,94,30,54,10,1,0,1,0,830,659,158,126,375,171,159,119,21,19,12,0,0,12,98311
32450,20744,1639,5215,9179,3387,1324,1470,803,522,55,81,386,281,252,164,38,50,29,9,0,20,667,468,97,26,345,199,153,70,40,43,46,18,28,0,98312
32451,665,0,99,374,129,63,106,90,7,0,0,7,83,83,83,0,0,0,0,0,0,16,0,0,0,0,16,16,16,0,0,0,0,0,0,98314
32452,2011,72,423,1040,381,95,375,305,49,26,0,23,256,250,250,0,0,6,0,0,6,70,24,0,5,19,46,17,17,0,0,29,0,0,29,98315
32453,1047,110,335,448,91,63,41,25,15,0,0,15,10,0,0,0,0,10,0,0,10,16,16,0,0,16,0,0,0,0,0,0,0,0,0,98320
32454,9430,1213,3096,3636,1112,373,717,413,314,49,47,218,99,64,22,30,12,35,0,27,8,304,249,96,63,90,55,55,44,0,11,0,0,0,0,98321
32455,440,56,184,178,22,0,42,12,12,3,3,6,0,0,0,0,0,0,0,0,0,30,11,0,2,9,19,19,16,0,3,0,0,0,0,98323
32456,1432,62,415,636,253,66,110,59,57,0,0,57,2,0,0,0,0,2,0,0,2,51,43,26,16,1,8,0,0,0,0,8,8,0,0,98325
32457,641,126,175,273,67,0,22,22,22,0,0,22,0,0,0,0,0,0,0,0,0,0,0,0,0,0,0,0,0,0,0,0,0,0,0,98326
32458,5336,161,492,2000,1714,969,350,216,187,24,12,151,29,29,12,0,17,0,0,0,0,134,101,39,0,62,33,33,33,0,0,0,0,0,0,98327
32459,6562,735,2429,2257,753,388,421,215,137,13,6,118,78,10,10,0,0,68,0,0,68,206,193,108,0,85,13,13,13,0,0,0,0,0,0,98328
32460,7294,419,1810,3090,1257,718,432,225,177,29,0,148,48,48,30,18,0,0,0,0,0,207,192,18,8,166,15,5,5,0,0,10,0,10,0,98329
32461,155,0,121,34,0,0,0,0,0,0,0,0,0,0,0,0,0,0,0,0,0,0,0,0,0,0,0,0,0,0,0,0,0,0,0,98330
32462,4352,550,1416,1817,369,200,372,159,144,29,0,115,15,11,9,0,2,4,4,0,0,213,154,29,0,125,59,52,27,25,0,7,0,0,7,98331
32463,11546,630,2376,3612,2898,2030,705,399,384,82,27,275,15,15,15,0,0,0,0,0,0,306,242,71,4,167,64,32,25,0,7,32,0,0,32,98332
32464,2528,42,351,818,806,511,327,201,201,17,28,156,0,0,0,0,0,0,0,0,0,126,126,49,0,77,0,0,0,0,0,0,0,0,0,98333
32465,18046,661,2989,5690,5281,3425,1195,630,478,123,26,329,152,139,121,0,18,13,0,0,13,565,453,124,33,296,112,112,93,10,9,0,0,0,0,98335
32466,628,203,267,114,29,15,0,0,0,0,0,0,0,0,0,0,0,0,0,0,0,0,0,0,0,0,0,0,0,0,0,0,0,0,0,98336
32467,4101,243,1009,1935,585,329,518,293,112,0,12,100,181,131,106,7,18,50,10,11,29,225,149,32,6,111,76,35,27,8,0,41,0,33,8,98337
32468,16379,1243,5874,6345,1919,998,1141,566,444,36,76,332,122,78,36,40,2,44,15,21,8,575,523,136,37,350,52,52,16,28,8,0,0,0,0,98338
32469,2160,211,688,975,184,102,160,72,43,10,0,33,29,29,21,8,0,0,0,0,0,88,36,20,0,16,52,52,52,0,0,0,0,0,0,98339
32470,2277,142,399,888,541,307,26,9,9,0,0,9,0,0,0,0,0,0,0,0,0,17,17,17,0,0,0,0,0,0,0,0,0,0,0,98340
32471,970,11,135,336,304,184,52,19,19,0,0,19,0,0,0,0,0,0,0,0,0,33,27,14,2,11,6,6,6,0,0,0,0,0,0,98342
32472,412,0,37,208,117,50,8,8,0,0,0,0,8,8,8,0,0,0,0,0,0,0,0,0,0,0,0,0,0,0,0,0,0,0,0,98345
32473,6832,452,1700,2553,1538,589,563,212,191,13,2,176,21,20,11,2,7,1,0,0,1,351,237,40,72,125,114,61,59,2,0,53,0,0,53,98346
32474,3009,198,825,1323,394,269,258,117,117,0,70,47,0,0,0,0,0,0,0,0,0,141,82,15,0,67,59,59,0,0,59,0,0,0,0,98349
32475,224,56,69,96,1,2,31,19,18,0,0,18,1,0,0,0,0,1,1,0,0,12,11,9,0,2,1,1,0,1,0,0,0,0,0,98350
32476,996,166,310,294,139,87,77,66,66,0,0,66,0,0,0,0,0,0,0,0,0,11,11,0,0,11,0,0,0,0,0,0,0,0,0,98351
32477,0,0,0,0,0,0,0,0,0,0,0,0,0,0,0,0,0,0,0,0,0,0,0,0,0,0,0,0,0,0,0,0,0,0,0,98353
32478,4622,264,1517,1917,593,331,448,88,83,39,0,44,5,5,5,0,0,0,0,0,0,360,360,111,39,210,0,0,0,0,0,0,0,0,0,98354
32479,455,46,245,119,28,17,6,6,6,0,0,6,0,0,0,0,0,0,0,0,0,0,0,0,0,0,0,0,0,0,0,0,0,0,0,98355
32480,1436,271,614,357,73,121,32,15,5,0,0,5,10,0,0,0,0,10,0,0,10,17,13,2,2,9,4,0,0,0,0,4,0,4,0,98356
32481,879,139,284,322,111,23,63,27,13,6,0,7,14,14,7,0,7,0,0,0,0,36,33,10,9,14,3,3,0,3,0,0,0,0,0,98357
32482,941,51,155,299,277,159,40,23,23,0,0,23,0,0,0,0,0,0,0,0,0,17,17,17,0,0,0,0,0,0,0,0,0,0,0,98358
32483,3538,189,986,1743,499,121,244,91,78,0,29,49,13,5,5,0,0,8,0,0,8,153,153,11,0,142,0,0,0,0,0,0,0,0,0,98359
32484,7776,644,2883,3029,726,494,413,257,202,40,29,133,55,27,13,0,14,28,0,28,0,156,139,39,20,80,17,11,11,0,0,6,0,0,6,98360
32485,902,147,286,275,122,72,43,14,14,14,0,0,0,0,0,0,0,0,0,0,0,29,29,29,0,0,0,0,0,0,0,0,0,0,0,98361
32486,16492,1313,4595,6948,2129,1507,1121,543,514,93,78,343,29,16,10,0,6,13,9,0,4,578,510,111,24,375,68,52,12,0,40,16,5,0,11,98362
32487,9831,946,2870,4021,1125,869,599,333,279,39,49,191,54,35,17,1,17,19,0,17,2,266,227,75,0,152,39,33,0,32,1,6,0,2,4,98363
32488,67,0,0,0,67,0,0,0,0,0,0,0,0,0,0,0,0,0,0,0,0,0,0,0,0,0,0,0,0,0,0,0,0,0,0,98364
32489,3730,169,684,1268,889,720,80,39,23,0,0,23,16,14,14,0,0,2,0,0,2,41,41,7,15,19,0,0,0,0,0,0,0,0,0,98365
32490,22445,2029,6330,9129,3359,1598,1821,1153,928,193,138,597,225,182,86,70,26,43,0,0,43,668,551,110,140,301,117,117,53,41,23,0,0,0,0,98366
32491,19344,1383,5425,8126,2993,1417,1821,958,766,140,52,574,192,147,24,53,70,45,17,0,28,863,691,156,173,362,172,172,120,24,28,0,0,0,0,98367
32492,11868,489,2201,3887,3217,2074,436,247,224,5,28,191,23,23,23,0,0,0,0,0,0,189,174,86,13,75,15,15,15,0,0,0,0,0,0,98368
32493,20162,1083,4424,7839,4167,2649,1282,551,477,61,51,365,74,61,50,0,11,13,0,0,13,731,642,212,32,398,89,44,42,0,2,45,0,43,2,98370
32494,14281,1069,4543,5101,2258,1310,967,478,425,79,7,339,53,50,37,13,0,3,0,0,3,489,442,152,58,232,47,47,47,0,0,0,0,0,0,98371
32495,15518,1441,5068,5497,2320,1192,1619,761,678,145,0,533,83,0,0,0,0,83,58,0,25,858,774,252,17,505,84,84,55,29,0,0,0,0,0,98372
32496,14438,790,4173,6228,2277,970,1539,657,518,110,123,285,139,83,32,45,6,56,39,0,17,882,675,161,98,416,207,130,46,0,84,77,44,0,33,98373
32497,23970,1443,6635,9913,3650,2329,2133,1197,995,193,100,702,202,144,84,11,49,58,41,0,17,936,758,257,97,404,178,105,65,0,40,73,10,7,56,98374
32498,17148,1828,5228,6271,2698,1123,1813,985,925,105,83,737,60,38,9,10,19,22,0,0,22,828,754,146,250,358,74,67,11,24,32,7,0,0,7,98375
32499,1597,60,443,606,270,218,78,51,51,0,0,51,0,0,0,0,0,0,0,0,0,27,18,0,6,12,9,9,0,0,9,0,0,0,0,98376
32500,1430,284,471,517,64,94,104,59,59,0,30,29,0,0,0,0,0,0,0,0,0,45,45,6,0,39,0,0,0,0,0,0,0,0,0,98377
32501,3565,266,890,1460,483,466,152,59,59,0,0,59,0,0,0,0,0,0,0,0,0,93,93,34,0,59,0,0,0,0,0,0,0,0,0,98380
32502,445,59,121,141,46,78,81,69,29,3,0,26,40,40,0,40,0,0,0,0,0,12,12,0,0,12,0,0,0,0,0,0,0,0,0,98381
32503,21661,1594,5350,8150,3988,2579,1066,534,450,89,0,361,84,69,59,10,0,15,13,0,2,532,461,105,21,335,71,32,20,12,0,39,11,0,28,98382
32504,13445,719,2744,5900,2616,1466,1344,543,388,41,56,291,155,112,52,22,38,43,0,21,22,801,736,193,126,417,65,65,46,12,7,0,0,0,0,98383
32505,338,23,148,116,27,24,38,6,6,0,6,0,0,0,0,0,0,0,0,0,0,32,20,10,0,10,12,12,0,3,9,0,0,0,0,98385
32506,27520,3124,9427,11081,2897,991,2823,1514,1296,165,135,996,218,182,92,36,54,36,8,0,28,1309,1027,203,155,669,282,213,114,81,18,69,28,11,30,98387
32507,5165,375,1344,1947,842,657,296,119,114,43,15,56,5,0,0,0,0,5,0,0,5,177,159,0,18,141,18,18,5,0,13,0,0,0,0,98388
32508,6654,571,2333,2560,884,306,450,290,203,37,80,86,87,87,35,6,46,0,0,0,0,160,137,39,8,90,23,12,12,0,0,11,0,0,11,98390
32509,29036,2122,8941,11274,4400,2299,2734,1443,1183,234,112,837,260,163,86,19,58,97,41,43,13,1291,1151,384,84,683,140,81,37,8,36,59,0,0,59,98391
32510,2101,135,490,869,372,235,151,71,57,11,4,42,14,9,9,0,0,5,3,2,0,80,63,6,5,52,17,17,13,0,4,0,0,0,0,98392
32511,1014,127,205,388,198,96,83,48,48,0,11,37,0,0,0,0,0,0,0,0,0,35,18,0,0,18,17,17,0,0,17,0,0,0,0,98394
32512,373,18,153,145,44,13,24,15,13,2,0,11,2,2,2,0,0,0,0,0,0,9,9,5,0,4,0,0,0,0,0,0,0,0,0,98396
32513,5144,847,1026,1973,769,529,349,108,22,0,0,22,86,44,24,0,20,42,0,0,42,241,156,39,66,51,85,53,0,24,29,32,9,0,23,98402
32514,5620,189,1154,1495,1499,1283,153,111,111,0,0,111,0,0,0,0,0,0,0,0,0,42,42,14,0,28,0,0,0,0,0,0,0,0,0,98403
32515,19334,4226,6344,6553,1677,534,1744,801,641,44,115,482,160,25,0,0,25,135,16,21,98,943,754,188,76,490,189,98,40,20,38,91,21,0,70,98404
32516,15410,2047,4479,5535,2095,1254,1149,618,382,73,48,261,236,116,80,36,0,120,8,77,35,531,433,79,32,322,98,84,16,37,31,14,0,0,14,98405
32517,15285,866,3631,4928,3560,2300,1180,640,593,91,61,441,47,47,33,0,14,0,0,0,0,540,501,140,124,237,39,27,27,0,0,12,0,0,12,98406
32518,14889,658,3052,5020,3458,2701,924,403,313,87,39,187,90,76,64,0,12,14,0,0,14,521,435,233,33,169,86,42,42,0,0,44,0,8,36,98407
32519,13486,1836,4962,4674,1466,548,909,425,412,0,0,412,13,13,13,0,0,0,0,0,0,484,261,44,58,159,223,203,138,20,45,20,11,0,9,98408
32520,14711,2207,4473,5778,1569,684,1267,566,443,75,59,309,123,81,81,0,0,42,0,0,42,701,612,58,118,436,89,6,6,0,0,83,19,0,64,98409
32521,10,0,0,10,0,0,870,401,401,36,113,252,0,0,0,0,0,0,0,0,0,469,469,242,13,214,0,0,0,0,0,0,0,0,0,98416
32522,6494,915,2357,2202,731,289,685,317,282,58,41,183,35,7,0,0,7,28,11,0,17,368,321,94,0,227,47,47,20,0,27,0,0,0,0,98418
32523,1,0,0,1,0,0,0,0,0,0,0,0,0,0,0,0,0,0,0,0,0,0,0,0,0,0,0,0,0,0,0,0,0,0,0,98421
32524,14036,915,3162,4798,3340,1821,1185,692,582,126,79,377,110,59,30,10,19,51,7,17,27,493,456,106,67,283,37,28,21,4,3,9,0,9,0,98422
32525,6562,636,2198,2370,943,415,563,272,232,49,13,170,40,28,6,0,22,12,3,0,9,291,201,24,14,163,90,41,24,17,0,49,31,0,18,98424
32526,10,0,0,0,5,5,0,0,0,0,0,0,0,0,0,0,0,0,0,0,0,0,0,0,0,0,0,0,0,0,0,0,0,0,0,98430
32527,6401,183,1351,3790,802,275,907,555,150,33,12,105,405,387,387,0,0,18,0,18,0,352,176,69,0,107,176,155,95,0,60,21,0,12,9,98433
32528,60,0,0,38,22,0,47,31,0,0,0,0,31,31,31,0,0,0,0,0,0,16,8,8,0,0,8,8,8,0,0,0,0,0,0,98438
32529,2891,307,837,1468,227,52,231,133,53,4,0,49,80,37,37,0,0,43,0,6,37,98,49,7,9,33,49,49,0,39,10,0,0,0,0,98439
32530,3938,243,1397,1579,575,144,252,111,104,11,9,84,7,7,0,0,7,0,0,0,0,141,123,62,0,61,18,18,18,0,0,0,0,0,0,98443
32531,20538,3931,7330,6869,1801,607,2438,1301,1050,105,71,874,251,136,42,79,15,115,48,55,12,1137,943,230,148,565,194,101,63,5,33,93,69,5,19,98444
32532,19666,2377,6965,7649,1923,752,1723,1023,962,114,77,771,61,61,34,27,0,0,0,0,0,700,589,75,98,416,111,90,4,43,43,21,0,21,0,98445
32533,6988,396,2312,3163,712,405,401,272,217,49,0,168,55,41,5,0,36,14,0,0,14,129,95,15,23,57,34,34,0,21,13,0,0,0,0,98446
32534,10,0,0,10,0,0,479,231,231,44,27,160,0,0,0,0,0,0,0,0,0,248,248,167,21,60,0,0,0,0,0,0,0,0,0,98447
32535,4638,532,1233,1650,717,506,230,120,90,10,43,37,30,0,0,0,0,30,0,0,30,110,110,5,13,92,0,0,0,0,0,0,0,0,0,98465
32536,17914,1105,4104,6876,3765,2064,1559,651,452,68,26,358,199,139,65,55,19,60,0,0,60,908,694,112,60,522,214,198,111,25,62,16,0,0,16,98466
32537,9834,583,1981,3668,2302,1300,659,372,333,43,18,272,39,10,10,0,0,29,11,0,18,287,223,39,24,160,64,55,27,0,28,9,9,0,0,98467
32538,20465,1850,5244,8335,3364,1672,1136,577,444,28,92,324,133,119,83,36,0,14,14,0,0,559,403,34,28,341,156,72,47,0,25,84,23,0,61,98498
32539,19530,2981,5700,7266,2432,1151,1521,788,543,43,165,335,245,173,48,123,2,72,12,0,60,733,556,146,63,347,177,95,59,0,36,82,7,20,55,98499
32540,27862,1574,5177,9218,6677,5216,1649,747,678,133,19,526,69,42,42,0,0,27,15,0,12,902,822,209,49,564,80,80,80,0,0,0,0,0,0,98501
32541,20444,1118,3008,6834,5297,4187,1675,880,823,129,110,584,57,49,38,11,0,8,0,0,8,795,710,147,124,439,85,71,50,0,21,14,0,0,14,98502
32542,24249,1618,6008,9770,4518,2335,2112,1147,961,128,98,735,186,127,76,51,0,59,21,0,38,965,833,303,91,439,132,81,15,20,46,51,0,11,40,98503
32543,12643,808,2746,3995,3141,1953,571,263,242,25,14,203,21,21,11,10,0,0,0,0,0,308,296,83,16,197,12,12,12,0,0,0,0,0,0,98506
32544,20220,1430,4723,7535,3950,2582,1579,754,708,135,30,543,46,35,10,16,9,11,9,0,2,825,765,269,4,492,60,41,33,8,0,19,19,0,0,98512
32545,22384,1573,5403,9384,3829,2195,1724,949,856,180,105,571,93,55,11,25,19,38,20,16,2,775,630,136,108,386,145,96,33,12,51,49,16,0,33,98513
32546,15114,1249,3274,5283,3209,2099,935,320,254,30,101,123,66,66,18,0,48,0,0,0,0,615,519,136,10,373,96,96,49,22,25,0,0,0,0,98516
32547,16118,2771,4937,6159,1565,686,1323,745,620,86,82,452,125,107,63,20,24,18,0,0,18,578,487,161,17,309,91,59,36,13,10,32,10,0,22,98520
32548,2661,177,570,1177,525,212,43,24,24,0,0,24,0,0,0,0,0,0,0,0,0,19,19,0,0,19,0,0,0,0,0,0,0,0,0,98524
32549,181,26,41,81,21,12,17,9,7,0,0,7,2,2,0,2,0,0,0,0,0,8,3,0,0,3,5,2,0,2,0,3,3,0,0,98526
32550,146,12,30,41,51,12,0,0,0,0,0,0,0,0,0,0,0,0,0,0,0,0,0,0,0,0,0,0,0,0,0,0,0,0,0,98527
32551,6610,734,2185,2766,591,334,367,41,41,10,18,13,0,0,0,0,0,0,0,0,0,326,267,24,15,228,59,59,18,24,17,0,0,0,0,98528
32552,361,66,82,181,25,7,33,7,7,0,0,7,0,0,0,0,0,0,0,0,0,26,26,0,0,26,0,0,0,0,0,0,0,0,0,98530
32553,15260,2699,4794,5622,1400,745,1613,832,685,159,22,504,147,135,67,38,30,12,0,0,12,781,589,378,26,185,192,192,139,41,12,0,0,0,0,98531
32554,16167,1762,4874,6895,1644,992,1418,783,698,29,88,581,85,48,43,0,5,37,0,0,37,635,456,156,41,259,179,169,127,16,26,10,7,0,3,98532
32555,590,25,267,224,64,10,73,58,41,0,0,41,17,17,0,17,0,0,0,0,0,15,15,0,0,15,0,0,0,0,0,0,0,0,0,98533
32556,486,60,96,330,0,0,0,0,0,0,0,0,0,0,0,0,0,0,0,0,0,0,0,0,0,0,0,0,0,0,0,0,0,0,0,98535
32557,138,0,14,63,47,14,0,0,0,0,0,0,0,0,0,0,0,0,0,0,0,0,0,0,0,0,0,0,0,0,0,0,0,0,0,98536
32558,1510,113,501,647,188,61,95,59,55,19,0,36,4,4,4,0,0,0,0,0,0,36,27,0,5,22,9,0,0,0,0,9,0,9,0,98537
32559,199,23,46,99,18,13,9,0,0,0,0,0,0,0,0,0,0,0,0,0,0,9,9,0,0,9,0,0,0,0,0,0,0,0,0,98538
32560,7092,1055,2650,2425,672,290,555,327,232,9,64,159,95,63,3,60,0,32,12,0,20,228,94,4,2,88,134,131,89,0,42,3,0,0,3,98541
32561,482,12,222,162,51,35,11,0,0,0,0,0,0,0,0,0,0,0,0,0,0,11,11,11,0,0,0,0,0,0,0,0,0,0,0,98542
32562,0,0,0,0,0,0,0,0,0,0,0,0,0,0,0,0,0,0,0,0,0,0,0,0,0,0,0,0,0,0,0,0,0,0,0,98544
32563,2481,211,482,1350,220,218,162,95,58,0,0,58,37,37,37,0,0,0,0,0,0,67,47,0,0,47,20,20,20,0,0,0,0,0,0,98546
32564,1273,168,519,452,83,51,91,52,52,17,35,0,0,0,0,0,0,0,0,0,0,39,31,31,0,0,8,0,0,0,0,8,0,0,8,98547
32565,2006,277,634,727,291,77,47,4,4,4,0,0,0,0,0,0,0,0,0,0,0,43,43,0,34,9,0,0,0,0,0,0,0,0,0,98548
32566,7932,1370,2512,3128,594,328,707,319,209,72,0,137,110,57,21,27,9,53,53,0,0,388,281,47,44,190,107,46,15,9,22,61,4,57,0,98550
32567,447,132,124,144,41,6,70,8,8,8,0,0,0,0,0,0,0,0,0,0,0,62,62,0,0,62,0,0,0,0,0,0,0,0,0,98552
32568,306,31,97,137,28,13,16,16,16,0,0,16,0,0,0,0,0,0,0,0,0,0,0,0,0,0,0,0,0,0,0,0,0,0,0,98555
32569,2312,368,620,1041,175,108,110,41,25,6,12,7,16,0,0,0,0,16,0,12,4,69,57,29,0,28,12,0,0,0,0,12,0,12,0,98557
32570,191,26,51,96,18,0,0,0,0,0,0,0,0,0,0,0,0,0,0,0,0,0,0,0,0,0,0,0,0,0,0,0,0,0,0,98558
32571,58,0,58,0,0,0,0,0,0,0,0,0,0,0,0,0,0,0,0,0,0,0,0,0,0,0,0,0,0,0,0,0,0,0,0,98559
32572,118,3,47,48,10,10,4,4,4,4,0,0,0,0,0,0,0,0,0,0,0,0,0,0,0,0,0,0,0,0,0,0,0,0,0,98560
32573,85,0,64,21,0,0,0,0,0,0,0,0,0,0,0,0,0,0,0,0,0,0,0,0,0,0,0,0,0,0,0,0,0,0,0,98562
32574,6078,651,1889,2509,718,311,347,130,108,20,38,50,22,22,22,0,0,0,0,0,0,217,182,26,0,156,35,17,17,0,0,18,0,0,18,98563
32575,1832,254,585,762,155,76,193,64,50,0,0,50,14,14,14,0,0,0,0,0,0,129,129,35,57,37,0,0,0,0,0,0,0,0,0,98564
32576,388,27,120,180,53,8,35,32,23,13,0,10,9,9,0,9,0,0,0,0,0,3,0,0,0,0,3,3,0,3,0,0,0,0,0,98565
32577,1714,305,624,685,61,39,149,90,55,10,0,45,35,29,12,13,4,6,0,0,6,59,49,19,1,29,10,5,0,0,5,5,0,0,5,98568
32578,4893,339,1298,2387,680,189,194,119,119,0,0,119,0,0,0,0,0,0,0,0,0,75,75,0,0,75,0,0,0,0,0,0,0,0,0,98569
32579,2889,321,1206,1124,134,104,146,138,138,0,9,129,0,0,0,0,0,0,0,0,0,8,8,0,8,0,0,0,0,0,0,0,0,0,0,98570
32580,269,40,63,111,40,15,0,0,0,0,0,0,0,0,0,0,0,0,0,0,0,0,0,0,0,0,0,0,0,0,0,0,0,0,0,98571
32581,518,61,203,195,46,13,31,20,20,0,0,20,0,0,0,0,0,0,0,0,0,11,11,0,0,11,0,0,0,0,0,0,0,0,0,98572
32582,184,7,41,102,30,4,0,0,0,0,0,0,0,0,0,0,0,0,0,0,0,0,0,0,0,0,0,0,0,0,0,0,0,0,0,98575
32583,3509,317,1261,1389,322,220,236,159,147,6,25,116,12,9,2,7,0,3,0,0,3,77,77,39,19,19,0,0,0,0,0,0,0,0,0,98576
32584,4867,722,1722,1709,497,217,275,116,106,19,0,87,10,10,4,0,6,0,0,0,0,159,125,21,3,101,34,25,8,0,17,9,0,0,9,98577
32585,9352,988,2665,4017,1327,355,583,309,205,30,29,146,104,0,0,0,0,104,104,0,0,274,238,51,33,154,36,22,22,0,0,14,0,14,0,98579
32586,7226,752,2359,2823,758,534,645,427,367,124,15,228,60,60,37,23,0,0,0,0,0,218,210,40,10,160,8,5,3,2,0,3,0,0,3,98580
32587,225,34,78,91,22,0,0,0,0,0,0,0,0,0,0,0,0,0,0,0,0,0,0,0,0,0,0,0,0,0,0,0,0,0,0,98581
32588,427,48,143,218,9,9,34,7,7,0,0,7,0,0,0,0,0,0,0,0,0,27,27,27,0,0,0,0,0,0,0,0,0,0,0,98582
32589,63,21,11,26,5,0,3,3,3,3,0,0,0,0,0,0,0,0,0,0,0,0,0,0,0,0,0,0,0,0,0,0,0,0,0,98583
32590,24854,3000,7715,9794,2977,1368,1588,1033,853,159,47,647,180,72,57,2,13,108,0,34,74,555,451,91,36,324,104,70,37,10,23,34,21,3,10,98584
32591,504,15,160,198,80,51,0,0,0,0,0,0,0,0,0,0,0,0,0,0,0,0,0,0,0,0,0,0,0,0,0,0,0,0,0,98585
32592,1399,292,362,566,133,46,78,54,54,10,0,44,0,0,0,0,0,0,0,0,0,24,24,7,0,17,0,0,0,0,0,0,0,0,0,98586
32593,521,93,162,183,59,24,42,19,15,0,0,15,4,4,0,2,2,0,0,0,0,23,15,6,3,6,8,8,0,8,0,0,0,0,0,98587
32594,1805,303,525,828,117,32,49,23,23,0,0,23,0,0,0,0,0,0,0,0,0,26,0,0,0,0,26,26,0,0,26,0,0,0,0,98588
32595,4498,429,1570,1831,526,142,358,234,186,17,0,169,48,22,22,0,0,26,0,0,26,124,119,35,0,84,5,5,5,0,0,0,0,0,0,98589
32596,232,54,44,104,18,12,6,1,1,0,1,0,0,0,0,0,0,0,0,0,0,5,0,0,0,0,5,0,0,0,0,5,0,0,5,98590
32597,2756,257,1012,1187,208,92,240,120,90,25,0,65,30,21,12,0,9,9,0,9,0,120,74,0,1,73,46,22,22,0,0,24,0,0,24,98591
32598,1274,51,377,446,255,145,138,21,21,21,0,0,0,0,0,0,0,0,0,0,0,117,117,67,0,50,0,0,0,0,0,0,0,0,0,98592
32599,546,72,186,255,25,8,37,27,9,0,0,9,18,0,0,0,0,18,0,0,18,10,8,0,0,8,2,2,2,0,0,0,0,0,0,98593
32600,1503,174,528,551,198,52,56,34,23,6,0,17,11,11,11,0,0,0,0,0,0,22,22,17,0,5,0,0,0,0,0,0,0,0,0,98595
32601,5013,807,1503,2099,332,272,291,149,91,26,0,65,58,51,33,18,0,7,7,0,0,142,114,19,0,95,28,28,6,0,22,0,0,0,0,98596
32602,13075,1096,4179,5682,1429,689,1185,803,625,71,109,445,178,118,17,79,22,60,12,15,33,382,357,25,112,220,25,25,25,0,0,0,0,0,0,98597
32603,1617,126,480,778,152,81,105,70,36,6,0,30,34,0,0,0,0,34,0,0,34,35,35,7,0,28,0,0,0,0,0,0,0,0,0,98601
32604,67,7,40,8,6,6,0,0,0,0,0,0,0,0,0,0,0,0,0,0,0,0,0,0,0,0,0,0,0,0,0,0,0,0,0,98602
32605,609,29,112,336,99,33,16,5,5,0,0,5,0,0,0,0,0,0,0,0,0,11,11,11,0,0,0,0,0,0,0,0,0,0,0,98603
32606,21146,1544,5708,8653,3503,1738,2227,1097,1031,167,150,714,66,27,8,19,0,39,24,0,15,1130,1024,293,137,594,106,89,79,0,10,17,10,0,7,98604
32607,1000,189,299,336,116,60,43,24,10,0,2,8,14,14,14,0,0,0,0,0,0,19,19,9,0,10,0,0,0,0,0,0,0,0,0,98605
32608,5860,267,1357,2461,1089,686,513,264,243,50,39,154,21,21,12,0,9,0,0,0,0,249,241,89,11,141,8,8,8,0,0,0,0,0,0,98606
32609,18104,968,3481,6389,4359,2907,1592,881,777,150,55,572,104,104,50,30,24,0,0,0,0,711,664,143,67,454,47,47,26,0,21,0,0,0,0,98607
32610,1986,215,674,831,181,85,231,164,149,17,66,66,15,0,0,0,0,15,0,6,9,67,67,7,11,49,0,0,0,0,0,0,0,0,0,98610
32611,7072,889,2284,2936,670,293,482,218,194,40,55,99,24,24,24,0,0,0,0,0,0,264,190,62,0,128,74,74,57,17,0,0,0,0,0,98611
32612,2009,90,763,882,157,117,156,88,81,0,0,81,7,3,0,0,3,4,0,4,0,68,25,0,0,25,43,0,0,0,0,43,15,28,0,98612
32613,364,40,104,171,15,34,29,25,25,0,0,25,0,0,0,0,0,0,0,0,0,4,4,0,0,4,0,0,0,0,0,0,0,0,0,98613
32614,222,0,153,59,0,10,9,9,9,0,0,9,0,0,0,0,0,0,0,0,0,0,0,0,0,0,0,0,0,0,0,0,0,0,0,98614
32615,189,21,44,89,10,25,0,0,0,0,0,0,0,0,0,0,0,0,0,0,0,0,0,0,0,0,0,0,0,0,0,0,0,0,0,98616
32616,790,68,343,276,103,0,40,16,16,16,0,0,0,0,0,0,0,0,0,0,0,24,0,0,0,0,24,24,0,0,24,0,0,0,0,98617
32617,355,26,140,131,39,19,9,7,7,0,0,7,0,0,0,0,0,0,0,0,0,2,2,2,0,0,0,0,0,0,0,0,0,0,0,98619
32618,5558,464,1793,2401,709,191,315,163,88,0,0,88,75,0,0,0,0,75,0,0,75,152,136,19,13,104,16,0,0,0,0,16,0,0,16,98620
32619,314,44,142,103,23,2,60,15,15,0,0,15,0,0,0,0,0,0,0,0,0,45,45,35,0,10,0,0,0,0,0,0,0,0,0,98621
32620,1050,52,251,432,191,124,75,47,34,8,0,26,13,10,5,2,3,3,0,0,3,28,22,9,0,13,6,6,6,0,0,0,0,0,0,98624
32621,4825,342,1498,2232,492,261,199,131,106,16,0,90,25,11,11,0,0,14,0,14,0,68,57,23,0,34,11,11,0,11,0,0,0,0,0,98625
32622,16098,2187,5655,6262,1423,571,1076,396,331,98,46,187,65,58,28,16,14,7,0,7,0,680,579,81,84,414,101,50,50,0,0,51,7,6,38,98626
32623,213,20,74,113,6,0,16,2,2,0,0,2,0,0,0,0,0,0,0,0,0,14,14,0,0,14,0,0,0,0,0,0,0,0,0,98628
32624,5701,283,1896,2167,948,407,546,332,301,51,18,232,31,20,20,0,0,11,11,0,0,214,191,53,17,121,23,14,5,0,9,9,3,0,6,98629
32625,3021,316,1029,1153,302,221,81,57,38,0,7,31,19,19,15,4,0,0,0,0,0,24,18,0,0,18,6,0,0,0,0,6,6,0,0,98631
32626,33854,4270,9575,14459,3492,2058,2315,1225,886,110,105,671,339,234,125,58,51,105,41,25,39,1090,859,122,127,610,231,194,166,28,0,37,13,14,10,98632
32627,1380,157,544,469,152,58,70,39,26,0,0,26,13,13,0,7,6,0,0,0,0,31,31,0,0,31,0,0,0,0,0,0,0,0,0,98635
32628,929,45,302,451,90,41,130,111,111,0,4,107,0,0,0,0,0,0,0,0,0,19,19,0,0,19,0,0,0,0,0,0,0,0,0,98638
32629,638,19,206,309,49,55,74,19,9,0,0,9,10,0,0,0,0,10,10,0,0,55,42,22,10,10,13,0,0,0,0,13,0,0,13,98639
32630,3245,384,949,1189,524,199,152,57,57,6,0,51,0,0,0,0,0,0,0,0,0,95,77,14,1,62,18,18,0,18,0,0,0,0,0,98640
32631,0,0,0,0,0,0,0,0,0,0,0,0,0,0,0,0,0,0,0,0,0,0,0,0,0,0,0,0,0,0,0,0,0,0,0,98641
32632,11521,563,2496,4718,2506,1238,782,406,373,65,24,284,33,33,16,0,17,0,0,0,0,376,313,51,0,262,63,55,0,0,55,8,0,0,8,98642
32633,330,21,95,136,70,8,11,11,0,0,0,0,11,11,0,11,0,0,0,0,0,0,0,0,0,0,0,0,0,0,0,0,0,0,0,98643
32634,286,19,74,137,54,2,12,12,0,0,0,0,12,12,12,0,0,0,0,0,0,0,0,0,0,0,0,0,0,0,0,0,0,0,0,98644
32635,975,119,348,348,115,45,77,42,37,0,19,18,5,5,0,0,5,0,0,0,0,35,27,0,14,13,8,8,0,8,0,0,0,0,0,98645
32636,204,14,38,115,23,14,7,7,7,0,0,7,0,0,0,0,0,0,0,0,0,0,0,0,0,0,0,0,0,0,0,0,0,0,0,98647
32637,2086,267,574,773,268,204,111,67,58,14,0,44,9,0,0,0,0,9,0,0,9,44,35,0,21,14,9,9,9,0,0,0,0,0,0,98648
32638,684,51,273,200,93,67,117,70,70,0,0,70,0,0,0,0,0,0,0,0,0,47,41,15,0,26,6,6,0,6,0,0,0,0,0,98649
32639,732,39,140,310,154,89,19,7,7,0,0,7,0,0,0,0,0,0,0,0,0,12,12,0,0,12,0,0,0,0,0,0,0,0,0,98650
32640,634,78,135,187,136,98,32,18,7,0,0,7,11,11,11,0,0,0,0,0,0,14,14,0,0,14,0,0,0,0,0,0,0,0,0,98651
32641,8910,1304,2110,3212,1323,961,389,198,101,14,16,71,97,41,31,0,10,56,0,0,56,191,151,16,45,90,40,33,7,13,13,7,0,7,0,98660
32642,27551,3729,8496,10318,3471,1537,1973,1122,943,69,52,822,179,104,91,0,13,75,0,19,56,851,731,75,104,552,120,27,9,0,18,93,0,41,52,98661
32643,21245,1866,6484,8794,2704,1397,1832,760,598,151,69,378,162,129,55,74,0,33,33,0,0,1072,858,222,97,539,214,151,87,46,18,63,11,0,52,98662
32644,9363,814,2493,3450,1701,905,499,317,295,52,42,201,22,7,7,0,0,15,0,0,15,182,154,29,5,120,28,25,17,8,0,3,0,0,3,98663
32645,15501,1389,4026,6040,2660,1386,645,318,271,53,26,192,47,47,0,7,40,0,0,0,0,327,264,34,67,163,63,45,0,45,0,18,0,0,18,98664
32646,15846,1654,4275,6202,2599,1116,995,580,436,60,65,311,144,138,81,3,54,6,0,6,0,415,348,109,86,153,67,34,0,27,7,33,13,8,12,98665
32647,62,8,24,28,0,2,2,2,2,0,0,2,0,0,0,0,0,0,0,0,0,0,0,0,0,0,0,0,0,0,0,0,0,0,0,98670
32648,15041,1051,4195,6122,2451,1222,1387,835,653,174,54,425,182,115,31,61,23,67,0,44,23,552,493,71,47,375,59,36,7,17,12,23,0,0,23,98671
32649,3858,669,907,1195,750,337,273,112,112,61,0,51,0,0,0,0,0,0,0,0,0,161,116,20,0,96,45,45,4,0,41,0,0,0,0,98672
32650,331,56,129,88,35,23,13,8,8,0,0,8,0,0,0,0,0,0,0,0,0,5,5,0,0,5,0,0,0,0,0,0,0,0,0,98673
32651,6650,888,2228,2284,725,525,990,517,450,136,35,279,67,67,67,0,0,0,0,0,0,473,319,48,28,243,154,94,47,17,30,60,26,0,34,98674
32652,3797,415,1467,1328,429,158,391,232,189,102,0,87,43,28,18,0,10,15,0,4,11,159,149,77,0,72,10,10,0,10,0,0,0,0,0,98675
32653,33465,4471,9345,13506,4252,1891,3258,1552,1319,223,223,873,233,155,34,46,75,78,11,0,67,1706,1468,259,160,1049,238,177,29,101,47,61,12,0,49,98682
32654,21370,1230,5131,7684,4525,2800,1380,722,671,223,33,415,51,25,0,11,14,26,14,12,0,658,599,89,74,436,59,59,46,13,0,0,0,0,0,98683
32655,18411,1307,4889,7802,3008,1405,1959,816,725,104,62,559,91,48,14,0,34,43,0,0,43,1143,1067,305,163,599,76,63,30,9,24,13,13,0,0,98684
32656,17550,733,3355,6854,4145,2463,1646,860,700,42,80,578,160,90,69,21,0,70,0,56,14,786,585,64,10,511,201,121,76,19,26,80,0,50,30,98685
32657,11840,1066,2395,4691,2233,1455,1293,624,568,37,96,435,56,56,36,20,0,0,0,0,0,669,532,143,83,306,137,137,72,13,52,0,0,0,0,98686
32658,27155,4536,7952,8127,4143,2397,2482,1114,819,180,82,557,295,196,104,43,49,99,0,75,24,1368,1268,305,73,890,100,83,72,0,11,17,0,17,0,98801
32659,18946,3054,5047,7152,2484,1209,1593,826,706,256,84,366,120,58,48,10,0,62,9,0,53,767,690,134,136,420,77,45,22,0,23,32,0,0,32,98802
32660,83,9,22,52,0,0,0,0,0,0,0,0,0,0,0,0,0,0,0,0,0,0,0,0,0,0,0,0,0,0,0,0,0,0,0,98811
32661,2583,984,637,586,249,127,276,151,109,7,12,90,42,29,0,0,29,13,0,0,13,125,83,15,4,64,42,39,11,10,18,3,0,0,3,98812
32662,1968,790,676,412,78,12,273,198,155,10,13,132,43,17,9,0,8,26,8,9,9,75,68,12,0,56,7,7,7,0,0,0,0,0,0,98813
32663,271,22,136,94,19,0,0,0,0,0,0,0,0,0,0,0,0,0,0,0,0,0,0,0,0,0,0,0,0,0,0,0,0,0,0,98814
32664,4870,810,1358,1535,771,396,405,177,150,62,0,88,27,27,0,27,0,0,0,0,0,228,220,97,14,109,8,4,4,0,0,4,4,0,0,98815
32665,4422,860,1140,1205,780,437,384,261,245,42,41,162,16,0,0,0,0,16,16,0,0,123,114,17,0,97,9,0,0,0,0,9,0,0,9,98816
32666,250,50,122,64,14,0,19,0,0,0,0,0,0,0,0,0,0,0,0,0,0,19,19,0,0,19,0,0,0,0,0,0,0,0,0,98817
32667,117,13,30,69,2,3,0,0,0,0,0,0,0,0,0,0,0,0,0,0,0,0,0,0,0,0,0,0,0,0,0,0,0,0,0,98819
32668,344,156,188,0,0,0,47,47,47,47,0,0,0,0,0,0,0,0,0,0,0,0,0,0,0,0,0,0,0,0,0,0,0,0,0,98821
32669,1533,297,456,504,173,103,120,22,22,0,0,22,0,0,0,0,0,0,0,0,0,98,71,10,18,43,27,9,9,0,0,18,3,0,15,98822
32670,6783,1379,2208,1982,1008,206,819,376,226,25,0,201,150,133,124,9,0,17,0,0,17,443,380,62,38,280,63,12,0,12,0,51,0,0,51,98823
32671,167,126,8,30,3,0,20,0,0,0,0,0,0,0,0,0,0,0,0,0,0,20,20,0,9,11,0,0,0,0,0,0,0,0,0,98824
32672,4723,372,1610,1256,952,533,278,153,70,15,19,36,83,77,16,54,7,6,0,6,0,125,125,85,0,40,0,0,0,0,0,0,0,0,0,98826
32673,574,278,212,75,9,0,46,46,28,0,0,28,18,0,0,0,0,18,0,0,18,0,0,0,0,0,0,0,0,0,0,0,0,0,0,98827
32674,1327,75,468,595,115,74,10,5,5,0,0,5,0,0,0,0,0,0,0,0,0,5,5,0,0,5,0,0,0,0,0,0,0,0,0,98828
32675,434,74,154,175,31,0,44,44,44,0,0,44,0,0,0,0,0,0,0,0,0,0,0,0,0,0,0,0,0,0,0,0,0,0,0,98829
32676,329,26,88,121,72,22,13,10,10,8,0,2,0,0,0,0,0,0,0,0,0,3,3,1,2,0,0,0,0,0,0,0,0,0,0,98830
32677,2334,577,762,572,295,128,79,49,27,9,0,18,22,0,0,0,0,22,22,0,0,30,30,11,0,19,0,0,0,0,0,0,0,0,0,98831
32678,134,9,21,104,0,0,40,24,24,4,0,20,0,0,0,0,0,0,0,0,0,16,16,16,0,0,0,0,0,0,0,0,0,0,0,98832
32679,118,0,0,53,53,12,0,0,0,0,0,0,0,0,0,0,0,0,0,0,0,0,0,0,0,0,0,0,0,0,0,0,0,0,0,98833
32680,129,29,47,43,4,6,10,10,10,7,0,3,0,0,0,0,0,0,0,0,0,0,0,0,0,0,0,0,0,0,0,0,0,0,0,98834
32681,431,84,71,129,116,31,24,24,0,0,0,0,24,0,0,0,0,24,24,0,0,0,0,0,0,0,0,0,0,0,0,0,0,0,0,98836
32682,24927,3823,7386,9478,2462,1778,2578,1274,995,178,16,801,279,117,39,31,47,162,14,24,124,1304,1122,222,102,798,182,142,22,38,82,40,22,0,18,98837
32683,3387,685,1205,963,339,195,214,131,115,35,12,68,16,0,0,0,0,16,0,0,16,83,75,18,0,57,8,0,0,0,0,8,0,8,0,98840
32684,6013,684,1933,2419,563,414,421,266,206,67,20,119,60,35,35,0,0,25,15,10,0,155,147,77,38,32,8,8,8,0,0,0,0,0,0,98841
32685,946,457,174,192,87,36,85,61,26,7,11,8,35,16,16,0,0,19,19,0,0,24,14,0,0,14,10,10,5,5,0,0,0,0,0,98843
32686,3047,664,1105,933,173,172,353,209,202,41,0,161,7,3,0,3,0,4,0,0,4,144,112,3,0,109,32,32,3,29,0,0,0,0,0,98844
32687,134,39,61,31,1,2,10,3,3,0,0,3,0,0,0,0,0,0,0,0,0,7,7,3,0,4,0,0,0,0,0,0,0,0,0,98845
32688,790,203,214,242,62,69,58,36,36,4,0,32,0,0,0,0,0,0,0,0,0,22,16,0,0,16,6,6,6,0,0,0,0,0,0,98846
32689,1211,438,397,239,80,57,88,7,7,0,0,7,0,0,0,0,0,0,0,0,0,81,59,15,0,44,22,0,0,0,0,22,0,22,0,98847
32690,6846,2382,1728,2112,460,164,862,335,278,43,9,226,57,57,47,10,0,0,0,0,0,527,365,123,35,207,162,148,58,0,90,14,0,14,0,98848
32691,1065,93,487,417,46,22,117,16,1,1,0,0,15,9,9,0,0,6,0,2,4,101,31,2,0,29,70,36,25,0,11,34,0,2,32,98849
32692,856,242,275,235,72,32,134,43,22,12,0,10,21,13,0,13,0,8,2,3,3,91,52,26,0,26,39,39,37,0,2,0,0,0,0,98850
32693,2670,454,738,1155,248,75,195,160,140,13,44,83,20,0,0,0,0,20,0,0,20,35,26,6,0,20,9,0,0,0,0,9,0,9,0,98851
32694,8,0,2,0,6,0,0,0,0,0,0,0,0,0,0,0,0,0,0,0,0,0,0,0,0,0,0,0,0,0,0,0,0,0,0,98852
32695,2,0,0,2,0,0,0,0,0,0,0,0,0,0,0,0,0,0,0,0,0,0,0,0,0,0,0,0,0,0,0,0,0,0,0,98853
32696,4550,1104,1469,1282,358,337,265,123,61,2,0,59,62,62,32,0,30,0,0,0,0,142,114,15,0,99,28,23,7,16,0,5,0,3,2,98855
32697,1920,171,561,747,300,141,76,38,38,0,0,38,0,0,0,0,0,0,0,0,0,38,38,7,0,31,0,0,0,0,0,0,0,0,0,98856
32698,2341,955,428,687,184,87,344,229,96,23,0,73,133,63,24,4,35,70,0,54,16,115,86,0,15,71,29,29,16,0,13,0,0,0,0,98857
32699,1230,139,472,462,141,16,129,77,69,14,0,55,8,8,8,0,0,0,0,0,0,52,49,6,0,43,3,3,3,0,0,0,0,0,0,98858
32700,144,16,40,84,4,0,0,0,0,0,0,0,0,0,0,0,0,0,0,0,0,0,0,0,0,0,0,0,0,0,0,0,0,0,0,98859
32701,191,21,76,57,18,19,20,2,2,0,0,2,0,0,0,0,0,0,0,0,0,18,15,0,0,15,3,3,0,0,3,0,0,0,0,98860
32702,1605,74,512,405,301,313,70,39,39,18,0,21,0,0,0,0,0,0,0,0,0,31,31,14,0,17,0,0,0,0,0,0,0,0,0,98862
32703,17867,6674,4632,4609,1152,800,1642,727,565,87,54,424,162,15,5,10,0,147,50,18,79,915,643,100,36,507,272,113,67,0,46,159,47,42,70,98901
32704,28006,8257,8211,7261,2530,1747,2903,1554,908,69,86,753,646,259,186,40,33,387,117,54,216,1349,847,123,127,597,502,340,199,67,74,162,85,0,77,98902
32705,9897,2717,3004,2964,805,407,829,461,434,87,8,339,27,23,0,0,23,4,0,0,4,368,368,53,23,292,0,0,0,0,0,0,0,0,0,98903
32706,24389,3086,5589,9040,4000,2674,1886,948,679,107,128,444,269,156,96,20,40,113,57,39,17,938,755,230,101,424,183,173,135,38,0,10,0,0,10,98908
32707,247,247,0,0,0,0,68,54,54,54,0,0,0,0,0,0,0,0,0,0,0,14,14,0,0,14,0,0,0,0,0,0,0,0,0,98921
32708,4223,406,1366,1419,792,240,235,173,92,41,35,16,81,81,81,0,0,0,0,0,0,62,62,15,2,45,0,0,0,0,0,0,0,0,0,98922
32709,717,299,311,103,4,0,12,12,12,0,0,12,0,0,0,0,0,0,0,0,0,0,0,0,0,0,0,0,0,0,0,0,0,0,0,98923
32710,387,48,195,88,53,3,32,18,18,0,0,18,0,0,0,0,0,0,0,0,0,14,12,2,0,10,2,2,0,0,2,0,0,0,0,98925
32711,16665,1293,4199,4713,4043,2417,2832,1288,1137,309,83,745,151,93,3,9,81,58,40,0,18,1544,1424,355,89,980,120,65,5,24,36,55,0,4,51,98926
32712,0,0,0,0,0,0,0,0,0,0,0,0,0,0,0,0,0,0,0,0,0,0,0,0,0,0,0,0,0,0,0,0,0,0,0,98929
32713,9172,3489,2304,2431,552,396,941,579,427,37,55,335,152,145,64,18,63,7,0,0,7,362,299,120,7,172,63,29,0,29,0,34,34,0,0,98930
32714,2446,1135,566,451,250,44,352,242,170,33,7,130,72,49,16,19,14,23,9,0,14,110,71,3,0,68,39,39,8,31,0,0,0,0,0,98932
32715,749,162,251,235,60,41,52,30,22,0,0,22,8,6,0,0,6,2,2,0,0,22,11,0,1,10,11,7,0,7,0,4,0,0,4,98933
32716,722,77,303,240,76,26,34,27,0,0,0,0,27,0,0,0,0,27,0,15,12,7,7,6,1,0,0,0,0,0,0,0,0,0,0,98934
32717,2085,999,630,369,54,33,233,104,85,7,0,78,19,4,0,4,0,15,13,0,2,129,103,0,4,99,26,26,17,9,0,0,0,0,0,98935
32718,3579,752,914,1427,385,101,219,119,98,19,13,66,21,4,0,4,0,17,12,0,5,100,100,13,0,87,0,0,0,0,0,0,0,0,0,98936
32719,2858,216,834,1173,433,202,255,118,101,9,0,92,17,17,0,17,0,0,0,0,0,137,137,34,10,93,0,0,0,0,0,0,0,0,0,98937
32720,951,338,194,207,179,33,96,81,48,14,0,34,33,0,0,0,0,33,33,0,0,15,15,0,0,15,0,0,0,0,0,0,0,0,0,98938
32721,81,34,18,29,0,0,32,9,9,0,0,9,0,0,0,0,0,0,0,0,0,23,23,0,0,23,0,0,0,0,0,0,0,0,0,98939
32722,496,16,143,185,137,15,20,0,0,0,0,0,0,0,0,0,0,0,0,0,0,20,20,0,9,11,0,0,0,0,0,0,0,0,0,98940
32723,600,63,186,169,135,47,21,9,9,4,0,5,0,0,0,0,0,0,0,0,0,12,5,5,0,0,7,7,0,7,0,0,0,0,0,98941
32724,10603,1214,2957,4014,1651,767,992,575,470,180,83,207,105,74,9,0,65,31,9,22,0,417,338,178,20,140,79,79,26,23,30,0,0,0,0,98942
32725,487,39,268,103,66,11,19,19,10,0,0,10,9,9,9,0,0,0,0,0,0,0,0,0,0,0,0,0,0,0,0,0,0,0,0,98943
32726,11687,5062,3176,2334,481,634,1854,1015,668,107,59,502,347,254,166,70,18,93,49,11,33,839,685,90,0,595,154,31,0,16,15,123,30,38,55,98944
32727,388,51,131,144,54,8,27,20,7,0,0,7,13,13,13,0,0,0,0,0,0,7,7,2,0,5,0,0,0,0,0,0,0,0,0,98946
32728,1643,566,436,358,196,87,115,39,26,3,2,21,13,13,3,8,2,0,0,0,0,76,67,11,24,32,9,9,0,0,9,0,0,0,0,98947
32729,7122,3231,1601,1656,428,206,1198,766,529,56,8,465,237,68,55,6,7,169,137,22,10,432,310,33,14,263,122,61,27,16,18,61,23,0,38,98948
32730,215,178,11,26,0,0,75,62,62,11,0,51,0,0,0,0,0,0,0,0,0,13,13,0,0,13,0,0,0,0,0,0,0,0,0,98950
32731,7430,2896,2098,1769,423,244,1157,601,406,120,16,270,195,114,76,30,8,81,0,0,81,556,397,90,22,285,159,62,0,0,62,97,38,12,47,98951
32732,1134,336,417,329,32,20,212,131,106,7,0,99,25,0,0,0,0,25,0,25,0,81,42,0,0,42,39,24,9,0,15,15,0,0,15,98952
32733,4096,994,1300,1130,508,164,369,142,125,62,6,57,17,17,0,0,17,0,0,0,0,227,194,34,4,156,33,33,0,33,0,0,0,0,0,98953
32734,4311,413,1498,1989,373,38,205,77,67,4,6,57,10,10,2,0,8,0,0,0,0,128,95,55,0,40,33,21,7,14,0,12,0,0,12,99001
32735,3424,281,998,1334,583,228,305,191,164,9,41,114,27,27,8,19,0,0,0,0,0,114,91,0,10,81,23,13,13,0,0,10,0,0,10,99003
32736,9409,420,1856,3555,2209,1369,2222,997,966,112,182,672,31,14,14,0,0,17,17,0,0,1225,1202,331,79,792,23,23,5,18,0,0,0,0,0,99004
32737,5631,158,1055,1927,1505,986,758,253,243,34,15,194,10,10,10,0,0,0,0,0,0,505,401,129,52,220,104,104,26,78,0,0,0,0,0,99005
32738,7598,744,2273,3081,1150,350,425,277,261,24,8,229,16,16,0,7,9,0,0,0,0,148,104,30,12,62,44,35,27,0,8,9,0,9,0,99006
32739,437,10,121,163,50,93,47,26,26,0,0,26,0,0,0,0,0,0,0,0,0,21,9,0,0,9,12,12,12,0,0,0,0,0,0,99008
32740,2987,368,1081,1065,249,224,235,117,58,15,10,33,59,59,48,11,0,0,0,0,0,118,69,10,10,49,49,49,16,33,0,0,0,0,0,99009
32741,1123,7,130,663,199,124,141,102,0,0,0,0,102,76,76,0,0,26,26,0,0,39,39,7,0,32,0,0,0,0,0,0,0,0,0,99011
32742,771,19,255,380,99,18,25,9,9,5,0,4,0,0,0,0,0,0,0,0,0,16,16,10,0,6,0,0,0,0,0,0,0,0,0,99012
32743,1194,164,315,501,143,71,107,60,39,0,0,39,21,21,21,0,0,0,0,0,0,47,47,5,0,42,0,0,0,0,0,0,0,0,0,99013
32744,8792,502,2538,3329,1712,711,669,318,296,35,35,226,22,22,5,17,0,0,0,0,0,351,332,109,0,223,19,19,8,11,0,0,0,0,0,99016
32745,124,5,31,36,36,16,15,11,11,0,0,11,0,0,0,0,0,0,0,0,0,4,4,0,0,4,0,0,0,0,0,0,0,0,0,99017
32746,206,6,64,111,14,11,6,2,2,0,0,2,0,0,0,0,0,0,0,0,0,4,4,0,0,4,0,0,0,0,0,0,0,0,0,99018
32747,6622,259,1000,2191,1968,1204,485,297,234,55,41,138,63,63,42,21,0,0,0,0,0,188,170,35,44,91,18,18,0,18,0,0,0,0,0,99019
32748,66,50,0,16,0,0,0,0,0,0,0,0,0,0,0,0,0,0,0,0,0,0,0,0,0,0,0,0,0,0,0,0,0,0,0,99020
32749,6329,437,1711,2450,1210,521,452,207,155,39,7,109,52,10,10,0,0,42,0,13,29,245,159,62,24,73,86,38,9,0,29,48,0,0,48,99021
32750,5935,466,1891,2203,863,512,534,246,196,27,0,169,50,50,0,11,39,0,0,0,0,288,274,156,0,118,14,0,0,0,0,14,0,0,14,99022
32751,281,26,24,105,37,89,87,40,16,9,7,0,24,24,13,0,11,0,0,0,0,47,47,0,12,35,0,0,0,0,0,0,0,0,0,99023
32752,3530,236,889,1444,615,346,340,142,142,32,0,110,0,0,0,0,0,0,0,0,0,198,139,22,0,117,59,59,41,0,18,0,0,0,0,99025
32753,6025,413,1599,2608,961,444,525,343,286,35,64,187,57,57,57,0,0,0,0,0,0,182,182,54,0,128,0,0,0,0,0,0,0,0,0,99026
32754,4421,424,1204,1988,602,203,406,232,106,0,27,79,126,126,95,0,31,0,0,0,0,174,112,28,0,84,62,62,25,37,0,0,0,0,0,99027
32755,1139,4,373,569,163,30,109,28,17,0,0,17,11,11,9,0,2,0,0,0,0,81,69,23,12,34,12,0,0,0,0,12,0,0,12,99029
32756,726,41,195,314,122,54,41,28,23,5,2,16,5,5,5,0,0,0,0,0,0,13,8,1,2,5,5,5,5,0,0,0,0,0,0,99030
32757,629,57,167,249,109,47,59,48,48,2,4,42,0,0,0,0,0,0,0,0,0,11,11,2,0,9,0,0,0,0,0,0,0,0,0,99031
32758,535,27,163,254,66,25,25,11,10,0,0,10,1,0,0,0,0,1,0,0,1,14,3,0,0,3,11,11,11,0,0,0,0,0,0,99032
32759,601,56,185,218,80,62,58,19,16,0,0,16,3,0,0,0,0,3,0,0,3,39,39,0,0,39,0,0,0,0,0,0,0,0,0,99033
32760,191,77,52,25,0,37,17,17,17,0,0,17,0,0,0,0,0,0,0,0,0,0,0,0,0,0,0,0,0,0,0,0,0,0,0,99034
32761,857,48,136,311,304,58,44,37,37,8,0,29,0,0,0,0,0,0,0,0,0,7,7,7,0,0,0,0,0,0,0,0,0,0,0,99036
32762,8197,591,2353,3079,1402,772,790,464,420,153,23,244,44,44,12,32,0,0,0,0,0,326,253,82,30,141,73,46,31,0,15,27,15,0,12,99037
32763,87,3,26,34,24,0,1,1,1,0,0,1,0,0,0,0,0,0,0,0,0,0,0,0,0,0,0,0,0,0,0,0,0,0,0,99039
32764,372,73,167,99,21,12,49,38,30,0,8,22,8,3,0,3,0,5,0,3,2,11,9,7,0,2,2,0,0,0,0,2,0,0,2,99040
32765,923,119,332,342,75,55,97,51,46,0,0,46,5,0,0,0,0,5,0,5,0,46,46,4,0,42,0,0,0,0,0,0,0,0,0,99101
32766,359,15,103,179,54,8,7,4,4,4,0,0,0,0,0,0,0,0,0,0,0,3,3,0,0,3,0,0,0,0,0,0,0,0,0,99102
32767,356,21,116,146,54,19,20,8,5,3,0,2,3,0,0,0,0,3,0,0,3,12,12,0,0,12,0,0,0,0,0,0,0,0,0,99103
32768,32,4,14,11,2,1,0,0,0,0,0,0,0,0,0,0,0,0,0,0,0,0,0,0,0,0,0,0,0,0,0,0,0,0,0,99105
32769,3892,490,1327,1410,465,200,263,85,85,17,5,63,0,0,0,0,0,0,0,0,0,178,166,43,11,112,12,12,12,0,0,0,0,0,0,99109
32770,861,114,275,336,80,56,175,107,80,37,5,38,27,14,14,0,0,13,13,0,0,68,68,0,0,68,0,0,0,0,0,0,0,0,0,99110
32771,2941,158,713,1121,648,301,167,91,68,21,0,47,23,13,5,0,8,10,0,0,10,76,61,23,0,38,15,15,15,0,0,0,0,0,0,99111
32772,464,17,122,165,94,66,31,18,18,4,4,10,0,0,0,0,0,0,0,0,0,13,13,2,0,11,0,0,0,0,0,0,0,0,0,99113
32773,8641,778,2697,3348,1126,692,638,305,227,9,10,208,78,78,32,25,21,0,0,0,0,333,281,116,12,153,52,52,12,40,0,0,0,0,0,99114
32774,836,92,302,290,94,58,33,11,3,3,0,0,8,8,8,0,0,0,0,0,0,22,22,5,0,17,0,0,0,0,0,0,0,0,0,99115
32775,1139,51,273,542,166,107,81,33,33,29,0,4,0,0,0,0,0,0,0,0,0,48,25,16,0,9,23,0,0,0,0,23,0,13,10,99116
32776,372,27,120,154,44,27,8,8,8,0,0,8,0,0,0,0,0,0,0,0,0,0,0,0,0,0,0,0,0,0,0,0,0,0,0,99117
32777,628,88,212,177,70,81,70,42,35,5,0,30,7,7,0,0,7,0,0,0,0,28,15,9,0,6,13,9,5,0,4,4,0,0,4,99118
32778,765,57,232,334,115,27,68,39,22,8,0,14,17,17,3,0,14,0,0,0,0,29,29,13,5,11,0,0,0,0,0,0,0,0,0,99119
32779,103,0,14,55,21,13,30,15,15,0,0,15,0,0,0,0,0,0,0,0,0,15,15,7,0,8,0,0,0,0,0,0,0,0,0,99121
32780,2527,189,769,986,402,181,177,93,84,42,0,42,9,9,0,0,9,0,0,0,0,84,73,27,3,43,11,11,7,4,0,0,0,0,0,99122
32781,885,48,380,329,89,39,26,7,3,0,0,3,4,0,0,0,0,4,0,0,4,19,8,0,8,0,11,0,0,0,0,11,0,0,11,99123
32782,242,40,68,85,39,10,4,0,0,0,0,0,0,0,0,0,0,0,0,0,0,4,4,0,0,4,0,0,0,0,0,0,0,0,0,99124
32783,395,11,139,161,57,27,12,8,8,0,0,8,0,0,0,0,0,0,0,0,0,4,4,0,0,4,0,0,0,0,0,0,0,0,0,99125
32784,846,66,374,332,60,14,30,16,0,0,0,0,16,0,0,0,0,16,16,0,0,14,14,0,0,14,0,0,0,0,0,0,0,0,0,99126
32785,270,14,59,104,72,21,20,14,14,4,0,10,0,0,0,0,0,0,0,0,0,6,6,3,0,3,0,0,0,0,0,0,0,0,0,99128
32786,523,69,201,190,37,26,69,44,40,3,0,37,4,4,0,0,4,0,0,0,0,25,2,2,0,0,23,23,0,23,0,0,0,0,0,99129
32787,575,31,172,233,85,54,40,26,23,16,0,7,3,1,0,0,1,2,0,2,0,14,8,5,0,3,6,0,0,0,0,6,0,6,0,99130
32788,140,6,39,63,18,14,4,4,4,0,0,4,0,0,0,0,0,0,0,0,0,0,0,0,0,0,0,0,0,0,0,0,0,0,0,99131
32789,1266,131,421,522,157,35,34,12,6,0,3,3,6,6,0,3,3,0,0,0,0,22,8,0,0,8,14,14,14,0,0,0,0,0,0,99133
32790,406,15,121,142,91,37,37,24,18,4,6,8,6,6,6,0,0,0,0,0,0,13,11,3,0,8,2,2,2,0,0,0,0,0,0,99134
32791,190,26,39,79,37,9,3,3,3,0,0,3,0,0,0,0,0,0,0,0,0,0,0,0,0,0,0,0,0,0,0,0,0,0,0,99135
32792,44,8,16,13,7,0,0,0,0,0,0,0,0,0,0,0,0,0,0,0,0,0,0,0,0,0,0,0,0,0,0,0,0,0,0,99136
32793,233,17,78,103,27,8,14,4,4,0,0,4,0,0,0,0,0,0,0,0,0,10,10,6,0,4,0,0,0,0,0,0,0,0,0,99137
32794,833,123,261,289,141,19,84,61,54,0,0,54,7,7,0,0,7,0,0,0,0,23,18,0,3,15,5,5,0,5,0,0,0,0,0,99138
32795,945,51,370,430,62,32,109,65,65,13,0,52,0,0,0,0,0,0,0,0,0,44,43,5,7,31,1,1,0,0,1,0,0,0,0,99139
32796,250,50,76,104,13,7,11,8,8,3,0,5,0,0,0,0,0,0,0,0,0,3,3,0,0,3,0,0,0,0,0,0,0,0,0,99140
32797,3978,247,1629,1402,557,143,228,144,103,43,24,36,41,32,19,13,0,9,0,0,9,84,84,4,3,77,0,0,0,0,0,0,0,0,0,99141
32798,433,43,135,169,64,22,25,21,12,4,0,8,9,9,1,0,8,0,0,0,0,4,4,2,0,2,0,0,0,0,0,0,0,0,0,99143
32799,34,0,4,11,15,4,0,0,0,0,0,0,0,0,0,0,0,0,0,0,0,0,0,0,0,0,0,0,0,0,0,0,0,0,0,99144
32800,32,0,14,12,0,6,0,0,0,0,0,0,0,0,0,0,0,0,0,0,0,0,0,0,0,0,0,0,0,0,0,0,0,0,0,99146
32801,118,0,64,47,7,0,8,8,8,0,0,8,0,0,0,0,0,0,0,0,0,0,0,0,0,0,0,0,0,0,0,0,0,0,0,99147
32802,1695,85,453,747,263,147,114,71,64,6,19,39,7,0,0,0,0,7,0,7,0,43,32,15,0,17,11,11,11,0,0,0,0,0,0,99148
32803,149,12,60,66,5,6,4,1,1,0,0,1,0,0,0,0,0,0,0,0,0,3,3,0,0,3,0,0,0,0,0,0,0,0,0,99149
32804,181,18,60,56,30,17,35,28,28,17,0,11,0,0,0,0,0,0,0,0,0,7,3,0,0,3,4,4,0,4,0,0,0,0,0,99150
32805,123,22,60,24,15,2,10,6,4,0,0,4,2,2,2,0,0,0,0,0,0,4,4,2,0,2,0,0,0,0,0,0,0,0,0,99151
32806,137,2,57,57,14,7,0,0,0,0,0,0,0,0,0,0,0,0,0,0,0,0,0,0,0,0,0,0,0,0,0,0,0,0,0,99152
32807,343,43,82,162,44,12,2,0,0,0,0,0,0,0,0,0,0,0,0,0,0,2,2,2,0,0,0,0,0,0,0,0,0,0,0,99153
32808,14,0,2,5,7,0,1,1,1,1,0,0,0,0,0,0,0,0,0,0,0,0,0,0,0,0,0,0,0,0,0,0,0,0,0,99154
32809,600,86,240,234,26,14,76,36,27,0,0,27,9,9,0,3,6,0,0,0,0,40,40,6,0,34,0,0,0,0,0,0,0,0,0,99155
32810,6032,654,2007,2335,729,307,449,313,122,31,15,76,191,104,95,0,9,87,0,0,87,136,126,63,12,51,10,10,10,0,0,0,0,0,0,99156
32811,565,56,184,234,68,23,58,35,32,15,0,17,3,3,0,0,3,0,0,0,0,23,23,9,0,14,0,0,0,0,0,0,0,0,0,99157
32812,501,25,146,199,92,39,36,16,14,4,0,10,2,2,1,1,0,0,0,0,0,20,20,5,0,15,0,0,0,0,0,0,0,0,0,99158
32813,1074,82,354,416,174,48,41,18,18,6,0,12,0,0,0,0,0,0,0,0,0,23,23,6,0,17,0,0,0,0,0,0,0,0,0,99159
32814,112,16,60,33,0,3,0,0,0,0,0,0,0,0,0,0,0,0,0,0,0,0,0,0,0,0,0,0,0,0,0,0,0,0,0,99160
32815,943,24,195,356,183,185,57,25,25,2,0,23,0,0,0,0,0,0,0,0,0,32,32,4,0,28,0,0,0,0,0,0,0,0,0,99161
32816,12077,315,1319,2486,3894,4063,6317,2550,2531,528,113,1890,19,6,6,0,0,13,0,0,13,3767,3757,956,113,2688,10,10,10,0,0,0,0,0,0,99163
32817,1,1,0,0,0,0,0,0,0,0,0,0,0,0,0,0,0,0,0,0,0,0,0,0,0,0,0,0,0,0,0,0,0,0,0,99164
32818,2608,353,828,1046,245,136,183,89,62,0,0,62,27,17,0,17,0,10,0,0,10,94,73,0,0,73,21,19,13,0,6,2,0,0,2,99166
32819,488,77,127,197,46,41,19,4,4,0,0,4,0,0,0,0,0,0,0,0,0,15,15,3,1,11,0,0,0,0,0,0,0,0,0,99167
32820,1903,172,597,749,257,128,126,70,54,9,0,45,16,16,0,16,0,0,0,0,0,56,56,19,0,37,0,0,0,0,0,0,0,0,0,99169
32821,732,25,221,319,143,24,29,23,23,0,0,23,0,0,0,0,0,0,0,0,0,6,6,2,0,4,0,0,0,0,0,0,0,0,0,99170
32822,693,36,228,238,151,40,39,17,13,0,0,13,4,4,0,0,4,0,0,0,0,22,22,3,4,15,0,0,0,0,0,0,0,0,0,99171
32823,1039,89,348,545,38,19,127,80,80,9,0,71,0,0,0,0,0,0,0,0,0,47,47,24,0,23,0,0,0,0,0,0,0,0,0,99173
32824,50,1,13,19,13,4,2,0,0,0,0,0,0,0,0,0,0,0,0,0,0,2,2,0,0,2,0,0,0,0,0,0,0,0,0,99174
32825,132,13,39,61,19,0,4,0,0,0,0,0,0,0,0,0,0,0,0,0,0,4,4,0,0,4,0,0,0,0,0,0,0,0,0,99176
32826,405,8,116,185,58,38,46,14,10,2,0,8,4,4,4,0,0,0,0,0,0,32,22,0,4,18,10,10,0,0,10,0,0,0,0,99179
32827,791,87,315,254,112,23,45,29,6,2,0,4,23,23,0,0,23,0,0,0,0,16,16,0,0,16,0,0,0,0,0,0,0,0,0,99180
32828,1199,80,368,496,203,52,116,71,63,10,0,53,8,3,0,3,0,5,0,0,5,45,45,0,0,45,0,0,0,0,0,0,0,0,0,99181
32829,842,54,380,305,75,28,52,14,14,5,0,9,0,0,0,0,0,0,0,0,0,38,34,10,0,24,4,4,0,4,0,0,0,0,0,99185
32830,9141,1157,2551,3303,1193,937,505,215,169,25,9,135,46,46,16,0,30,0,0,0,0,290,266,173,0,93,24,12,12,0,0,12,0,0,12,99201
32831,11572,1352,3232,4339,1708,941,2590,1186,1076,231,93,752,110,68,0,36,32,42,0,6,36,1404,1341,294,122,925,63,50,29,0,21,13,0,0,13,99202
32832,14581,362,2013,3855,4449,3902,687,383,350,50,40,260,33,20,0,0,20,13,0,0,13,304,182,32,0,150,122,107,27,23,57,15,0,7,8,99203
32833,4926,332,868,1542,1219,965,232,94,94,58,0,36,0,0,0,0,0,0,0,0,0,138,96,10,22,64,42,42,42,0,0,0,0,0,0,99204
32834,28138,2251,8113,11904,3924,1946,1748,863,663,234,56,373,200,118,96,0,22,82,8,30,44,885,715,163,119,433,170,136,88,41,7,34,0,0,34,99205
32835,24167,1665,6780,10187,4186,1349,1835,1004,754,133,85,536,250,141,37,81,23,109,76,0,33,831,678,247,85,346,153,116,49,63,4,37,14,12,11,99206
32836,18774,2791,6532,6986,1740,725,1399,743,555,95,168,292,188,171,129,27,15,17,0,0,17,656,577,174,57,346,79,52,52,0,0,27,18,9,0,99207
32837,32984,1931,7713,12931,6533,3876,2610,1180,1002,291,33,678,178,152,61,80,11,26,8,0,18,1430,1245,320,180,745,185,148,71,32,45,37,0,0,37,99208
32838,13533,1132,4079,5185,2258,879,1237,655,521,105,127,289,134,118,6,32,80,16,6,0,10,582,465,163,20,282,117,40,4,0,36,77,0,36,41,99212
32839,15679,1303,4476,6867,2302,731,907,390,287,40,43,204,103,62,53,9,0,41,24,9,8,517,422,102,38,282,95,34,26,8,0,61,0,11,50,99216
32840,11551,1155,3405,4680,1525,786,810,439,333,58,18,257,106,69,56,8,5,37,29,8,0,371,287,158,12,117,84,65,48,0,17,19,19,0,0,99217
32841,8842,379,2606,3389,1521,947,1579,728,662,43,65,554,66,41,35,6,0,25,0,0,25,851,754,267,53,434,97,97,97,0,0,0,0,0,0,99218
32842,20718,998,3266,6803,5446,4205,1314,756,686,121,28,537,70,57,16,35,6,13,0,8,5,558,504,144,52,308,54,39,0,30,9,15,7,0,8,99223
32843,13946,812,3093,5188,2989,1864,832,487,418,134,15,269,69,52,52,0,0,17,0,2,15,345,329,45,70,214,16,1,0,1,0,15,15,0,0,99224
32844,39902,11552,10128,11909,4158,2155,4342,2190,1662,319,107,1236,528,388,246,125,17,140,81,21,38,2152,1800,410,75,1315,352,211,74,54,83,141,41,16,84,99301
32845,5534,900,1520,2058,715,341,592,339,301,33,17,251,38,17,10,7,0,21,0,0,21,253,190,28,0,162,63,63,0,0,63,0,0,0,0,99320
32846,311,171,67,45,0,28,72,72,72,0,0,72,0,0,0,0,0,0,0,0,0,0,0,0,0,0,0,0,0,0,0,0,0,0,0,99321
32847,172,18,61,42,38,13,3,0,0,0,0,0,0,0,0,0,0,0,0,0,0,3,3,0,0,3,0,0,0,0,0,0,0,0,0,99322
32848,2301,238,599,953,370,141,203,90,90,0,9,81,0,0,0,0,0,0,0,0,0,113,109,24,0,85,4,4,0,4,0,0,0,0,0,99323
32849,5467,435,1062,2245,1062,663,758,357,334,105,22,207,23,0,0,0,0,23,0,0,23,401,401,229,8,164,0,0,0,0,0,0,0,0,0,99324
32850,3419,866,1072,1226,169,86,264,186,160,8,7,145,26,0,0,0,0,26,19,0,7,78,78,0,0,78,0,0,0,0,0,0,0,0,0,99326
32851,2812,410,774,1166,310,152,245,156,122,24,15,83,34,34,26,8,0,0,0,0,0,89,67,14,3,50,22,22,22,0,0,0,0,0,0,99328
32852,123,17,38,54,12,2,0,0,0,0,0,0,0,0,0,0,0,0,0,0,0,0,0,0,0,0,0,0,0,0,0,0,0,0,0,99329
32853,472,81,145,133,113,0,82,75,75,21,28,26,0,0,0,0,0,0,0,0,0,7,7,0,0,7,0,0,0,0,0,0,0,0,0,99330
32854,39,0,25,12,0,2,0,0,0,0,0,0,0,0,0,0,0,0,0,0,0,0,0,0,0,0,0,0,0,0,0,0,0,0,0,99333
32855,234,21,96,90,16,11,10,0,0,0,0,0,0,0,0,0,0,0,0,0,0,10,10,5,0,5,0,0,0,0,0,0,0,0,0,99335
32856,29676,5081,8532,10834,3337,1892,2524,1348,1030,142,0,888,318,184,35,11,138,134,19,14,101,1176,994,157,118,719,182,157,123,0,34,25,19,6,0,99336
32857,19733,2109,6077,7482,2784,1281,1641,757,547,45,54,448,210,167,161,0,6,43,32,0,11,884,718,292,11,415,166,128,101,14,13,38,11,0,27,99337
32858,7899,328,1501,2441,2260,1369,649,263,220,123,0,97,43,43,43,0,0,0,0,0,0,386,365,59,15,291,21,21,21,0,0,0,0,0,0,99338
32859,493,19,171,214,59,30,74,33,33,0,0,33,0,0,0,0,0,0,0,0,0,41,41,13,0,28,0,0,0,0,0,0,0,0,0,99341
32860,1522,678,299,447,61,37,160,92,71,12,0,59,21,21,21,0,0,0,0,0,0,68,58,10,3,45,10,10,0,10,0,0,0,0,0,99343
32861,8834,3661,2225,1869,716,363,1183,611,331,8,11,312,280,168,97,29,42,112,105,0,7,572,367,58,43,266,205,104,59,29,16,101,48,43,10,99344
32862,108,30,32,30,16,0,21,15,10,0,0,10,5,5,5,0,0,0,0,0,0,6,2,0,0,2,4,0,0,0,0,4,0,0,4,99345
32863,243,108,41,75,19,0,40,5,5,0,0,5,0,0,0,0,0,0,0,0,0,35,0,0,0,0,35,0,0,0,0,35,35,0,0,99346
32864,1791,64,549,769,321,88,93,58,57,10,0,47,1,0,0,0,0,1,1,0,0,35,35,0,33,2,0,0,0,0,0,0,0,0,0,99347
32865,884,385,180,194,88,37,91,44,39,16,0,23,5,5,0,5,0,0,0,0,0,47,37,5,0,32,10,0,0,0,0,10,0,0,10,99348
32866,3785,2222,890,371,250,52,373,233,217,14,10,193,16,3,3,0,0,13,0,0,13,140,98,38,0,60,42,0,0,0,0,42,42,0,0,99349
32867,8444,2366,1891,2678,978,531,704,372,244,105,3,136,128,78,55,0,23,50,50,0,0,332,312,72,27,213,20,16,0,0,16,4,3,0,1,99350
32868,18675,782,3505,6138,5133,3117,1630,809,711,197,66,448,98,88,56,0,32,10,0,0,10,821,756,202,23,531,65,44,22,0,22,21,0,0,21,99352
32869,9230,558,1772,3711,2314,875,796,469,406,111,31,264,63,63,38,25,0,0,0,0,0,327,311,113,0,198,16,16,9,0,7,0,0,0,0,99353
32870,14398,704,2693,4967,3074,2960,1272,844,668,149,17,502,176,157,62,11,84,19,0,0,19,428,325,111,14,200,103,89,84,0,5,14,0,0,14,99354
32871,196,57,50,67,16,6,5,5,5,0,0,5,0,0,0,0,0,0,0,0,0,0,0,0,0,0,0,0,0,0,0,0,0,0,0,99356
32872,1782,772,302,528,141,39,286,231,187,91,0,96,44,25,0,10,15,19,19,0,0,55,41,20,0,21,14,0,0,0,0,14,0,0,14,99357
32873,65,7,26,17,15,0,0,0,0,0,0,0,0,0,0,0,0,0,0,0,0,0,0,0,0,0,0,0,0,0,0,0,0,0,0,99359
32874,757,112,190,258,133,64,105,78,74,5,8,61,4,4,4,0,0,0,0,0,0,27,27,4,0,23,0,0,0,0,0,0,0,0,0,99360
32875,1181,88,331,450,186,126,76,46,44,0,0,44,2,2,2,0,0,0,0,0,0,30,29,2,0,27,1,0,0,0,0,1,0,0,1,99361
32876,27434,3272,6310,10808,4186,2858,2941,1371,1179,436,71,672,192,159,76,7,76,33,14,0,19,1570,1385,604,27,754,185,42,20,22,0,143,0,18,125,99362
32877,20,10,10,0,0,0,0,0,0,0,0,0,0,0,0,0,0,0,0,0,0,0,0,0,0,0,0,0,0,0,0,0,0,0,0,99363
32878,239,21,63,129,19,7,12,5,3,2,0,1,2,2,2,0,0,0,0,0,0,7,5,0,0,5,2,2,2,0,0,0,0,0,0,99371
32879,188,0,76,103,0,9,0,0,0,0,0,0,0,0,0,0,0,0,0,0,0,0,0,0,0,0,0,0,0,0,0,0,0,0,0,99401
32880,1161,85,357,472,170,77,89,41,33,25,4,4,8,8,0,8,0,0,0,0,0,48,41,12,0,29,7,7,0,7,0,0,0,0,0,99402
32881,14031,1506,4819,5240,1630,836,1014,540,499,69,64,366,41,40,19,0,21,1,0,0,1,474,404,175,21,208,70,45,22,10,13,25,25,0,0,99403
32882,11671,1457,2745,3719,2063,1687,504,293,264,29,27,208,29,25,8,0,17,4,0,0,4,211,177,54,20,103,34,34,16,7,11,0,0,0,0,99501
32883,15756,939,3281,6544,3309,1683,987,471,384,94,32,258,87,52,27,0,25,35,14,21,0,516,464,259,35,170,52,52,52,0,0,0,0,0,0,99502
32884,9396,1640,2615,3118,1395,628,510,224,178,70,0,108,46,46,46,0,0,0,0,0,0,286,243,89,66,88,43,25,25,0,0,18,0,0,18,99503
32885,26013,1901,7709,9861,4342,2200,2186,1001,836,246,125,465,165,143,104,38,1,22,0,22,0,1185,850,316,97,437,335,295,191,0,104,40,7,0,33,99504
32886,2266,19,425,1328,327,167,379,337,16,16,0,0,321,321,321,0,0,0,0,0,0,42,33,0,0,33,9,3,0,0,3,6,0,0,6,99505
32887,3013,31,503,1749,474,256,448,296,184,30,24,130,112,101,101,0,0,11,11,0,0,152,88,55,0,33,64,48,22,0,26,16,16,0,0,99506
32888,24483,1767,5030,8950,5530,3206,2152,1301,1038,213,285,540,263,194,88,63,43,69,41,0,28,851,641,262,64,315,210,142,100,9,33,68,0,30,38,99507
32889,21244,2700,5696,7650,2971,2227,2963,1425,1047,306,78,663,378,265,146,14,105,113,0,62,51,1538,1237,299,134,804,301,95,57,17,21,206,65,0,141,99508
32890,287,19,87,95,74,12,0,0,0,0,0,0,0,0,0,0,0,0,0,0,0,0,0,0,0,0,0,0,0,0,0,0,0,0,0,99510
32891,0,0,0,0,0,0,0,0,0,0,0,0,0,0,0,0,0,0,0,0,0,0,0,0,0,0,0,0,0,0,0,0,0,0,0,99513
32892,14743,1226,3972,5126,2921,1498,1334,726,611,237,29,345,115,100,59,20,21,15,0,15,0,608,557,182,23,352,51,51,43,0,8,0,0,0,0,99515
32893,14139,339,1982,4007,4952,2859,943,538,485,133,16,336,53,10,0,0,10,43,42,0,1,405,393,162,28,203,12,12,12,0,0,0,0,0,0,99516
32894,11251,570,2598,3922,2763,1398,801,399,305,56,0,249,94,47,29,0,18,47,47,0,0,402,309,100,19,190,93,93,45,25,23,0,0,0,0,99517
32895,7001,484,1877,2713,1596,331,571,286,224,56,0,168,62,62,8,54,0,0,0,0,0,285,250,122,14,114,35,28,9,4,15,7,0,0,7,99518
32896,816,35,166,456,154,5,0,0,0,0,0,0,0,0,0,0,0,0,0,0,0,0,0,0,0,0,0,0,0,0,0,0,0,0,0,99519
32897,243,0,16,77,118,32,0,0,0,0,0,0,0,0,0,0,0,0,0,0,0,0,0,0,0,0,0,0,0,0,0,0,0,0,0,99540
32898,83,2,33,39,1,8,0,0,0,0,0,0,0,0,0,0,0,0,0,0,0,0,0,0,0,0,0,0,0,0,0,0,0,0,0,99546
32899,50,4,27,13,0,6,4,2,2,0,0,2,0,0,0,0,0,0,0,0,0,2,2,0,0,2,0,0,0,0,0,0,0,0,0,99547
32900,36,8,5,20,1,2,1,1,1,1,0,0,0,0,0,0,0,0,0,0,0,0,0,0,0,0,0,0,0,0,0,0,0,0,0,99548
32901,41,6,19,7,4,5,12,8,6,0,0,6,2,2,0,0,2,0,0,0,0,4,2,0,0,2,2,2,2,0,0,0,0,0,0,99549
32902,163,19,51,75,2,16,28,0,0,0,0,0,0,0,0,0,0,0,0,0,0,28,21,2,0,19,7,0,0,0,0,7,0,0,7,99550
32903,311,64,112,107,17,11,48,27,17,0,3,14,10,1,0,1,0,9,0,3,6,21,15,0,0,15,6,4,4,0,0,2,0,0,2,99551
32904,202,34,91,69,1,7,15,5,2,2,0,0,3,0,0,0,0,3,0,0,3,10,7,0,1,6,3,1,0,0,1,2,0,0,2,99552
32905,831,256,303,188,84,0,10,10,0,0,0,0,10,10,10,0,0,0,0,0,0,0,0,0,0,0,0,0,0,0,0,0,0,0,0,99553
32906,274,82,109,66,15,2,61,26,18,0,3,15,8,2,0,0,2,6,2,2,2,35,18,0,0,18,17,10,5,0,5,7,2,2,3,99554
32907,114,23,30,48,13,0,28,23,20,0,6,14,3,0,0,0,0,3,0,0,3,5,3,0,0,3,2,2,2,0,0,0,0,0,0,99555
32908,2004,164,674,861,209,96,118,61,36,19,2,15,25,10,0,10,0,15,0,15,0,57,37,5,0,32,20,11,0,7,4,9,9,0,0,99556
32909,385,57,178,110,24,16,40,16,13,0,0,13,3,3,3,0,0,0,0,0,0,24,13,4,0,9,11,7,0,0,7,4,0,0,4,99557
32910,50,8,17,21,4,0,4,2,2,0,0,2,0,0,0,0,0,0,0,0,0,2,2,0,0,2,0,0,0,0,0,0,0,0,0,99558
32911,4319,580,1568,1316,576,279,680,359,282,31,0,251,77,13,2,11,0,64,13,0,51,321,244,113,0,131,77,51,4,29,18,26,17,0,9,99559
32912,214,56,108,45,3,2,44,20,17,0,0,17,3,0,0,0,0,3,0,0,3,24,14,0,0,14,10,6,2,4,0,4,0,0,4,99561
32913,448,90,217,119,22,0,104,49,32,1,0,31,17,17,8,6,3,0,0,0,0,55,47,0,0,47,8,2,0,0,2,6,3,3,0,99563
32914,55,7,12,29,5,2,16,12,12,1,0,11,0,0,0,0,0,0,0,0,0,4,0,0,0,0,4,0,0,0,0,4,0,0,4,99564
32915,49,8,14,13,10,4,10,0,0,0,0,0,0,0,0,0,0,0,0,0,0,10,10,2,0,8,0,0,0,0,0,0,0,0,0,99565
32916,135,29,47,22,37,0,28,20,5,5,0,0,15,15,0,0,15,0,0,0,0,8,8,0,0,8,0,0,0,0,0,0,0,0,0,99566
32917,6259,343,1556,2267,1296,797,684,305,255,45,52,158,50,50,17,33,0,0,0,0,0,379,293,55,0,238,86,86,76,0,10,0,0,0,0,99567
32918,174,18,71,45,12,28,0,0,0,0,0,0,0,0,0,0,0,0,0,0,0,0,0,0,0,0,0,0,0,0,0,0,0,0,0,99568
32919,44,11,7,26,0,0,22,11,5,0,0,5,6,0,0,0,0,6,0,0,6,11,8,2,0,6,3,3,3,0,0,0,0,0,0,99569
32920,82,13,42,17,10,0,4,0,0,0,0,0,0,0,0,0,0,0,0,0,0,4,4,0,0,4,0,0,0,0,0,0,0,0,0,99571
32921,202,0,78,69,26,29,10,10,10,10,0,0,0,0,0,0,0,0,0,0,0,0,0,0,0,0,0,0,0,0,0,0,0,0,0,99572
32922,487,31,104,207,89,56,49,19,8,0,0,8,11,11,8,0,3,0,0,0,0,30,24,1,0,23,6,0,0,0,0,6,0,0,6,99573
32923,1896,238,510,603,331,214,91,71,44,2,0,42,27,27,27,0,0,0,0,0,0,20,20,2,18,0,0,0,0,0,0,0,0,0,0,99574
32924,42,6,18,18,0,0,16,8,3,1,0,2,5,1,0,0,1,4,0,0,4,8,4,0,0,4,4,4,4,0,0,0,0,0,0,99575
32925,1432,93,407,545,232,155,135,64,57,3,0,54,7,7,7,0,0,0,0,0,0,71,59,0,0,59,12,12,6,0,6,0,0,0,0,99576
32926,16717,591,2750,6140,4682,2554,1960,737,608,186,20,402,129,129,54,36,39,0,0,0,0,1223,1021,150,63,808,202,92,43,0,49,110,82,21,7,99577
32927,158,60,59,34,4,1,21,15,15,3,0,12,0,0,0,0,0,0,0,0,0,6,3,0,0,3,3,2,0,0,2,1,0,1,0,99578
32928,47,7,34,4,2,0,0,0,0,0,0,0,0,0,0,0,0,0,0,0,0,0,0,0,0,0,0,0,0,0,0,0,0,0,0,99579
32929,67,18,19,21,4,5,19,8,3,0,0,3,5,5,5,0,0,0,0,0,0,11,11,0,0,11,0,0,0,0,0,0,0,0,0,99580
32930,411,62,188,123,22,16,79,42,31,4,0,27,11,9,2,6,1,2,0,0,2,37,25,0,7,18,12,8,4,0,4,4,0,0,4,99581
32931,13,0,8,3,1,1,2,2,0,0,0,0,2,0,0,0,0,2,2,0,0,0,0,0,0,0,0,0,0,0,0,0,0,0,0,99583
32932,161,38,79,42,2,0,41,23,18,0,0,18,5,5,5,0,0,0,0,0,0,18,15,0,0,15,3,3,2,1,0,0,0,0,0,99585
32933,477,74,152,145,58,48,7,0,0,0,0,0,0,0,0,0,0,0,0,0,0,7,7,0,0,7,0,0,0,0,0,0,0,0,0,99586
32934,1701,15,341,616,484,245,58,34,34,34,0,0,0,0,0,0,0,0,0,0,0,24,24,24,0,0,0,0,0,0,0,0,0,0,0,99587
32935,617,65,163,229,82,78,47,41,31,6,0,25,10,10,7,3,0,0,0,0,0,6,6,0,0,6,0,0,0,0,0,0,0,0,0,99588
32936,161,62,77,22,0,0,16,6,6,0,0,6,0,0,0,0,0,0,0,0,0,10,4,0,0,4,6,6,3,0,3,0,0,0,0,99589
32937,87,33,36,18,0,0,15,4,2,0,0,2,2,0,0,0,0,2,0,0,2,11,11,0,0,11,0,0,0,0,0,0,0,0,0,99590
32938,60,17,27,9,7,0,0,0,0,0,0,0,0,0,0,0,0,0,0,0,0,0,0,0,0,0,0,0,0,0,0,0,0,0,0,99591
32939,113,10,65,34,2,2,19,8,5,0,0,5,3,3,0,3,0,0,0,0,0,11,2,2,0,0,9,9,6,3,0,0,0,0,0,99602
32940,6705,507,1619,2507,1360,712,502,293,220,39,7,174,73,57,43,0,14,16,0,13,3,209,158,53,5,100,51,42,25,7,10,9,0,0,9,99603
32941,499,136,255,101,7,0,81,44,27,0,0,27,17,8,0,4,4,9,0,2,7,37,26,0,0,26,11,2,0,0,2,9,5,2,2,99604
32942,86,0,33,20,33,0,0,0,0,0,0,0,0,0,0,0,0,0,0,0,0,0,0,0,0,0,0,0,0,0,0,0,0,0,0,99605
32943,199,20,64,81,18,16,48,12,11,0,0,11,1,1,1,0,0,0,0,0,0,36,18,0,0,18,18,18,14,2,2,0,0,0,0,99606
32944,97,25,36,34,0,2,14,5,1,0,0,1,4,4,0,4,0,0,0,0,0,9,4,0,0,4,5,5,3,0,2,0,0,0,0,99607
32945,267,89,136,37,5,0,30,14,2,0,0,2,12,0,0,0,0,12,0,2,10,16,11,0,0,11,5,1,0,0,1,4,0,0,4,99609
32946,1646,56,539,628,254,169,161,75,66,21,0,45,9,9,0,4,5,0,0,0,0,86,62,13,0,49,24,20,5,15,0,4,4,0,0,99610
32947,10432,730,3603,4006,1397,696,846,510,456,169,32,255,54,54,28,12,14,0,0,0,0,336,256,56,23,177,80,80,50,30,0,0,0,0,0,99611
32948,638,82,287,148,111,10,36,20,17,3,0,14,3,3,3,0,0,0,0,0,0,16,12,0,0,12,4,4,4,0,0,0,0,0,0,99612
32949,205,19,54,84,21,27,12,9,7,4,0,3,2,2,2,0,0,0,0,0,0,3,3,0,0,3,0,0,0,0,0,0,0,0,0,99613
32950,326,74,173,60,19,0,37,29,27,2,0,25,2,2,2,0,0,0,0,0,0,8,6,1,0,5,2,2,0,0,2,0,0,0,0,99614
32951,7811,732,2031,3426,1169,453,821,574,293,80,17,196,281,189,146,20,23,92,29,22,41,247,219,148,9,62,28,16,16,0,0,12,12,0,0,99615
32952,275,62,146,52,6,9,39,18,14,0,0,14,4,2,2,0,0,2,0,0,2,21,14,0,0,14,7,5,2,2,1,2,0,2,0,99620
32953,332,76,154,93,9,0,61,35,29,0,0,29,6,4,2,0,2,2,0,0,2,26,18,2,0,16,8,6,1,0,5,2,0,0,2,99621
32954,163,37,74,52,0,0,21,9,7,0,0,7,2,0,0,0,0,2,0,0,2,12,12,0,0,12,0,0,0,0,0,0,0,0,0,99622
32955,54,7,17,28,2,0,0,0,0,0,0,0,0,0,0,0,0,0,0,0,0,0,0,0,0,0,0,0,0,0,0,0,0,0,0,99624
32956,49,2,19,27,0,1,15,5,5,3,0,2,0,0,0,0,0,0,0,0,0,10,5,0,0,5,5,2,2,0,0,3,0,0,3,99625
32957,148,24,95,22,4,3,16,5,5,0,0,5,0,0,0,0,0,0,0,0,0,11,11,0,0,11,0,0,0,0,0,0,0,0,0,99626
32958,248,16,93,96,27,16,26,10,3,0,0,3,7,7,7,0,0,0,0,0,0,16,7,3,0,4,9,6,4,0,2,3,0,0,3,99627
32959,327,71,131,92,30,3,46,30,23,0,0,23,7,4,0,4,0,3,0,0,3,16,8,0,0,8,8,8,5,3,0,0,0,0,0,99628
32960,126,28,56,33,7,2,10,7,4,0,0,4,3,3,0,3,0,0,0,0,0,3,3,0,0,3,0,0,0,0,0,0,0,0,0,99630
32961,349,34,169,23,106,17,0,0,0,0,0,0,0,0,0,0,0,0,0,0,0,0,0,0,0,0,0,0,0,0,0,0,0,0,0,99631
32962,334,95,126,96,12,5,61,23,11,0,0,11,12,11,4,3,4,1,0,0,1,38,34,2,0,32,4,3,0,1,2,1,1,0,0,99632
32963,381,24,97,195,46,19,42,19,19,1,0,18,0,0,0,0,0,0,0,0,0,23,19,8,0,11,4,4,4,0,0,0,0,0,0,99633
32964,162,34,84,44,0,0,20,8,7,0,0,7,1,0,0,0,0,1,1,0,0,12,10,0,0,10,2,0,0,0,0,2,2,0,0,99634
32965,259,73,105,73,8,0,49,21,18,0,2,16,3,3,0,0,3,0,0,0,0,28,23,2,0,21,5,3,0,0,3,2,0,0,2,99636
32966,325,95,131,80,14,5,53,32,18,5,0,13,14,3,3,0,0,11,0,6,5,21,21,3,0,18,0,0,0,0,0,0,0,0,0,99637
32967,24,2,16,5,1,0,1,1,1,0,0,1,0,0,0,0,0,0,0,0,0,0,0,0,0,0,0,0,0,0,0,0,0,0,0,99638
32968,694,29,228,264,119,54,32,21,21,5,0,16,0,0,0,0,0,0,0,0,0,11,11,0,11,0,0,0,0,0,0,0,0,0,0,99639
32969,102,14,54,30,4,0,8,3,3,0,0,3,0,0,0,0,0,0,0,0,0,5,5,3,2,0,0,0,0,0,0,0,0,0,0,99640
32970,173,45,62,55,6,5,23,8,5,0,0,5,3,0,0,0,0,3,0,0,3,15,8,2,0,6,7,2,0,0,2,5,2,1,2,99641
32971,151,60,29,50,3,9,18,10,4,1,0,3,6,3,1,2,0,3,0,0,3,8,6,1,0,5,2,2,0,0,2,0,0,0,0,99643
32972,185,48,69,52,9,7,15,3,0,0,0,0,3,3,0,3,0,0,0,0,0,12,9,0,2,7,3,3,0,0,3,0,0,0,0,99644
32973,16568,1001,4359,6737,2843,1628,1570,845,645,232,36,377,200,178,113,9,56,22,21,0,1,725,609,173,46,390,116,86,46,16,24,30,16,4,10,99645
32974,16,5,2,6,3,0,6,2,2,0,0,2,0,0,0,0,0,0,0,0,0,4,4,4,0,0,0,0,0,0,0,0,0,0,0,99647
32975,50,13,31,4,0,2,15,6,0,0,0,0,6,6,0,0,6,0,0,0,0,9,7,0,0,7,2,2,2,0,0,0,0,0,0,99648
32976,44,14,11,7,3,9,2,2,1,0,0,1,1,1,0,0,1,0,0,0,0,0,0,0,0,0,0,0,0,0,0,0,0,0,0,99649
32977,261,82,109,65,5,0,30,14,10,0,0,10,4,4,0,2,2,0,0,0,0,16,4,0,0,4,12,9,4,3,2,3,0,3,0,99650
32978,36,14,20,2,0,0,3,0,0,0,0,0,0,0,0,0,0,0,0,0,0,3,3,0,0,3,0,0,0,0,0,0,0,0,0,99651
32979,2714,197,871,1131,384,131,366,190,167,49,36,82,23,14,10,0,4,9,0,9,0,176,114,35,9,70,62,62,5,21,36,0,0,0,0,99652
32980,72,2,6,40,22,2,8,2,2,0,0,2,0,0,0,0,0,0,0,0,0,6,6,2,0,4,0,0,0,0,0,0,0,0,0,99653
32981,32661,2501,11148,12841,4507,1664,3138,1628,1248,343,123,782,380,232,84,69,79,148,38,33,77,1510,1237,365,49,823,273,204,113,39,52,69,9,17,43,99654
32982,335,134,137,59,2,3,35,16,10,2,0,8,6,0,0,0,0,6,0,2,4,19,13,5,0,8,6,0,0,0,0,6,0,0,6,99655
32983,17,6,6,5,0,0,7,4,4,0,0,4,0,0,0,0,0,0,0,0,0,3,3,0,0,3,0,0,0,0,0,0,0,0,0,99656
32984,146,34,61,45,4,2,31,17,10,0,0,10,7,4,0,4,0,3,0,1,2,14,8,0,0,8,6,2,1,1,0,4,0,0,4,99657
32985,349,55,151,96,29,18,65,33,23,6,0,17,10,8,7,1,0,2,0,0,2,32,19,0,3,16,13,4,0,0,4,9,0,0,9,99658
32986,159,21,77,46,10,5,24,15,15,2,3,10,0,0,0,0,0,0,0,0,0,9,7,0,0,7,2,2,0,2,0,0,0,0,0,99659
32987,400,87,163,113,23,14,58,35,2,0,0,2,33,33,26,0,7,0,0,0,0,23,17,0,0,17,6,4,0,4,0,2,0,0,2,99660
32988,894,178,383,256,68,9,51,32,14,6,0,8,18,14,13,1,0,4,1,0,3,19,9,7,0,2,10,10,10,0,0,0,0,0,0,99661
32989,194,46,96,49,3,0,54,29,17,0,0,17,12,10,2,8,0,2,2,0,0,25,25,1,0,24,0,0,0,0,0,0,0,0,0,99662
32990,376,22,111,165,27,51,16,0,0,0,0,0,0,0,0,0,0,0,0,0,0,16,16,2,0,14,0,0,0,0,0,0,0,0,0,99663
32991,3711,373,1412,1017,641,268,187,112,109,36,0,73,3,3,0,0,3,0,0,0,0,75,75,30,9,36,0,0,0,0,0,0,0,0,0,99664
32992,49,12,25,10,2,0,0,0,0,0,0,0,0,0,0,0,0,0,0,0,0,0,0,0,0,0,0,0,0,0,0,0,0,0,0,99665
32993,72,18,38,11,2,3,7,7,2,0,0,2,5,0,0,0,0,5,2,0,3,0,0,0,0,0,0,0,0,0,0,0,0,0,0,99666
32994,45,0,19,15,11,0,0,0,0,0,0,0,0,0,0,0,0,0,0,0,0,0,0,0,0,0,0,0,0,0,0,0,0,0,0,99667
32995,59,17,23,11,3,5,3,3,3,0,0,3,0,0,0,0,0,0,0,0,0,0,0,0,0,0,0,0,0,0,0,0,0,0,0,99668
32996,9332,691,2566,3786,1559,730,1018,573,401,156,52,193,172,89,52,37,0,83,59,0,24,445,391,55,36,300,54,23,13,0,10,31,0,0,31,99669
32997,51,8,13,23,5,2,1,0,0,0,0,0,0,0,0,0,0,0,0,0,0,1,1,0,0,1,0,0,0,0,0,0,0,0,0,99670
32998,227,63,93,68,0,3,46,26,18,2,0,16,8,4,2,0,2,4,0,0,4,20,12,0,0,12,8,8,0,0,8,0,0,0,0,99671
32999,2265,127,856,860,246,176,255,86,82,9,23,50,4,0,0,0,0,4,0,0,4,169,123,45,18,60,46,0,0,0,0,46,22,0,24,99672
33000,886,149,220,341,118,58,54,45,31,19,5,7,14,5,0,0,5,9,0,5,4,9,9,5,0,4,0,0,0,0,0,0,0,0,0,99674
33001,1054,115,354,322,188,75,60,38,38,19,9,10,0,0,0,0,0,0,0,0,0,22,22,10,0,12,0,0,0,0,0,0,0,0,0,99676
33002,30,6,14,8,2,0,0,0,0,0,0,0,0,0,0,0,0,0,0,0,0,0,0,0,0,0,0,0,0,0,0,0,0,0,0,99677
33003,482,155,156,136,25,10,58,25,21,0,0,21,4,4,0,0,4,0,0,0,0,33,32,4,0,28,1,0,0,0,0,1,0,0,1,99678
33004,193,70,89,32,2,0,17,9,4,0,0,4,5,2,0,2,0,3,0,2,1,8,7,0,0,7,1,1,0,0,1,0,0,0,0,99679
33005,182,79,62,35,4,2,22,14,10,0,0,10,4,4,1,0,3,0,0,0,0,8,6,0,0,6,2,0,0,0,0,2,0,0,2,99680
33006,157,34,79,36,7,1,20,10,10,2,0,8,0,0,0,0,0,0,0,0,0,10,10,0,0,10,0,0,0,0,0,0,0,0,0,99681
33007,266,8,163,60,17,18,23,5,0,0,0,0,5,0,0,0,0,5,5,0,0,18,13,0,0,13,5,0,0,0,0,5,0,0,5,99682
33008,412,30,137,203,28,14,50,26,9,0,0,9,17,0,0,0,0,17,0,0,17,24,22,12,0,10,2,2,2,0,0,0,0,0,0,99683
33009,436,46,191,119,62,18,34,14,8,0,0,8,6,5,0,1,4,1,0,0,1,20,17,9,2,6,3,3,2,1,0,0,0,0,0,99684
33010,3123,590,1085,1013,302,133,235,165,52,0,0,52,113,108,90,0,18,5,0,0,5,70,59,11,0,48,11,11,11,0,0,0,0,0,0,99685
33011,2588,113,505,1461,383,126,231,102,74,43,0,31,28,28,5,0,23,0,0,0,0,129,66,17,0,49,63,62,62,0,0,1,0,0,1,99686
33012,2021,237,623,808,258,95,118,69,53,7,6,40,16,16,0,16,0,0,0,0,0,49,49,0,0,49,0,0,0,0,0,0,0,0,0,99688
33013,396,27,122,157,69,21,23,14,12,4,1,7,2,2,0,0,2,0,0,0,0,9,9,2,0,7,0,0,0,0,0,0,0,0,0,99689
33014,155,55,63,32,1,4,24,17,16,8,0,8,1,0,0,0,0,1,1,0,0,7,6,1,0,5,1,0,0,0,0,1,0,0,1,99690
33015,47,15,21,11,0,0,2,2,0,0,0,0,2,2,0,2,0,0,0,0,0,0,0,0,0,0,0,0,0,0,0,0,0,0,0,99691
33016,124,0,73,40,11,0,0,0,0,0,0,0,0,0,0,0,0,0,0,0,0,0,0,0,0,0,0,0,0,0,0,0,0,0,0,99692
33017,184,7,57,77,35,8,9,5,4,0,0,4,1,0,0,0,0,1,0,1,0,4,4,0,0,4,0,0,0,0,0,0,0,0,0,99693
33018,1042,110,388,368,86,90,70,23,18,0,0,18,5,5,0,5,0,0,0,0,0,47,36,4,0,32,11,11,0,11,0,0,0,0,0,99694
33019,0,0,0,0,0,0,0,0,0,0,0,0,0,0,0,0,0,0,0,0,0,0,0,0,0,0,0,0,0,0,0,0,0,0,0,99695
33020,12127,1331,4057,4331,1647,761,897,492,307,37,15,255,185,147,126,0,21,38,0,16,22,405,299,144,47,108,106,81,42,0,39,25,16,0,9,99701
33021,1059,0,160,570,135,194,125,99,45,5,22,18,54,54,54,0,0,0,0,0,0,26,9,0,0,9,17,17,12,0,5,0,0,0,0,99702
33022,2643,129,592,1340,471,111,310,212,45,13,0,32,167,167,153,14,0,0,0,0,0,98,27,7,0,20,71,71,37,6,28,0,0,0,0,99703
33023,25,0,2,23,0,0,5,5,0,0,0,0,5,5,5,0,0,0,0,0,0,0,0,0,0,0,0,0,0,0,0,0,0,0,0,99704
33024,14137,1001,4233,6298,1893,712,1497,759,713,238,11,464,46,12,5,7,0,34,0,0,34,738,733,252,177,304,5,5,5,0,0,0,0,0,0,99705
33025,0,0,0,0,0,0,0,0,0,0,0,0,0,0,0,0,0,0,0,0,0,0,0,0,0,0,0,0,0,0,0,0,0,0,0,99706
33026,20855,1246,4306,7057,4128,4118,1608,800,635,241,11,383,165,130,75,0,55,35,11,24,0,808,784,288,0,496,24,10,0,0,10,14,7,0,7,99709
33027,8070,401,1694,3128,1601,1246,401,158,151,45,0,106,7,0,0,0,0,7,0,7,0,243,243,172,0,71,0,0,0,0,0,0,0,0,0,99712
33028,729,39,167,266,205,52,29,29,29,5,0,24,0,0,0,0,0,0,0,0,0,0,0,0,0,0,0,0,0,0,0,0,0,0,0,99714
33029,85,31,31,20,1,2,15,2,2,0,0,2,0,0,0,0,0,0,0,0,0,13,4,2,0,2,9,7,0,0,7,2,0,0,2,99720
33030,140,28,74,24,4,10,21,11,7,3,0,4,4,4,2,2,0,0,0,0,0,10,7,0,0,7,3,2,2,0,0,1,0,0,1,99721
33031,69,16,21,29,1,2,21,17,17,2,2,13,0,0,0,0,0,0,0,0,0,4,4,0,0,4,0,0,0,0,0,0,0,0,0,99722
33032,2380,399,822,770,198,191,266,166,112,5,23,84,54,54,44,3,7,0,0,0,0,100,61,19,14,28,39,14,13,0,1,25,0,0,25,99723
33033,72,17,29,20,3,3,2,2,2,2,0,0,0,0,0,0,0,0,0,0,0,0,0,0,0,0,0,0,0,0,0,0,0,0,0,99724
33034,37,2,5,19,9,2,0,0,0,0,0,0,0,0,0,0,0,0,0,0,0,0,0,0,0,0,0,0,0,0,0,0,0,0,0,99726
33035,215,39,133,34,9,0,58,23,10,0,0,10,13,11,2,2,7,2,0,2,0,35,29,3,0,26,6,2,1,0,1,4,4,0,0,99727
33036,150,11,52,51,31,5,10,10,6,0,0,6,4,4,0,0,4,0,0,0,0,0,0,0,0,0,0,0,0,0,0,0,0,0,0,99729
33037,107,13,38,38,10,8,4,4,4,0,0,4,0,0,0,0,0,0,0,0,0,0,0,0,0,0,0,0,0,0,0,0,0,0,0,99730
33038,0,0,0,0,0,0,0,0,0,0,0,0,0,0,0,0,0,0,0,0,0,0,0,0,0,0,0,0,0,0,0,0,0,0,0,99732
33039,51,20,22,9,0,0,3,2,0,0,0,0,2,2,0,0,2,0,0,0,0,1,0,0,0,0,1,1,0,0,1,0,0,0,0,99733
33040,1118,54,297,609,142,16,6,0,0,0,0,0,0,0,0,0,0,0,0,0,0,6,0,0,0,0,6,6,6,0,0,0,0,0,0,99734
33041,53,8,26,12,2,5,1,0,0,0,0,0,0,0,0,0,0,0,0,0,0,1,0,0,0,0,1,1,1,0,0,0,0,0,0,99736
33042,3141,98,993,1180,558,312,353,209,150,18,20,112,59,59,22,13,24,0,0,0,0,144,136,52,5,79,8,8,0,0,8,0,0,0,0,99737
33043,102,20,43,26,9,4,8,4,0,0,0,0,4,4,4,0,0,0,0,0,0,4,3,0,0,3,1,1,0,1,0,0,0,0,0,99738
33044,184,16,91,70,6,1,25,12,10,0,0,10,2,0,0,0,0,2,0,0,2,13,8,0,0,8,5,1,1,0,0,4,0,2,2,99739
33045,345,102,97,113,18,15,15,8,0,0,0,0,8,8,8,0,0,0,0,0,0,7,7,1,0,6,0,0,0,0,0,0,0,0,0,99740
33046,364,55,112,125,44,28,20,18,9,0,2,7,9,9,9,0,0,0,0,0,0,2,2,0,0,2,0,0,0,0,0,0,0,0,0,99741
33047,422,93,214,86,25,4,42,18,10,0,0,10,8,3,1,0,2,5,2,0,3,24,13,0,0,13,11,2,0,1,1,9,0,3,6,99742
33048,739,116,205,251,106,61,53,31,31,8,0,23,0,0,0,0,0,0,0,0,0,22,0,0,0,0,22,7,0,0,7,15,0,0,15,99743
33049,126,11,38,48,13,16,11,4,2,0,0,2,2,0,0,0,0,2,0,0,2,7,7,0,0,7,0,0,0,0,0,0,0,0,0,99744
33050,39,7,23,9,0,0,4,2,2,0,0,2,0,0,0,0,0,0,0,0,0,2,2,2,0,0,0,0,0,0,0,0,0,0,0,99745
33051,170,34,68,63,5,0,26,15,11,0,0,11,4,4,0,2,2,0,0,0,0,11,0,0,0,0,11,11,8,0,3,0,0,0,0,99746
33052,125,33,65,25,2,0,18,9,7,0,0,7,2,2,2,0,0,0,0,0,0,9,8,5,0,3,1,1,1,0,0,0,0,0,0,99747
33053,139,12,96,27,2,2,6,6,6,0,0,6,0,0,0,0,0,0,0,0,0,0,0,0,0,0,0,0,0,0,0,0,0,0,0,99748
33054,197,53,91,40,9,4,37,22,18,5,4,9,4,3,0,3,0,1,0,0,1,15,4,0,1,3,11,10,7,3,0,1,0,0,1,99749
33055,198,68,82,44,4,0,46,27,6,2,0,4,21,6,0,4,2,15,0,4,11,19,4,0,0,4,15,11,6,1,4,4,0,0,4,99750
33056,49,13,27,9,0,0,15,7,7,0,0,7,0,0,0,0,0,0,0,0,0,8,5,0,0,5,3,2,2,0,0,1,0,1,0,99751
33057,2066,364,677,654,189,182,213,106,72,4,24,44,34,21,0,11,10,13,6,3,4,107,82,26,8,48,25,16,11,2,3,9,0,5,4,99752
33058,116,26,53,35,2,0,30,15,9,0,0,9,6,6,0,0,6,0,0,0,0,15,8,0,0,8,7,7,5,2,0,0,0,0,0,99753
33059,64,13,29,19,1,2,3,3,3,2,0,1,0,0,0,0,0,0,0,0,0,0,0,0,0,0,0,0,0,0,0,0,0,0,0,99754
33060,288,18,34,78,145,13,14,14,0,0,0,0,14,14,14,0,0,0,0,0,0,0,0,0,0,0,0,0,0,0,0,0,0,0,0,99755
33061,52,11,19,15,7,0,13,5,5,0,0,5,0,0,0,0,0,0,0,0,0,8,8,0,0,8,0,0,0,0,0,0,0,0,0,99756
33062,13,5,1,5,2,0,3,3,3,0,0,3,0,0,0,0,0,0,0,0,0,0,0,0,0,0,0,0,0,0,0,0,0,0,0,99757
33063,120,36,49,28,7,0,15,9,4,0,0,4,5,5,3,2,0,0,0,0,0,6,6,0,4,2,0,0,0,0,0,0,0,0,0,99758
33064,142,31,57,40,12,2,13,5,5,0,0,5,0,0,0,0,0,0,0,0,0,8,1,1,0,0,7,2,0,0,2,5,0,1,4,99759
33065,649,71,218,306,49,5,71,57,45,12,0,33,12,12,0,0,12,0,0,0,0,14,14,6,0,8,0,0,0,0,0,0,0,0,0,99760
33066,218,42,136,36,4,0,40,18,10,0,0,10,8,8,1,0,7,0,0,0,0,22,8,0,0,8,14,14,6,6,2,0,0,0,0,99761
33067,2531,245,826,739,526,195,273,160,126,30,4,92,34,24,23,1,0,10,2,0,8,113,101,50,0,51,12,8,4,0,4,4,0,0,4,99762
33068,310,77,158,64,11,0,49,22,13,0,2,11,9,4,0,0,4,5,2,0,3,27,17,0,0,17,10,3,2,1,0,7,3,0,4,99763
33069,180,37,51,65,27,0,18,10,3,1,0,2,7,7,0,7,0,0,0,0,0,8,8,4,0,4,0,0,0,0,0,0,0,0,0,99764
33070,153,28,58,53,5,9,23,13,8,0,0,8,5,5,4,1,0,0,0,0,0,10,10,0,0,10,0,0,0,0,0,0,0,0,0,99765
33071,382,80,182,92,19,9,45,25,10,3,0,7,15,14,7,6,1,1,0,0,1,20,12,2,0,10,8,3,3,0,0,5,0,0,5,99766
33072,20,16,0,4,0,0,0,0,0,0,0,0,0,0,0,0,0,0,0,0,0,0,0,0,0,0,0,0,0,0,0,0,0,0,0,99767
33073,118,24,55,28,5,6,18,4,4,0,0,4,0,0,0,0,0,0,0,0,0,14,10,0,10,0,4,4,0,0,4,0,0,0,0,99768
33074,353,134,155,57,2,5,76,24,16,2,2,12,8,6,0,6,0,2,2,0,0,52,26,1,3,22,26,26,7,12,7,0,0,0,0,99769
33075,310,95,162,46,1,6,47,31,20,0,0,20,11,5,0,5,0,6,0,2,4,16,8,0,0,8,8,4,0,1,3,4,0,0,4,99770
33076,115,15,68,24,8,0,18,14,8,0,0,8,6,6,6,0,0,0,0,0,0,4,4,0,0,4,0,0,0,0,0,0,0,0,0,99771
33077,265,60,126,74,5,0,41,26,18,4,0,14,8,0,0,0,0,8,0,0,8,15,15,0,0,15,0,0,0,0,0,0,0,0,0,99772
33078,157,45,94,18,0,0,27,10,5,0,0,5,5,2,0,2,0,3,0,0,3,17,8,2,2,4,9,8,0,6,2,1,0,0,1,99773
33079,28,9,15,4,0,0,0,0,0,0,0,0,0,0,0,0,0,0,0,0,0,0,0,0,0,0,0,0,0,0,0,0,0,0,0,99774
33080,340,0,0,198,58,84,415,227,227,54,11,162,0,0,0,0,0,0,0,0,0,188,188,66,36,86,0,0,0,0,0,0,0,0,0,99775
33081,73,20,35,18,0,0,3,3,0,0,0,0,3,0,0,0,0,3,0,0,3,0,0,0,0,0,0,0,0,0,0,0,0,0,0,99776
33082,161,27,58,66,10,0,24,7,7,0,0,7,0,0,0,0,0,0,0,0,0,17,13,0,0,13,4,0,0,0,0,4,0,0,4,99777
33083,123,36,63,24,0,0,20,9,9,0,0,9,0,0,0,0,0,0,0,0,0,11,0,0,0,0,11,5,4,1,0,6,0,0,6,99778
33084,1158,164,296,549,97,52,82,42,38,7,0,31,4,2,2,0,0,2,0,0,2,40,23,3,8,12,17,10,3,0,7,7,0,0,7,99780
33085,99,44,37,12,6,0,16,16,9,0,0,9,7,7,0,7,0,0,0,0,0,0,0,0,0,0,0,0,0,0,0,0,0,0,0,99781
33086,304,82,128,91,0,3,34,19,9,4,0,5,10,3,2,1,0,7,2,0,5,15,8,4,2,2,7,5,3,2,0,2,0,0,2,99782
33087,67,25,31,8,3,0,2,0,0,0,0,0,0,0,0,0,0,0,0,0,0,2,2,0,0,2,0,0,0,0,0,0,0,0,0,99783
33088,92,18,32,31,4,7,14,13,13,0,0,13,0,0,0,0,0,0,0,0,0,1,1,0,0,1,0,0,0,0,0,0,0,0,0,99784
33089,168,37,82,42,4,3,31,20,15,9,0,6,5,3,0,0,3,2,0,2,0,11,7,3,0,4,4,4,0,2,2,0,0,0,0,99785
33090,145,32,64,43,4,2,13,7,2,0,0,2,5,5,0,4,1,0,0,0,0,6,2,0,0,2,4,4,1,0,3,0,0,0,0,99786
33091,32,4,15,9,2,2,4,0,0,0,0,0,0,0,0,0,0,0,0,0,0,4,2,0,0,2,2,0,0,0,0,2,0,0,2,99788
33092,196,52,104,24,7,9,42,24,16,2,3,11,8,5,0,2,3,3,3,0,0,18,10,2,1,7,8,7,5,2,0,1,1,0,0,99789
33093,43,0,10,31,2,0,0,0,0,0,0,0,0,0,0,0,0,0,0,0,0,0,0,0,0,0,0,0,0,0,0,0,0,0,0,99790
33094,134,39,48,37,6,4,30,20,10,0,3,7,10,3,1,2,0,7,4,0,3,10,5,0,0,5,5,3,0,0,3,2,0,0,2,99791
33095,20083,883,4496,7386,4393,2925,1781,928,755,212,71,472,173,151,62,29,60,22,0,0,22,853,758,300,15,443,95,70,70,0,0,25,0,25,0,99801
33096,327,58,105,99,32,33,35,12,7,0,0,7,5,5,0,5,0,0,0,0,0,23,9,0,0,9,14,14,12,0,2,0,0,0,0,99820
33097,1550,100,338,489,453,170,104,59,53,29,0,24,6,3,0,0,3,3,3,0,0,45,45,15,23,7,0,0,0,0,0,0,0,0,0,99824
33098,66,0,36,19,11,0,0,0,0,0,0,0,0,0,0,0,0,0,0,0,0,0,0,0,0,0,0,0,0,0,0,0,0,0,0,99825
33099,447,12,73,148,120,94,2,0,0,0,0,0,0,0,0,0,0,0,0,0,0,2,0,0,0,0,2,2,2,0,0,0,0,0,0,99826
33100,2023,81,615,717,455,155,83,59,40,5,1,34,19,8,8,0,0,11,0,11,0,24,17,17,0,0,7,7,7,0,0,0,0,0,0,99827
33101,530,90,179,190,52,19,48,26,18,2,6,10,8,3,0,3,0,5,2,0,3,22,15,3,2,10,7,7,0,7,0,0,0,0,0,99829
33102,330,45,115,111,26,33,25,7,6,0,1,5,1,1,1,0,0,0,0,0,0,18,16,8,0,8,2,2,0,2,0,0,0,0,0,99830
33103,49,4,26,6,10,3,4,4,0,0,0,0,4,4,4,0,0,0,0,0,0,0,0,0,0,0,0,0,0,0,0,0,0,0,0,99832
33104,2345,70,712,928,437,198,175,85,59,8,2,49,26,4,2,0,2,22,11,9,2,90,85,62,0,23,5,5,3,0,2,0,0,0,0,99833
33105,6092,536,1312,2164,1294,786,517,223,173,67,0,106,50,34,24,3,7,16,7,2,7,294,276,49,27,200,18,13,9,0,4,5,0,5,0,99835
33106,21,0,3,18,0,0,5,5,5,0,0,5,0,0,0,0,0,0,0,0,0,0,0,0,0,0,0,0,0,0,0,0,0,0,0,99836
33107,797,38,242,323,154,40,16,10,5,2,0,3,5,0,0,0,0,5,5,0,0,6,6,2,2,2,0,0,0,0,0,0,0,0,0,99840
33108,84,8,24,24,24,4,4,0,0,0,0,0,0,0,0,0,0,0,0,0,0,4,0,0,0,0,4,4,0,0,4,0,0,0,0,99841
33109,9230,597,3080,3215,1605,733,633,341,247,65,14,168,94,54,37,4,13,40,21,4,15,292,208,51,0,157,84,79,4,0,75,5,5,0,0,99901
33110,25,3,3,19,0,0,5,5,0,0,0,0,5,5,0,0,5,0,0,0,0,0,0,0,0,0,0,0,0,0,0,0,0,0,0,99903
33111,119,8,74,29,8,0,1,1,1,0,0,1,0,0,0,0,0,0,0,0,0,0,0,0,0,0,0,0,0,0,0,0,0,0,0,99918
33112,378,11,143,100,80,44,9,5,2,0,0,2,3,0,0,0,0,3,3,0,0,4,4,2,0,2,0,0,0,0,0,0,0,0,0,99919
33113,1399,107,536,465,210,81,106,54,48,15,2,31,6,6,0,5,1,0,0,0,0,52,39,2,0,37,13,13,11,2,0,0,0,0,0,99921
33114,241,35,129,61,10,6,24,16,16,1,0,15,0,0,0,0,0,0,0,0,0,8,8,2,0,6,0,0,0,0,0,0,0,0,0,99922
33115,81,4,18,15,44,0,0,0,0,0,0,0,0,0,0,0,0,0,0,0,0,0,0,0,0,0,0,0,0,0,0,0,0,0,0,99923
33116,472,78,211,161,11,11,17,9,5,0,1,4,4,0,0,0,0,4,0,0,4,8,8,5,0,3,0,0,0,0,0,0,0,0,0,99925
33117,985,92,451,352,50,40,73,36,16,10,0,6,20,20,13,0,7,0,0,0,0,37,29,4,0,25,8,2,0,2,0,6,0,0,6,99926
33118,111,9,56,41,5,0,0,0,0,0,0,0,0,0,0,0,0,0,0,0,0,0,0,0,0,0,0,0,0,0,0,0,0,0,0,99927
33119,1781,195,681,604,242,59,140,114,68,18,2,48,46,44,32,10,2,2,2,0,0,26,21,11,0,10,5,2,2,0,0,3,0,0,3,99929
